"ESTADO","DISTRITO","MUNICIPIO","SECCION","LISTA_HOMBRES","LISTA_MUJERES","LISTA","FECHA"
1,1,1,1,475,501,976,"21 de agosto de 1994"
1,1,1,2,423,430,853,"21 de agosto de 1994"
1,1,1,3,426,515,941,"21 de agosto de 1994"
1,1,1,4,310,359,669,"21 de agosto de 1994"
1,1,1,5,289,347,636,"21 de agosto de 1994"
1,1,1,6,261,316,577,"21 de agosto de 1994"
1,1,1,7,307,361,668,"21 de agosto de 1994"
1,1,1,8,407,480,887,"21 de agosto de 1994"
1,1,1,9,490,572,1062,"21 de agosto de 1994"
1,1,1,10,469,546,1015,"21 de agosto de 1994"
1,1,1,11,480,558,1038,"21 de agosto de 1994"
1,1,1,12,352,397,749,"21 de agosto de 1994"
1,1,1,13,300,390,690,"21 de agosto de 1994"
1,1,1,14,318,393,711,"21 de agosto de 1994"
1,1,1,15,438,492,930,"21 de agosto de 1994"
1,1,1,16,402,488,890,"21 de agosto de 1994"
1,1,1,17,508,568,1076,"21 de agosto de 1994"
1,1,1,18,482,541,1023,"21 de agosto de 1994"
1,1,1,19,351,440,791,"21 de agosto de 1994"
1,1,1,20,341,365,706,"21 de agosto de 1994"
1,1,1,21,651,781,1432,"21 de agosto de 1994"
1,1,1,22,341,430,771,"21 de agosto de 1994"
1,1,1,23,461,549,1010,"21 de agosto de 1994"
1,1,1,24,323,428,751,"21 de agosto de 1994"
1,1,1,25,403,532,935,"21 de agosto de 1994"
1,1,1,26,558,685,1243,"21 de agosto de 1994"
1,1,1,27,331,391,722,"21 de agosto de 1994"
1,1,1,28,239,275,514,"21 de agosto de 1994"
1,1,1,29,435,560,995,"21 de agosto de 1994"
1,1,1,30,327,400,727,"21 de agosto de 1994"
1,1,1,31,449,508,957,"21 de agosto de 1994"
1,1,1,32,556,647,1203,"21 de agosto de 1994"
1,1,1,33,422,549,971,"21 de agosto de 1994"
1,1,1,34,287,396,683,"21 de agosto de 1994"
1,1,1,35,366,396,762,"21 de agosto de 1994"
1,1,1,36,397,474,871,"21 de agosto de 1994"
1,1,1,37,604,671,1275,"21 de agosto de 1994"
1,1,1,38,608,771,1379,"21 de agosto de 1994"
1,1,1,39,459,549,1008,"21 de agosto de 1994"
1,1,1,40,596,725,1321,"21 de agosto de 1994"
1,1,1,41,389,465,854,"21 de agosto de 1994"
1,1,1,42,440,481,921,"21 de agosto de 1994"
1,1,1,43,435,476,911,"21 de agosto de 1994"
1,1,1,44,563,648,1211,"21 de agosto de 1994"
1,1,1,45,436,513,949,"21 de agosto de 1994"
1,1,1,46,395,478,873,"21 de agosto de 1994"
1,1,1,47,608,686,1294,"21 de agosto de 1994"
1,1,1,48,431,508,939,"21 de agosto de 1994"
1,1,1,49,501,606,1107,"21 de agosto de 1994"
1,1,1,50,447,511,958,"21 de agosto de 1994"
1,1,1,51,612,667,1279,"21 de agosto de 1994"
1,1,1,52,440,526,966,"21 de agosto de 1994"
1,1,1,53,535,609,1144,"21 de agosto de 1994"
1,1,1,54,537,619,1156,"21 de agosto de 1994"
1,1,1,55,567,652,1219,"21 de agosto de 1994"
1,1,1,56,450,519,969,"21 de agosto de 1994"
1,1,1,57,402,489,891,"21 de agosto de 1994"
1,1,1,58,318,410,728,"21 de agosto de 1994"
1,1,1,59,294,364,658,"21 de agosto de 1994"
1,1,1,60,569,644,1213,"21 de agosto de 1994"
1,1,1,61,391,480,871,"21 de agosto de 1994"
1,1,1,62,300,376,676,"21 de agosto de 1994"
1,1,1,63,312,374,686,"21 de agosto de 1994"
1,1,1,64,375,491,866,"21 de agosto de 1994"
1,1,1,65,271,363,634,"21 de agosto de 1994"
1,1,1,66,381,522,903,"21 de agosto de 1994"
1,1,1,67,253,284,537,"21 de agosto de 1994"
1,1,1,68,318,439,757,"21 de agosto de 1994"
1,1,1,69,454,563,1017,"21 de agosto de 1994"
1,1,1,70,355,432,787,"21 de agosto de 1994"
1,1,1,71,522,629,1151,"21 de agosto de 1994"
1,1,1,72,280,354,634,"21 de agosto de 1994"
1,1,1,73,396,560,956,"21 de agosto de 1994"
1,1,1,74,300,390,690,"21 de agosto de 1994"
1,1,1,75,316,447,763,"21 de agosto de 1994"
1,1,1,76,231,353,584,"21 de agosto de 1994"
1,1,1,77,273,382,655,"21 de agosto de 1994"
1,1,1,78,358,477,835,"21 de agosto de 1994"
1,1,1,79,413,510,923,"21 de agosto de 1994"
1,1,1,80,982,1065,2047,"21 de agosto de 1994"
1,1,1,81,589,623,1212,"21 de agosto de 1994"
1,1,1,82,537,573,1110,"21 de agosto de 1994"
1,1,1,83,528,597,1125,"21 de agosto de 1994"
1,1,1,84,514,576,1090,"21 de agosto de 1994"
1,1,1,85,668,753,1421,"21 de agosto de 1994"
1,1,1,86,433,474,907,"21 de agosto de 1994"
1,1,1,87,199,214,413,"21 de agosto de 1994"
1,1,1,88,286,297,583,"21 de agosto de 1994"
1,1,1,89,497,557,1054,"21 de agosto de 1994"
1,1,1,90,619,687,1306,"21 de agosto de 1994"
1,1,1,91,272,317,589,"21 de agosto de 1994"
1,1,1,92,312,342,654,"21 de agosto de 1994"
1,1,1,93,339,424,763,"21 de agosto de 1994"
1,1,1,94,348,401,749,"21 de agosto de 1994"
1,1,1,95,399,448,847,"21 de agosto de 1994"
1,1,1,96,384,483,867,"21 de agosto de 1994"
1,1,1,97,339,399,738,"21 de agosto de 1994"
1,1,1,98,475,566,1041,"21 de agosto de 1994"
1,1,1,99,856,444,1300,"21 de agosto de 1994"
1,1,1,100,418,502,920,"21 de agosto de 1994"
1,1,1,101,287,364,651,"21 de agosto de 1994"
1,1,1,102,438,480,918,"21 de agosto de 1994"
1,1,1,103,403,433,836,"21 de agosto de 1994"
1,1,1,104,394,416,810,"21 de agosto de 1994"
1,1,1,105,357,394,751,"21 de agosto de 1994"
1,1,1,106,606,694,1300,"21 de agosto de 1994"
1,1,1,107,567,688,1255,"21 de agosto de 1994"
1,1,1,108,475,592,1067,"21 de agosto de 1994"
1,1,1,109,639,714,1353,"21 de agosto de 1994"
1,1,1,110,334,367,701,"21 de agosto de 1994"
1,1,1,111,677,707,1384,"21 de agosto de 1994"
1,1,1,112,310,383,693,"21 de agosto de 1994"
1,1,1,113,311,377,688,"21 de agosto de 1994"
1,1,1,114,312,386,698,"21 de agosto de 1994"
1,1,1,115,391,424,815,"21 de agosto de 1994"
1,1,1,116,433,515,948,"21 de agosto de 1994"
1,1,1,117,491,531,1022,"21 de agosto de 1994"
1,1,1,118,397,459,856,"21 de agosto de 1994"
1,1,1,119,405,454,859,"21 de agosto de 1994"
1,1,1,120,332,406,738,"21 de agosto de 1994"
1,1,1,121,327,418,745,"21 de agosto de 1994"
1,1,1,122,584,650,1234,"21 de agosto de 1994"
1,1,1,123,361,418,779,"21 de agosto de 1994"
1,1,1,124,267,309,576,"21 de agosto de 1994"
1,1,1,125,504,516,1020,"21 de agosto de 1994"
1,1,1,126,452,464,916,"21 de agosto de 1994"
1,1,1,127,507,532,1039,"21 de agosto de 1994"
1,1,1,128,320,346,666,"21 de agosto de 1994"
1,1,1,129,361,394,755,"21 de agosto de 1994"
1,1,1,130,422,480,902,"21 de agosto de 1994"
1,1,1,131,393,419,812,"21 de agosto de 1994"
1,1,1,132,356,411,767,"21 de agosto de 1994"
1,1,1,133,379,429,808,"21 de agosto de 1994"
1,1,1,134,319,362,681,"21 de agosto de 1994"
1,1,1,135,301,345,646,"21 de agosto de 1994"
1,1,1,136,527,555,1082,"21 de agosto de 1994"
1,1,1,137,166,180,346,"21 de agosto de 1994"
1,1,1,138,478,542,1020,"21 de agosto de 1994"
1,1,1,139,446,459,905,"21 de agosto de 1994"
1,1,1,140,604,551,1155,"21 de agosto de 1994"
1,1,1,141,525,576,1101,"21 de agosto de 1994"
1,1,1,142,353,400,753,"21 de agosto de 1994"
1,1,1,143,336,433,769,"21 de agosto de 1994"
1,1,1,144,406,448,854,"21 de agosto de 1994"
1,1,1,145,283,338,621,"21 de agosto de 1994"
1,1,1,146,464,536,1000,"21 de agosto de 1994"
1,1,1,147,576,549,1125,"21 de agosto de 1994"
1,1,1,148,632,685,1317,"21 de agosto de 1994"
1,1,1,149,495,560,1055,"21 de agosto de 1994"
1,1,1,150,280,323,603,"21 de agosto de 1994"
1,1,1,151,146,158,304,"21 de agosto de 1994"
1,1,1,152,547,592,1139,"21 de agosto de 1994"
1,1,1,153,258,257,515,"21 de agosto de 1994"
1,1,1,154,384,380,764,"21 de agosto de 1994"
1,1,1,155,988,1119,2107,"21 de agosto de 1994"
1,1,1,156,1145,1369,2514,"21 de agosto de 1994"
1,1,1,157,391,432,823,"21 de agosto de 1994"
1,1,1,158,170,186,356,"21 de agosto de 1994"
1,1,1,159,298,354,652,"21 de agosto de 1994"
1,1,1,160,326,397,723,"21 de agosto de 1994"
1,1,1,161,621,684,1305,"21 de agosto de 1994"
1,1,1,162,491,530,1021,"21 de agosto de 1994"
1,1,1,163,369,423,792,"21 de agosto de 1994"
1,1,1,164,725,837,1562,"21 de agosto de 1994"
1,1,1,165,346,401,747,"21 de agosto de 1994"
1,1,1,166,1460,1636,3096,"21 de agosto de 1994"
1,1,1,167,150,184,334,"21 de agosto de 1994"
1,1,1,168,450,509,959,"21 de agosto de 1994"
1,1,1,169,490,573,1063,"21 de agosto de 1994"
1,1,1,170,391,449,840,"21 de agosto de 1994"
1,1,1,171,326,411,737,"21 de agosto de 1994"
1,1,1,172,334,401,735,"21 de agosto de 1994"
1,1,1,173,265,340,605,"21 de agosto de 1994"
1,1,1,174,540,737,1277,"21 de agosto de 1994"
1,1,1,175,431,581,1012,"21 de agosto de 1994"
1,1,1,176,221,303,524,"21 de agosto de 1994"
1,1,1,177,372,545,917,"21 de agosto de 1994"
1,1,1,178,307,407,714,"21 de agosto de 1994"
1,1,1,179,407,508,915,"21 de agosto de 1994"
1,1,1,180,260,322,582,"21 de agosto de 1994"
1,1,1,181,259,333,592,"21 de agosto de 1994"
1,1,1,182,287,431,718,"21 de agosto de 1994"
1,1,1,183,213,297,510,"21 de agosto de 1994"
1,1,1,184,476,574,1050,"21 de agosto de 1994"
1,1,1,185,217,273,490,"21 de agosto de 1994"
1,1,1,186,212,257,469,"21 de agosto de 1994"
1,1,1,187,381,442,823,"21 de agosto de 1994"
1,1,1,188,532,679,1211,"21 de agosto de 1994"
1,1,1,189,516,667,1183,"21 de agosto de 1994"
1,1,1,190,411,612,1023,"21 de agosto de 1994"
1,1,1,191,290,347,637,"21 de agosto de 1994"
1,1,1,192,570,614,1184,"21 de agosto de 1994"
1,1,1,193,464,531,995,"21 de agosto de 1994"
1,1,1,194,668,775,1443,"21 de agosto de 1994"
1,1,1,195,414,479,893,"21 de agosto de 1994"
1,1,1,196,264,383,647,"21 de agosto de 1994"
1,1,1,197,356,442,798,"21 de agosto de 1994"
1,1,1,198,277,338,615,"21 de agosto de 1994"
1,1,1,199,340,405,745,"21 de agosto de 1994"
1,1,1,200,358,422,780,"21 de agosto de 1994"
1,1,1,201,386,431,817,"21 de agosto de 1994"
1,1,1,202,352,382,734,"21 de agosto de 1994"
1,1,1,203,354,407,761,"21 de agosto de 1994"
1,1,1,204,610,672,1282,"21 de agosto de 1994"
1,1,1,205,514,605,1119,"21 de agosto de 1994"
1,1,1,206,258,296,554,"21 de agosto de 1994"
1,1,1,207,534,576,1110,"21 de agosto de 1994"
1,1,1,208,465,559,1024,"21 de agosto de 1994"
1,1,1,209,392,529,921,"21 de agosto de 1994"
1,1,1,210,482,561,1043,"21 de agosto de 1994"
1,1,1,211,278,314,592,"21 de agosto de 1994"
1,1,1,212,398,445,843,"21 de agosto de 1994"
1,1,1,213,329,369,698,"21 de agosto de 1994"
1,1,1,214,380,534,914,"21 de agosto de 1994"
1,1,1,215,414,509,923,"21 de agosto de 1994"
1,1,1,216,387,462,849,"21 de agosto de 1994"
1,1,1,217,393,510,903,"21 de agosto de 1994"
1,1,1,218,350,408,758,"21 de agosto de 1994"
1,1,1,219,250,328,578,"21 de agosto de 1994"
1,1,1,220,250,293,543,"21 de agosto de 1994"
1,1,1,221,309,318,627,"21 de agosto de 1994"
1,1,1,222,243,299,542,"21 de agosto de 1994"
1,1,1,223,202,237,439,"21 de agosto de 1994"
1,1,1,224,277,293,570,"21 de agosto de 1994"
1,1,1,225,274,332,606,"21 de agosto de 1994"
1,1,1,226,256,283,539,"21 de agosto de 1994"
1,1,1,227,359,389,748,"21 de agosto de 1994"
1,1,1,228,314,373,687,"21 de agosto de 1994"
1,1,1,229,290,309,599,"21 de agosto de 1994"
1,1,1,230,224,268,492,"21 de agosto de 1994"
1,1,1,231,282,317,599,"21 de agosto de 1994"
1,1,1,232,208,237,445,"21 de agosto de 1994"
1,1,1,233,372,399,771,"21 de agosto de 1994"
1,1,1,234,268,322,590,"21 de agosto de 1994"
1,1,1,235,244,298,542,"21 de agosto de 1994"
1,1,1,236,310,366,676,"21 de agosto de 1994"
1,1,1,237,317,358,675,"21 de agosto de 1994"
1,1,1,238,298,318,616,"21 de agosto de 1994"
1,1,1,239,338,364,702,"21 de agosto de 1994"
1,1,1,240,309,336,645,"21 de agosto de 1994"
1,1,1,241,246,313,559,"21 de agosto de 1994"
1,1,1,242,248,291,539,"21 de agosto de 1994"
1,1,1,243,495,544,1039,"21 de agosto de 1994"
1,1,1,244,412,498,910,"21 de agosto de 1994"
1,1,1,245,295,367,662,"21 de agosto de 1994"
1,1,1,246,435,473,908,"21 de agosto de 1994"
1,1,1,247,401,425,826,"21 de agosto de 1994"
1,1,1,248,322,377,699,"21 de agosto de 1994"
1,1,1,249,364,393,757,"21 de agosto de 1994"
1,1,1,250,334,364,698,"21 de agosto de 1994"
1,1,1,251,397,436,833,"21 de agosto de 1994"
1,1,1,252,395,470,865,"21 de agosto de 1994"
1,1,1,253,346,383,729,"21 de agosto de 1994"
1,1,1,254,297,335,632,"21 de agosto de 1994"
1,1,1,255,292,331,623,"21 de agosto de 1994"
1,1,1,256,397,394,791,"21 de agosto de 1994"
1,1,1,257,313,348,661,"21 de agosto de 1994"
1,1,1,258,447,529,976,"21 de agosto de 1994"
1,1,1,259,247,303,550,"21 de agosto de 1994"
1,1,1,260,274,303,577,"21 de agosto de 1994"
1,1,1,261,337,400,737,"21 de agosto de 1994"
1,1,1,262,205,279,484,"21 de agosto de 1994"
1,1,1,263,279,320,599,"21 de agosto de 1994"
1,1,1,264,336,390,726,"21 de agosto de 1994"
1,1,1,265,287,346,633,"21 de agosto de 1994"
1,1,1,266,225,248,473,"21 de agosto de 1994"
1,1,1,267,407,489,896,"21 de agosto de 1994"
1,1,1,268,235,279,514,"21 de agosto de 1994"
1,1,1,269,352,351,703,"21 de agosto de 1994"
1,1,1,270,472,530,1002,"21 de agosto de 1994"
1,1,1,271,395,489,884,"21 de agosto de 1994"
1,1,1,272,369,412,781,"21 de agosto de 1994"
1,1,1,273,391,475,866,"21 de agosto de 1994"
1,1,1,274,380,482,862,"21 de agosto de 1994"
1,1,1,275,459,591,1050,"21 de agosto de 1994"
1,1,1,276,411,543,954,"21 de agosto de 1994"
1,1,1,277,432,508,940,"21 de agosto de 1994"
1,1,1,278,374,440,814,"21 de agosto de 1994"
1,1,1,279,267,320,587,"21 de agosto de 1994"
1,1,1,280,240,313,553,"21 de agosto de 1994"
1,1,1,281,277,299,576,"21 de agosto de 1994"
1,1,1,282,176,212,388,"21 de agosto de 1994"
1,1,1,283,265,310,575,"21 de agosto de 1994"
1,1,1,284,391,441,832,"21 de agosto de 1994"
1,1,1,285,300,359,659,"21 de agosto de 1994"
1,1,1,286,280,395,675,"21 de agosto de 1994"
1,1,1,287,304,415,719,"21 de agosto de 1994"
1,1,1,288,376,447,823,"21 de agosto de 1994"
1,1,1,289,341,425,766,"21 de agosto de 1994"
1,1,1,290,265,304,569,"21 de agosto de 1994"
1,1,1,291,450,494,944,"21 de agosto de 1994"
1,1,1,292,460,512,972,"21 de agosto de 1994"
1,1,1,293,324,395,719,"21 de agosto de 1994"
1,1,1,294,452,509,961,"21 de agosto de 1994"
1,1,1,295,563,618,1181,"21 de agosto de 1994"
1,1,1,296,441,482,923,"21 de agosto de 1994"
1,1,1,297,400,425,825,"21 de agosto de 1994"
1,1,1,298,586,651,1237,"21 de agosto de 1994"
1,1,1,299,527,568,1095,"21 de agosto de 1994"
1,1,1,300,336,365,701,"21 de agosto de 1994"
1,1,1,301,357,378,735,"21 de agosto de 1994"
1,1,1,302,404,427,831,"21 de agosto de 1994"
1,1,1,303,390,399,789,"21 de agosto de 1994"
1,1,1,304,485,545,1030,"21 de agosto de 1994"
1,1,1,305,475,508,983,"21 de agosto de 1994"
1,1,1,306,482,504,986,"21 de agosto de 1994"
1,1,1,307,435,571,1006,"21 de agosto de 1994"
1,1,1,308,354,415,769,"21 de agosto de 1994"
1,1,1,309,376,468,844,"21 de agosto de 1994"
1,1,1,310,373,423,796,"21 de agosto de 1994"
1,1,1,311,416,477,893,"21 de agosto de 1994"
1,1,1,312,432,495,927,"21 de agosto de 1994"
1,1,1,313,566,641,1207,"21 de agosto de 1994"
1,1,1,314,464,538,1002,"21 de agosto de 1994"
1,2,1,19,1,0,1,"21 de agosto de 1994"
1,2,1,315,743,711,1454,"21 de agosto de 1994"
1,2,1,316,597,651,1248,"21 de agosto de 1994"
1,2,1,317,633,685,1318,"21 de agosto de 1994"
1,2,1,318,404,341,745,"21 de agosto de 1994"
1,2,1,319,998,1102,2100,"21 de agosto de 1994"
1,2,1,320,644,680,1324,"21 de agosto de 1994"
1,2,1,321,307,263,570,"21 de agosto de 1994"
1,2,1,322,601,589,1190,"21 de agosto de 1994"
1,2,1,323,189,170,359,"21 de agosto de 1994"
1,2,1,324,474,449,923,"21 de agosto de 1994"
1,2,1,325,508,508,1016,"21 de agosto de 1994"
1,2,1,326,294,252,546,"21 de agosto de 1994"
1,2,1,327,312,366,678,"21 de agosto de 1994"
1,2,1,328,319,368,687,"21 de agosto de 1994"
1,2,1,329,254,284,538,"21 de agosto de 1994"
1,2,1,330,588,557,1145,"21 de agosto de 1994"
1,2,1,331,369,373,742,"21 de agosto de 1994"
1,2,1,332,454,467,921,"21 de agosto de 1994"
1,2,1,333,444,458,902,"21 de agosto de 1994"
1,2,1,334,353,389,742,"21 de agosto de 1994"
1,2,1,335,156,152,308,"21 de agosto de 1994"
1,2,1,336,351,347,698,"21 de agosto de 1994"
1,2,1,337,325,364,689,"21 de agosto de 1994"
1,2,2,338,418,470,888,"21 de agosto de 1994"
1,2,2,339,416,459,875,"21 de agosto de 1994"
1,2,2,340,399,387,786,"21 de agosto de 1994"
1,2,2,341,391,416,807,"21 de agosto de 1994"
1,2,2,342,365,348,713,"21 de agosto de 1994"
1,2,2,343,702,684,1386,"21 de agosto de 1994"
1,2,2,344,569,584,1153,"21 de agosto de 1994"
1,2,2,345,573,603,1176,"21 de agosto de 1994"
1,2,2,346,439,434,873,"21 de agosto de 1994"
1,2,2,347,576,617,1193,"21 de agosto de 1994"
1,2,2,348,326,366,692,"21 de agosto de 1994"
1,2,2,349,461,563,1024,"21 de agosto de 1994"
1,2,2,350,523,492,1015,"21 de agosto de 1994"
1,2,2,351,402,405,807,"21 de agosto de 1994"
1,2,2,352,594,624,1218,"21 de agosto de 1994"
1,2,2,353,375,411,786,"21 de agosto de 1994"
1,2,2,354,418,405,823,"21 de agosto de 1994"
1,2,3,355,309,377,686,"21 de agosto de 1994"
1,2,3,356,667,745,1412,"21 de agosto de 1994"
1,2,3,357,501,629,1130,"21 de agosto de 1994"
1,2,3,358,639,555,1194,"21 de agosto de 1994"
1,2,3,359,323,451,774,"21 de agosto de 1994"
1,2,3,360,292,352,644,"21 de agosto de 1994"
1,2,3,361,569,676,1245,"21 de agosto de 1994"
1,2,3,362,610,713,1323,"21 de agosto de 1994"
1,2,3,363,337,371,708,"21 de agosto de 1994"
1,2,3,364,200,275,475,"21 de agosto de 1994"
1,2,3,365,119,156,275,"21 de agosto de 1994"
1,2,3,366,177,212,389,"21 de agosto de 1994"
1,2,3,367,487,631,1118,"21 de agosto de 1994"
1,2,3,368,30,38,68,"21 de agosto de 1994"
1,2,3,369,149,166,315,"21 de agosto de 1994"
1,2,3,370,360,467,827,"21 de agosto de 1994"
1,2,3,371,248,330,578,"21 de agosto de 1994"
1,2,3,372,222,278,500,"21 de agosto de 1994"
1,2,3,373,148,154,302,"21 de agosto de 1994"
1,2,3,374,320,370,690,"21 de agosto de 1994"
1,2,3,375,311,396,707,"21 de agosto de 1994"
1,2,3,376,468,587,1055,"21 de agosto de 1994"
1,2,3,377,425,533,958,"21 de agosto de 1994"
1,2,3,378,110,112,222,"21 de agosto de 1994"
1,2,3,379,459,557,1016,"21 de agosto de 1994"
1,2,3,380,456,499,955,"21 de agosto de 1994"
1,2,3,381,226,280,506,"21 de agosto de 1994"
1,2,3,382,470,609,1079,"21 de agosto de 1994"
1,2,3,383,452,546,998,"21 de agosto de 1994"
1,2,3,384,238,291,529,"21 de agosto de 1994"
1,2,3,385,369,531,900,"21 de agosto de 1994"
1,2,3,386,419,527,946,"21 de agosto de 1994"
1,2,4,387,687,698,1385,"21 de agosto de 1994"
1,2,4,388,594,665,1259,"21 de agosto de 1994"
1,2,4,389,570,589,1159,"21 de agosto de 1994"
1,2,4,390,562,511,1073,"21 de agosto de 1994"
1,2,4,391,592,604,1196,"21 de agosto de 1994"
1,2,5,1,2,0,2,"21 de agosto de 1994"
1,2,5,315,1,0,1,"21 de agosto de 1994"
1,2,5,392,484,515,999,"21 de agosto de 1994"
1,2,5,393,406,468,874,"21 de agosto de 1994"
1,2,5,394,630,737,1367,"21 de agosto de 1994"
1,2,5,395,559,643,1202,"21 de agosto de 1994"
1,2,5,396,824,938,1762,"21 de agosto de 1994"
1,2,5,397,958,1038,1996,"21 de agosto de 1994"
1,2,5,398,440,506,946,"21 de agosto de 1994"
1,2,5,399,247,277,524,"21 de agosto de 1994"
1,2,5,400,380,404,784,"21 de agosto de 1994"
1,2,5,401,478,525,1003,"21 de agosto de 1994"
1,2,5,402,362,370,732,"21 de agosto de 1994"
1,2,5,403,651,777,1428,"21 de agosto de 1994"
1,2,5,404,158,160,318,"21 de agosto de 1994"
1,2,5,405,710,727,1437,"21 de agosto de 1994"
1,2,5,406,448,496,944,"21 de agosto de 1994"
1,2,5,407,198,208,406,"21 de agosto de 1994"
1,2,5,408,125,139,264,"21 de agosto de 1994"
1,2,5,409,267,304,571,"21 de agosto de 1994"
1,2,5,410,573,617,1190,"21 de agosto de 1994"
1,2,5,411,249,252,501,"21 de agosto de 1994"
1,2,5,412,667,814,1481,"21 de agosto de 1994"
1,2,5,413,333,380,713,"21 de agosto de 1994"
1,2,5,414,463,575,1038,"21 de agosto de 1994"
1,2,6,415,673,794,1467,"21 de agosto de 1994"
1,2,6,416,355,390,745,"21 de agosto de 1994"
1,2,6,417,460,475,935,"21 de agosto de 1994"
1,2,6,418,483,557,1040,"21 de agosto de 1994"
1,2,6,419,672,752,1424,"21 de agosto de 1994"
1,2,6,420,445,526,971,"21 de agosto de 1994"
1,2,6,421,327,358,685,"21 de agosto de 1994"
1,2,6,422,399,453,852,"21 de agosto de 1994"
1,2,6,423,500,611,1111,"21 de agosto de 1994"
1,2,6,424,527,576,1103,"21 de agosto de 1994"
1,2,6,425,256,278,534,"21 de agosto de 1994"
1,2,6,426,273,303,576,"21 de agosto de 1994"
1,2,6,427,192,182,374,"21 de agosto de 1994"
1,2,6,428,409,466,875,"21 de agosto de 1994"
1,2,6,429,563,550,1113,"21 de agosto de 1994"
1,2,6,430,349,350,699,"21 de agosto de 1994"
1,2,7,321,0,0,0,"21 de agosto de 1994"
1,2,7,431,323,349,672,"21 de agosto de 1994"
1,2,7,432,474,452,926,"21 de agosto de 1994"
1,2,7,433,274,306,580,"21 de agosto de 1994"
1,2,7,434,398,448,846,"21 de agosto de 1994"
1,2,7,435,365,415,780,"21 de agosto de 1994"
1,2,7,436,396,462,858,"21 de agosto de 1994"
1,2,7,437,394,415,809,"21 de agosto de 1994"
1,2,7,438,387,425,812,"21 de agosto de 1994"
1,2,7,439,669,744,1413,"21 de agosto de 1994"
1,2,7,440,716,784,1500,"21 de agosto de 1994"
1,2,7,441,445,454,899,"21 de agosto de 1994"
1,2,7,442,494,521,1015,"21 de agosto de 1994"
1,2,7,443,484,499,983,"21 de agosto de 1994"
1,2,7,444,241,262,503,"21 de agosto de 1994"
1,2,7,445,496,494,990,"21 de agosto de 1994"
1,2,7,446,361,378,739,"21 de agosto de 1994"
1,2,7,447,512,500,1012,"21 de agosto de 1994"
1,2,7,448,419,380,799,"21 de agosto de 1994"
1,2,7,449,548,573,1121,"21 de agosto de 1994"
1,2,7,450,322,316,638,"21 de agosto de 1994"
1,2,7,451,300,307,607,"21 de agosto de 1994"
1,2,8,452,317,375,692,"21 de agosto de 1994"
1,2,8,453,284,292,576,"21 de agosto de 1994"
1,2,8,454,394,428,822,"21 de agosto de 1994"
1,2,8,455,89,83,172,"21 de agosto de 1994"
1,2,8,456,118,113,231,"21 de agosto de 1994"
1,2,8,457,183,221,404,"21 de agosto de 1994"
1,2,8,458,275,324,599,"21 de agosto de 1994"
1,2,8,459,50,62,112,"21 de agosto de 1994"
1,2,9,460,349,375,724,"21 de agosto de 1994"
1,2,9,461,431,484,915,"21 de agosto de 1994"
1,2,9,462,458,521,979,"21 de agosto de 1994"
1,2,9,463,451,501,952,"21 de agosto de 1994"
1,2,9,464,384,397,781,"21 de agosto de 1994"
1,2,9,465,164,137,301,"21 de agosto de 1994"
1,2,9,466,168,145,313,"21 de agosto de 1994"
1,2,9,467,445,473,918,"21 de agosto de 1994"
1,2,9,468,194,197,391,"21 de agosto de 1994"
1,2,9,469,626,661,1287,"21 de agosto de 1994"
1,2,10,315,0,1,1,"21 de agosto de 1994"
1,2,10,316,1,0,1,"21 de agosto de 1994"
1,2,10,317,0,1,1,"21 de agosto de 1994"
1,2,10,318,1,0,1,"21 de agosto de 1994"
1,2,10,329,2,1,3,"21 de agosto de 1994"
1,2,10,470,580,671,1251,"21 de agosto de 1994"
1,2,10,471,645,796,1441,"21 de agosto de 1994"
1,2,10,472,453,493,946,"21 de agosto de 1994"
1,2,10,473,458,523,981,"21 de agosto de 1994"
1,2,10,474,371,414,785,"21 de agosto de 1994"
1,2,10,475,295,269,564,"21 de agosto de 1994"
1,2,10,476,333,340,673,"21 de agosto de 1994"
1,2,10,477,346,378,724,"21 de agosto de 1994"
1,2,10,478,474,504,978,"21 de agosto de 1994"
1,2,11,322,0,4,4,"21 de agosto de 1994"
1,2,11,323,1,0,1,"21 de agosto de 1994"
1,2,11,324,1,0,1,"21 de agosto de 1994"
1,2,11,325,2,0,2,"21 de agosto de 1994"
1,2,11,479,530,512,1042,"21 de agosto de 1994"
1,2,11,480,467,479,946,"21 de agosto de 1994"
1,2,11,481,421,400,821,"21 de agosto de 1994"
1,2,11,482,625,601,1226,"21 de agosto de 1994"
1,2,11,483,234,181,415,"21 de agosto de 1994"
1,2,11,484,257,232,489,"21 de agosto de 1994"
1,2,11,485,660,683,1343,"21 de agosto de 1994"
1,2,11,486,470,452,922,"21 de agosto de 1994"
2,1,2,211,403,414,817,"21 de agosto de 1994"
2,1,2,212,343,399,742,"21 de agosto de 1994"
2,1,2,213,426,448,874,"21 de agosto de 1994"
2,1,2,214,343,388,731,"21 de agosto de 1994"
2,1,2,215,373,364,737,"21 de agosto de 1994"
2,1,2,216,258,274,532,"21 de agosto de 1994"
2,1,2,217,273,175,448,"21 de agosto de 1994"
2,1,2,218,304,288,592,"21 de agosto de 1994"
2,1,2,219,274,304,578,"21 de agosto de 1994"
2,1,2,220,230,246,476,"21 de agosto de 1994"
2,1,2,221,433,429,862,"21 de agosto de 1994"
2,1,2,222,344,385,729,"21 de agosto de 1994"
2,1,2,223,340,391,731,"21 de agosto de 1994"
2,1,2,224,321,349,670,"21 de agosto de 1994"
2,1,2,225,346,436,782,"21 de agosto de 1994"
2,1,2,226,364,410,774,"21 de agosto de 1994"
2,1,2,227,416,405,821,"21 de agosto de 1994"
2,1,2,228,304,293,597,"21 de agosto de 1994"
2,1,2,229,297,304,601,"21 de agosto de 1994"
2,1,2,230,363,379,742,"21 de agosto de 1994"
2,1,2,231,413,468,881,"21 de agosto de 1994"
2,1,2,232,383,414,797,"21 de agosto de 1994"
2,1,2,233,373,402,775,"21 de agosto de 1994"
2,1,2,234,309,368,677,"21 de agosto de 1994"
2,1,2,235,346,384,730,"21 de agosto de 1994"
2,1,2,236,322,361,683,"21 de agosto de 1994"
2,1,2,237,391,452,843,"21 de agosto de 1994"
2,1,2,238,305,342,647,"21 de agosto de 1994"
2,1,2,239,246,228,474,"21 de agosto de 1994"
2,1,2,240,403,425,828,"21 de agosto de 1994"
2,1,2,241,407,456,863,"21 de agosto de 1994"
2,1,2,242,350,371,721,"21 de agosto de 1994"
2,1,2,243,301,329,630,"21 de agosto de 1994"
2,1,2,244,420,434,854,"21 de agosto de 1994"
2,1,2,245,356,384,740,"21 de agosto de 1994"
2,1,2,246,448,485,933,"21 de agosto de 1994"
2,1,2,247,472,541,1013,"21 de agosto de 1994"
2,1,2,248,352,343,695,"21 de agosto de 1994"
2,1,2,249,263,283,546,"21 de agosto de 1994"
2,1,2,250,290,325,615,"21 de agosto de 1994"
2,1,2,251,312,327,639,"21 de agosto de 1994"
2,1,2,252,454,509,963,"21 de agosto de 1994"
2,1,2,253,344,382,726,"21 de agosto de 1994"
2,1,2,254,494,563,1057,"21 de agosto de 1994"
2,1,2,255,472,524,996,"21 de agosto de 1994"
2,1,2,256,312,376,688,"21 de agosto de 1994"
2,1,2,257,339,418,757,"21 de agosto de 1994"
2,1,2,258,382,413,795,"21 de agosto de 1994"
2,1,2,259,265,304,569,"21 de agosto de 1994"
2,1,2,260,327,354,681,"21 de agosto de 1994"
2,1,2,261,334,375,709,"21 de agosto de 1994"
2,1,2,262,327,346,673,"21 de agosto de 1994"
2,1,2,263,339,349,688,"21 de agosto de 1994"
2,1,2,264,263,262,525,"21 de agosto de 1994"
2,1,2,265,271,321,592,"21 de agosto de 1994"
2,1,2,266,328,370,698,"21 de agosto de 1994"
2,1,2,267,262,327,589,"21 de agosto de 1994"
2,1,2,268,460,497,957,"21 de agosto de 1994"
2,1,2,269,353,365,718,"21 de agosto de 1994"
2,1,2,270,400,457,857,"21 de agosto de 1994"
2,1,2,271,521,547,1068,"21 de agosto de 1994"
2,1,2,272,372,419,791,"21 de agosto de 1994"
2,1,2,273,383,393,776,"21 de agosto de 1994"
2,1,2,274,371,428,799,"21 de agosto de 1994"
2,1,2,275,356,402,758,"21 de agosto de 1994"
2,1,2,276,350,408,758,"21 de agosto de 1994"
2,1,2,277,320,341,661,"21 de agosto de 1994"
2,1,2,278,253,281,534,"21 de agosto de 1994"
2,1,2,279,358,340,698,"21 de agosto de 1994"
2,1,2,280,315,379,694,"21 de agosto de 1994"
2,1,2,281,372,427,799,"21 de agosto de 1994"
2,1,2,282,341,387,728,"21 de agosto de 1994"
2,1,2,283,324,377,701,"21 de agosto de 1994"
2,1,2,284,330,409,739,"21 de agosto de 1994"
2,1,2,285,508,497,1005,"21 de agosto de 1994"
2,1,2,286,415,462,877,"21 de agosto de 1994"
2,1,2,287,378,417,795,"21 de agosto de 1994"
2,1,2,288,343,370,713,"21 de agosto de 1994"
2,1,2,289,336,361,697,"21 de agosto de 1994"
2,1,2,290,428,476,904,"21 de agosto de 1994"
2,1,2,291,524,598,1122,"21 de agosto de 1994"
2,1,2,292,439,502,941,"21 de agosto de 1994"
2,1,2,293,443,487,930,"21 de agosto de 1994"
2,1,2,294,466,448,914,"21 de agosto de 1994"
2,1,2,295,258,263,521,"21 de agosto de 1994"
2,1,2,296,330,381,711,"21 de agosto de 1994"
2,1,2,297,449,504,953,"21 de agosto de 1994"
2,1,2,298,326,331,657,"21 de agosto de 1994"
2,1,2,299,446,527,973,"21 de agosto de 1994"
2,1,2,300,385,428,813,"21 de agosto de 1994"
2,1,2,301,496,552,1048,"21 de agosto de 1994"
2,1,2,302,299,370,669,"21 de agosto de 1994"
2,1,2,303,400,451,851,"21 de agosto de 1994"
2,1,2,304,587,149,736,"21 de agosto de 1994"
2,1,2,305,472,581,1053,"21 de agosto de 1994"
2,1,2,306,504,559,1063,"21 de agosto de 1994"
2,1,2,307,422,439,861,"21 de agosto de 1994"
2,1,2,308,373,389,762,"21 de agosto de 1994"
2,1,2,309,345,362,707,"21 de agosto de 1994"
2,1,2,310,375,429,804,"21 de agosto de 1994"
2,1,2,311,266,331,597,"21 de agosto de 1994"
2,1,2,312,305,372,677,"21 de agosto de 1994"
2,1,2,313,399,513,912,"21 de agosto de 1994"
2,1,2,314,343,409,752,"21 de agosto de 1994"
2,1,2,315,321,365,686,"21 de agosto de 1994"
2,1,2,316,473,509,982,"21 de agosto de 1994"
2,1,2,317,471,474,945,"21 de agosto de 1994"
2,1,2,318,307,349,656,"21 de agosto de 1994"
2,1,2,319,435,460,895,"21 de agosto de 1994"
2,1,2,320,358,334,692,"21 de agosto de 1994"
2,1,2,321,511,532,1043,"21 de agosto de 1994"
2,1,2,322,287,344,631,"21 de agosto de 1994"
2,1,2,323,343,369,712,"21 de agosto de 1994"
2,1,2,324,312,337,649,"21 de agosto de 1994"
2,1,2,325,296,347,643,"21 de agosto de 1994"
2,1,2,326,424,485,909,"21 de agosto de 1994"
2,1,2,327,393,457,850,"21 de agosto de 1994"
2,1,2,328,454,511,965,"21 de agosto de 1994"
2,1,2,329,403,470,873,"21 de agosto de 1994"
2,1,2,330,401,483,884,"21 de agosto de 1994"
2,1,2,331,581,702,1283,"21 de agosto de 1994"
2,1,2,332,286,364,650,"21 de agosto de 1994"
2,1,2,333,388,458,846,"21 de agosto de 1994"
2,1,2,334,349,388,737,"21 de agosto de 1994"
2,1,2,335,420,490,910,"21 de agosto de 1994"
2,1,2,336,322,346,668,"21 de agosto de 1994"
2,1,2,337,428,445,873,"21 de agosto de 1994"
2,1,2,338,584,656,1240,"21 de agosto de 1994"
2,1,2,339,410,417,827,"21 de agosto de 1994"
2,1,2,340,345,370,715,"21 de agosto de 1994"
2,1,2,341,456,488,944,"21 de agosto de 1994"
2,1,2,342,481,528,1009,"21 de agosto de 1994"
2,1,2,343,405,452,857,"21 de agosto de 1994"
2,1,2,344,343,421,764,"21 de agosto de 1994"
2,1,2,345,415,443,858,"21 de agosto de 1994"
2,1,2,346,397,446,843,"21 de agosto de 1994"
2,1,2,347,404,474,878,"21 de agosto de 1994"
2,1,2,348,317,396,713,"21 de agosto de 1994"
2,1,2,349,432,449,881,"21 de agosto de 1994"
2,1,2,350,381,457,838,"21 de agosto de 1994"
2,1,2,351,353,437,790,"21 de agosto de 1994"
2,1,2,352,315,370,685,"21 de agosto de 1994"
2,1,2,353,394,380,774,"21 de agosto de 1994"
2,1,2,354,331,315,646,"21 de agosto de 1994"
2,1,2,355,441,479,920,"21 de agosto de 1994"
2,1,2,356,494,559,1053,"21 de agosto de 1994"
2,1,2,357,426,508,934,"21 de agosto de 1994"
2,1,2,358,433,482,915,"21 de agosto de 1994"
2,1,2,359,339,362,701,"21 de agosto de 1994"
2,1,2,360,357,435,792,"21 de agosto de 1994"
2,1,2,361,444,460,904,"21 de agosto de 1994"
2,1,2,362,412,497,909,"21 de agosto de 1994"
2,1,2,363,370,395,765,"21 de agosto de 1994"
2,1,2,364,415,477,892,"21 de agosto de 1994"
2,1,2,365,479,525,1004,"21 de agosto de 1994"
2,1,2,366,395,436,831,"21 de agosto de 1994"
2,1,2,367,417,431,848,"21 de agosto de 1994"
2,1,2,368,456,491,947,"21 de agosto de 1994"
2,1,2,369,261,321,582,"21 de agosto de 1994"
2,2,4,735,472,520,992,"21 de agosto de 1994"
2,2,4,736,373,384,757,"21 de agosto de 1994"
2,2,4,737,364,445,809,"21 de agosto de 1994"
2,2,4,738,368,472,840,"21 de agosto de 1994"
2,2,4,739,412,477,889,"21 de agosto de 1994"
2,2,4,740,486,539,1025,"21 de agosto de 1994"
2,2,4,741,419,489,908,"21 de agosto de 1994"
2,2,4,742,388,417,805,"21 de agosto de 1994"
2,2,4,743,285,296,581,"21 de agosto de 1994"
2,2,4,744,307,328,635,"21 de agosto de 1994"
2,2,4,745,282,317,599,"21 de agosto de 1994"
2,2,4,746,402,479,881,"21 de agosto de 1994"
2,2,4,747,428,410,838,"21 de agosto de 1994"
2,2,4,748,284,356,640,"21 de agosto de 1994"
2,2,4,749,431,407,838,"21 de agosto de 1994"
2,2,4,750,365,393,758,"21 de agosto de 1994"
2,2,4,751,479,370,849,"21 de agosto de 1994"
2,2,4,752,402,345,747,"21 de agosto de 1994"
2,2,4,753,426,373,799,"21 de agosto de 1994"
2,2,4,754,335,311,646,"21 de agosto de 1994"
2,2,4,755,271,255,526,"21 de agosto de 1994"
2,2,4,756,423,412,835,"21 de agosto de 1994"
2,2,4,757,384,408,792,"21 de agosto de 1994"
2,2,4,758,328,379,707,"21 de agosto de 1994"
2,2,4,759,263,285,548,"21 de agosto de 1994"
2,2,4,760,307,333,640,"21 de agosto de 1994"
2,2,4,761,472,520,992,"21 de agosto de 1994"
2,2,4,762,364,409,773,"21 de agosto de 1994"
2,2,4,763,389,449,838,"21 de agosto de 1994"
2,2,4,764,300,319,619,"21 de agosto de 1994"
2,2,4,765,449,516,965,"21 de agosto de 1994"
2,2,4,766,495,553,1048,"21 de agosto de 1994"
2,2,4,767,432,453,885,"21 de agosto de 1994"
2,2,4,768,304,360,664,"21 de agosto de 1994"
2,2,4,769,368,397,765,"21 de agosto de 1994"
2,2,4,770,236,250,486,"21 de agosto de 1994"
2,2,4,771,360,416,776,"21 de agosto de 1994"
2,2,4,772,323,370,693,"21 de agosto de 1994"
2,2,4,773,286,316,602,"21 de agosto de 1994"
2,2,4,774,237,246,483,"21 de agosto de 1994"
2,2,4,775,388,379,767,"21 de agosto de 1994"
2,2,4,776,361,416,777,"21 de agosto de 1994"
2,2,4,777,374,409,783,"21 de agosto de 1994"
2,2,4,778,327,376,703,"21 de agosto de 1994"
2,2,4,779,319,307,626,"21 de agosto de 1994"
2,2,4,780,269,238,507,"21 de agosto de 1994"
2,2,4,781,319,202,521,"21 de agosto de 1994"
2,2,4,782,357,295,652,"21 de agosto de 1994"
2,2,4,783,470,456,926,"21 de agosto de 1994"
2,2,4,784,279,289,568,"21 de agosto de 1994"
2,2,4,785,326,396,722,"21 de agosto de 1994"
2,2,4,786,422,446,868,"21 de agosto de 1994"
2,2,4,787,406,488,894,"21 de agosto de 1994"
2,2,4,788,310,313,623,"21 de agosto de 1994"
2,2,4,789,292,350,642,"21 de agosto de 1994"
2,2,4,790,433,431,864,"21 de agosto de 1994"
2,2,4,791,279,279,558,"21 de agosto de 1994"
2,2,4,792,386,412,798,"21 de agosto de 1994"
2,2,4,793,346,431,777,"21 de agosto de 1994"
2,2,4,794,504,530,1034,"21 de agosto de 1994"
2,2,4,795,371,472,843,"21 de agosto de 1994"
2,2,4,796,411,488,899,"21 de agosto de 1994"
2,2,4,797,277,287,564,"21 de agosto de 1994"
2,2,4,798,323,367,690,"21 de agosto de 1994"
2,2,4,799,319,355,674,"21 de agosto de 1994"
2,2,4,800,483,527,1010,"21 de agosto de 1994"
2,2,4,801,384,443,827,"21 de agosto de 1994"
2,2,4,802,447,499,946,"21 de agosto de 1994"
2,2,4,803,596,668,1264,"21 de agosto de 1994"
2,2,4,804,535,564,1099,"21 de agosto de 1994"
2,2,4,805,521,573,1094,"21 de agosto de 1994"
2,2,4,806,314,317,631,"21 de agosto de 1994"
2,2,4,807,390,399,789,"21 de agosto de 1994"
2,2,4,808,476,550,1026,"21 de agosto de 1994"
2,2,4,809,298,359,657,"21 de agosto de 1994"
2,2,4,810,316,343,659,"21 de agosto de 1994"
2,2,4,811,448,438,886,"21 de agosto de 1994"
2,2,4,812,368,373,741,"21 de agosto de 1994"
2,2,4,813,278,289,567,"21 de agosto de 1994"
2,2,4,814,365,367,732,"21 de agosto de 1994"
2,2,4,815,395,293,688,"21 de agosto de 1994"
2,2,4,816,360,368,728,"21 de agosto de 1994"
2,2,4,817,301,332,633,"21 de agosto de 1994"
2,2,4,818,320,389,709,"21 de agosto de 1994"
2,2,4,819,417,482,899,"21 de agosto de 1994"
2,2,4,820,444,506,950,"21 de agosto de 1994"
2,2,4,821,521,531,1052,"21 de agosto de 1994"
2,2,4,822,484,561,1045,"21 de agosto de 1994"
2,2,4,823,388,370,758,"21 de agosto de 1994"
2,2,4,824,343,399,742,"21 de agosto de 1994"
2,2,4,825,305,345,650,"21 de agosto de 1994"
2,2,4,826,324,388,712,"21 de agosto de 1994"
2,2,4,827,426,491,917,"21 de agosto de 1994"
2,2,4,828,360,390,750,"21 de agosto de 1994"
2,2,4,829,437,469,906,"21 de agosto de 1994"
2,2,4,830,397,411,808,"21 de agosto de 1994"
2,2,4,831,222,209,431,"21 de agosto de 1994"
2,2,4,832,282,313,595,"21 de agosto de 1994"
2,2,4,833,400,430,830,"21 de agosto de 1994"
2,2,4,834,389,418,807,"21 de agosto de 1994"
2,2,4,835,255,267,522,"21 de agosto de 1994"
2,2,4,836,336,380,716,"21 de agosto de 1994"
2,2,4,837,349,392,741,"21 de agosto de 1994"
2,2,4,838,518,544,1062,"21 de agosto de 1994"
2,2,4,839,344,363,707,"21 de agosto de 1994"
2,2,4,840,388,460,848,"21 de agosto de 1994"
2,2,4,841,276,301,577,"21 de agosto de 1994"
2,2,4,842,296,332,628,"21 de agosto de 1994"
2,2,4,843,348,410,758,"21 de agosto de 1994"
2,2,4,844,279,289,568,"21 de agosto de 1994"
2,2,4,845,274,286,560,"21 de agosto de 1994"
2,2,4,846,422,457,879,"21 de agosto de 1994"
2,2,4,847,394,456,850,"21 de agosto de 1994"
2,2,4,848,452,527,979,"21 de agosto de 1994"
2,2,4,849,456,488,944,"21 de agosto de 1994"
2,2,4,850,451,460,911,"21 de agosto de 1994"
2,2,4,851,310,366,676,"21 de agosto de 1994"
2,2,4,852,354,395,749,"21 de agosto de 1994"
2,2,4,853,420,432,852,"21 de agosto de 1994"
2,2,4,854,531,560,1091,"21 de agosto de 1994"
2,2,4,855,207,215,422,"21 de agosto de 1994"
2,2,4,856,410,394,804,"21 de agosto de 1994"
2,2,4,857,360,354,714,"21 de agosto de 1994"
2,2,4,858,523,537,1060,"21 de agosto de 1994"
2,2,4,859,241,243,484,"21 de agosto de 1994"
2,2,4,860,269,301,570,"21 de agosto de 1994"
2,2,4,861,281,291,572,"21 de agosto de 1994"
2,2,4,862,237,262,499,"21 de agosto de 1994"
2,2,4,863,225,256,481,"21 de agosto de 1994"
2,2,4,864,206,210,416,"21 de agosto de 1994"
2,2,4,865,303,345,648,"21 de agosto de 1994"
2,2,4,866,230,262,492,"21 de agosto de 1994"
2,2,4,867,228,275,503,"21 de agosto de 1994"
2,3,1,1,195,221,416,"21 de agosto de 1994"
2,3,1,2,388,405,793,"21 de agosto de 1994"
2,3,1,3,291,292,583,"21 de agosto de 1994"
2,3,1,4,453,466,919,"21 de agosto de 1994"
2,3,1,5,210,227,437,"21 de agosto de 1994"
2,3,1,6,177,162,339,"21 de agosto de 1994"
2,3,1,7,237,242,479,"21 de agosto de 1994"
2,3,1,8,236,267,503,"21 de agosto de 1994"
2,3,1,9,351,389,740,"21 de agosto de 1994"
2,3,1,10,406,433,839,"21 de agosto de 1994"
2,3,1,11,477,580,1057,"21 de agosto de 1994"
2,3,1,12,407,433,840,"21 de agosto de 1994"
2,3,1,13,439,401,840,"21 de agosto de 1994"
2,3,1,14,594,639,1233,"21 de agosto de 1994"
2,3,1,15,536,570,1106,"21 de agosto de 1994"
2,3,1,16,576,597,1173,"21 de agosto de 1994"
2,3,1,17,593,605,1198,"21 de agosto de 1994"
2,3,1,18,538,568,1106,"21 de agosto de 1994"
2,3,1,19,507,550,1057,"21 de agosto de 1994"
2,3,1,20,291,361,652,"21 de agosto de 1994"
2,3,1,21,296,289,585,"21 de agosto de 1994"
2,3,1,22,417,457,874,"21 de agosto de 1994"
2,3,1,23,497,582,1079,"21 de agosto de 1994"
2,3,1,24,576,573,1149,"21 de agosto de 1994"
2,3,1,25,405,437,842,"21 de agosto de 1994"
2,3,1,26,312,378,690,"21 de agosto de 1994"
2,3,1,27,446,492,938,"21 de agosto de 1994"
2,3,1,28,246,267,513,"21 de agosto de 1994"
2,3,1,29,286,303,589,"21 de agosto de 1994"
2,3,1,30,408,410,818,"21 de agosto de 1994"
2,3,1,31,242,262,504,"21 de agosto de 1994"
2,3,1,32,543,561,1104,"21 de agosto de 1994"
2,3,1,33,515,529,1044,"21 de agosto de 1994"
2,3,1,34,352,381,733,"21 de agosto de 1994"
2,3,1,35,254,296,550,"21 de agosto de 1994"
2,3,1,36,322,331,653,"21 de agosto de 1994"
2,3,1,37,230,310,540,"21 de agosto de 1994"
2,3,1,38,470,508,978,"21 de agosto de 1994"
2,3,1,39,489,536,1025,"21 de agosto de 1994"
2,3,1,40,474,489,963,"21 de agosto de 1994"
2,3,1,41,434,453,887,"21 de agosto de 1994"
2,3,1,42,353,361,714,"21 de agosto de 1994"
2,3,1,43,418,452,870,"21 de agosto de 1994"
2,3,1,44,309,283,592,"21 de agosto de 1994"
2,3,1,45,327,343,670,"21 de agosto de 1994"
2,3,1,46,387,436,823,"21 de agosto de 1994"
2,3,1,47,523,524,1047,"21 de agosto de 1994"
2,3,1,48,575,564,1139,"21 de agosto de 1994"
2,3,1,49,227,143,370,"21 de agosto de 1994"
2,3,1,50,464,240,704,"21 de agosto de 1994"
2,3,1,51,314,257,571,"21 de agosto de 1994"
2,3,1,52,400,381,781,"21 de agosto de 1994"
2,3,1,53,317,280,597,"21 de agosto de 1994"
2,3,1,54,407,450,857,"21 de agosto de 1994"
2,3,1,55,262,305,567,"21 de agosto de 1994"
2,3,1,56,296,340,636,"21 de agosto de 1994"
2,3,1,57,198,212,410,"21 de agosto de 1994"
2,3,1,58,559,581,1140,"21 de agosto de 1994"
2,3,1,59,429,429,858,"21 de agosto de 1994"
2,3,1,60,650,717,1367,"21 de agosto de 1994"
2,3,1,61,463,474,937,"21 de agosto de 1994"
2,3,1,62,312,299,611,"21 de agosto de 1994"
2,3,1,63,361,420,781,"21 de agosto de 1994"
2,3,1,64,338,355,693,"21 de agosto de 1994"
2,3,1,65,529,570,1099,"21 de agosto de 1994"
2,3,1,66,377,441,818,"21 de agosto de 1994"
2,3,1,67,367,371,738,"21 de agosto de 1994"
2,3,1,68,393,407,800,"21 de agosto de 1994"
2,3,1,69,405,402,807,"21 de agosto de 1994"
2,3,1,70,378,379,757,"21 de agosto de 1994"
2,3,1,71,355,379,734,"21 de agosto de 1994"
2,3,1,72,512,544,1056,"21 de agosto de 1994"
2,3,1,73,350,351,701,"21 de agosto de 1994"
2,3,1,74,471,507,978,"21 de agosto de 1994"
2,3,1,75,493,493,986,"21 de agosto de 1994"
2,3,1,76,441,486,927,"21 de agosto de 1994"
2,3,1,77,441,474,915,"21 de agosto de 1994"
2,3,1,78,383,466,849,"21 de agosto de 1994"
2,3,1,79,494,488,982,"21 de agosto de 1994"
2,3,1,80,299,351,650,"21 de agosto de 1994"
2,3,1,81,221,240,461,"21 de agosto de 1994"
2,3,1,82,191,184,375,"21 de agosto de 1994"
2,3,1,83,406,433,839,"21 de agosto de 1994"
2,3,1,84,450,428,878,"21 de agosto de 1994"
2,3,1,85,357,419,776,"21 de agosto de 1994"
2,3,1,86,582,629,1211,"21 de agosto de 1994"
2,3,1,87,392,435,827,"21 de agosto de 1994"
2,3,1,88,483,529,1012,"21 de agosto de 1994"
2,3,1,89,431,446,877,"21 de agosto de 1994"
2,3,1,90,455,516,971,"21 de agosto de 1994"
2,3,1,91,284,335,619,"21 de agosto de 1994"
2,3,1,92,377,462,839,"21 de agosto de 1994"
2,3,1,93,337,381,718,"21 de agosto de 1994"
2,3,1,94,395,432,827,"21 de agosto de 1994"
2,3,1,95,407,458,865,"21 de agosto de 1994"
2,3,1,96,304,344,648,"21 de agosto de 1994"
2,3,1,97,221,243,464,"21 de agosto de 1994"
2,3,1,98,556,638,1194,"21 de agosto de 1994"
2,3,1,99,419,444,863,"21 de agosto de 1994"
2,3,1,100,540,620,1160,"21 de agosto de 1994"
2,3,1,101,458,492,950,"21 de agosto de 1994"
2,3,1,102,599,673,1272,"21 de agosto de 1994"
2,3,1,103,538,601,1139,"21 de agosto de 1994"
2,3,1,104,542,599,1141,"21 de agosto de 1994"
2,3,1,105,521,577,1098,"21 de agosto de 1994"
2,3,1,106,471,540,1011,"21 de agosto de 1994"
2,3,1,107,466,505,971,"21 de agosto de 1994"
2,3,1,108,269,270,539,"21 de agosto de 1994"
2,3,1,109,369,409,778,"21 de agosto de 1994"
2,3,1,110,412,495,907,"21 de agosto de 1994"
2,3,1,111,206,253,459,"21 de agosto de 1994"
2,3,1,112,284,341,625,"21 de agosto de 1994"
2,3,1,113,507,569,1076,"21 de agosto de 1994"
2,3,1,114,337,395,732,"21 de agosto de 1994"
2,3,1,115,253,290,543,"21 de agosto de 1994"
2,3,1,116,494,591,1085,"21 de agosto de 1994"
2,3,1,117,212,266,478,"21 de agosto de 1994"
2,3,1,118,393,443,836,"21 de agosto de 1994"
2,3,1,119,341,393,734,"21 de agosto de 1994"
2,3,1,120,327,379,706,"21 de agosto de 1994"
2,3,1,121,299,362,661,"21 de agosto de 1994"
2,3,1,122,556,243,799,"21 de agosto de 1994"
2,3,1,123,284,267,551,"21 de agosto de 1994"
2,3,1,124,84,72,156,"21 de agosto de 1994"
2,3,1,125,253,271,524,"21 de agosto de 1994"
2,3,1,126,548,578,1126,"21 de agosto de 1994"
2,3,1,127,400,428,828,"21 de agosto de 1994"
2,3,1,128,375,371,746,"21 de agosto de 1994"
2,3,1,129,349,323,672,"21 de agosto de 1994"
2,3,1,130,451,468,919,"21 de agosto de 1994"
2,3,1,131,454,467,921,"21 de agosto de 1994"
2,3,1,132,571,567,1138,"21 de agosto de 1994"
2,3,1,133,449,466,915,"21 de agosto de 1994"
2,3,1,134,404,477,881,"21 de agosto de 1994"
2,3,1,135,421,386,807,"21 de agosto de 1994"
2,3,1,136,245,257,502,"21 de agosto de 1994"
2,3,1,137,292,314,606,"21 de agosto de 1994"
2,3,1,138,260,274,534,"21 de agosto de 1994"
2,3,1,139,387,418,805,"21 de agosto de 1994"
2,3,1,140,308,352,660,"21 de agosto de 1994"
2,3,1,141,305,327,632,"21 de agosto de 1994"
2,3,1,142,273,271,544,"21 de agosto de 1994"
2,3,1,143,238,214,452,"21 de agosto de 1994"
2,3,1,144,199,191,390,"21 de agosto de 1994"
2,3,1,145,188,195,383,"21 de agosto de 1994"
2,3,1,146,298,282,580,"21 de agosto de 1994"
2,3,1,147,128,138,266,"21 de agosto de 1994"
2,3,1,148,262,225,487,"21 de agosto de 1994"
2,3,1,149,234,262,496,"21 de agosto de 1994"
2,3,1,150,333,270,603,"21 de agosto de 1994"
2,3,1,151,495,414,909,"21 de agosto de 1994"
2,3,1,152,535,482,1017,"21 de agosto de 1994"
2,3,1,153,550,482,1032,"21 de agosto de 1994"
2,3,1,154,433,435,868,"21 de agosto de 1994"
2,3,1,155,324,310,634,"21 de agosto de 1994"
2,3,1,156,235,253,488,"21 de agosto de 1994"
2,3,1,157,229,244,473,"21 de agosto de 1994"
2,3,1,158,419,461,880,"21 de agosto de 1994"
2,3,1,159,250,292,542,"21 de agosto de 1994"
2,3,1,160,738,370,1108,"21 de agosto de 1994"
2,3,1,161,241,261,502,"21 de agosto de 1994"
2,3,1,162,332,319,651,"21 de agosto de 1994"
2,3,1,163,244,194,438,"21 de agosto de 1994"
2,3,1,164,293,253,546,"21 de agosto de 1994"
2,3,1,165,183,148,331,"21 de agosto de 1994"
2,3,1,166,394,394,788,"21 de agosto de 1994"
2,3,1,167,138,64,202,"21 de agosto de 1994"
2,3,1,168,430,421,851,"21 de agosto de 1994"
2,3,1,169,209,172,381,"21 de agosto de 1994"
2,3,1,170,238,192,430,"21 de agosto de 1994"
2,3,1,171,392,344,736,"21 de agosto de 1994"
2,3,1,172,93,58,151,"21 de agosto de 1994"
2,3,1,173,282,262,544,"21 de agosto de 1994"
2,3,1,174,61,61,122,"21 de agosto de 1994"
2,3,1,175,155,149,304,"21 de agosto de 1994"
2,3,1,176,657,582,1239,"21 de agosto de 1994"
2,3,1,177,234,227,461,"21 de agosto de 1994"
2,3,1,178,497,475,972,"21 de agosto de 1994"
2,3,1,179,295,185,480,"21 de agosto de 1994"
2,3,1,180,271,188,459,"21 de agosto de 1994"
2,3,1,181,305,237,542,"21 de agosto de 1994"
2,3,1,182,235,170,405,"21 de agosto de 1994"
2,3,1,183,292,255,547,"21 de agosto de 1994"
2,3,1,184,136,107,243,"21 de agosto de 1994"
2,3,1,185,598,467,1065,"21 de agosto de 1994"
2,3,1,186,410,348,758,"21 de agosto de 1994"
2,3,1,187,352,352,704,"21 de agosto de 1994"
2,3,1,188,206,149,355,"21 de agosto de 1994"
2,3,1,189,718,639,1357,"21 de agosto de 1994"
2,3,1,190,414,375,789,"21 de agosto de 1994"
2,3,1,191,218,223,441,"21 de agosto de 1994"
2,3,1,192,601,533,1134,"21 de agosto de 1994"
2,3,1,193,88,62,150,"21 de agosto de 1994"
2,3,1,194,460,363,823,"21 de agosto de 1994"
2,3,1,195,334,279,613,"21 de agosto de 1994"
2,3,1,196,213,168,381,"21 de agosto de 1994"
2,3,1,197,365,295,660,"21 de agosto de 1994"
2,3,1,198,150,136,286,"21 de agosto de 1994"
2,3,1,199,541,456,997,"21 de agosto de 1994"
2,3,1,200,120,96,216,"21 de agosto de 1994"
2,3,1,201,154,117,271,"21 de agosto de 1994"
2,3,1,202,163,116,279,"21 de agosto de 1994"
2,3,1,203,187,131,318,"21 de agosto de 1994"
2,3,1,204,41,30,71,"21 de agosto de 1994"
2,3,1,205,14,1,15,"21 de agosto de 1994"
2,3,1,206,346,369,715,"21 de agosto de 1994"
2,3,1,207,277,283,560,"21 de agosto de 1994"
2,3,1,208,415,417,832,"21 de agosto de 1994"
2,3,1,209,445,451,896,"21 de agosto de 1994"
2,3,1,210,256,235,491,"21 de agosto de 1994"
2,3,3,694,399,419,818,"21 de agosto de 1994"
2,3,3,695,336,344,680,"21 de agosto de 1994"
2,3,3,696,606,614,1220,"21 de agosto de 1994"
2,3,3,697,533,533,1066,"21 de agosto de 1994"
2,3,3,698,404,346,750,"21 de agosto de 1994"
2,3,3,699,411,413,824,"21 de agosto de 1994"
2,3,3,700,522,537,1059,"21 de agosto de 1994"
2,3,3,701,486,491,977,"21 de agosto de 1994"
2,3,3,702,361,327,688,"21 de agosto de 1994"
2,3,3,703,458,499,957,"21 de agosto de 1994"
2,3,3,704,294,287,581,"21 de agosto de 1994"
2,3,3,705,533,607,1140,"21 de agosto de 1994"
2,3,3,706,482,479,961,"21 de agosto de 1994"
2,3,3,707,416,479,895,"21 de agosto de 1994"
2,3,3,708,358,423,781,"21 de agosto de 1994"
2,3,3,709,420,426,846,"21 de agosto de 1994"
2,3,3,710,374,350,724,"21 de agosto de 1994"
2,3,3,711,420,433,853,"21 de agosto de 1994"
2,3,3,712,551,572,1123,"21 de agosto de 1994"
2,3,3,713,517,512,1029,"21 de agosto de 1994"
2,3,3,714,463,474,937,"21 de agosto de 1994"
2,3,3,715,586,563,1149,"21 de agosto de 1994"
2,3,3,716,456,450,906,"21 de agosto de 1994"
2,3,3,717,434,453,887,"21 de agosto de 1994"
2,3,3,718,317,333,650,"21 de agosto de 1994"
2,3,3,719,393,417,810,"21 de agosto de 1994"
2,3,3,720,430,435,865,"21 de agosto de 1994"
2,3,3,721,375,366,741,"21 de agosto de 1994"
2,3,3,722,569,548,1117,"21 de agosto de 1994"
2,3,3,723,593,557,1150,"21 de agosto de 1994"
2,3,3,724,466,341,807,"21 de agosto de 1994"
2,3,3,725,269,223,492,"21 de agosto de 1994"
2,3,3,726,228,257,485,"21 de agosto de 1994"
2,3,3,727,180,140,320,"21 de agosto de 1994"
2,3,3,728,153,102,255,"21 de agosto de 1994"
2,3,3,729,231,209,440,"21 de agosto de 1994"
2,3,3,730,288,210,498,"21 de agosto de 1994"
2,3,3,731,109,86,195,"21 de agosto de 1994"
2,3,3,732,84,75,159,"21 de agosto de 1994"
2,3,3,733,185,132,317,"21 de agosto de 1994"
2,3,3,734,192,146,338,"21 de agosto de 1994"
2,4,2,370,340,395,735,"21 de agosto de 1994"
2,4,2,371,342,388,730,"21 de agosto de 1994"
2,4,2,372,349,399,748,"21 de agosto de 1994"
2,4,2,373,308,341,649,"21 de agosto de 1994"
2,4,2,374,338,400,738,"21 de agosto de 1994"
2,4,2,375,393,464,857,"21 de agosto de 1994"
2,4,2,376,430,483,913,"21 de agosto de 1994"
2,4,2,377,466,521,987,"21 de agosto de 1994"
2,4,2,378,372,427,799,"21 de agosto de 1994"
2,4,2,379,358,382,740,"21 de agosto de 1994"
2,4,2,380,219,236,455,"21 de agosto de 1994"
2,4,2,381,295,325,620,"21 de agosto de 1994"
2,4,2,382,437,481,918,"21 de agosto de 1994"
2,4,2,383,341,357,698,"21 de agosto de 1994"
2,4,2,384,520,531,1051,"21 de agosto de 1994"
2,4,2,385,511,571,1082,"21 de agosto de 1994"
2,4,2,386,371,441,812,"21 de agosto de 1994"
2,4,2,387,368,423,791,"21 de agosto de 1994"
2,4,2,388,503,583,1086,"21 de agosto de 1994"
2,4,2,389,357,466,823,"21 de agosto de 1994"
2,4,2,390,348,369,717,"21 de agosto de 1994"
2,4,2,391,389,433,822,"21 de agosto de 1994"
2,4,2,392,520,593,1113,"21 de agosto de 1994"
2,4,2,393,405,454,859,"21 de agosto de 1994"
2,4,2,394,381,408,789,"21 de agosto de 1994"
2,4,2,395,499,578,1077,"21 de agosto de 1994"
2,4,2,396,544,572,1116,"21 de agosto de 1994"
2,4,2,397,356,434,790,"21 de agosto de 1994"
2,4,2,398,385,400,785,"21 de agosto de 1994"
2,4,2,399,429,530,959,"21 de agosto de 1994"
2,4,2,400,476,554,1030,"21 de agosto de 1994"
2,4,2,401,444,507,951,"21 de agosto de 1994"
2,4,2,402,414,486,900,"21 de agosto de 1994"
2,4,2,403,422,477,899,"21 de agosto de 1994"
2,4,2,404,337,407,744,"21 de agosto de 1994"
2,4,2,405,352,394,746,"21 de agosto de 1994"
2,4,2,406,519,574,1093,"21 de agosto de 1994"
2,4,2,407,241,287,528,"21 de agosto de 1994"
2,4,2,408,297,323,620,"21 de agosto de 1994"
2,4,2,409,491,638,1129,"21 de agosto de 1994"
2,4,2,410,382,411,793,"21 de agosto de 1994"
2,4,2,411,471,541,1012,"21 de agosto de 1994"
2,4,2,412,349,392,741,"21 de agosto de 1994"
2,4,2,413,366,399,765,"21 de agosto de 1994"
2,4,2,414,438,510,948,"21 de agosto de 1994"
2,4,2,415,370,417,787,"21 de agosto de 1994"
2,4,2,416,349,380,729,"21 de agosto de 1994"
2,4,2,417,475,538,1013,"21 de agosto de 1994"
2,4,2,418,356,360,716,"21 de agosto de 1994"
2,4,2,419,317,353,670,"21 de agosto de 1994"
2,4,2,420,368,396,764,"21 de agosto de 1994"
2,4,2,421,324,388,712,"21 de agosto de 1994"
2,4,2,422,360,402,762,"21 de agosto de 1994"
2,4,2,423,472,514,986,"21 de agosto de 1994"
2,4,2,424,436,497,933,"21 de agosto de 1994"
2,4,2,425,459,503,962,"21 de agosto de 1994"
2,4,2,426,375,438,813,"21 de agosto de 1994"
2,4,2,427,374,412,786,"21 de agosto de 1994"
2,4,2,428,244,252,496,"21 de agosto de 1994"
2,4,2,429,364,424,788,"21 de agosto de 1994"
2,4,2,430,380,448,828,"21 de agosto de 1994"
2,4,2,431,335,391,726,"21 de agosto de 1994"
2,4,2,432,393,431,824,"21 de agosto de 1994"
2,4,2,433,479,494,973,"21 de agosto de 1994"
2,4,2,434,333,389,722,"21 de agosto de 1994"
2,4,2,435,497,547,1044,"21 de agosto de 1994"
2,4,2,436,485,547,1032,"21 de agosto de 1994"
2,4,2,437,317,334,651,"21 de agosto de 1994"
2,4,2,438,444,508,952,"21 de agosto de 1994"
2,4,2,439,518,632,1150,"21 de agosto de 1994"
2,4,2,440,424,474,898,"21 de agosto de 1994"
2,4,2,441,542,611,1153,"21 de agosto de 1994"
2,4,2,442,558,602,1160,"21 de agosto de 1994"
2,4,2,443,550,612,1162,"21 de agosto de 1994"
2,4,2,444,724,815,1539,"21 de agosto de 1994"
2,4,2,445,447,505,952,"21 de agosto de 1994"
2,4,2,446,537,612,1149,"21 de agosto de 1994"
2,4,2,447,346,412,758,"21 de agosto de 1994"
2,4,2,448,621,691,1312,"21 de agosto de 1994"
2,4,2,449,645,702,1347,"21 de agosto de 1994"
2,4,2,450,585,651,1236,"21 de agosto de 1994"
2,4,2,451,325,348,673,"21 de agosto de 1994"
2,4,2,452,361,417,778,"21 de agosto de 1994"
2,4,2,453,345,381,726,"21 de agosto de 1994"
2,4,2,454,561,629,1190,"21 de agosto de 1994"
2,4,2,455,324,387,711,"21 de agosto de 1994"
2,4,2,456,390,478,868,"21 de agosto de 1994"
2,4,2,457,535,622,1157,"21 de agosto de 1994"
2,4,2,458,338,389,727,"21 de agosto de 1994"
2,4,2,459,435,433,868,"21 de agosto de 1994"
2,4,2,460,304,345,649,"21 de agosto de 1994"
2,4,2,461,425,443,868,"21 de agosto de 1994"
2,4,2,462,297,298,595,"21 de agosto de 1994"
2,4,2,463,367,468,835,"21 de agosto de 1994"
2,4,2,464,268,271,539,"21 de agosto de 1994"
2,4,2,465,445,433,878,"21 de agosto de 1994"
2,4,2,466,360,409,769,"21 de agosto de 1994"
2,4,2,467,412,492,904,"21 de agosto de 1994"
2,4,2,468,407,424,831,"21 de agosto de 1994"
2,4,2,469,506,571,1077,"21 de agosto de 1994"
2,4,2,470,335,379,714,"21 de agosto de 1994"
2,4,2,471,357,406,763,"21 de agosto de 1994"
2,4,2,472,290,337,627,"21 de agosto de 1994"
2,4,2,473,281,295,576,"21 de agosto de 1994"
2,4,2,474,292,346,638,"21 de agosto de 1994"
2,4,2,475,235,289,524,"21 de agosto de 1994"
2,4,2,476,473,516,989,"21 de agosto de 1994"
2,4,2,477,479,494,973,"21 de agosto de 1994"
2,4,2,478,487,568,1055,"21 de agosto de 1994"
2,4,2,479,292,335,627,"21 de agosto de 1994"
2,4,2,480,218,257,475,"21 de agosto de 1994"
2,4,2,481,321,390,711,"21 de agosto de 1994"
2,4,2,482,365,443,808,"21 de agosto de 1994"
2,4,2,483,297,274,571,"21 de agosto de 1994"
2,4,2,484,339,367,706,"21 de agosto de 1994"
2,4,2,485,274,309,583,"21 de agosto de 1994"
2,4,2,486,443,449,892,"21 de agosto de 1994"
2,4,2,487,263,328,591,"21 de agosto de 1994"
2,4,2,488,692,869,1561,"21 de agosto de 1994"
2,4,2,489,270,319,589,"21 de agosto de 1994"
2,4,2,490,208,258,466,"21 de agosto de 1994"
2,4,2,491,363,428,791,"21 de agosto de 1994"
2,4,2,492,402,516,918,"21 de agosto de 1994"
2,4,2,493,467,532,999,"21 de agosto de 1994"
2,4,2,494,423,467,890,"21 de agosto de 1994"
2,4,2,495,390,436,826,"21 de agosto de 1994"
2,4,2,496,186,175,361,"21 de agosto de 1994"
2,4,2,497,265,301,566,"21 de agosto de 1994"
2,4,2,498,263,306,569,"21 de agosto de 1994"
2,4,2,499,445,515,960,"21 de agosto de 1994"
2,4,2,500,247,300,547,"21 de agosto de 1994"
2,4,2,501,233,270,503,"21 de agosto de 1994"
2,4,2,502,296,319,615,"21 de agosto de 1994"
2,4,2,503,210,240,450,"21 de agosto de 1994"
2,4,2,504,370,456,826,"21 de agosto de 1994"
2,4,2,505,307,367,674,"21 de agosto de 1994"
2,4,2,506,247,297,544,"21 de agosto de 1994"
2,4,2,507,260,302,562,"21 de agosto de 1994"
2,4,2,508,346,360,706,"21 de agosto de 1994"
2,4,2,509,253,306,559,"21 de agosto de 1994"
2,4,2,510,259,290,549,"21 de agosto de 1994"
2,4,2,511,272,315,587,"21 de agosto de 1994"
2,4,2,512,250,291,541,"21 de agosto de 1994"
2,4,2,513,237,275,512,"21 de agosto de 1994"
2,4,2,514,275,326,601,"21 de agosto de 1994"
2,4,2,515,241,286,527,"21 de agosto de 1994"
2,4,2,516,344,362,706,"21 de agosto de 1994"
2,4,2,517,397,468,865,"21 de agosto de 1994"
2,4,2,518,309,373,682,"21 de agosto de 1994"
2,4,2,519,139,170,309,"21 de agosto de 1994"
2,4,2,520,235,272,507,"21 de agosto de 1994"
2,4,2,521,289,303,592,"21 de agosto de 1994"
2,4,2,522,329,388,717,"21 de agosto de 1994"
2,4,2,523,208,233,441,"21 de agosto de 1994"
2,4,2,524,232,281,513,"21 de agosto de 1994"
2,4,2,525,271,274,545,"21 de agosto de 1994"
2,4,2,526,268,307,575,"21 de agosto de 1994"
2,4,2,527,211,250,461,"21 de agosto de 1994"
2,4,2,528,183,224,407,"21 de agosto de 1994"
2,4,2,529,395,405,800,"21 de agosto de 1994"
2,4,2,530,306,356,662,"21 de agosto de 1994"
2,4,2,531,367,430,797,"21 de agosto de 1994"
2,4,2,532,381,477,858,"21 de agosto de 1994"
2,4,2,533,410,459,869,"21 de agosto de 1994"
2,4,2,534,241,271,512,"21 de agosto de 1994"
2,4,2,535,137,194,331,"21 de agosto de 1994"
2,4,2,536,180,191,371,"21 de agosto de 1994"
2,4,2,537,264,300,564,"21 de agosto de 1994"
2,4,2,538,492,566,1058,"21 de agosto de 1994"
2,4,2,539,192,229,421,"21 de agosto de 1994"
2,4,2,540,456,447,903,"21 de agosto de 1994"
2,4,2,541,332,412,744,"21 de agosto de 1994"
2,4,2,542,414,467,881,"21 de agosto de 1994"
2,4,2,543,302,353,655,"21 de agosto de 1994"
2,4,2,544,583,752,1335,"21 de agosto de 1994"
2,4,2,545,258,301,559,"21 de agosto de 1994"
2,4,2,546,140,167,307,"21 de agosto de 1994"
2,4,2,547,267,321,588,"21 de agosto de 1994"
2,4,2,548,147,139,286,"21 de agosto de 1994"
2,4,2,549,327,236,563,"21 de agosto de 1994"
2,4,2,550,365,341,706,"21 de agosto de 1994"
2,4,2,551,308,262,570,"21 de agosto de 1994"
2,4,2,552,449,400,849,"21 de agosto de 1994"
2,4,2,553,286,277,563,"21 de agosto de 1994"
2,4,2,554,446,431,877,"21 de agosto de 1994"
2,4,2,555,403,432,835,"21 de agosto de 1994"
2,4,2,556,568,582,1150,"21 de agosto de 1994"
2,4,2,557,184,143,327,"21 de agosto de 1994"
2,4,2,558,485,476,961,"21 de agosto de 1994"
2,4,2,559,431,455,886,"21 de agosto de 1994"
2,4,2,560,472,486,958,"21 de agosto de 1994"
2,4,2,561,438,436,874,"21 de agosto de 1994"
2,4,2,562,315,315,630,"21 de agosto de 1994"
2,4,2,563,431,376,807,"21 de agosto de 1994"
2,4,2,564,347,317,664,"21 de agosto de 1994"
2,4,2,565,557,625,1182,"21 de agosto de 1994"
2,4,2,566,193,241,434,"21 de agosto de 1994"
2,4,2,567,297,345,642,"21 de agosto de 1994"
2,4,2,568,303,287,590,"21 de agosto de 1994"
2,4,2,569,205,193,398,"21 de agosto de 1994"
2,4,2,570,392,409,801,"21 de agosto de 1994"
2,4,2,571,392,384,776,"21 de agosto de 1994"
2,4,2,572,430,420,850,"21 de agosto de 1994"
2,4,2,573,327,323,650,"21 de agosto de 1994"
2,4,2,574,418,408,826,"21 de agosto de 1994"
2,4,2,575,537,492,1029,"21 de agosto de 1994"
2,4,2,576,147,133,280,"21 de agosto de 1994"
2,4,2,577,467,466,933,"21 de agosto de 1994"
2,4,2,578,529,518,1047,"21 de agosto de 1994"
2,4,2,579,465,462,927,"21 de agosto de 1994"
2,4,2,580,247,225,472,"21 de agosto de 1994"
2,4,2,581,472,451,923,"21 de agosto de 1994"
2,4,2,582,428,386,814,"21 de agosto de 1994"
2,4,2,583,276,287,563,"21 de agosto de 1994"
2,4,2,584,309,307,616,"21 de agosto de 1994"
2,4,2,585,371,386,757,"21 de agosto de 1994"
2,4,2,586,356,353,709,"21 de agosto de 1994"
2,4,2,587,94,91,185,"21 de agosto de 1994"
2,4,2,588,314,327,641,"21 de agosto de 1994"
2,4,2,589,336,328,664,"21 de agosto de 1994"
2,4,2,590,533,585,1118,"21 de agosto de 1994"
2,4,2,591,229,222,451,"21 de agosto de 1994"
2,4,2,592,491,442,933,"21 de agosto de 1994"
2,4,2,593,298,312,610,"21 de agosto de 1994"
2,4,2,594,341,357,698,"21 de agosto de 1994"
2,4,2,595,429,418,847,"21 de agosto de 1994"
2,4,2,596,435,462,897,"21 de agosto de 1994"
2,4,2,597,540,494,1034,"21 de agosto de 1994"
2,4,2,598,272,272,544,"21 de agosto de 1994"
2,4,2,599,451,425,876,"21 de agosto de 1994"
2,4,2,600,354,327,681,"21 de agosto de 1994"
2,4,2,601,379,350,729,"21 de agosto de 1994"
2,4,2,602,367,345,712,"21 de agosto de 1994"
2,4,2,603,564,519,1083,"21 de agosto de 1994"
2,4,2,604,233,259,492,"21 de agosto de 1994"
2,4,2,605,354,352,706,"21 de agosto de 1994"
2,4,2,606,373,368,741,"21 de agosto de 1994"
2,4,2,607,397,366,763,"21 de agosto de 1994"
2,4,2,608,350,369,719,"21 de agosto de 1994"
2,4,2,609,205,221,426,"21 de agosto de 1994"
2,4,2,610,419,397,816,"21 de agosto de 1994"
2,4,2,611,417,404,821,"21 de agosto de 1994"
2,4,2,612,132,89,221,"21 de agosto de 1994"
2,4,2,613,617,561,1178,"21 de agosto de 1994"
2,4,2,614,295,275,570,"21 de agosto de 1994"
2,4,2,615,531,539,1070,"21 de agosto de 1994"
2,4,2,616,275,274,549,"21 de agosto de 1994"
2,4,2,617,354,324,678,"21 de agosto de 1994"
2,4,2,618,283,282,565,"21 de agosto de 1994"
2,4,2,619,173,172,345,"21 de agosto de 1994"
2,4,2,620,555,517,1072,"21 de agosto de 1994"
2,4,2,621,466,470,936,"21 de agosto de 1994"
2,4,2,622,522,554,1076,"21 de agosto de 1994"
2,4,2,623,377,387,764,"21 de agosto de 1994"
2,4,2,624,480,437,917,"21 de agosto de 1994"
2,4,2,625,440,413,853,"21 de agosto de 1994"
2,4,2,626,350,286,636,"21 de agosto de 1994"
2,4,2,627,376,335,711,"21 de agosto de 1994"
2,4,2,628,334,332,666,"21 de agosto de 1994"
2,4,2,629,294,286,580,"21 de agosto de 1994"
2,4,2,630,330,319,649,"21 de agosto de 1994"
2,4,2,631,385,370,755,"21 de agosto de 1994"
2,4,2,632,288,290,578,"21 de agosto de 1994"
2,4,2,633,366,343,709,"21 de agosto de 1994"
2,4,2,634,495,466,961,"21 de agosto de 1994"
2,4,2,635,365,314,679,"21 de agosto de 1994"
2,4,2,636,172,171,343,"21 de agosto de 1994"
2,4,2,637,200,188,388,"21 de agosto de 1994"
2,4,2,638,343,375,718,"21 de agosto de 1994"
2,4,2,639,410,396,806,"21 de agosto de 1994"
2,4,2,640,284,249,533,"21 de agosto de 1994"
2,4,2,641,405,431,836,"21 de agosto de 1994"
2,4,2,642,228,222,450,"21 de agosto de 1994"
2,4,2,643,310,315,625,"21 de agosto de 1994"
2,4,2,644,336,366,702,"21 de agosto de 1994"
2,4,2,645,424,427,851,"21 de agosto de 1994"
2,4,2,646,274,264,538,"21 de agosto de 1994"
2,4,2,647,322,304,626,"21 de agosto de 1994"
2,4,2,648,418,430,848,"21 de agosto de 1994"
2,4,2,649,276,266,542,"21 de agosto de 1994"
2,4,2,650,298,290,588,"21 de agosto de 1994"
2,4,2,651,472,462,934,"21 de agosto de 1994"
2,4,2,652,184,212,396,"21 de agosto de 1994"
2,4,2,653,418,425,843,"21 de agosto de 1994"
2,4,2,654,350,326,676,"21 de agosto de 1994"
2,4,2,655,236,224,460,"21 de agosto de 1994"
2,4,2,656,315,327,642,"21 de agosto de 1994"
2,4,2,657,270,260,530,"21 de agosto de 1994"
2,4,2,658,240,228,468,"21 de agosto de 1994"
2,4,2,659,266,274,540,"21 de agosto de 1994"
2,4,2,660,261,245,506,"21 de agosto de 1994"
2,4,2,661,37,34,71,"21 de agosto de 1994"
2,4,2,662,82,68,150,"21 de agosto de 1994"
2,4,2,663,531,509,1040,"21 de agosto de 1994"
2,4,2,664,413,428,841,"21 de agosto de 1994"
2,4,2,665,284,290,574,"21 de agosto de 1994"
2,4,2,666,203,222,425,"21 de agosto de 1994"
2,4,2,667,335,358,693,"21 de agosto de 1994"
2,4,2,668,259,281,540,"21 de agosto de 1994"
2,4,2,669,158,113,271,"21 de agosto de 1994"
2,4,2,670,175,152,327,"21 de agosto de 1994"
2,4,2,671,167,155,322,"21 de agosto de 1994"
2,4,2,672,130,117,247,"21 de agosto de 1994"
2,4,2,673,499,455,954,"21 de agosto de 1994"
2,4,2,674,274,262,536,"21 de agosto de 1994"
2,4,2,675,396,388,784,"21 de agosto de 1994"
2,4,2,676,232,224,456,"21 de agosto de 1994"
2,4,2,677,381,390,771,"21 de agosto de 1994"
2,4,2,678,321,330,651,"21 de agosto de 1994"
2,4,2,679,361,357,718,"21 de agosto de 1994"
2,4,2,680,279,282,561,"21 de agosto de 1994"
2,4,2,681,210,224,434,"21 de agosto de 1994"
2,4,2,682,240,235,475,"21 de agosto de 1994"
2,4,2,683,265,308,573,"21 de agosto de 1994"
2,4,2,684,279,324,603,"21 de agosto de 1994"
2,4,2,685,243,283,526,"21 de agosto de 1994"
2,4,2,686,242,310,552,"21 de agosto de 1994"
2,4,2,687,275,304,579,"21 de agosto de 1994"
2,4,2,688,303,280,583,"21 de agosto de 1994"
2,4,2,689,286,271,557,"21 de agosto de 1994"
2,4,2,690,555,622,1177,"21 de agosto de 1994"
2,4,2,691,791,886,1677,"21 de agosto de 1994"
2,4,2,692,187,209,396,"21 de agosto de 1994"
2,4,2,693,300,298,598,"21 de agosto de 1994"
2,5,4,868,488,345,833,"21 de agosto de 1994"
2,5,4,869,229,205,434,"21 de agosto de 1994"
2,5,4,870,158,166,324,"21 de agosto de 1994"
2,5,4,871,287,383,670,"21 de agosto de 1994"
2,5,4,872,360,454,814,"21 de agosto de 1994"
2,5,4,873,371,290,661,"21 de agosto de 1994"
2,5,4,874,466,366,832,"21 de agosto de 1994"
2,5,4,875,386,334,720,"21 de agosto de 1994"
2,5,4,876,300,282,582,"21 de agosto de 1994"
2,5,4,877,173,159,332,"21 de agosto de 1994"
2,5,4,878,291,250,541,"21 de agosto de 1994"
2,5,4,879,167,183,350,"21 de agosto de 1994"
2,5,4,880,391,330,721,"21 de agosto de 1994"
2,5,4,881,256,235,491,"21 de agosto de 1994"
2,5,4,882,346,351,697,"21 de agosto de 1994"
2,5,4,883,318,328,646,"21 de agosto de 1994"
2,5,4,884,475,562,1037,"21 de agosto de 1994"
2,5,4,885,222,276,498,"21 de agosto de 1994"
2,5,4,886,314,366,680,"21 de agosto de 1994"
2,5,4,887,257,313,570,"21 de agosto de 1994"
2,5,4,888,268,306,574,"21 de agosto de 1994"
2,5,4,889,261,279,540,"21 de agosto de 1994"
2,5,4,890,216,235,451,"21 de agosto de 1994"
2,5,4,891,373,402,775,"21 de agosto de 1994"
2,5,4,892,356,308,664,"21 de agosto de 1994"
2,5,4,893,394,382,776,"21 de agosto de 1994"
2,5,4,894,440,520,960,"21 de agosto de 1994"
2,5,4,895,367,400,767,"21 de agosto de 1994"
2,5,4,896,369,407,776,"21 de agosto de 1994"
2,5,4,897,414,464,878,"21 de agosto de 1994"
2,5,4,898,458,486,944,"21 de agosto de 1994"
2,5,4,899,191,242,433,"21 de agosto de 1994"
2,5,4,900,392,436,828,"21 de agosto de 1994"
2,5,4,901,427,470,897,"21 de agosto de 1994"
2,5,4,902,240,299,539,"21 de agosto de 1994"
2,5,4,903,261,314,575,"21 de agosto de 1994"
2,5,4,904,342,371,713,"21 de agosto de 1994"
2,5,4,905,254,285,539,"21 de agosto de 1994"
2,5,4,906,232,252,484,"21 de agosto de 1994"
2,5,4,907,203,243,446,"21 de agosto de 1994"
2,5,4,908,322,357,679,"21 de agosto de 1994"
2,5,4,909,168,197,365,"21 de agosto de 1994"
2,5,4,910,330,364,694,"21 de agosto de 1994"
2,5,4,911,414,445,859,"21 de agosto de 1994"
2,5,4,912,299,349,648,"21 de agosto de 1994"
2,5,4,913,351,351,702,"21 de agosto de 1994"
2,5,4,914,359,344,703,"21 de agosto de 1994"
2,5,4,915,220,227,447,"21 de agosto de 1994"
2,5,4,916,301,311,612,"21 de agosto de 1994"
2,5,4,917,399,415,814,"21 de agosto de 1994"
2,5,4,918,190,173,363,"21 de agosto de 1994"
2,5,4,919,234,252,486,"21 de agosto de 1994"
2,5,4,920,228,257,485,"21 de agosto de 1994"
2,5,4,921,150,139,289,"21 de agosto de 1994"
2,5,4,922,319,353,672,"21 de agosto de 1994"
2,5,4,923,329,373,702,"21 de agosto de 1994"
2,5,4,924,352,367,719,"21 de agosto de 1994"
2,5,4,925,243,286,529,"21 de agosto de 1994"
2,5,4,926,426,470,896,"21 de agosto de 1994"
2,5,4,927,468,487,955,"21 de agosto de 1994"
2,5,4,928,287,334,621,"21 de agosto de 1994"
2,5,4,929,271,294,565,"21 de agosto de 1994"
2,5,4,930,413,443,856,"21 de agosto de 1994"
2,5,4,931,452,545,997,"21 de agosto de 1994"
2,5,4,932,202,261,463,"21 de agosto de 1994"
2,5,4,933,320,393,713,"21 de agosto de 1994"
2,5,4,934,347,415,762,"21 de agosto de 1994"
2,5,4,935,453,498,951,"21 de agosto de 1994"
2,5,4,936,299,355,654,"21 de agosto de 1994"
2,5,4,937,315,350,665,"21 de agosto de 1994"
2,5,4,938,234,273,507,"21 de agosto de 1994"
2,5,4,939,334,368,702,"21 de agosto de 1994"
2,5,4,940,369,395,764,"21 de agosto de 1994"
2,5,4,941,210,301,511,"21 de agosto de 1994"
2,5,4,942,376,475,851,"21 de agosto de 1994"
2,5,4,943,359,349,708,"21 de agosto de 1994"
2,5,4,944,100,100,200,"21 de agosto de 1994"
2,5,4,945,213,242,455,"21 de agosto de 1994"
2,5,4,946,143,141,284,"21 de agosto de 1994"
2,5,4,947,256,307,563,"21 de agosto de 1994"
2,5,4,948,313,351,664,"21 de agosto de 1994"
2,5,4,949,232,251,483,"21 de agosto de 1994"
2,5,4,950,263,294,557,"21 de agosto de 1994"
2,5,4,951,202,239,441,"21 de agosto de 1994"
2,5,4,952,478,521,999,"21 de agosto de 1994"
2,5,4,953,318,378,696,"21 de agosto de 1994"
2,5,4,954,407,445,852,"21 de agosto de 1994"
2,5,4,955,329,352,681,"21 de agosto de 1994"
2,5,4,956,285,301,586,"21 de agosto de 1994"
2,5,4,957,284,327,611,"21 de agosto de 1994"
2,5,4,958,398,467,865,"21 de agosto de 1994"
2,5,4,959,364,443,807,"21 de agosto de 1994"
2,5,4,960,415,484,899,"21 de agosto de 1994"
2,5,4,961,351,400,751,"21 de agosto de 1994"
2,5,4,962,478,543,1021,"21 de agosto de 1994"
2,5,4,963,271,308,579,"21 de agosto de 1994"
2,5,4,964,431,428,859,"21 de agosto de 1994"
2,5,4,965,448,480,928,"21 de agosto de 1994"
2,5,4,966,473,508,981,"21 de agosto de 1994"
2,5,4,967,263,312,575,"21 de agosto de 1994"
2,5,4,968,264,293,557,"21 de agosto de 1994"
2,5,4,969,344,340,684,"21 de agosto de 1994"
2,5,4,970,335,349,684,"21 de agosto de 1994"
2,5,4,971,275,271,546,"21 de agosto de 1994"
2,5,4,972,432,450,882,"21 de agosto de 1994"
2,5,4,973,241,258,499,"21 de agosto de 1994"
2,5,4,974,267,336,603,"21 de agosto de 1994"
2,5,4,975,279,281,560,"21 de agosto de 1994"
2,5,4,976,345,345,690,"21 de agosto de 1994"
2,5,4,977,334,349,683,"21 de agosto de 1994"
2,5,4,978,316,332,648,"21 de agosto de 1994"
2,5,4,979,391,430,821,"21 de agosto de 1994"
2,5,4,980,409,502,911,"21 de agosto de 1994"
2,5,4,981,417,435,852,"21 de agosto de 1994"
2,5,4,982,344,379,723,"21 de agosto de 1994"
2,5,4,983,446,488,934,"21 de agosto de 1994"
2,5,4,984,308,302,610,"21 de agosto de 1994"
2,5,4,985,377,360,737,"21 de agosto de 1994"
2,5,4,986,269,291,560,"21 de agosto de 1994"
2,5,4,987,354,416,770,"21 de agosto de 1994"
2,5,4,988,428,364,792,"21 de agosto de 1994"
2,5,4,989,349,368,717,"21 de agosto de 1994"
2,5,4,990,448,518,966,"21 de agosto de 1994"
2,5,4,991,215,239,454,"21 de agosto de 1994"
2,5,4,992,169,185,354,"21 de agosto de 1994"
2,5,4,993,515,558,1073,"21 de agosto de 1994"
2,5,4,994,454,474,928,"21 de agosto de 1994"
2,5,4,995,293,301,594,"21 de agosto de 1994"
2,5,4,996,279,257,536,"21 de agosto de 1994"
2,5,4,997,490,62,552,"21 de agosto de 1994"
2,5,4,998,244,257,501,"21 de agosto de 1994"
2,5,4,999,331,388,719,"21 de agosto de 1994"
2,5,4,1000,218,233,451,"21 de agosto de 1994"
2,5,4,1001,330,308,638,"21 de agosto de 1994"
2,5,4,1002,420,451,871,"21 de agosto de 1994"
2,5,4,1003,372,457,829,"21 de agosto de 1994"
2,5,4,1004,419,484,903,"21 de agosto de 1994"
2,5,4,1005,282,307,589,"21 de agosto de 1994"
2,5,4,1006,259,287,546,"21 de agosto de 1994"
2,5,4,1007,328,408,736,"21 de agosto de 1994"
2,5,4,1008,268,309,577,"21 de agosto de 1994"
2,5,4,1009,300,343,643,"21 de agosto de 1994"
2,5,4,1010,141,170,311,"21 de agosto de 1994"
2,5,4,1011,366,331,697,"21 de agosto de 1994"
2,5,4,1012,313,371,684,"21 de agosto de 1994"
2,5,4,1013,366,480,846,"21 de agosto de 1994"
2,5,4,1014,385,425,810,"21 de agosto de 1994"
2,5,4,1015,379,423,802,"21 de agosto de 1994"
2,5,4,1016,353,364,717,"21 de agosto de 1994"
2,5,4,1017,358,377,735,"21 de agosto de 1994"
2,5,4,1018,257,273,530,"21 de agosto de 1994"
2,5,4,1019,207,233,440,"21 de agosto de 1994"
2,5,4,1020,214,266,480,"21 de agosto de 1994"
2,5,4,1021,224,259,483,"21 de agosto de 1994"
2,5,4,1022,269,285,554,"21 de agosto de 1994"
2,5,4,1023,241,252,493,"21 de agosto de 1994"
2,5,4,1024,264,260,524,"21 de agosto de 1994"
2,5,4,1025,212,261,473,"21 de agosto de 1994"
2,5,4,1026,249,236,485,"21 de agosto de 1994"
2,5,4,1027,302,309,611,"21 de agosto de 1994"
2,5,4,1028,270,273,543,"21 de agosto de 1994"
2,5,4,1029,227,255,482,"21 de agosto de 1994"
2,5,4,1030,327,316,643,"21 de agosto de 1994"
2,5,4,1031,276,307,583,"21 de agosto de 1994"
2,5,4,1032,329,334,663,"21 de agosto de 1994"
2,5,4,1033,262,292,554,"21 de agosto de 1994"
2,5,4,1034,282,305,587,"21 de agosto de 1994"
2,5,4,1035,285,313,598,"21 de agosto de 1994"
2,5,4,1036,379,431,810,"21 de agosto de 1994"
2,5,4,1037,275,317,592,"21 de agosto de 1994"
2,6,4,1038,427,422,849,"21 de agosto de 1994"
2,6,4,1039,555,614,1169,"21 de agosto de 1994"
2,6,4,1040,433,519,952,"21 de agosto de 1994"
2,6,4,1041,353,378,731,"21 de agosto de 1994"
2,6,4,1042,482,460,942,"21 de agosto de 1994"
2,6,4,1043,330,360,690,"21 de agosto de 1994"
2,6,4,1044,555,626,1181,"21 de agosto de 1994"
2,6,4,1045,546,611,1157,"21 de agosto de 1994"
2,6,4,1046,349,354,703,"21 de agosto de 1994"
2,6,4,1047,550,543,1093,"21 de agosto de 1994"
2,6,4,1048,642,600,1242,"21 de agosto de 1994"
2,6,4,1049,616,601,1217,"21 de agosto de 1994"
2,6,4,1050,382,334,716,"21 de agosto de 1994"
2,6,4,1051,343,354,697,"21 de agosto de 1994"
2,6,4,1052,551,584,1135,"21 de agosto de 1994"
2,6,4,1053,336,327,663,"21 de agosto de 1994"
2,6,4,1054,364,391,755,"21 de agosto de 1994"
2,6,4,1055,336,309,645,"21 de agosto de 1994"
2,6,4,1056,333,415,748,"21 de agosto de 1994"
2,6,4,1057,361,442,803,"21 de agosto de 1994"
2,6,4,1058,468,512,980,"21 de agosto de 1994"
2,6,4,1059,460,504,964,"21 de agosto de 1994"
2,6,4,1060,511,563,1074,"21 de agosto de 1994"
2,6,4,1061,301,329,630,"21 de agosto de 1994"
2,6,4,1062,408,498,906,"21 de agosto de 1994"
2,6,4,1063,415,410,825,"21 de agosto de 1994"
2,6,4,1064,315,351,666,"21 de agosto de 1994"
2,6,4,1065,332,339,671,"21 de agosto de 1994"
2,6,4,1066,340,368,708,"21 de agosto de 1994"
2,6,4,1067,229,286,515,"21 de agosto de 1994"
2,6,4,1068,379,360,739,"21 de agosto de 1994"
2,6,4,1069,333,414,747,"21 de agosto de 1994"
2,6,4,1070,525,541,1066,"21 de agosto de 1994"
2,6,4,1071,403,444,847,"21 de agosto de 1994"
2,6,4,1072,378,404,782,"21 de agosto de 1994"
2,6,4,1073,424,363,787,"21 de agosto de 1994"
2,6,4,1074,387,376,763,"21 de agosto de 1994"
2,6,4,1075,372,380,752,"21 de agosto de 1994"
2,6,4,1076,748,865,1613,"21 de agosto de 1994"
2,6,4,1077,508,580,1088,"21 de agosto de 1994"
2,6,4,1078,555,512,1067,"21 de agosto de 1994"
2,6,4,1079,405,413,818,"21 de agosto de 1994"
2,6,4,1080,377,365,742,"21 de agosto de 1994"
2,6,4,1081,416,446,862,"21 de agosto de 1994"
2,6,4,1082,248,276,524,"21 de agosto de 1994"
2,6,4,1083,574,513,1087,"21 de agosto de 1994"
2,6,4,1084,326,387,713,"21 de agosto de 1994"
2,6,4,1085,435,481,916,"21 de agosto de 1994"
2,6,4,1086,393,489,882,"21 de agosto de 1994"
2,6,4,1087,332,357,689,"21 de agosto de 1994"
2,6,4,1088,355,379,734,"21 de agosto de 1994"
2,6,4,1089,434,412,846,"21 de agosto de 1994"
2,6,4,1090,478,523,1001,"21 de agosto de 1994"
2,6,4,1091,445,413,858,"21 de agosto de 1994"
2,6,4,1092,475,529,1004,"21 de agosto de 1994"
2,6,4,1093,578,680,1258,"21 de agosto de 1994"
2,6,4,1094,458,514,972,"21 de agosto de 1994"
2,6,4,1095,482,508,990,"21 de agosto de 1994"
2,6,4,1096,475,511,986,"21 de agosto de 1994"
2,6,4,1097,744,778,1522,"21 de agosto de 1994"
2,6,4,1098,463,382,845,"21 de agosto de 1994"
2,6,4,1099,453,501,954,"21 de agosto de 1994"
2,6,4,1100,470,433,903,"21 de agosto de 1994"
2,6,4,1101,485,535,1020,"21 de agosto de 1994"
2,6,4,1102,336,378,714,"21 de agosto de 1994"
2,6,4,1103,581,583,1164,"21 de agosto de 1994"
2,6,4,1104,236,232,468,"21 de agosto de 1994"
2,6,4,1105,212,230,442,"21 de agosto de 1994"
2,6,4,1106,431,477,908,"21 de agosto de 1994"
2,6,4,1107,511,522,1033,"21 de agosto de 1994"
2,6,4,1108,294,332,626,"21 de agosto de 1994"
2,6,4,1109,514,578,1092,"21 de agosto de 1994"
2,6,4,1110,409,470,879,"21 de agosto de 1994"
2,6,4,1111,349,380,729,"21 de agosto de 1994"
2,6,4,1112,381,361,742,"21 de agosto de 1994"
2,6,4,1113,423,393,816,"21 de agosto de 1994"
2,6,4,1114,369,366,735,"21 de agosto de 1994"
2,6,4,1115,322,299,621,"21 de agosto de 1994"
2,6,4,1116,591,575,1166,"21 de agosto de 1994"
2,6,4,1117,199,214,413,"21 de agosto de 1994"
2,6,4,1118,443,483,926,"21 de agosto de 1994"
2,6,4,1119,551,608,1159,"21 de agosto de 1994"
2,6,4,1120,207,247,454,"21 de agosto de 1994"
2,6,4,1121,430,480,910,"21 de agosto de 1994"
2,6,4,1122,686,720,1406,"21 de agosto de 1994"
2,6,4,1123,271,250,521,"21 de agosto de 1994"
2,6,4,1124,308,287,595,"21 de agosto de 1994"
2,6,4,1125,180,185,365,"21 de agosto de 1994"
2,6,4,1126,270,285,555,"21 de agosto de 1994"
2,6,4,1127,203,197,400,"21 de agosto de 1994"
2,6,4,1128,512,492,1004,"21 de agosto de 1994"
2,6,4,1129,385,392,777,"21 de agosto de 1994"
2,6,4,1130,481,547,1028,"21 de agosto de 1994"
2,6,4,1131,553,563,1116,"21 de agosto de 1994"
2,6,4,1132,479,566,1045,"21 de agosto de 1994"
2,6,4,1133,298,336,634,"21 de agosto de 1994"
2,6,4,1134,301,292,593,"21 de agosto de 1994"
2,6,4,1135,534,514,1048,"21 de agosto de 1994"
2,6,4,1136,355,330,685,"21 de agosto de 1994"
2,6,4,1137,481,533,1014,"21 de agosto de 1994"
2,6,4,1138,506,537,1043,"21 de agosto de 1994"
2,6,4,1139,565,525,1090,"21 de agosto de 1994"
2,6,4,1140,709,758,1467,"21 de agosto de 1994"
2,6,4,1141,442,482,924,"21 de agosto de 1994"
2,6,4,1142,490,468,958,"21 de agosto de 1994"
2,6,4,1143,676,678,1354,"21 de agosto de 1994"
2,6,4,1144,352,404,756,"21 de agosto de 1994"
2,6,4,1145,622,747,1369,"21 de agosto de 1994"
2,6,4,1146,479,597,1076,"21 de agosto de 1994"
2,6,4,1147,549,611,1160,"21 de agosto de 1994"
2,6,4,1148,250,290,540,"21 de agosto de 1994"
2,6,4,1149,559,608,1167,"21 de agosto de 1994"
2,6,4,1150,215,216,431,"21 de agosto de 1994"
2,6,4,1151,271,276,547,"21 de agosto de 1994"
2,6,4,1152,655,680,1335,"21 de agosto de 1994"
2,6,4,1153,510,484,994,"21 de agosto de 1994"
2,6,4,1154,445,473,918,"21 de agosto de 1994"
2,6,4,1155,377,398,775,"21 de agosto de 1994"
2,6,4,1156,459,488,947,"21 de agosto de 1994"
2,6,4,1157,661,667,1328,"21 de agosto de 1994"
2,6,4,1158,453,499,952,"21 de agosto de 1994"
2,6,4,1159,398,384,782,"21 de agosto de 1994"
2,6,4,1160,516,578,1094,"21 de agosto de 1994"
2,6,4,1161,319,370,689,"21 de agosto de 1994"
2,6,4,1162,351,426,777,"21 de agosto de 1994"
2,6,4,1163,392,399,791,"21 de agosto de 1994"
2,6,4,1164,492,560,1052,"21 de agosto de 1994"
2,6,4,1165,380,349,729,"21 de agosto de 1994"
2,6,4,1166,244,253,497,"21 de agosto de 1994"
2,6,4,1167,451,496,947,"21 de agosto de 1994"
2,6,4,1168,572,603,1175,"21 de agosto de 1994"
2,6,4,1169,684,646,1330,"21 de agosto de 1994"
2,6,4,1170,447,506,953,"21 de agosto de 1994"
2,6,4,1171,343,425,768,"21 de agosto de 1994"
2,6,4,1172,269,268,537,"21 de agosto de 1994"
2,6,4,1173,355,380,735,"21 de agosto de 1994"
2,6,4,1174,456,458,914,"21 de agosto de 1994"
2,6,4,1175,412,399,811,"21 de agosto de 1994"
2,6,4,1176,220,241,461,"21 de agosto de 1994"
2,6,4,1177,462,513,975,"21 de agosto de 1994"
2,6,4,1178,289,314,603,"21 de agosto de 1994"
2,6,4,1179,357,354,711,"21 de agosto de 1994"
2,6,4,1180,485,507,992,"21 de agosto de 1994"
2,6,4,1181,294,299,593,"21 de agosto de 1994"
2,6,4,1182,333,337,670,"21 de agosto de 1994"
2,6,4,1183,402,363,765,"21 de agosto de 1994"
2,6,4,1184,436,435,871,"21 de agosto de 1994"
2,6,4,1185,499,506,1005,"21 de agosto de 1994"
2,6,4,1186,348,356,704,"21 de agosto de 1994"
2,6,4,1187,488,502,990,"21 de agosto de 1994"
2,6,4,1188,321,370,691,"21 de agosto de 1994"
2,6,4,1189,912,1019,1931,"21 de agosto de 1994"
2,6,4,1190,471,415,886,"21 de agosto de 1994"
2,6,4,1191,537,581,1118,"21 de agosto de 1994"
2,6,4,1192,475,524,999,"21 de agosto de 1994"
2,6,4,1193,482,531,1013,"21 de agosto de 1994"
2,6,4,1194,323,289,612,"21 de agosto de 1994"
2,6,4,1195,454,472,926,"21 de agosto de 1994"
2,6,4,1196,449,451,900,"21 de agosto de 1994"
2,6,4,1197,384,410,794,"21 de agosto de 1994"
2,6,4,1198,660,635,1295,"21 de agosto de 1994"
2,6,4,1199,489,525,1014,"21 de agosto de 1994"
2,6,4,1200,527,529,1056,"21 de agosto de 1994"
2,6,4,1201,406,437,843,"21 de agosto de 1994"
2,6,4,1202,682,656,1338,"21 de agosto de 1994"
2,6,4,1203,536,597,1133,"21 de agosto de 1994"
2,6,4,1204,553,564,1117,"21 de agosto de 1994"
2,6,4,1205,450,465,915,"21 de agosto de 1994"
2,6,4,1206,70,79,149,"21 de agosto de 1994"
2,6,4,1207,44,38,82,"21 de agosto de 1994"
2,6,4,1208,116,90,206,"21 de agosto de 1994"
2,6,4,1209,339,366,705,"21 de agosto de 1994"
2,6,4,1210,388,444,832,"21 de agosto de 1994"
2,6,4,1211,381,428,809,"21 de agosto de 1994"
2,6,4,1212,586,650,1236,"21 de agosto de 1994"
2,6,4,1213,497,586,1083,"21 de agosto de 1994"
2,6,4,1214,362,330,692,"21 de agosto de 1994"
2,6,4,1215,378,390,768,"21 de agosto de 1994"
2,6,4,1216,302,320,622,"21 de agosto de 1994"
2,6,4,1217,464,538,1002,"21 de agosto de 1994"
2,6,4,1218,421,446,867,"21 de agosto de 1994"
2,6,4,1219,393,390,783,"21 de agosto de 1994"
2,6,4,1220,472,439,911,"21 de agosto de 1994"
2,6,4,1221,522,507,1029,"21 de agosto de 1994"
2,6,4,1222,415,437,852,"21 de agosto de 1994"
2,6,4,1223,431,456,887,"21 de agosto de 1994"
2,6,4,1224,343,357,700,"21 de agosto de 1994"
2,6,4,1225,252,285,537,"21 de agosto de 1994"
2,6,4,1226,433,489,922,"21 de agosto de 1994"
2,6,4,1227,326,315,641,"21 de agosto de 1994"
2,6,4,1228,461,468,929,"21 de agosto de 1994"
2,6,4,1229,428,424,852,"21 de agosto de 1994"
2,6,4,1230,545,579,1124,"21 de agosto de 1994"
2,6,4,1231,343,362,705,"21 de agosto de 1994"
2,6,4,1232,479,465,944,"21 de agosto de 1994"
2,6,4,1233,441,429,870,"21 de agosto de 1994"
2,6,4,1234,250,278,528,"21 de agosto de 1994"
2,6,4,1235,260,297,557,"21 de agosto de 1994"
2,6,4,1236,745,760,1505,"21 de agosto de 1994"
2,6,4,1237,513,556,1069,"21 de agosto de 1994"
2,6,4,1238,598,614,1212,"21 de agosto de 1994"
2,6,4,1239,613,613,1226,"21 de agosto de 1994"
2,6,4,1240,486,505,991,"21 de agosto de 1994"
2,6,4,1241,429,433,862,"21 de agosto de 1994"
2,6,4,1242,754,788,1542,"21 de agosto de 1994"
2,6,4,1243,257,303,560,"21 de agosto de 1994"
2,6,4,1244,491,533,1024,"21 de agosto de 1994"
2,6,4,1245,438,457,895,"21 de agosto de 1994"
2,6,4,1246,297,381,678,"21 de agosto de 1994"
2,6,4,1247,390,405,795,"21 de agosto de 1994"
2,6,4,1248,359,397,756,"21 de agosto de 1994"
2,6,4,1249,479,541,1020,"21 de agosto de 1994"
2,6,4,1250,426,478,904,"21 de agosto de 1994"
2,6,4,1251,349,425,774,"21 de agosto de 1994"
2,6,4,1252,457,540,997,"21 de agosto de 1994"
2,6,4,1253,337,354,691,"21 de agosto de 1994"
2,6,4,1254,491,607,1098,"21 de agosto de 1994"
2,6,4,1255,352,402,754,"21 de agosto de 1994"
2,6,4,1256,304,286,590,"21 de agosto de 1994"
2,6,4,1257,288,373,661,"21 de agosto de 1994"
2,6,4,1258,282,334,616,"21 de agosto de 1994"
2,6,4,1259,400,424,824,"21 de agosto de 1994"
2,6,4,1260,451,435,886,"21 de agosto de 1994"
2,6,4,1261,376,387,763,"21 de agosto de 1994"
2,6,4,1262,466,425,891,"21 de agosto de 1994"
2,6,4,1263,499,467,966,"21 de agosto de 1994"
2,6,4,1264,453,437,890,"21 de agosto de 1994"
2,6,4,1265,441,463,904,"21 de agosto de 1994"
2,6,4,1266,536,587,1123,"21 de agosto de 1994"
2,6,4,1267,254,228,482,"21 de agosto de 1994"
2,6,4,1268,324,329,653,"21 de agosto de 1994"
2,6,4,1269,421,400,821,"21 de agosto de 1994"
2,6,4,1270,440,385,825,"21 de agosto de 1994"
2,6,4,1271,437,410,847,"21 de agosto de 1994"
2,6,4,1272,334,299,633,"21 de agosto de 1994"
2,6,4,1273,354,359,713,"21 de agosto de 1994"
2,6,4,1274,249,291,540,"21 de agosto de 1994"
2,6,4,1275,257,288,545,"21 de agosto de 1994"
2,6,4,1276,440,423,863,"21 de agosto de 1994"
2,6,4,1277,373,394,767,"21 de agosto de 1994"
2,6,4,1278,706,820,1526,"21 de agosto de 1994"
2,6,4,1279,292,303,595,"21 de agosto de 1994"
2,6,4,1280,302,296,598,"21 de agosto de 1994"
2,6,4,1281,280,280,560,"21 de agosto de 1994"
2,6,4,1282,288,277,565,"21 de agosto de 1994"
2,6,4,1283,299,309,608,"21 de agosto de 1994"
2,6,4,1284,407,410,817,"21 de agosto de 1994"
2,6,4,1285,302,346,648,"21 de agosto de 1994"
2,6,4,1286,501,542,1043,"21 de agosto de 1994"
2,6,4,1287,350,377,727,"21 de agosto de 1994"
2,6,4,1288,397,425,822,"21 de agosto de 1994"
2,6,4,1289,556,506,1062,"21 de agosto de 1994"
2,6,4,1290,391,349,740,"21 de agosto de 1994"
2,6,4,1291,314,293,607,"21 de agosto de 1994"
2,6,4,1292,1066,1011,2077,"21 de agosto de 1994"
2,6,4,1293,168,127,295,"21 de agosto de 1994"
2,6,4,1294,289,238,527,"21 de agosto de 1994"
2,6,4,1295,682,664,1346,"21 de agosto de 1994"
2,6,4,1296,144,123,267,"21 de agosto de 1994"
2,6,4,1297,227,210,437,"21 de agosto de 1994"
2,6,4,1298,236,194,430,"21 de agosto de 1994"
2,6,4,1299,308,327,635,"21 de agosto de 1994"
2,6,4,1300,766,902,1668,"21 de agosto de 1994"
2,6,4,1301,299,321,620,"21 de agosto de 1994"
2,6,4,1302,448,487,935,"21 de agosto de 1994"
2,6,4,1303,376,354,730,"21 de agosto de 1994"
2,6,4,1304,352,389,741,"21 de agosto de 1994"
2,6,4,1305,358,374,732,"21 de agosto de 1994"
2,6,4,1306,176,217,393,"21 de agosto de 1994"
2,6,4,1307,336,369,705,"21 de agosto de 1994"
2,6,4,1308,332,352,684,"21 de agosto de 1994"
2,6,4,1309,284,320,604,"21 de agosto de 1994"
2,6,4,1310,362,362,724,"21 de agosto de 1994"
2,6,4,1311,418,355,773,"21 de agosto de 1994"
2,6,4,1312,364,331,695,"21 de agosto de 1994"
2,6,4,1313,292,311,603,"21 de agosto de 1994"
2,6,4,1314,362,394,756,"21 de agosto de 1994"
2,6,4,1315,308,328,636,"21 de agosto de 1994"
2,6,4,1316,365,332,697,"21 de agosto de 1994"
2,6,4,1317,316,329,645,"21 de agosto de 1994"
2,6,4,1318,322,377,699,"21 de agosto de 1994"
2,6,4,1319,495,432,927,"21 de agosto de 1994"
2,6,4,1320,380,412,792,"21 de agosto de 1994"
2,6,4,1321,596,576,1172,"21 de agosto de 1994"
2,6,4,1322,218,249,467,"21 de agosto de 1994"
2,6,4,1323,259,245,504,"21 de agosto de 1994"
2,6,4,1324,410,416,826,"21 de agosto de 1994"
2,6,4,1325,292,292,584,"21 de agosto de 1994"
2,6,4,1326,325,347,672,"21 de agosto de 1994"
2,6,4,1327,620,656,1276,"21 de agosto de 1994"
2,6,4,1328,943,942,1885,"21 de agosto de 1994"
2,6,4,1329,335,394,729,"21 de agosto de 1994"
2,6,4,1330,166,217,383,"21 de agosto de 1994"
2,6,4,1331,563,658,1221,"21 de agosto de 1994"
2,6,4,1332,395,455,850,"21 de agosto de 1994"
2,6,4,1333,233,270,503,"21 de agosto de 1994"
2,6,4,1334,291,322,613,"21 de agosto de 1994"
2,6,4,1335,360,435,795,"21 de agosto de 1994"
2,6,4,1336,925,1033,1958,"21 de agosto de 1994"
2,6,4,1337,388,371,759,"21 de agosto de 1994"
2,6,4,1338,234,244,478,"21 de agosto de 1994"
2,6,4,1339,276,306,582,"21 de agosto de 1994"
2,6,4,1340,267,285,552,"21 de agosto de 1994"
2,6,4,1341,289,278,567,"21 de agosto de 1994"
2,6,4,1342,316,384,700,"21 de agosto de 1994"
2,6,4,1343,310,370,680,"21 de agosto de 1994"
2,6,4,1344,396,409,805,"21 de agosto de 1994"
2,6,4,1345,445,483,928,"21 de agosto de 1994"
2,6,4,1346,483,486,969,"21 de agosto de 1994"
2,6,4,1347,476,464,940,"21 de agosto de 1994"
2,6,4,1348,339,369,708,"21 de agosto de 1994"
2,6,4,1349,416,432,848,"21 de agosto de 1994"
2,6,4,1350,154,144,298,"21 de agosto de 1994"
2,6,4,1351,298,304,602,"21 de agosto de 1994"
2,6,4,1352,330,319,649,"21 de agosto de 1994"
2,6,4,1353,239,213,452,"21 de agosto de 1994"
2,6,4,1354,1007,1077,2084,"21 de agosto de 1994"
2,6,4,1355,188,214,402,"21 de agosto de 1994"
2,6,4,1356,474,542,1016,"21 de agosto de 1994"
2,6,4,1357,284,325,609,"21 de agosto de 1994"
2,6,4,1358,245,258,503,"21 de agosto de 1994"
2,6,4,1359,242,289,531,"21 de agosto de 1994"
2,6,4,1360,249,317,566,"21 de agosto de 1994"
2,6,4,1361,293,375,668,"21 de agosto de 1994"
2,6,4,1362,214,256,470,"21 de agosto de 1994"
2,6,4,1363,75,65,140,"21 de agosto de 1994"
2,6,4,1364,252,217,469,"21 de agosto de 1994"
2,6,4,1365,298,285,583,"21 de agosto de 1994"
2,6,4,1366,288,302,590,"21 de agosto de 1994"
2,6,4,1367,104,90,194,"21 de agosto de 1994"
2,6,4,1368,188,161,349,"21 de agosto de 1994"
3,1,3,121,248,271,519,"21 de agosto de 1994"
3,1,3,122,295,257,552,"21 de agosto de 1994"
3,1,3,123,388,421,809,"21 de agosto de 1994"
3,1,3,124,515,532,1047,"21 de agosto de 1994"
3,1,3,125,278,311,589,"21 de agosto de 1994"
3,1,3,126,330,351,681,"21 de agosto de 1994"
3,1,3,127,376,351,727,"21 de agosto de 1994"
3,1,3,128,244,245,489,"21 de agosto de 1994"
3,1,3,129,274,281,555,"21 de agosto de 1994"
3,1,3,130,182,190,372,"21 de agosto de 1994"
3,1,3,131,236,295,531,"21 de agosto de 1994"
3,1,3,132,188,230,418,"21 de agosto de 1994"
3,1,3,133,170,185,355,"21 de agosto de 1994"
3,1,3,134,135,168,303,"21 de agosto de 1994"
3,1,3,135,431,424,855,"21 de agosto de 1994"
3,1,3,136,311,328,639,"21 de agosto de 1994"
3,1,3,137,353,388,741,"21 de agosto de 1994"
3,1,3,138,311,286,597,"21 de agosto de 1994"
3,1,3,139,274,237,511,"21 de agosto de 1994"
3,1,3,140,199,203,402,"21 de agosto de 1994"
3,1,3,141,284,300,584,"21 de agosto de 1994"
3,1,3,142,325,325,650,"21 de agosto de 1994"
3,1,3,143,252,257,509,"21 de agosto de 1994"
3,1,3,144,283,294,577,"21 de agosto de 1994"
3,1,3,145,260,237,497,"21 de agosto de 1994"
3,1,3,146,220,222,442,"21 de agosto de 1994"
3,1,3,147,243,274,517,"21 de agosto de 1994"
3,1,3,148,266,269,535,"21 de agosto de 1994"
3,1,3,149,324,301,625,"21 de agosto de 1994"
3,1,3,150,226,224,450,"21 de agosto de 1994"
3,1,3,151,172,177,349,"21 de agosto de 1994"
3,1,3,152,210,210,420,"21 de agosto de 1994"
3,1,3,153,182,199,381,"21 de agosto de 1994"
3,1,3,154,383,396,779,"21 de agosto de 1994"
3,1,3,155,433,449,882,"21 de agosto de 1994"
3,1,3,156,350,341,691,"21 de agosto de 1994"
3,1,3,157,218,239,457,"21 de agosto de 1994"
3,1,3,158,232,266,498,"21 de agosto de 1994"
3,1,3,159,244,258,502,"21 de agosto de 1994"
3,1,3,160,313,285,598,"21 de agosto de 1994"
3,1,3,161,347,368,715,"21 de agosto de 1994"
3,1,3,162,402,449,851,"21 de agosto de 1994"
3,1,3,163,339,329,668,"21 de agosto de 1994"
3,1,3,164,436,410,846,"21 de agosto de 1994"
3,1,3,165,459,463,922,"21 de agosto de 1994"
3,1,3,166,306,323,629,"21 de agosto de 1994"
3,1,3,167,496,497,993,"21 de agosto de 1994"
3,1,3,168,464,428,892,"21 de agosto de 1994"
3,1,3,169,526,306,832,"21 de agosto de 1994"
3,1,3,170,269,232,501,"21 de agosto de 1994"
3,1,3,171,272,263,535,"21 de agosto de 1994"
3,1,3,172,368,339,707,"21 de agosto de 1994"
3,1,3,173,475,491,966,"21 de agosto de 1994"
3,1,3,174,450,476,926,"21 de agosto de 1994"
3,1,3,175,408,417,825,"21 de agosto de 1994"
3,1,3,176,229,230,459,"21 de agosto de 1994"
3,1,3,177,288,274,562,"21 de agosto de 1994"
3,1,3,178,234,223,457,"21 de agosto de 1994"
3,1,3,179,308,312,620,"21 de agosto de 1994"
3,1,3,180,250,245,495,"21 de agosto de 1994"
3,1,3,181,427,421,848,"21 de agosto de 1994"
3,1,3,182,229,218,447,"21 de agosto de 1994"
3,1,3,183,222,216,438,"21 de agosto de 1994"
3,1,3,184,210,175,385,"21 de agosto de 1994"
3,1,3,185,267,293,560,"21 de agosto de 1994"
3,1,3,186,396,405,801,"21 de agosto de 1994"
3,1,3,187,428,440,868,"21 de agosto de 1994"
3,1,3,188,418,390,808,"21 de agosto de 1994"
3,1,3,189,381,418,799,"21 de agosto de 1994"
3,1,3,190,417,425,842,"21 de agosto de 1994"
3,1,3,191,396,425,821,"21 de agosto de 1994"
3,1,3,192,250,274,524,"21 de agosto de 1994"
3,1,3,193,391,406,797,"21 de agosto de 1994"
3,1,3,194,219,246,465,"21 de agosto de 1994"
3,1,3,195,363,327,690,"21 de agosto de 1994"
3,1,3,196,406,424,830,"21 de agosto de 1994"
3,1,3,197,278,279,557,"21 de agosto de 1994"
3,1,3,198,308,297,605,"21 de agosto de 1994"
3,1,3,199,292,273,565,"21 de agosto de 1994"
3,1,3,200,304,306,610,"21 de agosto de 1994"
3,1,3,201,204,216,420,"21 de agosto de 1994"
3,1,3,202,243,262,505,"21 de agosto de 1994"
3,1,3,203,277,280,557,"21 de agosto de 1994"
3,1,3,204,288,285,573,"21 de agosto de 1994"
3,1,3,205,263,269,532,"21 de agosto de 1994"
3,1,3,206,230,200,430,"21 de agosto de 1994"
3,1,3,207,292,243,535,"21 de agosto de 1994"
3,1,3,208,388,364,752,"21 de agosto de 1994"
3,1,3,209,235,256,491,"21 de agosto de 1994"
3,1,3,210,217,235,452,"21 de agosto de 1994"
3,1,3,211,311,322,633,"21 de agosto de 1994"
3,1,3,212,190,207,397,"21 de agosto de 1994"
3,1,3,213,623,597,1220,"21 de agosto de 1994"
3,1,3,214,283,294,577,"21 de agosto de 1994"
3,1,3,215,296,346,642,"21 de agosto de 1994"
3,1,3,216,187,179,366,"21 de agosto de 1994"
3,1,3,217,230,229,459,"21 de agosto de 1994"
3,1,3,218,193,139,332,"21 de agosto de 1994"
3,1,3,219,289,285,574,"21 de agosto de 1994"
3,1,3,220,412,424,836,"21 de agosto de 1994"
3,1,3,221,264,304,568,"21 de agosto de 1994"
3,1,3,222,253,252,505,"21 de agosto de 1994"
3,1,3,223,441,462,903,"21 de agosto de 1994"
3,1,3,224,219,228,447,"21 de agosto de 1994"
3,1,3,225,250,260,510,"21 de agosto de 1994"
3,1,3,226,251,262,513,"21 de agosto de 1994"
3,1,3,227,397,398,795,"21 de agosto de 1994"
3,1,3,228,222,268,490,"21 de agosto de 1994"
3,1,3,229,262,265,527,"21 de agosto de 1994"
3,1,3,230,249,282,531,"21 de agosto de 1994"
3,1,3,231,148,180,328,"21 de agosto de 1994"
3,1,3,232,276,284,560,"21 de agosto de 1994"
3,1,3,233,205,264,469,"21 de agosto de 1994"
3,1,3,234,314,381,695,"21 de agosto de 1994"
3,1,3,235,281,300,581,"21 de agosto de 1994"
3,1,3,236,148,157,305,"21 de agosto de 1994"
3,1,3,237,271,309,580,"21 de agosto de 1994"
3,1,3,238,260,338,598,"21 de agosto de 1994"
3,1,3,239,260,291,551,"21 de agosto de 1994"
3,1,3,240,173,169,342,"21 de agosto de 1994"
3,1,3,241,115,108,223,"21 de agosto de 1994"
3,1,3,242,250,261,511,"21 de agosto de 1994"
3,1,3,243,316,333,649,"21 de agosto de 1994"
3,1,3,244,370,416,786,"21 de agosto de 1994"
3,1,3,245,239,253,492,"21 de agosto de 1994"
3,1,3,246,449,464,913,"21 de agosto de 1994"
3,1,3,247,377,383,760,"21 de agosto de 1994"
3,1,3,248,173,214,387,"21 de agosto de 1994"
3,1,3,249,214,239,453,"21 de agosto de 1994"
3,1,3,250,478,524,1002,"21 de agosto de 1994"
3,1,3,251,238,244,482,"21 de agosto de 1994"
3,1,3,252,449,451,900,"21 de agosto de 1994"
3,1,3,253,581,581,1162,"21 de agosto de 1994"
3,1,3,254,97,70,167,"21 de agosto de 1994"
3,1,3,255,203,204,407,"21 de agosto de 1994"
3,1,3,256,394,353,747,"21 de agosto de 1994"
3,1,3,257,311,289,600,"21 de agosto de 1994"
3,1,3,258,110,75,185,"21 de agosto de 1994"
3,1,3,259,58,56,114,"21 de agosto de 1994"
3,1,3,260,123,87,210,"21 de agosto de 1994"
3,1,3,261,221,159,380,"21 de agosto de 1994"
3,1,3,262,54,52,106,"21 de agosto de 1994"
3,1,3,263,94,84,178,"21 de agosto de 1994"
3,1,3,264,80,60,140,"21 de agosto de 1994"
3,1,3,265,155,132,287,"21 de agosto de 1994"
3,1,3,266,111,103,214,"21 de agosto de 1994"
3,1,3,267,249,199,448,"21 de agosto de 1994"
3,1,3,268,148,118,266,"21 de agosto de 1994"
3,1,3,269,222,200,422,"21 de agosto de 1994"
3,1,3,270,614,484,1098,"21 de agosto de 1994"
3,1,3,271,254,227,481,"21 de agosto de 1994"
3,1,3,272,131,96,227,"21 de agosto de 1994"
3,1,3,273,65,46,111,"21 de agosto de 1994"
3,1,3,274,92,60,152,"21 de agosto de 1994"
3,1,3,275,37,21,58,"21 de agosto de 1994"
3,1,3,276,180,128,308,"21 de agosto de 1994"
3,1,3,277,144,108,252,"21 de agosto de 1994"
3,1,3,278,231,200,431,"21 de agosto de 1994"
3,1,3,279,41,30,71,"21 de agosto de 1994"
3,1,3,280,416,323,739,"21 de agosto de 1994"
3,1,3,281,312,263,575,"21 de agosto de 1994"
3,1,3,282,338,276,614,"21 de agosto de 1994"
3,1,3,283,363,306,669,"21 de agosto de 1994"
3,1,3,284,45,35,80,"21 de agosto de 1994"
3,1,3,285,28,30,58,"21 de agosto de 1994"
3,1,3,286,38,35,73,"21 de agosto de 1994"
3,1,3,287,48,31,79,"21 de agosto de 1994"
3,1,3,288,183,175,358,"21 de agosto de 1994"
3,1,3,289,122,114,236,"21 de agosto de 1994"
3,1,3,348,84,101,185,"21 de agosto de 1994"
3,1,3,349,105,127,232,"21 de agosto de 1994"
3,1,3,350,73,86,159,"21 de agosto de 1994"
3,1,4,290,204,158,362,"21 de agosto de 1994"
3,1,4,291,552,453,1005,"21 de agosto de 1994"
3,1,4,292,306,254,560,"21 de agosto de 1994"
3,1,4,293,367,350,717,"21 de agosto de 1994"
3,1,4,294,308,272,580,"21 de agosto de 1994"
3,1,4,295,450,356,806,"21 de agosto de 1994"
3,1,4,296,331,267,598,"21 de agosto de 1994"
3,1,4,297,484,366,850,"21 de agosto de 1994"
3,1,4,298,651,487,1138,"21 de agosto de 1994"
3,1,4,299,302,235,537,"21 de agosto de 1994"
3,1,4,300,350,319,669,"21 de agosto de 1994"
3,1,4,301,499,407,906,"21 de agosto de 1994"
3,1,4,302,423,425,848,"21 de agosto de 1994"
3,1,4,303,140,120,260,"21 de agosto de 1994"
3,1,4,304,412,344,756,"21 de agosto de 1994"
3,1,4,305,219,164,383,"21 de agosto de 1994"
3,1,4,306,477,365,842,"21 de agosto de 1994"
3,1,4,307,131,92,223,"21 de agosto de 1994"
3,1,4,308,562,439,1001,"21 de agosto de 1994"
3,1,4,309,209,137,346,"21 de agosto de 1994"
3,1,4,310,228,185,413,"21 de agosto de 1994"
3,1,4,311,216,184,400,"21 de agosto de 1994"
3,1,4,312,392,347,739,"21 de agosto de 1994"
3,1,4,313,315,287,602,"21 de agosto de 1994"
3,1,4,314,419,376,795,"21 de agosto de 1994"
3,1,4,315,174,138,312,"21 de agosto de 1994"
3,1,4,316,354,253,607,"21 de agosto de 1994"
3,1,4,317,587,384,971,"21 de agosto de 1994"
3,1,4,318,373,331,704,"21 de agosto de 1994"
3,1,4,319,148,132,280,"21 de agosto de 1994"
3,1,4,320,477,367,844,"21 de agosto de 1994"
3,1,4,321,316,242,558,"21 de agosto de 1994"
3,1,4,322,282,253,535,"21 de agosto de 1994"
3,1,4,323,387,331,718,"21 de agosto de 1994"
3,1,4,324,672,476,1148,"21 de agosto de 1994"
3,1,4,325,486,333,819,"21 de agosto de 1994"
3,1,4,326,290,209,499,"21 de agosto de 1994"
3,1,4,327,360,321,681,"21 de agosto de 1994"
3,1,4,328,358,312,670,"21 de agosto de 1994"
3,1,4,329,243,208,451,"21 de agosto de 1994"
3,1,4,330,269,206,475,"21 de agosto de 1994"
3,1,4,331,325,368,693,"21 de agosto de 1994"
3,1,4,332,379,282,661,"21 de agosto de 1994"
3,1,4,333,253,190,443,"21 de agosto de 1994"
3,1,4,334,98,73,171,"21 de agosto de 1994"
3,1,4,335,59,57,116,"21 de agosto de 1994"
3,1,4,336,21,27,48,"21 de agosto de 1994"
3,1,4,351,24,18,42,"21 de agosto de 1994"
3,1,4,352,63,73,136,"21 de agosto de 1994"
3,2,1,1,289,305,594,"21 de agosto de 1994"
3,2,1,2,145,125,270,"21 de agosto de 1994"
3,2,1,3,224,222,446,"21 de agosto de 1994"
3,2,1,4,294,328,622,"21 de agosto de 1994"
3,2,1,5,305,362,667,"21 de agosto de 1994"
3,2,1,6,455,71,526,"21 de agosto de 1994"
3,2,1,7,270,290,560,"21 de agosto de 1994"
3,2,1,8,256,255,511,"21 de agosto de 1994"
3,2,1,9,204,250,454,"21 de agosto de 1994"
3,2,1,10,317,352,669,"21 de agosto de 1994"
3,2,1,11,202,198,400,"21 de agosto de 1994"
3,2,1,12,157,169,326,"21 de agosto de 1994"
3,2,1,13,200,221,421,"21 de agosto de 1994"
3,2,1,14,205,241,446,"21 de agosto de 1994"
3,2,1,15,288,295,583,"21 de agosto de 1994"
3,2,1,16,274,289,563,"21 de agosto de 1994"
3,2,1,17,158,188,346,"21 de agosto de 1994"
3,2,1,18,330,345,675,"21 de agosto de 1994"
3,2,1,19,188,206,394,"21 de agosto de 1994"
3,2,1,20,275,284,559,"21 de agosto de 1994"
3,2,1,21,329,354,683,"21 de agosto de 1994"
3,2,1,22,290,335,625,"21 de agosto de 1994"
3,2,1,23,373,375,748,"21 de agosto de 1994"
3,2,1,24,216,222,438,"21 de agosto de 1994"
3,2,1,25,354,363,717,"21 de agosto de 1994"
3,2,1,26,380,382,762,"21 de agosto de 1994"
3,2,1,27,241,235,476,"21 de agosto de 1994"
3,2,1,28,439,458,897,"21 de agosto de 1994"
3,2,1,29,311,351,662,"21 de agosto de 1994"
3,2,1,30,382,419,801,"21 de agosto de 1994"
3,2,1,31,344,366,710,"21 de agosto de 1994"
3,2,1,32,284,294,578,"21 de agosto de 1994"
3,2,1,33,196,171,367,"21 de agosto de 1994"
3,2,1,34,195,214,409,"21 de agosto de 1994"
3,2,1,35,185,80,265,"21 de agosto de 1994"
3,2,1,36,141,113,254,"21 de agosto de 1994"
3,2,1,37,112,94,206,"21 de agosto de 1994"
3,2,1,38,83,87,170,"21 de agosto de 1994"
3,2,1,39,90,63,153,"21 de agosto de 1994"
3,2,1,40,296,306,602,"21 de agosto de 1994"
3,2,1,41,344,363,707,"21 de agosto de 1994"
3,2,1,42,289,285,574,"21 de agosto de 1994"
3,2,1,43,271,245,516,"21 de agosto de 1994"
3,2,1,44,335,359,694,"21 de agosto de 1994"
3,2,1,45,266,277,543,"21 de agosto de 1994"
3,2,1,46,277,282,559,"21 de agosto de 1994"
3,2,1,47,245,247,492,"21 de agosto de 1994"
3,2,1,48,395,366,761,"21 de agosto de 1994"
3,2,1,49,53,36,89,"21 de agosto de 1994"
3,2,1,50,101,81,182,"21 de agosto de 1994"
3,2,1,51,126,110,236,"21 de agosto de 1994"
3,2,1,52,173,152,325,"21 de agosto de 1994"
3,2,1,53,149,137,286,"21 de agosto de 1994"
3,2,1,54,366,316,682,"21 de agosto de 1994"
3,2,1,55,184,138,322,"21 de agosto de 1994"
3,2,1,56,124,118,242,"21 de agosto de 1994"
3,2,1,57,283,254,537,"21 de agosto de 1994"
3,2,1,58,288,248,536,"21 de agosto de 1994"
3,2,1,59,311,279,590,"21 de agosto de 1994"
3,2,1,60,301,239,540,"21 de agosto de 1994"
3,2,1,61,340,279,619,"21 de agosto de 1994"
3,2,1,62,76,61,137,"21 de agosto de 1994"
3,2,1,63,72,56,128,"21 de agosto de 1994"
3,2,1,64,72,41,113,"21 de agosto de 1994"
3,2,1,65,44,33,77,"21 de agosto de 1994"
3,2,1,66,70,54,124,"21 de agosto de 1994"
3,2,1,67,239,218,457,"21 de agosto de 1994"
3,2,1,68,147,148,295,"21 de agosto de 1994"
3,2,1,69,114,91,205,"21 de agosto de 1994"
3,2,1,70,103,77,180,"21 de agosto de 1994"
3,2,1,71,82,72,154,"21 de agosto de 1994"
3,2,1,72,208,161,369,"21 de agosto de 1994"
3,2,1,73,254,199,453,"21 de agosto de 1994"
3,2,1,74,41,36,77,"21 de agosto de 1994"
3,2,2,75,170,154,324,"21 de agosto de 1994"
3,2,2,76,452,424,876,"21 de agosto de 1994"
3,2,2,77,231,221,452,"21 de agosto de 1994"
3,2,2,78,380,326,706,"21 de agosto de 1994"
3,2,2,79,270,288,558,"21 de agosto de 1994"
3,2,2,80,456,404,860,"21 de agosto de 1994"
3,2,2,81,238,222,460,"21 de agosto de 1994"
3,2,2,82,396,377,773,"21 de agosto de 1994"
3,2,2,83,484,471,955,"21 de agosto de 1994"
3,2,2,84,172,167,339,"21 de agosto de 1994"
3,2,2,85,276,227,503,"21 de agosto de 1994"
3,2,2,86,67,51,118,"21 de agosto de 1994"
3,2,2,87,154,116,270,"21 de agosto de 1994"
3,2,2,88,336,275,611,"21 de agosto de 1994"
3,2,2,89,286,263,549,"21 de agosto de 1994"
3,2,2,90,263,257,520,"21 de agosto de 1994"
3,2,2,91,96,93,189,"21 de agosto de 1994"
3,2,2,92,256,228,484,"21 de agosto de 1994"
3,2,2,93,278,271,549,"21 de agosto de 1994"
3,2,2,94,458,436,894,"21 de agosto de 1994"
3,2,2,95,458,427,885,"21 de agosto de 1994"
3,2,2,96,308,298,606,"21 de agosto de 1994"
3,2,2,97,338,344,682,"21 de agosto de 1994"
3,2,2,98,364,363,727,"21 de agosto de 1994"
3,2,2,99,89,98,187,"21 de agosto de 1994"
3,2,2,100,31,25,56,"21 de agosto de 1994"
3,2,2,101,213,142,355,"21 de agosto de 1994"
3,2,2,102,182,111,293,"21 de agosto de 1994"
3,2,2,103,359,301,660,"21 de agosto de 1994"
3,2,2,104,482,404,886,"21 de agosto de 1994"
3,2,2,105,115,74,189,"21 de agosto de 1994"
3,2,2,106,50,43,93,"21 de agosto de 1994"
3,2,2,107,254,240,494,"21 de agosto de 1994"
3,2,2,108,309,274,583,"21 de agosto de 1994"
3,2,2,109,322,264,586,"21 de agosto de 1994"
3,2,2,110,69,55,124,"21 de agosto de 1994"
3,2,2,111,83,59,142,"21 de agosto de 1994"
3,2,2,112,247,221,468,"21 de agosto de 1994"
3,2,2,113,197,156,353,"21 de agosto de 1994"
3,2,2,114,287,261,548,"21 de agosto de 1994"
3,2,2,115,86,74,160,"21 de agosto de 1994"
3,2,2,116,404,335,739,"21 de agosto de 1994"
3,2,2,117,137,129,266,"21 de agosto de 1994"
3,2,2,118,143,96,239,"21 de agosto de 1994"
3,2,2,119,97,48,145,"21 de agosto de 1994"
3,2,2,120,247,204,451,"21 de agosto de 1994"
3,2,5,337,22,38,60,"21 de agosto de 1994"
3,2,5,338,343,305,648,"21 de agosto de 1994"
3,2,5,339,399,402,801,"21 de agosto de 1994"
3,2,5,340,401,409,810,"21 de agosto de 1994"
3,2,5,341,359,373,732,"21 de agosto de 1994"
3,2,5,342,355,326,681,"21 de agosto de 1994"
3,2,5,343,104,104,208,"21 de agosto de 1994"
3,2,5,344,380,326,706,"21 de agosto de 1994"
3,2,5,345,113,88,201,"21 de agosto de 1994"
3,2,5,346,121,91,212,"21 de agosto de 1994"
3,2,5,347,76,66,142,"21 de agosto de 1994"
4,1,3,183,165,168,333,"21 de agosto de 1994"
4,1,3,184,525,524,1049,"21 de agosto de 1994"
4,1,3,185,353,339,692,"21 de agosto de 1994"
4,1,3,186,306,280,586,"21 de agosto de 1994"
4,1,3,187,479,442,921,"21 de agosto de 1994"
4,1,3,188,331,349,680,"21 de agosto de 1994"
4,1,3,189,429,431,860,"21 de agosto de 1994"
4,1,3,190,366,377,743,"21 de agosto de 1994"
4,1,3,191,313,315,628,"21 de agosto de 1994"
4,1,3,192,338,319,657,"21 de agosto de 1994"
4,1,3,193,202,208,410,"21 de agosto de 1994"
4,1,3,194,322,339,661,"21 de agosto de 1994"
4,1,3,195,385,370,755,"21 de agosto de 1994"
4,1,3,196,451,425,876,"21 de agosto de 1994"
4,1,3,197,343,353,696,"21 de agosto de 1994"
4,1,3,198,136,9,145,"21 de agosto de 1994"
4,1,3,199,622,604,1226,"21 de agosto de 1994"
4,1,3,200,375,386,761,"21 de agosto de 1994"
4,1,3,201,309,301,610,"21 de agosto de 1994"
4,1,3,202,585,605,1190,"21 de agosto de 1994"
4,1,3,203,438,419,857,"21 de agosto de 1994"
4,1,3,204,222,246,468,"21 de agosto de 1994"
4,1,3,205,585,606,1191,"21 de agosto de 1994"
4,1,3,206,350,399,749,"21 de agosto de 1994"
4,1,3,207,289,302,591,"21 de agosto de 1994"
4,1,3,208,459,491,950,"21 de agosto de 1994"
4,1,3,209,520,547,1067,"21 de agosto de 1994"
4,1,3,210,591,548,1139,"21 de agosto de 1994"
4,1,3,211,547,611,1158,"21 de agosto de 1994"
4,1,3,212,316,336,652,"21 de agosto de 1994"
4,1,3,213,384,417,801,"21 de agosto de 1994"
4,1,3,214,508,481,989,"21 de agosto de 1994"
4,1,3,215,166,166,332,"21 de agosto de 1994"
4,1,3,216,399,393,792,"21 de agosto de 1994"
4,1,3,217,446,474,920,"21 de agosto de 1994"
4,1,3,218,539,506,1045,"21 de agosto de 1994"
4,1,3,219,198,224,422,"21 de agosto de 1994"
4,1,3,220,293,301,594,"21 de agosto de 1994"
4,1,3,221,295,325,620,"21 de agosto de 1994"
4,1,3,222,255,263,518,"21 de agosto de 1994"
4,1,3,223,302,297,599,"21 de agosto de 1994"
4,1,3,224,439,486,925,"21 de agosto de 1994"
4,1,3,225,432,410,842,"21 de agosto de 1994"
4,1,3,226,396,361,757,"21 de agosto de 1994"
4,1,3,227,514,472,986,"21 de agosto de 1994"
4,1,3,228,332,326,658,"21 de agosto de 1994"
4,1,3,229,373,368,741,"21 de agosto de 1994"
4,1,3,230,1128,1209,2337,"21 de agosto de 1994"
4,1,3,231,241,228,469,"21 de agosto de 1994"
4,1,3,232,560,503,1063,"21 de agosto de 1994"
4,1,3,233,559,548,1107,"21 de agosto de 1994"
4,1,3,234,519,510,1029,"21 de agosto de 1994"
4,1,3,235,366,389,755,"21 de agosto de 1994"
4,1,3,236,299,283,582,"21 de agosto de 1994"
4,1,3,237,423,435,858,"21 de agosto de 1994"
4,1,3,238,272,20,292,"21 de agosto de 1994"
4,1,3,239,343,331,674,"21 de agosto de 1994"
4,1,3,240,314,336,650,"21 de agosto de 1994"
4,1,3,241,374,393,767,"21 de agosto de 1994"
4,1,3,242,362,362,724,"21 de agosto de 1994"
4,1,3,243,394,390,784,"21 de agosto de 1994"
4,1,3,244,1039,1029,2068,"21 de agosto de 1994"
4,1,3,245,337,396,733,"21 de agosto de 1994"
4,1,3,246,378,348,726,"21 de agosto de 1994"
4,1,3,247,284,264,548,"21 de agosto de 1994"
4,1,3,248,365,350,715,"21 de agosto de 1994"
4,1,3,249,352,359,711,"21 de agosto de 1994"
4,1,3,250,455,370,825,"21 de agosto de 1994"
4,1,3,251,340,295,635,"21 de agosto de 1994"
4,1,3,252,308,297,605,"21 de agosto de 1994"
4,1,3,253,425,371,796,"21 de agosto de 1994"
4,1,3,254,187,128,315,"21 de agosto de 1994"
4,1,3,255,143,118,261,"21 de agosto de 1994"
4,1,3,256,354,330,684,"21 de agosto de 1994"
4,1,3,257,399,366,765,"21 de agosto de 1994"
4,1,3,258,406,319,725,"21 de agosto de 1994"
4,1,3,259,387,292,679,"21 de agosto de 1994"
4,1,3,260,170,141,311,"21 de agosto de 1994"
4,1,3,261,333,247,580,"21 de agosto de 1994"
4,1,3,262,425,336,761,"21 de agosto de 1994"
4,1,3,263,218,175,393,"21 de agosto de 1994"
4,1,3,264,132,101,233,"21 de agosto de 1994"
4,1,3,265,404,345,749,"21 de agosto de 1994"
4,1,3,266,376,328,704,"21 de agosto de 1994"
4,1,3,267,641,549,1190,"21 de agosto de 1994"
4,1,3,268,481,338,819,"21 de agosto de 1994"
4,1,3,269,103,87,190,"21 de agosto de 1994"
4,1,3,270,63,39,102,"21 de agosto de 1994"
4,1,3,271,174,134,308,"21 de agosto de 1994"
4,1,3,272,51,35,86,"21 de agosto de 1994"
4,1,3,273,450,311,761,"21 de agosto de 1994"
4,1,3,274,405,366,771,"21 de agosto de 1994"
4,1,3,275,183,146,329,"21 de agosto de 1994"
4,1,3,276,124,94,218,"21 de agosto de 1994"
4,1,3,277,421,339,760,"21 de agosto de 1994"
4,1,3,278,652,390,1042,"21 de agosto de 1994"
4,1,3,279,390,333,723,"21 de agosto de 1994"
4,1,3,280,347,362,709,"21 de agosto de 1994"
4,1,3,281,474,460,934,"21 de agosto de 1994"
4,1,3,282,304,279,583,"21 de agosto de 1994"
4,1,3,283,307,305,612,"21 de agosto de 1994"
4,1,3,284,114,80,194,"21 de agosto de 1994"
4,1,3,285,293,239,532,"21 de agosto de 1994"
4,1,3,286,70,56,126,"21 de agosto de 1994"
4,1,3,287,130,107,237,"21 de agosto de 1994"
4,1,3,288,149,122,271,"21 de agosto de 1994"
4,1,3,289,328,218,546,"21 de agosto de 1994"
4,1,3,290,43,23,66,"21 de agosto de 1994"
4,1,3,291,430,354,784,"21 de agosto de 1994"
4,1,3,292,202,149,351,"21 de agosto de 1994"
4,1,3,293,381,331,712,"21 de agosto de 1994"
4,1,3,294,56,39,95,"21 de agosto de 1994"
4,1,3,295,206,104,310,"21 de agosto de 1994"
4,1,3,296,195,179,374,"21 de agosto de 1994"
4,1,3,297,151,114,265,"21 de agosto de 1994"
4,1,3,298,349,272,621,"21 de agosto de 1994"
4,1,3,299,342,281,623,"21 de agosto de 1994"
4,1,3,300,133,84,217,"21 de agosto de 1994"
4,1,3,301,135,66,201,"21 de agosto de 1994"
4,1,3,302,91,83,174,"21 de agosto de 1994"
4,1,4,303,322,193,515,"21 de agosto de 1994"
4,1,4,304,358,346,704,"21 de agosto de 1994"
4,1,4,305,323,341,664,"21 de agosto de 1994"
4,1,4,306,295,300,595,"21 de agosto de 1994"
4,1,4,307,314,301,615,"21 de agosto de 1994"
4,1,4,308,202,167,369,"21 de agosto de 1994"
4,1,4,309,364,322,686,"21 de agosto de 1994"
4,1,4,310,301,270,571,"21 de agosto de 1994"
4,1,4,311,297,257,554,"21 de agosto de 1994"
4,1,4,312,254,258,512,"21 de agosto de 1994"
4,1,4,313,321,300,621,"21 de agosto de 1994"
4,1,4,314,373,365,738,"21 de agosto de 1994"
4,1,4,315,363,325,688,"21 de agosto de 1994"
4,1,4,316,315,315,630,"21 de agosto de 1994"
4,1,4,317,304,326,630,"21 de agosto de 1994"
4,1,4,318,319,322,641,"21 de agosto de 1994"
4,1,4,319,458,426,884,"21 de agosto de 1994"
4,1,4,320,333,270,603,"21 de agosto de 1994"
4,1,4,321,298,286,584,"21 de agosto de 1994"
4,1,4,322,277,266,543,"21 de agosto de 1994"
4,1,4,323,367,326,693,"21 de agosto de 1994"
4,1,4,324,345,320,665,"21 de agosto de 1994"
4,1,4,325,276,250,526,"21 de agosto de 1994"
4,1,4,326,216,176,392,"21 de agosto de 1994"
4,1,4,327,363,353,716,"21 de agosto de 1994"
4,1,4,328,313,306,619,"21 de agosto de 1994"
4,1,4,329,278,213,491,"21 de agosto de 1994"
4,1,4,330,312,288,600,"21 de agosto de 1994"
4,1,4,331,345,330,675,"21 de agosto de 1994"
4,1,4,332,212,200,412,"21 de agosto de 1994"
4,1,4,333,475,333,808,"21 de agosto de 1994"
4,1,4,334,341,268,609,"21 de agosto de 1994"
4,1,4,335,214,225,439,"21 de agosto de 1994"
4,1,4,336,299,221,520,"21 de agosto de 1994"
4,1,4,337,181,188,369,"21 de agosto de 1994"
4,1,4,338,92,76,168,"21 de agosto de 1994"
4,1,4,339,315,230,545,"21 de agosto de 1994"
4,1,4,340,435,324,759,"21 de agosto de 1994"
4,1,4,341,371,326,697,"21 de agosto de 1994"
4,1,4,342,457,378,835,"21 de agosto de 1994"
4,1,4,343,287,244,531,"21 de agosto de 1994"
4,1,4,344,270,231,501,"21 de agosto de 1994"
4,1,4,345,256,195,451,"21 de agosto de 1994"
4,1,4,346,348,319,667,"21 de agosto de 1994"
4,1,4,347,385,293,678,"21 de agosto de 1994"
4,1,4,348,266,202,468,"21 de agosto de 1994"
4,1,4,349,293,234,527,"21 de agosto de 1994"
4,1,4,350,358,306,664,"21 de agosto de 1994"
4,1,4,351,102,77,179,"21 de agosto de 1994"
4,1,4,352,153,120,273,"21 de agosto de 1994"
4,1,4,353,112,79,191,"21 de agosto de 1994"
4,1,4,354,197,141,338,"21 de agosto de 1994"
4,1,4,355,79,59,138,"21 de agosto de 1994"
4,1,4,356,478,377,855,"21 de agosto de 1994"
4,1,4,357,171,134,305,"21 de agosto de 1994"
4,1,4,358,120,111,231,"21 de agosto de 1994"
4,1,4,359,263,198,461,"21 de agosto de 1994"
4,1,4,360,368,289,657,"21 de agosto de 1994"
4,1,4,361,432,336,768,"21 de agosto de 1994"
4,1,4,362,115,81,196,"21 de agosto de 1994"
4,1,7,428,417,398,815,"21 de agosto de 1994"
4,1,7,429,574,558,1132,"21 de agosto de 1994"
4,1,7,430,132,129,261,"21 de agosto de 1994"
4,1,7,431,221,197,418,"21 de agosto de 1994"
4,1,7,432,142,116,258,"21 de agosto de 1994"
4,1,7,433,164,137,301,"21 de agosto de 1994"
4,1,7,434,32,23,55,"21 de agosto de 1994"
4,1,7,435,172,149,321,"21 de agosto de 1994"
4,1,7,436,31,27,58,"21 de agosto de 1994"
4,1,7,437,38,30,68,"21 de agosto de 1994"
4,1,7,438,28,15,43,"21 de agosto de 1994"
4,1,7,439,114,89,203,"21 de agosto de 1994"
4,1,9,448,431,402,833,"21 de agosto de 1994"
4,1,9,449,408,402,810,"21 de agosto de 1994"
4,1,9,450,392,369,761,"21 de agosto de 1994"
4,1,9,451,386,364,750,"21 de agosto de 1994"
4,1,9,452,324,339,663,"21 de agosto de 1994"
4,1,9,453,376,362,738,"21 de agosto de 1994"
4,1,9,454,338,356,694,"21 de agosto de 1994"
4,1,9,455,848,340,1188,"21 de agosto de 1994"
4,1,9,456,240,277,517,"21 de agosto de 1994"
4,1,9,457,273,282,555,"21 de agosto de 1994"
4,1,9,458,315,357,672,"21 de agosto de 1994"
4,1,9,459,283,274,557,"21 de agosto de 1994"
4,1,9,460,324,312,636,"21 de agosto de 1994"
4,1,9,461,350,343,693,"21 de agosto de 1994"
4,1,9,462,319,324,643,"21 de agosto de 1994"
4,1,9,463,314,325,639,"21 de agosto de 1994"
4,1,9,464,376,363,739,"21 de agosto de 1994"
4,1,9,465,126,91,217,"21 de agosto de 1994"
4,1,9,466,140,91,231,"21 de agosto de 1994"
4,1,9,467,199,154,353,"21 de agosto de 1994"
4,1,9,468,483,388,871,"21 de agosto de 1994"
4,1,9,469,193,141,334,"21 de agosto de 1994"
4,1,9,470,328,267,595,"21 de agosto de 1994"
4,1,9,471,326,232,558,"21 de agosto de 1994"
4,1,9,472,318,284,602,"21 de agosto de 1994"
4,1,9,473,344,300,644,"21 de agosto de 1994"
4,1,9,474,69,52,121,"21 de agosto de 1994"
4,1,9,475,294,276,570,"21 de agosto de 1994"
4,1,9,476,241,260,501,"21 de agosto de 1994"
4,1,9,477,302,283,585,"21 de agosto de 1994"
4,1,9,478,378,316,694,"21 de agosto de 1994"
4,1,9,479,204,164,368,"21 de agosto de 1994"
4,1,9,480,309,249,558,"21 de agosto de 1994"
4,1,9,481,419,356,775,"21 de agosto de 1994"
4,1,9,482,208,148,356,"21 de agosto de 1994"
4,1,9,483,115,85,200,"21 de agosto de 1994"
4,1,9,484,435,333,768,"21 de agosto de 1994"
4,1,9,485,312,270,582,"21 de agosto de 1994"
4,1,9,486,377,333,710,"21 de agosto de 1994"
4,1,9,487,282,212,494,"21 de agosto de 1994"
4,1,9,488,207,145,352,"21 de agosto de 1994"
4,1,9,489,213,251,464,"21 de agosto de 1994"
4,2,1,1,191,207,398,"21 de agosto de 1994"
4,2,1,2,269,300,569,"21 de agosto de 1994"
4,2,1,3,246,276,522,"21 de agosto de 1994"
4,2,1,4,231,243,474,"21 de agosto de 1994"
4,2,1,5,315,380,695,"21 de agosto de 1994"
4,2,1,6,218,256,474,"21 de agosto de 1994"
4,2,1,7,270,286,556,"21 de agosto de 1994"
4,2,1,8,253,295,548,"21 de agosto de 1994"
4,2,1,9,429,451,880,"21 de agosto de 1994"
4,2,1,10,403,429,832,"21 de agosto de 1994"
4,2,1,11,327,319,646,"21 de agosto de 1994"
4,2,1,12,570,641,1211,"21 de agosto de 1994"
4,2,1,13,405,459,864,"21 de agosto de 1994"
4,2,1,14,315,385,700,"21 de agosto de 1994"
4,2,1,15,257,315,572,"21 de agosto de 1994"
4,2,1,16,227,247,474,"21 de agosto de 1994"
4,2,1,17,217,241,458,"21 de agosto de 1994"
4,2,1,18,210,235,445,"21 de agosto de 1994"
4,2,1,19,240,259,499,"21 de agosto de 1994"
4,2,1,20,305,334,639,"21 de agosto de 1994"
4,2,1,21,294,324,618,"21 de agosto de 1994"
4,2,1,22,351,398,749,"21 de agosto de 1994"
4,2,1,23,284,347,631,"21 de agosto de 1994"
4,2,1,24,463,502,965,"21 de agosto de 1994"
4,2,1,25,300,344,644,"21 de agosto de 1994"
4,2,1,26,515,553,1068,"21 de agosto de 1994"
4,2,1,27,466,641,1107,"21 de agosto de 1994"
4,2,1,28,386,402,788,"21 de agosto de 1994"
4,2,1,29,428,498,926,"21 de agosto de 1994"
4,2,1,30,338,378,716,"21 de agosto de 1994"
4,2,1,31,335,367,702,"21 de agosto de 1994"
4,2,1,32,414,433,847,"21 de agosto de 1994"
4,2,1,33,362,396,758,"21 de agosto de 1994"
4,2,1,34,414,428,842,"21 de agosto de 1994"
4,2,1,35,287,303,590,"21 de agosto de 1994"
4,2,1,36,418,388,806,"21 de agosto de 1994"
4,2,1,37,229,251,480,"21 de agosto de 1994"
4,2,1,38,214,235,449,"21 de agosto de 1994"
4,2,1,39,426,496,922,"21 de agosto de 1994"
4,2,1,40,275,348,623,"21 de agosto de 1994"
4,2,1,41,330,336,666,"21 de agosto de 1994"
4,2,1,42,477,492,969,"21 de agosto de 1994"
4,2,1,43,427,429,856,"21 de agosto de 1994"
4,2,1,44,374,384,758,"21 de agosto de 1994"
4,2,1,45,383,416,799,"21 de agosto de 1994"
4,2,1,46,405,459,864,"21 de agosto de 1994"
4,2,1,47,389,425,814,"21 de agosto de 1994"
4,2,1,48,459,513,972,"21 de agosto de 1994"
4,2,1,49,510,570,1080,"21 de agosto de 1994"
4,2,1,50,490,542,1032,"21 de agosto de 1994"
4,2,1,51,558,575,1133,"21 de agosto de 1994"
4,2,1,52,378,429,807,"21 de agosto de 1994"
4,2,1,53,509,551,1060,"21 de agosto de 1994"
4,2,1,54,416,461,877,"21 de agosto de 1994"
4,2,1,55,611,651,1262,"21 de agosto de 1994"
4,2,1,56,414,471,885,"21 de agosto de 1994"
4,2,1,57,359,421,780,"21 de agosto de 1994"
4,2,1,58,454,556,1010,"21 de agosto de 1994"
4,2,1,59,453,485,938,"21 de agosto de 1994"
4,2,1,60,412,408,820,"21 de agosto de 1994"
4,2,1,61,354,411,765,"21 de agosto de 1994"
4,2,1,62,367,365,732,"21 de agosto de 1994"
4,2,1,63,407,464,871,"21 de agosto de 1994"
4,2,1,64,409,463,872,"21 de agosto de 1994"
4,2,1,65,494,521,1015,"21 de agosto de 1994"
4,2,1,66,397,404,801,"21 de agosto de 1994"
4,2,1,67,436,432,868,"21 de agosto de 1994"
4,2,1,68,327,369,696,"21 de agosto de 1994"
4,2,1,69,341,371,712,"21 de agosto de 1994"
4,2,1,70,396,427,823,"21 de agosto de 1994"
4,2,1,71,386,436,822,"21 de agosto de 1994"
4,2,1,72,489,571,1060,"21 de agosto de 1994"
4,2,1,73,722,371,1093,"21 de agosto de 1994"
4,2,1,74,620,702,1322,"21 de agosto de 1994"
4,2,1,75,457,488,945,"21 de agosto de 1994"
4,2,1,76,369,468,837,"21 de agosto de 1994"
4,2,1,77,324,383,707,"21 de agosto de 1994"
4,2,1,78,379,399,778,"21 de agosto de 1994"
4,2,1,79,426,406,832,"21 de agosto de 1994"
4,2,1,80,331,343,674,"21 de agosto de 1994"
4,2,1,81,586,741,1327,"21 de agosto de 1994"
4,2,1,82,331,406,737,"21 de agosto de 1994"
4,2,1,83,415,469,884,"21 de agosto de 1994"
4,2,1,84,254,279,533,"21 de agosto de 1994"
4,2,1,85,394,383,777,"21 de agosto de 1994"
4,2,1,86,357,462,819,"21 de agosto de 1994"
4,2,1,87,357,384,741,"21 de agosto de 1994"
4,2,1,88,259,312,571,"21 de agosto de 1994"
4,2,1,89,424,455,879,"21 de agosto de 1994"
4,2,1,90,473,509,982,"21 de agosto de 1994"
4,2,1,91,381,404,785,"21 de agosto de 1994"
4,2,1,92,239,255,494,"21 de agosto de 1994"
4,2,1,93,247,286,533,"21 de agosto de 1994"
4,2,1,94,356,368,724,"21 de agosto de 1994"
4,2,1,95,277,292,569,"21 de agosto de 1994"
4,2,1,96,369,410,779,"21 de agosto de 1994"
4,2,1,97,364,378,742,"21 de agosto de 1994"
4,2,1,98,272,320,592,"21 de agosto de 1994"
4,2,1,99,398,402,800,"21 de agosto de 1994"
4,2,1,100,579,606,1185,"21 de agosto de 1994"
4,2,1,101,585,594,1179,"21 de agosto de 1994"
4,2,1,102,340,391,731,"21 de agosto de 1994"
4,2,1,103,361,422,783,"21 de agosto de 1994"
4,2,1,104,268,318,586,"21 de agosto de 1994"
4,2,1,105,300,336,636,"21 de agosto de 1994"
4,2,1,106,272,296,568,"21 de agosto de 1994"
4,2,1,107,375,399,774,"21 de agosto de 1994"
4,2,1,108,413,470,883,"21 de agosto de 1994"
4,2,1,109,389,434,823,"21 de agosto de 1994"
4,2,1,110,385,316,701,"21 de agosto de 1994"
4,2,1,111,434,411,845,"21 de agosto de 1994"
4,2,1,112,386,439,825,"21 de agosto de 1994"
4,2,1,113,373,410,783,"21 de agosto de 1994"
4,2,1,114,406,373,779,"21 de agosto de 1994"
4,2,1,115,291,300,591,"21 de agosto de 1994"
4,2,1,116,335,347,682,"21 de agosto de 1994"
4,2,1,117,277,296,573,"21 de agosto de 1994"
4,2,1,118,248,224,472,"21 de agosto de 1994"
4,2,1,119,90,63,153,"21 de agosto de 1994"
4,2,1,120,162,137,299,"21 de agosto de 1994"
4,2,1,121,158,141,299,"21 de agosto de 1994"
4,2,1,122,241,195,436,"21 de agosto de 1994"
4,2,1,123,181,156,337,"21 de agosto de 1994"
4,2,1,124,292,242,534,"21 de agosto de 1994"
4,2,1,125,339,343,682,"21 de agosto de 1994"
4,2,1,126,451,433,884,"21 de agosto de 1994"
4,2,1,127,230,199,429,"21 de agosto de 1994"
4,2,1,128,46,41,87,"21 de agosto de 1994"
4,2,1,129,383,303,686,"21 de agosto de 1994"
4,2,1,130,115,87,202,"21 de agosto de 1994"
4,2,1,131,50,41,91,"21 de agosto de 1994"
4,2,1,132,50,38,88,"21 de agosto de 1994"
4,2,1,133,143,110,253,"21 de agosto de 1994"
4,2,1,134,81,52,133,"21 de agosto de 1994"
4,2,1,135,163,134,297,"21 de agosto de 1994"
4,2,1,136,56,42,98,"21 de agosto de 1994"
4,2,1,137,40,25,65,"21 de agosto de 1994"
4,2,1,138,127,87,214,"21 de agosto de 1994"
4,2,1,139,147,117,264,"21 de agosto de 1994"
4,2,1,140,322,310,632,"21 de agosto de 1994"
4,2,1,141,314,290,604,"21 de agosto de 1994"
4,2,1,142,437,363,800,"21 de agosto de 1994"
4,2,1,143,101,82,183,"21 de agosto de 1994"
4,2,1,144,51,38,89,"21 de agosto de 1994"
4,2,1,145,257,201,458,"21 de agosto de 1994"
4,2,1,146,102,72,174,"21 de agosto de 1994"
4,2,2,147,334,345,679,"21 de agosto de 1994"
4,2,2,148,321,341,662,"21 de agosto de 1994"
4,2,2,149,351,350,701,"21 de agosto de 1994"
4,2,2,150,286,326,612,"21 de agosto de 1994"
4,2,2,151,250,273,523,"21 de agosto de 1994"
4,2,2,152,351,338,689,"21 de agosto de 1994"
4,2,2,153,347,357,704,"21 de agosto de 1994"
4,2,2,154,413,407,820,"21 de agosto de 1994"
4,2,2,155,383,394,777,"21 de agosto de 1994"
4,2,2,156,190,192,382,"21 de agosto de 1994"
4,2,2,157,191,149,340,"21 de agosto de 1994"
4,2,2,158,231,208,439,"21 de agosto de 1994"
4,2,2,159,241,256,497,"21 de agosto de 1994"
4,2,2,160,255,311,566,"21 de agosto de 1994"
4,2,2,161,292,301,593,"21 de agosto de 1994"
4,2,2,162,236,240,476,"21 de agosto de 1994"
4,2,2,163,245,237,482,"21 de agosto de 1994"
4,2,2,164,283,287,570,"21 de agosto de 1994"
4,2,2,165,66,61,127,"21 de agosto de 1994"
4,2,2,166,500,477,977,"21 de agosto de 1994"
4,2,2,167,346,304,650,"21 de agosto de 1994"
4,2,2,168,359,310,669,"21 de agosto de 1994"
4,2,2,169,371,395,766,"21 de agosto de 1994"
4,2,2,170,262,227,489,"21 de agosto de 1994"
4,2,2,171,170,176,346,"21 de agosto de 1994"
4,2,2,172,285,294,579,"21 de agosto de 1994"
4,2,2,173,428,375,803,"21 de agosto de 1994"
4,2,2,174,342,323,665,"21 de agosto de 1994"
4,2,2,175,512,454,966,"21 de agosto de 1994"
4,2,2,176,476,428,904,"21 de agosto de 1994"
4,2,2,177,434,390,824,"21 de agosto de 1994"
4,2,2,178,96,92,188,"21 de agosto de 1994"
4,2,2,179,328,316,644,"21 de agosto de 1994"
4,2,2,180,466,411,877,"21 de agosto de 1994"
4,2,2,181,94,97,191,"21 de agosto de 1994"
4,2,2,182,45,40,85,"21 de agosto de 1994"
4,2,5,363,534,520,1054,"21 de agosto de 1994"
4,2,5,364,505,483,988,"21 de agosto de 1994"
4,2,5,365,312,319,631,"21 de agosto de 1994"
4,2,5,366,377,393,770,"21 de agosto de 1994"
4,2,5,367,334,325,659,"21 de agosto de 1994"
4,2,5,368,334,312,646,"21 de agosto de 1994"
4,2,5,369,197,192,389,"21 de agosto de 1994"
4,2,5,370,368,350,718,"21 de agosto de 1994"
4,2,5,371,195,185,380,"21 de agosto de 1994"
4,2,5,372,328,309,637,"21 de agosto de 1994"
4,2,5,373,161,157,318,"21 de agosto de 1994"
4,2,5,374,82,82,164,"21 de agosto de 1994"
4,2,5,375,376,343,719,"21 de agosto de 1994"
4,2,5,376,387,326,713,"21 de agosto de 1994"
4,2,5,377,366,379,745,"21 de agosto de 1994"
4,2,5,378,350,309,659,"21 de agosto de 1994"
4,2,5,379,259,258,517,"21 de agosto de 1994"
4,2,5,380,135,111,246,"21 de agosto de 1994"
4,2,6,381,380,400,780,"21 de agosto de 1994"
4,2,6,382,471,464,935,"21 de agosto de 1994"
4,2,6,383,324,327,651,"21 de agosto de 1994"
4,2,6,384,263,241,504,"21 de agosto de 1994"
4,2,6,385,79,79,158,"21 de agosto de 1994"
4,2,6,386,94,73,167,"21 de agosto de 1994"
4,2,6,387,50,30,80,"21 de agosto de 1994"
4,2,6,388,613,538,1151,"21 de agosto de 1994"
4,2,6,389,251,201,452,"21 de agosto de 1994"
4,2,6,390,65,42,107,"21 de agosto de 1994"
4,2,6,391,148,111,259,"21 de agosto de 1994"
4,2,6,392,33,22,55,"21 de agosto de 1994"
4,2,6,393,50,38,88,"21 de agosto de 1994"
4,2,6,394,198,171,369,"21 de agosto de 1994"
4,2,6,395,186,151,337,"21 de agosto de 1994"
4,2,6,396,155,139,294,"21 de agosto de 1994"
4,2,6,397,206,177,383,"21 de agosto de 1994"
4,2,6,398,197,166,363,"21 de agosto de 1994"
4,2,6,399,149,119,268,"21 de agosto de 1994"
4,2,6,400,268,232,500,"21 de agosto de 1994"
4,2,6,401,325,298,623,"21 de agosto de 1994"
4,2,6,402,40,35,75,"21 de agosto de 1994"
4,2,6,403,299,279,578,"21 de agosto de 1994"
4,2,6,404,304,252,556,"21 de agosto de 1994"
4,2,6,405,47,27,74,"21 de agosto de 1994"
4,2,6,406,105,84,189,"21 de agosto de 1994"
4,2,6,407,227,206,433,"21 de agosto de 1994"
4,2,6,408,87,63,150,"21 de agosto de 1994"
4,2,6,409,166,144,310,"21 de agosto de 1994"
4,2,6,410,302,255,557,"21 de agosto de 1994"
4,2,6,411,117,72,189,"21 de agosto de 1994"
4,2,6,412,71,67,138,"21 de agosto de 1994"
4,2,6,413,75,56,131,"21 de agosto de 1994"
4,2,6,414,88,62,150,"21 de agosto de 1994"
4,2,6,415,450,331,781,"21 de agosto de 1994"
4,2,6,416,33,28,61,"21 de agosto de 1994"
4,2,6,417,380,304,684,"21 de agosto de 1994"
4,2,6,418,66,49,115,"21 de agosto de 1994"
4,2,6,419,112,98,210,"21 de agosto de 1994"
4,2,6,420,36,34,70,"21 de agosto de 1994"
4,2,6,421,413,351,764,"21 de agosto de 1994"
4,2,6,422,267,187,454,"21 de agosto de 1994"
4,2,6,423,71,49,120,"21 de agosto de 1994"
4,2,6,424,160,111,271,"21 de agosto de 1994"
4,2,6,425,134,90,224,"21 de agosto de 1994"
4,2,6,426,297,238,535,"21 de agosto de 1994"
4,2,6,427,163,129,292,"21 de agosto de 1994"
4,2,8,440,368,319,687,"21 de agosto de 1994"
4,2,8,441,430,409,839,"21 de agosto de 1994"
4,2,8,442,423,377,800,"21 de agosto de 1994"
4,2,8,443,437,355,792,"21 de agosto de 1994"
4,2,8,444,37,36,73,"21 de agosto de 1994"
4,2,8,445,315,284,599,"21 de agosto de 1994"
4,2,8,446,29,22,51,"21 de agosto de 1994"
4,2,8,447,110,105,215,"21 de agosto de 1994"
5,1,30,730,324,353,677,"21 de agosto de 1994"
5,1,30,731,230,245,475,"21 de agosto de 1994"
5,1,30,732,329,336,665,"21 de agosto de 1994"
5,1,30,733,418,468,886,"21 de agosto de 1994"
5,1,30,734,314,341,655,"21 de agosto de 1994"
5,1,30,735,379,421,800,"21 de agosto de 1994"
5,1,30,736,481,539,1020,"21 de agosto de 1994"
5,1,30,737,444,501,945,"21 de agosto de 1994"
5,1,30,738,394,394,788,"21 de agosto de 1994"
5,1,30,739,535,593,1128,"21 de agosto de 1994"
5,1,30,740,416,439,855,"21 de agosto de 1994"
5,1,30,741,375,404,779,"21 de agosto de 1994"
5,1,30,742,553,601,1154,"21 de agosto de 1994"
5,1,30,743,562,676,1238,"21 de agosto de 1994"
5,1,30,744,410,458,868,"21 de agosto de 1994"
5,1,30,745,311,345,656,"21 de agosto de 1994"
5,1,30,746,343,364,707,"21 de agosto de 1994"
5,1,30,747,361,390,751,"21 de agosto de 1994"
5,1,30,748,479,568,1047,"21 de agosto de 1994"
5,1,30,749,331,366,697,"21 de agosto de 1994"
5,1,30,750,469,558,1027,"21 de agosto de 1994"
5,1,30,751,448,495,943,"21 de agosto de 1994"
5,1,30,752,310,339,649,"21 de agosto de 1994"
5,1,30,753,497,507,1004,"21 de agosto de 1994"
5,1,30,754,361,426,787,"21 de agosto de 1994"
5,1,30,755,172,195,367,"21 de agosto de 1994"
5,1,30,756,411,446,857,"21 de agosto de 1994"
5,1,30,757,500,533,1033,"21 de agosto de 1994"
5,1,30,758,386,431,817,"21 de agosto de 1994"
5,1,30,759,417,501,918,"21 de agosto de 1994"
5,1,30,760,293,339,632,"21 de agosto de 1994"
5,1,30,761,412,438,850,"21 de agosto de 1994"
5,1,30,762,290,317,607,"21 de agosto de 1994"
5,1,30,763,562,616,1178,"21 de agosto de 1994"
5,1,30,764,460,511,971,"21 de agosto de 1994"
5,1,30,765,410,447,857,"21 de agosto de 1994"
5,1,30,766,387,414,801,"21 de agosto de 1994"
5,1,30,767,347,386,733,"21 de agosto de 1994"
5,1,30,768,664,709,1373,"21 de agosto de 1994"
5,1,30,769,442,467,909,"21 de agosto de 1994"
5,1,30,770,330,399,729,"21 de agosto de 1994"
5,1,30,771,464,499,963,"21 de agosto de 1994"
5,1,30,772,291,309,600,"21 de agosto de 1994"
5,1,30,773,365,399,764,"21 de agosto de 1994"
5,1,30,774,459,548,1007,"21 de agosto de 1994"
5,1,30,775,389,432,821,"21 de agosto de 1994"
5,1,30,776,348,368,716,"21 de agosto de 1994"
5,1,30,777,329,369,698,"21 de agosto de 1994"
5,1,30,778,406,441,847,"21 de agosto de 1994"
5,1,30,779,525,599,1124,"21 de agosto de 1994"
5,1,30,780,346,401,747,"21 de agosto de 1994"
5,1,30,781,356,450,806,"21 de agosto de 1994"
5,1,30,782,407,491,898,"21 de agosto de 1994"
5,1,30,783,465,575,1040,"21 de agosto de 1994"
5,1,30,784,373,440,813,"21 de agosto de 1994"
5,1,30,785,296,344,640,"21 de agosto de 1994"
5,1,30,786,382,463,845,"21 de agosto de 1994"
5,1,30,787,488,522,1010,"21 de agosto de 1994"
5,1,30,788,409,517,926,"21 de agosto de 1994"
5,1,30,789,322,381,703,"21 de agosto de 1994"
5,1,30,790,349,428,777,"21 de agosto de 1994"
5,1,30,791,355,368,723,"21 de agosto de 1994"
5,1,30,792,531,594,1125,"21 de agosto de 1994"
5,1,30,793,339,372,711,"21 de agosto de 1994"
5,1,30,794,480,472,952,"21 de agosto de 1994"
5,1,30,795,562,629,1191,"21 de agosto de 1994"
5,1,30,796,693,776,1469,"21 de agosto de 1994"
5,1,30,797,352,410,762,"21 de agosto de 1994"
5,1,30,798,392,475,867,"21 de agosto de 1994"
5,1,30,799,316,369,685,"21 de agosto de 1994"
5,1,30,800,474,555,1029,"21 de agosto de 1994"
5,1,30,801,370,402,772,"21 de agosto de 1994"
5,1,30,802,226,250,476,"21 de agosto de 1994"
5,1,30,803,411,446,857,"21 de agosto de 1994"
5,1,30,804,517,517,1034,"21 de agosto de 1994"
5,1,30,805,416,465,881,"21 de agosto de 1994"
5,1,30,806,220,243,463,"21 de agosto de 1994"
5,1,30,807,487,509,996,"21 de agosto de 1994"
5,1,30,808,412,461,873,"21 de agosto de 1994"
5,1,30,809,328,362,690,"21 de agosto de 1994"
5,1,30,810,344,394,738,"21 de agosto de 1994"
5,1,30,811,293,380,673,"21 de agosto de 1994"
5,1,30,812,531,587,1118,"21 de agosto de 1994"
5,1,30,813,434,483,917,"21 de agosto de 1994"
5,1,30,814,516,625,1141,"21 de agosto de 1994"
5,1,30,815,443,441,884,"21 de agosto de 1994"
5,1,30,816,729,795,1524,"21 de agosto de 1994"
5,1,30,817,362,389,751,"21 de agosto de 1994"
5,1,30,818,390,420,810,"21 de agosto de 1994"
5,1,30,819,544,597,1141,"21 de agosto de 1994"
5,1,30,820,368,410,778,"21 de agosto de 1994"
5,1,30,821,392,454,846,"21 de agosto de 1994"
5,1,30,822,444,485,929,"21 de agosto de 1994"
5,1,30,823,411,432,843,"21 de agosto de 1994"
5,1,30,824,314,355,669,"21 de agosto de 1994"
5,1,30,825,326,362,688,"21 de agosto de 1994"
5,1,30,826,358,402,760,"21 de agosto de 1994"
5,1,30,827,319,415,734,"21 de agosto de 1994"
5,1,30,828,519,577,1096,"21 de agosto de 1994"
5,1,30,829,521,544,1065,"21 de agosto de 1994"
5,1,30,830,518,594,1112,"21 de agosto de 1994"
5,1,30,831,425,480,905,"21 de agosto de 1994"
5,1,30,832,424,521,945,"21 de agosto de 1994"
5,1,30,833,426,494,920,"21 de agosto de 1994"
5,1,30,834,120,138,258,"21 de agosto de 1994"
5,1,30,835,492,535,1027,"21 de agosto de 1994"
5,1,30,836,536,677,1213,"21 de agosto de 1994"
5,1,30,837,367,441,808,"21 de agosto de 1994"
5,1,30,838,461,498,959,"21 de agosto de 1994"
5,1,30,839,388,425,813,"21 de agosto de 1994"
5,1,30,840,318,394,712,"21 de agosto de 1994"
5,1,30,841,320,370,690,"21 de agosto de 1994"
5,1,30,842,319,358,677,"21 de agosto de 1994"
5,1,30,843,347,373,720,"21 de agosto de 1994"
5,1,30,844,299,358,657,"21 de agosto de 1994"
5,1,30,845,281,358,639,"21 de agosto de 1994"
5,1,30,846,327,392,719,"21 de agosto de 1994"
5,1,30,847,464,578,1042,"21 de agosto de 1994"
5,1,30,848,350,481,831,"21 de agosto de 1994"
5,1,30,849,270,308,578,"21 de agosto de 1994"
5,1,30,850,571,656,1227,"21 de agosto de 1994"
5,1,30,851,611,600,1211,"21 de agosto de 1994"
5,1,30,852,294,308,602,"21 de agosto de 1994"
5,1,30,853,400,432,832,"21 de agosto de 1994"
5,1,30,854,410,467,877,"21 de agosto de 1994"
5,1,30,855,323,399,722,"21 de agosto de 1994"
5,1,30,856,382,435,817,"21 de agosto de 1994"
5,1,30,857,402,548,950,"21 de agosto de 1994"
5,1,30,858,360,404,764,"21 de agosto de 1994"
5,1,30,859,400,470,870,"21 de agosto de 1994"
5,1,30,860,390,480,870,"21 de agosto de 1994"
5,1,30,861,283,372,655,"21 de agosto de 1994"
5,1,30,862,428,484,912,"21 de agosto de 1994"
5,1,30,863,679,687,1366,"21 de agosto de 1994"
5,1,30,864,738,722,1460,"21 de agosto de 1994"
5,1,30,865,609,657,1266,"21 de agosto de 1994"
5,1,30,866,402,433,835,"21 de agosto de 1994"
5,1,30,867,557,583,1140,"21 de agosto de 1994"
5,1,30,868,543,548,1091,"21 de agosto de 1994"
5,1,30,869,274,315,589,"21 de agosto de 1994"
5,1,30,870,272,322,594,"21 de agosto de 1994"
5,1,30,871,349,415,764,"21 de agosto de 1994"
5,1,30,872,535,580,1115,"21 de agosto de 1994"
5,1,30,873,459,539,998,"21 de agosto de 1994"
5,1,30,874,273,296,569,"21 de agosto de 1994"
5,1,30,875,357,433,790,"21 de agosto de 1994"
5,1,30,876,496,545,1041,"21 de agosto de 1994"
5,1,30,877,391,555,946,"21 de agosto de 1994"
5,1,30,878,284,342,626,"21 de agosto de 1994"
5,1,30,879,372,458,830,"21 de agosto de 1994"
5,1,30,880,485,524,1009,"21 de agosto de 1994"
5,1,30,881,244,346,590,"21 de agosto de 1994"
5,1,30,882,351,426,777,"21 de agosto de 1994"
5,1,30,883,483,537,1020,"21 de agosto de 1994"
5,1,30,884,457,482,939,"21 de agosto de 1994"
5,1,30,885,493,495,988,"21 de agosto de 1994"
5,1,30,886,442,441,883,"21 de agosto de 1994"
5,1,30,887,546,580,1126,"21 de agosto de 1994"
5,1,30,888,685,758,1443,"21 de agosto de 1994"
5,1,30,889,464,472,936,"21 de agosto de 1994"
5,1,30,890,351,376,727,"21 de agosto de 1994"
5,1,30,891,367,434,801,"21 de agosto de 1994"
5,1,30,892,348,398,746,"21 de agosto de 1994"
5,1,30,893,424,541,965,"21 de agosto de 1994"
5,1,30,894,323,374,697,"21 de agosto de 1994"
5,1,30,895,400,478,878,"21 de agosto de 1994"
5,1,30,896,390,479,869,"21 de agosto de 1994"
5,1,30,897,527,641,1168,"21 de agosto de 1994"
5,1,30,898,389,487,876,"21 de agosto de 1994"
5,1,30,899,398,491,889,"21 de agosto de 1994"
5,1,30,900,244,259,503,"21 de agosto de 1994"
5,1,30,901,201,233,434,"21 de agosto de 1994"
5,1,30,902,481,564,1045,"21 de agosto de 1994"
5,1,30,903,466,488,954,"21 de agosto de 1994"
5,1,30,904,328,330,658,"21 de agosto de 1994"
5,1,30,905,392,401,793,"21 de agosto de 1994"
5,1,30,906,379,417,796,"21 de agosto de 1994"
5,1,30,907,533,664,1197,"21 de agosto de 1994"
5,1,30,908,266,301,567,"21 de agosto de 1994"
5,1,30,909,256,316,572,"21 de agosto de 1994"
5,1,30,910,389,474,863,"21 de agosto de 1994"
5,1,30,911,512,562,1074,"21 de agosto de 1994"
5,1,30,912,429,481,910,"21 de agosto de 1994"
5,1,30,913,429,502,931,"21 de agosto de 1994"
5,1,30,914,446,479,925,"21 de agosto de 1994"
5,1,30,915,436,475,911,"21 de agosto de 1994"
5,1,30,916,362,413,775,"21 de agosto de 1994"
5,1,30,917,399,458,857,"21 de agosto de 1994"
5,1,30,918,416,469,885,"21 de agosto de 1994"
5,1,30,919,604,612,1216,"21 de agosto de 1994"
5,1,30,920,435,448,883,"21 de agosto de 1994"
5,1,30,921,516,573,1089,"21 de agosto de 1994"
5,1,30,922,493,564,1057,"21 de agosto de 1994"
5,1,30,923,496,618,1114,"21 de agosto de 1994"
5,1,30,924,398,412,810,"21 de agosto de 1994"
5,1,30,925,443,480,923,"21 de agosto de 1994"
5,1,30,926,384,453,837,"21 de agosto de 1994"
5,1,30,927,412,430,842,"21 de agosto de 1994"
5,1,30,928,389,438,827,"21 de agosto de 1994"
5,1,30,929,380,428,808,"21 de agosto de 1994"
5,1,30,930,421,512,933,"21 de agosto de 1994"
5,1,30,931,447,446,893,"21 de agosto de 1994"
5,1,30,932,614,714,1328,"21 de agosto de 1994"
5,1,30,933,887,546,1433,"21 de agosto de 1994"
5,1,30,934,471,567,1038,"21 de agosto de 1994"
5,1,30,935,499,558,1057,"21 de agosto de 1994"
5,1,30,936,363,427,790,"21 de agosto de 1994"
5,1,30,937,450,530,980,"21 de agosto de 1994"
5,1,30,938,407,478,885,"21 de agosto de 1994"
5,1,30,939,295,361,656,"21 de agosto de 1994"
5,1,30,940,400,448,848,"21 de agosto de 1994"
5,1,30,941,508,602,1110,"21 de agosto de 1994"
5,1,30,942,532,576,1108,"21 de agosto de 1994"
5,1,30,943,239,289,528,"21 de agosto de 1994"
5,1,30,944,238,269,507,"21 de agosto de 1994"
5,1,30,945,297,343,640,"21 de agosto de 1994"
5,1,30,946,300,349,649,"21 de agosto de 1994"
5,1,30,947,271,315,586,"21 de agosto de 1994"
5,1,30,948,316,394,710,"21 de agosto de 1994"
5,1,30,949,448,471,919,"21 de agosto de 1994"
5,1,30,950,341,388,729,"21 de agosto de 1994"
5,1,30,951,302,329,631,"21 de agosto de 1994"
5,1,30,952,368,414,782,"21 de agosto de 1994"
5,1,30,953,568,564,1132,"21 de agosto de 1994"
5,1,30,954,536,584,1120,"21 de agosto de 1994"
5,1,30,955,467,479,946,"21 de agosto de 1994"
5,1,30,956,540,561,1101,"21 de agosto de 1994"
5,1,30,957,438,479,917,"21 de agosto de 1994"
5,1,30,958,492,554,1046,"21 de agosto de 1994"
5,1,30,959,489,527,1016,"21 de agosto de 1994"
5,1,30,960,322,301,623,"21 de agosto de 1994"
5,1,30,961,506,585,1091,"21 de agosto de 1994"
5,1,30,962,424,449,873,"21 de agosto de 1994"
5,1,30,963,608,650,1258,"21 de agosto de 1994"
5,1,30,964,472,513,985,"21 de agosto de 1994"
5,1,30,965,419,432,851,"21 de agosto de 1994"
5,1,30,966,512,557,1069,"21 de agosto de 1994"
5,1,30,967,425,519,944,"21 de agosto de 1994"
5,1,30,968,279,366,645,"21 de agosto de 1994"
5,1,30,969,269,333,602,"21 de agosto de 1994"
5,1,30,970,380,432,812,"21 de agosto de 1994"
5,1,30,971,437,491,928,"21 de agosto de 1994"
5,1,30,972,479,486,965,"21 de agosto de 1994"
5,1,30,973,521,544,1065,"21 de agosto de 1994"
5,1,30,974,616,678,1294,"21 de agosto de 1994"
5,1,30,975,363,383,746,"21 de agosto de 1994"
5,1,30,976,364,411,775,"21 de agosto de 1994"
5,1,30,977,454,510,964,"21 de agosto de 1994"
5,1,30,978,598,717,1315,"21 de agosto de 1994"
5,1,30,979,469,480,949,"21 de agosto de 1994"
5,1,30,980,337,360,697,"21 de agosto de 1994"
5,1,30,981,365,404,769,"21 de agosto de 1994"
5,1,30,982,370,435,805,"21 de agosto de 1994"
5,1,30,983,375,407,782,"21 de agosto de 1994"
5,1,30,984,481,536,1017,"21 de agosto de 1994"
5,1,30,985,633,649,1282,"21 de agosto de 1994"
5,1,30,986,434,458,892,"21 de agosto de 1994"
5,1,30,987,205,227,432,"21 de agosto de 1994"
5,1,30,988,241,267,508,"21 de agosto de 1994"
5,1,30,989,431,448,879,"21 de agosto de 1994"
5,1,30,990,398,446,844,"21 de agosto de 1994"
5,1,30,991,255,302,557,"21 de agosto de 1994"
5,1,30,992,264,240,504,"21 de agosto de 1994"
5,1,30,993,770,845,1615,"21 de agosto de 1994"
5,1,30,994,233,273,506,"21 de agosto de 1994"
5,1,30,995,295,309,604,"21 de agosto de 1994"
5,1,30,996,321,408,729,"21 de agosto de 1994"
5,1,30,997,225,248,473,"21 de agosto de 1994"
5,1,30,998,230,279,509,"21 de agosto de 1994"
5,1,30,999,227,243,470,"21 de agosto de 1994"
5,2,35,1172,199,204,403,"21 de agosto de 1994"
5,2,35,1173,271,305,576,"21 de agosto de 1994"
5,2,35,1174,229,243,472,"21 de agosto de 1994"
5,2,35,1175,243,273,516,"21 de agosto de 1994"
5,2,35,1176,341,312,653,"21 de agosto de 1994"
5,2,35,1177,215,214,429,"21 de agosto de 1994"
5,2,35,1178,246,270,516,"21 de agosto de 1994"
5,2,35,1179,390,431,821,"21 de agosto de 1994"
5,2,35,1180,212,233,445,"21 de agosto de 1994"
5,2,35,1181,264,334,598,"21 de agosto de 1994"
5,2,35,1182,260,369,629,"21 de agosto de 1994"
5,2,35,1183,192,216,408,"21 de agosto de 1994"
5,2,35,1184,295,341,636,"21 de agosto de 1994"
5,2,35,1185,553,593,1146,"21 de agosto de 1994"
5,2,35,1186,221,255,476,"21 de agosto de 1994"
5,2,35,1187,370,474,844,"21 de agosto de 1994"
5,2,35,1188,341,383,724,"21 de agosto de 1994"
5,2,35,1189,494,539,1033,"21 de agosto de 1994"
5,2,35,1190,494,545,1039,"21 de agosto de 1994"
5,2,35,1191,301,387,688,"21 de agosto de 1994"
5,2,35,1192,468,521,989,"21 de agosto de 1994"
5,2,35,1193,362,433,795,"21 de agosto de 1994"
5,2,35,1194,460,563,1023,"21 de agosto de 1994"
5,2,35,1195,539,611,1150,"21 de agosto de 1994"
5,2,35,1196,608,633,1241,"21 de agosto de 1994"
5,2,35,1197,619,705,1324,"21 de agosto de 1994"
5,2,35,1198,441,536,977,"21 de agosto de 1994"
5,2,35,1199,397,470,867,"21 de agosto de 1994"
5,2,35,1200,482,527,1009,"21 de agosto de 1994"
5,2,35,1201,443,513,956,"21 de agosto de 1994"
5,2,35,1202,467,529,996,"21 de agosto de 1994"
5,2,35,1203,367,421,788,"21 de agosto de 1994"
5,2,35,1204,437,508,945,"21 de agosto de 1994"
5,2,35,1205,404,481,885,"21 de agosto de 1994"
5,2,35,1206,447,533,980,"21 de agosto de 1994"
5,2,35,1207,617,650,1267,"21 de agosto de 1994"
5,2,35,1208,502,507,1009,"21 de agosto de 1994"
5,2,35,1209,590,736,1326,"21 de agosto de 1994"
5,2,35,1210,580,717,1297,"21 de agosto de 1994"
5,2,35,1211,383,428,811,"21 de agosto de 1994"
5,2,35,1212,387,407,794,"21 de agosto de 1994"
5,2,35,1213,589,673,1262,"21 de agosto de 1994"
5,2,35,1214,713,755,1468,"21 de agosto de 1994"
5,2,35,1215,557,656,1213,"21 de agosto de 1994"
5,2,35,1216,404,474,878,"21 de agosto de 1994"
5,2,35,1217,276,333,609,"21 de agosto de 1994"
5,2,35,1218,597,695,1292,"21 de agosto de 1994"
5,2,35,1219,461,532,993,"21 de agosto de 1994"
5,2,35,1220,557,702,1259,"21 de agosto de 1994"
5,2,35,1221,536,613,1149,"21 de agosto de 1994"
5,2,35,1222,455,625,1080,"21 de agosto de 1994"
5,2,35,1223,430,563,993,"21 de agosto de 1994"
5,2,35,1224,545,666,1211,"21 de agosto de 1994"
5,2,35,1225,399,456,855,"21 de agosto de 1994"
5,2,35,1226,340,428,768,"21 de agosto de 1994"
5,2,35,1227,534,600,1134,"21 de agosto de 1994"
5,2,35,1228,458,553,1011,"21 de agosto de 1994"
5,2,35,1229,326,423,749,"21 de agosto de 1994"
5,2,35,1230,400,449,849,"21 de agosto de 1994"
5,2,35,1231,293,370,663,"21 de agosto de 1994"
5,2,35,1232,445,600,1045,"21 de agosto de 1994"
5,2,35,1233,484,623,1107,"21 de agosto de 1994"
5,2,35,1234,425,521,946,"21 de agosto de 1994"
5,2,35,1235,346,444,790,"21 de agosto de 1994"
5,2,35,1236,316,398,714,"21 de agosto de 1994"
5,2,35,1237,297,386,683,"21 de agosto de 1994"
5,2,35,1238,305,363,668,"21 de agosto de 1994"
5,2,35,1239,334,452,786,"21 de agosto de 1994"
5,2,35,1240,458,531,989,"21 de agosto de 1994"
5,2,35,1241,345,489,834,"21 de agosto de 1994"
5,2,35,1242,397,510,907,"21 de agosto de 1994"
5,2,35,1243,317,389,706,"21 de agosto de 1994"
5,2,35,1244,284,362,646,"21 de agosto de 1994"
5,2,35,1245,393,506,899,"21 de agosto de 1994"
5,2,35,1246,329,400,729,"21 de agosto de 1994"
5,2,35,1247,496,568,1064,"21 de agosto de 1994"
5,2,35,1248,566,640,1206,"21 de agosto de 1994"
5,2,35,1249,365,443,808,"21 de agosto de 1994"
5,2,35,1250,427,446,873,"21 de agosto de 1994"
5,2,35,1251,329,333,662,"21 de agosto de 1994"
5,2,35,1252,413,526,939,"21 de agosto de 1994"
5,2,35,1253,500,601,1101,"21 de agosto de 1994"
5,2,35,1254,532,633,1165,"21 de agosto de 1994"
5,2,35,1255,340,461,801,"21 de agosto de 1994"
5,2,35,1256,381,451,832,"21 de agosto de 1994"
5,2,35,1257,658,723,1381,"21 de agosto de 1994"
5,2,35,1258,572,588,1160,"21 de agosto de 1994"
5,2,35,1259,549,575,1124,"21 de agosto de 1994"
5,2,35,1260,627,655,1282,"21 de agosto de 1994"
5,2,35,1261,661,690,1351,"21 de agosto de 1994"
5,2,35,1262,377,386,763,"21 de agosto de 1994"
5,2,35,1263,391,453,844,"21 de agosto de 1994"
5,2,35,1264,586,640,1226,"21 de agosto de 1994"
5,2,35,1265,342,405,747,"21 de agosto de 1994"
5,2,35,1266,693,719,1412,"21 de agosto de 1994"
5,2,35,1267,629,656,1285,"21 de agosto de 1994"
5,2,35,1268,288,379,667,"21 de agosto de 1994"
5,2,35,1269,506,551,1057,"21 de agosto de 1994"
5,2,35,1270,328,319,647,"21 de agosto de 1994"
5,2,35,1271,624,620,1244,"21 de agosto de 1994"
5,2,35,1272,414,487,901,"21 de agosto de 1994"
5,2,35,1273,399,446,845,"21 de agosto de 1994"
5,2,35,1274,477,541,1018,"21 de agosto de 1994"
5,2,35,1275,502,581,1083,"21 de agosto de 1994"
5,2,35,1276,640,695,1335,"21 de agosto de 1994"
5,2,35,1277,649,757,1406,"21 de agosto de 1994"
5,2,35,1278,416,479,895,"21 de agosto de 1994"
5,2,35,1279,324,371,695,"21 de agosto de 1994"
5,2,35,1280,296,311,607,"21 de agosto de 1994"
5,2,35,1281,280,284,564,"21 de agosto de 1994"
5,2,35,1282,257,322,579,"21 de agosto de 1994"
5,2,35,1283,495,640,1135,"21 de agosto de 1994"
5,2,35,1284,350,359,709,"21 de agosto de 1994"
5,2,35,1285,515,552,1067,"21 de agosto de 1994"
5,2,35,1286,259,293,552,"21 de agosto de 1994"
5,2,35,1287,442,496,938,"21 de agosto de 1994"
5,2,35,1288,163,158,321,"21 de agosto de 1994"
5,2,35,1289,288,260,548,"21 de agosto de 1994"
5,2,35,1290,242,282,524,"21 de agosto de 1994"
5,2,35,1291,503,542,1045,"21 de agosto de 1994"
5,2,35,1292,304,298,602,"21 de agosto de 1994"
5,2,35,1293,226,239,465,"21 de agosto de 1994"
5,2,35,1294,291,324,615,"21 de agosto de 1994"
5,2,35,1295,301,302,603,"21 de agosto de 1994"
5,2,35,1296,424,444,868,"21 de agosto de 1994"
5,2,35,1297,251,291,542,"21 de agosto de 1994"
5,2,35,1298,402,403,805,"21 de agosto de 1994"
5,2,35,1299,320,304,624,"21 de agosto de 1994"
5,2,35,1300,395,454,849,"21 de agosto de 1994"
5,2,35,1301,346,426,772,"21 de agosto de 1994"
5,2,35,1302,377,433,810,"21 de agosto de 1994"
5,2,35,1303,301,341,642,"21 de agosto de 1994"
5,2,35,1304,258,295,553,"21 de agosto de 1994"
5,2,35,1305,185,179,364,"21 de agosto de 1994"
5,2,35,1306,385,436,821,"21 de agosto de 1994"
5,2,35,1307,350,392,742,"21 de agosto de 1994"
5,2,35,1308,303,349,652,"21 de agosto de 1994"
5,2,35,1309,358,356,714,"21 de agosto de 1994"
5,3,1,1,233,231,464,"21 de agosto de 1994"
5,3,1,2,142,163,305,"21 de agosto de 1994"
5,3,3,42,209,250,459,"21 de agosto de 1994"
5,3,3,43,295,365,660,"21 de agosto de 1994"
5,3,3,44,372,398,770,"21 de agosto de 1994"
5,3,3,45,346,425,771,"21 de agosto de 1994"
5,3,3,46,340,434,774,"21 de agosto de 1994"
5,3,3,47,362,383,745,"21 de agosto de 1994"
5,3,3,48,287,284,571,"21 de agosto de 1994"
5,3,3,49,514,593,1107,"21 de agosto de 1994"
5,3,3,50,454,544,998,"21 de agosto de 1994"
5,3,3,51,268,286,554,"21 de agosto de 1994"
5,3,3,52,257,320,577,"21 de agosto de 1994"
5,3,3,53,330,381,711,"21 de agosto de 1994"
5,3,3,54,499,488,987,"21 de agosto de 1994"
5,3,3,55,452,456,908,"21 de agosto de 1994"
5,3,3,56,62,46,108,"21 de agosto de 1994"
5,3,5,81,152,143,295,"21 de agosto de 1994"
5,3,5,82,275,285,560,"21 de agosto de 1994"
5,3,5,83,64,61,125,"21 de agosto de 1994"
5,3,8,127,98,83,181,"21 de agosto de 1994"
5,3,8,128,87,93,180,"21 de agosto de 1994"
5,3,8,129,118,123,241,"21 de agosto de 1994"
5,3,8,130,436,490,926,"21 de agosto de 1994"
5,3,12,233,197,164,361,"21 de agosto de 1994"
5,3,12,234,144,123,267,"21 de agosto de 1994"
5,3,12,235,71,54,125,"21 de agosto de 1994"
5,3,12,236,108,100,208,"21 de agosto de 1994"
5,3,12,237,77,78,155,"21 de agosto de 1994"
5,3,13,238,176,156,332,"21 de agosto de 1994"
5,3,13,239,97,93,190,"21 de agosto de 1994"
5,3,15,250,116,145,261,"21 de agosto de 1994"
5,3,15,251,99,99,198,"21 de agosto de 1994"
5,3,15,252,105,94,199,"21 de agosto de 1994"
5,3,15,253,37,39,76,"21 de agosto de 1994"
5,3,15,254,57,43,100,"21 de agosto de 1994"
5,3,18,319,304,289,593,"21 de agosto de 1994"
5,3,18,320,194,210,404,"21 de agosto de 1994"
5,3,18,321,393,398,791,"21 de agosto de 1994"
5,3,18,322,151,153,304,"21 de agosto de 1994"
5,3,18,323,363,364,727,"21 de agosto de 1994"
5,3,18,324,154,162,316,"21 de agosto de 1994"
5,3,18,325,270,291,561,"21 de agosto de 1994"
5,3,18,326,300,304,604,"21 de agosto de 1994"
5,3,18,327,246,245,491,"21 de agosto de 1994"
5,3,18,328,199,207,406,"21 de agosto de 1994"
5,3,18,329,107,113,220,"21 de agosto de 1994"
5,3,18,330,193,214,407,"21 de agosto de 1994"
5,3,18,331,307,347,654,"21 de agosto de 1994"
5,3,18,332,433,476,909,"21 de agosto de 1994"
5,3,18,333,274,294,568,"21 de agosto de 1994"
5,3,18,334,531,545,1076,"21 de agosto de 1994"
5,3,18,335,477,514,991,"21 de agosto de 1994"
5,3,18,336,367,342,709,"21 de agosto de 1994"
5,3,18,337,348,359,707,"21 de agosto de 1994"
5,3,18,338,270,286,556,"21 de agosto de 1994"
5,3,18,339,442,458,900,"21 de agosto de 1994"
5,3,18,340,476,513,989,"21 de agosto de 1994"
5,3,18,341,485,540,1025,"21 de agosto de 1994"
5,3,18,342,560,549,1109,"21 de agosto de 1994"
5,3,18,343,425,434,859,"21 de agosto de 1994"
5,3,18,344,412,453,865,"21 de agosto de 1994"
5,3,18,345,472,510,982,"21 de agosto de 1994"
5,3,18,346,319,346,665,"21 de agosto de 1994"
5,3,18,347,520,568,1088,"21 de agosto de 1994"
5,3,18,348,276,289,565,"21 de agosto de 1994"
5,3,18,349,380,445,825,"21 de agosto de 1994"
5,3,18,350,514,559,1073,"21 de agosto de 1994"
5,3,18,351,643,709,1352,"21 de agosto de 1994"
5,3,18,352,413,441,854,"21 de agosto de 1994"
5,3,18,353,442,507,949,"21 de agosto de 1994"
5,3,18,354,241,250,491,"21 de agosto de 1994"
5,3,18,355,478,472,950,"21 de agosto de 1994"
5,3,18,356,513,515,1028,"21 de agosto de 1994"
5,3,18,357,525,567,1092,"21 de agosto de 1994"
5,3,18,358,305,358,663,"21 de agosto de 1994"
5,3,18,359,434,464,898,"21 de agosto de 1994"
5,3,18,360,460,512,972,"21 de agosto de 1994"
5,3,18,361,528,563,1091,"21 de agosto de 1994"
5,3,18,362,207,277,484,"21 de agosto de 1994"
5,3,18,363,215,238,453,"21 de agosto de 1994"
5,3,18,364,465,512,977,"21 de agosto de 1994"
5,3,18,365,291,333,624,"21 de agosto de 1994"
5,3,18,366,231,227,458,"21 de agosto de 1994"
5,3,18,367,451,447,898,"21 de agosto de 1994"
5,3,18,368,379,415,794,"21 de agosto de 1994"
5,3,18,369,529,556,1085,"21 de agosto de 1994"
5,3,18,370,531,532,1063,"21 de agosto de 1994"
5,3,18,371,462,441,903,"21 de agosto de 1994"
5,3,18,372,432,436,868,"21 de agosto de 1994"
5,3,18,373,395,419,814,"21 de agosto de 1994"
5,3,18,374,282,296,578,"21 de agosto de 1994"
5,3,18,375,261,323,584,"21 de agosto de 1994"
5,3,18,376,398,389,787,"21 de agosto de 1994"
5,3,18,377,404,433,837,"21 de agosto de 1994"
5,3,18,378,370,384,754,"21 de agosto de 1994"
5,3,18,379,412,454,866,"21 de agosto de 1994"
5,3,18,380,332,349,681,"21 de agosto de 1994"
5,3,18,381,408,466,874,"21 de agosto de 1994"
5,3,18,382,435,459,894,"21 de agosto de 1994"
5,3,18,383,351,348,699,"21 de agosto de 1994"
5,3,18,384,325,338,663,"21 de agosto de 1994"
5,3,18,385,174,182,356,"21 de agosto de 1994"
5,3,18,386,456,491,947,"21 de agosto de 1994"
5,3,18,387,588,593,1181,"21 de agosto de 1994"
5,3,18,388,425,361,786,"21 de agosto de 1994"
5,3,18,389,421,405,826,"21 de agosto de 1994"
5,3,18,390,486,512,998,"21 de agosto de 1994"
5,3,18,391,357,382,739,"21 de agosto de 1994"
5,3,18,392,467,506,973,"21 de agosto de 1994"
5,3,18,393,331,383,714,"21 de agosto de 1994"
5,3,18,394,206,218,424,"21 de agosto de 1994"
5,3,18,395,329,388,717,"21 de agosto de 1994"
5,3,18,396,409,411,820,"21 de agosto de 1994"
5,3,18,397,174,163,337,"21 de agosto de 1994"
5,3,18,398,201,219,420,"21 de agosto de 1994"
5,3,18,399,413,447,860,"21 de agosto de 1994"
5,3,18,400,325,352,677,"21 de agosto de 1994"
5,3,18,401,306,292,598,"21 de agosto de 1994"
5,3,18,402,398,443,841,"21 de agosto de 1994"
5,3,18,403,405,417,822,"21 de agosto de 1994"
5,3,18,404,541,561,1102,"21 de agosto de 1994"
5,3,18,405,514,484,998,"21 de agosto de 1994"
5,3,18,406,503,519,1022,"21 de agosto de 1994"
5,3,18,407,400,402,802,"21 de agosto de 1994"
5,3,18,408,487,550,1037,"21 de agosto de 1994"
5,3,18,409,234,250,484,"21 de agosto de 1994"
5,3,18,410,383,359,742,"21 de agosto de 1994"
5,3,18,411,383,421,804,"21 de agosto de 1994"
5,3,18,412,547,584,1131,"21 de agosto de 1994"
5,3,18,413,526,593,1119,"21 de agosto de 1994"
5,3,18,414,155,154,309,"21 de agosto de 1994"
5,3,18,415,446,440,886,"21 de agosto de 1994"
5,3,18,416,555,565,1120,"21 de agosto de 1994"
5,3,18,417,348,390,738,"21 de agosto de 1994"
5,3,18,418,289,287,576,"21 de agosto de 1994"
5,3,18,419,571,602,1173,"21 de agosto de 1994"
5,3,18,420,392,434,826,"21 de agosto de 1994"
5,3,18,421,120,129,249,"21 de agosto de 1994"
5,3,18,422,445,488,933,"21 de agosto de 1994"
5,3,18,423,63,100,163,"21 de agosto de 1994"
5,3,18,424,348,338,686,"21 de agosto de 1994"
5,3,18,425,415,490,905,"21 de agosto de 1994"
5,3,18,426,348,358,706,"21 de agosto de 1994"
5,3,18,427,357,386,743,"21 de agosto de 1994"
5,3,18,428,501,493,994,"21 de agosto de 1994"
5,3,18,429,579,631,1210,"21 de agosto de 1994"
5,3,18,430,331,360,691,"21 de agosto de 1994"
5,3,18,431,591,614,1205,"21 de agosto de 1994"
5,3,18,432,362,418,780,"21 de agosto de 1994"
5,3,18,433,384,401,785,"21 de agosto de 1994"
5,3,18,434,611,618,1229,"21 de agosto de 1994"
5,3,18,435,219,252,471,"21 de agosto de 1994"
5,3,18,436,408,436,844,"21 de agosto de 1994"
5,3,18,437,396,430,826,"21 de agosto de 1994"
5,3,18,438,213,231,444,"21 de agosto de 1994"
5,3,18,439,351,374,725,"21 de agosto de 1994"
5,3,18,440,184,193,377,"21 de agosto de 1994"
5,3,18,441,264,276,540,"21 de agosto de 1994"
5,3,18,442,88,82,170,"21 de agosto de 1994"
5,3,18,443,38,24,62,"21 de agosto de 1994"
5,3,21,500,305,302,607,"21 de agosto de 1994"
5,3,21,501,351,351,702,"21 de agosto de 1994"
5,3,21,502,310,290,600,"21 de agosto de 1994"
5,3,21,503,266,240,506,"21 de agosto de 1994"
5,3,21,504,134,102,236,"21 de agosto de 1994"
5,3,21,505,289,242,531,"21 de agosto de 1994"
5,3,21,506,52,50,102,"21 de agosto de 1994"
5,3,21,507,42,42,84,"21 de agosto de 1994"
5,3,26,645,83,112,195,"21 de agosto de 1994"
5,3,26,646,78,111,189,"21 de agosto de 1994"
5,3,26,647,241,192,433,"21 de agosto de 1994"
5,3,26,648,169,182,351,"21 de agosto de 1994"
5,3,26,649,236,196,432,"21 de agosto de 1994"
5,3,26,650,169,173,342,"21 de agosto de 1994"
5,3,26,651,49,38,87,"21 de agosto de 1994"
5,3,31,1040,296,278,574,"21 de agosto de 1994"
5,3,31,1041,460,456,916,"21 de agosto de 1994"
5,3,31,1042,281,269,550,"21 de agosto de 1994"
5,3,31,1043,385,417,802,"21 de agosto de 1994"
5,3,31,1044,477,521,998,"21 de agosto de 1994"
5,3,31,1045,340,356,696,"21 de agosto de 1994"
5,3,31,1046,422,401,823,"21 de agosto de 1994"
5,3,31,1047,479,520,999,"21 de agosto de 1994"
5,3,31,1048,428,422,850,"21 de agosto de 1994"
5,3,31,1049,302,341,643,"21 de agosto de 1994"
5,3,31,1050,220,275,495,"21 de agosto de 1994"
5,3,31,1051,290,305,595,"21 de agosto de 1994"
5,3,31,1052,196,192,388,"21 de agosto de 1994"
5,3,31,1053,38,28,66,"21 de agosto de 1994"
5,3,31,1054,91,75,166,"21 de agosto de 1994"
5,3,31,1055,175,166,341,"21 de agosto de 1994"
5,3,31,1056,146,174,320,"21 de agosto de 1994"
5,3,31,1057,176,137,313,"21 de agosto de 1994"
5,3,37,1498,123,134,257,"21 de agosto de 1994"
5,3,37,1499,241,286,527,"21 de agosto de 1994"
5,3,37,1500,308,350,658,"21 de agosto de 1994"
5,3,37,1501,276,294,570,"21 de agosto de 1994"
5,3,37,1502,284,316,600,"21 de agosto de 1994"
5,3,37,1503,102,66,168,"21 de agosto de 1994"
5,3,37,1504,41,33,74,"21 de agosto de 1994"
5,3,37,1505,124,109,233,"21 de agosto de 1994"
5,4,2,3,703,748,1451,"21 de agosto de 1994"
5,4,2,4,669,653,1322,"21 de agosto de 1994"
5,4,2,5,220,238,458,"21 de agosto de 1994"
5,4,2,6,446,483,929,"21 de agosto de 1994"
5,4,2,7,497,580,1077,"21 de agosto de 1994"
5,4,2,8,457,538,995,"21 de agosto de 1994"
5,4,2,9,624,601,1225,"21 de agosto de 1994"
5,4,2,10,675,575,1250,"21 de agosto de 1994"
5,4,2,11,800,762,1562,"21 de agosto de 1994"
5,4,2,12,626,647,1273,"21 de agosto de 1994"
5,4,2,13,221,251,472,"21 de agosto de 1994"
5,4,2,14,384,448,832,"21 de agosto de 1994"
5,4,2,15,449,475,924,"21 de agosto de 1994"
5,4,2,16,459,460,919,"21 de agosto de 1994"
5,4,2,17,494,483,977,"21 de agosto de 1994"
5,4,2,18,516,568,1084,"21 de agosto de 1994"
5,4,2,19,302,312,614,"21 de agosto de 1994"
5,4,2,20,525,597,1122,"21 de agosto de 1994"
5,4,2,21,410,412,822,"21 de agosto de 1994"
5,4,2,22,406,481,887,"21 de agosto de 1994"
5,4,2,23,359,361,720,"21 de agosto de 1994"
5,4,2,24,380,409,789,"21 de agosto de 1994"
5,4,2,25,397,459,856,"21 de agosto de 1994"
5,4,2,26,179,188,367,"21 de agosto de 1994"
5,4,2,27,410,464,874,"21 de agosto de 1994"
5,4,2,28,476,518,994,"21 de agosto de 1994"
5,4,2,29,608,608,1216,"21 de agosto de 1994"
5,4,2,30,472,493,965,"21 de agosto de 1994"
5,4,2,31,226,213,439,"21 de agosto de 1994"
5,4,2,32,495,490,985,"21 de agosto de 1994"
5,4,2,33,281,305,586,"21 de agosto de 1994"
5,4,2,34,678,683,1361,"21 de agosto de 1994"
5,4,2,35,524,536,1060,"21 de agosto de 1994"
5,4,2,36,503,528,1031,"21 de agosto de 1994"
5,4,2,37,307,323,630,"21 de agosto de 1994"
5,4,2,38,31,11,42,"21 de agosto de 1994"
5,4,2,39,34,23,57,"21 de agosto de 1994"
5,4,2,40,47,33,80,"21 de agosto de 1994"
5,4,2,41,354,366,720,"21 de agosto de 1994"
5,4,14,240,185,178,363,"21 de agosto de 1994"
5,4,14,241,136,116,252,"21 de agosto de 1994"
5,4,14,242,449,506,955,"21 de agosto de 1994"
5,4,14,243,298,270,568,"21 de agosto de 1994"
5,4,14,244,198,194,392,"21 de agosto de 1994"
5,4,14,245,407,393,800,"21 de agosto de 1994"
5,4,14,246,384,378,762,"21 de agosto de 1994"
5,4,14,247,33,29,62,"21 de agosto de 1994"
5,4,14,248,76,52,128,"21 de agosto de 1994"
5,4,14,249,200,188,388,"21 de agosto de 1994"
5,4,19,444,217,252,469,"21 de agosto de 1994"
5,4,19,445,406,441,847,"21 de agosto de 1994"
5,4,19,446,431,427,858,"21 de agosto de 1994"
5,4,19,447,382,410,792,"21 de agosto de 1994"
5,4,19,448,234,230,464,"21 de agosto de 1994"
5,4,19,449,269,258,527,"21 de agosto de 1994"
5,4,22,508,484,443,927,"21 de agosto de 1994"
5,4,22,509,343,308,651,"21 de agosto de 1994"
5,4,22,510,507,405,912,"21 de agosto de 1994"
5,4,22,511,397,382,779,"21 de agosto de 1994"
5,4,22,512,297,306,603,"21 de agosto de 1994"
5,4,22,513,287,283,570,"21 de agosto de 1994"
5,4,22,514,385,381,766,"21 de agosto de 1994"
5,4,22,515,581,535,1116,"21 de agosto de 1994"
5,4,22,516,447,423,870,"21 de agosto de 1994"
5,4,22,517,297,328,625,"21 de agosto de 1994"
5,4,22,518,244,233,477,"21 de agosto de 1994"
5,4,22,519,228,236,464,"21 de agosto de 1994"
5,4,22,520,81,82,163,"21 de agosto de 1994"
5,4,22,521,32,27,59,"21 de agosto de 1994"
5,4,22,522,33,35,68,"21 de agosto de 1994"
5,4,22,523,112,105,217,"21 de agosto de 1994"
5,4,22,524,20,13,33,"21 de agosto de 1994"
5,4,22,525,114,91,205,"21 de agosto de 1994"
5,4,25,577,233,267,500,"21 de agosto de 1994"
5,4,25,578,398,432,830,"21 de agosto de 1994"
5,4,25,579,313,340,653,"21 de agosto de 1994"
5,4,25,580,306,315,621,"21 de agosto de 1994"
5,4,25,581,424,484,908,"21 de agosto de 1994"
5,4,25,582,198,224,422,"21 de agosto de 1994"
5,4,25,583,257,313,570,"21 de agosto de 1994"
5,4,25,584,299,322,621,"21 de agosto de 1994"
5,4,25,585,418,428,846,"21 de agosto de 1994"
5,4,25,586,543,556,1099,"21 de agosto de 1994"
5,4,25,587,822,900,1722,"21 de agosto de 1994"
5,4,25,588,526,558,1084,"21 de agosto de 1994"
5,4,25,589,220,233,453,"21 de agosto de 1994"
5,4,25,590,192,230,422,"21 de agosto de 1994"
5,4,25,591,367,436,803,"21 de agosto de 1994"
5,4,25,592,245,267,512,"21 de agosto de 1994"
5,4,25,593,324,325,649,"21 de agosto de 1994"
5,4,25,594,438,438,876,"21 de agosto de 1994"
5,4,25,595,440,473,913,"21 de agosto de 1994"
5,4,25,596,354,423,777,"21 de agosto de 1994"
5,4,25,597,425,533,958,"21 de agosto de 1994"
5,4,25,598,362,390,752,"21 de agosto de 1994"
5,4,25,599,277,309,586,"21 de agosto de 1994"
5,4,25,600,331,316,647,"21 de agosto de 1994"
5,4,25,601,443,495,938,"21 de agosto de 1994"
5,4,25,602,433,477,910,"21 de agosto de 1994"
5,4,25,603,357,402,759,"21 de agosto de 1994"
5,4,25,604,294,298,592,"21 de agosto de 1994"
5,4,25,605,332,402,734,"21 de agosto de 1994"
5,4,25,606,384,425,809,"21 de agosto de 1994"
5,4,25,607,285,299,584,"21 de agosto de 1994"
5,4,25,608,373,422,795,"21 de agosto de 1994"
5,4,25,609,361,400,761,"21 de agosto de 1994"
5,4,25,610,423,433,856,"21 de agosto de 1994"
5,4,25,611,1175,1322,2497,"21 de agosto de 1994"
5,4,25,612,531,581,1112,"21 de agosto de 1994"
5,4,25,613,625,697,1322,"21 de agosto de 1994"
5,4,25,614,460,563,1023,"21 de agosto de 1994"
5,4,25,615,303,392,695,"21 de agosto de 1994"
5,4,25,616,264,324,588,"21 de agosto de 1994"
5,4,25,617,425,478,903,"21 de agosto de 1994"
5,4,25,618,697,741,1438,"21 de agosto de 1994"
5,4,25,619,353,406,759,"21 de agosto de 1994"
5,4,25,620,528,604,1132,"21 de agosto de 1994"
5,4,25,621,584,636,1220,"21 de agosto de 1994"
5,4,25,622,383,392,775,"21 de agosto de 1994"
5,4,25,623,551,622,1173,"21 de agosto de 1994"
5,4,25,624,471,558,1029,"21 de agosto de 1994"
5,4,25,625,308,327,635,"21 de agosto de 1994"
5,4,25,626,353,378,731,"21 de agosto de 1994"
5,4,25,627,481,576,1057,"21 de agosto de 1994"
5,4,25,628,384,442,826,"21 de agosto de 1994"
5,4,25,629,301,321,622,"21 de agosto de 1994"
5,4,25,630,329,331,660,"21 de agosto de 1994"
5,4,25,631,405,367,772,"21 de agosto de 1994"
5,4,25,632,440,499,939,"21 de agosto de 1994"
5,4,25,633,340,411,751,"21 de agosto de 1994"
5,4,25,634,312,328,640,"21 de agosto de 1994"
5,4,25,635,204,250,454,"21 de agosto de 1994"
5,4,25,636,408,408,816,"21 de agosto de 1994"
5,4,25,637,367,387,754,"21 de agosto de 1994"
5,4,25,638,368,438,806,"21 de agosto de 1994"
5,4,25,639,574,602,1176,"21 de agosto de 1994"
5,4,25,640,716,800,1516,"21 de agosto de 1994"
5,4,25,641,536,561,1097,"21 de agosto de 1994"
5,4,25,642,92,94,186,"21 de agosto de 1994"
5,4,25,643,123,112,235,"21 de agosto de 1994"
5,4,25,644,58,38,96,"21 de agosto de 1994"
5,4,28,691,233,232,465,"21 de agosto de 1994"
5,4,28,692,579,635,1214,"21 de agosto de 1994"
5,4,28,693,763,784,1547,"21 de agosto de 1994"
5,4,28,694,552,663,1215,"21 de agosto de 1994"
5,4,28,695,440,498,938,"21 de agosto de 1994"
5,4,28,696,492,567,1059,"21 de agosto de 1994"
5,4,28,697,223,241,464,"21 de agosto de 1994"
5,4,28,698,419,456,875,"21 de agosto de 1994"
5,4,28,699,386,407,793,"21 de agosto de 1994"
5,4,28,700,323,391,714,"21 de agosto de 1994"
5,4,28,701,423,514,937,"21 de agosto de 1994"
5,4,28,702,496,604,1100,"21 de agosto de 1994"
5,4,28,703,458,504,962,"21 de agosto de 1994"
5,4,28,704,203,237,440,"21 de agosto de 1994"
5,4,28,705,332,395,727,"21 de agosto de 1994"
5,4,28,706,357,379,736,"21 de agosto de 1994"
5,4,28,707,407,438,845,"21 de agosto de 1994"
5,4,28,708,429,449,878,"21 de agosto de 1994"
5,4,28,709,502,545,1047,"21 de agosto de 1994"
5,4,28,710,481,511,992,"21 de agosto de 1994"
5,4,28,711,529,571,1100,"21 de agosto de 1994"
5,4,28,712,90,93,183,"21 de agosto de 1994"
5,4,28,713,71,65,136,"21 de agosto de 1994"
5,4,28,714,374,415,789,"21 de agosto de 1994"
5,4,28,715,436,471,907,"21 de agosto de 1994"
5,4,28,716,80,58,138,"21 de agosto de 1994"
5,4,28,717,275,289,564,"21 de agosto de 1994"
5,4,28,718,221,226,447,"21 de agosto de 1994"
5,4,28,719,228,262,490,"21 de agosto de 1994"
5,4,28,720,197,208,405,"21 de agosto de 1994"
5,4,28,721,318,350,668,"21 de agosto de 1994"
5,4,28,722,361,374,735,"21 de agosto de 1994"
5,4,28,723,531,556,1087,"21 de agosto de 1994"
5,4,28,724,506,574,1080,"21 de agosto de 1994"
5,4,28,725,334,391,725,"21 de agosto de 1994"
5,4,28,726,179,212,391,"21 de agosto de 1994"
5,4,28,727,74,68,142,"21 de agosto de 1994"
5,4,38,1506,325,330,655,"21 de agosto de 1994"
5,4,38,1507,330,357,687,"21 de agosto de 1994"
5,4,38,1508,426,460,886,"21 de agosto de 1994"
5,4,38,1509,330,375,705,"21 de agosto de 1994"
5,4,38,1510,205,229,434,"21 de agosto de 1994"
5,4,38,1511,366,393,759,"21 de agosto de 1994"
5,4,38,1512,356,395,751,"21 de agosto de 1994"
5,4,38,1513,272,278,550,"21 de agosto de 1994"
5,4,38,1514,25,14,39,"21 de agosto de 1994"
5,4,38,1515,122,63,185,"21 de agosto de 1994"
5,4,38,1516,183,166,349,"21 de agosto de 1994"
5,4,38,1517,93,78,171,"21 de agosto de 1994"
5,4,38,1518,64,49,113,"21 de agosto de 1994"
5,4,38,1519,31,17,48,"21 de agosto de 1994"
5,4,38,1520,124,124,248,"21 de agosto de 1994"
5,5,4,57,658,667,1325,"21 de agosto de 1994"
5,5,4,58,207,189,396,"21 de agosto de 1994"
5,5,4,59,531,509,1040,"21 de agosto de 1994"
5,5,4,60,30,26,56,"21 de agosto de 1994"
5,5,4,61,85,67,152,"21 de agosto de 1994"
5,5,4,62,59,55,114,"21 de agosto de 1994"
5,5,4,63,318,306,624,"21 de agosto de 1994"
5,5,4,64,387,348,735,"21 de agosto de 1994"
5,5,4,65,34,24,58,"21 de agosto de 1994"
5,5,4,66,240,198,438,"21 de agosto de 1994"
5,5,4,67,52,52,104,"21 de agosto de 1994"
5,5,4,68,161,125,286,"21 de agosto de 1994"
5,5,4,69,334,288,622,"21 de agosto de 1994"
5,5,4,70,171,147,318,"21 de agosto de 1994"
5,5,4,71,88,68,156,"21 de agosto de 1994"
5,5,4,72,46,35,81,"21 de agosto de 1994"
5,5,4,73,90,68,158,"21 de agosto de 1994"
5,5,4,74,177,161,338,"21 de agosto de 1994"
5,5,4,75,626,540,1166,"21 de agosto de 1994"
5,5,4,76,57,49,106,"21 de agosto de 1994"
5,5,4,77,74,56,130,"21 de agosto de 1994"
5,5,4,78,319,285,604,"21 de agosto de 1994"
5,5,4,79,416,358,774,"21 de agosto de 1994"
5,5,4,80,122,96,218,"21 de agosto de 1994"
5,5,6,84,345,349,694,"21 de agosto de 1994"
5,5,6,85,198,218,416,"21 de agosto de 1994"
5,5,6,86,152,173,325,"21 de agosto de 1994"
5,5,6,87,510,538,1048,"21 de agosto de 1994"
5,5,6,88,538,565,1103,"21 de agosto de 1994"
5,5,6,89,516,535,1051,"21 de agosto de 1994"
5,5,6,90,272,293,565,"21 de agosto de 1994"
5,5,6,91,400,385,785,"21 de agosto de 1994"
5,5,6,92,326,374,700,"21 de agosto de 1994"
5,5,6,93,360,421,781,"21 de agosto de 1994"
5,5,6,94,598,601,1199,"21 de agosto de 1994"
5,5,6,95,351,349,700,"21 de agosto de 1994"
5,5,6,96,476,518,994,"21 de agosto de 1994"
5,5,6,97,124,111,235,"21 de agosto de 1994"
5,5,6,98,70,53,123,"21 de agosto de 1994"
5,5,6,99,51,37,88,"21 de agosto de 1994"
5,5,6,100,27,16,43,"21 de agosto de 1994"
5,5,6,101,65,29,94,"21 de agosto de 1994"
5,5,6,102,73,51,124,"21 de agosto de 1994"
5,5,6,103,42,22,64,"21 de agosto de 1994"
5,5,6,104,118,99,217,"21 de agosto de 1994"
5,5,6,105,58,52,110,"21 de agosto de 1994"
5,5,6,106,66,54,120,"21 de agosto de 1994"
5,5,6,107,46,30,76,"21 de agosto de 1994"
5,5,6,108,74,54,128,"21 de agosto de 1994"
5,5,6,109,78,45,123,"21 de agosto de 1994"
5,5,10,173,338,344,682,"21 de agosto de 1994"
5,5,10,174,431,422,853,"21 de agosto de 1994"
5,5,10,175,390,394,784,"21 de agosto de 1994"
5,5,10,176,388,407,795,"21 de agosto de 1994"
5,5,10,177,485,486,971,"21 de agosto de 1994"
5,5,10,178,452,459,911,"21 de agosto de 1994"
5,5,10,179,516,516,1032,"21 de agosto de 1994"
5,5,10,180,509,516,1025,"21 de agosto de 1994"
5,5,10,181,208,216,424,"21 de agosto de 1994"
5,5,10,182,396,410,806,"21 de agosto de 1994"
5,5,10,183,397,374,771,"21 de agosto de 1994"
5,5,10,184,250,254,504,"21 de agosto de 1994"
5,5,10,185,558,526,1084,"21 de agosto de 1994"
5,5,10,186,434,505,939,"21 de agosto de 1994"
5,5,10,187,500,526,1026,"21 de agosto de 1994"
5,5,10,188,425,442,867,"21 de agosto de 1994"
5,5,10,189,219,194,413,"21 de agosto de 1994"
5,5,10,190,477,489,966,"21 de agosto de 1994"
5,5,10,191,119,127,246,"21 de agosto de 1994"
5,5,10,192,618,568,1186,"21 de agosto de 1994"
5,5,10,193,555,608,1163,"21 de agosto de 1994"
5,5,10,194,306,347,653,"21 de agosto de 1994"
5,5,10,195,510,554,1064,"21 de agosto de 1994"
5,5,10,196,356,370,726,"21 de agosto de 1994"
5,5,10,197,573,621,1194,"21 de agosto de 1994"
5,5,10,198,388,380,768,"21 de agosto de 1994"
5,5,10,199,573,572,1145,"21 de agosto de 1994"
5,5,10,200,541,539,1080,"21 de agosto de 1994"
5,5,10,201,360,358,718,"21 de agosto de 1994"
5,5,10,202,437,440,877,"21 de agosto de 1994"
5,5,10,203,455,468,923,"21 de agosto de 1994"
5,5,10,204,471,457,928,"21 de agosto de 1994"
5,5,10,205,206,195,401,"21 de agosto de 1994"
5,5,10,206,415,421,836,"21 de agosto de 1994"
5,5,10,207,456,432,888,"21 de agosto de 1994"
5,5,10,208,437,440,877,"21 de agosto de 1994"
5,5,10,209,373,386,759,"21 de agosto de 1994"
5,5,10,210,401,411,812,"21 de agosto de 1994"
5,5,10,211,411,396,807,"21 de agosto de 1994"
5,5,10,212,359,355,714,"21 de agosto de 1994"
5,5,10,213,75,55,130,"21 de agosto de 1994"
5,5,11,214,382,304,686,"21 de agosto de 1994"
5,5,11,215,323,308,631,"21 de agosto de 1994"
5,5,11,216,413,397,810,"21 de agosto de 1994"
5,5,11,217,281,212,493,"21 de agosto de 1994"
5,5,11,218,144,147,291,"21 de agosto de 1994"
5,5,11,219,53,39,92,"21 de agosto de 1994"
5,5,11,220,171,127,298,"21 de agosto de 1994"
5,5,11,221,31,34,65,"21 de agosto de 1994"
5,5,11,222,258,217,475,"21 de agosto de 1994"
5,5,11,223,235,192,427,"21 de agosto de 1994"
5,5,11,224,34,28,62,"21 de agosto de 1994"
5,5,11,225,195,163,358,"21 de agosto de 1994"
5,5,11,226,122,89,211,"21 de agosto de 1994"
5,5,11,227,180,141,321,"21 de agosto de 1994"
5,5,11,228,143,115,258,"21 de agosto de 1994"
5,5,11,229,139,111,250,"21 de agosto de 1994"
5,5,11,230,91,76,167,"21 de agosto de 1994"
5,5,11,231,267,226,493,"21 de agosto de 1994"
5,5,11,232,24,18,42,"21 de agosto de 1994"
5,5,24,542,242,234,476,"21 de agosto de 1994"
5,5,24,543,649,732,1381,"21 de agosto de 1994"
5,5,24,544,400,431,831,"21 de agosto de 1994"
5,5,24,545,433,496,929,"21 de agosto de 1994"
5,5,24,546,383,359,742,"21 de agosto de 1994"
5,5,24,547,446,500,946,"21 de agosto de 1994"
5,5,24,548,215,220,435,"21 de agosto de 1994"
5,5,24,549,528,528,1056,"21 de agosto de 1994"
5,5,24,550,653,766,1419,"21 de agosto de 1994"
5,5,24,551,498,587,1085,"21 de agosto de 1994"
5,5,24,552,264,278,542,"21 de agosto de 1994"
5,5,24,553,293,311,604,"21 de agosto de 1994"
5,5,24,554,416,469,885,"21 de agosto de 1994"
5,5,24,555,281,352,633,"21 de agosto de 1994"
5,5,24,556,384,441,825,"21 de agosto de 1994"
5,5,24,557,452,482,934,"21 de agosto de 1994"
5,5,24,558,489,519,1008,"21 de agosto de 1994"
5,5,24,559,205,192,397,"21 de agosto de 1994"
5,5,24,560,178,150,328,"21 de agosto de 1994"
5,5,24,561,67,50,117,"21 de agosto de 1994"
5,5,24,562,120,105,225,"21 de agosto de 1994"
5,5,24,563,151,110,261,"21 de agosto de 1994"
5,5,24,564,180,143,323,"21 de agosto de 1994"
5,5,24,565,276,207,483,"21 de agosto de 1994"
5,5,24,566,389,296,685,"21 de agosto de 1994"
5,5,24,567,378,321,699,"21 de agosto de 1994"
5,5,24,568,202,154,356,"21 de agosto de 1994"
5,5,24,569,257,201,458,"21 de agosto de 1994"
5,5,24,570,140,123,263,"21 de agosto de 1994"
5,5,24,571,382,300,682,"21 de agosto de 1994"
5,5,24,572,48,26,74,"21 de agosto de 1994"
5,5,24,573,322,230,552,"21 de agosto de 1994"
5,5,24,574,177,152,329,"21 de agosto de 1994"
5,5,24,575,216,179,395,"21 de agosto de 1994"
5,5,24,576,61,28,89,"21 de agosto de 1994"
5,5,27,652,301,334,635,"21 de agosto de 1994"
5,5,27,653,211,198,409,"21 de agosto de 1994"
5,5,27,654,452,457,909,"21 de agosto de 1994"
5,5,27,655,528,597,1125,"21 de agosto de 1994"
5,5,27,656,249,293,542,"21 de agosto de 1994"
5,5,27,657,462,500,962,"21 de agosto de 1994"
5,5,27,658,248,285,533,"21 de agosto de 1994"
5,5,27,659,434,438,872,"21 de agosto de 1994"
5,5,27,660,442,423,865,"21 de agosto de 1994"
5,5,27,661,515,552,1067,"21 de agosto de 1994"
5,5,27,662,295,297,592,"21 de agosto de 1994"
5,5,27,663,401,416,817,"21 de agosto de 1994"
5,5,27,664,387,434,821,"21 de agosto de 1994"
5,5,27,665,105,77,182,"21 de agosto de 1994"
5,5,27,666,116,84,200,"21 de agosto de 1994"
5,5,27,667,137,109,246,"21 de agosto de 1994"
5,5,27,668,38,38,76,"21 de agosto de 1994"
5,5,27,669,174,129,303,"21 de agosto de 1994"
5,5,27,670,103,73,176,"21 de agosto de 1994"
5,5,27,671,162,131,293,"21 de agosto de 1994"
5,5,27,672,45,42,87,"21 de agosto de 1994"
5,5,27,673,362,355,717,"21 de agosto de 1994"
5,5,27,674,76,60,136,"21 de agosto de 1994"
5,5,27,675,33,23,56,"21 de agosto de 1994"
5,5,27,676,210,176,386,"21 de agosto de 1994"
5,5,27,677,177,152,329,"21 de agosto de 1994"
5,5,27,678,56,48,104,"21 de agosto de 1994"
5,5,27,679,63,42,105,"21 de agosto de 1994"
5,5,27,680,43,43,86,"21 de agosto de 1994"
5,5,27,681,91,66,157,"21 de agosto de 1994"
5,5,27,682,48,37,85,"21 de agosto de 1994"
5,5,27,683,68,61,129,"21 de agosto de 1994"
5,5,27,684,109,102,211,"21 de agosto de 1994"
5,5,27,685,106,88,194,"21 de agosto de 1994"
5,5,27,686,152,142,294,"21 de agosto de 1994"
5,5,27,687,53,37,90,"21 de agosto de 1994"
5,5,27,688,71,66,137,"21 de agosto de 1994"
5,5,27,689,108,81,189,"21 de agosto de 1994"
5,5,27,690,52,41,93,"21 de agosto de 1994"
5,5,30,1000,117,87,204,"21 de agosto de 1994"
5,5,30,1001,132,103,235,"21 de agosto de 1994"
5,5,30,1002,133,119,252,"21 de agosto de 1994"
5,5,30,1003,54,47,101,"21 de agosto de 1994"
5,5,30,1004,89,115,204,"21 de agosto de 1994"
5,5,30,1005,134,102,236,"21 de agosto de 1994"
5,5,30,1006,650,395,1045,"21 de agosto de 1994"
5,5,30,1007,120,105,225,"21 de agosto de 1994"
5,5,30,1008,138,112,250,"21 de agosto de 1994"
5,5,30,1009,326,228,554,"21 de agosto de 1994"
5,5,30,1010,108,106,214,"21 de agosto de 1994"
5,5,30,1011,400,338,738,"21 de agosto de 1994"
5,5,30,1012,65,55,120,"21 de agosto de 1994"
5,5,30,1013,72,51,123,"21 de agosto de 1994"
5,5,30,1014,320,300,620,"21 de agosto de 1994"
5,5,30,1015,138,119,257,"21 de agosto de 1994"
5,5,30,1016,123,113,236,"21 de agosto de 1994"
5,5,30,1017,71,53,124,"21 de agosto de 1994"
5,5,30,1018,59,65,124,"21 de agosto de 1994"
5,5,30,1019,101,74,175,"21 de agosto de 1994"
5,5,30,1020,91,71,162,"21 de agosto de 1994"
5,5,30,1021,78,77,155,"21 de agosto de 1994"
5,5,30,1022,86,83,169,"21 de agosto de 1994"
5,5,30,1023,107,79,186,"21 de agosto de 1994"
5,5,30,1024,48,43,91,"21 de agosto de 1994"
5,5,30,1025,166,126,292,"21 de agosto de 1994"
5,5,30,1026,135,133,268,"21 de agosto de 1994"
5,5,30,1027,61,62,123,"21 de agosto de 1994"
5,5,30,1028,64,55,119,"21 de agosto de 1994"
5,5,30,1029,110,81,191,"21 de agosto de 1994"
5,5,30,1030,72,54,126,"21 de agosto de 1994"
5,5,30,1031,168,152,320,"21 de agosto de 1994"
5,5,30,1032,56,45,101,"21 de agosto de 1994"
5,5,30,1033,128,111,239,"21 de agosto de 1994"
5,5,30,1034,83,76,159,"21 de agosto de 1994"
5,5,30,1035,96,76,172,"21 de agosto de 1994"
5,5,30,1036,94,75,169,"21 de agosto de 1994"
5,5,30,1037,38,34,72,"21 de agosto de 1994"
5,5,30,1038,196,175,371,"21 de agosto de 1994"
5,5,30,1039,177,168,345,"21 de agosto de 1994"
5,6,9,131,566,546,1112,"21 de agosto de 1994"
5,6,9,132,298,290,588,"21 de agosto de 1994"
5,6,9,133,234,272,506,"21 de agosto de 1994"
5,6,9,134,440,477,917,"21 de agosto de 1994"
5,6,9,135,534,581,1115,"21 de agosto de 1994"
5,6,9,136,410,483,893,"21 de agosto de 1994"
5,6,9,137,171,181,352,"21 de agosto de 1994"
5,6,9,138,344,390,734,"21 de agosto de 1994"
5,6,9,139,424,481,905,"21 de agosto de 1994"
5,6,9,140,231,268,499,"21 de agosto de 1994"
5,6,9,141,366,411,777,"21 de agosto de 1994"
5,6,9,142,332,358,690,"21 de agosto de 1994"
5,6,9,143,488,553,1041,"21 de agosto de 1994"
5,6,9,144,494,578,1072,"21 de agosto de 1994"
5,6,9,145,401,429,830,"21 de agosto de 1994"
5,6,9,146,550,543,1093,"21 de agosto de 1994"
5,6,9,147,332,399,731,"21 de agosto de 1994"
5,6,9,148,305,267,572,"21 de agosto de 1994"
5,6,9,149,99,74,173,"21 de agosto de 1994"
5,6,9,150,197,207,404,"21 de agosto de 1994"
5,6,9,151,66,61,127,"21 de agosto de 1994"
5,6,9,152,253,277,530,"21 de agosto de 1994"
5,6,9,153,211,213,424,"21 de agosto de 1994"
5,6,9,154,211,202,413,"21 de agosto de 1994"
5,6,9,155,181,179,360,"21 de agosto de 1994"
5,6,9,156,276,288,564,"21 de agosto de 1994"
5,6,9,157,377,367,744,"21 de agosto de 1994"
5,6,9,158,249,246,495,"21 de agosto de 1994"
5,6,9,159,401,397,798,"21 de agosto de 1994"
5,6,9,160,216,221,437,"21 de agosto de 1994"
5,6,9,161,257,258,515,"21 de agosto de 1994"
5,6,9,162,519,557,1076,"21 de agosto de 1994"
5,6,9,163,190,207,397,"21 de agosto de 1994"
5,6,9,164,164,172,336,"21 de agosto de 1994"
5,6,9,165,253,252,505,"21 de agosto de 1994"
5,6,9,166,239,242,481,"21 de agosto de 1994"
5,6,9,167,129,96,225,"21 de agosto de 1994"
5,6,9,168,465,465,930,"21 de agosto de 1994"
5,6,9,169,523,535,1058,"21 de agosto de 1994"
5,6,9,170,206,191,397,"21 de agosto de 1994"
5,6,9,171,342,312,654,"21 de agosto de 1994"
5,6,9,172,195,200,395,"21 de agosto de 1994"
5,6,17,257,321,346,667,"21 de agosto de 1994"
5,6,17,258,530,541,1071,"21 de agosto de 1994"
5,6,17,259,480,496,976,"21 de agosto de 1994"
5,6,17,260,494,541,1035,"21 de agosto de 1994"
5,6,17,261,514,611,1125,"21 de agosto de 1994"
5,6,17,262,688,722,1410,"21 de agosto de 1994"
5,6,17,263,615,663,1278,"21 de agosto de 1994"
5,6,17,264,375,393,768,"21 de agosto de 1994"
5,6,17,265,483,521,1004,"21 de agosto de 1994"
5,6,17,266,531,613,1144,"21 de agosto de 1994"
5,6,17,267,465,544,1009,"21 de agosto de 1994"
5,6,17,268,152,193,345,"21 de agosto de 1994"
5,6,17,269,680,781,1461,"21 de agosto de 1994"
5,6,17,270,387,458,845,"21 de agosto de 1994"
5,6,17,271,632,725,1357,"21 de agosto de 1994"
5,6,17,272,602,680,1282,"21 de agosto de 1994"
5,6,17,273,384,417,801,"21 de agosto de 1994"
5,6,17,274,447,505,952,"21 de agosto de 1994"
5,6,17,275,291,311,602,"21 de agosto de 1994"
5,6,17,276,335,350,685,"21 de agosto de 1994"
5,6,17,277,203,203,406,"21 de agosto de 1994"
5,6,17,278,253,219,472,"21 de agosto de 1994"
5,6,17,279,307,322,629,"21 de agosto de 1994"
5,6,17,280,582,650,1232,"21 de agosto de 1994"
5,6,17,281,231,229,460,"21 de agosto de 1994"
5,6,17,282,297,297,594,"21 de agosto de 1994"
5,6,17,283,388,384,772,"21 de agosto de 1994"
5,6,17,284,374,419,793,"21 de agosto de 1994"
5,6,17,285,431,439,870,"21 de agosto de 1994"
5,6,17,286,472,445,917,"21 de agosto de 1994"
5,6,17,287,606,614,1220,"21 de agosto de 1994"
5,6,17,288,497,541,1038,"21 de agosto de 1994"
5,6,17,289,309,294,603,"21 de agosto de 1994"
5,6,17,290,521,528,1049,"21 de agosto de 1994"
5,6,17,291,529,513,1042,"21 de agosto de 1994"
5,6,17,292,193,200,393,"21 de agosto de 1994"
5,6,17,293,387,371,758,"21 de agosto de 1994"
5,6,17,294,315,348,663,"21 de agosto de 1994"
5,6,17,295,197,163,360,"21 de agosto de 1994"
5,6,17,296,340,275,615,"21 de agosto de 1994"
5,6,17,297,536,533,1069,"21 de agosto de 1994"
5,6,17,298,392,359,751,"21 de agosto de 1994"
5,6,17,299,168,155,323,"21 de agosto de 1994"
5,6,17,300,191,193,384,"21 de agosto de 1994"
5,6,17,301,225,223,448,"21 de agosto de 1994"
5,6,17,302,246,238,484,"21 de agosto de 1994"
5,6,17,303,315,312,627,"21 de agosto de 1994"
5,6,17,304,333,363,696,"21 de agosto de 1994"
5,6,17,305,751,782,1533,"21 de agosto de 1994"
5,6,17,306,588,594,1182,"21 de agosto de 1994"
5,6,17,307,372,358,730,"21 de agosto de 1994"
5,6,17,308,282,300,582,"21 de agosto de 1994"
5,6,17,309,151,132,283,"21 de agosto de 1994"
5,6,17,310,317,307,624,"21 de agosto de 1994"
5,6,17,311,197,174,371,"21 de agosto de 1994"
5,6,17,312,440,469,909,"21 de agosto de 1994"
5,6,17,313,168,155,323,"21 de agosto de 1994"
5,6,17,314,327,294,621,"21 de agosto de 1994"
5,6,17,315,145,142,287,"21 de agosto de 1994"
5,6,17,316,70,72,142,"21 de agosto de 1994"
5,6,17,317,91,86,177,"21 de agosto de 1994"
5,6,17,318,295,329,624,"21 de agosto de 1994"
5,6,35,1310,207,224,431,"21 de agosto de 1994"
5,6,35,1311,441,472,913,"21 de agosto de 1994"
5,6,35,1312,427,442,869,"21 de agosto de 1994"
5,6,35,1313,422,467,889,"21 de agosto de 1994"
5,6,35,1314,352,383,735,"21 de agosto de 1994"
5,6,35,1315,447,488,935,"21 de agosto de 1994"
5,6,35,1316,365,423,788,"21 de agosto de 1994"
5,6,35,1317,468,509,977,"21 de agosto de 1994"
5,6,35,1318,454,489,943,"21 de agosto de 1994"
5,6,35,1319,370,448,818,"21 de agosto de 1994"
5,6,35,1320,571,626,1197,"21 de agosto de 1994"
5,6,35,1321,215,226,441,"21 de agosto de 1994"
5,6,35,1322,470,497,967,"21 de agosto de 1994"
5,6,35,1323,525,623,1148,"21 de agosto de 1994"
5,6,35,1324,456,522,978,"21 de agosto de 1994"
5,6,35,1325,445,502,947,"21 de agosto de 1994"
5,6,35,1326,489,587,1076,"21 de agosto de 1994"
5,6,35,1327,549,581,1130,"21 de agosto de 1994"
5,6,35,1328,460,529,989,"21 de agosto de 1994"
5,6,35,1329,648,659,1307,"21 de agosto de 1994"
5,6,35,1330,509,548,1057,"21 de agosto de 1994"
5,6,35,1331,459,540,999,"21 de agosto de 1994"
5,6,35,1332,454,512,966,"21 de agosto de 1994"
5,6,35,1333,455,526,981,"21 de agosto de 1994"
5,6,35,1334,415,516,931,"21 de agosto de 1994"
5,6,35,1335,258,304,562,"21 de agosto de 1994"
5,6,35,1336,510,551,1061,"21 de agosto de 1994"
5,6,35,1337,454,498,952,"21 de agosto de 1994"
5,6,35,1338,530,578,1108,"21 de agosto de 1994"
5,6,35,1339,530,594,1124,"21 de agosto de 1994"
5,6,35,1340,451,507,958,"21 de agosto de 1994"
5,6,35,1341,421,481,902,"21 de agosto de 1994"
5,6,35,1342,506,555,1061,"21 de agosto de 1994"
5,6,35,1343,665,761,1426,"21 de agosto de 1994"
5,6,35,1344,339,370,709,"21 de agosto de 1994"
5,6,35,1345,551,604,1155,"21 de agosto de 1994"
5,6,35,1346,465,546,1011,"21 de agosto de 1994"
5,6,35,1347,388,443,831,"21 de agosto de 1994"
5,6,35,1348,364,435,799,"21 de agosto de 1994"
5,6,35,1349,435,490,925,"21 de agosto de 1994"
5,6,35,1350,1654,1948,3602,"21 de agosto de 1994"
5,6,35,1351,234,258,492,"21 de agosto de 1994"
5,6,35,1352,178,202,380,"21 de agosto de 1994"
5,6,35,1353,352,393,745,"21 de agosto de 1994"
5,6,35,1354,762,640,1402,"21 de agosto de 1994"
5,6,35,1355,477,541,1018,"21 de agosto de 1994"
5,6,35,1356,362,423,785,"21 de agosto de 1994"
5,6,35,1357,294,348,642,"21 de agosto de 1994"
5,6,35,1358,399,430,829,"21 de agosto de 1994"
5,6,35,1359,315,334,649,"21 de agosto de 1994"
5,6,35,1360,894,1025,1919,"21 de agosto de 1994"
5,6,35,1361,358,410,768,"21 de agosto de 1994"
5,6,35,1362,425,523,948,"21 de agosto de 1994"
5,6,35,1363,472,490,962,"21 de agosto de 1994"
5,6,35,1364,319,391,710,"21 de agosto de 1994"
5,6,35,1365,1435,1603,3038,"21 de agosto de 1994"
5,6,35,1366,329,412,741,"21 de agosto de 1994"
5,6,35,1367,567,674,1241,"21 de agosto de 1994"
5,6,35,1368,608,654,1262,"21 de agosto de 1994"
5,6,35,1369,421,528,949,"21 de agosto de 1994"
5,6,35,1370,248,326,574,"21 de agosto de 1994"
5,6,35,1371,370,439,809,"21 de agosto de 1994"
5,6,35,1372,386,451,837,"21 de agosto de 1994"
5,6,35,1373,488,595,1083,"21 de agosto de 1994"
5,6,35,1374,504,656,1160,"21 de agosto de 1994"
5,6,35,1375,440,510,950,"21 de agosto de 1994"
5,6,35,1376,393,517,910,"21 de agosto de 1994"
5,6,35,1377,543,668,1211,"21 de agosto de 1994"
5,6,35,1378,411,504,915,"21 de agosto de 1994"
5,6,35,1379,296,387,683,"21 de agosto de 1994"
5,6,35,1380,501,632,1133,"21 de agosto de 1994"
5,6,35,1381,433,519,952,"21 de agosto de 1994"
5,6,35,1382,573,628,1201,"21 de agosto de 1994"
5,6,35,1383,427,462,889,"21 de agosto de 1994"
5,6,35,1384,590,706,1296,"21 de agosto de 1994"
5,6,35,1385,256,292,548,"21 de agosto de 1994"
5,6,35,1386,302,319,621,"21 de agosto de 1994"
5,6,35,1387,375,438,813,"21 de agosto de 1994"
5,6,35,1388,789,946,1735,"21 de agosto de 1994"
5,6,35,1389,266,323,589,"21 de agosto de 1994"
5,6,35,1390,479,527,1006,"21 de agosto de 1994"
5,6,35,1391,424,513,937,"21 de agosto de 1994"
5,6,35,1392,395,468,863,"21 de agosto de 1994"
5,6,35,1393,548,645,1193,"21 de agosto de 1994"
5,6,35,1394,285,358,643,"21 de agosto de 1994"
5,6,35,1395,501,619,1120,"21 de agosto de 1994"
5,6,35,1396,290,343,633,"21 de agosto de 1994"
5,6,35,1397,534,607,1141,"21 de agosto de 1994"
5,6,35,1398,619,744,1363,"21 de agosto de 1994"
5,6,35,1399,451,549,1000,"21 de agosto de 1994"
5,6,35,1400,359,460,819,"21 de agosto de 1994"
5,6,35,1401,376,445,821,"21 de agosto de 1994"
5,6,35,1402,492,573,1065,"21 de agosto de 1994"
5,6,35,1403,401,460,861,"21 de agosto de 1994"
5,6,35,1404,322,403,725,"21 de agosto de 1994"
5,6,35,1405,331,360,691,"21 de agosto de 1994"
5,6,35,1406,314,401,715,"21 de agosto de 1994"
5,6,35,1407,457,499,956,"21 de agosto de 1994"
5,6,35,1408,288,359,647,"21 de agosto de 1994"
5,6,35,1409,398,415,813,"21 de agosto de 1994"
5,6,35,1410,487,491,978,"21 de agosto de 1994"
5,6,35,1411,471,558,1029,"21 de agosto de 1994"
5,6,35,1412,308,319,627,"21 de agosto de 1994"
5,6,35,1413,358,389,747,"21 de agosto de 1994"
5,6,35,1414,427,475,902,"21 de agosto de 1994"
5,6,35,1415,398,432,830,"21 de agosto de 1994"
5,6,35,1416,327,388,715,"21 de agosto de 1994"
5,6,35,1417,309,370,679,"21 de agosto de 1994"
5,6,35,1418,378,451,829,"21 de agosto de 1994"
5,6,35,1419,317,390,707,"21 de agosto de 1994"
5,6,35,1420,422,502,924,"21 de agosto de 1994"
5,6,35,1421,370,440,810,"21 de agosto de 1994"
5,6,35,1422,349,409,758,"21 de agosto de 1994"
5,6,35,1423,345,388,733,"21 de agosto de 1994"
5,6,35,1424,423,472,895,"21 de agosto de 1994"
5,6,35,1425,418,469,887,"21 de agosto de 1994"
5,6,35,1426,490,529,1019,"21 de agosto de 1994"
5,6,35,1427,441,466,907,"21 de agosto de 1994"
5,6,35,1428,461,530,991,"21 de agosto de 1994"
5,6,35,1429,467,548,1015,"21 de agosto de 1994"
5,6,35,1430,456,528,984,"21 de agosto de 1994"
5,6,35,1431,425,470,895,"21 de agosto de 1994"
5,6,35,1432,477,540,1017,"21 de agosto de 1994"
5,6,35,1433,506,572,1078,"21 de agosto de 1994"
5,6,35,1434,483,540,1023,"21 de agosto de 1994"
5,6,35,1435,372,395,767,"21 de agosto de 1994"
5,6,35,1436,75,95,170,"21 de agosto de 1994"
5,6,35,1437,377,414,791,"21 de agosto de 1994"
5,6,35,1438,468,501,969,"21 de agosto de 1994"
5,6,35,1439,512,531,1043,"21 de agosto de 1994"
5,6,35,1440,434,457,891,"21 de agosto de 1994"
5,6,35,1441,346,395,741,"21 de agosto de 1994"
5,6,35,1442,650,716,1366,"21 de agosto de 1994"
5,6,35,1443,391,423,814,"21 de agosto de 1994"
5,6,35,1444,371,430,801,"21 de agosto de 1994"
5,6,35,1445,570,583,1153,"21 de agosto de 1994"
5,6,35,1446,378,390,768,"21 de agosto de 1994"
5,6,35,1447,295,339,634,"21 de agosto de 1994"
5,6,35,1448,291,340,631,"21 de agosto de 1994"
5,6,35,1449,308,352,660,"21 de agosto de 1994"
5,6,35,1450,278,333,611,"21 de agosto de 1994"
5,6,35,1451,446,502,948,"21 de agosto de 1994"
5,6,35,1452,355,413,768,"21 de agosto de 1994"
5,6,35,1453,370,403,773,"21 de agosto de 1994"
5,6,35,1454,356,396,752,"21 de agosto de 1994"
5,6,35,1455,320,356,676,"21 de agosto de 1994"
5,6,35,1456,277,271,548,"21 de agosto de 1994"
5,6,35,1457,226,265,491,"21 de agosto de 1994"
5,6,35,1458,252,261,513,"21 de agosto de 1994"
5,6,35,1459,506,507,1013,"21 de agosto de 1994"
5,6,35,1460,576,557,1133,"21 de agosto de 1994"
5,6,35,1461,614,589,1203,"21 de agosto de 1994"
5,6,35,1462,655,624,1279,"21 de agosto de 1994"
5,6,35,1463,538,576,1114,"21 de agosto de 1994"
5,6,35,1464,450,466,916,"21 de agosto de 1994"
5,6,35,1465,596,620,1216,"21 de agosto de 1994"
5,6,35,1466,362,412,774,"21 de agosto de 1994"
5,6,35,1467,559,572,1131,"21 de agosto de 1994"
5,6,35,1468,240,250,490,"21 de agosto de 1994"
5,6,35,1469,609,603,1212,"21 de agosto de 1994"
5,6,35,1470,436,412,848,"21 de agosto de 1994"
5,6,35,1471,133,121,254,"21 de agosto de 1994"
5,6,35,1472,172,178,350,"21 de agosto de 1994"
5,6,35,1473,209,219,428,"21 de agosto de 1994"
5,6,35,1474,96,99,195,"21 de agosto de 1994"
5,6,36,1475,420,419,839,"21 de agosto de 1994"
5,6,36,1476,608,560,1168,"21 de agosto de 1994"
5,6,36,1477,135,107,242,"21 de agosto de 1994"
5,6,36,1478,213,227,440,"21 de agosto de 1994"
5,6,36,1479,256,222,478,"21 de agosto de 1994"
5,6,36,1480,120,116,236,"21 de agosto de 1994"
5,6,36,1481,124,117,241,"21 de agosto de 1994"
5,6,36,1482,177,169,346,"21 de agosto de 1994"
5,6,36,1483,159,175,334,"21 de agosto de 1994"
5,6,36,1484,298,305,603,"21 de agosto de 1994"
5,6,36,1485,334,334,668,"21 de agosto de 1994"
5,6,36,1486,169,151,320,"21 de agosto de 1994"
5,6,36,1487,22,16,38,"21 de agosto de 1994"
5,6,36,1488,84,57,141,"21 de agosto de 1994"
5,6,36,1489,315,288,603,"21 de agosto de 1994"
5,6,36,1490,559,543,1102,"21 de agosto de 1994"
5,6,36,1491,524,515,1039,"21 de agosto de 1994"
5,6,36,1492,366,374,740,"21 de agosto de 1994"
5,6,36,1493,314,313,627,"21 de agosto de 1994"
5,6,36,1494,79,41,120,"21 de agosto de 1994"
5,6,36,1495,78,64,142,"21 de agosto de 1994"
5,6,36,1496,89,77,166,"21 de agosto de 1994"
5,6,36,1497,186,166,352,"21 de agosto de 1994"
5,7,7,110,220,228,448,"21 de agosto de 1994"
5,7,7,111,427,431,858,"21 de agosto de 1994"
5,7,7,112,289,293,582,"21 de agosto de 1994"
5,7,7,113,358,396,754,"21 de agosto de 1994"
5,7,7,114,358,367,725,"21 de agosto de 1994"
5,7,7,115,372,358,730,"21 de agosto de 1994"
5,7,7,116,409,379,788,"21 de agosto de 1994"
5,7,7,117,43,31,74,"21 de agosto de 1994"
5,7,7,118,48,33,81,"21 de agosto de 1994"
5,7,7,119,65,57,122,"21 de agosto de 1994"
5,7,7,120,38,22,60,"21 de agosto de 1994"
5,7,7,121,57,59,116,"21 de agosto de 1994"
5,7,7,122,159,109,268,"21 de agosto de 1994"
5,7,7,123,153,123,276,"21 de agosto de 1994"
5,7,7,124,72,46,118,"21 de agosto de 1994"
5,7,7,125,79,44,123,"21 de agosto de 1994"
5,7,7,126,96,80,176,"21 de agosto de 1994"
5,7,16,255,254,269,523,"21 de agosto de 1994"
5,7,16,256,345,314,659,"21 de agosto de 1994"
5,7,20,450,341,359,700,"21 de agosto de 1994"
5,7,20,451,400,443,843,"21 de agosto de 1994"
5,7,20,452,469,518,987,"21 de agosto de 1994"
5,7,20,453,514,557,1071,"21 de agosto de 1994"
5,7,20,454,584,695,1279,"21 de agosto de 1994"
5,7,20,455,363,381,744,"21 de agosto de 1994"
5,7,20,456,217,228,445,"21 de agosto de 1994"
5,7,20,457,557,554,1111,"21 de agosto de 1994"
5,7,20,458,505,539,1044,"21 de agosto de 1994"
5,7,20,459,445,527,972,"21 de agosto de 1994"
5,7,20,460,342,352,694,"21 de agosto de 1994"
5,7,20,461,522,528,1050,"21 de agosto de 1994"
5,7,20,462,450,584,1034,"21 de agosto de 1994"
5,7,20,463,221,237,458,"21 de agosto de 1994"
5,7,20,464,505,607,1112,"21 de agosto de 1994"
5,7,20,465,235,268,503,"21 de agosto de 1994"
5,7,20,466,290,296,586,"21 de agosto de 1994"
5,7,20,467,479,523,1002,"21 de agosto de 1994"
5,7,20,468,480,518,998,"21 de agosto de 1994"
5,7,20,469,427,456,883,"21 de agosto de 1994"
5,7,20,470,509,289,798,"21 de agosto de 1994"
5,7,20,471,29,7,36,"21 de agosto de 1994"
5,7,20,472,23,13,36,"21 de agosto de 1994"
5,7,20,473,270,262,532,"21 de agosto de 1994"
5,7,20,474,219,232,451,"21 de agosto de 1994"
5,7,20,475,251,255,506,"21 de agosto de 1994"
5,7,20,476,473,464,937,"21 de agosto de 1994"
5,7,20,477,338,357,695,"21 de agosto de 1994"
5,7,20,478,568,581,1149,"21 de agosto de 1994"
5,7,20,479,535,558,1093,"21 de agosto de 1994"
5,7,20,480,369,356,725,"21 de agosto de 1994"
5,7,20,481,291,298,589,"21 de agosto de 1994"
5,7,20,482,403,362,765,"21 de agosto de 1994"
5,7,20,483,318,350,668,"21 de agosto de 1994"
5,7,20,484,225,221,446,"21 de agosto de 1994"
5,7,20,485,232,224,456,"21 de agosto de 1994"
5,7,20,486,274,263,537,"21 de agosto de 1994"
5,7,20,487,158,147,305,"21 de agosto de 1994"
5,7,20,488,244,252,496,"21 de agosto de 1994"
5,7,20,489,362,383,745,"21 de agosto de 1994"
5,7,20,490,381,379,760,"21 de agosto de 1994"
5,7,20,491,75,68,143,"21 de agosto de 1994"
5,7,20,492,559,532,1091,"21 de agosto de 1994"
5,7,20,493,370,381,751,"21 de agosto de 1994"
5,7,20,494,235,248,483,"21 de agosto de 1994"
5,7,20,495,385,409,794,"21 de agosto de 1994"
5,7,20,496,276,286,562,"21 de agosto de 1994"
5,7,20,497,334,332,666,"21 de agosto de 1994"
5,7,20,498,197,194,391,"21 de agosto de 1994"
5,7,20,499,318,310,628,"21 de agosto de 1994"
5,7,23,526,405,422,827,"21 de agosto de 1994"
5,7,23,527,297,315,612,"21 de agosto de 1994"
5,7,23,528,105,90,195,"21 de agosto de 1994"
5,7,23,529,105,71,176,"21 de agosto de 1994"
5,7,23,530,111,93,204,"21 de agosto de 1994"
5,7,23,531,108,84,192,"21 de agosto de 1994"
5,7,23,532,271,231,502,"21 de agosto de 1994"
5,7,23,533,140,105,245,"21 de agosto de 1994"
5,7,23,534,134,112,246,"21 de agosto de 1994"
5,7,23,535,143,106,249,"21 de agosto de 1994"
5,7,23,536,107,63,170,"21 de agosto de 1994"
5,7,23,537,94,79,173,"21 de agosto de 1994"
5,7,23,538,76,73,149,"21 de agosto de 1994"
5,7,23,539,354,282,636,"21 de agosto de 1994"
5,7,23,540,391,359,750,"21 de agosto de 1994"
5,7,23,541,30,33,63,"21 de agosto de 1994"
5,7,29,728,300,296,596,"21 de agosto de 1994"
5,7,29,729,295,261,556,"21 de agosto de 1994"
5,7,32,1058,250,263,513,"21 de agosto de 1994"
5,7,32,1059,194,185,379,"21 de agosto de 1994"
5,7,32,1060,217,191,408,"21 de agosto de 1994"
5,7,32,1061,438,497,935,"21 de agosto de 1994"
5,7,32,1062,215,255,470,"21 de agosto de 1994"
5,7,32,1063,383,418,801,"21 de agosto de 1994"
5,7,32,1064,607,663,1270,"21 de agosto de 1994"
5,7,32,1065,260,273,533,"21 de agosto de 1994"
5,7,32,1066,341,343,684,"21 de agosto de 1994"
5,7,32,1067,439,488,927,"21 de agosto de 1994"
5,7,32,1068,504,558,1062,"21 de agosto de 1994"
5,7,32,1069,98,106,204,"21 de agosto de 1994"
5,7,32,1070,166,190,356,"21 de agosto de 1994"
5,7,32,1071,564,595,1159,"21 de agosto de 1994"
5,7,32,1072,467,542,1009,"21 de agosto de 1994"
5,7,32,1073,549,604,1153,"21 de agosto de 1994"
5,7,32,1074,341,355,696,"21 de agosto de 1994"
5,7,32,1075,268,325,593,"21 de agosto de 1994"
5,7,32,1076,552,594,1146,"21 de agosto de 1994"
5,7,32,1077,304,341,645,"21 de agosto de 1994"
5,7,32,1078,312,297,609,"21 de agosto de 1994"
5,7,32,1079,451,496,947,"21 de agosto de 1994"
5,7,32,1080,352,412,764,"21 de agosto de 1994"
5,7,32,1081,262,314,576,"21 de agosto de 1994"
5,7,32,1082,391,423,814,"21 de agosto de 1994"
5,7,32,1083,511,557,1068,"21 de agosto de 1994"
5,7,32,1084,405,436,841,"21 de agosto de 1994"
5,7,32,1085,269,337,606,"21 de agosto de 1994"
5,7,32,1086,389,463,852,"21 de agosto de 1994"
5,7,32,1087,285,306,591,"21 de agosto de 1994"
5,7,32,1088,218,240,458,"21 de agosto de 1994"
5,7,32,1089,118,161,279,"21 de agosto de 1994"
5,7,32,1090,129,134,263,"21 de agosto de 1994"
5,7,33,1091,193,198,391,"21 de agosto de 1994"
5,7,33,1092,78,65,143,"21 de agosto de 1994"
5,7,33,1093,510,553,1063,"21 de agosto de 1994"
5,7,33,1094,177,202,379,"21 de agosto de 1994"
5,7,33,1095,383,402,785,"21 de agosto de 1994"
5,7,33,1096,668,670,1338,"21 de agosto de 1994"
5,7,33,1097,310,330,640,"21 de agosto de 1994"
5,7,33,1098,731,755,1486,"21 de agosto de 1994"
5,7,33,1099,429,427,856,"21 de agosto de 1994"
5,7,33,1100,589,613,1202,"21 de agosto de 1994"
5,7,33,1101,303,364,667,"21 de agosto de 1994"
5,7,33,1102,282,322,604,"21 de agosto de 1994"
5,7,33,1103,535,564,1099,"21 de agosto de 1994"
5,7,33,1104,484,547,1031,"21 de agosto de 1994"
5,7,33,1105,300,304,604,"21 de agosto de 1994"
5,7,33,1106,213,213,426,"21 de agosto de 1994"
5,7,33,1107,179,192,371,"21 de agosto de 1994"
5,7,33,1108,474,462,936,"21 de agosto de 1994"
5,7,33,1109,423,487,910,"21 de agosto de 1994"
5,7,33,1110,223,222,445,"21 de agosto de 1994"
5,7,33,1111,631,753,1384,"21 de agosto de 1994"
5,7,33,1112,453,482,935,"21 de agosto de 1994"
5,7,33,1113,374,486,860,"21 de agosto de 1994"
5,7,33,1114,142,163,305,"21 de agosto de 1994"
5,7,33,1115,287,328,615,"21 de agosto de 1994"
5,7,33,1116,562,611,1173,"21 de agosto de 1994"
5,7,33,1117,509,532,1041,"21 de agosto de 1994"
5,7,33,1118,152,162,314,"21 de agosto de 1994"
5,7,33,1119,99,79,178,"21 de agosto de 1994"
5,7,33,1120,108,90,198,"21 de agosto de 1994"
5,7,33,1121,106,101,207,"21 de agosto de 1994"
5,7,33,1122,256,243,499,"21 de agosto de 1994"
5,7,33,1123,33,28,61,"21 de agosto de 1994"
5,7,33,1124,83,66,149,"21 de agosto de 1994"
5,7,33,1125,399,385,784,"21 de agosto de 1994"
5,7,33,1126,147,131,278,"21 de agosto de 1994"
5,7,33,1127,242,243,485,"21 de agosto de 1994"
5,7,33,1128,365,348,713,"21 de agosto de 1994"
5,7,33,1129,357,335,692,"21 de agosto de 1994"
5,7,33,1130,245,268,513,"21 de agosto de 1994"
5,7,33,1131,340,304,644,"21 de agosto de 1994"
5,7,33,1132,460,465,925,"21 de agosto de 1994"
5,7,33,1133,173,178,351,"21 de agosto de 1994"
5,7,33,1134,87,79,166,"21 de agosto de 1994"
5,7,33,1135,337,277,614,"21 de agosto de 1994"
5,7,33,1136,464,477,941,"21 de agosto de 1994"
5,7,33,1137,369,366,735,"21 de agosto de 1994"
5,7,33,1138,369,356,725,"21 de agosto de 1994"
5,7,33,1139,289,282,571,"21 de agosto de 1994"
5,7,33,1140,598,633,1231,"21 de agosto de 1994"
5,7,33,1141,557,571,1128,"21 de agosto de 1994"
5,7,33,1142,435,427,862,"21 de agosto de 1994"
5,7,33,1143,171,152,323,"21 de agosto de 1994"
5,7,33,1144,155,127,282,"21 de agosto de 1994"
5,7,33,1145,34,29,63,"21 de agosto de 1994"
5,7,33,1146,401,371,772,"21 de agosto de 1994"
5,7,33,1147,313,292,605,"21 de agosto de 1994"
5,7,33,1148,366,344,710,"21 de agosto de 1994"
5,7,33,1149,607,550,1157,"21 de agosto de 1994"
5,7,33,1150,158,156,314,"21 de agosto de 1994"
5,7,33,1151,251,257,508,"21 de agosto de 1994"
5,7,33,1152,129,113,242,"21 de agosto de 1994"
5,7,33,1153,240,216,456,"21 de agosto de 1994"
5,7,33,1154,304,279,583,"21 de agosto de 1994"
5,7,33,1155,231,216,447,"21 de agosto de 1994"
5,7,33,1156,428,438,866,"21 de agosto de 1994"
5,7,33,1157,528,479,1007,"21 de agosto de 1994"
5,7,33,1158,326,336,662,"21 de agosto de 1994"
5,7,33,1159,410,374,784,"21 de agosto de 1994"
5,7,33,1160,300,298,598,"21 de agosto de 1994"
5,7,33,1161,377,324,701,"21 de agosto de 1994"
5,7,33,1162,461,422,883,"21 de agosto de 1994"
5,7,33,1163,527,478,1005,"21 de agosto de 1994"
5,7,33,1164,178,162,340,"21 de agosto de 1994"
5,7,33,1165,157,137,294,"21 de agosto de 1994"
5,7,34,1166,196,175,371,"21 de agosto de 1994"
5,7,34,1167,604,423,1027,"21 de agosto de 1994"
5,7,34,1168,90,72,162,"21 de agosto de 1994"
5,7,34,1169,33,21,54,"21 de agosto de 1994"
5,7,34,1170,421,398,819,"21 de agosto de 1994"
5,7,34,1171,172,116,288,"21 de agosto de 1994"
6,1,1,1,458,489,947,"21 de agosto de 1994"
6,1,1,2,149,149,298,"21 de agosto de 1994"
6,1,1,3,563,704,1267,"21 de agosto de 1994"
6,1,1,4,266,331,597,"21 de agosto de 1994"
6,1,1,5,229,269,498,"21 de agosto de 1994"
6,1,1,6,347,395,742,"21 de agosto de 1994"
6,1,1,7,397,466,863,"21 de agosto de 1994"
6,1,1,8,515,603,1118,"21 de agosto de 1994"
6,1,1,9,405,472,877,"21 de agosto de 1994"
6,1,1,10,474,521,995,"21 de agosto de 1994"
6,1,1,11,282,317,599,"21 de agosto de 1994"
6,1,1,12,177,217,394,"21 de agosto de 1994"
6,1,1,13,260,312,572,"21 de agosto de 1994"
6,1,1,14,300,406,706,"21 de agosto de 1994"
6,1,1,15,239,321,560,"21 de agosto de 1994"
6,1,1,16,254,356,610,"21 de agosto de 1994"
6,1,1,17,329,400,729,"21 de agosto de 1994"
6,1,1,18,482,523,1005,"21 de agosto de 1994"
6,1,1,19,491,523,1014,"21 de agosto de 1994"
6,1,1,20,432,494,926,"21 de agosto de 1994"
6,1,1,21,441,471,912,"21 de agosto de 1994"
6,1,1,22,269,279,548,"21 de agosto de 1994"
6,1,1,23,71,77,148,"21 de agosto de 1994"
6,1,1,24,170,173,343,"21 de agosto de 1994"
6,1,1,25,467,529,996,"21 de agosto de 1994"
6,1,1,26,450,555,1005,"21 de agosto de 1994"
6,1,1,27,335,412,747,"21 de agosto de 1994"
6,1,1,28,238,330,568,"21 de agosto de 1994"
6,1,1,29,350,462,812,"21 de agosto de 1994"
6,1,1,30,284,363,647,"21 de agosto de 1994"
6,1,1,31,485,606,1091,"21 de agosto de 1994"
6,1,1,32,570,661,1231,"21 de agosto de 1994"
6,1,1,33,551,608,1159,"21 de agosto de 1994"
6,1,1,34,384,455,839,"21 de agosto de 1994"
6,1,1,35,422,478,900,"21 de agosto de 1994"
6,1,1,36,279,335,614,"21 de agosto de 1994"
6,1,1,37,271,307,578,"21 de agosto de 1994"
6,1,1,38,410,511,921,"21 de agosto de 1994"
6,1,1,39,252,306,558,"21 de agosto de 1994"
6,1,1,40,272,340,612,"21 de agosto de 1994"
6,1,1,41,215,283,498,"21 de agosto de 1994"
6,1,1,42,304,376,680,"21 de agosto de 1994"
6,1,1,43,478,564,1042,"21 de agosto de 1994"
6,1,1,44,581,222,803,"21 de agosto de 1994"
6,1,1,45,679,773,1452,"21 de agosto de 1994"
6,1,1,46,307,405,712,"21 de agosto de 1994"
6,1,1,47,458,567,1025,"21 de agosto de 1994"
6,1,1,48,411,478,889,"21 de agosto de 1994"
6,1,1,49,213,222,435,"21 de agosto de 1994"
6,1,1,50,472,540,1012,"21 de agosto de 1994"
6,1,1,51,383,468,851,"21 de agosto de 1994"
6,1,1,52,804,895,1699,"21 de agosto de 1994"
6,1,1,53,520,595,1115,"21 de agosto de 1994"
6,1,1,54,413,473,886,"21 de agosto de 1994"
6,1,1,55,532,591,1123,"21 de agosto de 1994"
6,1,1,56,222,273,495,"21 de agosto de 1994"
6,1,1,57,355,428,783,"21 de agosto de 1994"
6,1,1,58,424,500,924,"21 de agosto de 1994"
6,1,1,59,498,579,1077,"21 de agosto de 1994"
6,1,1,60,156,194,350,"21 de agosto de 1994"
6,1,1,61,140,173,313,"21 de agosto de 1994"
6,1,1,62,233,250,483,"21 de agosto de 1994"
6,1,1,63,360,418,778,"21 de agosto de 1994"
6,1,1,64,582,597,1179,"21 de agosto de 1994"
6,1,1,65,133,154,287,"21 de agosto de 1994"
6,1,1,66,541,622,1163,"21 de agosto de 1994"
6,1,1,67,563,612,1175,"21 de agosto de 1994"
6,1,1,68,545,629,1174,"21 de agosto de 1994"
6,1,1,69,212,227,439,"21 de agosto de 1994"
6,1,1,70,438,500,938,"21 de agosto de 1994"
6,1,1,71,377,395,772,"21 de agosto de 1994"
6,1,1,72,275,325,600,"21 de agosto de 1994"
6,1,1,73,171,201,372,"21 de agosto de 1994"
6,1,1,74,381,419,800,"21 de agosto de 1994"
6,1,1,75,301,316,617,"21 de agosto de 1994"
6,1,1,76,309,351,660,"21 de agosto de 1994"
6,1,1,77,173,183,356,"21 de agosto de 1994"
6,1,1,78,39,45,84,"21 de agosto de 1994"
6,1,1,79,465,522,987,"21 de agosto de 1994"
6,1,1,80,178,205,383,"21 de agosto de 1994"
6,1,1,81,541,611,1152,"21 de agosto de 1994"
6,1,1,82,538,630,1168,"21 de agosto de 1994"
6,1,1,83,176,162,338,"21 de agosto de 1994"
6,1,1,84,397,393,790,"21 de agosto de 1994"
6,1,1,85,426,367,793,"21 de agosto de 1994"
6,1,1,86,127,136,263,"21 de agosto de 1994"
6,1,1,87,257,232,489,"21 de agosto de 1994"
6,1,1,88,332,407,739,"21 de agosto de 1994"
6,1,1,89,284,295,579,"21 de agosto de 1994"
6,1,1,90,170,149,319,"21 de agosto de 1994"
6,1,1,91,192,173,365,"21 de agosto de 1994"
6,1,2,92,456,488,944,"21 de agosto de 1994"
6,1,2,93,491,530,1021,"21 de agosto de 1994"
6,1,2,94,475,581,1056,"21 de agosto de 1994"
6,1,2,95,415,457,872,"21 de agosto de 1994"
6,1,2,96,460,512,972,"21 de agosto de 1994"
6,1,2,97,169,159,328,"21 de agosto de 1994"
6,1,2,98,42,37,79,"21 de agosto de 1994"
6,1,2,99,224,222,446,"21 de agosto de 1994"
6,1,2,100,376,389,765,"21 de agosto de 1994"
6,1,2,101,411,434,845,"21 de agosto de 1994"
6,1,2,102,194,190,384,"21 de agosto de 1994"
6,1,2,103,419,429,848,"21 de agosto de 1994"
6,1,2,104,404,430,834,"21 de agosto de 1994"
6,1,3,105,258,310,568,"21 de agosto de 1994"
6,1,3,106,482,513,995,"21 de agosto de 1994"
6,1,3,107,443,463,906,"21 de agosto de 1994"
6,1,3,108,325,353,678,"21 de agosto de 1994"
6,1,3,109,424,429,853,"21 de agosto de 1994"
6,1,3,110,351,352,703,"21 de agosto de 1994"
6,1,3,111,431,529,960,"21 de agosto de 1994"
6,1,3,112,134,110,244,"21 de agosto de 1994"
6,1,3,113,142,127,269,"21 de agosto de 1994"
6,1,3,114,70,80,150,"21 de agosto de 1994"
6,1,3,115,106,97,203,"21 de agosto de 1994"
6,1,3,116,454,435,889,"21 de agosto de 1994"
6,1,3,117,260,254,514,"21 de agosto de 1994"
6,1,3,118,196,170,366,"21 de agosto de 1994"
6,1,3,119,186,158,344,"21 de agosto de 1994"
6,1,4,120,481,492,973,"21 de agosto de 1994"
6,1,4,121,396,410,806,"21 de agosto de 1994"
6,1,4,122,394,424,818,"21 de agosto de 1994"
6,1,4,123,470,449,919,"21 de agosto de 1994"
6,1,4,124,420,445,865,"21 de agosto de 1994"
6,1,4,125,285,271,556,"21 de agosto de 1994"
6,1,4,126,341,335,676,"21 de agosto de 1994"
6,1,4,127,325,336,661,"21 de agosto de 1994"
6,1,4,128,339,362,701,"21 de agosto de 1994"
6,1,4,129,403,411,814,"21 de agosto de 1994"
6,1,4,130,501,538,1039,"21 de agosto de 1994"
6,1,4,131,378,390,768,"21 de agosto de 1994"
6,1,4,132,480,507,987,"21 de agosto de 1994"
6,1,4,133,312,329,641,"21 de agosto de 1994"
6,1,4,134,567,524,1091,"21 de agosto de 1994"
6,1,4,135,432,410,842,"21 de agosto de 1994"
6,1,4,136,222,216,438,"21 de agosto de 1994"
6,1,4,137,339,355,694,"21 de agosto de 1994"
6,1,5,138,203,256,459,"21 de agosto de 1994"
6,1,5,139,254,272,526,"21 de agosto de 1994"
6,1,5,140,523,595,1118,"21 de agosto de 1994"
6,1,5,141,111,145,256,"21 de agosto de 1994"
6,1,5,142,269,359,628,"21 de agosto de 1994"
6,1,5,143,329,405,734,"21 de agosto de 1994"
6,1,5,144,398,464,862,"21 de agosto de 1994"
6,1,5,145,646,766,1412,"21 de agosto de 1994"
6,1,5,146,226,249,475,"21 de agosto de 1994"
6,1,5,147,630,731,1361,"21 de agosto de 1994"
6,1,5,148,723,788,1511,"21 de agosto de 1994"
6,1,5,149,532,611,1143,"21 de agosto de 1994"
6,1,5,150,418,453,871,"21 de agosto de 1994"
6,1,5,151,408,494,902,"21 de agosto de 1994"
6,1,5,152,368,428,796,"21 de agosto de 1994"
6,1,5,153,437,510,947,"21 de agosto de 1994"
6,1,5,154,441,474,915,"21 de agosto de 1994"
6,1,5,155,523,581,1104,"21 de agosto de 1994"
6,1,5,156,440,440,880,"21 de agosto de 1994"
6,1,5,157,463,511,974,"21 de agosto de 1994"
6,1,5,158,247,298,545,"21 de agosto de 1994"
6,1,5,159,613,660,1273,"21 de agosto de 1994"
6,1,5,160,448,505,953,"21 de agosto de 1994"
6,1,5,161,664,798,1462,"21 de agosto de 1994"
6,1,5,162,199,262,461,"21 de agosto de 1994"
6,1,5,163,1171,1382,2553,"21 de agosto de 1994"
6,1,5,164,554,633,1187,"21 de agosto de 1994"
6,1,5,165,354,399,753,"21 de agosto de 1994"
6,1,5,166,103,83,186,"21 de agosto de 1994"
6,1,5,167,204,183,387,"21 de agosto de 1994"
6,1,5,168,122,112,234,"21 de agosto de 1994"
6,1,5,169,80,69,149,"21 de agosto de 1994"
6,2,6,170,363,387,750,"21 de agosto de 1994"
6,2,6,171,426,395,821,"21 de agosto de 1994"
6,2,6,172,288,330,618,"21 de agosto de 1994"
6,2,6,173,499,519,1018,"21 de agosto de 1994"
6,2,6,174,377,390,767,"21 de agosto de 1994"
6,2,6,175,272,321,593,"21 de agosto de 1994"
6,2,6,176,430,492,922,"21 de agosto de 1994"
6,2,6,177,436,459,895,"21 de agosto de 1994"
6,2,6,178,376,365,741,"21 de agosto de 1994"
6,2,6,179,329,298,627,"21 de agosto de 1994"
6,2,6,180,337,373,710,"21 de agosto de 1994"
6,2,6,181,349,365,714,"21 de agosto de 1994"
6,2,6,182,342,332,674,"21 de agosto de 1994"
6,2,6,183,269,224,493,"21 de agosto de 1994"
6,2,6,184,177,164,341,"21 de agosto de 1994"
6,2,6,185,249,259,508,"21 de agosto de 1994"
6,2,6,186,427,446,873,"21 de agosto de 1994"
6,2,6,187,327,349,676,"21 de agosto de 1994"
6,2,6,188,389,450,839,"21 de agosto de 1994"
6,2,6,189,140,118,258,"21 de agosto de 1994"
6,2,6,190,127,137,264,"21 de agosto de 1994"
6,2,7,191,346,376,722,"21 de agosto de 1994"
6,2,7,192,302,341,643,"21 de agosto de 1994"
6,2,7,193,106,85,191,"21 de agosto de 1994"
6,2,7,194,95,97,192,"21 de agosto de 1994"
6,2,7,195,178,164,342,"21 de agosto de 1994"
6,2,7,196,128,116,244,"21 de agosto de 1994"
6,2,7,197,98,91,189,"21 de agosto de 1994"
6,2,7,198,33,22,55,"21 de agosto de 1994"
6,2,7,199,183,169,352,"21 de agosto de 1994"
6,2,8,200,773,393,1166,"21 de agosto de 1994"
6,2,8,201,108,93,201,"21 de agosto de 1994"
6,2,8,202,697,743,1440,"21 de agosto de 1994"
6,2,8,203,603,647,1250,"21 de agosto de 1994"
6,2,8,204,514,532,1046,"21 de agosto de 1994"
6,2,8,205,376,387,763,"21 de agosto de 1994"
6,2,8,206,530,529,1059,"21 de agosto de 1994"
6,2,8,207,322,371,693,"21 de agosto de 1994"
6,2,8,208,546,556,1102,"21 de agosto de 1994"
6,2,8,209,648,670,1318,"21 de agosto de 1994"
6,2,8,210,563,558,1121,"21 de agosto de 1994"
6,2,8,211,544,553,1097,"21 de agosto de 1994"
6,2,8,212,419,421,840,"21 de agosto de 1994"
6,2,8,213,550,552,1102,"21 de agosto de 1994"
6,2,8,214,612,626,1238,"21 de agosto de 1994"
6,2,8,215,523,518,1041,"21 de agosto de 1994"
6,2,8,216,338,286,624,"21 de agosto de 1994"
6,2,8,217,515,579,1094,"21 de agosto de 1994"
6,2,8,218,388,411,799,"21 de agosto de 1994"
6,2,8,219,477,491,968,"21 de agosto de 1994"
6,2,8,220,328,377,705,"21 de agosto de 1994"
6,2,8,221,435,467,902,"21 de agosto de 1994"
6,2,8,222,200,169,369,"21 de agosto de 1994"
6,2,8,223,236,209,445,"21 de agosto de 1994"
6,2,8,224,129,118,247,"21 de agosto de 1994"
6,2,8,225,312,327,639,"21 de agosto de 1994"
6,2,8,226,348,337,685,"21 de agosto de 1994"
6,2,8,227,263,251,514,"21 de agosto de 1994"
6,2,8,228,498,470,968,"21 de agosto de 1994"
6,2,8,229,77,62,139,"21 de agosto de 1994"
6,2,8,230,582,589,1171,"21 de agosto de 1994"
6,2,8,231,127,110,237,"21 de agosto de 1994"
6,2,8,232,259,273,532,"21 de agosto de 1994"
6,2,8,233,349,350,699,"21 de agosto de 1994"
6,2,8,234,402,353,755,"21 de agosto de 1994"
6,2,8,235,156,153,309,"21 de agosto de 1994"
6,2,8,236,707,700,1407,"21 de agosto de 1994"
6,2,8,237,741,744,1485,"21 de agosto de 1994"
6,2,8,238,705,711,1416,"21 de agosto de 1994"
6,2,8,239,318,289,607,"21 de agosto de 1994"
6,2,8,240,508,592,1100,"21 de agosto de 1994"
6,2,8,241,431,429,860,"21 de agosto de 1994"
6,2,8,242,169,173,342,"21 de agosto de 1994"
6,2,8,243,528,604,1132,"21 de agosto de 1994"
6,2,8,244,220,205,425,"21 de agosto de 1994"
6,2,8,245,678,669,1347,"21 de agosto de 1994"
6,2,8,246,576,609,1185,"21 de agosto de 1994"
6,2,8,247,105,92,197,"21 de agosto de 1994"
6,2,8,248,248,225,473,"21 de agosto de 1994"
6,2,8,249,306,302,608,"21 de agosto de 1994"
6,2,8,250,384,408,792,"21 de agosto de 1994"
6,2,8,251,716,811,1527,"21 de agosto de 1994"
6,2,8,252,347,396,743,"21 de agosto de 1994"
6,2,8,253,485,513,998,"21 de agosto de 1994"
6,2,8,254,247,263,510,"21 de agosto de 1994"
6,2,8,255,121,144,265,"21 de agosto de 1994"
6,2,8,256,792,384,1176,"21 de agosto de 1994"
6,2,8,257,300,305,605,"21 de agosto de 1994"
6,2,8,258,744,735,1479,"21 de agosto de 1994"
6,2,8,259,403,391,794,"21 de agosto de 1994"
6,2,8,260,731,736,1467,"21 de agosto de 1994"
6,2,8,261,476,538,1014,"21 de agosto de 1994"
6,2,8,262,409,431,840,"21 de agosto de 1994"
6,2,8,263,303,294,597,"21 de agosto de 1994"
6,2,8,264,285,288,573,"21 de agosto de 1994"
6,2,8,265,163,151,314,"21 de agosto de 1994"
6,2,8,266,228,246,474,"21 de agosto de 1994"
6,2,8,267,491,509,1000,"21 de agosto de 1994"
6,2,8,268,283,261,544,"21 de agosto de 1994"
6,2,8,269,506,471,977,"21 de agosto de 1994"
6,2,9,270,455,428,883,"21 de agosto de 1994"
6,2,9,271,278,282,560,"21 de agosto de 1994"
6,2,9,272,348,340,688,"21 de agosto de 1994"
6,2,9,273,252,198,450,"21 de agosto de 1994"
6,2,9,274,160,101,261,"21 de agosto de 1994"
6,2,9,275,357,261,618,"21 de agosto de 1994"
6,2,9,276,227,185,412,"21 de agosto de 1994"
6,2,10,277,605,603,1208,"21 de agosto de 1994"
6,2,10,278,421,490,911,"21 de agosto de 1994"
6,2,10,279,221,226,447,"21 de agosto de 1994"
6,2,10,280,370,373,743,"21 de agosto de 1994"
6,2,10,281,441,451,892,"21 de agosto de 1994"
6,2,10,282,659,736,1395,"21 de agosto de 1994"
6,2,10,283,751,815,1566,"21 de agosto de 1994"
6,2,10,284,402,416,818,"21 de agosto de 1994"
6,2,10,285,301,308,609,"21 de agosto de 1994"
6,2,10,286,324,362,686,"21 de agosto de 1994"
6,2,10,287,288,325,613,"21 de agosto de 1994"
6,2,10,288,258,327,585,"21 de agosto de 1994"
6,2,10,289,554,576,1130,"21 de agosto de 1994"
6,2,10,290,501,545,1046,"21 de agosto de 1994"
6,2,10,291,437,444,881,"21 de agosto de 1994"
6,2,10,292,470,480,950,"21 de agosto de 1994"
6,2,10,293,396,419,815,"21 de agosto de 1994"
6,2,10,294,301,306,607,"21 de agosto de 1994"
6,2,10,295,389,418,807,"21 de agosto de 1994"
6,2,10,296,387,395,782,"21 de agosto de 1994"
6,2,10,297,429,458,887,"21 de agosto de 1994"
6,2,10,298,457,482,939,"21 de agosto de 1994"
6,2,10,299,489,525,1014,"21 de agosto de 1994"
6,2,10,300,397,467,864,"21 de agosto de 1994"
6,2,10,301,390,477,867,"21 de agosto de 1994"
6,2,10,302,286,283,569,"21 de agosto de 1994"
6,2,10,303,331,390,721,"21 de agosto de 1994"
6,2,10,304,373,385,758,"21 de agosto de 1994"
6,2,10,305,614,601,1215,"21 de agosto de 1994"
6,2,10,306,377,418,795,"21 de agosto de 1994"
6,2,10,307,676,362,1038,"21 de agosto de 1994"
6,2,10,308,444,461,905,"21 de agosto de 1994"
6,2,10,309,274,289,563,"21 de agosto de 1994"
6,2,10,310,309,317,626,"21 de agosto de 1994"
6,2,10,311,751,730,1481,"21 de agosto de 1994"
6,2,10,312,800,840,1640,"21 de agosto de 1994"
6,2,10,313,434,449,883,"21 de agosto de 1994"
6,2,10,314,296,305,601,"21 de agosto de 1994"
6,2,10,315,330,334,664,"21 de agosto de 1994"
6,2,10,316,480,462,942,"21 de agosto de 1994"
6,2,10,317,331,351,682,"21 de agosto de 1994"
6,2,10,318,334,342,676,"21 de agosto de 1994"
6,2,10,319,292,304,596,"21 de agosto de 1994"
6,2,10,320,299,295,594,"21 de agosto de 1994"
6,2,10,321,493,475,968,"21 de agosto de 1994"
6,2,10,322,181,174,355,"21 de agosto de 1994"
6,2,10,323,120,117,237,"21 de agosto de 1994"
6,2,10,324,337,361,698,"21 de agosto de 1994"
6,2,10,325,235,213,448,"21 de agosto de 1994"
6,2,10,326,260,278,538,"21 de agosto de 1994"
6,2,10,327,63,73,136,"21 de agosto de 1994"
6,2,10,328,185,165,350,"21 de agosto de 1994"
6,2,10,329,506,491,997,"21 de agosto de 1994"
6,2,10,330,42,37,79,"21 de agosto de 1994"
6,2,10,331,72,60,132,"21 de agosto de 1994"
6,2,10,332,97,81,178,"21 de agosto de 1994"
6,2,10,333,103,81,184,"21 de agosto de 1994"
6,2,10,334,379,332,711,"21 de agosto de 1994"
6,2,10,335,467,424,891,"21 de agosto de 1994"
6,2,10,336,601,574,1175,"21 de agosto de 1994"
7,1,12,130,565,529,1094,"21 de agosto de 1994"
7,1,12,131,649,638,1287,"21 de agosto de 1994"
7,1,12,132,494,490,984,"21 de agosto de 1994"
7,1,12,133,289,283,572,"21 de agosto de 1994"
7,1,12,134,640,632,1272,"21 de agosto de 1994"
7,1,12,135,660,667,1327,"21 de agosto de 1994"
7,1,12,136,814,549,1363,"21 de agosto de 1994"
7,1,12,137,322,260,582,"21 de agosto de 1994"
7,1,12,138,303,255,558,"21 de agosto de 1994"
7,1,12,139,118,107,225,"21 de agosto de 1994"
7,1,12,140,130,97,227,"21 de agosto de 1994"
7,1,12,141,152,137,289,"21 de agosto de 1994"
7,1,12,142,363,320,683,"21 de agosto de 1994"
7,1,12,143,147,136,283,"21 de agosto de 1994"
7,1,17,197,377,331,708,"21 de agosto de 1994"
7,1,17,198,417,482,899,"21 de agosto de 1994"
7,1,17,199,595,651,1246,"21 de agosto de 1994"
7,1,17,200,584,629,1213,"21 de agosto de 1994"
7,1,17,201,504,503,1007,"21 de agosto de 1994"
7,1,17,202,614,602,1216,"21 de agosto de 1994"
7,1,17,203,568,562,1130,"21 de agosto de 1994"
7,1,17,204,486,560,1046,"21 de agosto de 1994"
7,1,17,205,586,658,1244,"21 de agosto de 1994"
7,1,17,206,516,563,1079,"21 de agosto de 1994"
7,1,17,207,727,769,1496,"21 de agosto de 1994"
7,1,17,208,628,645,1273,"21 de agosto de 1994"
7,1,17,209,435,415,850,"21 de agosto de 1994"
7,1,17,210,492,517,1009,"21 de agosto de 1994"
7,1,17,211,463,524,987,"21 de agosto de 1994"
7,1,17,212,480,525,1005,"21 de agosto de 1994"
7,1,17,213,577,360,937,"21 de agosto de 1994"
7,1,17,214,454,333,787,"21 de agosto de 1994"
7,1,17,215,463,339,802,"21 de agosto de 1994"
7,1,17,216,95,78,173,"21 de agosto de 1994"
7,1,17,217,452,356,808,"21 de agosto de 1994"
7,1,17,218,308,281,589,"21 de agosto de 1994"
7,1,17,219,265,231,496,"21 de agosto de 1994"
7,1,17,220,223,181,404,"21 de agosto de 1994"
7,1,17,221,249,193,442,"21 de agosto de 1994"
7,1,17,222,194,169,363,"21 de agosto de 1994"
7,1,17,223,713,623,1336,"21 de agosto de 1994"
7,1,17,224,380,335,715,"21 de agosto de 1994"
7,1,17,225,462,422,884,"21 de agosto de 1994"
7,1,17,226,170,154,324,"21 de agosto de 1994"
7,1,17,227,90,65,155,"21 de agosto de 1994"
7,1,17,228,232,188,420,"21 de agosto de 1994"
7,1,17,229,288,223,511,"21 de agosto de 1994"
7,1,17,230,635,524,1159,"21 de agosto de 1994"
7,1,17,231,433,384,817,"21 de agosto de 1994"
7,1,17,232,589,560,1149,"21 de agosto de 1994"
7,1,17,233,410,366,776,"21 de agosto de 1994"
7,1,46,638,211,194,405,"21 de agosto de 1994"
7,1,46,639,578,573,1151,"21 de agosto de 1994"
7,1,46,640,521,502,1023,"21 de agosto de 1994"
7,1,46,641,620,574,1194,"21 de agosto de 1994"
7,1,46,642,271,274,545,"21 de agosto de 1994"
7,1,46,643,287,201,488,"21 de agosto de 1994"
7,1,46,644,527,457,984,"21 de agosto de 1994"
7,1,46,645,189,149,338,"21 de agosto de 1994"
7,1,46,646,262,250,512,"21 de agosto de 1994"
7,1,46,647,525,481,1006,"21 de agosto de 1994"
7,1,46,648,331,296,627,"21 de agosto de 1994"
7,1,46,649,396,301,697,"21 de agosto de 1994"
7,1,46,650,399,342,741,"21 de agosto de 1994"
7,1,46,651,606,583,1189,"21 de agosto de 1994"
7,1,46,652,623,542,1165,"21 de agosto de 1994"
7,1,46,653,463,391,854,"21 de agosto de 1994"
7,1,46,654,449,425,874,"21 de agosto de 1994"
7,1,46,655,394,374,768,"21 de agosto de 1994"
7,1,46,656,201,168,369,"21 de agosto de 1994"
7,1,46,657,348,310,658,"21 de agosto de 1994"
7,1,46,658,554,501,1055,"21 de agosto de 1994"
7,1,46,659,411,392,803,"21 de agosto de 1994"
7,1,46,660,366,326,692,"21 de agosto de 1994"
7,1,46,661,314,241,555,"21 de agosto de 1994"
7,1,61,885,396,335,731,"21 de agosto de 1994"
7,1,61,886,438,492,930,"21 de agosto de 1994"
7,1,61,887,604,517,1121,"21 de agosto de 1994"
7,1,61,888,605,643,1248,"21 de agosto de 1994"
7,1,61,889,558,610,1168,"21 de agosto de 1994"
7,1,61,890,361,364,725,"21 de agosto de 1994"
7,1,61,891,505,469,974,"21 de agosto de 1994"
7,1,61,892,567,593,1160,"21 de agosto de 1994"
7,1,61,893,626,614,1240,"21 de agosto de 1994"
7,1,61,894,524,507,1031,"21 de agosto de 1994"
7,1,61,895,608,537,1145,"21 de agosto de 1994"
7,1,61,896,204,190,394,"21 de agosto de 1994"
7,1,61,897,688,622,1310,"21 de agosto de 1994"
7,1,61,898,624,555,1179,"21 de agosto de 1994"
7,1,61,899,332,289,621,"21 de agosto de 1994"
7,1,61,900,738,573,1311,"21 de agosto de 1994"
7,1,61,901,742,656,1398,"21 de agosto de 1994"
7,1,61,902,173,168,341,"21 de agosto de 1994"
7,1,61,903,194,184,378,"21 de agosto de 1994"
7,1,61,904,186,143,329,"21 de agosto de 1994"
7,1,61,905,445,391,836,"21 de agosto de 1994"
7,1,61,906,195,157,352,"21 de agosto de 1994"
7,1,61,907,239,206,445,"21 de agosto de 1994"
7,1,61,908,193,164,357,"21 de agosto de 1994"
7,1,61,909,525,456,981,"21 de agosto de 1994"
7,1,61,910,363,280,643,"21 de agosto de 1994"
7,1,61,911,271,249,520,"21 de agosto de 1994"
7,1,61,912,549,383,932,"21 de agosto de 1994"
7,1,78,1165,567,502,1069,"21 de agosto de 1994"
7,1,78,1166,426,401,827,"21 de agosto de 1994"
7,1,78,1167,508,435,943,"21 de agosto de 1994"
7,1,78,1168,624,579,1203,"21 de agosto de 1994"
7,1,78,1169,249,211,460,"21 de agosto de 1994"
7,1,78,1170,438,393,831,"21 de agosto de 1994"
7,1,78,1171,124,165,289,"21 de agosto de 1994"
7,1,78,1172,462,401,863,"21 de agosto de 1994"
7,1,78,1173,339,292,631,"21 de agosto de 1994"
7,1,78,1174,353,315,668,"21 de agosto de 1994"
7,1,78,1175,591,492,1083,"21 de agosto de 1994"
7,1,78,1176,464,432,896,"21 de agosto de 1994"
7,1,78,1177,538,477,1015,"21 de agosto de 1994"
7,1,87,1240,472,426,898,"21 de agosto de 1994"
7,1,87,1241,511,453,964,"21 de agosto de 1994"
7,1,87,1242,534,489,1023,"21 de agosto de 1994"
7,1,87,1243,594,602,1196,"21 de agosto de 1994"
7,1,87,1244,480,462,942,"21 de agosto de 1994"
7,1,87,1245,397,356,753,"21 de agosto de 1994"
7,1,87,1246,433,371,804,"21 de agosto de 1994"
7,1,102,1602,334,341,675,"21 de agosto de 1994"
7,1,102,1603,568,595,1163,"21 de agosto de 1994"
7,1,102,1604,636,679,1315,"21 de agosto de 1994"
7,1,102,1605,510,586,1096,"21 de agosto de 1994"
7,1,102,1606,738,796,1534,"21 de agosto de 1994"
7,1,102,1607,400,430,830,"21 de agosto de 1994"
7,1,102,1608,930,1027,1957,"21 de agosto de 1994"
7,1,102,1609,516,552,1068,"21 de agosto de 1994"
7,1,102,1610,712,783,1495,"21 de agosto de 1994"
7,1,102,1611,589,700,1289,"21 de agosto de 1994"
7,1,102,1612,710,790,1500,"21 de agosto de 1994"
7,1,102,1613,733,742,1475,"21 de agosto de 1994"
7,1,102,1614,611,680,1291,"21 de agosto de 1994"
7,1,102,1615,634,633,1267,"21 de agosto de 1994"
7,1,102,1616,643,714,1357,"21 de agosto de 1994"
7,1,102,1617,721,755,1476,"21 de agosto de 1994"
7,1,102,1618,611,765,1376,"21 de agosto de 1994"
7,1,102,1619,570,642,1212,"21 de agosto de 1994"
7,1,102,1620,616,739,1355,"21 de agosto de 1994"
7,1,102,1621,313,401,714,"21 de agosto de 1994"
7,1,102,1622,697,764,1461,"21 de agosto de 1994"
7,1,102,1623,491,510,1001,"21 de agosto de 1994"
7,1,102,1624,666,719,1385,"21 de agosto de 1994"
7,1,102,1625,763,738,1501,"21 de agosto de 1994"
7,1,102,1626,557,679,1236,"21 de agosto de 1994"
7,1,102,1627,539,700,1239,"21 de agosto de 1994"
7,1,102,1628,497,622,1119,"21 de agosto de 1994"
7,1,102,1629,676,830,1506,"21 de agosto de 1994"
7,1,102,1630,648,749,1397,"21 de agosto de 1994"
7,1,102,1631,631,685,1316,"21 de agosto de 1994"
7,1,102,1632,293,310,603,"21 de agosto de 1994"
7,1,102,1633,615,765,1380,"21 de agosto de 1994"
7,1,102,1634,384,455,839,"21 de agosto de 1994"
7,1,102,1635,252,245,497,"21 de agosto de 1994"
7,1,102,1636,656,724,1380,"21 de agosto de 1994"
7,1,102,1637,716,833,1549,"21 de agosto de 1994"
7,1,102,1638,647,468,1115,"21 de agosto de 1994"
7,1,102,1639,665,625,1290,"21 de agosto de 1994"
7,1,102,1640,973,1036,2009,"21 de agosto de 1994"
7,1,102,1641,530,637,1167,"21 de agosto de 1994"
7,1,102,1642,372,434,806,"21 de agosto de 1994"
7,1,102,1643,472,596,1068,"21 de agosto de 1994"
7,1,102,1644,418,503,921,"21 de agosto de 1994"
7,1,102,1645,520,634,1154,"21 de agosto de 1994"
7,1,102,1646,622,713,1335,"21 de agosto de 1994"
7,1,102,1647,743,774,1517,"21 de agosto de 1994"
7,1,102,1648,557,642,1199,"21 de agosto de 1994"
7,1,102,1649,599,720,1319,"21 de agosto de 1994"
7,1,102,1650,389,414,803,"21 de agosto de 1994"
7,1,102,1651,648,722,1370,"21 de agosto de 1994"
7,1,102,1652,544,622,1166,"21 de agosto de 1994"
7,1,102,1653,541,667,1208,"21 de agosto de 1994"
7,1,102,1654,455,538,993,"21 de agosto de 1994"
7,1,102,1655,649,793,1442,"21 de agosto de 1994"
7,1,102,1656,540,692,1232,"21 de agosto de 1994"
7,1,102,1657,612,696,1308,"21 de agosto de 1994"
7,1,102,1658,863,890,1753,"21 de agosto de 1994"
7,1,102,1659,511,534,1045,"21 de agosto de 1994"
7,1,102,1660,749,757,1506,"21 de agosto de 1994"
7,1,102,1661,684,775,1459,"21 de agosto de 1994"
7,1,102,1662,620,739,1359,"21 de agosto de 1994"
7,1,102,1663,603,658,1261,"21 de agosto de 1994"
7,1,102,1664,655,827,1482,"21 de agosto de 1994"
7,1,102,1665,457,511,968,"21 de agosto de 1994"
7,1,102,1666,718,735,1453,"21 de agosto de 1994"
7,1,102,1667,408,438,846,"21 de agosto de 1994"
7,1,102,1668,657,750,1407,"21 de agosto de 1994"
7,1,102,1669,604,762,1366,"21 de agosto de 1994"
7,1,102,1670,443,555,998,"21 de agosto de 1994"
7,1,102,1671,572,627,1199,"21 de agosto de 1994"
7,1,102,1672,531,623,1154,"21 de agosto de 1994"
7,1,102,1673,577,640,1217,"21 de agosto de 1994"
7,1,102,1674,486,577,1063,"21 de agosto de 1994"
7,1,102,1675,314,409,723,"21 de agosto de 1994"
7,1,102,1676,455,575,1030,"21 de agosto de 1994"
7,1,102,1677,311,394,705,"21 de agosto de 1994"
7,1,102,1678,415,493,908,"21 de agosto de 1994"
7,1,102,1679,517,616,1133,"21 de agosto de 1994"
7,1,102,1680,608,739,1347,"21 de agosto de 1994"
7,1,102,1681,468,649,1117,"21 de agosto de 1994"
7,1,102,1682,629,714,1343,"21 de agosto de 1994"
7,1,102,1683,650,781,1431,"21 de agosto de 1994"
7,1,102,1684,665,746,1411,"21 de agosto de 1994"
7,1,102,1685,691,878,1569,"21 de agosto de 1994"
7,1,102,1686,774,924,1698,"21 de agosto de 1994"
7,1,102,1687,453,484,937,"21 de agosto de 1994"
7,1,102,1688,494,558,1052,"21 de agosto de 1994"
7,1,102,1689,725,824,1549,"21 de agosto de 1994"
7,1,102,1690,623,721,1344,"21 de agosto de 1994"
7,1,102,1691,629,720,1349,"21 de agosto de 1994"
7,1,102,1692,560,599,1159,"21 de agosto de 1994"
7,1,102,1693,452,586,1038,"21 de agosto de 1994"
7,1,102,1694,560,603,1163,"21 de agosto de 1994"
7,1,102,1695,550,607,1157,"21 de agosto de 1994"
7,1,102,1696,388,490,878,"21 de agosto de 1994"
7,1,102,1697,377,440,817,"21 de agosto de 1994"
7,1,102,1698,752,883,1635,"21 de agosto de 1994"
7,1,102,1699,589,647,1236,"21 de agosto de 1994"
7,1,102,1700,795,898,1693,"21 de agosto de 1994"
7,1,102,1701,476,524,1000,"21 de agosto de 1994"
7,1,102,1702,594,606,1200,"21 de agosto de 1994"
7,1,102,1703,750,761,1511,"21 de agosto de 1994"
7,1,102,1704,686,684,1370,"21 de agosto de 1994"
7,1,102,1705,604,627,1231,"21 de agosto de 1994"
7,1,102,1706,624,664,1288,"21 de agosto de 1994"
7,1,102,1707,852,975,1827,"21 de agosto de 1994"
7,1,102,1708,782,810,1592,"21 de agosto de 1994"
7,1,102,1709,734,854,1588,"21 de agosto de 1994"
7,1,102,1710,353,412,765,"21 de agosto de 1994"
7,1,102,1711,411,444,855,"21 de agosto de 1994"
7,1,102,1712,551,666,1217,"21 de agosto de 1994"
7,1,102,1713,661,734,1395,"21 de agosto de 1994"
7,1,102,1714,734,808,1542,"21 de agosto de 1994"
7,1,102,1715,624,695,1319,"21 de agosto de 1994"
7,1,102,1716,634,720,1354,"21 de agosto de 1994"
7,1,102,1717,903,950,1853,"21 de agosto de 1994"
7,1,102,1718,415,481,896,"21 de agosto de 1994"
7,1,102,1719,366,406,772,"21 de agosto de 1994"
7,1,102,1720,551,633,1184,"21 de agosto de 1994"
7,1,102,1721,663,790,1453,"21 de agosto de 1994"
7,1,102,1722,493,477,970,"21 de agosto de 1994"
7,1,102,1723,711,809,1520,"21 de agosto de 1994"
7,1,102,1724,674,742,1416,"21 de agosto de 1994"
7,1,102,1725,644,748,1392,"21 de agosto de 1994"
7,1,102,1726,705,755,1460,"21 de agosto de 1994"
7,1,102,1727,582,684,1266,"21 de agosto de 1994"
7,1,102,1728,351,425,776,"21 de agosto de 1994"
7,1,102,1729,784,857,1641,"21 de agosto de 1994"
7,1,102,1730,770,819,1589,"21 de agosto de 1994"
7,1,102,1731,699,804,1503,"21 de agosto de 1994"
7,1,102,1732,713,753,1466,"21 de agosto de 1994"
7,1,102,1733,680,773,1453,"21 de agosto de 1994"
7,1,102,1734,560,589,1149,"21 de agosto de 1994"
7,1,102,1735,802,807,1609,"21 de agosto de 1994"
7,1,102,1736,697,789,1486,"21 de agosto de 1994"
7,1,102,1737,616,543,1159,"21 de agosto de 1994"
7,1,102,1738,607,536,1143,"21 de agosto de 1994"
7,1,102,1739,414,447,861,"21 de agosto de 1994"
7,1,102,1740,453,531,984,"21 de agosto de 1994"
7,1,102,1741,601,644,1245,"21 de agosto de 1994"
7,1,102,1742,706,660,1366,"21 de agosto de 1994"
7,1,102,1743,481,509,990,"21 de agosto de 1994"
7,1,102,1744,393,371,764,"21 de agosto de 1994"
7,1,102,1745,553,553,1106,"21 de agosto de 1994"
7,1,102,1746,383,376,759,"21 de agosto de 1994"
7,1,102,1747,625,626,1251,"21 de agosto de 1994"
7,1,102,1748,172,134,306,"21 de agosto de 1994"
7,1,102,1749,289,333,622,"21 de agosto de 1994"
7,1,102,1750,241,311,552,"21 de agosto de 1994"
7,1,102,1751,477,488,965,"21 de agosto de 1994"
7,1,102,1752,495,84,579,"21 de agosto de 1994"
7,1,102,1753,207,49,256,"21 de agosto de 1994"
7,1,102,1754,147,181,328,"21 de agosto de 1994"
7,2,23,336,170,147,317,"21 de agosto de 1994"
7,2,23,337,184,195,379,"21 de agosto de 1994"
7,2,23,338,206,227,433,"21 de agosto de 1994"
7,2,23,339,331,400,731,"21 de agosto de 1994"
7,2,23,340,230,263,493,"21 de agosto de 1994"
7,2,23,341,245,303,548,"21 de agosto de 1994"
7,2,23,342,289,314,603,"21 de agosto de 1994"
7,2,23,343,337,400,737,"21 de agosto de 1994"
7,2,23,344,386,434,820,"21 de agosto de 1994"
7,2,23,345,322,336,658,"21 de agosto de 1994"
7,2,23,346,287,322,609,"21 de agosto de 1994"
7,2,23,347,302,320,622,"21 de agosto de 1994"
7,2,23,348,235,314,549,"21 de agosto de 1994"
7,2,23,349,283,335,618,"21 de agosto de 1994"
7,2,23,350,278,343,621,"21 de agosto de 1994"
7,2,23,351,326,368,694,"21 de agosto de 1994"
7,2,23,352,244,278,522,"21 de agosto de 1994"
7,2,23,353,279,358,637,"21 de agosto de 1994"
7,2,23,354,197,233,430,"21 de agosto de 1994"
7,2,23,355,310,371,681,"21 de agosto de 1994"
7,2,23,356,309,358,667,"21 de agosto de 1994"
7,2,23,357,331,373,704,"21 de agosto de 1994"
7,2,23,358,491,555,1046,"21 de agosto de 1994"
7,2,23,359,345,344,689,"21 de agosto de 1994"
7,2,23,360,274,279,553,"21 de agosto de 1994"
7,2,23,361,278,333,611,"21 de agosto de 1994"
7,2,23,362,377,441,818,"21 de agosto de 1994"
7,2,23,363,248,201,449,"21 de agosto de 1994"
7,2,23,364,362,443,805,"21 de agosto de 1994"
7,2,23,365,261,364,625,"21 de agosto de 1994"
7,2,23,366,241,322,563,"21 de agosto de 1994"
7,2,23,367,233,319,552,"21 de agosto de 1994"
7,2,23,368,325,353,678,"21 de agosto de 1994"
7,2,23,369,150,198,348,"21 de agosto de 1994"
7,2,23,370,331,354,685,"21 de agosto de 1994"
7,2,23,371,265,299,564,"21 de agosto de 1994"
7,2,23,372,120,144,264,"21 de agosto de 1994"
7,2,23,373,240,265,505,"21 de agosto de 1994"
7,2,23,374,275,333,608,"21 de agosto de 1994"
7,2,26,384,378,395,773,"21 de agosto de 1994"
7,2,26,385,173,151,324,"21 de agosto de 1994"
7,2,26,386,501,449,950,"21 de agosto de 1994"
7,2,26,387,339,331,670,"21 de agosto de 1994"
7,2,26,388,397,366,763,"21 de agosto de 1994"
7,2,26,389,491,472,963,"21 de agosto de 1994"
7,2,26,390,343,316,659,"21 de agosto de 1994"
7,2,26,391,427,466,893,"21 de agosto de 1994"
7,2,26,392,342,320,662,"21 de agosto de 1994"
7,2,26,393,585,619,1204,"21 de agosto de 1994"
7,2,26,394,402,389,791,"21 de agosto de 1994"
7,2,26,395,311,316,627,"21 de agosto de 1994"
7,2,26,396,313,327,640,"21 de agosto de 1994"
7,2,26,397,348,368,716,"21 de agosto de 1994"
7,2,26,398,285,317,602,"21 de agosto de 1994"
7,2,26,399,375,411,786,"21 de agosto de 1994"
7,2,26,400,373,390,763,"21 de agosto de 1994"
7,2,26,401,304,325,629,"21 de agosto de 1994"
7,2,28,433,503,451,954,"21 de agosto de 1994"
7,2,28,434,556,531,1087,"21 de agosto de 1994"
7,2,28,435,186,170,356,"21 de agosto de 1994"
7,2,44,627,494,485,979,"21 de agosto de 1994"
7,2,44,628,495,447,942,"21 de agosto de 1994"
7,2,44,629,431,373,804,"21 de agosto de 1994"
7,2,44,630,316,220,536,"21 de agosto de 1994"
7,2,44,631,539,448,987,"21 de agosto de 1994"
7,2,44,632,312,305,617,"21 de agosto de 1994"
7,2,44,633,245,222,467,"21 de agosto de 1994"
7,2,44,634,299,280,579,"21 de agosto de 1994"
7,2,44,635,398,389,787,"21 de agosto de 1994"
7,2,49,682,371,390,761,"21 de agosto de 1994"
7,2,49,683,593,588,1181,"21 de agosto de 1994"
7,2,49,684,339,355,694,"21 de agosto de 1994"
7,2,49,685,395,395,790,"21 de agosto de 1994"
7,2,49,686,385,377,762,"21 de agosto de 1994"
7,2,49,687,340,338,678,"21 de agosto de 1994"
7,2,49,688,254,249,503,"21 de agosto de 1994"
7,2,49,689,401,413,814,"21 de agosto de 1994"
7,2,49,690,437,477,914,"21 de agosto de 1994"
7,2,49,691,222,241,463,"21 de agosto de 1994"
7,2,56,782,171,171,342,"21 de agosto de 1994"
7,2,56,783,157,157,314,"21 de agosto de 1994"
7,2,56,784,310,329,639,"21 de agosto de 1994"
7,2,56,785,247,283,530,"21 de agosto de 1994"
7,2,56,786,246,273,519,"21 de agosto de 1994"
7,2,58,814,722,641,1363,"21 de agosto de 1994"
7,2,66,977,204,195,399,"21 de agosto de 1994"
7,2,66,978,439,434,873,"21 de agosto de 1994"
7,2,66,979,474,487,961,"21 de agosto de 1994"
7,2,66,980,304,335,639,"21 de agosto de 1994"
7,2,66,981,346,341,687,"21 de agosto de 1994"
7,2,66,982,448,415,863,"21 de agosto de 1994"
7,2,66,983,372,322,694,"21 de agosto de 1994"
7,2,66,984,444,410,854,"21 de agosto de 1994"
7,2,77,1113,379,417,796,"21 de agosto de 1994"
7,2,77,1114,421,477,898,"21 de agosto de 1994"
7,2,77,1115,461,489,950,"21 de agosto de 1994"
7,2,77,1116,632,679,1311,"21 de agosto de 1994"
7,2,77,1117,429,509,938,"21 de agosto de 1994"
7,2,77,1118,398,398,796,"21 de agosto de 1994"
7,2,77,1119,293,283,576,"21 de agosto de 1994"
7,2,77,1120,733,738,1471,"21 de agosto de 1994"
7,2,77,1121,544,601,1145,"21 de agosto de 1994"
7,2,77,1122,599,644,1243,"21 de agosto de 1994"
7,2,77,1123,507,544,1051,"21 de agosto de 1994"
7,2,77,1124,657,791,1448,"21 de agosto de 1994"
7,2,77,1125,696,770,1466,"21 de agosto de 1994"
7,2,77,1126,464,566,1030,"21 de agosto de 1994"
7,2,77,1127,699,827,1526,"21 de agosto de 1994"
7,2,77,1128,667,733,1400,"21 de agosto de 1994"
7,2,77,1129,509,581,1090,"21 de agosto de 1994"
7,2,77,1130,445,444,889,"21 de agosto de 1994"
7,2,77,1131,549,602,1151,"21 de agosto de 1994"
7,2,77,1132,395,460,855,"21 de agosto de 1994"
7,2,77,1133,509,647,1156,"21 de agosto de 1994"
7,2,77,1134,443,571,1014,"21 de agosto de 1994"
7,2,77,1135,613,709,1322,"21 de agosto de 1994"
7,2,77,1136,373,396,769,"21 de agosto de 1994"
7,2,77,1137,684,710,1394,"21 de agosto de 1994"
7,2,77,1138,451,594,1045,"21 de agosto de 1994"
7,2,77,1139,406,534,940,"21 de agosto de 1994"
7,2,77,1140,271,335,606,"21 de agosto de 1994"
7,2,77,1141,508,566,1074,"21 de agosto de 1994"
7,2,77,1142,664,748,1412,"21 de agosto de 1994"
7,2,77,1143,659,716,1375,"21 de agosto de 1994"
7,2,77,1144,782,861,1643,"21 de agosto de 1994"
7,2,77,1145,801,893,1694,"21 de agosto de 1994"
7,2,77,1146,729,893,1622,"21 de agosto de 1994"
7,2,77,1147,464,513,977,"21 de agosto de 1994"
7,2,77,1148,308,336,644,"21 de agosto de 1994"
7,2,77,1149,579,670,1249,"21 de agosto de 1994"
7,2,77,1150,490,466,956,"21 de agosto de 1994"
7,2,77,1151,848,907,1755,"21 de agosto de 1994"
7,2,77,1152,286,310,596,"21 de agosto de 1994"
7,2,77,1153,288,362,650,"21 de agosto de 1994"
7,2,77,1154,356,445,801,"21 de agosto de 1994"
7,2,77,1155,306,325,631,"21 de agosto de 1994"
7,2,77,1156,153,192,345,"21 de agosto de 1994"
7,2,77,1157,322,362,684,"21 de agosto de 1994"
7,2,77,1158,221,214,435,"21 de agosto de 1994"
7,2,77,1159,271,288,559,"21 de agosto de 1994"
7,2,77,1160,833,418,1251,"21 de agosto de 1994"
7,2,77,1161,305,299,604,"21 de agosto de 1994"
7,2,77,1162,207,199,406,"21 de agosto de 1994"
7,2,77,1163,313,317,630,"21 de agosto de 1994"
7,2,77,1164,85,95,180,"21 de agosto de 1994"
7,2,80,1187,581,542,1123,"21 de agosto de 1994"
7,2,80,1188,576,504,1080,"21 de agosto de 1994"
7,2,94,1438,305,376,681,"21 de agosto de 1994"
7,2,94,1439,328,361,689,"21 de agosto de 1994"
7,2,94,1440,343,348,691,"21 de agosto de 1994"
7,2,94,1441,409,450,859,"21 de agosto de 1994"
7,2,94,1442,346,373,719,"21 de agosto de 1994"
7,2,94,1443,393,443,836,"21 de agosto de 1994"
7,2,94,1444,327,335,662,"21 de agosto de 1994"
7,2,94,1445,329,341,670,"21 de agosto de 1994"
7,2,94,1446,336,324,660,"21 de agosto de 1994"
7,2,94,1447,368,367,735,"21 de agosto de 1994"
7,2,94,1448,323,328,651,"21 de agosto de 1994"
7,2,94,1449,415,385,800,"21 de agosto de 1994"
7,2,94,1450,425,512,937,"21 de agosto de 1994"
7,2,94,1451,367,346,713,"21 de agosto de 1994"
7,2,94,1452,502,525,1027,"21 de agosto de 1994"
7,2,94,1453,279,288,567,"21 de agosto de 1994"
7,2,98,1530,516,460,976,"21 de agosto de 1994"
7,2,98,1531,532,461,993,"21 de agosto de 1994"
7,2,106,1786,435,369,804,"21 de agosto de 1994"
7,2,106,1787,423,420,843,"21 de agosto de 1994"
7,2,106,1788,460,414,874,"21 de agosto de 1994"
7,2,106,1789,381,339,720,"21 de agosto de 1994"
7,2,106,1790,456,437,893,"21 de agosto de 1994"
7,2,106,1791,419,389,808,"21 de agosto de 1994"
7,2,106,1792,462,435,897,"21 de agosto de 1994"
7,2,106,1793,575,513,1088,"21 de agosto de 1994"
7,2,106,1794,390,317,707,"21 de agosto de 1994"
7,2,106,1795,481,376,857,"21 de agosto de 1994"
7,2,106,1796,654,609,1263,"21 de agosto de 1994"
7,2,106,1797,641,633,1274,"21 de agosto de 1994"
7,2,106,1798,756,692,1448,"21 de agosto de 1994"
7,2,106,1799,457,451,908,"21 de agosto de 1994"
7,2,106,1800,409,421,830,"21 de agosto de 1994"
7,2,106,1801,535,499,1034,"21 de agosto de 1994"
7,2,106,1802,613,524,1137,"21 de agosto de 1994"
7,2,106,1803,100,75,175,"21 de agosto de 1994"
7,2,106,1804,426,365,791,"21 de agosto de 1994"
7,2,106,1805,509,480,989,"21 de agosto de 1994"
7,2,106,1806,518,453,971,"21 de agosto de 1994"
7,2,106,1807,461,445,906,"21 de agosto de 1994"
7,2,106,1808,361,308,669,"21 de agosto de 1994"
7,2,106,1809,148,102,250,"21 de agosto de 1994"
7,2,106,1810,342,272,614,"21 de agosto de 1994"
7,2,106,1811,336,275,611,"21 de agosto de 1994"
7,3,7,68,423,501,924,"21 de agosto de 1994"
7,3,7,69,235,260,495,"21 de agosto de 1994"
7,3,7,70,440,447,887,"21 de agosto de 1994"
7,3,7,71,344,341,685,"21 de agosto de 1994"
7,3,8,72,504,500,1004,"21 de agosto de 1994"
7,3,8,73,552,502,1054,"21 de agosto de 1994"
7,3,8,74,408,389,797,"21 de agosto de 1994"
7,3,8,75,439,373,812,"21 de agosto de 1994"
7,3,8,76,431,379,810,"21 de agosto de 1994"
7,3,8,77,430,354,784,"21 de agosto de 1994"
7,3,8,78,670,551,1221,"21 de agosto de 1994"
7,3,8,79,334,205,539,"21 de agosto de 1994"
7,3,8,80,358,257,615,"21 de agosto de 1994"
7,3,8,81,184,155,339,"21 de agosto de 1994"
7,3,8,82,345,302,647,"21 de agosto de 1994"
7,3,8,83,416,349,765,"21 de agosto de 1994"
7,3,8,84,321,258,579,"21 de agosto de 1994"
7,3,8,85,56,38,94,"21 de agosto de 1994"
7,3,8,86,267,203,470,"21 de agosto de 1994"
7,3,8,87,320,267,587,"21 de agosto de 1994"
7,3,11,116,198,190,388,"21 de agosto de 1994"
7,3,11,117,407,376,783,"21 de agosto de 1994"
7,3,11,118,206,192,398,"21 de agosto de 1994"
7,3,11,119,137,133,270,"21 de agosto de 1994"
7,3,11,120,229,237,466,"21 de agosto de 1994"
7,3,11,121,327,331,658,"21 de agosto de 1994"
7,3,11,122,179,179,358,"21 de agosto de 1994"
7,3,11,123,301,238,539,"21 de agosto de 1994"
7,3,11,124,364,291,655,"21 de agosto de 1994"
7,3,11,125,144,141,285,"21 de agosto de 1994"
7,3,11,126,331,303,634,"21 de agosto de 1994"
7,3,11,127,198,181,379,"21 de agosto de 1994"
7,3,11,128,505,452,957,"21 de agosto de 1994"
7,3,11,129,97,104,201,"21 de agosto de 1994"
7,3,19,239,616,669,1285,"21 de agosto de 1994"
7,3,19,240,665,775,1440,"21 de agosto de 1994"
7,3,19,241,330,401,731,"21 de agosto de 1994"
7,3,19,242,634,725,1359,"21 de agosto de 1994"
7,3,19,243,396,474,870,"21 de agosto de 1994"
7,3,19,244,568,588,1156,"21 de agosto de 1994"
7,3,19,245,474,558,1032,"21 de agosto de 1994"
7,3,19,246,452,587,1039,"21 de agosto de 1994"
7,3,19,247,507,607,1114,"21 de agosto de 1994"
7,3,19,248,634,767,1401,"21 de agosto de 1994"
7,3,19,249,350,361,711,"21 de agosto de 1994"
7,3,19,250,546,657,1203,"21 de agosto de 1994"
7,3,19,251,524,657,1181,"21 de agosto de 1994"
7,3,19,252,337,433,770,"21 de agosto de 1994"
7,3,19,253,347,429,776,"21 de agosto de 1994"
7,3,19,254,561,689,1250,"21 de agosto de 1994"
7,3,19,255,363,381,744,"21 de agosto de 1994"
7,3,19,256,477,546,1023,"21 de agosto de 1994"
7,3,19,257,610,743,1353,"21 de agosto de 1994"
7,3,19,258,347,500,847,"21 de agosto de 1994"
7,3,19,259,579,718,1297,"21 de agosto de 1994"
7,3,19,260,501,551,1052,"21 de agosto de 1994"
7,3,19,261,377,472,849,"21 de agosto de 1994"
7,3,19,262,696,741,1437,"21 de agosto de 1994"
7,3,19,263,604,697,1301,"21 de agosto de 1994"
7,3,19,264,338,342,680,"21 de agosto de 1994"
7,3,19,265,386,413,799,"21 de agosto de 1994"
7,3,19,266,677,762,1439,"21 de agosto de 1994"
7,3,19,267,209,187,396,"21 de agosto de 1994"
7,3,19,268,257,234,491,"21 de agosto de 1994"
7,3,19,269,173,156,329,"21 de agosto de 1994"
7,3,19,270,387,333,720,"21 de agosto de 1994"
7,3,19,271,338,313,651,"21 de agosto de 1994"
7,3,19,272,266,251,517,"21 de agosto de 1994"
7,3,19,273,427,391,818,"21 de agosto de 1994"
7,3,19,274,161,144,305,"21 de agosto de 1994"
7,3,19,275,355,333,688,"21 de agosto de 1994"
7,3,19,276,264,280,544,"21 de agosto de 1994"
7,3,19,277,294,293,587,"21 de agosto de 1994"
7,3,19,278,195,168,363,"21 de agosto de 1994"
7,3,19,279,484,453,937,"21 de agosto de 1994"
7,3,19,280,323,322,645,"21 de agosto de 1994"
7,3,19,281,328,305,633,"21 de agosto de 1994"
7,3,19,282,405,388,793,"21 de agosto de 1994"
7,3,19,283,351,318,669,"21 de agosto de 1994"
7,3,19,284,314,334,648,"21 de agosto de 1994"
7,3,19,285,222,248,470,"21 de agosto de 1994"
7,3,19,286,293,325,618,"21 de agosto de 1994"
7,3,19,287,353,393,746,"21 de agosto de 1994"
7,3,19,288,177,188,365,"21 de agosto de 1994"
7,3,19,289,429,444,873,"21 de agosto de 1994"
7,3,19,290,385,375,760,"21 de agosto de 1994"
7,3,19,291,315,280,595,"21 de agosto de 1994"
7,3,19,292,505,62,567,"21 de agosto de 1994"
7,3,20,293,565,518,1083,"21 de agosto de 1994"
7,3,20,294,618,593,1211,"21 de agosto de 1994"
7,3,20,295,351,336,687,"21 de agosto de 1994"
7,3,20,296,329,302,631,"21 de agosto de 1994"
7,3,20,297,139,103,242,"21 de agosto de 1994"
7,3,20,298,380,342,722,"21 de agosto de 1994"
7,3,20,299,750,613,1363,"21 de agosto de 1994"
7,3,20,300,540,436,976,"21 de agosto de 1994"
7,3,20,301,420,379,799,"21 de agosto de 1994"
7,3,20,302,413,352,765,"21 de agosto de 1994"
7,3,20,303,241,206,447,"21 de agosto de 1994"
7,3,20,304,102,75,177,"21 de agosto de 1994"
7,3,20,305,230,204,434,"21 de agosto de 1994"
7,3,20,306,332,293,625,"21 de agosto de 1994"
7,3,20,307,338,312,650,"21 de agosto de 1994"
7,3,20,308,360,314,674,"21 de agosto de 1994"
7,3,20,309,203,156,359,"21 de agosto de 1994"
7,3,20,310,366,290,656,"21 de agosto de 1994"
7,3,20,311,521,478,999,"21 de agosto de 1994"
7,3,20,312,604,514,1118,"21 de agosto de 1994"
7,3,20,313,307,222,529,"21 de agosto de 1994"
7,3,20,314,321,240,561,"21 de agosto de 1994"
7,3,20,315,577,400,977,"21 de agosto de 1994"
7,3,20,316,335,250,585,"21 de agosto de 1994"
7,3,24,375,240,237,477,"21 de agosto de 1994"
7,3,24,376,303,305,608,"21 de agosto de 1994"
7,3,24,377,158,148,306,"21 de agosto de 1994"
7,3,24,378,129,141,270,"21 de agosto de 1994"
7,3,24,379,149,143,292,"21 de agosto de 1994"
7,3,24,380,424,355,779,"21 de agosto de 1994"
7,3,30,439,296,287,583,"21 de agosto de 1994"
7,3,30,440,427,421,848,"21 de agosto de 1994"
7,3,30,441,313,306,619,"21 de agosto de 1994"
7,3,30,442,263,226,489,"21 de agosto de 1994"
7,3,30,443,154,145,299,"21 de agosto de 1994"
7,3,30,444,654,573,1227,"21 de agosto de 1994"
7,3,30,445,244,202,446,"21 de agosto de 1994"
7,3,30,446,262,199,461,"21 de agosto de 1994"
7,3,30,447,518,420,938,"21 de agosto de 1994"
7,3,30,448,389,349,738,"21 de agosto de 1994"
7,3,30,449,356,307,663,"21 de agosto de 1994"
7,3,30,450,279,245,524,"21 de agosto de 1994"
7,3,30,451,322,305,627,"21 de agosto de 1994"
7,3,30,452,277,258,535,"21 de agosto de 1994"
7,3,30,453,226,216,442,"21 de agosto de 1994"
7,3,30,454,448,401,849,"21 de agosto de 1994"
7,3,30,455,267,226,493,"21 de agosto de 1994"
7,3,34,504,571,548,1119,"21 de agosto de 1994"
7,3,34,505,563,569,1132,"21 de agosto de 1994"
7,3,34,506,705,636,1341,"21 de agosto de 1994"
7,3,34,507,819,739,1558,"21 de agosto de 1994"
7,3,34,508,487,464,951,"21 de agosto de 1994"
7,3,34,509,316,296,612,"21 de agosto de 1994"
7,3,34,510,177,150,327,"21 de agosto de 1994"
7,3,34,511,533,542,1075,"21 de agosto de 1994"
7,3,34,512,485,444,929,"21 de agosto de 1994"
7,3,34,513,303,282,585,"21 de agosto de 1994"
7,3,34,514,378,358,736,"21 de agosto de 1994"
7,3,34,515,90,81,171,"21 de agosto de 1994"
7,3,34,516,238,216,454,"21 de agosto de 1994"
7,3,34,517,356,336,692,"21 de agosto de 1994"
7,3,34,518,150,126,276,"21 de agosto de 1994"
7,3,34,519,47,41,88,"21 de agosto de 1994"
7,3,34,520,536,458,994,"21 de agosto de 1994"
7,3,34,521,366,300,666,"21 de agosto de 1994"
7,3,34,522,119,107,226,"21 de agosto de 1994"
7,3,34,523,257,234,491,"21 de agosto de 1994"
7,3,34,524,253,208,461,"21 de agosto de 1994"
7,3,34,525,268,248,516,"21 de agosto de 1994"
7,3,34,526,280,230,510,"21 de agosto de 1994"
7,3,34,527,291,246,537,"21 de agosto de 1994"
7,3,34,528,170,141,311,"21 de agosto de 1994"
7,3,34,529,615,545,1160,"21 de agosto de 1994"
7,3,34,530,445,411,856,"21 de agosto de 1994"
7,3,34,531,291,273,564,"21 de agosto de 1994"
7,3,39,566,314,320,634,"21 de agosto de 1994"
7,3,39,567,267,286,553,"21 de agosto de 1994"
7,3,39,568,415,445,860,"21 de agosto de 1994"
7,3,39,569,377,406,783,"21 de agosto de 1994"
7,3,39,570,477,451,928,"21 de agosto de 1994"
7,3,39,571,401,406,807,"21 de agosto de 1994"
7,3,39,572,281,292,573,"21 de agosto de 1994"
7,3,39,573,304,293,597,"21 de agosto de 1994"
7,3,39,574,388,376,764,"21 de agosto de 1994"
7,3,39,575,472,484,956,"21 de agosto de 1994"
7,3,39,576,433,463,896,"21 de agosto de 1994"
7,3,64,925,399,480,879,"21 de agosto de 1994"
7,3,64,926,324,372,696,"21 de agosto de 1994"
7,3,64,927,232,230,462,"21 de agosto de 1994"
7,3,64,928,305,292,597,"21 de agosto de 1994"
7,3,64,929,429,357,786,"21 de agosto de 1994"
7,3,64,930,471,438,909,"21 de agosto de 1994"
7,3,64,931,637,533,1170,"21 de agosto de 1994"
7,3,64,932,355,356,711,"21 de agosto de 1994"
7,3,64,933,352,348,700,"21 de agosto de 1994"
7,3,64,934,376,335,711,"21 de agosto de 1994"
7,3,64,935,591,632,1223,"21 de agosto de 1994"
7,3,64,936,436,402,838,"21 de agosto de 1994"
7,3,64,937,242,245,487,"21 de agosto de 1994"
7,3,64,938,481,474,955,"21 de agosto de 1994"
7,3,64,939,424,419,843,"21 de agosto de 1994"
7,3,64,940,700,655,1355,"21 de agosto de 1994"
7,3,64,941,299,234,533,"21 de agosto de 1994"
7,3,64,942,346,312,658,"21 de agosto de 1994"
7,3,64,943,409,374,783,"21 de agosto de 1994"
7,3,74,1070,340,309,649,"21 de agosto de 1994"
7,3,74,1071,345,326,671,"21 de agosto de 1994"
7,3,74,1072,262,273,535,"21 de agosto de 1994"
7,3,74,1073,292,283,575,"21 de agosto de 1994"
7,3,74,1074,438,438,876,"21 de agosto de 1994"
7,3,74,1075,331,354,685,"21 de agosto de 1994"
7,3,74,1076,439,405,844,"21 de agosto de 1994"
7,3,74,1077,383,380,763,"21 de agosto de 1994"
7,3,74,1078,496,474,970,"21 de agosto de 1994"
7,3,74,1079,412,334,746,"21 de agosto de 1994"
7,3,74,1080,310,274,584,"21 de agosto de 1994"
7,3,74,1081,296,241,537,"21 de agosto de 1994"
7,3,84,1226,597,589,1186,"21 de agosto de 1994"
7,3,84,1227,605,571,1176,"21 de agosto de 1994"
7,3,84,1228,338,274,612,"21 de agosto de 1994"
7,3,84,1229,219,180,399,"21 de agosto de 1994"
7,3,84,1230,399,362,761,"21 de agosto de 1994"
7,3,84,1231,501,398,899,"21 de agosto de 1994"
7,3,84,1232,564,453,1017,"21 de agosto de 1994"
7,3,95,1454,514,494,1008,"21 de agosto de 1994"
7,3,95,1455,541,520,1061,"21 de agosto de 1994"
7,3,95,1456,542,531,1073,"21 de agosto de 1994"
7,3,95,1457,399,404,803,"21 de agosto de 1994"
7,3,95,1458,372,367,739,"21 de agosto de 1994"
7,3,95,1459,316,331,647,"21 de agosto de 1994"
7,3,95,1460,434,497,931,"21 de agosto de 1994"
7,3,95,1461,450,484,934,"21 de agosto de 1994"
7,3,95,1462,505,501,1006,"21 de agosto de 1994"
7,3,95,1463,636,517,1153,"21 de agosto de 1994"
7,3,99,1532,73,73,146,"21 de agosto de 1994"
7,3,99,1533,479,489,968,"21 de agosto de 1994"
7,3,99,1534,258,267,525,"21 de agosto de 1994"
7,3,99,1535,369,355,724,"21 de agosto de 1994"
7,3,99,1536,647,716,1363,"21 de agosto de 1994"
7,3,99,1537,467,436,903,"21 de agosto de 1994"
7,3,99,1538,328,343,671,"21 de agosto de 1994"
7,3,99,1539,593,585,1178,"21 de agosto de 1994"
7,3,99,1540,391,368,759,"21 de agosto de 1994"
7,3,99,1541,505,441,946,"21 de agosto de 1994"
7,3,99,1542,518,490,1008,"21 de agosto de 1994"
7,3,99,1543,391,353,744,"21 de agosto de 1994"
7,3,99,1544,451,421,872,"21 de agosto de 1994"
7,3,99,1545,251,223,474,"21 de agosto de 1994"
7,3,99,1546,247,233,480,"21 de agosto de 1994"
7,3,99,1547,213,172,385,"21 de agosto de 1994"
7,3,99,1548,242,216,458,"21 de agosto de 1994"
7,3,99,1549,180,164,344,"21 de agosto de 1994"
7,3,99,1550,264,222,486,"21 de agosto de 1994"
7,3,99,1551,411,371,782,"21 de agosto de 1994"
7,3,99,1552,478,373,851,"21 de agosto de 1994"
7,3,99,1553,267,250,517,"21 de agosto de 1994"
7,3,99,1554,430,426,856,"21 de agosto de 1994"
7,3,99,1555,195,191,386,"21 de agosto de 1994"
7,3,99,1556,410,371,781,"21 de agosto de 1994"
7,3,99,1557,260,251,511,"21 de agosto de 1994"
7,3,99,1558,34,37,71,"21 de agosto de 1994"
7,3,99,1559,462,569,1031,"21 de agosto de 1994"
7,3,99,1560,182,203,385,"21 de agosto de 1994"
7,3,99,1561,390,405,795,"21 de agosto de 1994"
7,3,99,1562,336,342,678,"21 de agosto de 1994"
7,3,99,1563,90,75,165,"21 de agosto de 1994"
7,3,99,1564,432,371,803,"21 de agosto de 1994"
7,3,99,1565,447,384,831,"21 de agosto de 1994"
7,3,99,1566,404,376,780,"21 de agosto de 1994"
7,3,99,1567,324,324,648,"21 de agosto de 1994"
7,3,104,1771,583,649,1232,"21 de agosto de 1994"
7,3,104,1772,215,225,440,"21 de agosto de 1994"
7,3,104,1773,279,271,550,"21 de agosto de 1994"
7,3,104,1774,314,289,603,"21 de agosto de 1994"
7,3,104,1775,585,542,1127,"21 de agosto de 1994"
7,3,104,1776,390,345,735,"21 de agosto de 1994"
7,3,104,1777,457,407,864,"21 de agosto de 1994"
7,4,2,7,521,509,1030,"21 de agosto de 1994"
7,4,2,8,369,389,758,"21 de agosto de 1994"
7,4,2,9,443,404,847,"21 de agosto de 1994"
7,4,2,10,638,629,1267,"21 de agosto de 1994"
7,4,2,11,488,494,982,"21 de agosto de 1994"
7,4,2,12,405,399,804,"21 de agosto de 1994"
7,4,2,13,374,368,742,"21 de agosto de 1994"
7,4,2,14,257,226,483,"21 de agosto de 1994"
7,4,2,15,207,170,377,"21 de agosto de 1994"
7,4,2,16,354,357,711,"21 de agosto de 1994"
7,4,2,17,644,642,1286,"21 de agosto de 1994"
7,4,2,18,114,89,203,"21 de agosto de 1994"
7,4,2,19,465,392,857,"21 de agosto de 1994"
7,4,2,20,353,299,652,"21 de agosto de 1994"
7,4,13,144,468,500,968,"21 de agosto de 1994"
7,4,13,145,499,513,1012,"21 de agosto de 1994"
7,4,13,146,373,399,772,"21 de agosto de 1994"
7,4,13,147,497,520,1017,"21 de agosto de 1994"
7,4,13,148,245,232,477,"21 de agosto de 1994"
7,4,13,149,401,346,747,"21 de agosto de 1994"
7,4,13,150,284,264,548,"21 de agosto de 1994"
7,4,13,151,375,362,737,"21 de agosto de 1994"
7,4,13,152,406,390,796,"21 de agosto de 1994"
7,4,13,153,204,180,384,"21 de agosto de 1994"
7,4,13,154,342,325,667,"21 de agosto de 1994"
7,4,21,317,376,369,745,"21 de agosto de 1994"
7,4,21,318,330,364,694,"21 de agosto de 1994"
7,4,21,319,360,353,713,"21 de agosto de 1994"
7,4,21,320,348,318,666,"21 de agosto de 1994"
7,4,21,321,416,352,768,"21 de agosto de 1994"
7,4,21,322,288,229,517,"21 de agosto de 1994"
7,4,21,323,147,127,274,"21 de agosto de 1994"
7,4,21,324,243,208,451,"21 de agosto de 1994"
7,4,21,325,242,213,455,"21 de agosto de 1994"
7,4,21,326,275,239,514,"21 de agosto de 1994"
7,4,21,327,316,283,599,"21 de agosto de 1994"
7,4,21,328,302,265,567,"21 de agosto de 1994"
7,4,21,329,397,346,743,"21 de agosto de 1994"
7,4,21,330,297,241,538,"21 de agosto de 1994"
7,4,25,381,488,475,963,"21 de agosto de 1994"
7,4,25,382,310,277,587,"21 de agosto de 1994"
7,4,25,383,560,573,1133,"21 de agosto de 1994"
7,4,27,402,599,633,1232,"21 de agosto de 1994"
7,4,27,403,440,425,865,"21 de agosto de 1994"
7,4,27,404,463,449,912,"21 de agosto de 1994"
7,4,27,405,497,447,944,"21 de agosto de 1994"
7,4,27,406,393,365,758,"21 de agosto de 1994"
7,4,27,407,615,617,1232,"21 de agosto de 1994"
7,4,27,408,439,509,948,"21 de agosto de 1994"
7,4,27,409,489,558,1047,"21 de agosto de 1994"
7,4,27,410,525,588,1113,"21 de agosto de 1994"
7,4,27,411,648,627,1275,"21 de agosto de 1994"
7,4,27,412,703,672,1375,"21 de agosto de 1994"
7,4,27,413,476,385,861,"21 de agosto de 1994"
7,4,27,414,461,409,870,"21 de agosto de 1994"
7,4,27,415,421,290,711,"21 de agosto de 1994"
7,4,27,416,468,415,883,"21 de agosto de 1994"
7,4,27,417,378,359,737,"21 de agosto de 1994"
7,4,27,418,159,100,259,"21 de agosto de 1994"
7,4,27,419,264,242,506,"21 de agosto de 1994"
7,4,27,420,213,230,443,"21 de agosto de 1994"
7,4,27,421,308,270,578,"21 de agosto de 1994"
7,4,27,422,240,193,433,"21 de agosto de 1994"
7,4,27,423,369,272,641,"21 de agosto de 1994"
7,4,27,424,390,360,750,"21 de agosto de 1994"
7,4,27,425,449,397,846,"21 de agosto de 1994"
7,4,27,426,340,316,656,"21 de agosto de 1994"
7,4,27,427,313,314,627,"21 de agosto de 1994"
7,4,27,428,362,362,724,"21 de agosto de 1994"
7,4,27,429,423,381,804,"21 de agosto de 1994"
7,4,27,430,320,306,626,"21 de agosto de 1994"
7,4,27,431,662,616,1278,"21 de agosto de 1994"
7,4,27,432,371,319,690,"21 de agosto de 1994"
7,4,29,436,385,337,722,"21 de agosto de 1994"
7,4,29,437,452,383,835,"21 de agosto de 1994"
7,4,29,438,169,149,318,"21 de agosto de 1994"
7,4,33,502,594,518,1112,"21 de agosto de 1994"
7,4,33,503,395,315,710,"21 de agosto de 1994"
7,4,43,621,451,411,862,"21 de agosto de 1994"
7,4,43,622,538,520,1058,"21 de agosto de 1994"
7,4,43,623,347,321,668,"21 de agosto de 1994"
7,4,43,624,225,214,439,"21 de agosto de 1994"
7,4,43,625,127,117,244,"21 de agosto de 1994"
7,4,43,626,392,376,768,"21 de agosto de 1994"
7,4,48,669,522,555,1077,"21 de agosto de 1994"
7,4,48,670,621,618,1239,"21 de agosto de 1994"
7,4,48,671,629,616,1245,"21 de agosto de 1994"
7,4,48,672,520,501,1021,"21 de agosto de 1994"
7,4,48,673,349,301,650,"21 de agosto de 1994"
7,4,48,674,427,412,839,"21 de agosto de 1994"
7,4,48,675,179,134,313,"21 de agosto de 1994"
7,4,48,676,493,442,935,"21 de agosto de 1994"
7,4,48,677,279,229,508,"21 de agosto de 1994"
7,4,48,678,432,373,805,"21 de agosto de 1994"
7,4,48,679,349,320,669,"21 de agosto de 1994"
7,4,48,680,341,318,659,"21 de agosto de 1994"
7,4,48,681,354,339,693,"21 de agosto de 1994"
7,4,62,913,616,547,1163,"21 de agosto de 1994"
7,4,62,914,498,391,889,"21 de agosto de 1994"
7,4,62,915,381,327,708,"21 de agosto de 1994"
7,4,62,916,555,516,1071,"21 de agosto de 1994"
7,4,62,917,223,206,429,"21 de agosto de 1994"
7,4,62,918,383,349,732,"21 de agosto de 1994"
7,4,62,919,273,246,519,"21 de agosto de 1994"
7,4,62,920,525,459,984,"21 de agosto de 1994"
7,4,62,921,290,259,549,"21 de agosto de 1994"
7,4,62,922,210,203,413,"21 de agosto de 1994"
7,4,63,923,349,395,744,"21 de agosto de 1994"
7,4,63,924,255,233,488,"21 de agosto de 1994"
7,4,68,990,891,833,1724,"21 de agosto de 1994"
7,4,68,991,509,484,993,"21 de agosto de 1994"
7,4,68,992,339,390,729,"21 de agosto de 1994"
7,4,68,993,462,489,951,"21 de agosto de 1994"
7,4,68,994,487,555,1042,"21 de agosto de 1994"
7,4,68,995,585,559,1144,"21 de agosto de 1994"
7,4,68,996,392,358,750,"21 de agosto de 1994"
7,4,68,997,455,381,836,"21 de agosto de 1994"
7,4,68,998,396,316,712,"21 de agosto de 1994"
7,4,68,999,430,350,780,"21 de agosto de 1994"
7,4,68,1000,328,304,632,"21 de agosto de 1994"
7,4,68,1001,297,236,533,"21 de agosto de 1994"
7,4,68,1002,492,428,920,"21 de agosto de 1994"
7,4,68,1003,370,345,715,"21 de agosto de 1994"
7,4,68,1004,246,223,469,"21 de agosto de 1994"
7,4,68,1005,145,111,256,"21 de agosto de 1994"
7,4,68,1006,169,138,307,"21 de agosto de 1994"
7,4,68,1007,439,385,824,"21 de agosto de 1994"
7,4,73,1052,580,544,1124,"21 de agosto de 1994"
7,4,73,1053,502,499,1001,"21 de agosto de 1994"
7,4,73,1054,457,405,862,"21 de agosto de 1994"
7,4,73,1055,375,381,756,"21 de agosto de 1994"
7,4,73,1056,448,450,898,"21 de agosto de 1994"
7,4,73,1057,389,421,810,"21 de agosto de 1994"
7,4,73,1058,385,358,743,"21 de agosto de 1994"
7,4,73,1059,390,378,768,"21 de agosto de 1994"
7,4,73,1060,483,482,965,"21 de agosto de 1994"
7,4,73,1061,482,447,929,"21 de agosto de 1994"
7,4,73,1062,607,574,1181,"21 de agosto de 1994"
7,4,73,1063,334,280,614,"21 de agosto de 1994"
7,4,73,1064,471,390,861,"21 de agosto de 1994"
7,4,73,1065,383,333,716,"21 de agosto de 1994"
7,4,73,1066,448,437,885,"21 de agosto de 1994"
7,4,73,1067,316,289,605,"21 de agosto de 1994"
7,4,73,1068,345,335,680,"21 de agosto de 1994"
7,4,73,1069,491,442,933,"21 de agosto de 1994"
7,4,86,1236,531,484,1015,"21 de agosto de 1994"
7,4,86,1237,392,364,756,"21 de agosto de 1994"
7,4,86,1238,151,143,294,"21 de agosto de 1994"
7,4,86,1239,593,494,1087,"21 de agosto de 1994"
7,4,89,1264,471,448,919,"21 de agosto de 1994"
7,4,93,1411,435,399,834,"21 de agosto de 1994"
7,4,93,1412,248,219,467,"21 de agosto de 1994"
7,4,93,1413,340,302,642,"21 de agosto de 1994"
7,4,93,1414,368,361,729,"21 de agosto de 1994"
7,4,93,1415,197,200,397,"21 de agosto de 1994"
7,4,93,1416,309,288,597,"21 de agosto de 1994"
7,4,93,1417,452,355,807,"21 de agosto de 1994"
7,4,93,1418,250,227,477,"21 de agosto de 1994"
7,4,93,1419,317,302,619,"21 de agosto de 1994"
7,4,93,1420,224,225,449,"21 de agosto de 1994"
7,4,93,1421,301,287,588,"21 de agosto de 1994"
7,4,93,1422,328,281,609,"21 de agosto de 1994"
7,4,93,1423,293,270,563,"21 de agosto de 1994"
7,4,93,1424,384,315,699,"21 de agosto de 1994"
7,4,93,1425,206,189,395,"21 de agosto de 1994"
7,4,93,1426,450,374,824,"21 de agosto de 1994"
7,4,93,1427,295,288,583,"21 de agosto de 1994"
7,4,93,1428,234,186,420,"21 de agosto de 1994"
7,4,93,1429,493,494,987,"21 de agosto de 1994"
7,4,93,1430,353,351,704,"21 de agosto de 1994"
7,4,93,1431,398,340,738,"21 de agosto de 1994"
7,4,93,1432,488,451,939,"21 de agosto de 1994"
7,4,93,1433,429,408,837,"21 de agosto de 1994"
7,4,93,1434,400,351,751,"21 de agosto de 1994"
7,4,93,1435,339,252,591,"21 de agosto de 1994"
7,4,93,1436,80,61,141,"21 de agosto de 1994"
7,4,93,1437,323,259,582,"21 de agosto de 1994"
7,4,111,1915,299,332,631,"21 de agosto de 1994"
7,4,111,1916,296,315,611,"21 de agosto de 1994"
7,4,111,1917,230,185,415,"21 de agosto de 1994"
7,4,111,1918,363,372,735,"21 de agosto de 1994"
7,4,111,1919,228,248,476,"21 de agosto de 1994"
7,4,111,1920,588,566,1154,"21 de agosto de 1994"
7,4,111,1921,297,319,616,"21 de agosto de 1994"
7,4,111,1922,404,477,881,"21 de agosto de 1994"
7,4,111,1923,438,545,983,"21 de agosto de 1994"
7,4,111,1924,311,275,586,"21 de agosto de 1994"
7,4,111,1925,346,288,634,"21 de agosto de 1994"
7,4,111,1926,247,283,530,"21 de agosto de 1994"
7,4,111,1927,610,594,1204,"21 de agosto de 1994"
7,4,111,1928,277,297,574,"21 de agosto de 1994"
7,4,111,1929,319,266,585,"21 de agosto de 1994"
7,5,15,163,358,345,703,"21 de agosto de 1994"
7,5,15,164,599,642,1241,"21 de agosto de 1994"
7,5,15,165,343,418,761,"21 de agosto de 1994"
7,5,15,166,388,383,771,"21 de agosto de 1994"
7,5,15,167,405,402,807,"21 de agosto de 1994"
7,5,15,168,287,317,604,"21 de agosto de 1994"
7,5,15,169,326,327,653,"21 de agosto de 1994"
7,5,15,170,287,260,547,"21 de agosto de 1994"
7,5,15,171,212,178,390,"21 de agosto de 1994"
7,5,15,172,206,171,377,"21 de agosto de 1994"
7,5,15,173,355,327,682,"21 de agosto de 1994"
7,5,15,174,218,182,400,"21 de agosto de 1994"
7,5,15,175,321,301,622,"21 de agosto de 1994"
7,5,15,176,513,488,1001,"21 de agosto de 1994"
7,5,15,177,231,221,452,"21 de agosto de 1994"
7,5,15,178,454,425,879,"21 de agosto de 1994"
7,5,15,179,295,276,571,"21 de agosto de 1994"
7,5,15,180,397,365,762,"21 de agosto de 1994"
7,5,15,181,466,423,889,"21 de agosto de 1994"
7,5,15,182,460,426,886,"21 de agosto de 1994"
7,5,15,183,360,377,737,"21 de agosto de 1994"
7,5,15,184,556,612,1168,"21 de agosto de 1994"
7,5,15,185,260,218,478,"21 de agosto de 1994"
7,5,35,532,705,664,1369,"21 de agosto de 1994"
7,5,35,533,454,441,895,"21 de agosto de 1994"
7,5,35,534,313,268,581,"21 de agosto de 1994"
7,5,35,535,421,395,816,"21 de agosto de 1994"
7,5,35,536,435,480,915,"21 de agosto de 1994"
7,5,55,780,650,671,1321,"21 de agosto de 1994"
7,5,55,781,413,413,826,"21 de agosto de 1994"
7,5,88,1247,285,287,572,"21 de agosto de 1994"
7,5,88,1248,513,543,1056,"21 de agosto de 1994"
7,5,88,1249,493,500,993,"21 de agosto de 1994"
7,5,88,1250,443,468,911,"21 de agosto de 1994"
7,5,88,1251,408,435,843,"21 de agosto de 1994"
7,5,88,1252,406,359,765,"21 de agosto de 1994"
7,5,88,1253,326,271,597,"21 de agosto de 1994"
7,5,88,1254,376,295,671,"21 de agosto de 1994"
7,5,88,1255,183,144,327,"21 de agosto de 1994"
7,5,88,1256,245,247,492,"21 de agosto de 1994"
7,5,88,1257,292,250,542,"21 de agosto de 1994"
7,5,88,1258,314,315,629,"21 de agosto de 1994"
7,5,88,1259,425,423,848,"21 de agosto de 1994"
7,5,88,1260,344,346,690,"21 de agosto de 1994"
7,5,88,1261,208,185,393,"21 de agosto de 1994"
7,5,88,1262,202,174,376,"21 de agosto de 1994"
7,5,88,1263,174,171,345,"21 de agosto de 1994"
7,5,90,1265,559,551,1110,"21 de agosto de 1994"
7,5,90,1266,529,590,1119,"21 de agosto de 1994"
7,5,90,1267,457,476,933,"21 de agosto de 1994"
7,5,90,1268,686,766,1452,"21 de agosto de 1994"
7,5,90,1269,460,499,959,"21 de agosto de 1994"
7,5,90,1270,594,676,1270,"21 de agosto de 1994"
7,5,90,1271,552,622,1174,"21 de agosto de 1994"
7,5,90,1272,614,622,1236,"21 de agosto de 1994"
7,5,90,1273,510,521,1031,"21 de agosto de 1994"
7,5,90,1274,496,547,1043,"21 de agosto de 1994"
7,5,90,1275,520,592,1112,"21 de agosto de 1994"
7,5,90,1276,313,338,651,"21 de agosto de 1994"
7,5,90,1277,559,618,1177,"21 de agosto de 1994"
7,5,90,1278,527,578,1105,"21 de agosto de 1994"
7,5,90,1279,510,612,1122,"21 de agosto de 1994"
7,5,90,1280,607,688,1295,"21 de agosto de 1994"
7,5,90,1281,613,639,1252,"21 de agosto de 1994"
7,5,90,1282,568,694,1262,"21 de agosto de 1994"
7,5,90,1283,484,535,1019,"21 de agosto de 1994"
7,5,90,1284,325,395,720,"21 de agosto de 1994"
7,5,90,1285,390,441,831,"21 de agosto de 1994"
7,5,90,1286,478,547,1025,"21 de agosto de 1994"
7,5,90,1287,411,490,901,"21 de agosto de 1994"
7,5,90,1288,248,289,537,"21 de agosto de 1994"
7,5,90,1289,314,404,718,"21 de agosto de 1994"
7,5,90,1290,335,435,770,"21 de agosto de 1994"
7,5,90,1291,450,534,984,"21 de agosto de 1994"
7,5,90,1292,417,489,906,"21 de agosto de 1994"
7,5,90,1293,585,697,1282,"21 de agosto de 1994"
7,5,90,1294,525,650,1175,"21 de agosto de 1994"
7,5,90,1295,506,619,1125,"21 de agosto de 1994"
7,5,90,1296,481,572,1053,"21 de agosto de 1994"
7,5,90,1297,349,416,765,"21 de agosto de 1994"
7,5,90,1298,273,337,610,"21 de agosto de 1994"
7,5,90,1299,277,290,567,"21 de agosto de 1994"
7,5,90,1300,384,493,877,"21 de agosto de 1994"
7,5,90,1301,461,543,1004,"21 de agosto de 1994"
7,5,90,1302,402,466,868,"21 de agosto de 1994"
7,5,90,1303,270,291,561,"21 de agosto de 1994"
7,5,90,1304,571,654,1225,"21 de agosto de 1994"
7,5,90,1305,211,231,442,"21 de agosto de 1994"
7,5,90,1306,301,343,644,"21 de agosto de 1994"
7,5,90,1307,424,484,908,"21 de agosto de 1994"
7,5,90,1308,257,346,603,"21 de agosto de 1994"
7,5,90,1309,521,658,1179,"21 de agosto de 1994"
7,5,90,1310,422,520,942,"21 de agosto de 1994"
7,5,90,1311,492,630,1122,"21 de agosto de 1994"
7,5,90,1312,311,333,644,"21 de agosto de 1994"
7,5,90,1313,380,433,813,"21 de agosto de 1994"
7,5,90,1314,404,488,892,"21 de agosto de 1994"
7,5,90,1315,336,387,723,"21 de agosto de 1994"
7,5,90,1316,232,315,547,"21 de agosto de 1994"
7,5,90,1317,388,464,852,"21 de agosto de 1994"
7,5,90,1318,245,275,520,"21 de agosto de 1994"
7,5,90,1319,219,252,471,"21 de agosto de 1994"
7,5,90,1320,502,504,1006,"21 de agosto de 1994"
7,5,90,1321,446,486,932,"21 de agosto de 1994"
7,5,90,1322,382,457,839,"21 de agosto de 1994"
7,5,90,1323,542,584,1126,"21 de agosto de 1994"
7,5,90,1324,529,562,1091,"21 de agosto de 1994"
7,5,90,1325,323,383,706,"21 de agosto de 1994"
7,5,90,1326,432,501,933,"21 de agosto de 1994"
7,5,90,1327,632,686,1318,"21 de agosto de 1994"
7,5,90,1328,483,533,1016,"21 de agosto de 1994"
7,5,90,1329,462,557,1019,"21 de agosto de 1994"
7,5,90,1330,458,541,999,"21 de agosto de 1994"
7,5,90,1331,558,639,1197,"21 de agosto de 1994"
7,5,90,1332,495,602,1097,"21 de agosto de 1994"
7,5,90,1333,617,694,1311,"21 de agosto de 1994"
7,5,90,1334,575,644,1219,"21 de agosto de 1994"
7,5,90,1335,309,374,683,"21 de agosto de 1994"
7,5,90,1336,726,797,1523,"21 de agosto de 1994"
7,5,90,1337,467,445,912,"21 de agosto de 1994"
7,5,90,1338,592,650,1242,"21 de agosto de 1994"
7,5,90,1339,567,629,1196,"21 de agosto de 1994"
7,5,90,1340,527,554,1081,"21 de agosto de 1994"
7,5,90,1341,576,612,1188,"21 de agosto de 1994"
7,5,90,1342,244,260,504,"21 de agosto de 1994"
7,5,90,1343,457,483,940,"21 de agosto de 1994"
7,5,90,1344,599,461,1060,"21 de agosto de 1994"
7,5,90,1345,219,179,398,"21 de agosto de 1994"
7,5,90,1346,658,613,1271,"21 de agosto de 1994"
7,5,90,1347,256,209,465,"21 de agosto de 1994"
7,5,90,1348,120,102,222,"21 de agosto de 1994"
7,5,90,1349,261,221,482,"21 de agosto de 1994"
7,5,90,1350,272,237,509,"21 de agosto de 1994"
7,5,90,1351,463,413,876,"21 de agosto de 1994"
7,5,90,1352,396,358,754,"21 de agosto de 1994"
7,5,90,1353,224,191,415,"21 de agosto de 1994"
7,5,90,1354,338,280,618,"21 de agosto de 1994"
7,5,90,1355,345,315,660,"21 de agosto de 1994"
7,5,90,1356,241,202,443,"21 de agosto de 1994"
7,5,90,1357,189,143,332,"21 de agosto de 1994"
7,5,90,1358,393,319,712,"21 de agosto de 1994"
7,5,90,1359,330,323,653,"21 de agosto de 1994"
7,5,90,1360,284,271,555,"21 de agosto de 1994"
7,5,90,1361,391,318,709,"21 de agosto de 1994"
7,5,90,1362,337,336,673,"21 de agosto de 1994"
7,5,90,1363,307,273,580,"21 de agosto de 1994"
7,5,90,1364,242,227,469,"21 de agosto de 1994"
7,5,90,1365,263,250,513,"21 de agosto de 1994"
7,5,90,1366,230,225,455,"21 de agosto de 1994"
7,5,90,1367,356,341,697,"21 de agosto de 1994"
7,5,90,1368,180,167,347,"21 de agosto de 1994"
7,5,90,1369,274,241,515,"21 de agosto de 1994"
7,5,90,1370,557,601,1158,"21 de agosto de 1994"
7,5,90,1371,299,281,580,"21 de agosto de 1994"
7,5,90,1372,308,294,602,"21 de agosto de 1994"
7,5,90,1373,406,382,788,"21 de agosto de 1994"
7,5,90,1374,345,307,652,"21 de agosto de 1994"
7,5,90,1375,233,183,416,"21 de agosto de 1994"
7,5,90,1376,214,191,405,"21 de agosto de 1994"
7,5,90,1377,306,271,577,"21 de agosto de 1994"
7,5,90,1378,422,429,851,"21 de agosto de 1994"
7,5,90,1379,462,441,903,"21 de agosto de 1994"
7,5,90,1380,197,210,407,"21 de agosto de 1994"
7,5,90,1381,434,423,857,"21 de agosto de 1994"
7,5,90,1382,231,202,433,"21 de agosto de 1994"
7,5,90,1383,317,276,593,"21 de agosto de 1994"
7,5,90,1384,409,395,804,"21 de agosto de 1994"
7,5,90,1385,374,392,766,"21 de agosto de 1994"
7,5,90,1386,339,299,638,"21 de agosto de 1994"
7,5,90,1387,588,566,1154,"21 de agosto de 1994"
7,5,90,1388,262,256,518,"21 de agosto de 1994"
7,5,90,1389,316,258,574,"21 de agosto de 1994"
7,5,90,1390,375,351,726,"21 de agosto de 1994"
7,5,90,1391,281,264,545,"21 de agosto de 1994"
7,5,90,1392,273,257,530,"21 de agosto de 1994"
7,5,90,1393,437,403,840,"21 de agosto de 1994"
7,5,90,1394,18,21,39,"21 de agosto de 1994"
7,5,90,1395,456,452,908,"21 de agosto de 1994"
7,5,90,1396,469,461,930,"21 de agosto de 1994"
7,5,90,1397,394,405,799,"21 de agosto de 1994"
7,5,90,1398,366,309,675,"21 de agosto de 1994"
7,5,90,1399,406,360,766,"21 de agosto de 1994"
7,5,90,1400,320,280,600,"21 de agosto de 1994"
7,5,90,1401,615,51,666,"21 de agosto de 1994"
7,5,90,1402,530,53,583,"21 de agosto de 1994"
7,5,90,1403,435,431,866,"21 de agosto de 1994"
7,5,101,1580,221,242,463,"21 de agosto de 1994"
7,5,101,1581,384,425,809,"21 de agosto de 1994"
7,5,101,1582,380,398,778,"21 de agosto de 1994"
7,5,101,1583,389,408,797,"21 de agosto de 1994"
7,5,101,1584,346,354,700,"21 de agosto de 1994"
7,5,101,1585,318,304,622,"21 de agosto de 1994"
7,5,101,1586,398,351,749,"21 de agosto de 1994"
7,5,101,1587,210,225,435,"21 de agosto de 1994"
7,5,101,1588,279,231,510,"21 de agosto de 1994"
7,5,101,1589,287,247,534,"21 de agosto de 1994"
7,5,101,1590,406,407,813,"21 de agosto de 1994"
7,5,101,1591,554,524,1078,"21 de agosto de 1994"
7,5,101,1592,523,470,993,"21 de agosto de 1994"
7,5,101,1593,371,328,699,"21 de agosto de 1994"
7,5,101,1594,562,549,1111,"21 de agosto de 1994"
7,5,101,1595,231,245,476,"21 de agosto de 1994"
7,5,101,1596,316,326,642,"21 de agosto de 1994"
7,5,101,1597,317,342,659,"21 de agosto de 1994"
7,5,101,1598,322,331,653,"21 de agosto de 1994"
7,5,101,1599,175,169,344,"21 de agosto de 1994"
7,5,101,1600,270,256,526,"21 de agosto de 1994"
7,5,101,1601,290,265,555,"21 de agosto de 1994"
7,5,103,1755,503,531,1034,"21 de agosto de 1994"
7,5,103,1756,246,225,471,"21 de agosto de 1994"
7,5,103,1757,304,259,563,"21 de agosto de 1994"
7,5,103,1758,283,262,545,"21 de agosto de 1994"
7,5,103,1759,463,381,844,"21 de agosto de 1994"
7,5,103,1760,272,251,523,"21 de agosto de 1994"
7,5,103,1761,192,177,369,"21 de agosto de 1994"
7,5,103,1762,298,286,584,"21 de agosto de 1994"
7,5,103,1763,196,222,418,"21 de agosto de 1994"
7,5,103,1764,460,435,895,"21 de agosto de 1994"
7,5,103,1765,346,321,667,"21 de agosto de 1994"
7,5,103,1766,285,265,550,"21 de agosto de 1994"
7,5,103,1767,391,341,732,"21 de agosto de 1994"
7,5,103,1768,198,168,366,"21 de agosto de 1994"
7,5,103,1769,406,358,764,"21 de agosto de 1994"
7,5,103,1770,454,439,893,"21 de agosto de 1994"
7,5,105,1778,540,541,1081,"21 de agosto de 1994"
7,5,105,1779,380,340,720,"21 de agosto de 1994"
7,5,105,1780,286,260,546,"21 de agosto de 1994"
7,5,105,1781,347,374,721,"21 de agosto de 1994"
7,5,105,1782,343,326,669,"21 de agosto de 1994"
7,5,105,1783,216,237,453,"21 de agosto de 1994"
7,5,105,1784,436,465,901,"21 de agosto de 1994"
7,5,105,1785,342,353,695,"21 de agosto de 1994"
7,6,5,44,768,701,1469,"21 de agosto de 1994"
7,6,5,45,280,224,504,"21 de agosto de 1994"
7,6,5,46,233,185,418,"21 de agosto de 1994"
7,6,5,47,140,121,261,"21 de agosto de 1994"
7,6,5,48,468,431,899,"21 de agosto de 1994"
7,6,5,49,315,266,581,"21 de agosto de 1994"
7,6,5,50,381,297,678,"21 de agosto de 1994"
7,6,5,51,255,192,447,"21 de agosto de 1994"
7,6,5,52,322,253,575,"21 de agosto de 1994"
7,6,5,53,415,339,754,"21 de agosto de 1994"
7,6,16,186,372,384,756,"21 de agosto de 1994"
7,6,16,187,575,569,1144,"21 de agosto de 1994"
7,6,16,188,552,468,1020,"21 de agosto de 1994"
7,6,16,189,304,249,553,"21 de agosto de 1994"
7,6,16,190,160,148,308,"21 de agosto de 1994"
7,6,16,191,198,178,376,"21 de agosto de 1994"
7,6,16,192,433,391,824,"21 de agosto de 1994"
7,6,16,193,592,522,1114,"21 de agosto de 1994"
7,6,16,194,526,470,996,"21 de agosto de 1994"
7,6,16,195,235,215,450,"21 de agosto de 1994"
7,6,16,196,233,207,440,"21 de agosto de 1994"
7,6,31,456,516,477,993,"21 de agosto de 1994"
7,6,31,457,590,581,1171,"21 de agosto de 1994"
7,6,31,458,516,543,1059,"21 de agosto de 1994"
7,6,31,459,538,552,1090,"21 de agosto de 1994"
7,6,31,460,400,378,778,"21 de agosto de 1994"
7,6,31,461,517,489,1006,"21 de agosto de 1994"
7,6,31,462,773,778,1551,"21 de agosto de 1994"
7,6,31,463,356,347,703,"21 de agosto de 1994"
7,6,31,464,557,536,1093,"21 de agosto de 1994"
7,6,31,465,376,332,708,"21 de agosto de 1994"
7,6,31,466,417,368,785,"21 de agosto de 1994"
7,6,31,467,361,362,723,"21 de agosto de 1994"
7,6,31,468,387,349,736,"21 de agosto de 1994"
7,6,31,469,365,344,709,"21 de agosto de 1994"
7,6,31,470,326,302,628,"21 de agosto de 1994"
7,6,31,471,602,606,1208,"21 de agosto de 1994"
7,6,31,472,321,306,627,"21 de agosto de 1994"
7,6,31,473,616,618,1234,"21 de agosto de 1994"
7,6,31,474,250,242,492,"21 de agosto de 1994"
7,6,31,475,378,360,738,"21 de agosto de 1994"
7,6,31,476,529,525,1054,"21 de agosto de 1994"
7,6,31,477,637,665,1302,"21 de agosto de 1994"
7,6,31,478,692,739,1431,"21 de agosto de 1994"
7,6,31,479,339,365,704,"21 de agosto de 1994"
7,6,31,480,335,328,663,"21 de agosto de 1994"
7,6,31,481,776,747,1523,"21 de agosto de 1994"
7,6,31,482,704,683,1387,"21 de agosto de 1994"
7,6,31,483,344,325,669,"21 de agosto de 1994"
7,6,31,484,401,367,768,"21 de agosto de 1994"
7,6,31,485,356,350,706,"21 de agosto de 1994"
7,6,31,486,713,767,1480,"21 de agosto de 1994"
7,6,31,487,732,719,1451,"21 de agosto de 1994"
7,6,31,488,539,567,1106,"21 de agosto de 1994"
7,6,38,556,434,446,880,"21 de agosto de 1994"
7,6,38,557,383,356,739,"21 de agosto de 1994"
7,6,38,558,418,335,753,"21 de agosto de 1994"
7,6,38,559,328,274,602,"21 de agosto de 1994"
7,6,38,560,480,403,883,"21 de agosto de 1994"
7,6,38,561,506,414,920,"21 de agosto de 1994"
7,6,38,562,327,249,576,"21 de agosto de 1994"
7,6,38,563,448,399,847,"21 de agosto de 1994"
7,6,38,564,223,183,406,"21 de agosto de 1994"
7,6,38,565,343,305,648,"21 de agosto de 1994"
7,6,50,692,169,188,357,"21 de agosto de 1994"
7,6,50,693,288,276,564,"21 de agosto de 1994"
7,6,50,694,281,256,537,"21 de agosto de 1994"
7,6,50,695,326,272,598,"21 de agosto de 1994"
7,6,50,696,447,429,876,"21 de agosto de 1994"
7,6,65,944,617,522,1139,"21 de agosto de 1994"
7,6,65,945,666,620,1286,"21 de agosto de 1994"
7,6,65,946,734,763,1497,"21 de agosto de 1994"
7,6,65,947,747,749,1496,"21 de agosto de 1994"
7,6,65,948,710,723,1433,"21 de agosto de 1994"
7,6,65,949,748,723,1471,"21 de agosto de 1994"
7,6,65,950,813,793,1606,"21 de agosto de 1994"
7,6,65,951,907,876,1783,"21 de agosto de 1994"
7,6,65,952,750,751,1501,"21 de agosto de 1994"
7,6,65,953,636,586,1222,"21 de agosto de 1994"
7,6,65,954,488,454,942,"21 de agosto de 1994"
7,6,65,955,344,280,624,"21 de agosto de 1994"
7,6,65,956,404,329,733,"21 de agosto de 1994"
7,6,65,957,321,268,589,"21 de agosto de 1994"
7,6,65,958,375,335,710,"21 de agosto de 1994"
7,6,65,959,376,342,718,"21 de agosto de 1994"
7,6,65,960,562,509,1071,"21 de agosto de 1994"
7,6,65,961,235,202,437,"21 de agosto de 1994"
7,6,65,962,564,549,1113,"21 de agosto de 1994"
7,6,65,963,530,505,1035,"21 de agosto de 1994"
7,6,65,964,700,648,1348,"21 de agosto de 1994"
7,6,65,965,549,462,1011,"21 de agosto de 1994"
7,6,65,966,202,168,370,"21 de agosto de 1994"
7,6,65,967,231,228,459,"21 de agosto de 1994"
7,6,65,968,532,471,1003,"21 de agosto de 1994"
7,6,65,969,528,535,1063,"21 de agosto de 1994"
7,6,65,970,524,492,1016,"21 de agosto de 1994"
7,6,65,971,588,526,1114,"21 de agosto de 1994"
7,6,65,972,652,543,1195,"21 de agosto de 1994"
7,6,65,973,543,420,963,"21 de agosto de 1994"
7,6,65,974,673,565,1238,"21 de agosto de 1994"
7,6,65,975,598,526,1124,"21 de agosto de 1994"
7,6,65,976,458,389,847,"21 de agosto de 1994"
7,6,71,1039,414,430,844,"21 de agosto de 1994"
7,6,71,1040,325,317,642,"21 de agosto de 1994"
7,6,71,1041,712,681,1393,"21 de agosto de 1994"
7,6,71,1042,379,360,739,"21 de agosto de 1994"
7,6,71,1043,347,266,613,"21 de agosto de 1994"
7,6,71,1044,490,496,986,"21 de agosto de 1994"
7,6,71,1045,500,450,950,"21 de agosto de 1994"
7,6,71,1046,193,226,419,"21 de agosto de 1994"
7,6,71,1047,582,518,1100,"21 de agosto de 1994"
7,6,71,1048,498,453,951,"21 de agosto de 1994"
7,6,75,1082,445,401,846,"21 de agosto de 1994"
7,6,75,1083,494,436,930,"21 de agosto de 1994"
7,6,75,1084,459,413,872,"21 de agosto de 1994"
7,6,75,1085,432,408,840,"21 de agosto de 1994"
7,6,75,1086,227,215,442,"21 de agosto de 1994"
7,6,75,1087,608,581,1189,"21 de agosto de 1994"
7,6,75,1088,413,371,784,"21 de agosto de 1994"
7,6,75,1089,419,446,865,"21 de agosto de 1994"
7,6,75,1090,324,290,614,"21 de agosto de 1994"
7,6,75,1091,297,306,603,"21 de agosto de 1994"
7,6,76,1092,508,509,1017,"21 de agosto de 1994"
7,6,76,1093,508,490,998,"21 de agosto de 1994"
7,6,76,1094,403,310,713,"21 de agosto de 1994"
7,6,76,1095,344,279,623,"21 de agosto de 1994"
7,6,76,1096,533,464,997,"21 de agosto de 1994"
7,6,76,1097,413,348,761,"21 de agosto de 1994"
7,6,76,1098,577,542,1119,"21 de agosto de 1994"
7,6,76,1099,332,291,623,"21 de agosto de 1994"
7,6,76,1100,596,565,1161,"21 de agosto de 1994"
7,6,76,1101,255,311,566,"21 de agosto de 1994"
7,6,76,1102,335,353,688,"21 de agosto de 1994"
7,6,76,1103,539,540,1079,"21 de agosto de 1994"
7,6,76,1104,421,482,903,"21 de agosto de 1994"
7,6,76,1105,466,514,980,"21 de agosto de 1994"
7,6,76,1106,684,767,1451,"21 de agosto de 1994"
7,6,76,1107,485,534,1019,"21 de agosto de 1994"
7,6,76,1108,664,667,1331,"21 de agosto de 1994"
7,6,76,1109,391,382,773,"21 de agosto de 1994"
7,6,76,1110,423,439,862,"21 de agosto de 1994"
7,6,76,1111,552,491,1043,"21 de agosto de 1994"
7,6,76,1112,523,526,1049,"21 de agosto de 1994"
7,6,96,1464,386,406,792,"21 de agosto de 1994"
7,6,96,1465,483,479,962,"21 de agosto de 1994"
7,6,96,1466,343,340,683,"21 de agosto de 1994"
7,6,96,1467,374,362,736,"21 de agosto de 1994"
7,6,96,1468,549,538,1087,"21 de agosto de 1994"
7,6,96,1469,299,285,584,"21 de agosto de 1994"
7,6,96,1470,598,611,1209,"21 de agosto de 1994"
7,6,96,1471,611,565,1176,"21 de agosto de 1994"
7,6,96,1472,561,559,1120,"21 de agosto de 1994"
7,6,96,1473,473,449,922,"21 de agosto de 1994"
7,6,96,1474,647,634,1281,"21 de agosto de 1994"
7,6,96,1475,758,701,1459,"21 de agosto de 1994"
7,6,96,1476,617,623,1240,"21 de agosto de 1994"
7,6,96,1477,536,520,1056,"21 de agosto de 1994"
7,6,96,1478,501,504,1005,"21 de agosto de 1994"
7,6,96,1479,600,590,1190,"21 de agosto de 1994"
7,6,96,1480,686,662,1348,"21 de agosto de 1994"
7,6,96,1481,664,678,1342,"21 de agosto de 1994"
7,6,96,1482,501,567,1068,"21 de agosto de 1994"
7,6,96,1483,451,447,898,"21 de agosto de 1994"
7,6,96,1484,758,755,1513,"21 de agosto de 1994"
7,6,96,1485,665,639,1304,"21 de agosto de 1994"
7,6,100,1568,415,418,833,"21 de agosto de 1994"
7,6,100,1569,454,412,866,"21 de agosto de 1994"
7,6,100,1570,447,441,888,"21 de agosto de 1994"
7,6,100,1571,432,468,900,"21 de agosto de 1994"
7,6,100,1572,734,759,1493,"21 de agosto de 1994"
7,6,100,1573,296,289,585,"21 de agosto de 1994"
7,6,100,1574,400,414,814,"21 de agosto de 1994"
7,6,100,1575,417,463,880,"21 de agosto de 1994"
7,6,100,1576,486,486,972,"21 de agosto de 1994"
7,6,100,1577,255,292,547,"21 de agosto de 1994"
7,6,100,1578,679,675,1354,"21 de agosto de 1994"
7,6,100,1579,465,513,978,"21 de agosto de 1994"
7,6,110,1902,660,695,1355,"21 de agosto de 1994"
7,6,110,1903,513,563,1076,"21 de agosto de 1994"
7,6,110,1904,770,792,1562,"21 de agosto de 1994"
7,6,110,1905,521,560,1081,"21 de agosto de 1994"
7,6,110,1906,498,513,1011,"21 de agosto de 1994"
7,6,110,1907,381,345,726,"21 de agosto de 1994"
7,6,110,1908,601,655,1256,"21 de agosto de 1994"
7,6,110,1909,391,422,813,"21 de agosto de 1994"
7,6,110,1910,375,344,719,"21 de agosto de 1994"
7,6,110,1911,416,338,754,"21 de agosto de 1994"
7,6,110,1912,314,310,624,"21 de agosto de 1994"
7,6,110,1913,447,457,904,"21 de agosto de 1994"
7,6,110,1914,340,356,696,"21 de agosto de 1994"
7,7,1,1,587,520,1107,"21 de agosto de 1994"
7,7,1,2,570,565,1135,"21 de agosto de 1994"
7,7,1,3,573,545,1118,"21 de agosto de 1994"
7,7,1,4,216,153,369,"21 de agosto de 1994"
7,7,1,5,361,285,646,"21 de agosto de 1994"
7,7,1,6,623,535,1158,"21 de agosto de 1994"
7,7,3,21,253,271,524,"21 de agosto de 1994"
7,7,3,22,327,319,646,"21 de agosto de 1994"
7,7,3,23,311,331,642,"21 de agosto de 1994"
7,7,3,24,456,471,927,"21 de agosto de 1994"
7,7,3,25,622,512,1134,"21 de agosto de 1994"
7,7,3,26,626,642,1268,"21 de agosto de 1994"
7,7,3,27,539,479,1018,"21 de agosto de 1994"
7,7,3,28,560,438,998,"21 de agosto de 1994"
7,7,3,29,412,318,730,"21 de agosto de 1994"
7,7,3,30,304,263,567,"21 de agosto de 1994"
7,7,3,31,334,287,621,"21 de agosto de 1994"
7,7,3,32,391,306,697,"21 de agosto de 1994"
7,7,3,33,226,171,397,"21 de agosto de 1994"
7,7,3,34,722,615,1337,"21 de agosto de 1994"
7,7,6,54,510,461,971,"21 de agosto de 1994"
7,7,6,55,237,200,437,"21 de agosto de 1994"
7,7,6,56,264,235,499,"21 de agosto de 1994"
7,7,6,57,343,330,673,"21 de agosto de 1994"
7,7,6,58,169,161,330,"21 de agosto de 1994"
7,7,6,59,323,276,599,"21 de agosto de 1994"
7,7,6,60,382,390,772,"21 de agosto de 1994"
7,7,6,61,466,430,896,"21 de agosto de 1994"
7,7,6,62,505,479,984,"21 de agosto de 1994"
7,7,6,63,142,126,268,"21 de agosto de 1994"
7,7,6,64,477,444,921,"21 de agosto de 1994"
7,7,6,65,326,298,624,"21 de agosto de 1994"
7,7,6,66,414,401,815,"21 de agosto de 1994"
7,7,6,67,340,293,633,"21 de agosto de 1994"
7,7,10,113,384,375,759,"21 de agosto de 1994"
7,7,10,114,583,538,1121,"21 de agosto de 1994"
7,7,10,115,387,335,722,"21 de agosto de 1994"
7,7,32,489,432,392,824,"21 de agosto de 1994"
7,7,32,490,663,672,1335,"21 de agosto de 1994"
7,7,32,491,661,777,1438,"21 de agosto de 1994"
7,7,32,492,309,234,543,"21 de agosto de 1994"
7,7,32,493,409,331,740,"21 de agosto de 1994"
7,7,32,494,435,271,706,"21 de agosto de 1994"
7,7,32,495,277,236,513,"21 de agosto de 1994"
7,7,32,496,592,575,1167,"21 de agosto de 1994"
7,7,32,497,472,395,867,"21 de agosto de 1994"
7,7,32,498,487,442,929,"21 de agosto de 1994"
7,7,32,499,334,265,599,"21 de agosto de 1994"
7,7,32,500,438,379,817,"21 de agosto de 1994"
7,7,32,501,386,385,771,"21 de agosto de 1994"
7,7,36,537,447,421,868,"21 de agosto de 1994"
7,7,36,538,310,300,610,"21 de agosto de 1994"
7,7,36,539,371,390,761,"21 de agosto de 1994"
7,7,37,540,657,626,1283,"21 de agosto de 1994"
7,7,37,541,502,515,1017,"21 de agosto de 1994"
7,7,37,542,521,517,1038,"21 de agosto de 1994"
7,7,37,543,610,624,1234,"21 de agosto de 1994"
7,7,37,544,325,283,608,"21 de agosto de 1994"
7,7,37,545,487,430,917,"21 de agosto de 1994"
7,7,37,546,420,383,803,"21 de agosto de 1994"
7,7,37,547,397,329,726,"21 de agosto de 1994"
7,7,37,548,662,708,1370,"21 de agosto de 1994"
7,7,37,549,271,248,519,"21 de agosto de 1994"
7,7,37,550,268,225,493,"21 de agosto de 1994"
7,7,37,551,217,199,416,"21 de agosto de 1994"
7,7,37,552,573,487,1060,"21 de agosto de 1994"
7,7,37,553,629,682,1311,"21 de agosto de 1994"
7,7,37,554,468,434,902,"21 de agosto de 1994"
7,7,37,555,284,290,574,"21 de agosto de 1994"
7,7,40,577,494,481,975,"21 de agosto de 1994"
7,7,40,578,634,589,1223,"21 de agosto de 1994"
7,7,40,579,451,490,941,"21 de agosto de 1994"
7,7,40,580,663,695,1358,"21 de agosto de 1994"
7,7,40,581,256,255,511,"21 de agosto de 1994"
7,7,40,582,520,609,1129,"21 de agosto de 1994"
7,7,40,583,422,511,933,"21 de agosto de 1994"
7,7,40,584,638,705,1343,"21 de agosto de 1994"
7,7,40,585,426,487,913,"21 de agosto de 1994"
7,7,40,586,621,668,1289,"21 de agosto de 1994"
7,7,40,587,603,677,1280,"21 de agosto de 1994"
7,7,40,588,541,646,1187,"21 de agosto de 1994"
7,7,40,589,646,616,1262,"21 de agosto de 1994"
7,7,40,590,331,319,650,"21 de agosto de 1994"
7,7,40,591,364,302,666,"21 de agosto de 1994"
7,7,40,592,308,206,514,"21 de agosto de 1994"
7,7,40,593,436,366,802,"21 de agosto de 1994"
7,7,40,594,442,390,832,"21 de agosto de 1994"
7,7,40,595,426,396,822,"21 de agosto de 1994"
7,7,40,596,435,390,825,"21 de agosto de 1994"
7,7,40,597,488,422,910,"21 de agosto de 1994"
7,7,40,598,533,488,1021,"21 de agosto de 1994"
7,7,40,599,472,434,906,"21 de agosto de 1994"
7,7,40,600,321,280,601,"21 de agosto de 1994"
7,7,40,601,91,72,163,"21 de agosto de 1994"
7,7,53,760,402,392,794,"21 de agosto de 1994"
7,7,53,761,300,274,574,"21 de agosto de 1994"
7,7,53,762,345,319,664,"21 de agosto de 1994"
7,7,53,763,316,276,592,"21 de agosto de 1994"
7,7,53,764,282,256,538,"21 de agosto de 1994"
7,7,54,765,689,684,1373,"21 de agosto de 1994"
7,7,54,766,631,643,1274,"21 de agosto de 1994"
7,7,54,767,675,642,1317,"21 de agosto de 1994"
7,7,54,768,149,117,266,"21 de agosto de 1994"
7,7,54,769,361,321,682,"21 de agosto de 1994"
7,7,54,770,338,291,629,"21 de agosto de 1994"
7,7,54,771,229,211,440,"21 de agosto de 1994"
7,7,54,772,531,455,986,"21 de agosto de 1994"
7,7,54,773,497,461,958,"21 de agosto de 1994"
7,7,54,774,474,426,900,"21 de agosto de 1994"
7,7,54,775,184,154,338,"21 de agosto de 1994"
7,7,54,776,287,246,533,"21 de agosto de 1994"
7,7,54,777,291,272,563,"21 de agosto de 1994"
7,7,54,778,338,267,605,"21 de agosto de 1994"
7,7,54,779,174,129,303,"21 de agosto de 1994"
7,7,57,787,270,225,495,"21 de agosto de 1994"
7,7,57,788,469,488,957,"21 de agosto de 1994"
7,7,57,789,471,484,955,"21 de agosto de 1994"
7,7,57,790,513,511,1024,"21 de agosto de 1994"
7,7,57,791,389,337,726,"21 de agosto de 1994"
7,7,57,792,488,453,941,"21 de agosto de 1994"
7,7,57,793,558,587,1145,"21 de agosto de 1994"
7,7,57,794,421,366,787,"21 de agosto de 1994"
7,7,57,795,331,271,602,"21 de agosto de 1994"
7,7,57,796,380,315,695,"21 de agosto de 1994"
7,7,57,797,577,448,1025,"21 de agosto de 1994"
7,7,57,798,381,338,719,"21 de agosto de 1994"
7,7,57,799,383,293,676,"21 de agosto de 1994"
7,7,57,800,238,212,450,"21 de agosto de 1994"
7,7,57,801,294,230,524,"21 de agosto de 1994"
7,7,57,802,499,381,880,"21 de agosto de 1994"
7,7,57,803,269,226,495,"21 de agosto de 1994"
7,7,57,804,297,293,590,"21 de agosto de 1994"
7,7,57,805,536,397,933,"21 de agosto de 1994"
7,7,57,806,908,760,1668,"21 de agosto de 1994"
7,7,57,807,290,220,510,"21 de agosto de 1994"
7,7,57,808,375,323,698,"21 de agosto de 1994"
7,7,57,809,434,353,787,"21 de agosto de 1994"
7,7,57,810,646,461,1107,"21 de agosto de 1994"
7,7,57,811,412,337,749,"21 de agosto de 1994"
7,7,57,812,358,303,661,"21 de agosto de 1994"
7,7,57,813,537,430,967,"21 de agosto de 1994"
7,7,70,1034,615,560,1175,"21 de agosto de 1994"
7,7,70,1035,406,458,864,"21 de agosto de 1994"
7,7,70,1036,406,407,813,"21 de agosto de 1994"
7,7,70,1037,496,495,991,"21 de agosto de 1994"
7,7,70,1038,472,448,920,"21 de agosto de 1994"
7,7,81,1189,528,471,999,"21 de agosto de 1994"
7,7,81,1190,511,485,996,"21 de agosto de 1994"
7,7,81,1191,149,117,266,"21 de agosto de 1994"
7,7,81,1192,300,248,548,"21 de agosto de 1994"
7,7,81,1193,347,280,627,"21 de agosto de 1994"
7,7,81,1194,384,343,727,"21 de agosto de 1994"
7,7,81,1195,425,353,778,"21 de agosto de 1994"
7,7,81,1196,310,211,521,"21 de agosto de 1994"
7,7,81,1197,363,269,632,"21 de agosto de 1994"
7,7,81,1198,326,256,582,"21 de agosto de 1994"
7,7,81,1199,388,338,726,"21 de agosto de 1994"
7,7,81,1200,461,431,892,"21 de agosto de 1994"
7,7,81,1201,312,304,616,"21 de agosto de 1994"
7,7,81,1202,311,304,615,"21 de agosto de 1994"
7,7,81,1203,422,407,829,"21 de agosto de 1994"
7,7,81,1204,384,306,690,"21 de agosto de 1994"
7,7,81,1205,522,399,921,"21 de agosto de 1994"
7,7,81,1206,346,264,610,"21 de agosto de 1994"
7,7,107,1812,522,514,1036,"21 de agosto de 1994"
7,7,107,1813,546,511,1057,"21 de agosto de 1994"
7,7,107,1814,592,573,1165,"21 de agosto de 1994"
7,7,107,1815,674,643,1317,"21 de agosto de 1994"
7,7,107,1816,244,198,442,"21 de agosto de 1994"
7,7,107,1817,400,331,731,"21 de agosto de 1994"
7,7,107,1818,223,158,381,"21 de agosto de 1994"
7,7,107,1819,488,400,888,"21 de agosto de 1994"
7,7,107,1820,260,193,453,"21 de agosto de 1994"
7,7,107,1821,640,542,1182,"21 de agosto de 1994"
7,7,107,1822,293,265,558,"21 de agosto de 1994"
7,7,107,1823,338,336,674,"21 de agosto de 1994"
7,7,107,1824,231,189,420,"21 de agosto de 1994"
7,7,107,1825,383,342,725,"21 de agosto de 1994"
7,7,107,1826,364,281,645,"21 de agosto de 1994"
7,7,107,1827,175,164,339,"21 de agosto de 1994"
7,8,9,88,427,438,865,"21 de agosto de 1994"
7,8,9,89,340,394,734,"21 de agosto de 1994"
7,8,9,90,362,406,768,"21 de agosto de 1994"
7,8,9,91,708,759,1467,"21 de agosto de 1994"
7,8,9,92,233,239,472,"21 de agosto de 1994"
7,8,9,93,396,432,828,"21 de agosto de 1994"
7,8,9,94,366,390,756,"21 de agosto de 1994"
7,8,9,95,468,483,951,"21 de agosto de 1994"
7,8,9,96,539,616,1155,"21 de agosto de 1994"
7,8,9,97,520,567,1087,"21 de agosto de 1994"
7,8,9,98,549,609,1158,"21 de agosto de 1994"
7,8,9,99,513,561,1074,"21 de agosto de 1994"
7,8,9,100,417,456,873,"21 de agosto de 1994"
7,8,9,101,122,81,203,"21 de agosto de 1994"
7,8,9,102,157,127,284,"21 de agosto de 1994"
7,8,9,103,396,336,732,"21 de agosto de 1994"
7,8,9,104,341,312,653,"21 de agosto de 1994"
7,8,9,105,271,236,507,"21 de agosto de 1994"
7,8,9,106,549,589,1138,"21 de agosto de 1994"
7,8,9,107,159,108,267,"21 de agosto de 1994"
7,8,9,108,44,20,64,"21 de agosto de 1994"
7,8,9,109,396,357,753,"21 de agosto de 1994"
7,8,9,110,383,289,672,"21 de agosto de 1994"
7,8,9,111,356,305,661,"21 de agosto de 1994"
7,8,9,112,760,642,1402,"21 de agosto de 1994"
7,8,51,697,449,472,921,"21 de agosto de 1994"
7,8,51,698,488,529,1017,"21 de agosto de 1994"
7,8,51,699,383,455,838,"21 de agosto de 1994"
7,8,51,700,498,496,994,"21 de agosto de 1994"
7,8,51,701,483,504,987,"21 de agosto de 1994"
7,8,51,702,306,366,672,"21 de agosto de 1994"
7,8,51,703,370,397,767,"21 de agosto de 1994"
7,8,51,704,398,431,829,"21 de agosto de 1994"
7,8,51,705,599,468,1067,"21 de agosto de 1994"
7,8,51,706,584,427,1011,"21 de agosto de 1994"
7,8,51,707,159,127,286,"21 de agosto de 1994"
7,8,51,708,516,471,987,"21 de agosto de 1994"
7,8,51,709,462,374,836,"21 de agosto de 1994"
7,8,51,710,449,345,794,"21 de agosto de 1994"
7,8,51,711,125,103,228,"21 de agosto de 1994"
7,8,51,712,443,381,824,"21 de agosto de 1994"
7,8,51,713,573,461,1034,"21 de agosto de 1994"
7,8,51,714,684,593,1277,"21 de agosto de 1994"
7,8,51,715,416,332,748,"21 de agosto de 1994"
7,8,51,716,374,282,656,"21 de agosto de 1994"
7,8,51,717,287,232,519,"21 de agosto de 1994"
7,8,69,1008,673,595,1268,"21 de agosto de 1994"
7,8,69,1009,418,449,867,"21 de agosto de 1994"
7,8,69,1010,677,697,1374,"21 de agosto de 1994"
7,8,69,1011,559,548,1107,"21 de agosto de 1994"
7,8,69,1012,404,448,852,"21 de agosto de 1994"
7,8,69,1013,317,337,654,"21 de agosto de 1994"
7,8,69,1014,489,497,986,"21 de agosto de 1994"
7,8,69,1015,277,241,518,"21 de agosto de 1994"
7,8,69,1016,398,309,707,"21 de agosto de 1994"
7,8,69,1017,474,431,905,"21 de agosto de 1994"
7,8,69,1018,613,552,1165,"21 de agosto de 1994"
7,8,69,1019,346,271,617,"21 de agosto de 1994"
7,8,69,1020,322,280,602,"21 de agosto de 1994"
7,8,69,1021,627,540,1167,"21 de agosto de 1994"
7,8,69,1022,492,438,930,"21 de agosto de 1994"
7,8,69,1023,187,188,375,"21 de agosto de 1994"
7,8,69,1024,378,309,687,"21 de agosto de 1994"
7,8,69,1025,341,315,656,"21 de agosto de 1994"
7,8,69,1026,461,424,885,"21 de agosto de 1994"
7,8,69,1027,204,167,371,"21 de agosto de 1994"
7,8,69,1028,568,480,1048,"21 de agosto de 1994"
7,8,69,1029,390,332,722,"21 de agosto de 1994"
7,8,69,1030,467,390,857,"21 de agosto de 1994"
7,8,69,1031,351,253,604,"21 de agosto de 1994"
7,8,69,1032,485,402,887,"21 de agosto de 1994"
7,8,69,1033,405,407,812,"21 de agosto de 1994"
7,8,97,1486,306,362,668,"21 de agosto de 1994"
7,8,97,1487,486,504,990,"21 de agosto de 1994"
7,8,97,1488,436,461,897,"21 de agosto de 1994"
7,8,97,1489,484,562,1046,"21 de agosto de 1994"
7,8,97,1490,649,739,1388,"21 de agosto de 1994"
7,8,97,1491,489,596,1085,"21 de agosto de 1994"
7,8,97,1492,396,457,853,"21 de agosto de 1994"
7,8,97,1493,432,476,908,"21 de agosto de 1994"
7,8,97,1494,351,441,792,"21 de agosto de 1994"
7,8,97,1495,400,523,923,"21 de agosto de 1994"
7,8,97,1496,617,701,1318,"21 de agosto de 1994"
7,8,97,1497,316,319,635,"21 de agosto de 1994"
7,8,97,1498,464,485,949,"21 de agosto de 1994"
7,8,97,1499,396,424,820,"21 de agosto de 1994"
7,8,97,1500,355,427,782,"21 de agosto de 1994"
7,8,97,1501,503,544,1047,"21 de agosto de 1994"
7,8,97,1502,399,410,809,"21 de agosto de 1994"
7,8,97,1503,181,150,331,"21 de agosto de 1994"
7,8,97,1504,285,261,546,"21 de agosto de 1994"
7,8,97,1505,176,108,284,"21 de agosto de 1994"
7,8,97,1506,381,336,717,"21 de agosto de 1994"
7,8,97,1507,294,274,568,"21 de agosto de 1994"
7,8,97,1508,662,616,1278,"21 de agosto de 1994"
7,8,97,1509,619,609,1228,"21 de agosto de 1994"
7,8,97,1510,674,526,1200,"21 de agosto de 1994"
7,8,97,1511,447,396,843,"21 de agosto de 1994"
7,8,97,1512,684,578,1262,"21 de agosto de 1994"
7,8,97,1513,305,273,578,"21 de agosto de 1994"
7,8,97,1514,212,162,374,"21 de agosto de 1994"
7,8,97,1515,361,298,659,"21 de agosto de 1994"
7,8,97,1516,738,660,1398,"21 de agosto de 1994"
7,8,97,1517,550,444,994,"21 de agosto de 1994"
7,8,97,1518,628,531,1159,"21 de agosto de 1994"
7,8,97,1519,225,171,396,"21 de agosto de 1994"
7,8,97,1520,493,496,989,"21 de agosto de 1994"
7,8,97,1521,562,567,1129,"21 de agosto de 1994"
7,8,97,1522,155,97,252,"21 de agosto de 1994"
7,8,97,1523,496,398,894,"21 de agosto de 1994"
7,8,97,1524,185,152,337,"21 de agosto de 1994"
7,8,97,1525,492,412,904,"21 de agosto de 1994"
7,8,97,1526,153,127,280,"21 de agosto de 1994"
7,8,97,1527,379,327,706,"21 de agosto de 1994"
7,8,97,1528,215,204,419,"21 de agosto de 1994"
7,8,97,1529,381,13,394,"21 de agosto de 1994"
7,8,108,1828,625,583,1208,"21 de agosto de 1994"
7,8,108,1829,448,485,933,"21 de agosto de 1994"
7,8,108,1830,419,452,871,"21 de agosto de 1994"
7,8,108,1831,554,529,1083,"21 de agosto de 1994"
7,8,108,1832,762,633,1395,"21 de agosto de 1994"
7,8,108,1833,629,602,1231,"21 de agosto de 1994"
7,8,108,1834,559,548,1107,"21 de agosto de 1994"
7,8,108,1835,657,623,1280,"21 de agosto de 1994"
7,8,108,1836,279,231,510,"21 de agosto de 1994"
7,8,108,1837,679,601,1280,"21 de agosto de 1994"
7,8,108,1838,209,155,364,"21 de agosto de 1994"
7,8,108,1839,530,479,1009,"21 de agosto de 1994"
7,8,108,1840,855,775,1630,"21 de agosto de 1994"
7,8,108,1841,825,758,1583,"21 de agosto de 1994"
7,8,108,1842,170,111,281,"21 de agosto de 1994"
7,8,108,1843,496,400,896,"21 de agosto de 1994"
7,8,108,1844,692,629,1321,"21 de agosto de 1994"
7,8,108,1845,853,795,1648,"21 de agosto de 1994"
7,8,108,1846,993,858,1851,"21 de agosto de 1994"
7,8,108,1847,386,272,658,"21 de agosto de 1994"
7,8,108,1848,377,376,753,"21 de agosto de 1994"
7,8,108,1849,488,538,1026,"21 de agosto de 1994"
7,8,108,1850,396,374,770,"21 de agosto de 1994"
7,8,108,1851,458,350,808,"21 de agosto de 1994"
7,8,108,1852,728,366,1094,"21 de agosto de 1994"
7,8,108,1853,543,417,960,"21 de agosto de 1994"
7,8,108,1854,562,407,969,"21 de agosto de 1994"
7,8,108,1855,568,339,907,"21 de agosto de 1994"
7,8,109,1856,382,361,743,"21 de agosto de 1994"
7,8,109,1857,410,429,839,"21 de agosto de 1994"
7,8,109,1858,545,533,1078,"21 de agosto de 1994"
7,8,109,1859,338,312,650,"21 de agosto de 1994"
7,8,109,1860,665,758,1423,"21 de agosto de 1994"
7,8,109,1861,277,305,582,"21 de agosto de 1994"
7,8,109,1862,375,410,785,"21 de agosto de 1994"
7,8,109,1863,312,334,646,"21 de agosto de 1994"
7,8,109,1864,461,477,938,"21 de agosto de 1994"
7,8,109,1865,619,663,1282,"21 de agosto de 1994"
7,8,109,1866,346,301,647,"21 de agosto de 1994"
7,8,109,1867,547,594,1141,"21 de agosto de 1994"
7,8,109,1868,606,642,1248,"21 de agosto de 1994"
7,8,109,1869,488,527,1015,"21 de agosto de 1994"
7,8,109,1870,340,344,684,"21 de agosto de 1994"
7,8,109,1871,378,384,762,"21 de agosto de 1994"
7,8,109,1872,357,321,678,"21 de agosto de 1994"
7,8,109,1873,352,303,655,"21 de agosto de 1994"
7,8,109,1874,512,428,940,"21 de agosto de 1994"
7,8,109,1875,108,86,194,"21 de agosto de 1994"
7,8,109,1876,295,211,506,"21 de agosto de 1994"
7,8,109,1877,386,369,755,"21 de agosto de 1994"
7,8,109,1878,466,396,862,"21 de agosto de 1994"
7,8,109,1879,370,337,707,"21 de agosto de 1994"
7,8,109,1880,315,229,544,"21 de agosto de 1994"
7,8,109,1881,564,554,1118,"21 de agosto de 1994"
7,8,109,1882,548,498,1046,"21 de agosto de 1994"
7,8,109,1883,469,409,878,"21 de agosto de 1994"
7,8,109,1884,403,310,713,"21 de agosto de 1994"
7,8,109,1885,409,369,778,"21 de agosto de 1994"
7,8,109,1886,558,529,1087,"21 de agosto de 1994"
7,8,109,1887,303,234,537,"21 de agosto de 1994"
7,8,109,1888,545,415,960,"21 de agosto de 1994"
7,8,109,1889,264,223,487,"21 de agosto de 1994"
7,8,109,1890,621,527,1148,"21 de agosto de 1994"
7,8,109,1891,466,443,909,"21 de agosto de 1994"
7,8,109,1892,454,385,839,"21 de agosto de 1994"
7,8,109,1893,453,422,875,"21 de agosto de 1994"
7,8,109,1894,457,384,841,"21 de agosto de 1994"
7,8,109,1895,589,444,1033,"21 de agosto de 1994"
7,8,109,1896,519,381,900,"21 de agosto de 1994"
7,8,109,1897,303,249,552,"21 de agosto de 1994"
7,8,109,1898,561,520,1081,"21 de agosto de 1994"
7,8,109,1899,362,304,666,"21 de agosto de 1994"
7,8,109,1900,174,130,304,"21 de agosto de 1994"
7,8,109,1901,609,548,1157,"21 de agosto de 1994"
7,9,4,35,584,519,1103,"21 de agosto de 1994"
7,9,4,36,438,443,881,"21 de agosto de 1994"
7,9,4,37,408,385,793,"21 de agosto de 1994"
7,9,4,38,294,213,507,"21 de agosto de 1994"
7,9,4,39,405,382,787,"21 de agosto de 1994"
7,9,4,40,677,648,1325,"21 de agosto de 1994"
7,9,4,41,456,431,887,"21 de agosto de 1994"
7,9,4,42,589,576,1165,"21 de agosto de 1994"
7,9,4,43,331,292,623,"21 de agosto de 1994"
7,9,14,155,523,561,1084,"21 de agosto de 1994"
7,9,14,156,431,400,831,"21 de agosto de 1994"
7,9,14,157,370,352,722,"21 de agosto de 1994"
7,9,14,158,385,357,742,"21 de agosto de 1994"
7,9,14,159,376,367,743,"21 de agosto de 1994"
7,9,14,160,581,549,1130,"21 de agosto de 1994"
7,9,14,161,235,226,461,"21 de agosto de 1994"
7,9,14,162,401,416,817,"21 de agosto de 1994"
7,9,18,234,323,325,648,"21 de agosto de 1994"
7,9,18,235,283,322,605,"21 de agosto de 1994"
7,9,18,236,228,192,420,"21 de agosto de 1994"
7,9,18,237,337,306,643,"21 de agosto de 1994"
7,9,18,238,288,233,521,"21 de agosto de 1994"
7,9,22,331,120,119,239,"21 de agosto de 1994"
7,9,22,332,426,391,817,"21 de agosto de 1994"
7,9,22,333,505,482,987,"21 de agosto de 1994"
7,9,22,334,515,461,976,"21 de agosto de 1994"
7,9,22,335,423,413,836,"21 de agosto de 1994"
7,9,41,602,618,629,1247,"21 de agosto de 1994"
7,9,41,603,312,378,690,"21 de agosto de 1994"
7,9,41,604,512,494,1006,"21 de agosto de 1994"
7,9,41,605,407,395,802,"21 de agosto de 1994"
7,9,41,606,474,445,919,"21 de agosto de 1994"
7,9,41,607,528,504,1032,"21 de agosto de 1994"
7,9,41,608,753,678,1431,"21 de agosto de 1994"
7,9,41,609,320,295,615,"21 de agosto de 1994"
7,9,41,610,292,296,588,"21 de agosto de 1994"
7,9,41,611,194,197,391,"21 de agosto de 1994"
7,9,41,612,583,526,1109,"21 de agosto de 1994"
7,9,41,613,433,412,845,"21 de agosto de 1994"
7,9,41,614,503,448,951,"21 de agosto de 1994"
7,9,41,615,409,353,762,"21 de agosto de 1994"
7,9,41,616,358,350,708,"21 de agosto de 1994"
7,9,42,617,331,335,666,"21 de agosto de 1994"
7,9,42,618,637,603,1240,"21 de agosto de 1994"
7,9,42,619,354,338,692,"21 de agosto de 1994"
7,9,42,620,467,417,884,"21 de agosto de 1994"
7,9,45,636,445,388,833,"21 de agosto de 1994"
7,9,45,637,622,542,1164,"21 de agosto de 1994"
7,9,47,662,412,386,798,"21 de agosto de 1994"
7,9,47,663,499,500,999,"21 de agosto de 1994"
7,9,47,664,301,261,562,"21 de agosto de 1994"
7,9,47,665,175,146,321,"21 de agosto de 1994"
7,9,47,666,290,267,557,"21 de agosto de 1994"
7,9,47,667,509,497,1006,"21 de agosto de 1994"
7,9,47,668,169,149,318,"21 de agosto de 1994"
7,9,52,718,468,515,983,"21 de agosto de 1994"
7,9,52,719,636,679,1315,"21 de agosto de 1994"
7,9,52,720,488,543,1031,"21 de agosto de 1994"
7,9,52,721,590,673,1263,"21 de agosto de 1994"
7,9,52,722,333,315,648,"21 de agosto de 1994"
7,9,52,723,596,570,1166,"21 de agosto de 1994"
7,9,52,724,604,610,1214,"21 de agosto de 1994"
7,9,52,725,740,720,1460,"21 de agosto de 1994"
7,9,52,726,316,283,599,"21 de agosto de 1994"
7,9,52,727,305,287,592,"21 de agosto de 1994"
7,9,52,728,331,279,610,"21 de agosto de 1994"
7,9,52,729,359,317,676,"21 de agosto de 1994"
7,9,52,730,500,433,933,"21 de agosto de 1994"
7,9,52,731,588,541,1129,"21 de agosto de 1994"
7,9,52,732,579,581,1160,"21 de agosto de 1994"
7,9,52,733,682,599,1281,"21 de agosto de 1994"
7,9,52,734,597,596,1193,"21 de agosto de 1994"
7,9,52,735,565,547,1112,"21 de agosto de 1994"
7,9,52,736,612,650,1262,"21 de agosto de 1994"
7,9,52,737,590,583,1173,"21 de agosto de 1994"
7,9,52,738,408,368,776,"21 de agosto de 1994"
7,9,52,739,464,468,932,"21 de agosto de 1994"
7,9,52,740,470,474,944,"21 de agosto de 1994"
7,9,52,741,470,506,976,"21 de agosto de 1994"
7,9,52,742,454,412,866,"21 de agosto de 1994"
7,9,52,743,491,460,951,"21 de agosto de 1994"
7,9,52,744,618,578,1196,"21 de agosto de 1994"
7,9,52,745,454,395,849,"21 de agosto de 1994"
7,9,52,746,184,177,361,"21 de agosto de 1994"
7,9,52,747,76,57,133,"21 de agosto de 1994"
7,9,52,748,306,268,574,"21 de agosto de 1994"
7,9,52,749,399,358,757,"21 de agosto de 1994"
7,9,52,750,354,317,671,"21 de agosto de 1994"
7,9,52,751,545,494,1039,"21 de agosto de 1994"
7,9,52,752,255,264,519,"21 de agosto de 1994"
7,9,52,753,166,158,324,"21 de agosto de 1994"
7,9,52,754,165,160,325,"21 de agosto de 1994"
7,9,52,755,234,202,436,"21 de agosto de 1994"
7,9,52,756,142,138,280,"21 de agosto de 1994"
7,9,52,757,276,238,514,"21 de agosto de 1994"
7,9,52,758,278,244,522,"21 de agosto de 1994"
7,9,52,759,363,340,703,"21 de agosto de 1994"
7,9,59,815,552,581,1133,"21 de agosto de 1994"
7,9,59,816,919,927,1846,"21 de agosto de 1994"
7,9,59,817,722,743,1465,"21 de agosto de 1994"
7,9,59,818,714,726,1440,"21 de agosto de 1994"
7,9,59,819,675,713,1388,"21 de agosto de 1994"
7,9,59,820,786,751,1537,"21 de agosto de 1994"
7,9,59,821,205,182,387,"21 de agosto de 1994"
7,9,59,822,318,312,630,"21 de agosto de 1994"
7,9,59,823,361,317,678,"21 de agosto de 1994"
7,9,59,824,284,254,538,"21 de agosto de 1994"
7,9,59,825,464,449,913,"21 de agosto de 1994"
7,9,59,826,613,581,1194,"21 de agosto de 1994"
7,9,59,827,367,358,725,"21 de agosto de 1994"
7,9,59,828,445,394,839,"21 de agosto de 1994"
7,9,59,829,432,417,849,"21 de agosto de 1994"
7,9,59,830,403,349,752,"21 de agosto de 1994"
7,9,59,831,421,368,789,"21 de agosto de 1994"
7,9,59,832,336,294,630,"21 de agosto de 1994"
7,9,59,833,493,441,934,"21 de agosto de 1994"
7,9,59,834,329,334,663,"21 de agosto de 1994"
7,9,59,835,438,384,822,"21 de agosto de 1994"
7,9,59,836,496,520,1016,"21 de agosto de 1994"
7,9,59,837,433,418,851,"21 de agosto de 1994"
7,9,59,838,359,346,705,"21 de agosto de 1994"
7,9,59,839,578,582,1160,"21 de agosto de 1994"
7,9,59,840,457,414,871,"21 de agosto de 1994"
7,9,59,841,466,413,879,"21 de agosto de 1994"
7,9,59,842,558,498,1056,"21 de agosto de 1994"
7,9,59,843,700,641,1341,"21 de agosto de 1994"
7,9,59,844,577,496,1073,"21 de agosto de 1994"
7,9,59,845,515,466,981,"21 de agosto de 1994"
7,9,59,846,586,559,1145,"21 de agosto de 1994"
7,9,59,847,437,405,842,"21 de agosto de 1994"
7,9,59,848,808,768,1576,"21 de agosto de 1994"
7,9,59,849,637,622,1259,"21 de agosto de 1994"
7,9,59,850,464,402,866,"21 de agosto de 1994"
7,9,59,851,193,171,364,"21 de agosto de 1994"
7,9,59,852,96,94,190,"21 de agosto de 1994"
7,9,59,853,413,367,780,"21 de agosto de 1994"
7,9,59,854,363,326,689,"21 de agosto de 1994"
7,9,59,855,537,516,1053,"21 de agosto de 1994"
7,9,59,856,361,325,686,"21 de agosto de 1994"
7,9,59,857,793,658,1451,"21 de agosto de 1994"
7,9,59,858,616,571,1187,"21 de agosto de 1994"
7,9,59,859,536,488,1024,"21 de agosto de 1994"
7,9,59,860,314,291,605,"21 de agosto de 1994"
7,9,59,861,521,503,1024,"21 de agosto de 1994"
7,9,59,862,551,439,990,"21 de agosto de 1994"
7,9,59,863,446,371,817,"21 de agosto de 1994"
7,9,59,864,666,624,1290,"21 de agosto de 1994"
7,9,59,865,332,320,652,"21 de agosto de 1994"
7,9,59,866,330,304,634,"21 de agosto de 1994"
7,9,59,867,376,287,663,"21 de agosto de 1994"
7,9,59,868,437,342,779,"21 de agosto de 1994"
7,9,59,869,334,253,587,"21 de agosto de 1994"
7,9,59,870,586,520,1106,"21 de agosto de 1994"
7,9,59,871,407,394,801,"21 de agosto de 1994"
7,9,59,872,761,637,1398,"21 de agosto de 1994"
7,9,59,873,259,228,487,"21 de agosto de 1994"
7,9,59,874,305,217,522,"21 de agosto de 1994"
7,9,59,875,268,203,471,"21 de agosto de 1994"
7,9,59,876,543,398,941,"21 de agosto de 1994"
7,9,59,877,96,73,169,"21 de agosto de 1994"
7,9,59,878,451,356,807,"21 de agosto de 1994"
7,9,59,879,476,389,865,"21 de agosto de 1994"
7,9,59,880,146,93,239,"21 de agosto de 1994"
7,9,59,881,302,213,515,"21 de agosto de 1994"
7,9,60,882,621,610,1231,"21 de agosto de 1994"
7,9,60,883,472,453,925,"21 de agosto de 1994"
7,9,60,884,514,491,1005,"21 de agosto de 1994"
7,9,67,985,602,609,1211,"21 de agosto de 1994"
7,9,67,986,357,377,734,"21 de agosto de 1994"
7,9,67,987,240,214,454,"21 de agosto de 1994"
7,9,67,988,251,226,477,"21 de agosto de 1994"
7,9,67,989,269,305,574,"21 de agosto de 1994"
7,9,72,1049,428,426,854,"21 de agosto de 1994"
7,9,72,1050,615,587,1202,"21 de agosto de 1994"
7,9,72,1051,336,312,648,"21 de agosto de 1994"
7,9,79,1178,544,599,1143,"21 de agosto de 1994"
7,9,79,1179,595,555,1150,"21 de agosto de 1994"
7,9,79,1180,509,495,1004,"21 de agosto de 1994"
7,9,79,1181,472,422,894,"21 de agosto de 1994"
7,9,79,1182,505,479,984,"21 de agosto de 1994"
7,9,79,1183,528,518,1046,"21 de agosto de 1994"
7,9,79,1184,386,419,805,"21 de agosto de 1994"
7,9,79,1185,596,605,1201,"21 de agosto de 1994"
7,9,79,1186,305,311,616,"21 de agosto de 1994"
7,9,82,1207,496,475,971,"21 de agosto de 1994"
7,9,82,1208,533,531,1064,"21 de agosto de 1994"
7,9,82,1209,491,481,972,"21 de agosto de 1994"
7,9,82,1210,459,427,886,"21 de agosto de 1994"
7,9,82,1211,155,150,305,"21 de agosto de 1994"
7,9,82,1212,204,180,384,"21 de agosto de 1994"
7,9,82,1213,508,483,991,"21 de agosto de 1994"
7,9,82,1214,373,360,733,"21 de agosto de 1994"
7,9,82,1215,605,574,1179,"21 de agosto de 1994"
7,9,82,1216,349,305,654,"21 de agosto de 1994"
7,9,82,1217,333,346,679,"21 de agosto de 1994"
7,9,82,1218,599,568,1167,"21 de agosto de 1994"
7,9,82,1219,488,527,1015,"21 de agosto de 1994"
7,9,82,1220,441,467,908,"21 de agosto de 1994"
7,9,82,1221,323,296,619,"21 de agosto de 1994"
7,9,83,1222,368,381,749,"21 de agosto de 1994"
7,9,83,1223,344,315,659,"21 de agosto de 1994"
7,9,83,1224,358,357,715,"21 de agosto de 1994"
7,9,83,1225,625,546,1171,"21 de agosto de 1994"
7,9,85,1233,705,664,1369,"21 de agosto de 1994"
7,9,85,1234,415,365,780,"21 de agosto de 1994"
7,9,85,1235,518,510,1028,"21 de agosto de 1994"
7,9,91,1404,458,466,924,"21 de agosto de 1994"
7,9,91,1405,382,374,756,"21 de agosto de 1994"
7,9,92,1406,596,538,1134,"21 de agosto de 1994"
7,9,92,1407,287,323,610,"21 de agosto de 1994"
7,9,92,1408,305,296,601,"21 de agosto de 1994"
7,9,92,1409,396,413,809,"21 de agosto de 1994"
7,9,92,1410,525,466,991,"21 de agosto de 1994"
8,1,19,402,209,273,482,"21 de agosto de 1994"
8,1,19,403,263,252,515,"21 de agosto de 1994"
8,1,19,404,190,211,401,"21 de agosto de 1994"
8,1,19,405,259,300,559,"21 de agosto de 1994"
8,1,19,406,245,260,505,"21 de agosto de 1994"
8,1,19,407,269,276,545,"21 de agosto de 1994"
8,1,19,408,318,328,646,"21 de agosto de 1994"
8,1,19,409,263,309,572,"21 de agosto de 1994"
8,1,19,410,333,368,701,"21 de agosto de 1994"
8,1,19,411,190,200,390,"21 de agosto de 1994"
8,1,19,412,210,224,434,"21 de agosto de 1994"
8,1,19,413,371,399,770,"21 de agosto de 1994"
8,1,19,414,450,494,944,"21 de agosto de 1994"
8,1,19,415,426,461,887,"21 de agosto de 1994"
8,1,19,416,422,494,916,"21 de agosto de 1994"
8,1,19,417,338,360,698,"21 de agosto de 1994"
8,1,19,418,414,474,888,"21 de agosto de 1994"
8,1,19,419,339,417,756,"21 de agosto de 1994"
8,1,19,420,574,620,1194,"21 de agosto de 1994"
8,1,19,421,315,383,698,"21 de agosto de 1994"
8,1,19,422,436,493,929,"21 de agosto de 1994"
8,1,19,423,346,413,759,"21 de agosto de 1994"
8,1,19,424,353,364,717,"21 de agosto de 1994"
8,1,19,425,468,512,980,"21 de agosto de 1994"
8,1,19,426,303,341,644,"21 de agosto de 1994"
8,1,19,427,253,299,552,"21 de agosto de 1994"
8,1,19,428,314,360,674,"21 de agosto de 1994"
8,1,19,429,358,427,785,"21 de agosto de 1994"
8,1,19,430,162,202,364,"21 de agosto de 1994"
8,1,19,431,268,312,580,"21 de agosto de 1994"
8,1,19,432,277,325,602,"21 de agosto de 1994"
8,1,19,433,309,352,661,"21 de agosto de 1994"
8,1,19,434,358,333,691,"21 de agosto de 1994"
8,1,19,435,273,271,544,"21 de agosto de 1994"
8,1,19,436,335,354,689,"21 de agosto de 1994"
8,1,19,437,306,374,680,"21 de agosto de 1994"
8,1,19,438,348,402,750,"21 de agosto de 1994"
8,1,19,439,406,477,883,"21 de agosto de 1994"
8,1,19,440,476,497,973,"21 de agosto de 1994"
8,1,19,441,342,334,676,"21 de agosto de 1994"
8,1,19,442,248,285,533,"21 de agosto de 1994"
8,1,19,443,307,318,625,"21 de agosto de 1994"
8,1,19,444,258,316,574,"21 de agosto de 1994"
8,1,19,445,243,277,520,"21 de agosto de 1994"
8,1,19,446,316,356,672,"21 de agosto de 1994"
8,1,19,447,312,368,680,"21 de agosto de 1994"
8,1,19,448,266,352,618,"21 de agosto de 1994"
8,1,19,449,214,264,478,"21 de agosto de 1994"
8,1,19,450,417,486,903,"21 de agosto de 1994"
8,1,19,451,196,233,429,"21 de agosto de 1994"
8,1,19,452,388,445,833,"21 de agosto de 1994"
8,1,19,453,240,251,491,"21 de agosto de 1994"
8,1,19,454,258,291,549,"21 de agosto de 1994"
8,1,19,455,405,449,854,"21 de agosto de 1994"
8,1,19,456,205,267,472,"21 de agosto de 1994"
8,1,19,457,334,376,710,"21 de agosto de 1994"
8,1,19,458,203,234,437,"21 de agosto de 1994"
8,1,19,459,320,444,764,"21 de agosto de 1994"
8,1,19,460,395,452,847,"21 de agosto de 1994"
8,1,19,461,291,386,677,"21 de agosto de 1994"
8,1,19,462,294,356,650,"21 de agosto de 1994"
8,1,19,463,325,410,735,"21 de agosto de 1994"
8,1,19,464,523,598,1121,"21 de agosto de 1994"
8,1,19,465,362,434,796,"21 de agosto de 1994"
8,1,19,466,476,522,998,"21 de agosto de 1994"
8,1,19,467,537,189,726,"21 de agosto de 1994"
8,1,19,468,495,618,1113,"21 de agosto de 1994"
8,1,19,469,300,337,637,"21 de agosto de 1994"
8,1,19,470,285,373,658,"21 de agosto de 1994"
8,1,19,471,299,316,615,"21 de agosto de 1994"
8,1,19,472,335,374,709,"21 de agosto de 1994"
8,1,19,473,354,387,741,"21 de agosto de 1994"
8,1,19,474,280,297,577,"21 de agosto de 1994"
8,1,19,475,292,303,595,"21 de agosto de 1994"
8,1,19,476,423,465,888,"21 de agosto de 1994"
8,1,19,477,342,395,737,"21 de agosto de 1994"
8,1,19,478,314,391,705,"21 de agosto de 1994"
8,1,19,479,295,312,607,"21 de agosto de 1994"
8,1,19,480,440,512,952,"21 de agosto de 1994"
8,1,19,481,400,469,869,"21 de agosto de 1994"
8,1,19,482,306,385,691,"21 de agosto de 1994"
8,1,19,483,291,337,628,"21 de agosto de 1994"
8,1,19,484,204,225,429,"21 de agosto de 1994"
8,1,19,485,308,338,646,"21 de agosto de 1994"
8,1,19,486,316,349,665,"21 de agosto de 1994"
8,1,19,487,367,421,788,"21 de agosto de 1994"
8,1,19,488,298,328,626,"21 de agosto de 1994"
8,1,19,489,216,267,483,"21 de agosto de 1994"
8,1,19,490,300,358,658,"21 de agosto de 1994"
8,1,19,491,172,210,382,"21 de agosto de 1994"
8,1,19,492,300,306,606,"21 de agosto de 1994"
8,1,19,493,339,360,699,"21 de agosto de 1994"
8,1,19,494,396,472,868,"21 de agosto de 1994"
8,1,19,495,511,544,1055,"21 de agosto de 1994"
8,1,19,496,381,424,805,"21 de agosto de 1994"
8,1,19,497,344,360,704,"21 de agosto de 1994"
8,1,19,498,248,262,510,"21 de agosto de 1994"
8,1,19,499,304,344,648,"21 de agosto de 1994"
8,1,19,500,404,473,877,"21 de agosto de 1994"
8,1,19,501,285,312,597,"21 de agosto de 1994"
8,1,19,502,418,531,949,"21 de agosto de 1994"
8,1,19,503,177,219,396,"21 de agosto de 1994"
8,1,19,504,313,343,656,"21 de agosto de 1994"
8,1,19,505,326,383,709,"21 de agosto de 1994"
8,1,19,506,335,398,733,"21 de agosto de 1994"
8,1,19,507,305,346,651,"21 de agosto de 1994"
8,1,19,508,320,349,669,"21 de agosto de 1994"
8,1,19,509,559,557,1116,"21 de agosto de 1994"
8,1,19,510,301,365,666,"21 de agosto de 1994"
8,1,19,511,213,234,447,"21 de agosto de 1994"
8,1,19,512,318,325,643,"21 de agosto de 1994"
8,1,19,513,442,432,874,"21 de agosto de 1994"
8,1,19,514,435,455,890,"21 de agosto de 1994"
8,1,19,515,491,529,1020,"21 de agosto de 1994"
8,1,19,516,251,277,528,"21 de agosto de 1994"
8,1,19,517,341,399,740,"21 de agosto de 1994"
8,1,19,518,430,507,937,"21 de agosto de 1994"
8,1,19,519,338,427,765,"21 de agosto de 1994"
8,1,19,520,343,444,787,"21 de agosto de 1994"
8,1,19,521,413,488,901,"21 de agosto de 1994"
8,1,19,522,368,442,810,"21 de agosto de 1994"
8,1,19,523,280,316,596,"21 de agosto de 1994"
8,1,19,524,336,386,722,"21 de agosto de 1994"
8,1,19,525,259,330,589,"21 de agosto de 1994"
8,1,19,526,201,257,458,"21 de agosto de 1994"
8,1,19,527,483,512,995,"21 de agosto de 1994"
8,1,19,528,476,498,974,"21 de agosto de 1994"
8,1,19,529,293,336,629,"21 de agosto de 1994"
8,1,19,530,509,608,1117,"21 de agosto de 1994"
8,1,19,531,321,339,660,"21 de agosto de 1994"
8,1,19,532,302,338,640,"21 de agosto de 1994"
8,1,19,533,248,315,563,"21 de agosto de 1994"
8,1,19,534,496,530,1026,"21 de agosto de 1994"
8,1,19,535,230,245,475,"21 de agosto de 1994"
8,1,19,536,276,316,592,"21 de agosto de 1994"
8,1,19,537,182,182,364,"21 de agosto de 1994"
8,1,19,538,416,437,853,"21 de agosto de 1994"
8,1,19,539,197,192,389,"21 de agosto de 1994"
8,1,19,540,186,196,382,"21 de agosto de 1994"
8,1,19,541,451,494,945,"21 de agosto de 1994"
8,1,19,542,246,259,505,"21 de agosto de 1994"
8,1,19,543,592,647,1239,"21 de agosto de 1994"
8,1,19,544,456,537,993,"21 de agosto de 1994"
8,1,19,545,351,408,759,"21 de agosto de 1994"
8,1,19,546,332,366,698,"21 de agosto de 1994"
8,1,19,547,247,274,521,"21 de agosto de 1994"
8,1,19,548,384,487,871,"21 de agosto de 1994"
8,1,19,549,314,333,647,"21 de agosto de 1994"
8,1,19,550,486,543,1029,"21 de agosto de 1994"
8,1,19,551,531,588,1119,"21 de agosto de 1994"
8,1,19,552,336,347,683,"21 de agosto de 1994"
8,1,19,553,369,430,799,"21 de agosto de 1994"
8,1,19,554,527,589,1116,"21 de agosto de 1994"
8,1,19,555,286,360,646,"21 de agosto de 1994"
8,1,19,556,295,302,597,"21 de agosto de 1994"
8,1,19,557,411,474,885,"21 de agosto de 1994"
8,1,19,558,371,411,782,"21 de agosto de 1994"
8,1,19,559,212,225,437,"21 de agosto de 1994"
8,1,19,560,390,416,806,"21 de agosto de 1994"
8,1,19,561,276,316,592,"21 de agosto de 1994"
8,1,19,562,386,394,780,"21 de agosto de 1994"
8,1,19,563,300,331,631,"21 de agosto de 1994"
8,1,19,564,308,352,660,"21 de agosto de 1994"
8,1,19,565,231,253,484,"21 de agosto de 1994"
8,1,19,566,369,381,750,"21 de agosto de 1994"
8,1,19,567,240,268,508,"21 de agosto de 1994"
8,1,19,568,283,295,578,"21 de agosto de 1994"
8,1,19,569,340,368,708,"21 de agosto de 1994"
8,1,19,570,390,465,855,"21 de agosto de 1994"
8,1,19,571,349,398,747,"21 de agosto de 1994"
8,1,19,572,267,287,554,"21 de agosto de 1994"
8,1,19,573,363,397,760,"21 de agosto de 1994"
8,1,19,574,503,549,1052,"21 de agosto de 1994"
8,1,19,575,389,414,803,"21 de agosto de 1994"
8,1,19,576,386,405,791,"21 de agosto de 1994"
8,1,19,577,218,255,473,"21 de agosto de 1994"
8,1,19,578,426,456,882,"21 de agosto de 1994"
8,1,19,579,187,209,396,"21 de agosto de 1994"
8,1,19,580,348,397,745,"21 de agosto de 1994"
8,1,19,581,221,284,505,"21 de agosto de 1994"
8,1,19,582,257,255,512,"21 de agosto de 1994"
8,1,19,583,372,407,779,"21 de agosto de 1994"
8,1,19,584,236,263,499,"21 de agosto de 1994"
8,1,19,585,276,312,588,"21 de agosto de 1994"
8,1,19,586,273,285,558,"21 de agosto de 1994"
8,1,19,587,294,325,619,"21 de agosto de 1994"
8,1,19,588,183,206,389,"21 de agosto de 1994"
8,1,19,589,180,200,380,"21 de agosto de 1994"
8,1,19,590,319,351,670,"21 de agosto de 1994"
8,1,19,591,383,408,791,"21 de agosto de 1994"
8,1,19,592,259,281,540,"21 de agosto de 1994"
8,1,19,593,459,491,950,"21 de agosto de 1994"
8,1,19,594,264,329,593,"21 de agosto de 1994"
8,1,19,595,273,337,610,"21 de agosto de 1994"
8,1,19,596,268,296,564,"21 de agosto de 1994"
8,1,19,597,255,353,608,"21 de agosto de 1994"
8,1,19,598,285,373,658,"21 de agosto de 1994"
8,1,19,599,356,442,798,"21 de agosto de 1994"
8,1,19,600,468,526,994,"21 de agosto de 1994"
8,1,19,601,334,406,740,"21 de agosto de 1994"
8,1,19,602,215,252,467,"21 de agosto de 1994"
8,1,19,603,278,310,588,"21 de agosto de 1994"
8,1,19,604,400,436,836,"21 de agosto de 1994"
8,1,19,605,416,464,880,"21 de agosto de 1994"
8,1,19,606,277,328,605,"21 de agosto de 1994"
8,1,19,607,291,335,626,"21 de agosto de 1994"
8,2,3,38,321,322,643,"21 de agosto de 1994"
8,2,3,39,370,383,753,"21 de agosto de 1994"
8,2,3,40,267,298,565,"21 de agosto de 1994"
8,2,3,41,272,273,545,"21 de agosto de 1994"
8,2,3,42,65,39,104,"21 de agosto de 1994"
8,2,3,43,156,139,295,"21 de agosto de 1994"
8,2,3,44,45,51,96,"21 de agosto de 1994"
8,2,3,45,75,59,134,"21 de agosto de 1994"
8,2,3,46,79,68,147,"21 de agosto de 1994"
8,2,3,47,76,61,137,"21 de agosto de 1994"
8,2,3,48,103,89,192,"21 de agosto de 1994"
8,2,3,49,72,60,132,"21 de agosto de 1994"
8,2,3,50,96,81,177,"21 de agosto de 1994"
8,2,3,51,82,63,145,"21 de agosto de 1994"
8,2,3,52,116,89,205,"21 de agosto de 1994"
8,2,3,53,311,250,561,"21 de agosto de 1994"
8,2,3,54,261,210,471,"21 de agosto de 1994"
8,2,3,55,218,182,400,"21 de agosto de 1994"
8,2,7,102,349,283,632,"21 de agosto de 1994"
8,2,7,103,386,361,747,"21 de agosto de 1994"
8,2,7,104,109,66,175,"21 de agosto de 1994"
8,2,7,105,257,234,491,"21 de agosto de 1994"
8,2,7,106,405,309,714,"21 de agosto de 1994"
8,2,7,107,251,228,479,"21 de agosto de 1994"
8,2,7,108,206,184,390,"21 de agosto de 1994"
8,2,7,109,142,108,250,"21 de agosto de 1994"
8,2,7,110,324,224,548,"21 de agosto de 1994"
8,2,7,111,272,186,458,"21 de agosto de 1994"
8,2,7,112,188,125,313,"21 de agosto de 1994"
8,2,7,113,556,293,849,"21 de agosto de 1994"
8,2,7,114,509,375,884,"21 de agosto de 1994"
8,2,7,115,394,274,668,"21 de agosto de 1994"
8,2,8,116,479,324,803,"21 de agosto de 1994"
8,2,8,117,257,118,375,"21 de agosto de 1994"
8,2,8,118,70,49,119,"21 de agosto de 1994"
8,2,8,119,313,205,518,"21 de agosto de 1994"
8,2,8,120,154,46,200,"21 de agosto de 1994"
8,2,8,121,373,303,676,"21 de agosto de 1994"
8,2,8,122,190,67,257,"21 de agosto de 1994"
8,2,8,123,193,126,319,"21 de agosto de 1994"
8,2,8,124,99,56,155,"21 de agosto de 1994"
8,2,8,125,210,131,341,"21 de agosto de 1994"
8,2,8,126,192,118,310,"21 de agosto de 1994"
8,2,14,253,356,330,686,"21 de agosto de 1994"
8,2,14,254,55,38,93,"21 de agosto de 1994"
8,2,14,255,24,19,43,"21 de agosto de 1994"
8,2,14,256,121,107,228,"21 de agosto de 1994"
8,2,14,257,60,47,107,"21 de agosto de 1994"
8,2,14,258,61,43,104,"21 de agosto de 1994"
8,2,14,259,82,59,141,"21 de agosto de 1994"
8,2,14,260,40,37,77,"21 de agosto de 1994"
8,2,29,1135,306,326,632,"21 de agosto de 1994"
8,2,29,1136,517,497,1014,"21 de agosto de 1994"
8,2,29,1137,87,40,127,"21 de agosto de 1994"
8,2,29,1138,202,110,312,"21 de agosto de 1994"
8,2,29,1139,282,246,528,"21 de agosto de 1994"
8,2,29,1140,483,382,865,"21 de agosto de 1994"
8,2,29,1141,23,16,39,"21 de agosto de 1994"
8,2,29,1142,162,142,304,"21 de agosto de 1994"
8,2,29,1143,577,534,1111,"21 de agosto de 1994"
8,2,29,1144,265,168,433,"21 de agosto de 1994"
8,2,29,1145,197,158,355,"21 de agosto de 1994"
8,2,29,1146,378,261,639,"21 de agosto de 1994"
8,2,29,1147,422,263,685,"21 de agosto de 1994"
8,2,29,1148,466,402,868,"21 de agosto de 1994"
8,2,29,1149,84,75,159,"21 de agosto de 1994"
8,2,29,1150,39,26,65,"21 de agosto de 1994"
8,2,29,1151,63,28,91,"21 de agosto de 1994"
8,2,29,1152,127,94,221,"21 de agosto de 1994"
8,2,29,1153,218,147,365,"21 de agosto de 1994"
8,2,29,1154,283,217,500,"21 de agosto de 1994"
8,2,29,1155,468,338,806,"21 de agosto de 1994"
8,2,29,1156,241,180,421,"21 de agosto de 1994"
8,2,29,1157,121,85,206,"21 de agosto de 1994"
8,2,29,1158,311,273,584,"21 de agosto de 1994"
8,2,29,1159,594,476,1070,"21 de agosto de 1994"
8,2,29,1160,352,307,659,"21 de agosto de 1994"
8,2,29,1161,128,122,250,"21 de agosto de 1994"
8,2,29,1162,176,149,325,"21 de agosto de 1994"
8,2,29,1163,296,246,542,"21 de agosto de 1994"
8,2,29,1164,368,322,690,"21 de agosto de 1994"
8,2,29,1165,558,488,1046,"21 de agosto de 1994"
8,2,29,1166,69,66,135,"21 de agosto de 1994"
8,2,32,1266,203,204,407,"21 de agosto de 1994"
8,2,32,1267,189,204,393,"21 de agosto de 1994"
8,2,32,1268,304,327,631,"21 de agosto de 1994"
8,2,32,1269,241,267,508,"21 de agosto de 1994"
8,2,32,1270,131,169,300,"21 de agosto de 1994"
8,2,32,1271,193,218,411,"21 de agosto de 1994"
8,2,32,1272,275,287,562,"21 de agosto de 1994"
8,2,32,1273,401,458,859,"21 de agosto de 1994"
8,2,32,1274,160,176,336,"21 de agosto de 1994"
8,2,32,1275,439,464,903,"21 de agosto de 1994"
8,2,32,1276,348,371,719,"21 de agosto de 1994"
8,2,32,1277,306,396,702,"21 de agosto de 1994"
8,2,32,1278,380,396,776,"21 de agosto de 1994"
8,2,32,1279,227,227,454,"21 de agosto de 1994"
8,2,32,1280,279,308,587,"21 de agosto de 1994"
8,2,32,1281,624,706,1330,"21 de agosto de 1994"
8,2,32,1282,266,281,547,"21 de agosto de 1994"
8,2,32,1283,288,343,631,"21 de agosto de 1994"
8,2,32,1284,424,451,875,"21 de agosto de 1994"
8,2,32,1285,327,381,708,"21 de agosto de 1994"
8,2,32,1286,170,205,375,"21 de agosto de 1994"
8,2,32,1287,223,255,478,"21 de agosto de 1994"
8,2,32,1288,474,473,947,"21 de agosto de 1994"
8,2,32,1289,455,503,958,"21 de agosto de 1994"
8,2,32,1290,467,507,974,"21 de agosto de 1994"
8,2,32,1291,193,228,421,"21 de agosto de 1994"
8,2,32,1292,335,414,749,"21 de agosto de 1994"
8,2,32,1293,386,437,823,"21 de agosto de 1994"
8,2,32,1294,345,337,682,"21 de agosto de 1994"
8,2,32,1295,208,213,421,"21 de agosto de 1994"
8,2,32,1296,345,384,729,"21 de agosto de 1994"
8,2,32,1297,325,344,669,"21 de agosto de 1994"
8,2,32,1298,718,280,998,"21 de agosto de 1994"
8,2,32,1299,229,244,473,"21 de agosto de 1994"
8,2,32,1300,276,304,580,"21 de agosto de 1994"
8,2,32,1301,333,365,698,"21 de agosto de 1994"
8,2,32,1302,283,335,618,"21 de agosto de 1994"
8,2,32,1303,248,286,534,"21 de agosto de 1994"
8,2,32,1304,238,273,511,"21 de agosto de 1994"
8,2,32,1305,216,238,454,"21 de agosto de 1994"
8,2,32,1306,357,390,747,"21 de agosto de 1994"
8,2,32,1307,192,204,396,"21 de agosto de 1994"
8,2,32,1308,446,509,955,"21 de agosto de 1994"
8,2,32,1309,357,415,772,"21 de agosto de 1994"
8,2,32,1310,185,229,414,"21 de agosto de 1994"
8,2,32,1311,281,308,589,"21 de agosto de 1994"
8,2,32,1312,501,545,1046,"21 de agosto de 1994"
8,2,32,1313,296,365,661,"21 de agosto de 1994"
8,2,32,1314,209,256,465,"21 de agosto de 1994"
8,2,32,1315,313,384,697,"21 de agosto de 1994"
8,2,32,1316,206,252,458,"21 de agosto de 1994"
8,2,32,1317,321,394,715,"21 de agosto de 1994"
8,2,32,1318,422,470,892,"21 de agosto de 1994"
8,2,32,1319,365,390,755,"21 de agosto de 1994"
8,2,32,1320,147,164,311,"21 de agosto de 1994"
8,2,32,1321,195,265,460,"21 de agosto de 1994"
8,2,32,1322,335,387,722,"21 de agosto de 1994"
8,2,32,1323,338,418,756,"21 de agosto de 1994"
8,2,32,1324,276,330,606,"21 de agosto de 1994"
8,2,32,1325,338,358,696,"21 de agosto de 1994"
8,2,32,1326,221,260,481,"21 de agosto de 1994"
8,2,32,1327,363,422,785,"21 de agosto de 1994"
8,2,32,1328,482,548,1030,"21 de agosto de 1994"
8,2,32,1329,294,363,657,"21 de agosto de 1994"
8,2,32,1330,196,220,416,"21 de agosto de 1994"
8,2,32,1331,335,335,670,"21 de agosto de 1994"
8,2,32,1332,371,411,782,"21 de agosto de 1994"
8,2,32,1333,362,400,762,"21 de agosto de 1994"
8,2,32,1334,467,481,948,"21 de agosto de 1994"
8,2,32,1335,220,245,465,"21 de agosto de 1994"
8,2,32,1336,264,307,571,"21 de agosto de 1994"
8,2,32,1337,397,443,840,"21 de agosto de 1994"
8,2,32,1338,302,363,665,"21 de agosto de 1994"
8,2,32,1339,256,266,522,"21 de agosto de 1994"
8,2,32,1340,435,486,921,"21 de agosto de 1994"
8,2,32,1341,340,388,728,"21 de agosto de 1994"
8,2,32,1342,456,516,972,"21 de agosto de 1994"
8,2,32,1343,214,251,465,"21 de agosto de 1994"
8,2,32,1344,221,219,440,"21 de agosto de 1994"
8,2,32,1345,570,621,1191,"21 de agosto de 1994"
8,2,32,1346,348,384,732,"21 de agosto de 1994"
8,2,32,1347,263,289,552,"21 de agosto de 1994"
8,2,32,1348,306,322,628,"21 de agosto de 1994"
8,2,32,1349,81,47,128,"21 de agosto de 1994"
8,2,32,1350,53,23,76,"21 de agosto de 1994"
8,2,32,1351,69,38,107,"21 de agosto de 1994"
8,2,32,1352,28,23,51,"21 de agosto de 1994"
8,2,32,1353,287,249,536,"21 de agosto de 1994"
8,2,32,1354,158,125,283,"21 de agosto de 1994"
8,2,33,1355,198,222,420,"21 de agosto de 1994"
8,2,33,1356,197,183,380,"21 de agosto de 1994"
8,2,39,2206,390,350,740,"21 de agosto de 1994"
8,2,39,2207,333,322,655,"21 de agosto de 1994"
8,2,39,2208,107,100,207,"21 de agosto de 1994"
8,2,39,2209,86,67,153,"21 de agosto de 1994"
8,2,39,2210,39,37,76,"21 de agosto de 1994"
8,2,39,2211,189,179,368,"21 de agosto de 1994"
8,2,39,2212,175,172,347,"21 de agosto de 1994"
8,2,39,2213,59,38,97,"21 de agosto de 1994"
8,2,44,2278,394,394,788,"21 de agosto de 1994"
8,2,44,2279,292,316,608,"21 de agosto de 1994"
8,2,44,2280,188,160,348,"21 de agosto de 1994"
8,2,44,2281,114,100,214,"21 de agosto de 1994"
8,2,44,2282,91,80,171,"21 de agosto de 1994"
8,2,44,2283,58,57,115,"21 de agosto de 1994"
8,2,44,2284,54,37,91,"21 de agosto de 1994"
8,2,44,2285,37,34,71,"21 de agosto de 1994"
8,2,44,2286,178,146,324,"21 de agosto de 1994"
8,2,44,2287,96,87,183,"21 de agosto de 1994"
8,2,46,2323,298,202,500,"21 de agosto de 1994"
8,2,46,2324,65,41,106,"21 de agosto de 1994"
8,2,46,2325,161,122,283,"21 de agosto de 1994"
8,2,46,2326,105,69,174,"21 de agosto de 1994"
8,2,46,2327,139,95,234,"21 de agosto de 1994"
8,2,46,2328,186,144,330,"21 de agosto de 1994"
8,2,46,2329,311,288,599,"21 de agosto de 1994"
8,2,46,2330,103,75,178,"21 de agosto de 1994"
8,2,59,2566,338,363,701,"21 de agosto de 1994"
8,2,59,2567,257,270,527,"21 de agosto de 1994"
8,2,59,2568,157,137,294,"21 de agosto de 1994"
8,2,59,2569,202,213,415,"21 de agosto de 1994"
8,2,59,2570,154,160,314,"21 de agosto de 1994"
8,2,59,2571,163,168,331,"21 de agosto de 1994"
8,2,59,2572,240,262,502,"21 de agosto de 1994"
8,2,59,2573,249,281,530,"21 de agosto de 1994"
8,2,59,2574,283,272,555,"21 de agosto de 1994"
8,2,59,2575,150,130,280,"21 de agosto de 1994"
8,2,59,2576,65,54,119,"21 de agosto de 1994"
8,2,59,2577,55,40,95,"21 de agosto de 1994"
8,2,60,2578,32,24,56,"21 de agosto de 1994"
8,2,60,2579,192,182,374,"21 de agosto de 1994"
8,2,60,2580,131,157,288,"21 de agosto de 1994"
8,2,60,2581,210,210,420,"21 de agosto de 1994"
8,2,60,2582,175,185,360,"21 de agosto de 1994"
8,2,60,2583,274,277,551,"21 de agosto de 1994"
8,2,60,2584,256,270,526,"21 de agosto de 1994"
8,2,60,2585,287,298,585,"21 de agosto de 1994"
8,2,60,2586,231,251,482,"21 de agosto de 1994"
8,2,60,2587,270,268,538,"21 de agosto de 1994"
8,2,60,2588,295,341,636,"21 de agosto de 1994"
8,2,60,2589,146,164,310,"21 de agosto de 1994"
8,2,60,2590,242,250,492,"21 de agosto de 1994"
8,2,60,2591,392,394,786,"21 de agosto de 1994"
8,2,60,2592,138,151,289,"21 de agosto de 1994"
8,2,60,2593,187,187,374,"21 de agosto de 1994"
8,2,60,2594,79,63,142,"21 de agosto de 1994"
8,2,60,2595,222,219,441,"21 de agosto de 1994"
8,2,60,2596,46,32,78,"21 de agosto de 1994"
8,2,60,2597,48,43,91,"21 de agosto de 1994"
8,2,60,2598,43,34,77,"21 de agosto de 1994"
8,2,60,2599,77,59,136,"21 de agosto de 1994"
8,2,60,2600,27,20,47,"21 de agosto de 1994"
8,2,64,2661,180,196,376,"21 de agosto de 1994"
8,2,64,2662,107,122,229,"21 de agosto de 1994"
8,2,64,2663,163,159,322,"21 de agosto de 1994"
8,2,64,2664,73,69,142,"21 de agosto de 1994"
8,2,64,2665,73,73,146,"21 de agosto de 1994"
8,2,64,2666,31,39,70,"21 de agosto de 1994"
8,2,64,2667,60,63,123,"21 de agosto de 1994"
8,2,65,2668,352,307,659,"21 de agosto de 1994"
8,2,65,2669,195,187,382,"21 de agosto de 1994"
8,2,65,2670,113,78,191,"21 de agosto de 1994"
8,2,65,2671,551,466,1017,"21 de agosto de 1994"
8,2,65,2672,111,100,211,"21 de agosto de 1994"
8,2,65,2673,235,225,460,"21 de agosto de 1994"
8,2,65,2674,133,129,262,"21 de agosto de 1994"
8,2,65,2675,131,118,249,"21 de agosto de 1994"
8,2,65,2676,346,296,642,"21 de agosto de 1994"
8,2,65,2677,211,160,371,"21 de agosto de 1994"
8,2,65,2678,224,195,419,"21 de agosto de 1994"
8,2,65,2679,349,247,596,"21 de agosto de 1994"
8,2,65,2680,96,79,175,"21 de agosto de 1994"
8,2,65,2681,193,163,356,"21 de agosto de 1994"
8,2,65,2682,549,386,935,"21 de agosto de 1994"
8,2,65,2683,209,173,382,"21 de agosto de 1994"
8,3,37,1424,262,257,519,"21 de agosto de 1994"
8,3,37,1425,454,464,918,"21 de agosto de 1994"
8,3,37,1426,316,339,655,"21 de agosto de 1994"
8,3,37,1427,193,228,421,"21 de agosto de 1994"
8,3,37,1428,421,432,853,"21 de agosto de 1994"
8,3,37,1429,339,331,670,"21 de agosto de 1994"
8,3,37,1430,372,375,747,"21 de agosto de 1994"
8,3,37,1431,244,260,504,"21 de agosto de 1994"
8,3,37,1432,307,353,660,"21 de agosto de 1994"
8,3,37,1433,262,254,516,"21 de agosto de 1994"
8,3,37,1434,251,285,536,"21 de agosto de 1994"
8,3,37,1435,273,281,554,"21 de agosto de 1994"
8,3,37,1436,333,366,699,"21 de agosto de 1994"
8,3,37,1437,345,362,707,"21 de agosto de 1994"
8,3,37,1438,375,413,788,"21 de agosto de 1994"
8,3,37,1439,116,160,276,"21 de agosto de 1994"
8,3,37,1440,242,272,514,"21 de agosto de 1994"
8,3,37,1441,212,248,460,"21 de agosto de 1994"
8,3,37,1442,263,331,594,"21 de agosto de 1994"
8,3,37,1443,197,168,365,"21 de agosto de 1994"
8,3,37,1444,281,240,521,"21 de agosto de 1994"
8,3,37,1445,200,241,441,"21 de agosto de 1994"
8,3,37,1446,279,300,579,"21 de agosto de 1994"
8,3,37,1447,231,276,507,"21 de agosto de 1994"
8,3,37,1448,248,322,570,"21 de agosto de 1994"
8,3,37,1449,220,243,463,"21 de agosto de 1994"
8,3,37,1450,227,267,494,"21 de agosto de 1994"
8,3,37,1451,299,289,588,"21 de agosto de 1994"
8,3,37,1452,192,212,404,"21 de agosto de 1994"
8,3,37,1453,227,251,478,"21 de agosto de 1994"
8,3,37,1454,225,250,475,"21 de agosto de 1994"
8,3,37,1455,310,350,660,"21 de agosto de 1994"
8,3,37,1456,241,243,484,"21 de agosto de 1994"
8,3,37,1457,271,279,550,"21 de agosto de 1994"
8,3,37,1458,396,437,833,"21 de agosto de 1994"
8,3,37,1459,257,277,534,"21 de agosto de 1994"
8,3,37,1460,273,303,576,"21 de agosto de 1994"
8,3,37,1461,399,450,849,"21 de agosto de 1994"
8,3,37,1462,305,360,665,"21 de agosto de 1994"
8,3,37,1463,377,377,754,"21 de agosto de 1994"
8,3,37,1464,332,336,668,"21 de agosto de 1994"
8,3,37,1465,244,261,505,"21 de agosto de 1994"
8,3,37,1466,338,340,678,"21 de agosto de 1994"
8,3,37,1467,224,220,444,"21 de agosto de 1994"
8,3,37,1468,212,239,451,"21 de agosto de 1994"
8,3,37,1469,459,420,879,"21 de agosto de 1994"
8,3,37,1470,276,308,584,"21 de agosto de 1994"
8,3,37,1471,228,228,456,"21 de agosto de 1994"
8,3,37,1472,313,321,634,"21 de agosto de 1994"
8,3,37,1473,228,254,482,"21 de agosto de 1994"
8,3,37,1474,249,264,513,"21 de agosto de 1994"
8,3,37,1475,243,247,490,"21 de agosto de 1994"
8,3,37,1476,274,277,551,"21 de agosto de 1994"
8,3,37,1477,264,274,538,"21 de agosto de 1994"
8,3,37,1478,393,448,841,"21 de agosto de 1994"
8,3,37,1479,284,294,578,"21 de agosto de 1994"
8,3,37,1480,234,263,497,"21 de agosto de 1994"
8,3,37,1481,275,294,569,"21 de agosto de 1994"
8,3,37,1482,271,269,540,"21 de agosto de 1994"
8,3,37,1483,319,352,671,"21 de agosto de 1994"
8,3,37,1484,377,404,781,"21 de agosto de 1994"
8,3,37,1485,304,348,652,"21 de agosto de 1994"
8,3,37,1486,264,289,553,"21 de agosto de 1994"
8,3,37,1487,239,257,496,"21 de agosto de 1994"
8,3,37,1488,330,331,661,"21 de agosto de 1994"
8,3,37,1489,248,248,496,"21 de agosto de 1994"
8,3,37,1490,227,245,472,"21 de agosto de 1994"
8,3,37,1491,225,218,443,"21 de agosto de 1994"
8,3,37,1492,260,285,545,"21 de agosto de 1994"
8,3,37,1493,272,251,523,"21 de agosto de 1994"
8,3,37,1494,304,285,589,"21 de agosto de 1994"
8,3,37,1495,155,168,323,"21 de agosto de 1994"
8,3,37,1496,267,269,536,"21 de agosto de 1994"
8,3,37,1497,238,228,466,"21 de agosto de 1994"
8,3,37,1498,105,81,186,"21 de agosto de 1994"
8,3,37,1499,258,223,481,"21 de agosto de 1994"
8,3,37,1500,164,189,353,"21 de agosto de 1994"
8,3,37,1501,173,171,344,"21 de agosto de 1994"
8,3,37,1502,232,264,496,"21 de agosto de 1994"
8,3,37,1503,339,349,688,"21 de agosto de 1994"
8,3,37,1504,470,538,1008,"21 de agosto de 1994"
8,3,37,1505,402,406,808,"21 de agosto de 1994"
8,3,37,1506,420,447,867,"21 de agosto de 1994"
8,3,37,1507,430,460,890,"21 de agosto de 1994"
8,3,37,1508,388,422,810,"21 de agosto de 1994"
8,3,37,1509,428,482,910,"21 de agosto de 1994"
8,3,37,1510,540,583,1123,"21 de agosto de 1994"
8,3,37,1511,393,371,764,"21 de agosto de 1994"
8,3,37,1512,313,315,628,"21 de agosto de 1994"
8,3,37,1513,230,269,499,"21 de agosto de 1994"
8,3,37,1514,301,287,588,"21 de agosto de 1994"
8,3,37,1515,212,257,469,"21 de agosto de 1994"
8,3,37,1516,255,249,504,"21 de agosto de 1994"
8,3,37,1517,323,328,651,"21 de agosto de 1994"
8,3,37,1518,305,344,649,"21 de agosto de 1994"
8,3,37,1519,410,422,832,"21 de agosto de 1994"
8,3,37,1520,219,248,467,"21 de agosto de 1994"
8,3,37,1521,248,252,500,"21 de agosto de 1994"
8,3,37,1522,193,211,404,"21 de agosto de 1994"
8,3,37,1523,301,288,589,"21 de agosto de 1994"
8,3,37,1524,177,175,352,"21 de agosto de 1994"
8,3,37,1525,197,210,407,"21 de agosto de 1994"
8,3,37,1526,239,255,494,"21 de agosto de 1994"
8,3,37,1527,318,341,659,"21 de agosto de 1994"
8,3,37,1528,169,187,356,"21 de agosto de 1994"
8,3,37,1529,195,214,409,"21 de agosto de 1994"
8,3,37,1530,171,199,370,"21 de agosto de 1994"
8,3,37,1531,363,380,743,"21 de agosto de 1994"
8,3,37,1532,121,126,247,"21 de agosto de 1994"
8,3,37,1533,153,173,326,"21 de agosto de 1994"
8,3,37,1534,178,190,368,"21 de agosto de 1994"
8,3,37,1535,268,307,575,"21 de agosto de 1994"
8,3,37,1536,332,379,711,"21 de agosto de 1994"
8,3,37,1537,303,329,632,"21 de agosto de 1994"
8,3,37,1538,472,526,998,"21 de agosto de 1994"
8,3,37,1539,232,233,465,"21 de agosto de 1994"
8,3,37,1540,224,215,439,"21 de agosto de 1994"
8,3,37,1541,236,252,488,"21 de agosto de 1994"
8,3,37,1542,391,379,770,"21 de agosto de 1994"
8,3,37,1543,160,177,337,"21 de agosto de 1994"
8,3,37,1544,257,256,513,"21 de agosto de 1994"
8,3,37,1545,223,223,446,"21 de agosto de 1994"
8,3,37,1546,296,298,594,"21 de agosto de 1994"
8,3,37,1547,377,372,749,"21 de agosto de 1994"
8,3,37,1548,295,293,588,"21 de agosto de 1994"
8,3,37,1549,411,410,821,"21 de agosto de 1994"
8,3,37,1550,194,185,379,"21 de agosto de 1994"
8,3,37,1551,207,209,416,"21 de agosto de 1994"
8,3,37,1552,185,205,390,"21 de agosto de 1994"
8,3,37,1553,253,261,514,"21 de agosto de 1994"
8,3,37,1554,353,379,732,"21 de agosto de 1994"
8,3,37,1555,197,243,440,"21 de agosto de 1994"
8,3,37,1556,411,443,854,"21 de agosto de 1994"
8,3,37,1557,252,252,504,"21 de agosto de 1994"
8,3,37,1558,289,275,564,"21 de agosto de 1994"
8,3,37,1559,485,472,957,"21 de agosto de 1994"
8,3,37,1560,641,641,1282,"21 de agosto de 1994"
8,3,37,1561,215,213,428,"21 de agosto de 1994"
8,3,37,1562,10,13,23,"21 de agosto de 1994"
8,3,37,1563,231,220,451,"21 de agosto de 1994"
8,3,37,1564,166,176,342,"21 de agosto de 1994"
8,3,37,1565,281,303,584,"21 de agosto de 1994"
8,3,37,2055,0,1,1,"21 de agosto de 1994"
8,4,37,1399,0,0,0,"21 de agosto de 1994"
8,4,37,1566,170,169,339,"21 de agosto de 1994"
8,4,37,1567,607,670,1277,"21 de agosto de 1994"
8,4,37,1568,374,383,757,"21 de agosto de 1994"
8,4,37,1569,248,284,532,"21 de agosto de 1994"
8,4,37,1570,522,562,1084,"21 de agosto de 1994"
8,4,37,1571,295,320,615,"21 de agosto de 1994"
8,4,37,1572,336,326,662,"21 de agosto de 1994"
8,4,37,1573,442,507,949,"21 de agosto de 1994"
8,4,37,1574,299,346,645,"21 de agosto de 1994"
8,4,37,1575,480,553,1033,"21 de agosto de 1994"
8,4,37,1576,408,521,929,"21 de agosto de 1994"
8,4,37,1577,275,329,604,"21 de agosto de 1994"
8,4,37,1578,415,450,865,"21 de agosto de 1994"
8,4,37,1579,507,572,1079,"21 de agosto de 1994"
8,4,37,1580,124,133,257,"21 de agosto de 1994"
8,4,37,1581,249,282,531,"21 de agosto de 1994"
8,4,37,1582,372,423,795,"21 de agosto de 1994"
8,4,37,1583,383,411,794,"21 de agosto de 1994"
8,4,37,1584,233,252,485,"21 de agosto de 1994"
8,4,37,1585,333,350,683,"21 de agosto de 1994"
8,4,37,1586,224,269,493,"21 de agosto de 1994"
8,4,37,1587,358,388,746,"21 de agosto de 1994"
8,4,37,1588,276,332,608,"21 de agosto de 1994"
8,4,37,1589,191,203,394,"21 de agosto de 1994"
8,4,37,1590,169,188,357,"21 de agosto de 1994"
8,4,37,1591,265,297,562,"21 de agosto de 1994"
8,4,37,1592,290,356,646,"21 de agosto de 1994"
8,4,37,1593,241,283,524,"21 de agosto de 1994"
8,4,37,1594,367,381,748,"21 de agosto de 1994"
8,4,37,1595,535,557,1092,"21 de agosto de 1994"
8,4,37,1596,224,279,503,"21 de agosto de 1994"
8,4,37,1597,284,316,600,"21 de agosto de 1994"
8,4,37,1598,520,534,1054,"21 de agosto de 1994"
8,4,37,1599,312,322,634,"21 de agosto de 1994"
8,4,37,1600,270,303,573,"21 de agosto de 1994"
8,4,37,1601,225,247,472,"21 de agosto de 1994"
8,4,37,1602,318,378,696,"21 de agosto de 1994"
8,4,37,1603,610,624,1234,"21 de agosto de 1994"
8,4,37,1604,173,173,346,"21 de agosto de 1994"
8,4,37,1605,196,245,441,"21 de agosto de 1994"
8,4,37,1606,199,203,402,"21 de agosto de 1994"
8,4,37,1607,224,253,477,"21 de agosto de 1994"
8,4,37,1608,282,293,575,"21 de agosto de 1994"
8,4,37,1609,244,299,543,"21 de agosto de 1994"
8,4,37,1610,287,300,587,"21 de agosto de 1994"
8,4,37,1611,226,276,502,"21 de agosto de 1994"
8,4,37,1612,311,360,671,"21 de agosto de 1994"
8,4,37,1613,294,335,629,"21 de agosto de 1994"
8,4,37,1614,275,325,600,"21 de agosto de 1994"
8,4,37,1615,115,102,217,"21 de agosto de 1994"
8,4,37,1616,482,531,1013,"21 de agosto de 1994"
8,4,37,1617,275,333,608,"21 de agosto de 1994"
8,4,37,1618,594,672,1266,"21 de agosto de 1994"
8,4,37,1619,273,308,581,"21 de agosto de 1994"
8,4,37,1620,182,221,403,"21 de agosto de 1994"
8,4,37,1621,608,679,1287,"21 de agosto de 1994"
8,4,37,1622,166,198,364,"21 de agosto de 1994"
8,4,37,1623,479,544,1023,"21 de agosto de 1994"
8,4,37,1624,247,278,525,"21 de agosto de 1994"
8,4,37,1625,237,274,511,"21 de agosto de 1994"
8,4,37,1626,270,322,592,"21 de agosto de 1994"
8,4,37,1627,103,117,220,"21 de agosto de 1994"
8,4,37,1628,384,397,781,"21 de agosto de 1994"
8,4,37,1629,328,354,682,"21 de agosto de 1994"
8,4,37,1630,247,336,583,"21 de agosto de 1994"
8,4,37,1631,362,462,824,"21 de agosto de 1994"
8,4,37,1632,408,468,876,"21 de agosto de 1994"
8,4,37,1633,360,410,770,"21 de agosto de 1994"
8,4,37,1634,280,357,637,"21 de agosto de 1994"
8,4,37,1635,393,474,867,"21 de agosto de 1994"
8,4,37,1636,458,534,992,"21 de agosto de 1994"
8,4,37,1637,343,376,719,"21 de agosto de 1994"
8,4,37,1638,360,430,790,"21 de agosto de 1994"
8,4,37,1639,371,407,778,"21 de agosto de 1994"
8,4,37,1640,189,221,410,"21 de agosto de 1994"
8,4,37,1641,535,599,1134,"21 de agosto de 1994"
8,4,37,1642,313,331,644,"21 de agosto de 1994"
8,4,37,1643,432,456,888,"21 de agosto de 1994"
8,4,37,1644,147,158,305,"21 de agosto de 1994"
8,4,37,1645,257,290,547,"21 de agosto de 1994"
8,4,37,1646,483,568,1051,"21 de agosto de 1994"
8,4,37,1647,207,259,466,"21 de agosto de 1994"
8,4,37,1648,240,310,550,"21 de agosto de 1994"
8,4,37,1649,412,461,873,"21 de agosto de 1994"
8,4,37,1650,290,343,633,"21 de agosto de 1994"
8,4,37,1651,398,432,830,"21 de agosto de 1994"
8,4,37,1652,236,255,491,"21 de agosto de 1994"
8,4,37,1653,337,345,682,"21 de agosto de 1994"
8,4,37,1654,426,523,949,"21 de agosto de 1994"
8,4,37,1655,425,493,918,"21 de agosto de 1994"
8,4,37,1656,212,248,460,"21 de agosto de 1994"
8,4,37,1657,425,487,912,"21 de agosto de 1994"
8,4,37,1658,274,329,603,"21 de agosto de 1994"
8,4,37,1659,357,364,721,"21 de agosto de 1994"
8,4,37,1660,338,319,657,"21 de agosto de 1994"
8,4,37,1661,277,300,577,"21 de agosto de 1994"
8,4,37,1662,276,301,577,"21 de agosto de 1994"
8,4,37,1663,353,402,755,"21 de agosto de 1994"
8,4,37,1664,303,381,684,"21 de agosto de 1994"
8,4,37,1665,536,564,1100,"21 de agosto de 1994"
8,4,37,1666,631,685,1316,"21 de agosto de 1994"
8,4,37,1667,244,242,486,"21 de agosto de 1994"
8,4,37,1668,230,243,473,"21 de agosto de 1994"
8,4,37,1669,161,167,328,"21 de agosto de 1994"
8,4,37,1670,265,272,537,"21 de agosto de 1994"
8,4,37,1671,221,245,466,"21 de agosto de 1994"
8,4,37,1672,364,441,805,"21 de agosto de 1994"
8,4,37,1673,576,651,1227,"21 de agosto de 1994"
8,4,37,1674,385,484,869,"21 de agosto de 1994"
8,4,37,1675,538,603,1141,"21 de agosto de 1994"
8,4,37,1676,409,482,891,"21 de agosto de 1994"
8,4,37,1677,186,238,424,"21 de agosto de 1994"
8,4,37,1678,428,485,913,"21 de agosto de 1994"
8,4,37,1679,350,405,755,"21 de agosto de 1994"
8,4,37,1680,391,459,850,"21 de agosto de 1994"
8,4,37,1681,255,291,546,"21 de agosto de 1994"
8,4,37,1682,321,358,679,"21 de agosto de 1994"
8,4,37,1683,106,89,195,"21 de agosto de 1994"
8,4,37,1684,445,546,991,"21 de agosto de 1994"
8,4,37,1685,242,258,500,"21 de agosto de 1994"
8,4,37,1686,300,311,611,"21 de agosto de 1994"
8,4,37,1687,447,472,919,"21 de agosto de 1994"
8,4,37,1688,318,358,676,"21 de agosto de 1994"
8,4,37,1689,345,378,723,"21 de agosto de 1994"
8,4,37,1690,318,342,660,"21 de agosto de 1994"
8,4,37,1691,155,182,337,"21 de agosto de 1994"
8,4,37,1692,276,308,584,"21 de agosto de 1994"
8,4,37,1693,390,405,795,"21 de agosto de 1994"
8,4,37,1694,394,392,786,"21 de agosto de 1994"
8,4,37,1695,215,227,442,"21 de agosto de 1994"
8,4,37,1696,328,361,689,"21 de agosto de 1994"
8,4,37,1697,406,443,849,"21 de agosto de 1994"
8,4,37,1698,286,301,587,"21 de agosto de 1994"
8,4,37,1699,251,275,526,"21 de agosto de 1994"
8,4,37,1700,374,437,811,"21 de agosto de 1994"
8,4,37,1701,437,518,955,"21 de agosto de 1994"
8,4,37,1702,454,475,929,"21 de agosto de 1994"
8,4,37,1703,370,452,822,"21 de agosto de 1994"
8,4,37,1704,491,516,1007,"21 de agosto de 1994"
8,4,37,1705,389,446,835,"21 de agosto de 1994"
8,4,37,1706,522,551,1073,"21 de agosto de 1994"
8,4,37,1707,323,403,726,"21 de agosto de 1994"
8,4,37,1708,317,398,715,"21 de agosto de 1994"
8,4,37,1709,226,256,482,"21 de agosto de 1994"
8,4,37,1710,375,423,798,"21 de agosto de 1994"
8,4,37,1711,653,699,1352,"21 de agosto de 1994"
8,4,37,1712,417,461,878,"21 de agosto de 1994"
8,4,37,1713,176,215,391,"21 de agosto de 1994"
8,4,37,1714,290,282,572,"21 de agosto de 1994"
8,4,37,1715,360,398,758,"21 de agosto de 1994"
8,4,37,1716,533,556,1089,"21 de agosto de 1994"
8,4,37,1717,490,542,1032,"21 de agosto de 1994"
8,4,37,1718,224,264,488,"21 de agosto de 1994"
8,4,37,1719,207,243,450,"21 de agosto de 1994"
8,4,37,1720,361,459,820,"21 de agosto de 1994"
8,4,37,1721,247,281,528,"21 de agosto de 1994"
8,4,37,1722,187,196,383,"21 de agosto de 1994"
8,4,37,1723,301,311,612,"21 de agosto de 1994"
8,4,37,1724,389,462,851,"21 de agosto de 1994"
8,4,37,1725,249,270,519,"21 de agosto de 1994"
8,4,37,1726,345,415,760,"21 de agosto de 1994"
8,4,37,1727,212,205,417,"21 de agosto de 1994"
8,4,37,1728,118,122,240,"21 de agosto de 1994"
8,4,37,1729,482,536,1018,"21 de agosto de 1994"
8,4,37,1730,290,325,615,"21 de agosto de 1994"
8,4,37,1731,198,256,454,"21 de agosto de 1994"
8,4,37,1732,582,636,1218,"21 de agosto de 1994"
8,4,37,1733,292,311,603,"21 de agosto de 1994"
8,4,37,1734,571,490,1061,"21 de agosto de 1994"
8,4,37,1735,309,347,656,"21 de agosto de 1994"
8,4,37,1736,259,258,517,"21 de agosto de 1994"
8,4,37,1737,247,226,473,"21 de agosto de 1994"
8,4,37,1738,301,360,661,"21 de agosto de 1994"
8,4,37,1739,191,240,431,"21 de agosto de 1994"
8,4,37,1740,231,265,496,"21 de agosto de 1994"
8,4,37,1741,102,112,214,"21 de agosto de 1994"
8,4,37,1742,92,100,192,"21 de agosto de 1994"
8,4,37,1743,164,164,328,"21 de agosto de 1994"
8,4,37,1744,362,383,745,"21 de agosto de 1994"
8,4,37,1745,761,799,1560,"21 de agosto de 1994"
8,4,37,1746,333,395,728,"21 de agosto de 1994"
8,4,37,1747,164,169,333,"21 de agosto de 1994"
8,4,37,1748,270,314,584,"21 de agosto de 1994"
8,4,37,1749,390,408,798,"21 de agosto de 1994"
8,4,37,1750,261,269,530,"21 de agosto de 1994"
8,4,37,1751,202,216,418,"21 de agosto de 1994"
8,4,37,1752,102,101,203,"21 de agosto de 1994"
8,4,37,1753,352,403,755,"21 de agosto de 1994"
8,4,37,1754,233,299,532,"21 de agosto de 1994"
8,4,37,1755,143,138,281,"21 de agosto de 1994"
8,4,37,1756,229,231,460,"21 de agosto de 1994"
8,4,37,1757,416,445,861,"21 de agosto de 1994"
8,4,37,1758,926,947,1873,"21 de agosto de 1994"
8,4,37,1759,228,256,484,"21 de agosto de 1994"
8,4,37,1760,345,364,709,"21 de agosto de 1994"
8,4,37,1761,236,247,483,"21 de agosto de 1994"
8,4,37,1762,232,239,471,"21 de agosto de 1994"
8,4,37,1763,768,691,1459,"21 de agosto de 1994"
8,4,37,1764,475,472,947,"21 de agosto de 1994"
8,4,37,1765,257,278,535,"21 de agosto de 1994"
8,4,37,1766,433,462,895,"21 de agosto de 1994"
8,4,37,1767,308,330,638,"21 de agosto de 1994"
8,4,37,1768,379,385,764,"21 de agosto de 1994"
8,4,37,1769,428,470,898,"21 de agosto de 1994"
8,4,37,1770,262,272,534,"21 de agosto de 1994"
8,4,37,1771,132,128,260,"21 de agosto de 1994"
8,4,37,1772,582,619,1201,"21 de agosto de 1994"
8,4,37,1773,215,247,462,"21 de agosto de 1994"
8,4,37,1774,298,333,631,"21 de agosto de 1994"
8,4,37,1775,374,383,757,"21 de agosto de 1994"
8,4,37,1776,242,272,514,"21 de agosto de 1994"
8,4,37,1777,268,277,545,"21 de agosto de 1994"
8,4,37,1778,388,475,863,"21 de agosto de 1994"
8,4,37,1779,361,396,757,"21 de agosto de 1994"
8,4,37,1780,137,132,269,"21 de agosto de 1994"
8,4,37,1781,218,260,478,"21 de agosto de 1994"
8,4,37,1782,317,335,652,"21 de agosto de 1994"
8,4,37,1783,355,412,767,"21 de agosto de 1994"
8,4,37,1784,368,391,759,"21 de agosto de 1994"
8,4,37,1785,271,280,551,"21 de agosto de 1994"
8,4,37,1786,273,272,545,"21 de agosto de 1994"
8,4,37,1787,432,510,942,"21 de agosto de 1994"
8,4,37,1788,167,190,357,"21 de agosto de 1994"
8,4,37,1789,218,231,449,"21 de agosto de 1994"
8,4,37,1790,247,312,559,"21 de agosto de 1994"
8,4,37,1791,244,253,497,"21 de agosto de 1994"
8,4,37,1792,97,138,235,"21 de agosto de 1994"
8,4,37,1793,274,324,598,"21 de agosto de 1994"
8,4,37,1794,315,371,686,"21 de agosto de 1994"
8,4,37,1795,209,243,452,"21 de agosto de 1994"
8,4,37,1796,342,408,750,"21 de agosto de 1994"
8,4,37,1797,263,307,570,"21 de agosto de 1994"
8,4,37,1798,227,248,475,"21 de agosto de 1994"
8,4,37,1799,427,478,905,"21 de agosto de 1994"
8,4,37,1800,250,325,575,"21 de agosto de 1994"
8,4,37,1801,215,246,461,"21 de agosto de 1994"
8,4,37,1802,154,167,321,"21 de agosto de 1994"
8,4,37,1803,187,182,369,"21 de agosto de 1994"
8,4,37,1804,140,148,288,"21 de agosto de 1994"
8,4,37,1805,230,271,501,"21 de agosto de 1994"
8,4,37,1806,240,253,493,"21 de agosto de 1994"
8,4,37,1807,253,286,539,"21 de agosto de 1994"
8,4,37,1808,326,337,663,"21 de agosto de 1994"
8,4,37,1809,225,234,459,"21 de agosto de 1994"
8,4,37,1810,237,283,520,"21 de agosto de 1994"
8,4,37,1811,251,291,542,"21 de agosto de 1994"
8,4,37,1812,318,366,684,"21 de agosto de 1994"
8,4,37,1813,237,278,515,"21 de agosto de 1994"
8,4,37,1814,302,348,650,"21 de agosto de 1994"
8,4,37,1815,368,369,737,"21 de agosto de 1994"
8,4,37,1816,209,192,401,"21 de agosto de 1994"
8,4,37,1817,222,221,443,"21 de agosto de 1994"
8,4,37,1818,252,283,535,"21 de agosto de 1994"
8,4,37,1819,301,324,625,"21 de agosto de 1994"
8,4,37,1820,206,241,447,"21 de agosto de 1994"
8,4,37,1821,375,432,807,"21 de agosto de 1994"
8,4,37,1822,252,291,543,"21 de agosto de 1994"
8,4,37,1823,267,263,530,"21 de agosto de 1994"
8,4,37,1824,270,289,559,"21 de agosto de 1994"
8,4,37,1825,336,324,660,"21 de agosto de 1994"
8,4,37,1826,967,1022,1989,"21 de agosto de 1994"
8,4,37,1827,532,575,1107,"21 de agosto de 1994"
8,4,37,1828,383,400,783,"21 de agosto de 1994"
8,4,37,1829,306,342,648,"21 de agosto de 1994"
8,4,37,1830,260,288,548,"21 de agosto de 1994"
8,4,37,1831,236,248,484,"21 de agosto de 1994"
8,4,37,1832,295,288,583,"21 de agosto de 1994"
8,4,37,1833,185,221,406,"21 de agosto de 1994"
8,4,37,1834,299,333,632,"21 de agosto de 1994"
8,4,37,1835,271,269,540,"21 de agosto de 1994"
8,4,37,1836,312,298,610,"21 de agosto de 1994"
8,4,37,1837,583,564,1147,"21 de agosto de 1994"
8,4,37,1838,383,378,761,"21 de agosto de 1994"
8,4,37,1839,266,281,547,"21 de agosto de 1994"
8,4,37,1840,325,337,662,"21 de agosto de 1994"
8,4,37,1841,301,332,633,"21 de agosto de 1994"
8,4,37,1842,314,364,678,"21 de agosto de 1994"
8,4,37,1843,279,325,604,"21 de agosto de 1994"
8,4,37,1844,316,344,660,"21 de agosto de 1994"
8,4,37,1845,322,317,639,"21 de agosto de 1994"
8,4,37,1846,271,262,533,"21 de agosto de 1994"
8,4,37,1847,254,313,567,"21 de agosto de 1994"
8,4,37,1848,227,276,503,"21 de agosto de 1994"
8,4,37,1849,234,267,501,"21 de agosto de 1994"
8,4,37,1850,220,262,482,"21 de agosto de 1994"
8,4,37,1851,464,449,913,"21 de agosto de 1994"
8,4,37,1852,227,254,481,"21 de agosto de 1994"
8,4,37,1853,265,294,559,"21 de agosto de 1994"
8,4,37,1854,291,298,589,"21 de agosto de 1994"
8,4,37,1855,307,323,630,"21 de agosto de 1994"
8,4,37,1856,233,223,456,"21 de agosto de 1994"
8,4,37,1857,318,316,634,"21 de agosto de 1994"
8,4,37,1858,201,211,412,"21 de agosto de 1994"
8,4,37,1859,229,248,477,"21 de agosto de 1994"
8,4,37,1860,399,431,830,"21 de agosto de 1994"
8,4,37,1861,166,186,352,"21 de agosto de 1994"
8,4,37,1862,251,261,512,"21 de agosto de 1994"
8,4,37,1863,330,342,672,"21 de agosto de 1994"
8,4,37,1864,159,127,286,"21 de agosto de 1994"
8,4,37,1865,242,278,520,"21 de agosto de 1994"
8,4,37,1866,276,302,578,"21 de agosto de 1994"
8,4,37,1867,187,235,422,"21 de agosto de 1994"
8,4,37,1868,328,370,698,"21 de agosto de 1994"
8,4,37,1869,380,391,771,"21 de agosto de 1994"
8,4,37,1870,288,297,585,"21 de agosto de 1994"
8,4,37,1871,314,353,667,"21 de agosto de 1994"
8,4,37,1872,311,392,703,"21 de agosto de 1994"
8,4,37,1873,217,227,444,"21 de agosto de 1994"
8,4,37,1874,259,267,526,"21 de agosto de 1994"
8,4,37,1875,206,218,424,"21 de agosto de 1994"
8,4,37,1876,252,241,493,"21 de agosto de 1994"
8,4,37,1877,416,427,843,"21 de agosto de 1994"
8,4,37,1878,356,418,774,"21 de agosto de 1994"
8,4,37,1879,597,565,1162,"21 de agosto de 1994"
8,4,37,1880,345,386,731,"21 de agosto de 1994"
8,4,37,1881,220,252,472,"21 de agosto de 1994"
8,4,37,1882,261,274,535,"21 de agosto de 1994"
8,4,37,1883,400,400,800,"21 de agosto de 1994"
8,4,37,1884,36,29,65,"21 de agosto de 1994"
8,4,37,1885,1034,961,1995,"21 de agosto de 1994"
8,4,37,1886,363,382,745,"21 de agosto de 1994"
8,4,37,1887,203,207,410,"21 de agosto de 1994"
8,4,37,1888,495,478,973,"21 de agosto de 1994"
8,4,37,1889,1101,963,2064,"21 de agosto de 1994"
8,4,37,1890,33,25,58,"21 de agosto de 1994"
8,4,37,1891,360,373,733,"21 de agosto de 1994"
8,4,37,1892,306,314,620,"21 de agosto de 1994"
8,4,37,1893,245,228,473,"21 de agosto de 1994"
8,4,37,1894,211,222,433,"21 de agosto de 1994"
8,4,37,1895,277,280,557,"21 de agosto de 1994"
8,4,37,1896,319,293,612,"21 de agosto de 1994"
8,4,37,1897,253,264,517,"21 de agosto de 1994"
8,4,37,1898,335,298,633,"21 de agosto de 1994"
8,4,37,1899,254,253,507,"21 de agosto de 1994"
8,4,37,1900,275,270,545,"21 de agosto de 1994"
8,4,37,1901,282,278,560,"21 de agosto de 1994"
8,4,37,1902,347,329,676,"21 de agosto de 1994"
8,4,37,1903,266,274,540,"21 de agosto de 1994"
8,4,37,1904,283,302,585,"21 de agosto de 1994"
8,4,37,1905,137,150,287,"21 de agosto de 1994"
8,4,37,1906,310,326,636,"21 de agosto de 1994"
8,4,37,1907,582,550,1132,"21 de agosto de 1994"
8,4,37,1908,354,411,765,"21 de agosto de 1994"
8,4,37,1909,259,223,482,"21 de agosto de 1994"
8,4,37,1910,282,280,562,"21 de agosto de 1994"
8,4,37,1911,243,229,472,"21 de agosto de 1994"
8,4,37,1912,242,247,489,"21 de agosto de 1994"
8,4,37,1913,580,540,1120,"21 de agosto de 1994"
8,4,37,1914,204,169,373,"21 de agosto de 1994"
8,4,37,1915,26,23,49,"21 de agosto de 1994"
8,4,37,1916,482,512,994,"21 de agosto de 1994"
8,4,37,1917,227,244,471,"21 de agosto de 1994"
8,4,37,1918,273,323,596,"21 de agosto de 1994"
8,4,37,1919,291,327,618,"21 de agosto de 1994"
8,4,37,1920,309,354,663,"21 de agosto de 1994"
8,4,37,1921,279,357,636,"21 de agosto de 1994"
8,4,37,1922,246,302,548,"21 de agosto de 1994"
8,4,37,1923,277,317,594,"21 de agosto de 1994"
8,4,37,1924,201,245,446,"21 de agosto de 1994"
8,4,37,1925,304,346,650,"21 de agosto de 1994"
8,4,37,1926,300,330,630,"21 de agosto de 1994"
8,4,37,1927,299,352,651,"21 de agosto de 1994"
8,4,37,1928,214,238,452,"21 de agosto de 1994"
8,4,37,1929,741,771,1512,"21 de agosto de 1994"
8,4,37,1930,557,585,1142,"21 de agosto de 1994"
8,4,37,1931,309,286,595,"21 de agosto de 1994"
8,4,37,1932,352,370,722,"21 de agosto de 1994"
8,4,37,1933,436,513,949,"21 de agosto de 1994"
8,4,37,1934,249,293,542,"21 de agosto de 1994"
8,4,37,1935,268,306,574,"21 de agosto de 1994"
8,4,37,1936,410,421,831,"21 de agosto de 1994"
8,4,37,1937,171,193,364,"21 de agosto de 1994"
8,4,37,1938,179,225,404,"21 de agosto de 1994"
8,4,37,1939,215,221,436,"21 de agosto de 1994"
8,4,37,1940,231,273,504,"21 de agosto de 1994"
8,4,37,1941,162,185,347,"21 de agosto de 1994"
8,4,37,1942,601,615,1216,"21 de agosto de 1994"
8,4,37,1943,416,401,817,"21 de agosto de 1994"
8,4,37,1944,212,231,443,"21 de agosto de 1994"
8,4,37,1945,312,255,567,"21 de agosto de 1994"
8,4,37,1946,313,328,641,"21 de agosto de 1994"
8,4,37,1947,505,549,1054,"21 de agosto de 1994"
8,4,37,1948,509,543,1052,"21 de agosto de 1994"
8,4,37,1949,177,180,357,"21 de agosto de 1994"
8,4,37,1950,421,475,896,"21 de agosto de 1994"
8,4,37,2052,1,0,1,"21 de agosto de 1994"
8,5,6,82,247,226,473,"21 de agosto de 1994"
8,5,6,83,147,143,290,"21 de agosto de 1994"
8,5,6,84,142,120,262,"21 de agosto de 1994"
8,5,6,85,132,132,264,"21 de agosto de 1994"
8,5,6,86,70,60,130,"21 de agosto de 1994"
8,5,6,87,258,225,483,"21 de agosto de 1994"
8,5,6,88,166,124,290,"21 de agosto de 1994"
8,5,6,89,109,105,214,"21 de agosto de 1994"
8,5,6,90,118,103,221,"21 de agosto de 1994"
8,5,6,91,75,63,138,"21 de agosto de 1994"
8,5,6,92,65,54,119,"21 de agosto de 1994"
8,5,6,93,42,42,84,"21 de agosto de 1994"
8,5,6,94,85,74,159,"21 de agosto de 1994"
8,5,6,95,138,138,276,"21 de agosto de 1994"
8,5,6,96,25,24,49,"21 de agosto de 1994"
8,5,6,97,78,64,142,"21 de agosto de 1994"
8,5,6,98,81,77,158,"21 de agosto de 1994"
8,5,6,99,146,142,288,"21 de agosto de 1994"
8,5,6,100,220,182,402,"21 de agosto de 1994"
8,5,6,101,162,162,324,"21 de agosto de 1994"
8,5,9,127,97,81,178,"21 de agosto de 1994"
8,5,9,128,251,252,503,"21 de agosto de 1994"
8,5,9,129,387,422,809,"21 de agosto de 1994"
8,5,9,130,405,430,835,"21 de agosto de 1994"
8,5,9,131,297,320,617,"21 de agosto de 1994"
8,5,9,132,427,480,907,"21 de agosto de 1994"
8,5,9,133,336,372,708,"21 de agosto de 1994"
8,5,9,134,268,277,545,"21 de agosto de 1994"
8,5,9,135,340,331,671,"21 de agosto de 1994"
8,5,9,136,552,533,1085,"21 de agosto de 1994"
8,5,9,137,606,437,1043,"21 de agosto de 1994"
8,5,9,138,229,155,384,"21 de agosto de 1994"
8,5,9,139,325,248,573,"21 de agosto de 1994"
8,5,9,140,289,197,486,"21 de agosto de 1994"
8,5,9,141,257,179,436,"21 de agosto de 1994"
8,5,9,142,144,119,263,"21 de agosto de 1994"
8,5,9,143,175,146,321,"21 de agosto de 1994"
8,5,9,144,429,396,825,"21 de agosto de 1994"
8,5,9,145,342,279,621,"21 de agosto de 1994"
8,5,9,146,390,274,664,"21 de agosto de 1994"
8,5,9,147,256,192,448,"21 de agosto de 1994"
8,5,9,148,132,102,234,"21 de agosto de 1994"
8,5,12,221,334,323,657,"21 de agosto de 1994"
8,5,12,222,208,204,412,"21 de agosto de 1994"
8,5,12,223,135,115,250,"21 de agosto de 1994"
8,5,12,224,77,71,148,"21 de agosto de 1994"
8,5,12,225,238,206,444,"21 de agosto de 1994"
8,5,12,226,84,65,149,"21 de agosto de 1994"
8,5,12,227,125,98,223,"21 de agosto de 1994"
8,5,12,228,56,40,96,"21 de agosto de 1994"
8,5,12,229,73,47,120,"21 de agosto de 1994"
8,5,12,230,57,43,100,"21 de agosto de 1994"
8,5,12,231,93,61,154,"21 de agosto de 1994"
8,5,12,232,98,68,166,"21 de agosto de 1994"
8,5,12,233,65,44,109,"21 de agosto de 1994"
8,5,12,234,286,149,435,"21 de agosto de 1994"
8,5,12,235,174,118,292,"21 de agosto de 1994"
8,5,12,236,107,46,153,"21 de agosto de 1994"
8,5,12,237,130,33,163,"21 de agosto de 1994"
8,5,20,912,363,308,671,"21 de agosto de 1994"
8,5,20,913,179,143,322,"21 de agosto de 1994"
8,5,20,914,391,322,713,"21 de agosto de 1994"
8,5,20,915,107,87,194,"21 de agosto de 1994"
8,5,20,916,130,86,216,"21 de agosto de 1994"
8,5,20,917,173,140,313,"21 de agosto de 1994"
8,5,20,918,163,115,278,"21 de agosto de 1994"
8,5,20,919,279,199,478,"21 de agosto de 1994"
8,5,20,920,31,19,50,"21 de agosto de 1994"
8,5,25,1053,271,286,557,"21 de agosto de 1994"
8,5,25,1054,248,245,493,"21 de agosto de 1994"
8,5,25,1055,94,87,181,"21 de agosto de 1994"
8,5,25,1056,100,92,192,"21 de agosto de 1994"
8,5,25,1057,275,279,554,"21 de agosto de 1994"
8,5,25,1058,362,340,702,"21 de agosto de 1994"
8,5,25,1059,200,165,365,"21 de agosto de 1994"
8,5,25,1060,198,191,389,"21 de agosto de 1994"
8,5,25,1061,215,198,413,"21 de agosto de 1994"
8,5,25,1062,124,116,240,"21 de agosto de 1994"
8,5,25,1063,120,125,245,"21 de agosto de 1994"
8,5,25,1064,135,142,277,"21 de agosto de 1994"
8,5,25,1065,280,268,548,"21 de agosto de 1994"
8,5,25,1066,77,82,159,"21 de agosto de 1994"
8,5,25,1067,261,229,490,"21 de agosto de 1994"
8,5,25,1068,20,13,33,"21 de agosto de 1994"
8,5,30,1167,195,195,390,"21 de agosto de 1994"
8,5,30,1168,213,184,397,"21 de agosto de 1994"
8,5,30,1169,248,180,428,"21 de agosto de 1994"
8,5,30,1170,102,76,178,"21 de agosto de 1994"
8,5,30,1171,242,180,422,"21 de agosto de 1994"
8,5,30,1172,82,64,146,"21 de agosto de 1994"
8,5,30,1173,157,101,258,"21 de agosto de 1994"
8,5,30,1174,218,199,417,"21 de agosto de 1994"
8,5,30,1175,117,101,218,"21 de agosto de 1994"
8,5,30,1176,61,49,110,"21 de agosto de 1994"
8,5,30,1177,166,133,299,"21 de agosto de 1994"
8,5,30,1178,84,71,155,"21 de agosto de 1994"
8,5,30,1179,59,50,109,"21 de agosto de 1994"
8,5,30,1180,76,75,151,"21 de agosto de 1994"
8,5,30,1181,114,101,215,"21 de agosto de 1994"
8,5,31,1182,330,347,677,"21 de agosto de 1994"
8,5,31,1183,247,257,504,"21 de agosto de 1994"
8,5,31,1184,336,373,709,"21 de agosto de 1994"
8,5,31,1185,261,244,505,"21 de agosto de 1994"
8,5,31,1186,390,451,841,"21 de agosto de 1994"
8,5,31,1187,317,353,670,"21 de agosto de 1994"
8,5,31,1188,115,143,258,"21 de agosto de 1994"
8,5,31,1189,161,169,330,"21 de agosto de 1994"
8,5,31,1190,183,192,375,"21 de agosto de 1994"
8,5,31,1191,115,114,229,"21 de agosto de 1994"
8,5,31,1192,116,115,231,"21 de agosto de 1994"
8,5,31,1193,140,129,269,"21 de agosto de 1994"
8,5,31,1194,243,268,511,"21 de agosto de 1994"
8,5,31,1195,339,381,720,"21 de agosto de 1994"
8,5,31,1196,314,298,612,"21 de agosto de 1994"
8,5,31,1197,132,134,266,"21 de agosto de 1994"
8,5,31,1198,290,313,603,"21 de agosto de 1994"
8,5,31,1199,304,305,609,"21 de agosto de 1994"
8,5,31,1200,316,326,642,"21 de agosto de 1994"
8,5,31,1201,184,161,345,"21 de agosto de 1994"
8,5,31,1202,113,96,209,"21 de agosto de 1994"
8,5,31,1203,78,67,145,"21 de agosto de 1994"
8,5,31,1204,101,99,200,"21 de agosto de 1994"
8,5,31,1205,94,75,169,"21 de agosto de 1994"
8,5,31,1206,57,45,102,"21 de agosto de 1994"
8,5,31,1207,51,45,96,"21 de agosto de 1994"
8,5,31,1208,71,62,133,"21 de agosto de 1994"
8,5,31,1209,100,79,179,"21 de agosto de 1994"
8,5,31,1210,199,206,405,"21 de agosto de 1994"
8,5,31,1211,140,160,300,"21 de agosto de 1994"
8,5,31,1212,185,155,340,"21 de agosto de 1994"
8,5,31,1213,196,161,357,"21 de agosto de 1994"
8,5,31,1214,137,120,257,"21 de agosto de 1994"
8,5,31,1215,257,194,451,"21 de agosto de 1994"
8,5,31,1216,75,74,149,"21 de agosto de 1994"
8,5,31,1217,118,102,220,"21 de agosto de 1994"
8,5,31,1218,423,437,860,"21 de agosto de 1994"
8,5,31,1219,190,156,346,"21 de agosto de 1994"
8,5,31,1220,33,41,74,"21 de agosto de 1994"
8,5,31,1221,149,153,302,"21 de agosto de 1994"
8,5,31,1222,81,71,152,"21 de agosto de 1994"
8,5,31,1223,73,70,143,"21 de agosto de 1994"
8,5,31,1224,148,117,265,"21 de agosto de 1994"
8,5,31,1225,128,76,204,"21 de agosto de 1994"
8,5,31,1226,114,83,197,"21 de agosto de 1994"
8,5,31,1227,60,47,107,"21 de agosto de 1994"
8,5,31,1228,198,165,363,"21 de agosto de 1994"
8,5,31,1229,206,193,399,"21 de agosto de 1994"
8,5,31,1230,107,95,202,"21 de agosto de 1994"
8,5,31,1231,98,75,173,"21 de agosto de 1994"
8,5,31,1232,89,84,173,"21 de agosto de 1994"
8,5,31,1233,46,35,81,"21 de agosto de 1994"
8,5,31,1234,33,30,63,"21 de agosto de 1994"
8,5,31,1235,213,199,412,"21 de agosto de 1994"
8,5,31,1236,53,32,85,"21 de agosto de 1994"
8,5,31,1237,434,392,826,"21 de agosto de 1994"
8,5,31,1238,47,29,76,"21 de agosto de 1994"
8,5,31,1239,95,68,163,"21 de agosto de 1994"
8,5,31,1240,27,22,49,"21 de agosto de 1994"
8,5,31,1241,48,47,95,"21 de agosto de 1994"
8,5,31,1242,266,259,525,"21 de agosto de 1994"
8,5,31,1243,68,50,118,"21 de agosto de 1994"
8,5,31,1244,353,336,689,"21 de agosto de 1994"
8,5,31,1245,181,158,339,"21 de agosto de 1994"
8,5,31,1246,84,52,136,"21 de agosto de 1994"
8,5,31,1247,47,35,82,"21 de agosto de 1994"
8,5,31,1248,268,249,517,"21 de agosto de 1994"
8,5,31,1249,110,88,198,"21 de agosto de 1994"
8,5,31,1250,152,160,312,"21 de agosto de 1994"
8,5,31,1251,54,37,91,"21 de agosto de 1994"
8,5,31,1252,17,12,29,"21 de agosto de 1994"
8,5,31,1253,40,39,79,"21 de agosto de 1994"
8,5,31,1254,23,15,38,"21 de agosto de 1994"
8,5,31,1255,68,49,117,"21 de agosto de 1994"
8,5,31,1256,19,25,44,"21 de agosto de 1994"
8,5,31,1257,257,213,470,"21 de agosto de 1994"
8,5,31,1258,67,57,124,"21 de agosto de 1994"
8,5,31,1259,34,26,60,"21 de agosto de 1994"
8,5,31,1260,90,77,167,"21 de agosto de 1994"
8,5,31,1261,89,60,149,"21 de agosto de 1994"
8,5,31,1262,35,15,50,"21 de agosto de 1994"
8,5,31,1263,49,36,85,"21 de agosto de 1994"
8,5,31,1264,80,60,140,"21 de agosto de 1994"
8,5,31,1265,59,52,111,"21 de agosto de 1994"
8,5,41,2261,148,131,279,"21 de agosto de 1994"
8,5,41,2262,82,48,130,"21 de agosto de 1994"
8,5,41,2263,52,39,91,"21 de agosto de 1994"
8,5,41,2264,63,40,103,"21 de agosto de 1994"
8,5,41,2265,112,74,186,"21 de agosto de 1994"
8,5,43,2271,91,95,186,"21 de agosto de 1994"
8,5,43,2272,381,405,786,"21 de agosto de 1994"
8,5,43,2273,198,197,395,"21 de agosto de 1994"
8,5,43,2274,123,114,237,"21 de agosto de 1994"
8,5,43,2275,75,58,133,"21 de agosto de 1994"
8,5,43,2276,172,187,359,"21 de agosto de 1994"
8,5,43,2277,95,87,182,"21 de agosto de 1994"
8,5,47,2331,314,246,560,"21 de agosto de 1994"
8,5,47,2332,66,50,116,"21 de agosto de 1994"
8,5,47,2333,165,144,309,"21 de agosto de 1994"
8,5,47,2334,52,36,88,"21 de agosto de 1994"
8,5,47,2335,361,286,647,"21 de agosto de 1994"
8,5,47,2336,65,58,123,"21 de agosto de 1994"
8,5,47,2337,117,103,220,"21 de agosto de 1994"
8,5,47,2338,113,87,200,"21 de agosto de 1994"
8,5,48,2339,276,285,561,"21 de agosto de 1994"
8,5,48,2340,174,158,332,"21 de agosto de 1994"
8,5,48,2341,116,104,220,"21 de agosto de 1994"
8,5,48,2342,382,359,741,"21 de agosto de 1994"
8,5,48,2343,393,340,733,"21 de agosto de 1994"
8,5,48,2344,290,269,559,"21 de agosto de 1994"
8,5,48,2345,113,89,202,"21 de agosto de 1994"
8,5,48,2346,149,147,296,"21 de agosto de 1994"
8,5,48,2347,188,211,399,"21 de agosto de 1994"
8,5,48,2348,194,177,371,"21 de agosto de 1994"
8,5,48,2349,289,273,562,"21 de agosto de 1994"
8,5,48,2350,345,338,683,"21 de agosto de 1994"
8,5,48,2351,221,215,436,"21 de agosto de 1994"
8,5,48,2352,241,236,477,"21 de agosto de 1994"
8,5,48,2353,329,294,623,"21 de agosto de 1994"
8,5,48,2354,314,348,662,"21 de agosto de 1994"
8,5,48,2355,77,64,141,"21 de agosto de 1994"
8,5,48,2356,61,61,122,"21 de agosto de 1994"
8,5,48,2357,73,58,131,"21 de agosto de 1994"
8,5,48,2358,176,109,285,"21 de agosto de 1994"
8,5,48,2359,31,27,58,"21 de agosto de 1994"
8,5,48,2360,97,94,191,"21 de agosto de 1994"
8,5,48,2361,150,130,280,"21 de agosto de 1994"
8,5,48,2362,109,70,179,"21 de agosto de 1994"
8,5,48,2363,108,81,189,"21 de agosto de 1994"
8,5,48,2364,106,92,198,"21 de agosto de 1994"
8,5,48,2365,241,242,483,"21 de agosto de 1994"
8,5,48,2366,44,36,80,"21 de agosto de 1994"
8,5,48,2367,179,147,326,"21 de agosto de 1994"
8,5,48,2368,87,83,170,"21 de agosto de 1994"
8,5,48,2369,36,27,63,"21 de agosto de 1994"
8,5,48,2370,24,23,47,"21 de agosto de 1994"
8,5,48,2371,41,41,82,"21 de agosto de 1994"
8,5,48,2372,36,31,67,"21 de agosto de 1994"
8,5,48,2373,44,40,84,"21 de agosto de 1994"
8,5,48,2374,58,55,113,"21 de agosto de 1994"
8,5,48,2375,138,125,263,"21 de agosto de 1994"
8,5,48,2376,35,31,66,"21 de agosto de 1994"
8,5,48,2377,44,42,86,"21 de agosto de 1994"
8,5,48,2378,85,92,177,"21 de agosto de 1994"
8,5,48,2379,142,135,277,"21 de agosto de 1994"
8,5,48,2380,161,154,315,"21 de agosto de 1994"
8,5,48,2381,346,306,652,"21 de agosto de 1994"
8,5,48,2382,149,125,274,"21 de agosto de 1994"
8,5,48,2383,63,60,123,"21 de agosto de 1994"
8,5,48,2384,209,179,388,"21 de agosto de 1994"
8,5,48,2385,204,170,374,"21 de agosto de 1994"
8,5,48,2386,60,49,109,"21 de agosto de 1994"
8,5,48,2387,101,91,192,"21 de agosto de 1994"
8,5,48,2388,184,173,357,"21 de agosto de 1994"
8,5,48,2389,157,145,302,"21 de agosto de 1994"
8,5,51,2460,154,128,282,"21 de agosto de 1994"
8,5,51,2461,78,70,148,"21 de agosto de 1994"
8,5,51,2462,67,56,123,"21 de agosto de 1994"
8,5,51,2463,84,74,158,"21 de agosto de 1994"
8,5,51,2464,81,59,140,"21 de agosto de 1994"
8,5,51,2465,16,17,33,"21 de agosto de 1994"
8,5,51,2466,205,167,372,"21 de agosto de 1994"
8,5,51,2467,252,202,454,"21 de agosto de 1994"
8,5,51,2468,2,1,3,"21 de agosto de 1994"
8,5,51,2469,85,58,143,"21 de agosto de 1994"
8,5,51,2470,100,70,170,"21 de agosto de 1994"
8,5,51,2471,87,68,155,"21 de agosto de 1994"
8,5,51,2472,259,172,431,"21 de agosto de 1994"
8,5,51,2473,164,135,299,"21 de agosto de 1994"
8,5,51,2474,74,66,140,"21 de agosto de 1994"
8,5,51,2475,131,117,248,"21 de agosto de 1994"
8,5,51,2476,113,82,195,"21 de agosto de 1994"
8,5,63,2648,206,205,411,"21 de agosto de 1994"
8,5,63,2649,415,396,811,"21 de agosto de 1994"
8,5,63,2650,117,132,249,"21 de agosto de 1994"
8,5,63,2651,96,84,180,"21 de agosto de 1994"
8,5,63,2652,145,120,265,"21 de agosto de 1994"
8,5,63,2653,260,258,518,"21 de agosto de 1994"
8,5,63,2654,109,89,198,"21 de agosto de 1994"
8,5,63,2655,188,134,322,"21 de agosto de 1994"
8,5,63,2656,200,158,358,"21 de agosto de 1994"
8,5,63,2657,126,92,218,"21 de agosto de 1994"
8,5,63,2658,81,60,141,"21 de agosto de 1994"
8,5,63,2659,310,220,530,"21 de agosto de 1994"
8,5,63,2660,188,141,329,"21 de agosto de 1994"
8,5,66,2684,207,202,409,"21 de agosto de 1994"
8,5,66,2685,412,310,722,"21 de agosto de 1994"
8,5,66,2686,155,107,262,"21 de agosto de 1994"
8,5,66,2687,93,76,169,"21 de agosto de 1994"
8,5,66,2688,35,15,50,"21 de agosto de 1994"
8,5,66,2689,138,129,267,"21 de agosto de 1994"
8,5,66,2690,127,108,235,"21 de agosto de 1994"
8,5,66,2691,99,84,183,"21 de agosto de 1994"
8,5,66,2692,188,143,331,"21 de agosto de 1994"
8,5,66,2693,109,89,198,"21 de agosto de 1994"
8,5,66,2694,104,80,184,"21 de agosto de 1994"
8,5,66,2695,138,109,247,"21 de agosto de 1994"
8,5,66,2696,66,34,100,"21 de agosto de 1994"
8,6,11,175,174,188,362,"21 de agosto de 1994"
8,6,11,176,379,400,779,"21 de agosto de 1994"
8,6,11,177,284,313,597,"21 de agosto de 1994"
8,6,11,178,283,352,635,"21 de agosto de 1994"
8,6,11,179,177,221,398,"21 de agosto de 1994"
8,6,11,180,232,245,477,"21 de agosto de 1994"
8,6,11,181,232,252,484,"21 de agosto de 1994"
8,6,11,182,205,270,475,"21 de agosto de 1994"
8,6,11,183,339,324,663,"21 de agosto de 1994"
8,6,11,184,268,279,547,"21 de agosto de 1994"
8,6,11,185,530,546,1076,"21 de agosto de 1994"
8,6,11,186,485,500,985,"21 de agosto de 1994"
8,6,11,187,289,286,575,"21 de agosto de 1994"
8,6,11,188,257,284,541,"21 de agosto de 1994"
8,6,11,189,363,364,727,"21 de agosto de 1994"
8,6,11,190,374,418,792,"21 de agosto de 1994"
8,6,11,191,606,662,1268,"21 de agosto de 1994"
8,6,11,192,306,318,624,"21 de agosto de 1994"
8,6,11,193,350,375,725,"21 de agosto de 1994"
8,6,11,194,280,299,579,"21 de agosto de 1994"
8,6,11,195,257,260,517,"21 de agosto de 1994"
8,6,11,196,465,473,938,"21 de agosto de 1994"
8,6,11,197,413,428,841,"21 de agosto de 1994"
8,6,11,198,54,69,123,"21 de agosto de 1994"
8,6,11,199,566,547,1113,"21 de agosto de 1994"
8,6,11,200,306,330,636,"21 de agosto de 1994"
8,6,11,201,322,338,660,"21 de agosto de 1994"
8,6,11,202,389,387,776,"21 de agosto de 1994"
8,6,11,203,427,431,858,"21 de agosto de 1994"
8,6,11,204,534,527,1061,"21 de agosto de 1994"
8,6,11,205,371,363,734,"21 de agosto de 1994"
8,6,11,206,349,369,718,"21 de agosto de 1994"
8,6,11,207,87,73,160,"21 de agosto de 1994"
8,6,11,208,93,86,179,"21 de agosto de 1994"
8,6,11,209,49,44,93,"21 de agosto de 1994"
8,6,11,210,62,53,115,"21 de agosto de 1994"
8,6,11,211,76,40,116,"21 de agosto de 1994"
8,6,11,212,92,63,155,"21 de agosto de 1994"
8,6,11,213,23,19,42,"21 de agosto de 1994"
8,6,11,214,140,151,291,"21 de agosto de 1994"
8,6,11,215,395,370,765,"21 de agosto de 1994"
8,6,11,216,381,355,736,"21 de agosto de 1994"
8,6,11,217,260,201,461,"21 de agosto de 1994"
8,6,11,218,207,157,364,"21 de agosto de 1994"
8,6,11,219,337,253,590,"21 de agosto de 1994"
8,6,11,220,120,86,206,"21 de agosto de 1994"
8,6,15,261,294,246,540,"21 de agosto de 1994"
8,6,15,262,44,18,62,"21 de agosto de 1994"
8,6,15,263,82,64,146,"21 de agosto de 1994"
8,6,15,264,116,100,216,"21 de agosto de 1994"
8,6,15,265,213,152,365,"21 de agosto de 1994"
8,6,16,266,282,282,564,"21 de agosto de 1994"
8,6,16,267,226,213,439,"21 de agosto de 1994"
8,6,16,268,157,128,285,"21 de agosto de 1994"
8,6,16,269,280,242,522,"21 de agosto de 1994"
8,6,16,270,272,268,540,"21 de agosto de 1994"
8,6,21,921,400,413,813,"21 de agosto de 1994"
8,6,21,922,421,438,859,"21 de agosto de 1994"
8,6,21,923,397,456,853,"21 de agosto de 1994"
8,6,21,924,274,313,587,"21 de agosto de 1994"
8,6,21,925,372,343,715,"21 de agosto de 1994"
8,6,21,926,323,351,674,"21 de agosto de 1994"
8,6,21,927,262,289,551,"21 de agosto de 1994"
8,6,21,928,204,244,448,"21 de agosto de 1994"
8,6,21,929,322,369,691,"21 de agosto de 1994"
8,6,21,930,284,357,641,"21 de agosto de 1994"
8,6,21,931,240,264,504,"21 de agosto de 1994"
8,6,21,932,338,353,691,"21 de agosto de 1994"
8,6,21,933,382,400,782,"21 de agosto de 1994"
8,6,21,934,321,357,678,"21 de agosto de 1994"
8,6,21,935,319,336,655,"21 de agosto de 1994"
8,6,21,936,214,244,458,"21 de agosto de 1994"
8,6,21,937,310,335,645,"21 de agosto de 1994"
8,6,21,938,205,216,421,"21 de agosto de 1994"
8,6,21,939,335,384,719,"21 de agosto de 1994"
8,6,21,940,207,224,431,"21 de agosto de 1994"
8,6,21,941,230,246,476,"21 de agosto de 1994"
8,6,21,942,227,251,478,"21 de agosto de 1994"
8,6,21,943,232,253,485,"21 de agosto de 1994"
8,6,21,944,296,306,602,"21 de agosto de 1994"
8,6,21,945,216,239,455,"21 de agosto de 1994"
8,6,21,946,429,452,881,"21 de agosto de 1994"
8,6,21,947,271,282,553,"21 de agosto de 1994"
8,6,21,948,267,313,580,"21 de agosto de 1994"
8,6,21,949,289,278,567,"21 de agosto de 1994"
8,6,21,950,350,373,723,"21 de agosto de 1994"
8,6,21,951,292,339,631,"21 de agosto de 1994"
8,6,21,952,211,210,421,"21 de agosto de 1994"
8,6,21,953,284,341,625,"21 de agosto de 1994"
8,6,21,954,402,419,821,"21 de agosto de 1994"
8,6,21,955,255,313,568,"21 de agosto de 1994"
8,6,21,956,222,239,461,"21 de agosto de 1994"
8,6,21,957,402,428,830,"21 de agosto de 1994"
8,6,21,958,426,467,893,"21 de agosto de 1994"
8,6,21,959,328,381,709,"21 de agosto de 1994"
8,6,21,960,379,439,818,"21 de agosto de 1994"
8,6,21,961,263,329,592,"21 de agosto de 1994"
8,6,21,962,397,439,836,"21 de agosto de 1994"
8,6,21,963,421,443,864,"21 de agosto de 1994"
8,6,21,964,279,296,575,"21 de agosto de 1994"
8,6,21,965,372,416,788,"21 de agosto de 1994"
8,6,21,966,268,288,556,"21 de agosto de 1994"
8,6,21,967,300,300,600,"21 de agosto de 1994"
8,6,21,968,339,365,704,"21 de agosto de 1994"
8,6,21,969,374,435,809,"21 de agosto de 1994"
8,6,21,970,349,392,741,"21 de agosto de 1994"
8,6,21,971,247,297,544,"21 de agosto de 1994"
8,6,21,972,221,217,438,"21 de agosto de 1994"
8,6,21,973,567,539,1106,"21 de agosto de 1994"
8,6,21,974,357,414,771,"21 de agosto de 1994"
8,6,21,975,296,327,623,"21 de agosto de 1994"
8,6,21,976,283,284,567,"21 de agosto de 1994"
8,6,21,977,273,300,573,"21 de agosto de 1994"
8,6,21,978,291,320,611,"21 de agosto de 1994"
8,6,21,979,257,276,533,"21 de agosto de 1994"
8,6,21,980,296,331,627,"21 de agosto de 1994"
8,6,21,981,377,412,789,"21 de agosto de 1994"
8,6,21,982,281,286,567,"21 de agosto de 1994"
8,6,21,983,348,372,720,"21 de agosto de 1994"
8,6,21,984,457,518,975,"21 de agosto de 1994"
8,6,21,985,265,298,563,"21 de agosto de 1994"
8,6,21,986,231,242,473,"21 de agosto de 1994"
8,6,21,987,325,360,685,"21 de agosto de 1994"
8,6,21,988,322,332,654,"21 de agosto de 1994"
8,6,21,989,399,399,798,"21 de agosto de 1994"
8,6,21,990,315,311,626,"21 de agosto de 1994"
8,6,21,991,465,514,979,"21 de agosto de 1994"
8,6,21,992,289,319,608,"21 de agosto de 1994"
8,6,21,993,240,241,481,"21 de agosto de 1994"
8,6,21,994,319,317,636,"21 de agosto de 1994"
8,6,21,995,278,311,589,"21 de agosto de 1994"
8,6,21,996,284,285,569,"21 de agosto de 1994"
8,6,21,997,258,274,532,"21 de agosto de 1994"
8,6,21,998,137,139,276,"21 de agosto de 1994"
8,6,21,999,174,232,406,"21 de agosto de 1994"
8,6,21,1000,328,343,671,"21 de agosto de 1994"
8,6,21,1001,716,779,1495,"21 de agosto de 1994"
8,6,21,1002,327,363,690,"21 de agosto de 1994"
8,6,21,1003,196,226,422,"21 de agosto de 1994"
8,6,21,1004,204,225,429,"21 de agosto de 1994"
8,6,21,1005,136,158,294,"21 de agosto de 1994"
8,6,21,1006,401,402,803,"21 de agosto de 1994"
8,6,21,1007,194,222,416,"21 de agosto de 1994"
8,6,21,1008,292,321,613,"21 de agosto de 1994"
8,6,21,1009,189,185,374,"21 de agosto de 1994"
8,6,21,1010,112,107,219,"21 de agosto de 1994"
8,6,21,1011,248,246,494,"21 de agosto de 1994"
8,6,21,1012,102,104,206,"21 de agosto de 1994"
8,6,21,1013,272,276,548,"21 de agosto de 1994"
8,6,21,1014,75,79,154,"21 de agosto de 1994"
8,6,21,1015,301,278,579,"21 de agosto de 1994"
8,6,21,1016,233,224,457,"21 de agosto de 1994"
8,6,21,1017,91,92,183,"21 de agosto de 1994"
8,6,21,1018,183,162,345,"21 de agosto de 1994"
8,6,21,1019,168,150,318,"21 de agosto de 1994"
8,6,21,1020,394,362,756,"21 de agosto de 1994"
8,6,21,1021,195,190,385,"21 de agosto de 1994"
8,6,21,1022,91,91,182,"21 de agosto de 1994"
8,6,21,1023,374,356,730,"21 de agosto de 1994"
8,6,21,1024,454,446,900,"21 de agosto de 1994"
8,6,21,1025,65,52,117,"21 de agosto de 1994"
8,6,21,1026,362,193,555,"21 de agosto de 1994"
8,6,21,1027,238,208,446,"21 de agosto de 1994"
8,6,21,1028,259,227,486,"21 de agosto de 1994"
8,6,21,1029,229,198,427,"21 de agosto de 1994"
8,6,21,1030,412,393,805,"21 de agosto de 1994"
8,6,36,1387,263,247,510,"21 de agosto de 1994"
8,6,36,1388,271,278,549,"21 de agosto de 1994"
8,6,36,1389,404,394,798,"21 de agosto de 1994"
8,6,36,1390,400,428,828,"21 de agosto de 1994"
8,6,36,1391,310,339,649,"21 de agosto de 1994"
8,6,36,1392,228,232,460,"21 de agosto de 1994"
8,6,36,1393,360,366,726,"21 de agosto de 1994"
8,6,36,1394,222,247,469,"21 de agosto de 1994"
8,6,36,1395,392,419,811,"21 de agosto de 1994"
8,6,36,1396,332,353,685,"21 de agosto de 1994"
8,6,36,1397,275,253,528,"21 de agosto de 1994"
8,6,36,1398,491,542,1033,"21 de agosto de 1994"
8,6,36,1399,442,474,916,"21 de agosto de 1994"
8,6,36,1400,431,492,923,"21 de agosto de 1994"
8,6,36,1401,270,284,554,"21 de agosto de 1994"
8,6,36,1402,332,318,650,"21 de agosto de 1994"
8,6,36,1403,321,340,661,"21 de agosto de 1994"
8,6,36,1404,235,282,517,"21 de agosto de 1994"
8,6,36,1405,163,183,346,"21 de agosto de 1994"
8,6,36,1406,516,547,1063,"21 de agosto de 1994"
8,6,36,1407,419,399,818,"21 de agosto de 1994"
8,6,36,1408,220,247,467,"21 de agosto de 1994"
8,6,36,1409,261,245,506,"21 de agosto de 1994"
8,6,36,1410,242,234,476,"21 de agosto de 1994"
8,6,36,1411,326,352,678,"21 de agosto de 1994"
8,6,36,1412,291,335,626,"21 de agosto de 1994"
8,6,36,1413,306,231,537,"21 de agosto de 1994"
8,6,36,1414,210,187,397,"21 de agosto de 1994"
8,6,36,1415,237,224,461,"21 de agosto de 1994"
8,6,36,1416,238,191,429,"21 de agosto de 1994"
8,6,36,1417,185,144,329,"21 de agosto de 1994"
8,6,36,1418,286,195,481,"21 de agosto de 1994"
8,6,36,1419,311,283,594,"21 de agosto de 1994"
8,6,36,1420,48,20,68,"21 de agosto de 1994"
8,6,36,1421,297,192,489,"21 de agosto de 1994"
8,6,36,1422,179,168,347,"21 de agosto de 1994"
8,6,36,1423,152,138,290,"21 de agosto de 1994"
8,6,42,2266,229,208,437,"21 de agosto de 1994"
8,6,42,2267,203,159,362,"21 de agosto de 1994"
8,6,42,2268,187,147,334,"21 de agosto de 1994"
8,6,42,2269,98,85,183,"21 de agosto de 1994"
8,6,42,2270,174,150,324,"21 de agosto de 1994"
8,6,52,2477,348,375,723,"21 de agosto de 1994"
8,6,52,2478,186,196,382,"21 de agosto de 1994"
8,6,52,2479,343,381,724,"21 de agosto de 1994"
8,6,52,2480,277,291,568,"21 de agosto de 1994"
8,6,52,2481,422,458,880,"21 de agosto de 1994"
8,6,52,2482,252,255,507,"21 de agosto de 1994"
8,6,52,2483,275,328,603,"21 de agosto de 1994"
8,6,52,2484,235,235,470,"21 de agosto de 1994"
8,6,52,2485,297,292,589,"21 de agosto de 1994"
8,6,52,2486,339,371,710,"21 de agosto de 1994"
8,6,52,2487,324,376,700,"21 de agosto de 1994"
8,6,52,2488,290,292,582,"21 de agosto de 1994"
8,6,52,2489,269,300,569,"21 de agosto de 1994"
8,6,52,2490,289,314,603,"21 de agosto de 1994"
8,6,52,2491,288,282,570,"21 de agosto de 1994"
8,6,52,2492,353,375,728,"21 de agosto de 1994"
8,6,52,2493,422,443,865,"21 de agosto de 1994"
8,6,52,2494,42,28,70,"21 de agosto de 1994"
8,6,52,2495,81,65,146,"21 de agosto de 1994"
8,6,52,2496,64,58,122,"21 de agosto de 1994"
8,6,52,2497,80,64,144,"21 de agosto de 1994"
8,6,52,2498,160,119,279,"21 de agosto de 1994"
8,6,52,2499,177,148,325,"21 de agosto de 1994"
8,6,52,2500,275,234,509,"21 de agosto de 1994"
8,6,52,2501,183,172,355,"21 de agosto de 1994"
8,6,52,2502,30,19,49,"21 de agosto de 1994"
8,6,52,2503,88,64,152,"21 de agosto de 1994"
8,6,52,2504,221,186,407,"21 de agosto de 1994"
8,6,52,2505,174,132,306,"21 de agosto de 1994"
8,6,52,2506,51,37,88,"21 de agosto de 1994"
8,6,52,2507,116,94,210,"21 de agosto de 1994"
8,6,52,2508,104,88,192,"21 de agosto de 1994"
8,6,62,2615,389,360,749,"21 de agosto de 1994"
8,6,62,2616,308,301,609,"21 de agosto de 1994"
8,6,62,2617,184,172,356,"21 de agosto de 1994"
8,6,62,2618,170,177,347,"21 de agosto de 1994"
8,6,62,2619,289,253,542,"21 de agosto de 1994"
8,6,62,2620,495,514,1009,"21 de agosto de 1994"
8,6,62,2621,224,281,505,"21 de agosto de 1994"
8,6,62,2622,298,317,615,"21 de agosto de 1994"
8,6,62,2623,310,329,639,"21 de agosto de 1994"
8,6,62,2624,337,342,679,"21 de agosto de 1994"
8,6,62,2625,253,270,523,"21 de agosto de 1994"
8,6,62,2626,325,316,641,"21 de agosto de 1994"
8,6,62,2627,433,391,824,"21 de agosto de 1994"
8,6,62,2628,389,383,772,"21 de agosto de 1994"
8,6,62,2629,235,187,422,"21 de agosto de 1994"
8,6,62,2630,173,175,348,"21 de agosto de 1994"
8,6,62,2631,249,239,488,"21 de agosto de 1994"
8,6,62,2632,301,310,611,"21 de agosto de 1994"
8,6,62,2633,263,240,503,"21 de agosto de 1994"
8,6,62,2634,376,333,709,"21 de agosto de 1994"
8,6,62,2635,315,303,618,"21 de agosto de 1994"
8,6,62,2636,388,397,785,"21 de agosto de 1994"
8,6,62,2637,221,204,425,"21 de agosto de 1994"
8,6,62,2638,368,361,729,"21 de agosto de 1994"
8,6,62,2639,289,236,525,"21 de agosto de 1994"
8,6,62,2640,393,373,766,"21 de agosto de 1994"
8,6,62,2641,249,234,483,"21 de agosto de 1994"
8,6,62,2642,177,159,336,"21 de agosto de 1994"
8,6,62,2643,281,276,557,"21 de agosto de 1994"
8,6,62,2644,236,205,441,"21 de agosto de 1994"
8,6,62,2645,181,173,354,"21 de agosto de 1994"
8,6,62,2646,178,180,358,"21 de agosto de 1994"
8,6,62,2647,308,151,459,"21 de agosto de 1994"
8,7,2,17,375,387,762,"21 de agosto de 1994"
8,7,2,18,387,390,777,"21 de agosto de 1994"
8,7,2,19,300,311,611,"21 de agosto de 1994"
8,7,2,20,455,466,921,"21 de agosto de 1994"
8,7,2,21,331,349,680,"21 de agosto de 1994"
8,7,2,22,402,404,806,"21 de agosto de 1994"
8,7,2,23,428,475,903,"21 de agosto de 1994"
8,7,2,24,361,409,770,"21 de agosto de 1994"
8,7,2,25,246,259,505,"21 de agosto de 1994"
8,7,2,26,256,287,543,"21 de agosto de 1994"
8,7,2,27,405,432,837,"21 de agosto de 1994"
8,7,2,28,351,373,724,"21 de agosto de 1994"
8,7,2,29,39,26,65,"21 de agosto de 1994"
8,7,2,30,157,118,275,"21 de agosto de 1994"
8,7,2,31,117,101,218,"21 de agosto de 1994"
8,7,2,32,204,179,383,"21 de agosto de 1994"
8,7,2,33,95,59,154,"21 de agosto de 1994"
8,7,2,34,474,408,882,"21 de agosto de 1994"
8,7,2,35,144,105,249,"21 de agosto de 1994"
8,7,2,36,101,67,168,"21 de agosto de 1994"
8,7,2,37,99,61,160,"21 de agosto de 1994"
8,7,4,56,631,586,1217,"21 de agosto de 1994"
8,7,4,57,232,210,442,"21 de agosto de 1994"
8,7,4,58,99,69,168,"21 de agosto de 1994"
8,7,4,59,221,215,436,"21 de agosto de 1994"
8,7,19,608,365,372,737,"21 de agosto de 1994"
8,7,19,609,72,54,126,"21 de agosto de 1994"
8,7,19,610,911,1008,1919,"21 de agosto de 1994"
8,7,19,611,462,431,893,"21 de agosto de 1994"
8,7,19,612,347,370,717,"21 de agosto de 1994"
8,7,19,613,498,547,1045,"21 de agosto de 1994"
8,7,19,614,379,410,789,"21 de agosto de 1994"
8,7,19,615,250,254,504,"21 de agosto de 1994"
8,7,19,616,414,421,835,"21 de agosto de 1994"
8,7,19,617,431,428,859,"21 de agosto de 1994"
8,7,19,618,192,229,421,"21 de agosto de 1994"
8,7,19,619,226,243,469,"21 de agosto de 1994"
8,7,19,620,289,326,615,"21 de agosto de 1994"
8,7,19,621,590,590,1180,"21 de agosto de 1994"
8,7,19,622,140,178,318,"21 de agosto de 1994"
8,7,19,623,323,377,700,"21 de agosto de 1994"
8,7,19,624,266,356,622,"21 de agosto de 1994"
8,7,19,625,181,186,367,"21 de agosto de 1994"
8,7,19,626,386,399,785,"21 de agosto de 1994"
8,7,19,627,287,321,608,"21 de agosto de 1994"
8,7,19,628,227,231,458,"21 de agosto de 1994"
8,7,19,629,224,251,475,"21 de agosto de 1994"
8,7,19,630,225,227,452,"21 de agosto de 1994"
8,7,19,631,236,287,523,"21 de agosto de 1994"
8,7,19,632,227,254,481,"21 de agosto de 1994"
8,7,19,633,452,469,921,"21 de agosto de 1994"
8,7,19,634,186,211,397,"21 de agosto de 1994"
8,7,19,635,161,178,339,"21 de agosto de 1994"
8,7,19,636,263,287,550,"21 de agosto de 1994"
8,7,19,637,272,270,542,"21 de agosto de 1994"
8,7,19,638,263,261,524,"21 de agosto de 1994"
8,7,19,639,138,146,284,"21 de agosto de 1994"
8,7,19,640,272,285,557,"21 de agosto de 1994"
8,7,19,641,837,945,1782,"21 de agosto de 1994"
8,7,19,642,249,274,523,"21 de agosto de 1994"
8,7,19,643,243,275,518,"21 de agosto de 1994"
8,7,19,644,261,278,539,"21 de agosto de 1994"
8,7,19,645,223,248,471,"21 de agosto de 1994"
8,7,19,646,411,456,867,"21 de agosto de 1994"
8,7,19,647,461,482,943,"21 de agosto de 1994"
8,7,19,648,293,321,614,"21 de agosto de 1994"
8,7,19,649,411,419,830,"21 de agosto de 1994"
8,7,19,650,314,299,613,"21 de agosto de 1994"
8,7,19,651,393,426,819,"21 de agosto de 1994"
8,7,19,652,279,293,572,"21 de agosto de 1994"
8,7,19,653,348,402,750,"21 de agosto de 1994"
8,7,19,654,282,323,605,"21 de agosto de 1994"
8,7,19,655,224,271,495,"21 de agosto de 1994"
8,7,19,656,218,246,464,"21 de agosto de 1994"
8,7,19,657,311,389,700,"21 de agosto de 1994"
8,7,19,658,266,288,554,"21 de agosto de 1994"
8,7,19,659,241,303,544,"21 de agosto de 1994"
8,7,19,660,311,323,634,"21 de agosto de 1994"
8,7,19,661,664,728,1392,"21 de agosto de 1994"
8,7,19,662,317,337,654,"21 de agosto de 1994"
8,7,19,663,290,310,600,"21 de agosto de 1994"
8,7,19,664,285,291,576,"21 de agosto de 1994"
8,7,19,665,203,229,432,"21 de agosto de 1994"
8,7,19,666,372,400,772,"21 de agosto de 1994"
8,7,19,667,255,259,514,"21 de agosto de 1994"
8,7,19,668,438,447,885,"21 de agosto de 1994"
8,7,19,669,618,644,1262,"21 de agosto de 1994"
8,7,19,670,27,23,50,"21 de agosto de 1994"
8,7,19,671,543,566,1109,"21 de agosto de 1994"
8,7,19,672,352,358,710,"21 de agosto de 1994"
8,7,19,673,353,344,697,"21 de agosto de 1994"
8,7,19,674,531,578,1109,"21 de agosto de 1994"
8,7,19,675,267,291,558,"21 de agosto de 1994"
8,7,19,676,312,349,661,"21 de agosto de 1994"
8,7,19,677,338,374,712,"21 de agosto de 1994"
8,7,19,678,302,346,648,"21 de agosto de 1994"
8,7,19,679,395,472,867,"21 de agosto de 1994"
8,7,19,680,337,392,729,"21 de agosto de 1994"
8,7,19,681,309,344,653,"21 de agosto de 1994"
8,7,19,682,257,300,557,"21 de agosto de 1994"
8,7,19,683,352,356,708,"21 de agosto de 1994"
8,7,19,684,449,491,940,"21 de agosto de 1994"
8,7,19,685,280,321,601,"21 de agosto de 1994"
8,7,19,686,362,419,781,"21 de agosto de 1994"
8,7,19,687,324,390,714,"21 de agosto de 1994"
8,7,19,688,462,514,976,"21 de agosto de 1994"
8,7,19,689,539,548,1087,"21 de agosto de 1994"
8,7,19,690,456,461,917,"21 de agosto de 1994"
8,7,19,691,304,339,643,"21 de agosto de 1994"
8,7,19,692,517,598,1115,"21 de agosto de 1994"
8,7,19,693,328,347,675,"21 de agosto de 1994"
8,7,19,694,209,269,478,"21 de agosto de 1994"
8,7,19,695,517,588,1105,"21 de agosto de 1994"
8,7,19,696,583,651,1234,"21 de agosto de 1994"
8,7,19,697,572,626,1198,"21 de agosto de 1994"
8,7,19,698,237,281,518,"21 de agosto de 1994"
8,7,19,699,317,352,669,"21 de agosto de 1994"
8,7,19,700,295,341,636,"21 de agosto de 1994"
8,7,19,701,169,199,368,"21 de agosto de 1994"
8,7,19,702,241,251,492,"21 de agosto de 1994"
8,7,19,703,431,481,912,"21 de agosto de 1994"
8,7,19,704,375,412,787,"21 de agosto de 1994"
8,7,19,705,487,546,1033,"21 de agosto de 1994"
8,7,19,706,298,296,594,"21 de agosto de 1994"
8,7,19,707,325,389,714,"21 de agosto de 1994"
8,7,19,708,300,354,654,"21 de agosto de 1994"
8,7,19,709,370,402,772,"21 de agosto de 1994"
8,7,19,710,477,524,1001,"21 de agosto de 1994"
8,7,19,711,71,75,146,"21 de agosto de 1994"
8,7,19,712,387,403,790,"21 de agosto de 1994"
8,7,19,713,398,426,824,"21 de agosto de 1994"
8,7,19,714,509,547,1056,"21 de agosto de 1994"
8,7,19,715,213,251,464,"21 de agosto de 1994"
8,7,19,716,328,367,695,"21 de agosto de 1994"
8,7,19,717,369,403,772,"21 de agosto de 1994"
8,7,19,718,787,940,1727,"21 de agosto de 1994"
8,7,19,719,434,473,907,"21 de agosto de 1994"
8,7,19,720,657,712,1369,"21 de agosto de 1994"
8,7,19,721,342,378,720,"21 de agosto de 1994"
8,7,19,722,300,348,648,"21 de agosto de 1994"
8,7,19,723,332,371,703,"21 de agosto de 1994"
8,7,19,724,311,372,683,"21 de agosto de 1994"
8,7,19,725,433,479,912,"21 de agosto de 1994"
8,7,19,726,372,481,853,"21 de agosto de 1994"
8,7,19,727,197,225,422,"21 de agosto de 1994"
8,7,19,728,200,232,432,"21 de agosto de 1994"
8,7,19,729,168,213,381,"21 de agosto de 1994"
8,7,19,730,273,317,590,"21 de agosto de 1994"
8,7,19,731,205,252,457,"21 de agosto de 1994"
8,7,19,732,197,223,420,"21 de agosto de 1994"
8,7,19,733,194,223,417,"21 de agosto de 1994"
8,7,19,734,422,482,904,"21 de agosto de 1994"
8,7,19,735,238,275,513,"21 de agosto de 1994"
8,7,19,736,381,456,837,"21 de agosto de 1994"
8,7,19,737,310,332,642,"21 de agosto de 1994"
8,7,19,738,251,284,535,"21 de agosto de 1994"
8,7,19,739,251,268,519,"21 de agosto de 1994"
8,7,19,740,483,554,1037,"21 de agosto de 1994"
8,7,19,741,316,321,637,"21 de agosto de 1994"
8,7,19,742,218,276,494,"21 de agosto de 1994"
8,7,19,743,329,364,693,"21 de agosto de 1994"
8,7,19,744,314,385,699,"21 de agosto de 1994"
8,7,19,745,463,503,966,"21 de agosto de 1994"
8,7,19,746,411,459,870,"21 de agosto de 1994"
8,7,19,747,260,292,552,"21 de agosto de 1994"
8,7,19,748,360,388,748,"21 de agosto de 1994"
8,7,19,749,203,243,446,"21 de agosto de 1994"
8,7,19,750,222,247,469,"21 de agosto de 1994"
8,7,19,751,210,236,446,"21 de agosto de 1994"
8,7,19,752,220,256,476,"21 de agosto de 1994"
8,7,19,753,305,356,661,"21 de agosto de 1994"
8,7,19,754,268,324,592,"21 de agosto de 1994"
8,7,19,755,127,154,281,"21 de agosto de 1994"
8,7,19,756,348,392,740,"21 de agosto de 1994"
8,7,19,757,326,392,718,"21 de agosto de 1994"
8,7,19,758,285,341,626,"21 de agosto de 1994"
8,7,19,759,357,417,774,"21 de agosto de 1994"
8,7,19,760,448,538,986,"21 de agosto de 1994"
8,7,19,761,439,484,923,"21 de agosto de 1994"
8,7,19,762,388,447,835,"21 de agosto de 1994"
8,7,19,763,409,484,893,"21 de agosto de 1994"
8,7,19,764,333,420,753,"21 de agosto de 1994"
8,7,19,765,233,269,502,"21 de agosto de 1994"
8,7,19,766,301,372,673,"21 de agosto de 1994"
8,7,19,767,385,457,842,"21 de agosto de 1994"
8,7,19,768,356,373,729,"21 de agosto de 1994"
8,7,19,769,333,372,705,"21 de agosto de 1994"
8,7,19,770,285,364,649,"21 de agosto de 1994"
8,7,19,771,487,565,1052,"21 de agosto de 1994"
8,7,19,772,467,522,989,"21 de agosto de 1994"
8,7,19,773,446,499,945,"21 de agosto de 1994"
8,7,19,774,405,470,875,"21 de agosto de 1994"
8,7,19,775,444,530,974,"21 de agosto de 1994"
8,7,19,776,138,139,277,"21 de agosto de 1994"
8,7,19,777,470,536,1006,"21 de agosto de 1994"
8,7,19,778,519,637,1156,"21 de agosto de 1994"
8,7,19,779,516,608,1124,"21 de agosto de 1994"
8,7,19,780,358,427,785,"21 de agosto de 1994"
8,7,19,781,295,337,632,"21 de agosto de 1994"
8,7,19,782,416,542,958,"21 de agosto de 1994"
8,7,19,783,304,346,650,"21 de agosto de 1994"
8,7,19,784,298,373,671,"21 de agosto de 1994"
8,7,19,785,328,379,707,"21 de agosto de 1994"
8,7,19,786,259,255,514,"21 de agosto de 1994"
8,7,19,787,548,609,1157,"21 de agosto de 1994"
8,7,19,788,381,399,780,"21 de agosto de 1994"
8,7,19,789,317,388,705,"21 de agosto de 1994"
8,7,19,790,282,291,573,"21 de agosto de 1994"
8,7,19,791,333,363,696,"21 de agosto de 1994"
8,7,19,792,610,688,1298,"21 de agosto de 1994"
8,7,19,793,461,525,986,"21 de agosto de 1994"
8,7,19,794,216,260,476,"21 de agosto de 1994"
8,7,19,795,465,557,1022,"21 de agosto de 1994"
8,7,19,796,236,319,555,"21 de agosto de 1994"
8,7,19,797,324,404,728,"21 de agosto de 1994"
8,7,19,798,311,357,668,"21 de agosto de 1994"
8,7,19,799,260,327,587,"21 de agosto de 1994"
8,7,19,800,413,516,929,"21 de agosto de 1994"
8,7,19,801,468,530,998,"21 de agosto de 1994"
8,7,19,802,139,179,318,"21 de agosto de 1994"
8,7,19,803,273,255,528,"21 de agosto de 1994"
8,7,19,804,365,386,751,"21 de agosto de 1994"
8,7,19,805,614,684,1298,"21 de agosto de 1994"
8,7,19,806,355,424,779,"21 de agosto de 1994"
8,7,19,807,422,538,960,"21 de agosto de 1994"
8,7,19,808,454,574,1028,"21 de agosto de 1994"
8,7,19,809,401,494,895,"21 de agosto de 1994"
8,7,19,810,430,468,898,"21 de agosto de 1994"
8,7,19,811,195,203,398,"21 de agosto de 1994"
8,7,19,812,277,296,573,"21 de agosto de 1994"
8,7,19,813,399,443,842,"21 de agosto de 1994"
8,7,19,814,362,378,740,"21 de agosto de 1994"
8,7,19,815,290,314,604,"21 de agosto de 1994"
8,7,19,816,311,395,706,"21 de agosto de 1994"
8,7,19,817,467,575,1042,"21 de agosto de 1994"
8,7,19,818,363,378,741,"21 de agosto de 1994"
8,7,19,819,482,525,1007,"21 de agosto de 1994"
8,7,19,820,236,276,512,"21 de agosto de 1994"
8,7,19,821,159,165,324,"21 de agosto de 1994"
8,7,19,822,223,275,498,"21 de agosto de 1994"
8,7,19,823,454,525,979,"21 de agosto de 1994"
8,7,19,824,261,310,571,"21 de agosto de 1994"
8,7,19,825,336,400,736,"21 de agosto de 1994"
8,7,19,826,516,682,1198,"21 de agosto de 1994"
8,7,19,827,379,433,812,"21 de agosto de 1994"
8,7,19,828,348,355,703,"21 de agosto de 1994"
8,7,19,829,451,456,907,"21 de agosto de 1994"
8,7,19,830,268,304,572,"21 de agosto de 1994"
8,7,19,831,255,304,559,"21 de agosto de 1994"
8,7,19,832,316,318,634,"21 de agosto de 1994"
8,7,19,833,303,343,646,"21 de agosto de 1994"
8,7,19,834,204,250,454,"21 de agosto de 1994"
8,7,19,835,215,244,459,"21 de agosto de 1994"
8,7,19,836,323,413,736,"21 de agosto de 1994"
8,7,19,837,343,398,741,"21 de agosto de 1994"
8,7,19,838,427,466,893,"21 de agosto de 1994"
8,7,19,839,466,555,1021,"21 de agosto de 1994"
8,7,19,840,425,455,880,"21 de agosto de 1994"
8,7,19,841,378,395,773,"21 de agosto de 1994"
8,7,19,842,372,432,804,"21 de agosto de 1994"
8,7,19,843,161,215,376,"21 de agosto de 1994"
8,7,19,844,321,356,677,"21 de agosto de 1994"
8,7,19,845,382,431,813,"21 de agosto de 1994"
8,7,19,846,276,328,604,"21 de agosto de 1994"
8,7,19,847,233,315,548,"21 de agosto de 1994"
8,7,19,848,276,276,552,"21 de agosto de 1994"
8,7,19,849,380,379,759,"21 de agosto de 1994"
8,7,19,850,234,270,504,"21 de agosto de 1994"
8,7,19,851,279,282,561,"21 de agosto de 1994"
8,7,19,852,197,168,365,"21 de agosto de 1994"
8,7,19,853,132,133,265,"21 de agosto de 1994"
8,7,19,854,204,201,405,"21 de agosto de 1994"
8,7,19,855,95,82,177,"21 de agosto de 1994"
8,7,19,856,60,60,120,"21 de agosto de 1994"
8,7,19,857,243,287,530,"21 de agosto de 1994"
8,7,19,858,341,394,735,"21 de agosto de 1994"
8,7,19,859,226,215,441,"21 de agosto de 1994"
8,7,19,860,344,364,708,"21 de agosto de 1994"
8,7,19,861,233,238,471,"21 de agosto de 1994"
8,7,19,862,427,444,871,"21 de agosto de 1994"
8,7,19,863,427,520,947,"21 de agosto de 1994"
8,7,19,864,228,231,459,"21 de agosto de 1994"
8,7,19,865,379,405,784,"21 de agosto de 1994"
8,7,19,866,184,194,378,"21 de agosto de 1994"
8,7,19,867,385,449,834,"21 de agosto de 1994"
8,7,19,868,435,466,901,"21 de agosto de 1994"
8,7,19,869,478,477,955,"21 de agosto de 1994"
8,7,19,870,561,574,1135,"21 de agosto de 1994"
8,7,19,871,647,654,1301,"21 de agosto de 1994"
8,7,19,872,500,554,1054,"21 de agosto de 1994"
8,7,19,873,492,545,1037,"21 de agosto de 1994"
8,7,19,874,496,545,1041,"21 de agosto de 1994"
8,7,19,875,457,501,958,"21 de agosto de 1994"
8,7,19,876,603,646,1249,"21 de agosto de 1994"
8,7,19,877,264,289,553,"21 de agosto de 1994"
8,7,19,878,254,295,549,"21 de agosto de 1994"
8,7,19,879,235,235,470,"21 de agosto de 1994"
8,7,19,880,453,515,968,"21 de agosto de 1994"
8,7,19,881,282,281,563,"21 de agosto de 1994"
8,7,19,882,228,217,445,"21 de agosto de 1994"
8,7,19,883,327,351,678,"21 de agosto de 1994"
8,7,19,884,238,258,496,"21 de agosto de 1994"
8,7,19,885,319,338,657,"21 de agosto de 1994"
8,7,19,886,142,104,246,"21 de agosto de 1994"
8,7,19,887,156,113,269,"21 de agosto de 1994"
8,7,19,888,54,36,90,"21 de agosto de 1994"
8,7,19,889,329,337,666,"21 de agosto de 1994"
8,7,19,890,266,216,482,"21 de agosto de 1994"
8,7,19,891,283,217,500,"21 de agosto de 1994"
8,7,19,892,59,52,111,"21 de agosto de 1994"
8,7,19,893,243,164,407,"21 de agosto de 1994"
8,7,19,894,240,186,426,"21 de agosto de 1994"
8,7,19,895,377,297,674,"21 de agosto de 1994"
8,7,19,896,244,232,476,"21 de agosto de 1994"
8,7,19,897,116,93,209,"21 de agosto de 1994"
8,7,19,898,259,174,433,"21 de agosto de 1994"
8,7,19,899,158,133,291,"21 de agosto de 1994"
8,7,19,900,73,47,120,"21 de agosto de 1994"
8,7,19,901,121,100,221,"21 de agosto de 1994"
8,7,19,902,122,82,204,"21 de agosto de 1994"
8,7,19,903,178,151,329,"21 de agosto de 1994"
8,7,19,904,126,115,241,"21 de agosto de 1994"
8,7,19,905,284,264,548,"21 de agosto de 1994"
8,7,19,906,271,340,611,"21 de agosto de 1994"
8,7,19,907,916,994,1910,"21 de agosto de 1994"
8,7,19,908,106,113,219,"21 de agosto de 1994"
8,7,19,909,39,26,65,"21 de agosto de 1994"
8,7,19,910,379,444,823,"21 de agosto de 1994"
8,7,19,911,198,222,420,"21 de agosto de 1994"
8,7,24,1046,322,353,675,"21 de agosto de 1994"
8,7,24,1047,432,361,793,"21 de agosto de 1994"
8,7,24,1048,220,208,428,"21 de agosto de 1994"
8,7,24,1049,153,151,304,"21 de agosto de 1994"
8,7,24,1050,306,231,537,"21 de agosto de 1994"
8,7,24,1051,118,90,208,"21 de agosto de 1994"
8,7,24,1052,126,138,264,"21 de agosto de 1994"
8,7,38,2199,290,268,558,"21 de agosto de 1994"
8,7,38,2200,349,324,673,"21 de agosto de 1994"
8,7,38,2201,223,183,406,"21 de agosto de 1994"
8,7,38,2202,45,26,71,"21 de agosto de 1994"
8,7,38,2203,440,420,860,"21 de agosto de 1994"
8,7,38,2204,215,219,434,"21 de agosto de 1994"
8,7,38,2205,228,232,460,"21 de agosto de 1994"
8,7,45,2288,261,282,543,"21 de agosto de 1994"
8,7,45,2289,340,333,673,"21 de agosto de 1994"
8,7,45,2290,356,356,712,"21 de agosto de 1994"
8,7,45,2291,229,240,469,"21 de agosto de 1994"
8,7,45,2292,339,350,689,"21 de agosto de 1994"
8,7,45,2293,289,300,589,"21 de agosto de 1994"
8,7,45,2294,478,468,946,"21 de agosto de 1994"
8,7,45,2295,269,309,578,"21 de agosto de 1994"
8,7,45,2296,389,425,814,"21 de agosto de 1994"
8,7,45,2297,384,395,779,"21 de agosto de 1994"
8,7,45,2298,295,311,606,"21 de agosto de 1994"
8,7,45,2299,363,362,725,"21 de agosto de 1994"
8,7,45,2300,422,473,895,"21 de agosto de 1994"
8,7,45,2301,428,420,848,"21 de agosto de 1994"
8,7,45,2302,472,417,889,"21 de agosto de 1994"
8,7,45,2303,279,268,547,"21 de agosto de 1994"
8,7,45,2304,319,285,604,"21 de agosto de 1994"
8,7,45,2305,434,439,873,"21 de agosto de 1994"
8,7,45,2306,253,248,501,"21 de agosto de 1994"
8,7,45,2307,218,212,430,"21 de agosto de 1994"
8,7,45,2308,278,267,545,"21 de agosto de 1994"
8,7,45,2309,272,281,553,"21 de agosto de 1994"
8,7,45,2310,143,139,282,"21 de agosto de 1994"
8,7,45,2311,337,321,658,"21 de agosto de 1994"
8,7,45,2312,306,277,583,"21 de agosto de 1994"
8,7,45,2313,127,130,257,"21 de agosto de 1994"
8,7,45,2314,546,513,1059,"21 de agosto de 1994"
8,7,45,2315,318,264,582,"21 de agosto de 1994"
8,7,45,2316,342,299,641,"21 de agosto de 1994"
8,7,45,2317,190,202,392,"21 de agosto de 1994"
8,7,45,2318,200,194,394,"21 de agosto de 1994"
8,7,45,2319,367,386,753,"21 de agosto de 1994"
8,7,45,2320,155,155,310,"21 de agosto de 1994"
8,7,45,2321,554,537,1091,"21 de agosto de 1994"
8,7,45,2322,413,340,753,"21 de agosto de 1994"
8,8,37,1951,289,322,611,"21 de agosto de 1994"
8,8,37,1952,232,193,425,"21 de agosto de 1994"
8,8,37,1953,216,235,451,"21 de agosto de 1994"
8,8,37,1954,199,238,437,"21 de agosto de 1994"
8,8,37,1955,317,349,666,"21 de agosto de 1994"
8,8,37,1956,262,287,549,"21 de agosto de 1994"
8,8,37,1957,167,188,355,"21 de agosto de 1994"
8,8,37,1958,188,256,444,"21 de agosto de 1994"
8,8,37,1959,206,248,454,"21 de agosto de 1994"
8,8,37,1960,214,260,474,"21 de agosto de 1994"
8,8,37,1961,239,279,518,"21 de agosto de 1994"
8,8,37,1962,208,237,445,"21 de agosto de 1994"
8,8,37,1963,162,189,351,"21 de agosto de 1994"
8,8,37,1964,191,231,422,"21 de agosto de 1994"
8,8,37,1965,239,235,474,"21 de agosto de 1994"
8,8,37,1966,165,209,374,"21 de agosto de 1994"
8,8,37,1967,236,234,470,"21 de agosto de 1994"
8,8,37,1968,273,291,564,"21 de agosto de 1994"
8,8,37,1969,209,245,454,"21 de agosto de 1994"
8,8,37,1970,153,186,339,"21 de agosto de 1994"
8,8,37,1971,268,311,579,"21 de agosto de 1994"
8,8,37,1972,248,287,535,"21 de agosto de 1994"
8,8,37,1973,251,258,509,"21 de agosto de 1994"
8,8,37,1974,421,491,912,"21 de agosto de 1994"
8,8,37,1975,269,256,525,"21 de agosto de 1994"
8,8,37,1976,345,344,689,"21 de agosto de 1994"
8,8,37,1977,230,271,501,"21 de agosto de 1994"
8,8,37,1978,441,463,904,"21 de agosto de 1994"
8,8,37,1979,353,371,724,"21 de agosto de 1994"
8,8,37,1980,201,236,437,"21 de agosto de 1994"
8,8,37,1981,279,259,538,"21 de agosto de 1994"
8,8,37,1982,242,257,499,"21 de agosto de 1994"
8,8,37,1983,241,267,508,"21 de agosto de 1994"
8,8,37,1984,246,280,526,"21 de agosto de 1994"
8,8,37,1985,284,322,606,"21 de agosto de 1994"
8,8,37,1986,464,513,977,"21 de agosto de 1994"
8,8,37,1987,373,394,767,"21 de agosto de 1994"
8,8,37,1988,364,383,747,"21 de agosto de 1994"
8,8,37,1989,259,314,573,"21 de agosto de 1994"
8,8,37,1990,315,309,624,"21 de agosto de 1994"
8,8,37,1991,333,343,676,"21 de agosto de 1994"
8,8,37,1992,369,429,798,"21 de agosto de 1994"
8,8,37,1993,353,424,777,"21 de agosto de 1994"
8,8,37,1994,412,475,887,"21 de agosto de 1994"
8,8,37,1995,279,361,640,"21 de agosto de 1994"
8,8,37,1996,262,298,560,"21 de agosto de 1994"
8,8,37,1997,238,278,516,"21 de agosto de 1994"
8,8,37,1998,197,250,447,"21 de agosto de 1994"
8,8,37,1999,222,254,476,"21 de agosto de 1994"
8,8,37,2000,449,435,884,"21 de agosto de 1994"
8,8,37,2001,339,356,695,"21 de agosto de 1994"
8,8,37,2002,296,362,658,"21 de agosto de 1994"
8,8,37,2003,304,324,628,"21 de agosto de 1994"
8,8,37,2004,221,244,465,"21 de agosto de 1994"
8,8,37,2005,229,247,476,"21 de agosto de 1994"
8,8,37,2006,208,237,445,"21 de agosto de 1994"
8,8,37,2007,263,308,571,"21 de agosto de 1994"
8,8,37,2008,368,355,723,"21 de agosto de 1994"
8,8,37,2009,268,288,556,"21 de agosto de 1994"
8,8,37,2010,378,392,770,"21 de agosto de 1994"
8,8,37,2011,265,270,535,"21 de agosto de 1994"
8,8,37,2012,348,428,776,"21 de agosto de 1994"
8,8,37,2013,355,360,715,"21 de agosto de 1994"
8,8,37,2014,364,400,764,"21 de agosto de 1994"
8,8,37,2015,287,307,594,"21 de agosto de 1994"
8,8,37,2016,257,296,553,"21 de agosto de 1994"
8,8,37,2017,382,387,769,"21 de agosto de 1994"
8,8,37,2018,327,300,627,"21 de agosto de 1994"
8,8,37,2019,395,410,805,"21 de agosto de 1994"
8,8,37,2020,263,294,557,"21 de agosto de 1994"
8,8,37,2021,234,245,479,"21 de agosto de 1994"
8,8,37,2022,282,346,628,"21 de agosto de 1994"
8,8,37,2023,262,277,539,"21 de agosto de 1994"
8,8,37,2024,364,432,796,"21 de agosto de 1994"
8,8,37,2025,384,427,811,"21 de agosto de 1994"
8,8,37,2026,395,374,769,"21 de agosto de 1994"
8,8,37,2027,311,360,671,"21 de agosto de 1994"
8,8,37,2028,413,488,901,"21 de agosto de 1994"
8,8,37,2029,458,507,965,"21 de agosto de 1994"
8,8,37,2030,240,247,487,"21 de agosto de 1994"
8,8,37,2031,467,471,938,"21 de agosto de 1994"
8,8,37,2032,261,268,529,"21 de agosto de 1994"
8,8,37,2033,356,408,764,"21 de agosto de 1994"
8,8,37,2034,270,318,588,"21 de agosto de 1994"
8,8,37,2035,286,286,572,"21 de agosto de 1994"
8,8,37,2036,347,358,705,"21 de agosto de 1994"
8,8,37,2037,324,358,682,"21 de agosto de 1994"
8,8,37,2038,570,642,1212,"21 de agosto de 1994"
8,8,37,2039,259,293,552,"21 de agosto de 1994"
8,8,37,2040,260,257,517,"21 de agosto de 1994"
8,8,37,2041,395,447,842,"21 de agosto de 1994"
8,8,37,2042,363,374,737,"21 de agosto de 1994"
8,8,37,2043,215,235,450,"21 de agosto de 1994"
8,8,37,2044,325,338,663,"21 de agosto de 1994"
8,8,37,2045,342,356,698,"21 de agosto de 1994"
8,8,37,2046,198,202,400,"21 de agosto de 1994"
8,8,37,2047,279,307,586,"21 de agosto de 1994"
8,8,37,2048,397,440,837,"21 de agosto de 1994"
8,8,37,2049,363,351,714,"21 de agosto de 1994"
8,8,37,2050,244,252,496,"21 de agosto de 1994"
8,8,37,2051,250,251,501,"21 de agosto de 1994"
8,8,37,2052,583,594,1177,"21 de agosto de 1994"
8,8,37,2053,551,604,1155,"21 de agosto de 1994"
8,8,37,2054,499,469,968,"21 de agosto de 1994"
8,8,37,2055,628,565,1193,"21 de agosto de 1994"
8,8,37,2056,517,510,1027,"21 de agosto de 1994"
8,8,37,2057,588,561,1149,"21 de agosto de 1994"
8,8,37,2058,313,322,635,"21 de agosto de 1994"
8,8,37,2059,170,183,353,"21 de agosto de 1994"
8,8,37,2060,375,446,821,"21 de agosto de 1994"
8,8,37,2061,342,381,723,"21 de agosto de 1994"
8,8,37,2062,296,308,604,"21 de agosto de 1994"
8,8,37,2063,177,177,354,"21 de agosto de 1994"
8,8,37,2064,232,262,494,"21 de agosto de 1994"
8,8,37,2065,318,298,616,"21 de agosto de 1994"
8,8,37,2066,339,369,708,"21 de agosto de 1994"
8,8,37,2067,288,317,605,"21 de agosto de 1994"
8,8,37,2068,414,458,872,"21 de agosto de 1994"
8,8,37,2069,446,467,913,"21 de agosto de 1994"
8,8,37,2070,414,476,890,"21 de agosto de 1994"
8,8,37,2071,219,245,464,"21 de agosto de 1994"
8,8,37,2072,246,284,530,"21 de agosto de 1994"
8,8,37,2073,297,317,614,"21 de agosto de 1994"
8,8,37,2074,478,507,985,"21 de agosto de 1994"
8,8,37,2075,277,318,595,"21 de agosto de 1994"
8,8,37,2076,213,242,455,"21 de agosto de 1994"
8,8,37,2077,434,411,845,"21 de agosto de 1994"
8,8,37,2078,512,518,1030,"21 de agosto de 1994"
8,8,37,2079,351,323,674,"21 de agosto de 1994"
8,8,37,2080,238,256,494,"21 de agosto de 1994"
8,8,37,2081,280,284,564,"21 de agosto de 1994"
8,8,37,2082,336,323,659,"21 de agosto de 1994"
8,8,37,2083,342,363,705,"21 de agosto de 1994"
8,8,37,2084,217,247,464,"21 de agosto de 1994"
8,8,37,2085,270,302,572,"21 de agosto de 1994"
8,8,37,2086,412,430,842,"21 de agosto de 1994"
8,8,37,2087,194,202,396,"21 de agosto de 1994"
8,8,37,2088,237,262,499,"21 de agosto de 1994"
8,8,37,2089,330,342,672,"21 de agosto de 1994"
8,8,37,2090,290,314,604,"21 de agosto de 1994"
8,8,37,2091,225,283,508,"21 de agosto de 1994"
8,8,37,2092,174,198,372,"21 de agosto de 1994"
8,8,37,2093,339,355,694,"21 de agosto de 1994"
8,8,37,2094,564,570,1134,"21 de agosto de 1994"
8,8,37,2095,258,261,519,"21 de agosto de 1994"
8,8,37,2096,234,228,462,"21 de agosto de 1994"
8,8,37,2097,417,472,889,"21 de agosto de 1994"
8,8,37,2098,351,317,668,"21 de agosto de 1994"
8,8,37,2099,176,181,357,"21 de agosto de 1994"
8,8,37,2100,273,272,545,"21 de agosto de 1994"
8,8,37,2101,351,385,736,"21 de agosto de 1994"
8,8,37,2102,649,683,1332,"21 de agosto de 1994"
8,8,37,2103,529,555,1084,"21 de agosto de 1994"
8,8,37,2104,483,524,1007,"21 de agosto de 1994"
8,8,37,2105,208,223,431,"21 de agosto de 1994"
8,8,37,2106,376,320,696,"21 de agosto de 1994"
8,8,37,2107,297,310,607,"21 de agosto de 1994"
8,8,37,2108,340,332,672,"21 de agosto de 1994"
8,8,37,2109,373,401,774,"21 de agosto de 1994"
8,8,37,2110,81,84,165,"21 de agosto de 1994"
8,8,37,2111,394,454,848,"21 de agosto de 1994"
8,8,37,2112,389,401,790,"21 de agosto de 1994"
8,8,37,2113,276,289,565,"21 de agosto de 1994"
8,8,37,2114,495,527,1022,"21 de agosto de 1994"
8,8,37,2115,189,218,407,"21 de agosto de 1994"
8,8,37,2116,373,364,737,"21 de agosto de 1994"
8,8,37,2117,106,124,230,"21 de agosto de 1994"
8,8,37,2118,275,296,571,"21 de agosto de 1994"
8,8,37,2119,303,315,618,"21 de agosto de 1994"
8,8,37,2120,329,291,620,"21 de agosto de 1994"
8,8,37,2121,516,540,1056,"21 de agosto de 1994"
8,8,37,2122,267,267,534,"21 de agosto de 1994"
8,8,37,2123,519,516,1035,"21 de agosto de 1994"
8,8,37,2124,213,222,435,"21 de agosto de 1994"
8,8,37,2125,164,163,327,"21 de agosto de 1994"
8,8,37,2126,216,212,428,"21 de agosto de 1994"
8,8,37,2127,266,307,573,"21 de agosto de 1994"
8,8,37,2128,214,220,434,"21 de agosto de 1994"
8,8,37,2129,357,341,698,"21 de agosto de 1994"
8,8,37,2130,542,488,1030,"21 de agosto de 1994"
8,8,37,2131,563,566,1129,"21 de agosto de 1994"
8,8,37,2132,270,290,560,"21 de agosto de 1994"
8,8,37,2133,472,523,995,"21 de agosto de 1994"
8,8,37,2134,562,639,1201,"21 de agosto de 1994"
8,8,37,2135,508,536,1044,"21 de agosto de 1994"
8,8,37,2136,297,287,584,"21 de agosto de 1994"
8,8,37,2137,382,412,794,"21 de agosto de 1994"
8,8,37,2138,138,126,264,"21 de agosto de 1994"
8,8,37,2139,234,239,473,"21 de agosto de 1994"
8,8,37,2140,488,468,956,"21 de agosto de 1994"
8,8,37,2141,368,427,795,"21 de agosto de 1994"
8,8,37,2142,355,404,759,"21 de agosto de 1994"
8,8,37,2143,250,245,495,"21 de agosto de 1994"
8,8,37,2144,212,218,430,"21 de agosto de 1994"
8,8,37,2145,437,506,943,"21 de agosto de 1994"
8,8,37,2146,254,301,555,"21 de agosto de 1994"
8,8,37,2147,246,241,487,"21 de agosto de 1994"
8,8,37,2148,240,282,522,"21 de agosto de 1994"
8,8,37,2149,389,392,781,"21 de agosto de 1994"
8,8,37,2150,192,232,424,"21 de agosto de 1994"
8,8,37,2151,278,307,585,"21 de agosto de 1994"
8,8,37,2152,469,495,964,"21 de agosto de 1994"
8,8,37,2153,416,446,862,"21 de agosto de 1994"
8,8,37,2154,339,339,678,"21 de agosto de 1994"
8,8,37,2155,639,662,1301,"21 de agosto de 1994"
8,8,37,2156,316,309,625,"21 de agosto de 1994"
8,8,37,2157,155,167,322,"21 de agosto de 1994"
8,8,37,2158,337,375,712,"21 de agosto de 1994"
8,8,37,2159,268,276,544,"21 de agosto de 1994"
8,8,37,2160,224,225,449,"21 de agosto de 1994"
8,8,37,2161,218,254,472,"21 de agosto de 1994"
8,8,37,2162,177,162,339,"21 de agosto de 1994"
8,8,37,2163,242,247,489,"21 de agosto de 1994"
8,8,37,2164,206,217,423,"21 de agosto de 1994"
8,8,37,2165,321,353,674,"21 de agosto de 1994"
8,8,37,2166,390,390,780,"21 de agosto de 1994"
8,8,37,2167,272,286,558,"21 de agosto de 1994"
8,8,37,2168,161,169,330,"21 de agosto de 1994"
8,8,37,2169,167,168,335,"21 de agosto de 1994"
8,8,37,2170,159,190,349,"21 de agosto de 1994"
8,8,37,2171,271,267,538,"21 de agosto de 1994"
8,8,37,2172,479,504,983,"21 de agosto de 1994"
8,8,37,2173,494,500,994,"21 de agosto de 1994"
8,8,37,2174,453,491,944,"21 de agosto de 1994"
8,8,37,2175,220,208,428,"21 de agosto de 1994"
8,8,37,2176,236,270,506,"21 de agosto de 1994"
8,8,37,2177,379,385,764,"21 de agosto de 1994"
8,8,37,2178,398,411,809,"21 de agosto de 1994"
8,8,37,2179,432,434,866,"21 de agosto de 1994"
8,8,37,2180,445,487,932,"21 de agosto de 1994"
8,8,37,2181,241,253,494,"21 de agosto de 1994"
8,8,37,2182,270,289,559,"21 de agosto de 1994"
8,8,37,2183,218,255,473,"21 de agosto de 1994"
8,8,37,2184,255,254,509,"21 de agosto de 1994"
8,8,37,2185,255,260,515,"21 de agosto de 1994"
8,8,37,2186,278,281,559,"21 de agosto de 1994"
8,8,37,2187,435,458,893,"21 de agosto de 1994"
8,8,37,2188,489,534,1023,"21 de agosto de 1994"
8,8,37,2189,426,438,864,"21 de agosto de 1994"
8,8,37,2190,142,129,271,"21 de agosto de 1994"
8,8,37,2191,431,437,868,"21 de agosto de 1994"
8,8,37,2192,482,478,960,"21 de agosto de 1994"
8,8,37,2193,378,404,782,"21 de agosto de 1994"
8,8,37,2194,220,236,456,"21 de agosto de 1994"
8,8,37,2195,338,179,517,"21 de agosto de 1994"
8,8,37,2196,137,55,192,"21 de agosto de 1994"
8,8,37,2197,239,175,414,"21 de agosto de 1994"
8,8,37,2198,753,781,1534,"21 de agosto de 1994"
8,9,1,1,245,230,475,"21 de agosto de 1994"
8,9,1,2,297,272,569,"21 de agosto de 1994"
8,9,1,3,283,282,565,"21 de agosto de 1994"
8,9,1,4,369,366,735,"21 de agosto de 1994"
8,9,1,5,432,416,848,"21 de agosto de 1994"
8,9,1,6,309,300,609,"21 de agosto de 1994"
8,9,1,7,180,172,352,"21 de agosto de 1994"
8,9,1,8,251,245,496,"21 de agosto de 1994"
8,9,1,9,23,13,36,"21 de agosto de 1994"
8,9,1,10,105,79,184,"21 de agosto de 1994"
8,9,1,11,76,74,150,"21 de agosto de 1994"
8,9,1,12,213,144,357,"21 de agosto de 1994"
8,9,1,13,242,172,414,"21 de agosto de 1994"
8,9,1,14,167,152,319,"21 de agosto de 1994"
8,9,1,15,121,108,229,"21 de agosto de 1994"
8,9,1,16,85,74,159,"21 de agosto de 1994"
8,9,5,60,298,279,577,"21 de agosto de 1994"
8,9,5,61,201,202,403,"21 de agosto de 1994"
8,9,5,62,226,217,443,"21 de agosto de 1994"
8,9,5,63,328,328,656,"21 de agosto de 1994"
8,9,5,64,190,196,386,"21 de agosto de 1994"
8,9,5,65,181,196,377,"21 de agosto de 1994"
8,9,5,66,221,219,440,"21 de agosto de 1994"
8,9,5,67,234,266,500,"21 de agosto de 1994"
8,9,5,68,234,254,488,"21 de agosto de 1994"
8,9,5,69,202,189,391,"21 de agosto de 1994"
8,9,5,70,162,160,322,"21 de agosto de 1994"
8,9,5,71,198,197,395,"21 de agosto de 1994"
8,9,5,72,165,194,359,"21 de agosto de 1994"
8,9,5,73,181,196,377,"21 de agosto de 1994"
8,9,5,74,209,205,414,"21 de agosto de 1994"
8,9,5,75,155,159,314,"21 de agosto de 1994"
8,9,5,76,209,210,419,"21 de agosto de 1994"
8,9,5,77,114,78,192,"21 de agosto de 1994"
8,9,5,78,415,368,783,"21 de agosto de 1994"
8,9,5,79,294,201,495,"21 de agosto de 1994"
8,9,5,80,72,54,126,"21 de agosto de 1994"
8,9,5,81,283,164,447,"21 de agosto de 1994"
8,9,10,149,226,207,433,"21 de agosto de 1994"
8,9,10,150,173,162,335,"21 de agosto de 1994"
8,9,10,151,226,223,449,"21 de agosto de 1994"
8,9,10,152,230,232,462,"21 de agosto de 1994"
8,9,10,153,228,220,448,"21 de agosto de 1994"
8,9,10,154,97,74,171,"21 de agosto de 1994"
8,9,10,155,133,111,244,"21 de agosto de 1994"
8,9,10,156,109,111,220,"21 de agosto de 1994"
8,9,10,157,263,226,489,"21 de agosto de 1994"
8,9,10,158,210,200,410,"21 de agosto de 1994"
8,9,10,159,229,215,444,"21 de agosto de 1994"
8,9,10,160,288,277,565,"21 de agosto de 1994"
8,9,10,161,277,266,543,"21 de agosto de 1994"
8,9,10,162,250,223,473,"21 de agosto de 1994"
8,9,10,163,256,256,512,"21 de agosto de 1994"
8,9,10,164,177,184,361,"21 de agosto de 1994"
8,9,10,165,119,109,228,"21 de agosto de 1994"
8,9,10,166,268,245,513,"21 de agosto de 1994"
8,9,10,167,310,278,588,"21 de agosto de 1994"
8,9,10,168,407,372,779,"21 de agosto de 1994"
8,9,10,169,76,46,122,"21 de agosto de 1994"
8,9,10,170,36,26,62,"21 de agosto de 1994"
8,9,10,171,177,146,323,"21 de agosto de 1994"
8,9,10,172,302,295,597,"21 de agosto de 1994"
8,9,10,173,259,286,545,"21 de agosto de 1994"
8,9,10,174,341,276,617,"21 de agosto de 1994"
8,9,13,238,123,122,245,"21 de agosto de 1994"
8,9,13,239,179,173,352,"21 de agosto de 1994"
8,9,13,240,446,460,906,"21 de agosto de 1994"
8,9,13,241,250,274,524,"21 de agosto de 1994"
8,9,13,242,242,208,450,"21 de agosto de 1994"
8,9,13,243,263,239,502,"21 de agosto de 1994"
8,9,13,244,158,163,321,"21 de agosto de 1994"
8,9,13,245,462,404,866,"21 de agosto de 1994"
8,9,13,246,56,44,100,"21 de agosto de 1994"
8,9,13,247,86,62,148,"21 de agosto de 1994"
8,9,13,248,146,108,254,"21 de agosto de 1994"
8,9,13,249,138,105,243,"21 de agosto de 1994"
8,9,13,250,174,128,302,"21 de agosto de 1994"
8,9,13,251,333,284,617,"21 de agosto de 1994"
8,9,13,252,78,45,123,"21 de agosto de 1994"
8,9,23,1042,190,192,382,"21 de agosto de 1994"
8,9,23,1043,39,22,61,"21 de agosto de 1994"
8,9,23,1044,276,304,580,"21 de agosto de 1994"
8,9,23,1045,438,426,864,"21 de agosto de 1994"
8,9,28,1126,528,545,1073,"21 de agosto de 1994"
8,9,28,1127,483,462,945,"21 de agosto de 1994"
8,9,28,1128,168,163,331,"21 de agosto de 1994"
8,9,28,1129,242,191,433,"21 de agosto de 1994"
8,9,28,1130,503,530,1033,"21 de agosto de 1994"
8,9,28,1131,265,206,471,"21 de agosto de 1994"
8,9,28,1132,179,169,348,"21 de agosto de 1994"
8,9,28,1133,63,45,108,"21 de agosto de 1994"
8,9,28,1134,433,448,881,"21 de agosto de 1994"
8,9,34,1357,160,162,322,"21 de agosto de 1994"
8,9,34,1358,405,391,796,"21 de agosto de 1994"
8,9,34,1359,345,337,682,"21 de agosto de 1994"
8,9,34,1360,93,86,179,"21 de agosto de 1994"
8,9,34,1361,101,88,189,"21 de agosto de 1994"
8,9,34,1362,82,77,159,"21 de agosto de 1994"
8,9,34,1363,101,86,187,"21 de agosto de 1994"
8,9,34,1364,42,25,67,"21 de agosto de 1994"
8,9,34,1365,89,59,148,"21 de agosto de 1994"
8,9,34,1366,122,112,234,"21 de agosto de 1994"
8,9,34,1367,145,107,252,"21 de agosto de 1994"
8,9,34,1368,241,243,484,"21 de agosto de 1994"
8,9,34,1369,203,152,355,"21 de agosto de 1994"
8,9,34,1370,33,21,54,"21 de agosto de 1994"
8,9,34,1371,114,84,198,"21 de agosto de 1994"
8,9,34,1372,77,74,151,"21 de agosto de 1994"
8,9,34,1373,66,47,113,"21 de agosto de 1994"
8,9,34,1374,158,151,309,"21 de agosto de 1994"
8,9,35,1375,245,238,483,"21 de agosto de 1994"
8,9,35,1376,250,234,484,"21 de agosto de 1994"
8,9,35,1377,282,248,530,"21 de agosto de 1994"
8,9,35,1378,75,36,111,"21 de agosto de 1994"
8,9,35,1379,346,284,630,"21 de agosto de 1994"
8,9,35,1380,162,149,311,"21 de agosto de 1994"
8,9,35,1381,250,218,468,"21 de agosto de 1994"
8,9,35,1382,37,27,64,"21 de agosto de 1994"
8,9,35,1383,252,219,471,"21 de agosto de 1994"
8,9,35,1384,224,199,423,"21 de agosto de 1994"
8,9,35,1385,62,55,117,"21 de agosto de 1994"
8,9,35,1386,134,109,243,"21 de agosto de 1994"
8,9,40,2214,153,141,294,"21 de agosto de 1994"
8,9,40,2215,247,255,502,"21 de agosto de 1994"
8,9,40,2216,217,212,429,"21 de agosto de 1994"
8,9,40,2217,239,239,478,"21 de agosto de 1994"
8,9,40,2218,172,177,349,"21 de agosto de 1994"
8,9,40,2219,301,280,581,"21 de agosto de 1994"
8,9,40,2220,222,247,469,"21 de agosto de 1994"
8,9,40,2221,206,244,450,"21 de agosto de 1994"
8,9,40,2222,146,161,307,"21 de agosto de 1994"
8,9,40,2223,287,296,583,"21 de agosto de 1994"
8,9,40,2224,238,253,491,"21 de agosto de 1994"
8,9,40,2225,255,324,579,"21 de agosto de 1994"
8,9,40,2226,365,332,697,"21 de agosto de 1994"
8,9,40,2227,294,254,548,"21 de agosto de 1994"
8,9,40,2228,146,172,318,"21 de agosto de 1994"
8,9,40,2229,223,225,448,"21 de agosto de 1994"
8,9,40,2230,229,236,465,"21 de agosto de 1994"
8,9,40,2231,199,199,398,"21 de agosto de 1994"
8,9,40,2232,183,191,374,"21 de agosto de 1994"
8,9,40,2233,185,202,387,"21 de agosto de 1994"
8,9,40,2234,182,176,358,"21 de agosto de 1994"
8,9,40,2235,156,156,312,"21 de agosto de 1994"
8,9,40,2236,119,107,226,"21 de agosto de 1994"
8,9,40,2237,209,167,376,"21 de agosto de 1994"
8,9,40,2238,184,191,375,"21 de agosto de 1994"
8,9,40,2239,292,285,577,"21 de agosto de 1994"
8,9,40,2240,280,234,514,"21 de agosto de 1994"
8,9,40,2241,247,234,481,"21 de agosto de 1994"
8,9,40,2242,192,191,383,"21 de agosto de 1994"
8,9,40,2243,213,166,379,"21 de agosto de 1994"
8,9,40,2244,148,124,272,"21 de agosto de 1994"
8,9,40,2245,134,125,259,"21 de agosto de 1994"
8,9,40,2246,200,187,387,"21 de agosto de 1994"
8,9,40,2247,204,179,383,"21 de agosto de 1994"
8,9,40,2248,97,62,159,"21 de agosto de 1994"
8,9,40,2249,80,54,134,"21 de agosto de 1994"
8,9,40,2250,306,256,562,"21 de agosto de 1994"
8,9,40,2251,231,200,431,"21 de agosto de 1994"
8,9,40,2252,101,88,189,"21 de agosto de 1994"
8,9,40,2253,189,188,377,"21 de agosto de 1994"
8,9,40,2254,142,112,254,"21 de agosto de 1994"
8,9,40,2255,328,284,612,"21 de agosto de 1994"
8,9,40,2256,215,175,390,"21 de agosto de 1994"
8,9,40,2257,85,70,155,"21 de agosto de 1994"
8,9,40,2258,208,175,383,"21 de agosto de 1994"
8,9,40,2259,216,170,386,"21 de agosto de 1994"
8,9,40,2260,77,62,139,"21 de agosto de 1994"
8,9,50,2396,328,394,722,"21 de agosto de 1994"
8,9,50,2397,451,470,921,"21 de agosto de 1994"
8,9,50,2398,448,494,942,"21 de agosto de 1994"
8,9,50,2399,204,215,419,"21 de agosto de 1994"
8,9,50,2400,294,323,617,"21 de agosto de 1994"
8,9,50,2401,209,227,436,"21 de agosto de 1994"
8,9,50,2402,252,267,519,"21 de agosto de 1994"
8,9,50,2403,153,165,318,"21 de agosto de 1994"
8,9,50,2404,181,198,379,"21 de agosto de 1994"
8,9,50,2405,153,181,334,"21 de agosto de 1994"
8,9,50,2406,221,224,445,"21 de agosto de 1994"
8,9,50,2407,195,222,417,"21 de agosto de 1994"
8,9,50,2408,244,282,526,"21 de agosto de 1994"
8,9,50,2409,193,185,378,"21 de agosto de 1994"
8,9,50,2410,239,254,493,"21 de agosto de 1994"
8,9,50,2411,168,201,369,"21 de agosto de 1994"
8,9,50,2412,217,240,457,"21 de agosto de 1994"
8,9,50,2413,265,319,584,"21 de agosto de 1994"
8,9,50,2414,279,310,589,"21 de agosto de 1994"
8,9,50,2415,246,293,539,"21 de agosto de 1994"
8,9,50,2416,268,276,544,"21 de agosto de 1994"
8,9,50,2417,245,282,527,"21 de agosto de 1994"
8,9,50,2418,216,277,493,"21 de agosto de 1994"
8,9,50,2419,231,237,468,"21 de agosto de 1994"
8,9,50,2420,181,187,368,"21 de agosto de 1994"
8,9,50,2421,194,240,434,"21 de agosto de 1994"
8,9,50,2422,228,281,509,"21 de agosto de 1994"
8,9,50,2423,251,266,517,"21 de agosto de 1994"
8,9,50,2424,233,267,500,"21 de agosto de 1994"
8,9,50,2425,251,268,519,"21 de agosto de 1994"
8,9,50,2426,303,320,623,"21 de agosto de 1994"
8,9,50,2427,198,224,422,"21 de agosto de 1994"
8,9,50,2428,226,203,429,"21 de agosto de 1994"
8,9,50,2429,243,259,502,"21 de agosto de 1994"
8,9,50,2430,472,486,958,"21 de agosto de 1994"
8,9,50,2431,338,359,697,"21 de agosto de 1994"
8,9,50,2432,226,227,453,"21 de agosto de 1994"
8,9,50,2433,143,149,292,"21 de agosto de 1994"
8,9,50,2434,208,255,463,"21 de agosto de 1994"
8,9,50,2435,247,279,526,"21 de agosto de 1994"
8,9,50,2436,175,203,378,"21 de agosto de 1994"
8,9,50,2437,175,184,359,"21 de agosto de 1994"
8,9,50,2438,340,361,701,"21 de agosto de 1994"
8,9,50,2439,334,409,743,"21 de agosto de 1994"
8,9,50,2440,245,255,500,"21 de agosto de 1994"
8,9,50,2441,132,137,269,"21 de agosto de 1994"
8,9,50,2442,185,210,395,"21 de agosto de 1994"
8,9,50,2443,152,157,309,"21 de agosto de 1994"
8,9,50,2444,197,204,401,"21 de agosto de 1994"
8,9,50,2445,175,175,350,"21 de agosto de 1994"
8,9,50,2446,263,258,521,"21 de agosto de 1994"
8,9,50,2447,199,220,419,"21 de agosto de 1994"
8,9,50,2448,72,83,155,"21 de agosto de 1994"
8,9,50,2449,90,82,172,"21 de agosto de 1994"
8,9,50,2450,247,224,471,"21 de agosto de 1994"
8,9,50,2451,243,231,474,"21 de agosto de 1994"
8,9,50,2452,280,264,544,"21 de agosto de 1994"
8,9,50,2453,154,136,290,"21 de agosto de 1994"
8,9,50,2454,264,270,534,"21 de agosto de 1994"
8,9,50,2455,68,44,112,"21 de agosto de 1994"
8,9,50,2456,138,124,262,"21 de agosto de 1994"
8,9,50,2457,229,218,447,"21 de agosto de 1994"
8,9,50,2458,183,157,340,"21 de agosto de 1994"
8,9,50,2459,180,165,345,"21 de agosto de 1994"
8,9,53,2509,299,285,584,"21 de agosto de 1994"
8,9,53,2510,411,381,792,"21 de agosto de 1994"
8,9,53,2511,387,388,775,"21 de agosto de 1994"
8,9,53,2512,197,218,415,"21 de agosto de 1994"
8,9,53,2513,331,303,634,"21 de agosto de 1994"
8,9,53,2514,203,174,377,"21 de agosto de 1994"
8,9,53,2515,236,218,454,"21 de agosto de 1994"
8,9,53,2516,411,377,788,"21 de agosto de 1994"
8,9,53,2517,234,205,439,"21 de agosto de 1994"
8,10,17,271,160,176,336,"21 de agosto de 1994"
8,10,17,272,217,180,397,"21 de agosto de 1994"
8,10,17,273,183,210,393,"21 de agosto de 1994"
8,10,17,274,211,285,496,"21 de agosto de 1994"
8,10,17,275,281,328,609,"21 de agosto de 1994"
8,10,17,276,186,204,390,"21 de agosto de 1994"
8,10,17,277,364,432,796,"21 de agosto de 1994"
8,10,17,278,465,562,1027,"21 de agosto de 1994"
8,10,17,279,716,534,1250,"21 de agosto de 1994"
8,10,17,280,240,292,532,"21 de agosto de 1994"
8,10,17,281,331,389,720,"21 de agosto de 1994"
8,10,17,282,289,306,595,"21 de agosto de 1994"
8,10,17,283,355,399,754,"21 de agosto de 1994"
8,10,17,284,337,420,757,"21 de agosto de 1994"
8,10,17,285,195,241,436,"21 de agosto de 1994"
8,10,17,286,296,339,635,"21 de agosto de 1994"
8,10,17,287,185,236,421,"21 de agosto de 1994"
8,10,17,288,452,492,944,"21 de agosto de 1994"
8,10,17,289,309,333,642,"21 de agosto de 1994"
8,10,17,290,306,335,641,"21 de agosto de 1994"
8,10,17,291,275,296,571,"21 de agosto de 1994"
8,10,17,292,256,285,541,"21 de agosto de 1994"
8,10,17,293,186,204,390,"21 de agosto de 1994"
8,10,17,294,198,235,433,"21 de agosto de 1994"
8,10,17,295,206,279,485,"21 de agosto de 1994"
8,10,17,296,224,287,511,"21 de agosto de 1994"
8,10,17,297,413,451,864,"21 de agosto de 1994"
8,10,17,298,209,227,436,"21 de agosto de 1994"
8,10,17,299,269,318,587,"21 de agosto de 1994"
8,10,17,300,228,292,520,"21 de agosto de 1994"
8,10,17,301,215,281,496,"21 de agosto de 1994"
8,10,17,302,331,404,735,"21 de agosto de 1994"
8,10,17,303,200,259,459,"21 de agosto de 1994"
8,10,17,304,186,245,431,"21 de agosto de 1994"
8,10,17,305,182,210,392,"21 de agosto de 1994"
8,10,17,306,309,368,677,"21 de agosto de 1994"
8,10,17,307,310,361,671,"21 de agosto de 1994"
8,10,17,308,262,325,587,"21 de agosto de 1994"
8,10,17,309,203,246,449,"21 de agosto de 1994"
8,10,17,310,429,491,920,"21 de agosto de 1994"
8,10,17,311,309,345,654,"21 de agosto de 1994"
8,10,17,312,411,464,875,"21 de agosto de 1994"
8,10,17,313,257,348,605,"21 de agosto de 1994"
8,10,17,314,359,420,779,"21 de agosto de 1994"
8,10,17,315,226,267,493,"21 de agosto de 1994"
8,10,17,316,156,184,340,"21 de agosto de 1994"
8,10,17,317,239,299,538,"21 de agosto de 1994"
8,10,17,318,206,246,452,"21 de agosto de 1994"
8,10,17,319,218,254,472,"21 de agosto de 1994"
8,10,17,320,242,291,533,"21 de agosto de 1994"
8,10,17,321,396,429,825,"21 de agosto de 1994"
8,10,17,322,167,168,335,"21 de agosto de 1994"
8,10,17,323,246,269,515,"21 de agosto de 1994"
8,10,17,324,210,252,462,"21 de agosto de 1994"
8,10,17,325,294,335,629,"21 de agosto de 1994"
8,10,17,326,554,655,1209,"21 de agosto de 1994"
8,10,17,327,542,656,1198,"21 de agosto de 1994"
8,10,17,328,234,291,525,"21 de agosto de 1994"
8,10,17,329,211,244,455,"21 de agosto de 1994"
8,10,17,330,254,280,534,"21 de agosto de 1994"
8,10,17,331,278,321,599,"21 de agosto de 1994"
8,10,17,332,407,467,874,"21 de agosto de 1994"
8,10,17,333,220,256,476,"21 de agosto de 1994"
8,10,17,334,529,563,1092,"21 de agosto de 1994"
8,10,17,335,312,376,688,"21 de agosto de 1994"
8,10,17,336,248,272,520,"21 de agosto de 1994"
8,10,17,337,312,347,659,"21 de agosto de 1994"
8,10,17,338,558,597,1155,"21 de agosto de 1994"
8,10,17,339,284,313,597,"21 de agosto de 1994"
8,10,17,340,409,422,831,"21 de agosto de 1994"
8,10,17,341,364,398,762,"21 de agosto de 1994"
8,10,17,342,384,396,780,"21 de agosto de 1994"
8,10,17,343,447,495,942,"21 de agosto de 1994"
8,10,17,344,343,378,721,"21 de agosto de 1994"
8,10,17,345,141,176,317,"21 de agosto de 1994"
8,10,17,346,181,196,377,"21 de agosto de 1994"
8,10,17,347,140,159,299,"21 de agosto de 1994"
8,10,17,348,385,422,807,"21 de agosto de 1994"
8,10,17,349,369,368,737,"21 de agosto de 1994"
8,10,17,350,375,413,788,"21 de agosto de 1994"
8,10,17,351,220,234,454,"21 de agosto de 1994"
8,10,17,352,117,110,227,"21 de agosto de 1994"
8,10,17,353,250,234,484,"21 de agosto de 1994"
8,10,17,354,22,16,38,"21 de agosto de 1994"
8,10,17,355,87,81,168,"21 de agosto de 1994"
8,10,17,356,361,331,692,"21 de agosto de 1994"
8,10,17,357,49,25,74,"21 de agosto de 1994"
8,10,17,358,59,51,110,"21 de agosto de 1994"
8,10,17,359,287,280,567,"21 de agosto de 1994"
8,10,17,360,59,45,104,"21 de agosto de 1994"
8,10,17,361,52,41,93,"21 de agosto de 1994"
8,10,17,362,80,82,162,"21 de agosto de 1994"
8,10,17,363,156,170,326,"21 de agosto de 1994"
8,10,17,364,369,189,558,"21 de agosto de 1994"
8,10,17,365,221,201,422,"21 de agosto de 1994"
8,10,17,366,33,31,64,"21 de agosto de 1994"
8,10,17,367,83,67,150,"21 de agosto de 1994"
8,10,17,368,288,165,453,"21 de agosto de 1994"
8,10,17,369,242,104,346,"21 de agosto de 1994"
8,10,17,370,156,136,292,"21 de agosto de 1994"
8,10,17,371,48,46,94,"21 de agosto de 1994"
8,10,17,372,46,35,81,"21 de agosto de 1994"
8,10,17,373,388,206,594,"21 de agosto de 1994"
8,10,17,374,101,94,195,"21 de agosto de 1994"
8,10,17,375,47,53,100,"21 de agosto de 1994"
8,10,17,376,52,58,110,"21 de agosto de 1994"
8,10,17,377,62,60,122,"21 de agosto de 1994"
8,10,17,378,67,66,133,"21 de agosto de 1994"
8,10,17,379,55,36,91,"21 de agosto de 1994"
8,10,17,380,109,107,216,"21 de agosto de 1994"
8,10,17,381,82,70,152,"21 de agosto de 1994"
8,10,17,382,91,86,177,"21 de agosto de 1994"
8,10,17,383,208,201,409,"21 de agosto de 1994"
8,10,17,384,79,77,156,"21 de agosto de 1994"
8,10,17,385,144,102,246,"21 de agosto de 1994"
8,10,17,386,109,98,207,"21 de agosto de 1994"
8,10,17,387,43,33,76,"21 de agosto de 1994"
8,10,18,388,137,73,210,"21 de agosto de 1994"
8,10,18,389,113,107,220,"21 de agosto de 1994"
8,10,18,390,42,24,66,"21 de agosto de 1994"
8,10,18,391,77,65,142,"21 de agosto de 1994"
8,10,18,392,24,12,36,"21 de agosto de 1994"
8,10,18,393,130,132,262,"21 de agosto de 1994"
8,10,18,394,218,200,418,"21 de agosto de 1994"
8,10,18,395,161,152,313,"21 de agosto de 1994"
8,10,18,396,225,184,409,"21 de agosto de 1994"
8,10,18,397,120,108,228,"21 de agosto de 1994"
8,10,18,398,245,222,467,"21 de agosto de 1994"
8,10,18,399,93,60,153,"21 de agosto de 1994"
8,10,18,400,76,58,134,"21 de agosto de 1994"
8,10,18,401,105,74,179,"21 de agosto de 1994"
8,10,22,1031,397,377,774,"21 de agosto de 1994"
8,10,22,1032,181,170,351,"21 de agosto de 1994"
8,10,22,1033,172,185,357,"21 de agosto de 1994"
8,10,22,1034,148,142,290,"21 de agosto de 1994"
8,10,22,1035,121,111,232,"21 de agosto de 1994"
8,10,22,1036,148,165,313,"21 de agosto de 1994"
8,10,22,1037,29,25,54,"21 de agosto de 1994"
8,10,22,1038,48,45,93,"21 de agosto de 1994"
8,10,22,1039,87,58,145,"21 de agosto de 1994"
8,10,22,1040,34,25,59,"21 de agosto de 1994"
8,10,22,1041,176,170,346,"21 de agosto de 1994"
8,10,26,1069,189,177,366,"21 de agosto de 1994"
8,10,26,1070,149,145,294,"21 de agosto de 1994"
8,10,26,1071,83,93,176,"21 de agosto de 1994"
8,10,26,1072,83,91,174,"21 de agosto de 1994"
8,10,26,1073,115,115,230,"21 de agosto de 1994"
8,10,26,1074,85,85,170,"21 de agosto de 1994"
8,10,26,1075,91,83,174,"21 de agosto de 1994"
8,10,26,1076,83,67,150,"21 de agosto de 1994"
8,10,26,1077,119,85,204,"21 de agosto de 1994"
8,10,26,1078,66,63,129,"21 de agosto de 1994"
8,10,26,1079,253,258,511,"21 de agosto de 1994"
8,10,26,1080,156,174,330,"21 de agosto de 1994"
8,10,26,1081,78,73,151,"21 de agosto de 1994"
8,10,27,1082,158,151,309,"21 de agosto de 1994"
8,10,27,1083,283,325,608,"21 de agosto de 1994"
8,10,27,1084,187,194,381,"21 de agosto de 1994"
8,10,27,1085,257,314,571,"21 de agosto de 1994"
8,10,27,1086,169,193,362,"21 de agosto de 1994"
8,10,27,1087,238,281,519,"21 de agosto de 1994"
8,10,27,1088,211,231,442,"21 de agosto de 1994"
8,10,27,1089,217,217,434,"21 de agosto de 1994"
8,10,27,1090,166,190,356,"21 de agosto de 1994"
8,10,27,1091,314,339,653,"21 de agosto de 1994"
8,10,27,1092,261,163,424,"21 de agosto de 1994"
8,10,27,1093,246,167,413,"21 de agosto de 1994"
8,10,27,1094,227,112,339,"21 de agosto de 1994"
8,10,27,1095,232,150,382,"21 de agosto de 1994"
8,10,27,1096,119,31,150,"21 de agosto de 1994"
8,10,27,1097,365,253,618,"21 de agosto de 1994"
8,10,27,1098,573,337,910,"21 de agosto de 1994"
8,10,27,1099,57,40,97,"21 de agosto de 1994"
8,10,27,1100,330,182,512,"21 de agosto de 1994"
8,10,27,1101,342,235,577,"21 de agosto de 1994"
8,10,27,1102,211,145,356,"21 de agosto de 1994"
8,10,27,1103,137,82,219,"21 de agosto de 1994"
8,10,27,1104,195,142,337,"21 de agosto de 1994"
8,10,27,1105,157,106,263,"21 de agosto de 1994"
8,10,27,1106,113,73,186,"21 de agosto de 1994"
8,10,27,1107,635,496,1131,"21 de agosto de 1994"
8,10,27,1108,190,133,323,"21 de agosto de 1994"
8,10,27,1109,98,70,168,"21 de agosto de 1994"
8,10,27,1110,107,65,172,"21 de agosto de 1994"
8,10,27,1111,176,157,333,"21 de agosto de 1994"
8,10,27,1112,84,58,142,"21 de agosto de 1994"
8,10,27,1113,109,72,181,"21 de agosto de 1994"
8,10,27,1114,411,173,584,"21 de agosto de 1994"
8,10,27,1115,90,63,153,"21 de agosto de 1994"
8,10,27,1116,115,81,196,"21 de agosto de 1994"
8,10,27,1117,268,173,441,"21 de agosto de 1994"
8,10,27,1118,400,377,777,"21 de agosto de 1994"
8,10,27,1119,147,129,276,"21 de agosto de 1994"
8,10,27,1120,189,154,343,"21 de agosto de 1994"
8,10,27,1121,37,16,53,"21 de agosto de 1994"
8,10,27,1122,128,96,224,"21 de agosto de 1994"
8,10,27,1123,224,182,406,"21 de agosto de 1994"
8,10,27,1124,93,68,161,"21 de agosto de 1994"
8,10,27,1125,95,104,199,"21 de agosto de 1994"
8,10,49,2390,407,349,756,"21 de agosto de 1994"
8,10,49,2391,75,58,133,"21 de agosto de 1994"
8,10,49,2392,102,70,172,"21 de agosto de 1994"
8,10,49,2393,181,150,331,"21 de agosto de 1994"
8,10,49,2394,19,15,34,"21 de agosto de 1994"
8,10,49,2395,125,93,218,"21 de agosto de 1994"
8,10,54,2518,221,189,410,"21 de agosto de 1994"
8,10,54,2519,266,170,436,"21 de agosto de 1994"
8,10,54,2520,441,269,710,"21 de agosto de 1994"
8,10,54,2521,69,50,119,"21 de agosto de 1994"
8,10,54,2522,61,37,98,"21 de agosto de 1994"
8,10,54,2523,108,111,219,"21 de agosto de 1994"
8,10,54,2524,60,47,107,"21 de agosto de 1994"
8,10,54,2525,36,31,67,"21 de agosto de 1994"
8,10,54,2526,50,33,83,"21 de agosto de 1994"
8,10,54,2527,35,22,57,"21 de agosto de 1994"
8,10,55,2528,334,364,698,"21 de agosto de 1994"
8,10,55,2529,370,349,719,"21 de agosto de 1994"
8,10,55,2530,335,305,640,"21 de agosto de 1994"
8,10,55,2531,412,423,835,"21 de agosto de 1994"
8,10,55,2532,87,70,157,"21 de agosto de 1994"
8,10,55,2533,244,175,419,"21 de agosto de 1994"
8,10,55,2534,242,228,470,"21 de agosto de 1994"
8,10,55,2535,148,135,283,"21 de agosto de 1994"
8,10,55,2536,72,36,108,"21 de agosto de 1994"
8,10,55,2537,420,371,791,"21 de agosto de 1994"
8,10,55,2538,312,319,631,"21 de agosto de 1994"
8,10,55,2539,129,115,244,"21 de agosto de 1994"
8,10,55,2540,101,98,199,"21 de agosto de 1994"
8,10,55,2541,273,249,522,"21 de agosto de 1994"
8,10,55,2542,576,503,1079,"21 de agosto de 1994"
8,10,55,2543,269,260,529,"21 de agosto de 1994"
8,10,55,2544,272,253,525,"21 de agosto de 1994"
8,10,56,2545,338,319,657,"21 de agosto de 1994"
8,10,56,2546,284,245,529,"21 de agosto de 1994"
8,10,56,2547,127,116,243,"21 de agosto de 1994"
8,10,56,2548,210,212,422,"21 de agosto de 1994"
8,10,57,2549,279,238,517,"21 de agosto de 1994"
8,10,57,2550,204,193,397,"21 de agosto de 1994"
8,10,57,2551,30,21,51,"21 de agosto de 1994"
8,10,57,2552,66,43,109,"21 de agosto de 1994"
8,10,57,2553,32,20,52,"21 de agosto de 1994"
8,10,57,2554,121,84,205,"21 de agosto de 1994"
8,10,57,2555,61,46,107,"21 de agosto de 1994"
8,10,57,2556,41,24,65,"21 de agosto de 1994"
8,10,57,2557,96,82,178,"21 de agosto de 1994"
8,10,57,2558,86,77,163,"21 de agosto de 1994"
8,10,58,2559,238,208,446,"21 de agosto de 1994"
8,10,58,2560,211,184,395,"21 de agosto de 1994"
8,10,58,2561,328,311,639,"21 de agosto de 1994"
8,10,58,2562,64,65,129,"21 de agosto de 1994"
8,10,58,2563,41,36,77,"21 de agosto de 1994"
8,10,58,2564,80,76,156,"21 de agosto de 1994"
8,10,58,2565,47,37,84,"21 de agosto de 1994"
8,10,61,2601,143,95,238,"21 de agosto de 1994"
8,10,61,2602,251,218,469,"21 de agosto de 1994"
8,10,61,2603,62,54,116,"21 de agosto de 1994"
8,10,61,2604,113,103,216,"21 de agosto de 1994"
8,10,61,2605,68,83,151,"21 de agosto de 1994"
8,10,61,2606,219,211,430,"21 de agosto de 1994"
8,10,61,2607,122,99,221,"21 de agosto de 1994"
8,10,61,2608,234,222,456,"21 de agosto de 1994"
8,10,61,2609,117,89,206,"21 de agosto de 1994"
8,10,61,2610,69,55,124,"21 de agosto de 1994"
8,10,61,2611,153,127,280,"21 de agosto de 1994"
8,10,61,2612,89,67,156,"21 de agosto de 1994"
8,10,61,2613,215,155,370,"21 de agosto de 1994"
8,10,61,2614,72,62,134,"21 de agosto de 1994"
8,10,67,2697,333,319,652,"21 de agosto de 1994"
8,10,67,2698,177,180,357,"21 de agosto de 1994"
8,10,67,2699,158,124,282,"21 de agosto de 1994"
8,10,67,2700,91,84,175,"21 de agosto de 1994"
8,10,67,2701,140,120,260,"21 de agosto de 1994"
8,10,67,2702,112,109,221,"21 de agosto de 1994"
8,10,67,2703,89,78,167,"21 de agosto de 1994"
8,10,67,2704,72,57,129,"21 de agosto de 1994"
8,10,67,2705,54,47,101,"21 de agosto de 1994"
8,10,67,2706,250,267,517,"21 de agosto de 1994"
8,10,67,2707,112,87,199,"21 de agosto de 1994"
8,10,67,2708,31,25,56,"21 de agosto de 1994"
8,10,67,2709,114,101,215,"21 de agosto de 1994"
8,10,67,2710,151,122,273,"21 de agosto de 1994"
9,1,15,3289,0,0,0,"21 de agosto de 1994"
9,1,15,4523,594,718,1312,"21 de agosto de 1994"
9,1,15,4524,363,438,801,"21 de agosto de 1994"
9,1,15,4525,499,620,1119,"21 de agosto de 1994"
9,1,15,4526,333,392,725,"21 de agosto de 1994"
9,1,15,4527,496,573,1069,"21 de agosto de 1994"
9,1,15,4528,443,518,961,"21 de agosto de 1994"
9,1,15,4529,344,430,774,"21 de agosto de 1994"
9,1,15,4530,393,489,882,"21 de agosto de 1994"
9,1,15,4531,410,523,933,"21 de agosto de 1994"
9,1,15,4532,597,659,1256,"21 de agosto de 1994"
9,1,15,4533,359,465,824,"21 de agosto de 1994"
9,1,15,4534,340,348,688,"21 de agosto de 1994"
9,1,15,4535,402,533,935,"21 de agosto de 1994"
9,1,15,4536,314,389,703,"21 de agosto de 1994"
9,1,15,4537,245,302,547,"21 de agosto de 1994"
9,1,15,4538,426,568,994,"21 de agosto de 1994"
9,1,15,4539,384,493,877,"21 de agosto de 1994"
9,1,15,4540,416,541,957,"21 de agosto de 1994"
9,1,15,4541,483,620,1103,"21 de agosto de 1994"
9,1,15,4542,375,452,827,"21 de agosto de 1994"
9,1,15,4543,568,688,1256,"21 de agosto de 1994"
9,1,15,4544,366,499,865,"21 de agosto de 1994"
9,1,15,4545,496,522,1018,"21 de agosto de 1994"
9,1,15,4546,280,324,604,"21 de agosto de 1994"
9,1,15,4547,321,457,778,"21 de agosto de 1994"
9,1,15,4548,298,370,668,"21 de agosto de 1994"
9,1,15,4549,311,430,741,"21 de agosto de 1994"
9,1,15,4550,460,633,1093,"21 de agosto de 1994"
9,1,15,4551,539,727,1266,"21 de agosto de 1994"
9,1,15,4552,433,594,1027,"21 de agosto de 1994"
9,1,15,4553,401,502,903,"21 de agosto de 1994"
9,1,15,4554,422,531,953,"21 de agosto de 1994"
9,1,15,4555,511,623,1134,"21 de agosto de 1994"
9,1,15,4556,435,573,1008,"21 de agosto de 1994"
9,1,15,4557,521,588,1109,"21 de agosto de 1994"
9,1,15,4558,547,720,1267,"21 de agosto de 1994"
9,1,15,4559,444,551,995,"21 de agosto de 1994"
9,1,15,4560,534,723,1257,"21 de agosto de 1994"
9,1,15,4561,255,360,615,"21 de agosto de 1994"
9,1,15,4562,280,417,697,"21 de agosto de 1994"
9,1,15,4563,389,549,938,"21 de agosto de 1994"
9,1,15,4564,390,528,918,"21 de agosto de 1994"
9,1,15,4565,397,512,909,"21 de agosto de 1994"
9,1,15,4566,205,305,510,"21 de agosto de 1994"
9,1,15,4567,222,289,511,"21 de agosto de 1994"
9,1,15,4568,370,518,888,"21 de agosto de 1994"
9,1,15,4569,253,309,562,"21 de agosto de 1994"
9,1,15,4570,478,644,1122,"21 de agosto de 1994"
9,1,15,4571,228,298,526,"21 de agosto de 1994"
9,1,15,4572,301,431,732,"21 de agosto de 1994"
9,1,15,4573,513,618,1131,"21 de agosto de 1994"
9,1,15,4574,437,568,1005,"21 de agosto de 1994"
9,1,15,4575,559,686,1245,"21 de agosto de 1994"
9,1,15,4576,393,539,932,"21 de agosto de 1994"
9,1,15,4577,365,498,863,"21 de agosto de 1994"
9,1,15,4578,456,555,1011,"21 de agosto de 1994"
9,1,15,4579,357,472,829,"21 de agosto de 1994"
9,1,15,4580,379,532,911,"21 de agosto de 1994"
9,1,15,4581,391,540,931,"21 de agosto de 1994"
9,1,15,4582,363,520,883,"21 de agosto de 1994"
9,1,15,4583,373,545,918,"21 de agosto de 1994"
9,1,15,4584,315,443,758,"21 de agosto de 1994"
9,1,15,4585,332,471,803,"21 de agosto de 1994"
9,2,15,4586,221,256,477,"21 de agosto de 1994"
9,2,15,4587,207,220,427,"21 de agosto de 1994"
9,2,15,4588,637,738,1375,"21 de agosto de 1994"
9,2,15,4589,565,635,1200,"21 de agosto de 1994"
9,2,15,4590,514,575,1089,"21 de agosto de 1994"
9,2,15,4591,570,601,1171,"21 de agosto de 1994"
9,2,15,4592,272,328,600,"21 de agosto de 1994"
9,2,15,4593,625,694,1319,"21 de agosto de 1994"
9,2,15,4594,440,527,967,"21 de agosto de 1994"
9,2,15,4595,558,677,1235,"21 de agosto de 1994"
9,2,15,4596,535,681,1216,"21 de agosto de 1994"
9,2,15,4597,537,667,1204,"21 de agosto de 1994"
9,2,15,4598,358,437,795,"21 de agosto de 1994"
9,2,15,4599,452,604,1056,"21 de agosto de 1994"
9,2,15,4600,376,427,803,"21 de agosto de 1994"
9,2,15,4601,418,596,1014,"21 de agosto de 1994"
9,2,15,4602,462,626,1088,"21 de agosto de 1994"
9,2,15,4603,344,446,790,"21 de agosto de 1994"
9,2,15,4604,496,661,1157,"21 de agosto de 1994"
9,2,15,4605,460,501,961,"21 de agosto de 1994"
9,2,15,4606,604,772,1376,"21 de agosto de 1994"
9,2,15,4607,495,608,1103,"21 de agosto de 1994"
9,2,15,4608,503,649,1152,"21 de agosto de 1994"
9,2,15,4609,687,809,1496,"21 de agosto de 1994"
9,2,15,4610,521,636,1157,"21 de agosto de 1994"
9,2,15,4611,525,662,1187,"21 de agosto de 1994"
9,2,15,4612,594,730,1324,"21 de agosto de 1994"
9,2,15,4613,540,670,1210,"21 de agosto de 1994"
9,2,15,4614,573,682,1255,"21 de agosto de 1994"
9,2,15,4615,475,564,1039,"21 de agosto de 1994"
9,2,15,4616,537,615,1152,"21 de agosto de 1994"
9,2,15,4617,544,657,1201,"21 de agosto de 1994"
9,2,15,4618,532,626,1158,"21 de agosto de 1994"
9,2,15,4619,519,589,1108,"21 de agosto de 1994"
9,2,15,4620,535,586,1121,"21 de agosto de 1994"
9,2,15,4621,627,775,1402,"21 de agosto de 1994"
9,2,15,4622,601,693,1294,"21 de agosto de 1994"
9,2,15,4623,525,636,1161,"21 de agosto de 1994"
9,2,15,4624,451,509,960,"21 de agosto de 1994"
9,2,15,4625,531,726,1257,"21 de agosto de 1994"
9,2,15,4626,450,583,1033,"21 de agosto de 1994"
9,2,15,4627,483,601,1084,"21 de agosto de 1994"
9,2,15,4628,468,632,1100,"21 de agosto de 1994"
9,2,15,4629,394,510,904,"21 de agosto de 1994"
9,2,15,4630,269,374,643,"21 de agosto de 1994"
9,2,15,4631,458,542,1000,"21 de agosto de 1994"
9,2,15,4632,628,743,1371,"21 de agosto de 1994"
9,2,15,4633,554,568,1122,"21 de agosto de 1994"
9,2,15,4634,529,650,1179,"21 de agosto de 1994"
9,2,15,4635,613,708,1321,"21 de agosto de 1994"
9,2,15,4636,581,657,1238,"21 de agosto de 1994"
9,2,15,4637,735,675,1410,"21 de agosto de 1994"
9,2,15,4638,296,370,666,"21 de agosto de 1994"
9,2,15,4639,434,498,932,"21 de agosto de 1994"
9,2,15,4640,536,640,1176,"21 de agosto de 1994"
9,2,15,4641,515,616,1131,"21 de agosto de 1994"
9,2,15,4642,475,566,1041,"21 de agosto de 1994"
9,2,15,4643,493,667,1160,"21 de agosto de 1994"
9,2,15,4644,696,786,1482,"21 de agosto de 1994"
9,2,15,4645,486,591,1077,"21 de agosto de 1994"
9,2,15,4646,412,445,857,"21 de agosto de 1994"
9,2,15,4647,390,449,839,"21 de agosto de 1994"
9,2,15,4648,310,364,674,"21 de agosto de 1994"
9,2,15,4649,352,404,756,"21 de agosto de 1994"
9,2,15,4650,237,263,500,"21 de agosto de 1994"
9,2,15,4651,257,263,520,"21 de agosto de 1994"
9,2,15,4652,248,286,534,"21 de agosto de 1994"
9,2,15,4653,188,216,404,"21 de agosto de 1994"
9,3,15,555,1,0,1,"21 de agosto de 1994"
9,3,15,4654,545,677,1222,"21 de agosto de 1994"
9,3,15,4655,600,688,1288,"21 de agosto de 1994"
9,3,15,4656,669,737,1406,"21 de agosto de 1994"
9,3,15,4657,543,644,1187,"21 de agosto de 1994"
9,3,15,4658,666,769,1435,"21 de agosto de 1994"
9,3,15,4659,622,779,1401,"21 de agosto de 1994"
9,3,15,4660,503,618,1121,"21 de agosto de 1994"
9,3,15,4661,528,593,1121,"21 de agosto de 1994"
9,3,15,4662,560,747,1307,"21 de agosto de 1994"
9,3,15,4663,666,742,1408,"21 de agosto de 1994"
9,3,15,4664,604,731,1335,"21 de agosto de 1994"
9,3,15,4665,427,494,921,"21 de agosto de 1994"
9,3,15,4666,588,649,1237,"21 de agosto de 1994"
9,3,15,4667,539,569,1108,"21 de agosto de 1994"
9,3,15,4668,643,668,1311,"21 de agosto de 1994"
9,3,15,4669,596,741,1337,"21 de agosto de 1994"
9,3,15,4670,223,278,501,"21 de agosto de 1994"
9,3,15,4671,442,589,1031,"21 de agosto de 1994"
9,3,15,4672,554,689,1243,"21 de agosto de 1994"
9,3,15,4673,455,586,1041,"21 de agosto de 1994"
9,3,15,4674,281,368,649,"21 de agosto de 1994"
9,3,15,4675,233,279,512,"21 de agosto de 1994"
9,3,15,4676,370,498,868,"21 de agosto de 1994"
9,3,15,4677,460,565,1025,"21 de agosto de 1994"
9,3,15,4678,212,247,459,"21 de agosto de 1994"
9,3,15,4679,400,418,818,"21 de agosto de 1994"
9,3,15,4680,610,690,1300,"21 de agosto de 1994"
9,3,15,4681,181,189,370,"21 de agosto de 1994"
9,3,15,4682,480,510,990,"21 de agosto de 1994"
9,3,15,4683,494,577,1071,"21 de agosto de 1994"
9,3,15,4684,366,421,787,"21 de agosto de 1994"
9,3,15,4685,432,496,928,"21 de agosto de 1994"
9,3,15,4686,416,506,922,"21 de agosto de 1994"
9,3,15,4687,626,798,1424,"21 de agosto de 1994"
9,3,15,4688,399,444,843,"21 de agosto de 1994"
9,3,15,4689,422,501,923,"21 de agosto de 1994"
9,3,15,4690,472,572,1044,"21 de agosto de 1994"
9,3,15,4691,682,710,1392,"21 de agosto de 1994"
9,3,15,4692,537,590,1127,"21 de agosto de 1994"
9,3,15,4693,628,665,1293,"21 de agosto de 1994"
9,3,15,4694,527,665,1192,"21 de agosto de 1994"
9,3,15,4695,403,436,839,"21 de agosto de 1994"
9,3,15,4696,552,628,1180,"21 de agosto de 1994"
9,3,15,4697,447,515,962,"21 de agosto de 1994"
9,3,15,4698,568,607,1175,"21 de agosto de 1994"
9,3,15,4699,580,638,1218,"21 de agosto de 1994"
9,3,15,4700,655,699,1354,"21 de agosto de 1994"
9,3,15,4701,377,458,835,"21 de agosto de 1994"
9,3,15,4702,608,658,1266,"21 de agosto de 1994"
9,3,15,4703,482,491,973,"21 de agosto de 1994"
9,3,15,4704,622,612,1234,"21 de agosto de 1994"
9,3,15,4705,441,498,939,"21 de agosto de 1994"
9,3,15,4706,246,277,523,"21 de agosto de 1994"
9,3,15,4707,461,538,999,"21 de agosto de 1994"
9,3,15,4708,619,661,1280,"21 de agosto de 1994"
9,3,15,4709,736,716,1452,"21 de agosto de 1994"
9,3,15,4710,620,704,1324,"21 de agosto de 1994"
9,3,15,4711,579,615,1194,"21 de agosto de 1994"
9,3,15,4712,361,461,822,"21 de agosto de 1994"
9,3,15,4713,289,347,636,"21 de agosto de 1994"
9,3,15,4714,387,418,805,"21 de agosto de 1994"
9,3,15,4715,251,259,510,"21 de agosto de 1994"
9,3,15,4716,332,399,731,"21 de agosto de 1994"
9,3,15,4717,417,521,938,"21 de agosto de 1994"
9,3,15,4718,250,272,522,"21 de agosto de 1994"
9,3,15,4719,218,260,478,"21 de agosto de 1994"
9,3,15,4720,330,377,707,"21 de agosto de 1994"
9,3,15,4721,324,320,644,"21 de agosto de 1994"
9,3,15,4722,380,395,775,"21 de agosto de 1994"
9,3,15,4723,264,280,544,"21 de agosto de 1994"
9,4,15,4724,493,544,1037,"21 de agosto de 1994"
9,4,15,4725,440,504,944,"21 de agosto de 1994"
9,4,15,4726,239,278,517,"21 de agosto de 1994"
9,4,15,5224,0,1,1,"21 de agosto de 1994"
9,4,17,5183,526,620,1146,"21 de agosto de 1994"
9,4,17,5184,595,625,1220,"21 de agosto de 1994"
9,4,17,5185,558,537,1095,"21 de agosto de 1994"
9,4,17,5186,594,699,1293,"21 de agosto de 1994"
9,4,17,5187,534,638,1172,"21 de agosto de 1994"
9,4,17,5188,139,174,313,"21 de agosto de 1994"
9,4,17,5189,574,663,1237,"21 de agosto de 1994"
9,4,17,5190,492,552,1044,"21 de agosto de 1994"
9,4,17,5191,436,522,958,"21 de agosto de 1994"
9,4,17,5192,486,569,1055,"21 de agosto de 1994"
9,4,17,5193,531,592,1123,"21 de agosto de 1994"
9,4,17,5194,330,367,697,"21 de agosto de 1994"
9,4,17,5195,502,611,1113,"21 de agosto de 1994"
9,4,17,5196,614,695,1309,"21 de agosto de 1994"
9,4,17,5197,601,700,1301,"21 de agosto de 1994"
9,4,17,5198,439,517,956,"21 de agosto de 1994"
9,4,17,5199,600,693,1293,"21 de agosto de 1994"
9,4,17,5200,498,645,1143,"21 de agosto de 1994"
9,4,17,5201,580,649,1229,"21 de agosto de 1994"
9,4,17,5202,613,677,1290,"21 de agosto de 1994"
9,4,17,5203,275,323,598,"21 de agosto de 1994"
9,4,17,5204,470,610,1080,"21 de agosto de 1994"
9,4,17,5205,490,629,1119,"21 de agosto de 1994"
9,4,17,5206,404,455,859,"21 de agosto de 1994"
9,4,17,5207,403,436,839,"21 de agosto de 1994"
9,4,17,5208,421,498,919,"21 de agosto de 1994"
9,4,17,5209,725,753,1478,"21 de agosto de 1994"
9,4,17,5210,495,512,1007,"21 de agosto de 1994"
9,4,17,5211,471,497,968,"21 de agosto de 1994"
9,4,17,5212,367,377,744,"21 de agosto de 1994"
9,4,17,5213,639,682,1321,"21 de agosto de 1994"
9,4,17,5214,333,415,748,"21 de agosto de 1994"
9,4,17,5215,486,541,1027,"21 de agosto de 1994"
9,4,17,5216,457,565,1022,"21 de agosto de 1994"
9,4,17,5217,508,561,1069,"21 de agosto de 1994"
9,4,17,5218,652,711,1363,"21 de agosto de 1994"
9,4,17,5219,648,748,1396,"21 de agosto de 1994"
9,4,17,5220,459,547,1006,"21 de agosto de 1994"
9,4,17,5221,559,643,1202,"21 de agosto de 1994"
9,4,17,5222,355,405,760,"21 de agosto de 1994"
9,4,17,5223,493,576,1069,"21 de agosto de 1994"
9,4,17,5224,754,790,1544,"21 de agosto de 1994"
9,4,17,5225,539,600,1139,"21 de agosto de 1994"
9,4,17,5226,708,789,1497,"21 de agosto de 1994"
9,4,17,5227,541,561,1102,"21 de agosto de 1994"
9,4,17,5228,527,610,1137,"21 de agosto de 1994"
9,4,17,5229,675,769,1444,"21 de agosto de 1994"
9,4,17,5230,605,657,1262,"21 de agosto de 1994"
9,4,17,5231,536,604,1140,"21 de agosto de 1994"
9,4,17,5232,636,690,1326,"21 de agosto de 1994"
9,4,17,5233,444,514,958,"21 de agosto de 1994"
9,4,17,5234,562,609,1171,"21 de agosto de 1994"
9,4,17,5235,457,456,913,"21 de agosto de 1994"
9,4,17,5236,584,633,1217,"21 de agosto de 1994"
9,4,17,5237,560,630,1190,"21 de agosto de 1994"
9,4,17,5238,443,488,931,"21 de agosto de 1994"
9,4,17,5239,442,457,899,"21 de agosto de 1994"
9,4,17,5240,320,338,658,"21 de agosto de 1994"
9,4,17,5241,387,434,821,"21 de agosto de 1994"
9,4,17,5242,278,332,610,"21 de agosto de 1994"
9,4,17,5243,535,674,1209,"21 de agosto de 1994"
9,4,17,5244,288,312,600,"21 de agosto de 1994"
9,4,17,5245,371,449,820,"21 de agosto de 1994"
9,4,17,5246,449,503,952,"21 de agosto de 1994"
9,4,17,5247,355,377,732,"21 de agosto de 1994"
9,4,17,5248,234,249,483,"21 de agosto de 1994"
9,5,15,4727,621,652,1273,"21 de agosto de 1994"
9,5,15,4728,427,447,874,"21 de agosto de 1994"
9,5,15,4729,462,501,963,"21 de agosto de 1994"
9,5,15,4730,463,447,910,"21 de agosto de 1994"
9,5,15,4731,661,748,1409,"21 de agosto de 1994"
9,5,15,4732,558,569,1127,"21 de agosto de 1994"
9,5,15,4733,446,502,948,"21 de agosto de 1994"
9,5,15,4734,602,675,1277,"21 de agosto de 1994"
9,5,15,4735,559,622,1181,"21 de agosto de 1994"
9,5,15,4736,565,611,1176,"21 de agosto de 1994"
9,5,15,4737,773,758,1531,"21 de agosto de 1994"
9,5,15,4738,635,669,1304,"21 de agosto de 1994"
9,5,15,4739,471,568,1039,"21 de agosto de 1994"
9,5,15,4740,470,517,987,"21 de agosto de 1994"
9,5,15,4741,591,632,1223,"21 de agosto de 1994"
9,5,15,4742,496,533,1029,"21 de agosto de 1994"
9,5,15,4743,560,651,1211,"21 de agosto de 1994"
9,5,15,4744,479,510,989,"21 de agosto de 1994"
9,5,15,4745,473,491,964,"21 de agosto de 1994"
9,5,15,4746,459,504,963,"21 de agosto de 1994"
9,5,15,4747,383,383,766,"21 de agosto de 1994"
9,5,15,4748,643,494,1137,"21 de agosto de 1994"
9,5,15,4749,384,397,781,"21 de agosto de 1994"
9,5,15,4750,504,533,1037,"21 de agosto de 1994"
9,5,15,4751,599,681,1280,"21 de agosto de 1994"
9,5,15,4752,513,528,1041,"21 de agosto de 1994"
9,5,15,4753,628,628,1256,"21 de agosto de 1994"
9,5,15,4754,692,703,1395,"21 de agosto de 1994"
9,5,15,4755,492,515,1007,"21 de agosto de 1994"
9,5,15,4756,461,524,985,"21 de agosto de 1994"
9,5,15,4757,479,560,1039,"21 de agosto de 1994"
9,5,15,4758,444,454,898,"21 de agosto de 1994"
9,5,15,4759,334,452,786,"21 de agosto de 1994"
9,5,17,4734,1,0,1,"21 de agosto de 1994"
9,5,17,5249,538,579,1117,"21 de agosto de 1994"
9,5,17,5250,600,617,1217,"21 de agosto de 1994"
9,5,17,5251,434,429,863,"21 de agosto de 1994"
9,5,17,5252,387,424,811,"21 de agosto de 1994"
9,5,17,5253,665,709,1374,"21 de agosto de 1994"
9,5,17,5254,532,550,1082,"21 de agosto de 1994"
9,5,17,5255,435,516,951,"21 de agosto de 1994"
9,5,17,5256,487,509,996,"21 de agosto de 1994"
9,5,17,5257,474,617,1091,"21 de agosto de 1994"
9,5,17,5258,516,566,1082,"21 de agosto de 1994"
9,5,17,5259,553,643,1196,"21 de agosto de 1994"
9,5,17,5260,516,528,1044,"21 de agosto de 1994"
9,5,17,5261,457,488,945,"21 de agosto de 1994"
9,5,17,5262,528,572,1100,"21 de agosto de 1994"
9,5,17,5263,508,508,1016,"21 de agosto de 1994"
9,5,17,5264,480,507,987,"21 de agosto de 1994"
9,5,17,5265,576,495,1071,"21 de agosto de 1994"
9,5,17,5266,425,452,877,"21 de agosto de 1994"
9,5,17,5267,536,567,1103,"21 de agosto de 1994"
9,5,17,5268,640,683,1323,"21 de agosto de 1994"
9,5,17,5269,585,677,1262,"21 de agosto de 1994"
9,5,17,5270,407,436,843,"21 de agosto de 1994"
9,6,15,4760,187,225,412,"21 de agosto de 1994"
9,6,15,4761,675,813,1488,"21 de agosto de 1994"
9,6,15,4762,479,611,1090,"21 de agosto de 1994"
9,6,15,4763,376,504,880,"21 de agosto de 1994"
9,6,15,4764,313,423,736,"21 de agosto de 1994"
9,6,15,4765,513,544,1057,"21 de agosto de 1994"
9,6,15,4766,411,529,940,"21 de agosto de 1994"
9,6,15,4767,533,600,1133,"21 de agosto de 1994"
9,6,15,4768,531,614,1145,"21 de agosto de 1994"
9,6,15,4769,421,580,1001,"21 de agosto de 1994"
9,6,15,4770,628,820,1448,"21 de agosto de 1994"
9,6,15,4771,558,675,1233,"21 de agosto de 1994"
9,6,15,4772,434,566,1000,"21 de agosto de 1994"
9,6,15,4773,320,413,733,"21 de agosto de 1994"
9,6,15,4774,423,475,898,"21 de agosto de 1994"
9,6,15,4775,550,630,1180,"21 de agosto de 1994"
9,6,15,4776,596,692,1288,"21 de agosto de 1994"
9,6,15,4777,485,579,1064,"21 de agosto de 1994"
9,6,15,4778,496,507,1003,"21 de agosto de 1994"
9,6,15,4779,430,550,980,"21 de agosto de 1994"
9,6,15,4780,498,623,1121,"21 de agosto de 1994"
9,6,15,4781,626,740,1366,"21 de agosto de 1994"
9,6,15,4782,453,532,985,"21 de agosto de 1994"
9,6,15,4783,323,387,710,"21 de agosto de 1994"
9,6,15,4784,499,621,1120,"21 de agosto de 1994"
9,6,15,4785,409,511,920,"21 de agosto de 1994"
9,6,15,4786,499,612,1111,"21 de agosto de 1994"
9,6,15,4787,586,696,1282,"21 de agosto de 1994"
9,6,15,4788,321,401,722,"21 de agosto de 1994"
9,6,15,4789,525,664,1189,"21 de agosto de 1994"
9,6,15,4790,462,525,987,"21 de agosto de 1994"
9,6,15,4791,453,543,996,"21 de agosto de 1994"
9,6,15,4792,529,575,1104,"21 de agosto de 1994"
9,6,15,4793,495,593,1088,"21 de agosto de 1994"
9,6,15,4794,423,482,905,"21 de agosto de 1994"
9,6,15,4795,597,747,1344,"21 de agosto de 1994"
9,6,15,4796,610,695,1305,"21 de agosto de 1994"
9,6,15,4797,817,897,1714,"21 de agosto de 1994"
9,6,15,4798,623,715,1338,"21 de agosto de 1994"
9,6,15,4799,417,493,910,"21 de agosto de 1994"
9,6,15,4800,584,682,1266,"21 de agosto de 1994"
9,6,15,4801,712,765,1477,"21 de agosto de 1994"
9,6,15,4802,529,630,1159,"21 de agosto de 1994"
9,6,15,4803,451,529,980,"21 de agosto de 1994"
9,6,15,4804,421,497,918,"21 de agosto de 1994"
9,6,15,4805,383,462,845,"21 de agosto de 1994"
9,6,15,4806,318,390,708,"21 de agosto de 1994"
9,6,15,4807,737,836,1573,"21 de agosto de 1994"
9,6,15,4808,406,519,925,"21 de agosto de 1994"
9,6,15,4809,570,675,1245,"21 de agosto de 1994"
9,6,15,4810,484,602,1086,"21 de agosto de 1994"
9,6,15,4811,469,591,1060,"21 de agosto de 1994"
9,6,15,4812,367,457,824,"21 de agosto de 1994"
9,6,15,4813,335,354,689,"21 de agosto de 1994"
9,6,15,4814,271,352,623,"21 de agosto de 1994"
9,6,15,4815,250,319,569,"21 de agosto de 1994"
9,6,15,4816,270,334,604,"21 de agosto de 1994"
9,6,15,4817,293,346,639,"21 de agosto de 1994"
9,7,14,4269,468,660,1128,"21 de agosto de 1994"
9,7,14,4270,509,606,1115,"21 de agosto de 1994"
9,7,14,4271,522,624,1146,"21 de agosto de 1994"
9,7,14,4272,351,484,835,"21 de agosto de 1994"
9,7,14,4273,583,692,1275,"21 de agosto de 1994"
9,7,14,4274,355,426,781,"21 de agosto de 1994"
9,7,14,4275,325,477,802,"21 de agosto de 1994"
9,7,14,4276,413,569,982,"21 de agosto de 1994"
9,7,14,4277,447,625,1072,"21 de agosto de 1994"
9,7,14,4278,454,560,1014,"21 de agosto de 1994"
9,7,14,4279,470,600,1070,"21 de agosto de 1994"
9,7,14,4280,444,564,1008,"21 de agosto de 1994"
9,7,14,4281,548,669,1217,"21 de agosto de 1994"
9,7,14,4282,458,590,1048,"21 de agosto de 1994"
9,7,14,4283,525,659,1184,"21 de agosto de 1994"
9,7,14,4284,605,727,1332,"21 de agosto de 1994"
9,7,14,4285,513,635,1148,"21 de agosto de 1994"
9,7,14,4286,463,583,1046,"21 de agosto de 1994"
9,7,14,4287,430,563,993,"21 de agosto de 1994"
9,7,14,4288,458,565,1023,"21 de agosto de 1994"
9,7,14,4289,430,527,957,"21 de agosto de 1994"
9,7,14,4290,458,608,1066,"21 de agosto de 1994"
9,7,14,4291,568,757,1325,"21 de agosto de 1994"
9,7,14,4292,354,487,841,"21 de agosto de 1994"
9,7,14,4293,264,400,664,"21 de agosto de 1994"
9,7,14,4294,239,337,576,"21 de agosto de 1994"
9,7,14,4295,313,458,771,"21 de agosto de 1994"
9,7,14,4296,450,597,1047,"21 de agosto de 1994"
9,7,14,4297,501,644,1145,"21 de agosto de 1994"
9,7,14,4298,406,554,960,"21 de agosto de 1994"
9,7,14,4299,358,535,893,"21 de agosto de 1994"
9,7,14,4300,490,587,1077,"21 de agosto de 1994"
9,7,14,4301,487,620,1107,"21 de agosto de 1994"
9,7,14,4302,612,763,1375,"21 de agosto de 1994"
9,7,14,4303,624,783,1407,"21 de agosto de 1994"
9,7,14,4304,481,618,1099,"21 de agosto de 1994"
9,7,14,4305,503,628,1131,"21 de agosto de 1994"
9,7,14,4306,410,573,983,"21 de agosto de 1994"
9,7,14,4307,443,605,1048,"21 de agosto de 1994"
9,7,14,4308,481,687,1168,"21 de agosto de 1994"
9,7,14,4309,505,715,1220,"21 de agosto de 1994"
9,7,14,4310,398,505,903,"21 de agosto de 1994"
9,7,14,4311,621,797,1418,"21 de agosto de 1994"
9,7,14,4312,388,530,918,"21 de agosto de 1994"
9,7,14,4313,318,430,748,"21 de agosto de 1994"
9,7,14,4314,386,538,924,"21 de agosto de 1994"
9,7,14,4315,443,627,1070,"21 de agosto de 1994"
9,7,14,4316,591,679,1270,"21 de agosto de 1994"
9,7,14,4317,351,391,742,"21 de agosto de 1994"
9,7,14,4318,439,495,934,"21 de agosto de 1994"
9,7,14,4319,321,383,704,"21 de agosto de 1994"
9,7,14,4320,422,606,1028,"21 de agosto de 1994"
9,7,14,4321,608,803,1411,"21 de agosto de 1994"
9,7,14,4322,320,469,789,"21 de agosto de 1994"
9,7,14,4323,487,685,1172,"21 de agosto de 1994"
9,7,14,4324,341,476,817,"21 de agosto de 1994"
9,7,14,4325,368,508,876,"21 de agosto de 1994"
9,7,14,4326,179,231,410,"21 de agosto de 1994"
9,7,14,4327,554,658,1212,"21 de agosto de 1994"
9,7,14,4328,266,302,568,"21 de agosto de 1994"
9,7,14,4329,360,456,816,"21 de agosto de 1994"
9,7,14,4330,201,248,449,"21 de agosto de 1994"
9,7,14,4331,413,557,970,"21 de agosto de 1994"
9,7,14,4332,233,332,565,"21 de agosto de 1994"
9,7,14,4333,280,425,705,"21 de agosto de 1994"
9,7,15,4818,584,679,1263,"21 de agosto de 1994"
9,7,15,4819,440,536,976,"21 de agosto de 1994"
9,7,15,4820,533,605,1138,"21 de agosto de 1994"
9,8,10,3163,480,474,954,"21 de agosto de 1994"
9,8,10,3164,453,525,978,"21 de agosto de 1994"
9,8,10,3165,512,589,1101,"21 de agosto de 1994"
9,8,10,3166,417,465,882,"21 de agosto de 1994"
9,8,10,3167,323,390,713,"21 de agosto de 1994"
9,8,10,3168,545,626,1171,"21 de agosto de 1994"
9,8,10,3169,436,514,950,"21 de agosto de 1994"
9,8,10,3170,151,193,344,"21 de agosto de 1994"
9,8,10,3171,405,448,853,"21 de agosto de 1994"
9,8,10,3172,390,485,875,"21 de agosto de 1994"
9,8,10,3173,526,645,1171,"21 de agosto de 1994"
9,8,10,3174,724,519,1243,"21 de agosto de 1994"
9,8,10,3175,958,578,1536,"21 de agosto de 1994"
9,8,10,3176,555,583,1138,"21 de agosto de 1994"
9,8,10,3177,516,549,1065,"21 de agosto de 1994"
9,8,10,3178,274,49,323,"21 de agosto de 1994"
9,8,10,3179,674,709,1383,"21 de agosto de 1994"
9,8,16,4912,137,326,463,"21 de agosto de 1994"
9,8,16,4913,287,457,744,"21 de agosto de 1994"
9,8,16,4914,304,467,771,"21 de agosto de 1994"
9,8,16,4915,336,458,794,"21 de agosto de 1994"
9,8,16,4916,283,343,626,"21 de agosto de 1994"
9,8,16,4917,226,322,548,"21 de agosto de 1994"
9,8,16,4918,348,524,872,"21 de agosto de 1994"
9,8,16,4919,226,301,527,"21 de agosto de 1994"
9,8,16,4920,388,454,842,"21 de agosto de 1994"
9,8,16,4921,621,710,1331,"21 de agosto de 1994"
9,8,16,4922,635,752,1387,"21 de agosto de 1994"
9,8,16,4923,317,512,829,"21 de agosto de 1994"
9,8,16,4924,232,357,589,"21 de agosto de 1994"
9,8,16,4925,263,368,631,"21 de agosto de 1994"
9,8,16,4926,265,363,628,"21 de agosto de 1994"
9,8,16,4927,264,373,637,"21 de agosto de 1994"
9,8,16,4928,243,363,606,"21 de agosto de 1994"
9,8,16,4929,272,341,613,"21 de agosto de 1994"
9,8,16,4930,290,392,682,"21 de agosto de 1994"
9,8,16,4931,269,415,684,"21 de agosto de 1994"
9,8,16,4932,344,504,848,"21 de agosto de 1994"
9,8,16,4933,312,515,827,"21 de agosto de 1994"
9,8,16,4934,340,537,877,"21 de agosto de 1994"
9,8,16,4935,461,689,1150,"21 de agosto de 1994"
9,8,16,4936,255,345,600,"21 de agosto de 1994"
9,8,16,4937,452,607,1059,"21 de agosto de 1994"
9,8,16,4938,328,537,865,"21 de agosto de 1994"
9,8,16,4939,384,647,1031,"21 de agosto de 1994"
9,8,16,4940,348,518,866,"21 de agosto de 1994"
9,8,16,4941,220,338,558,"21 de agosto de 1994"
9,8,16,4942,302,403,705,"21 de agosto de 1994"
9,8,16,4943,317,443,760,"21 de agosto de 1994"
9,8,16,4944,447,618,1065,"21 de agosto de 1994"
9,8,16,4945,402,541,943,"21 de agosto de 1994"
9,8,16,4946,431,587,1018,"21 de agosto de 1994"
9,8,16,4947,410,475,885,"21 de agosto de 1994"
9,8,16,4948,148,214,362,"21 de agosto de 1994"
9,8,16,4949,356,454,810,"21 de agosto de 1994"
9,8,16,4950,371,483,854,"21 de agosto de 1994"
9,8,16,4951,457,576,1033,"21 de agosto de 1994"
9,8,16,4952,682,772,1454,"21 de agosto de 1994"
9,8,16,4953,399,510,909,"21 de agosto de 1994"
9,8,16,4954,557,751,1308,"21 de agosto de 1994"
9,8,16,4955,356,481,837,"21 de agosto de 1994"
9,8,16,4956,534,630,1164,"21 de agosto de 1994"
9,8,16,4957,393,421,814,"21 de agosto de 1994"
9,8,16,4958,562,640,1202,"21 de agosto de 1994"
9,8,16,4959,679,757,1436,"21 de agosto de 1994"
9,8,16,4960,654,723,1377,"21 de agosto de 1994"
9,8,16,4961,437,546,983,"21 de agosto de 1994"
9,8,16,4962,558,737,1295,"21 de agosto de 1994"
9,8,16,4963,486,662,1148,"21 de agosto de 1994"
9,8,16,4964,407,470,877,"21 de agosto de 1994"
9,8,16,4965,494,640,1134,"21 de agosto de 1994"
9,8,16,4966,389,479,868,"21 de agosto de 1994"
9,8,16,4967,198,252,450,"21 de agosto de 1994"
9,8,16,4968,453,595,1048,"21 de agosto de 1994"
9,8,16,4969,543,634,1177,"21 de agosto de 1994"
9,8,16,4970,631,832,1463,"21 de agosto de 1994"
9,8,16,4971,474,696,1170,"21 de agosto de 1994"
9,8,16,4972,691,742,1433,"21 de agosto de 1994"
9,8,16,4973,483,567,1050,"21 de agosto de 1994"
9,8,16,4974,521,643,1164,"21 de agosto de 1994"
9,8,16,4975,479,529,1008,"21 de agosto de 1994"
9,8,16,4976,579,651,1230,"21 de agosto de 1994"
9,8,16,4977,561,589,1150,"21 de agosto de 1994"
9,8,16,4978,414,500,914,"21 de agosto de 1994"
9,8,16,4979,534,679,1213,"21 de agosto de 1994"
9,8,16,4980,114,201,315,"21 de agosto de 1994"
9,8,16,4981,931,194,1125,"21 de agosto de 1994"
9,8,16,4982,280,359,639,"21 de agosto de 1994"
9,8,16,4983,147,212,359,"21 de agosto de 1994"
9,8,16,4984,203,289,492,"21 de agosto de 1994"
9,8,16,4985,466,495,961,"21 de agosto de 1994"
9,8,16,4986,161,200,361,"21 de agosto de 1994"
9,8,16,4987,209,297,506,"21 de agosto de 1994"
9,8,16,4988,238,13,251,"21 de agosto de 1994"
9,8,16,4989,912,0,912,"21 de agosto de 1994"
9,8,16,4990,487,77,564,"21 de agosto de 1994"
9,8,16,4991,460,13,473,"21 de agosto de 1994"
9,8,16,4992,395,507,902,"21 de agosto de 1994"
9,8,16,4993,437,210,647,"21 de agosto de 1994"
9,8,16,4994,323,378,701,"21 de agosto de 1994"
9,9,2,1,430,462,892,"21 de agosto de 1994"
9,9,2,2,519,598,1117,"21 de agosto de 1994"
9,9,2,3,473,518,991,"21 de agosto de 1994"
9,9,2,4,478,539,1017,"21 de agosto de 1994"
9,9,2,5,418,433,851,"21 de agosto de 1994"
9,9,2,6,445,481,926,"21 de agosto de 1994"
9,9,2,7,393,470,863,"21 de agosto de 1994"
9,9,2,8,568,587,1155,"21 de agosto de 1994"
9,9,2,9,410,430,840,"21 de agosto de 1994"
9,9,2,10,505,582,1087,"21 de agosto de 1994"
9,9,2,11,385,438,823,"21 de agosto de 1994"
9,9,2,12,286,411,697,"21 de agosto de 1994"
9,9,2,13,498,623,1121,"21 de agosto de 1994"
9,9,2,14,341,457,798,"21 de agosto de 1994"
9,9,2,15,390,498,888,"21 de agosto de 1994"
9,9,2,16,524,622,1146,"21 de agosto de 1994"
9,9,2,17,416,440,856,"21 de agosto de 1994"
9,9,2,18,428,469,897,"21 de agosto de 1994"
9,9,2,19,411,475,886,"21 de agosto de 1994"
9,9,2,20,399,470,869,"21 de agosto de 1994"
9,9,2,21,476,501,977,"21 de agosto de 1994"
9,9,2,22,537,557,1094,"21 de agosto de 1994"
9,9,2,23,376,401,777,"21 de agosto de 1994"
9,9,2,24,439,492,931,"21 de agosto de 1994"
9,9,2,25,336,403,739,"21 de agosto de 1994"
9,9,2,26,400,461,861,"21 de agosto de 1994"
9,9,2,27,463,505,968,"21 de agosto de 1994"
9,9,2,28,561,565,1126,"21 de agosto de 1994"
9,9,2,29,453,499,952,"21 de agosto de 1994"
9,9,2,30,533,563,1096,"21 de agosto de 1994"
9,9,2,31,520,598,1118,"21 de agosto de 1994"
9,9,2,32,390,488,878,"21 de agosto de 1994"
9,9,2,33,403,484,887,"21 de agosto de 1994"
9,9,2,34,372,428,800,"21 de agosto de 1994"
9,9,2,35,424,507,931,"21 de agosto de 1994"
9,9,2,36,427,544,971,"21 de agosto de 1994"
9,9,2,37,428,558,986,"21 de agosto de 1994"
9,9,2,38,416,465,881,"21 de agosto de 1994"
9,9,2,39,456,543,999,"21 de agosto de 1994"
9,9,2,40,386,436,822,"21 de agosto de 1994"
9,9,2,41,407,484,891,"21 de agosto de 1994"
9,9,2,42,437,508,945,"21 de agosto de 1994"
9,9,2,43,423,394,817,"21 de agosto de 1994"
9,9,2,44,351,463,814,"21 de agosto de 1994"
9,9,2,45,414,532,946,"21 de agosto de 1994"
9,9,2,46,291,397,688,"21 de agosto de 1994"
9,9,2,47,498,563,1061,"21 de agosto de 1994"
9,9,2,48,570,682,1252,"21 de agosto de 1994"
9,9,2,49,407,447,854,"21 de agosto de 1994"
9,9,2,50,437,525,962,"21 de agosto de 1994"
9,9,2,51,561,601,1162,"21 de agosto de 1994"
9,9,2,52,398,511,909,"21 de agosto de 1994"
9,9,2,53,362,437,799,"21 de agosto de 1994"
9,9,2,54,609,628,1237,"21 de agosto de 1994"
9,9,2,55,415,499,914,"21 de agosto de 1994"
9,9,16,4995,401,442,843,"21 de agosto de 1994"
9,9,16,4996,321,421,742,"21 de agosto de 1994"
9,9,16,4997,592,689,1281,"21 de agosto de 1994"
9,9,16,4998,421,539,960,"21 de agosto de 1994"
9,9,16,4999,588,711,1299,"21 de agosto de 1994"
9,9,16,5000,411,507,918,"21 de agosto de 1994"
9,9,16,5001,592,623,1215,"21 de agosto de 1994"
9,9,16,5002,433,544,977,"21 de agosto de 1994"
9,9,16,5003,545,647,1192,"21 de agosto de 1994"
9,9,16,5004,385,487,872,"21 de agosto de 1994"
9,9,16,5005,396,517,913,"21 de agosto de 1994"
9,9,16,5006,534,601,1135,"21 de agosto de 1994"
9,9,16,5007,639,703,1342,"21 de agosto de 1994"
9,9,16,5008,527,610,1137,"21 de agosto de 1994"
9,9,16,5009,444,493,937,"21 de agosto de 1994"
9,9,16,5010,274,336,610,"21 de agosto de 1994"
9,9,16,5011,313,26,339,"21 de agosto de 1994"
9,9,16,5012,241,301,542,"21 de agosto de 1994"
9,10,5,821,463,479,942,"21 de agosto de 1994"
9,10,5,822,450,416,866,"21 de agosto de 1994"
9,10,5,823,517,527,1044,"21 de agosto de 1994"
9,10,5,824,633,613,1246,"21 de agosto de 1994"
9,10,5,825,424,461,885,"21 de agosto de 1994"
9,10,5,826,336,361,697,"21 de agosto de 1994"
9,10,5,827,555,591,1146,"21 de agosto de 1994"
9,10,5,828,513,519,1032,"21 de agosto de 1994"
9,10,5,829,471,476,947,"21 de agosto de 1994"
9,10,5,830,412,455,867,"21 de agosto de 1994"
9,10,5,831,480,492,972,"21 de agosto de 1994"
9,10,5,832,473,508,981,"21 de agosto de 1994"
9,10,5,833,446,502,948,"21 de agosto de 1994"
9,10,5,834,403,403,806,"21 de agosto de 1994"
9,10,5,835,663,671,1334,"21 de agosto de 1994"
9,10,5,836,383,384,767,"21 de agosto de 1994"
9,10,5,837,471,509,980,"21 de agosto de 1994"
9,10,5,838,445,482,927,"21 de agosto de 1994"
9,10,5,839,509,536,1045,"21 de agosto de 1994"
9,10,5,840,493,513,1006,"21 de agosto de 1994"
9,10,5,841,559,608,1167,"21 de agosto de 1994"
9,10,5,842,569,591,1160,"21 de agosto de 1994"
9,10,5,843,601,622,1223,"21 de agosto de 1994"
9,10,5,844,510,575,1085,"21 de agosto de 1994"
9,10,5,845,413,467,880,"21 de agosto de 1994"
9,10,5,846,485,556,1041,"21 de agosto de 1994"
9,10,5,847,279,266,545,"21 de agosto de 1994"
9,10,5,848,529,514,1043,"21 de agosto de 1994"
9,10,5,849,561,574,1135,"21 de agosto de 1994"
9,10,5,850,536,588,1124,"21 de agosto de 1994"
9,10,5,851,424,502,926,"21 de agosto de 1994"
9,10,5,852,743,827,1570,"21 de agosto de 1994"
9,10,5,853,473,503,976,"21 de agosto de 1994"
9,10,5,854,541,606,1147,"21 de agosto de 1994"
9,10,5,855,438,523,961,"21 de agosto de 1994"
9,10,5,856,467,511,978,"21 de agosto de 1994"
9,10,5,857,494,560,1054,"21 de agosto de 1994"
9,10,5,858,409,478,887,"21 de agosto de 1994"
9,10,5,859,655,667,1322,"21 de agosto de 1994"
9,10,5,860,624,656,1280,"21 de agosto de 1994"
9,10,5,861,451,489,940,"21 de agosto de 1994"
9,10,5,862,204,268,472,"21 de agosto de 1994"
9,10,5,863,450,460,910,"21 de agosto de 1994"
9,10,5,864,443,460,903,"21 de agosto de 1994"
9,10,5,865,548,602,1150,"21 de agosto de 1994"
9,10,5,866,461,498,959,"21 de agosto de 1994"
9,10,5,867,388,444,832,"21 de agosto de 1994"
9,10,5,868,410,424,834,"21 de agosto de 1994"
9,10,5,869,411,507,918,"21 de agosto de 1994"
9,10,5,870,453,436,889,"21 de agosto de 1994"
9,10,5,871,496,566,1062,"21 de agosto de 1994"
9,10,5,872,433,464,897,"21 de agosto de 1994"
9,10,5,873,476,538,1014,"21 de agosto de 1994"
9,10,5,874,479,545,1024,"21 de agosto de 1994"
9,10,5,875,603,647,1250,"21 de agosto de 1994"
9,10,5,876,426,486,912,"21 de agosto de 1994"
9,10,5,877,577,603,1180,"21 de agosto de 1994"
9,10,5,878,484,492,976,"21 de agosto de 1994"
9,10,5,879,367,379,746,"21 de agosto de 1994"
9,10,5,880,398,378,776,"21 de agosto de 1994"
9,10,5,881,537,559,1096,"21 de agosto de 1994"
9,10,5,882,457,514,971,"21 de agosto de 1994"
9,10,5,883,406,468,874,"21 de agosto de 1994"
9,10,5,884,506,519,1025,"21 de agosto de 1994"
9,10,5,885,484,547,1031,"21 de agosto de 1994"
9,10,5,886,388,428,816,"21 de agosto de 1994"
9,10,5,887,563,560,1123,"21 de agosto de 1994"
9,10,5,888,626,663,1289,"21 de agosto de 1994"
9,10,5,889,462,553,1015,"21 de agosto de 1994"
9,10,5,890,530,539,1069,"21 de agosto de 1994"
9,10,5,891,492,507,999,"21 de agosto de 1994"
9,10,5,892,418,489,907,"21 de agosto de 1994"
9,10,5,893,478,528,1006,"21 de agosto de 1994"
9,10,5,894,411,439,850,"21 de agosto de 1994"
9,10,5,895,492,501,993,"21 de agosto de 1994"
9,10,5,896,491,545,1036,"21 de agosto de 1994"
9,10,5,897,440,531,971,"21 de agosto de 1994"
9,10,5,898,372,399,771,"21 de agosto de 1994"
9,10,5,899,449,537,986,"21 de agosto de 1994"
9,10,5,900,540,577,1117,"21 de agosto de 1994"
9,10,5,901,493,489,982,"21 de agosto de 1994"
9,10,5,902,478,526,1004,"21 de agosto de 1994"
9,10,5,903,490,512,1002,"21 de agosto de 1994"
9,10,5,904,520,556,1076,"21 de agosto de 1994"
9,10,5,905,593,599,1192,"21 de agosto de 1994"
9,10,5,906,492,475,967,"21 de agosto de 1994"
9,10,5,907,392,438,830,"21 de agosto de 1994"
9,10,5,908,490,532,1022,"21 de agosto de 1994"
9,10,5,909,478,501,979,"21 de agosto de 1994"
9,10,5,910,556,603,1159,"21 de agosto de 1994"
9,10,5,911,382,426,808,"21 de agosto de 1994"
9,10,5,912,483,466,949,"21 de agosto de 1994"
9,10,5,913,533,608,1141,"21 de agosto de 1994"
9,10,5,914,513,579,1092,"21 de agosto de 1994"
9,10,5,915,550,609,1159,"21 de agosto de 1994"
9,10,5,916,525,558,1083,"21 de agosto de 1994"
9,10,5,917,531,541,1072,"21 de agosto de 1994"
9,10,5,918,512,546,1058,"21 de agosto de 1994"
9,10,5,919,525,536,1061,"21 de agosto de 1994"
9,10,5,920,519,541,1060,"21 de agosto de 1994"
9,10,5,921,472,529,1001,"21 de agosto de 1994"
9,10,5,922,528,517,1045,"21 de agosto de 1994"
9,10,5,923,488,468,956,"21 de agosto de 1994"
9,10,5,924,427,425,852,"21 de agosto de 1994"
9,10,5,925,436,430,866,"21 de agosto de 1994"
9,10,5,926,480,507,987,"21 de agosto de 1994"
9,10,5,927,535,534,1069,"21 de agosto de 1994"
9,10,5,928,289,321,610,"21 de agosto de 1994"
9,10,5,929,524,522,1046,"21 de agosto de 1994"
9,10,5,930,382,426,808,"21 de agosto de 1994"
9,10,5,931,469,535,1004,"21 de agosto de 1994"
9,10,5,932,303,347,650,"21 de agosto de 1994"
9,10,5,933,332,373,705,"21 de agosto de 1994"
9,10,5,934,307,331,638,"21 de agosto de 1994"
9,10,5,935,302,379,681,"21 de agosto de 1994"
9,10,5,936,397,438,835,"21 de agosto de 1994"
9,10,5,937,479,502,981,"21 de agosto de 1994"
9,10,5,938,457,478,935,"21 de agosto de 1994"
9,10,5,939,493,507,1000,"21 de agosto de 1994"
9,10,5,940,470,490,960,"21 de agosto de 1994"
9,10,5,941,488,514,1002,"21 de agosto de 1994"
9,10,5,942,314,344,658,"21 de agosto de 1994"
9,10,5,943,533,557,1090,"21 de agosto de 1994"
9,10,5,944,440,512,952,"21 de agosto de 1994"
9,10,5,945,407,426,833,"21 de agosto de 1994"
9,10,5,946,481,551,1032,"21 de agosto de 1994"
9,10,5,947,232,248,480,"21 de agosto de 1994"
9,10,5,948,437,495,932,"21 de agosto de 1994"
9,10,5,949,449,511,960,"21 de agosto de 1994"
9,10,5,950,337,377,714,"21 de agosto de 1994"
9,10,5,951,384,460,844,"21 de agosto de 1994"
9,10,5,952,330,355,685,"21 de agosto de 1994"
9,10,5,953,542,594,1136,"21 de agosto de 1994"
9,10,5,954,377,414,791,"21 de agosto de 1994"
9,10,5,955,505,640,1145,"21 de agosto de 1994"
9,10,5,956,387,394,781,"21 de agosto de 1994"
9,10,5,957,311,311,622,"21 de agosto de 1994"
9,10,5,958,405,489,894,"21 de agosto de 1994"
9,10,5,959,427,506,933,"21 de agosto de 1994"
9,10,5,960,275,347,622,"21 de agosto de 1994"
9,10,5,961,376,509,885,"21 de agosto de 1994"
9,10,5,962,303,398,701,"21 de agosto de 1994"
9,10,5,963,329,371,700,"21 de agosto de 1994"
9,10,5,964,339,401,740,"21 de agosto de 1994"
9,10,5,965,285,311,596,"21 de agosto de 1994"
9,10,5,966,553,581,1134,"21 de agosto de 1994"
9,10,5,967,455,485,940,"21 de agosto de 1994"
9,10,5,968,432,442,874,"21 de agosto de 1994"
9,10,5,969,464,508,972,"21 de agosto de 1994"
9,10,5,970,443,475,918,"21 de agosto de 1994"
9,10,5,971,499,505,1004,"21 de agosto de 1994"
9,10,5,972,466,481,947,"21 de agosto de 1994"
9,10,5,973,272,301,573,"21 de agosto de 1994"
9,10,5,974,458,511,969,"21 de agosto de 1994"
9,10,5,975,515,544,1059,"21 de agosto de 1994"
9,10,5,976,411,434,845,"21 de agosto de 1994"
9,10,5,977,377,438,815,"21 de agosto de 1994"
9,10,5,978,269,298,567,"21 de agosto de 1994"
9,10,5,979,270,309,579,"21 de agosto de 1994"
9,10,5,980,365,400,765,"21 de agosto de 1994"
9,10,5,981,264,343,607,"21 de agosto de 1994"
9,10,5,982,414,431,845,"21 de agosto de 1994"
9,10,5,983,304,379,683,"21 de agosto de 1994"
9,10,5,984,349,430,779,"21 de agosto de 1994"
9,10,5,985,248,284,532,"21 de agosto de 1994"
9,10,5,986,373,408,781,"21 de agosto de 1994"
9,10,5,987,473,539,1012,"21 de agosto de 1994"
9,10,5,988,305,321,626,"21 de agosto de 1994"
9,10,5,989,359,416,775,"21 de agosto de 1994"
9,10,5,990,380,418,798,"21 de agosto de 1994"
9,10,5,991,377,479,856,"21 de agosto de 1994"
9,10,5,992,284,305,589,"21 de agosto de 1994"
9,10,5,993,355,372,727,"21 de agosto de 1994"
9,10,5,994,494,517,1011,"21 de agosto de 1994"
9,10,5,995,469,536,1005,"21 de agosto de 1994"
9,10,5,996,451,500,951,"21 de agosto de 1994"
9,10,5,997,201,231,432,"21 de agosto de 1994"
9,10,5,998,494,506,1000,"21 de agosto de 1994"
9,10,5,999,532,582,1114,"21 de agosto de 1994"
9,10,5,1000,488,517,1005,"21 de agosto de 1994"
9,10,5,1001,486,519,1005,"21 de agosto de 1994"
9,10,5,1002,642,689,1331,"21 de agosto de 1994"
9,10,5,1003,456,510,966,"21 de agosto de 1994"
9,10,5,1004,493,564,1057,"21 de agosto de 1994"
9,10,5,1005,373,409,782,"21 de agosto de 1994"
9,10,5,1006,385,442,827,"21 de agosto de 1994"
9,10,5,1007,267,296,563,"21 de agosto de 1994"
9,10,5,1008,420,467,887,"21 de agosto de 1994"
9,10,5,1009,507,540,1047,"21 de agosto de 1994"
9,10,5,1010,353,407,760,"21 de agosto de 1994"
9,10,5,1011,325,362,687,"21 de agosto de 1994"
9,10,5,1012,260,308,568,"21 de agosto de 1994"
9,10,5,1013,365,401,766,"21 de agosto de 1994"
9,10,5,1014,607,659,1266,"21 de agosto de 1994"
9,10,5,1015,501,586,1087,"21 de agosto de 1994"
9,10,5,1016,473,521,994,"21 de agosto de 1994"
9,10,5,1017,438,483,921,"21 de agosto de 1994"
9,10,5,1018,284,264,548,"21 de agosto de 1994"
9,10,5,1019,390,480,870,"21 de agosto de 1994"
9,10,5,1020,345,405,750,"21 de agosto de 1994"
9,10,5,1021,328,376,704,"21 de agosto de 1994"
9,10,5,1022,391,410,801,"21 de agosto de 1994"
9,10,5,1023,404,456,860,"21 de agosto de 1994"
9,10,5,1024,387,418,805,"21 de agosto de 1994"
9,10,5,1025,397,467,864,"21 de agosto de 1994"
9,10,5,1026,440,528,968,"21 de agosto de 1994"
9,10,5,1027,507,529,1036,"21 de agosto de 1994"
9,10,5,1028,169,173,342,"21 de agosto de 1994"
9,10,5,1029,656,762,1418,"21 de agosto de 1994"
9,10,5,1030,376,457,833,"21 de agosto de 1994"
9,10,5,1031,431,505,936,"21 de agosto de 1994"
9,10,5,1032,354,414,768,"21 de agosto de 1994"
9,10,5,1033,313,358,671,"21 de agosto de 1994"
9,10,5,1034,292,380,672,"21 de agosto de 1994"
9,10,5,1035,188,194,382,"21 de agosto de 1994"
9,10,5,1036,293,316,609,"21 de agosto de 1994"
9,10,5,1037,234,281,515,"21 de agosto de 1994"
9,10,5,1038,439,500,939,"21 de agosto de 1994"
9,10,5,1039,278,337,615,"21 de agosto de 1994"
9,10,5,1040,446,534,980,"21 de agosto de 1994"
9,10,5,1041,714,831,1545,"21 de agosto de 1994"
9,10,5,1042,501,495,996,"21 de agosto de 1994"
9,10,5,1043,419,483,902,"21 de agosto de 1994"
9,10,5,1044,387,425,812,"21 de agosto de 1994"
9,10,5,1045,440,513,953,"21 de agosto de 1994"
9,10,5,1046,268,327,595,"21 de agosto de 1994"
9,10,5,1047,434,488,922,"21 de agosto de 1994"
9,10,5,1048,310,384,694,"21 de agosto de 1994"
9,10,5,1049,224,268,492,"21 de agosto de 1994"
9,10,5,1050,333,440,773,"21 de agosto de 1994"
9,10,5,1051,432,517,949,"21 de agosto de 1994"
9,10,5,1052,338,399,737,"21 de agosto de 1994"
9,10,5,1053,326,422,748,"21 de agosto de 1994"
9,10,5,1054,289,333,622,"21 de agosto de 1994"
9,10,5,1055,261,328,589,"21 de agosto de 1994"
9,10,5,1056,484,532,1016,"21 de agosto de 1994"
9,10,5,1057,250,342,592,"21 de agosto de 1994"
9,10,5,1058,254,292,546,"21 de agosto de 1994"
9,10,5,1059,426,541,967,"21 de agosto de 1994"
9,10,5,1060,433,533,966,"21 de agosto de 1994"
9,10,5,1061,504,583,1087,"21 de agosto de 1994"
9,10,5,1062,540,640,1180,"21 de agosto de 1994"
9,10,5,1063,483,551,1034,"21 de agosto de 1994"
9,10,5,1064,518,553,1071,"21 de agosto de 1994"
9,10,5,1065,417,472,889,"21 de agosto de 1994"
9,10,5,1066,378,411,789,"21 de agosto de 1994"
9,10,5,1067,295,396,691,"21 de agosto de 1994"
9,10,5,1068,375,483,858,"21 de agosto de 1994"
9,10,5,1069,445,502,947,"21 de agosto de 1994"
9,10,5,1070,254,341,595,"21 de agosto de 1994"
9,10,5,1071,268,317,585,"21 de agosto de 1994"
9,10,5,1072,144,157,301,"21 de agosto de 1994"
9,10,5,1073,275,281,556,"21 de agosto de 1994"
9,10,5,1074,406,449,855,"21 de agosto de 1994"
9,10,5,1075,246,298,544,"21 de agosto de 1994"
9,10,5,1076,295,363,658,"21 de agosto de 1994"
9,10,5,1077,310,356,666,"21 de agosto de 1994"
9,10,5,1078,274,293,567,"21 de agosto de 1994"
9,11,5,1079,363,473,836,"21 de agosto de 1994"
9,11,5,1080,308,445,753,"21 de agosto de 1994"
9,11,5,1081,331,363,694,"21 de agosto de 1994"
9,11,5,1082,324,411,735,"21 de agosto de 1994"
9,11,5,1083,362,441,803,"21 de agosto de 1994"
9,11,5,1084,370,474,844,"21 de agosto de 1994"
9,11,5,1085,411,458,869,"21 de agosto de 1994"
9,11,5,1086,419,560,979,"21 de agosto de 1994"
9,11,5,1087,366,473,839,"21 de agosto de 1994"
9,11,5,1088,330,425,755,"21 de agosto de 1994"
9,11,5,1089,307,392,699,"21 de agosto de 1994"
9,11,5,1090,385,474,859,"21 de agosto de 1994"
9,11,5,1091,488,614,1102,"21 de agosto de 1994"
9,11,5,1092,410,523,933,"21 de agosto de 1994"
9,11,5,1093,375,508,883,"21 de agosto de 1994"
9,11,5,1094,354,479,833,"21 de agosto de 1994"
9,11,5,1095,327,445,772,"21 de agosto de 1994"
9,11,5,1096,300,455,755,"21 de agosto de 1994"
9,11,5,1097,366,478,844,"21 de agosto de 1994"
9,11,5,1098,462,582,1044,"21 de agosto de 1994"
9,11,5,1099,395,503,898,"21 de agosto de 1994"
9,11,5,1100,418,548,966,"21 de agosto de 1994"
9,11,5,1101,394,434,828,"21 de agosto de 1994"
9,11,5,1102,333,421,754,"21 de agosto de 1994"
9,11,5,1103,363,495,858,"21 de agosto de 1994"
9,11,5,1104,300,380,680,"21 de agosto de 1994"
9,11,5,1105,393,500,893,"21 de agosto de 1994"
9,11,5,1106,468,544,1012,"21 de agosto de 1994"
9,11,5,1107,336,411,747,"21 de agosto de 1994"
9,11,5,1108,339,457,796,"21 de agosto de 1994"
9,11,5,1109,336,484,820,"21 de agosto de 1994"
9,11,5,1110,347,413,760,"21 de agosto de 1994"
9,11,5,1111,259,324,583,"21 de agosto de 1994"
9,11,5,1112,393,486,879,"21 de agosto de 1994"
9,11,5,1113,309,416,725,"21 de agosto de 1994"
9,11,5,1114,410,518,928,"21 de agosto de 1994"
9,11,5,1115,314,432,746,"21 de agosto de 1994"
9,11,5,1116,279,336,615,"21 de agosto de 1994"
9,11,5,1117,387,417,804,"21 de agosto de 1994"
9,11,5,1118,383,507,890,"21 de agosto de 1994"
9,11,5,1119,451,512,963,"21 de agosto de 1994"
9,11,5,1120,382,497,879,"21 de agosto de 1994"
9,11,5,1121,370,451,821,"21 de agosto de 1994"
9,11,5,1122,352,429,781,"21 de agosto de 1994"
9,11,5,1123,347,424,771,"21 de agosto de 1994"
9,11,5,1124,294,381,675,"21 de agosto de 1994"
9,11,5,1125,322,397,719,"21 de agosto de 1994"
9,11,5,1126,384,446,830,"21 de agosto de 1994"
9,11,5,1127,314,402,716,"21 de agosto de 1994"
9,11,5,1128,335,453,788,"21 de agosto de 1994"
9,11,5,1129,266,347,613,"21 de agosto de 1994"
9,11,5,1130,248,364,612,"21 de agosto de 1994"
9,11,5,1131,391,553,944,"21 de agosto de 1994"
9,11,5,1132,310,369,679,"21 de agosto de 1994"
9,11,5,1133,286,350,636,"21 de agosto de 1994"
9,11,5,1134,441,488,929,"21 de agosto de 1994"
9,11,5,1135,422,484,906,"21 de agosto de 1994"
9,11,5,1136,543,593,1136,"21 de agosto de 1994"
9,11,5,1137,548,599,1147,"21 de agosto de 1994"
9,11,5,1138,399,438,837,"21 de agosto de 1994"
9,11,5,1139,274,328,602,"21 de agosto de 1994"
9,11,5,1140,309,372,681,"21 de agosto de 1994"
9,11,5,1141,508,625,1133,"21 de agosto de 1994"
9,11,5,1142,441,498,939,"21 de agosto de 1994"
9,11,5,1143,493,573,1066,"21 de agosto de 1994"
9,11,5,1144,453,533,986,"21 de agosto de 1994"
9,11,5,1145,718,783,1501,"21 de agosto de 1994"
9,11,5,1146,302,354,656,"21 de agosto de 1994"
9,11,5,1147,294,309,603,"21 de agosto de 1994"
9,11,5,4823,0,1,1,"21 de agosto de 1994"
9,11,5,4826,0,1,1,"21 de agosto de 1994"
9,11,15,4821,402,477,879,"21 de agosto de 1994"
9,11,15,4822,733,857,1590,"21 de agosto de 1994"
9,11,15,4823,659,764,1423,"21 de agosto de 1994"
9,11,15,4824,435,453,888,"21 de agosto de 1994"
9,11,15,4825,444,526,970,"21 de agosto de 1994"
9,11,15,4826,658,737,1395,"21 de agosto de 1994"
9,11,15,4827,708,834,1542,"21 de agosto de 1994"
9,11,15,4828,614,668,1282,"21 de agosto de 1994"
9,11,15,4829,378,462,840,"21 de agosto de 1994"
9,11,15,4830,332,374,706,"21 de agosto de 1994"
9,12,5,1148,440,549,989,"21 de agosto de 1994"
9,12,5,1149,468,534,1002,"21 de agosto de 1994"
9,12,5,1150,515,563,1078,"21 de agosto de 1994"
9,12,5,1151,447,532,979,"21 de agosto de 1994"
9,12,5,1152,534,600,1134,"21 de agosto de 1994"
9,12,5,1153,501,570,1071,"21 de agosto de 1994"
9,12,5,1154,534,578,1112,"21 de agosto de 1994"
9,12,5,1155,478,545,1023,"21 de agosto de 1994"
9,12,5,1156,489,534,1023,"21 de agosto de 1994"
9,12,5,1157,424,445,869,"21 de agosto de 1994"
9,12,5,1158,494,550,1044,"21 de agosto de 1994"
9,12,5,1159,479,515,994,"21 de agosto de 1994"
9,12,5,1160,535,582,1117,"21 de agosto de 1994"
9,12,5,1161,412,480,892,"21 de agosto de 1994"
9,12,5,1162,561,599,1160,"21 de agosto de 1994"
9,12,5,1163,438,536,974,"21 de agosto de 1994"
9,12,5,1164,380,425,805,"21 de agosto de 1994"
9,12,5,1165,560,627,1187,"21 de agosto de 1994"
9,12,5,1166,514,601,1115,"21 de agosto de 1994"
9,12,5,1167,407,489,896,"21 de agosto de 1994"
9,12,5,1168,467,552,1019,"21 de agosto de 1994"
9,12,5,1169,467,510,977,"21 de agosto de 1994"
9,12,5,1170,543,590,1133,"21 de agosto de 1994"
9,12,5,1171,465,518,983,"21 de agosto de 1994"
9,12,5,1172,367,415,782,"21 de agosto de 1994"
9,12,5,1173,408,479,887,"21 de agosto de 1994"
9,12,5,1174,437,476,913,"21 de agosto de 1994"
9,12,5,1175,416,452,868,"21 de agosto de 1994"
9,12,5,1176,484,506,990,"21 de agosto de 1994"
9,12,5,1177,547,614,1161,"21 de agosto de 1994"
9,12,5,1178,538,609,1147,"21 de agosto de 1994"
9,12,5,1179,546,603,1149,"21 de agosto de 1994"
9,12,5,1180,500,500,1000,"21 de agosto de 1994"
9,12,5,1181,559,644,1203,"21 de agosto de 1994"
9,12,5,1182,440,548,988,"21 de agosto de 1994"
9,12,5,1183,516,605,1121,"21 de agosto de 1994"
9,12,5,1184,601,647,1248,"21 de agosto de 1994"
9,12,5,1185,552,618,1170,"21 de agosto de 1994"
9,12,5,1186,504,550,1054,"21 de agosto de 1994"
9,12,5,1187,457,538,995,"21 de agosto de 1994"
9,12,5,1188,451,497,948,"21 de agosto de 1994"
9,12,5,1189,488,563,1051,"21 de agosto de 1994"
9,12,5,1190,469,529,998,"21 de agosto de 1994"
9,12,5,1191,444,492,936,"21 de agosto de 1994"
9,12,5,1192,373,431,804,"21 de agosto de 1994"
9,12,5,1193,291,338,629,"21 de agosto de 1994"
9,12,5,1194,456,511,967,"21 de agosto de 1994"
9,12,5,1195,530,602,1132,"21 de agosto de 1994"
9,12,5,1196,412,494,906,"21 de agosto de 1994"
9,12,5,1197,442,484,926,"21 de agosto de 1994"
9,12,5,1198,588,707,1295,"21 de agosto de 1994"
9,12,5,1199,496,593,1089,"21 de agosto de 1994"
9,12,5,1200,503,550,1053,"21 de agosto de 1994"
9,12,5,1201,609,718,1327,"21 de agosto de 1994"
9,12,5,1202,482,559,1041,"21 de agosto de 1994"
9,12,5,1203,478,537,1015,"21 de agosto de 1994"
9,12,5,1204,551,592,1143,"21 de agosto de 1994"
9,12,5,1205,479,533,1012,"21 de agosto de 1994"
9,12,5,1206,361,431,792,"21 de agosto de 1994"
9,12,5,1207,391,467,858,"21 de agosto de 1994"
9,12,5,1208,455,518,973,"21 de agosto de 1994"
9,12,5,1209,474,531,1005,"21 de agosto de 1994"
9,12,5,1210,545,659,1204,"21 de agosto de 1994"
9,12,5,1211,406,496,902,"21 de agosto de 1994"
9,12,5,1212,550,622,1172,"21 de agosto de 1994"
9,12,5,1213,500,586,1086,"21 de agosto de 1994"
9,12,17,5271,332,371,703,"21 de agosto de 1994"
9,12,17,5272,416,448,864,"21 de agosto de 1994"
9,12,17,5273,376,428,804,"21 de agosto de 1994"
9,13,17,5274,514,613,1127,"21 de agosto de 1994"
9,13,17,5275,634,695,1329,"21 de agosto de 1994"
9,13,17,5276,649,756,1405,"21 de agosto de 1994"
9,13,17,5277,639,731,1370,"21 de agosto de 1994"
9,13,17,5278,526,584,1110,"21 de agosto de 1994"
9,13,17,5279,434,507,941,"21 de agosto de 1994"
9,13,17,5280,532,564,1096,"21 de agosto de 1994"
9,13,17,5281,505,559,1064,"21 de agosto de 1994"
9,13,17,5282,267,307,574,"21 de agosto de 1994"
9,13,17,5283,479,481,960,"21 de agosto de 1994"
9,13,17,5284,428,465,893,"21 de agosto de 1994"
9,13,17,5285,475,536,1011,"21 de agosto de 1994"
9,13,17,5286,476,548,1024,"21 de agosto de 1994"
9,13,17,5287,568,654,1222,"21 de agosto de 1994"
9,13,17,5288,426,486,912,"21 de agosto de 1994"
9,13,17,5289,658,741,1399,"21 de agosto de 1994"
9,13,17,5290,374,474,848,"21 de agosto de 1994"
9,13,17,5291,548,589,1137,"21 de agosto de 1994"
9,13,17,5292,695,762,1457,"21 de agosto de 1994"
9,13,17,5293,635,717,1352,"21 de agosto de 1994"
9,13,17,5294,582,655,1237,"21 de agosto de 1994"
9,13,17,5295,472,606,1078,"21 de agosto de 1994"
9,13,17,5296,497,553,1050,"21 de agosto de 1994"
9,13,17,5297,610,693,1303,"21 de agosto de 1994"
9,13,17,5298,488,614,1102,"21 de agosto de 1994"
9,13,17,5299,601,703,1304,"21 de agosto de 1994"
9,13,17,5300,569,673,1242,"21 de agosto de 1994"
9,13,17,5301,479,535,1014,"21 de agosto de 1994"
9,13,17,5302,537,669,1206,"21 de agosto de 1994"
9,13,17,5303,596,678,1274,"21 de agosto de 1994"
9,13,17,5304,191,211,402,"21 de agosto de 1994"
9,13,17,5305,579,665,1244,"21 de agosto de 1994"
9,13,17,5306,597,703,1300,"21 de agosto de 1994"
9,13,17,5307,429,501,930,"21 de agosto de 1994"
9,13,17,5308,626,742,1368,"21 de agosto de 1994"
9,13,17,5309,578,662,1240,"21 de agosto de 1994"
9,13,17,5310,507,636,1143,"21 de agosto de 1994"
9,13,17,5311,407,468,875,"21 de agosto de 1994"
9,13,17,5312,526,630,1156,"21 de agosto de 1994"
9,13,17,5313,396,494,890,"21 de agosto de 1994"
9,13,17,5314,275,374,649,"21 de agosto de 1994"
9,13,17,5315,412,503,915,"21 de agosto de 1994"
9,13,17,5316,471,478,949,"21 de agosto de 1994"
9,13,17,5317,446,512,958,"21 de agosto de 1994"
9,13,17,5318,488,596,1084,"21 de agosto de 1994"
9,13,17,5319,504,598,1102,"21 de agosto de 1994"
9,13,17,5320,511,556,1067,"21 de agosto de 1994"
9,13,17,5321,567,633,1200,"21 de agosto de 1994"
9,13,17,5322,546,637,1183,"21 de agosto de 1994"
9,13,17,5323,517,659,1176,"21 de agosto de 1994"
9,13,17,5324,531,660,1191,"21 de agosto de 1994"
9,13,17,5325,377,413,790,"21 de agosto de 1994"
9,13,17,5326,363,445,808,"21 de agosto de 1994"
9,13,17,5327,376,460,836,"21 de agosto de 1994"
9,13,17,5328,683,786,1469,"21 de agosto de 1994"
9,13,17,5329,523,661,1184,"21 de agosto de 1994"
9,13,17,5330,375,473,848,"21 de agosto de 1994"
9,13,17,5331,308,328,636,"21 de agosto de 1994"
9,13,17,5332,446,496,942,"21 de agosto de 1994"
9,13,17,5333,168,199,367,"21 de agosto de 1994"
9,13,17,5334,294,352,646,"21 de agosto de 1994"
9,13,17,5335,328,433,761,"21 de agosto de 1994"
9,13,17,5336,330,388,718,"21 de agosto de 1994"
9,13,17,5337,255,322,577,"21 de agosto de 1994"
9,14,6,1672,443,472,915,"21 de agosto de 1994"
9,14,6,1673,419,462,881,"21 de agosto de 1994"
9,14,6,1674,394,411,805,"21 de agosto de 1994"
9,14,6,1675,613,696,1309,"21 de agosto de 1994"
9,14,6,1676,551,560,1111,"21 de agosto de 1994"
9,14,6,1677,323,344,667,"21 de agosto de 1994"
9,14,6,1678,565,642,1207,"21 de agosto de 1994"
9,14,6,1679,433,491,924,"21 de agosto de 1994"
9,14,6,1680,419,462,881,"21 de agosto de 1994"
9,14,6,1681,489,542,1031,"21 de agosto de 1994"
9,14,6,1682,331,390,721,"21 de agosto de 1994"
9,14,6,1683,532,577,1109,"21 de agosto de 1994"
9,14,6,1684,444,450,894,"21 de agosto de 1994"
9,14,6,1685,303,356,659,"21 de agosto de 1994"
9,14,6,1686,316,357,673,"21 de agosto de 1994"
9,14,6,1687,490,514,1004,"21 de agosto de 1994"
9,14,6,1688,479,530,1009,"21 de agosto de 1994"
9,14,6,1689,341,392,733,"21 de agosto de 1994"
9,14,6,1690,453,488,941,"21 de agosto de 1994"
9,14,6,1691,562,566,1128,"21 de agosto de 1994"
9,14,6,1692,493,543,1036,"21 de agosto de 1994"
9,14,6,1693,328,385,713,"21 de agosto de 1994"
9,14,6,1694,419,570,989,"21 de agosto de 1994"
9,14,6,1695,251,270,521,"21 de agosto de 1994"
9,14,17,5338,246,292,538,"21 de agosto de 1994"
9,14,17,5339,506,616,1122,"21 de agosto de 1994"
9,14,17,5340,458,525,983,"21 de agosto de 1994"
9,14,17,5341,349,468,817,"21 de agosto de 1994"
9,14,17,5342,381,456,837,"21 de agosto de 1994"
9,14,17,5343,618,754,1372,"21 de agosto de 1994"
9,14,17,5344,455,644,1099,"21 de agosto de 1994"
9,14,17,5345,534,632,1166,"21 de agosto de 1994"
9,14,17,5346,473,629,1102,"21 de agosto de 1994"
9,14,17,5347,528,665,1193,"21 de agosto de 1994"
9,14,17,5348,537,679,1216,"21 de agosto de 1994"
9,14,17,5349,416,586,1002,"21 de agosto de 1994"
9,14,17,5350,515,676,1191,"21 de agosto de 1994"
9,14,17,5351,444,552,996,"21 de agosto de 1994"
9,14,17,5352,480,589,1069,"21 de agosto de 1994"
9,14,17,5353,440,561,1001,"21 de agosto de 1994"
9,14,17,5354,384,497,881,"21 de agosto de 1994"
9,14,17,5355,313,401,714,"21 de agosto de 1994"
9,14,17,5356,370,504,874,"21 de agosto de 1994"
9,14,17,5357,418,518,936,"21 de agosto de 1994"
9,14,17,5358,433,556,989,"21 de agosto de 1994"
9,14,17,5359,471,578,1049,"21 de agosto de 1994"
9,14,17,5360,387,566,953,"21 de agosto de 1994"
9,14,17,5361,522,720,1242,"21 de agosto de 1994"
9,14,17,5362,476,584,1060,"21 de agosto de 1994"
9,14,17,5363,580,720,1300,"21 de agosto de 1994"
9,14,17,5364,583,750,1333,"21 de agosto de 1994"
9,14,17,5365,478,664,1142,"21 de agosto de 1994"
9,14,17,5366,554,754,1308,"21 de agosto de 1994"
9,14,17,5367,411,544,955,"21 de agosto de 1994"
9,14,17,5368,500,624,1124,"21 de agosto de 1994"
9,14,17,5369,617,756,1373,"21 de agosto de 1994"
9,14,17,5370,298,409,707,"21 de agosto de 1994"
9,14,17,5371,479,674,1153,"21 de agosto de 1994"
9,14,17,5372,706,786,1492,"21 de agosto de 1994"
9,14,17,5373,574,716,1290,"21 de agosto de 1994"
9,14,17,5374,446,574,1020,"21 de agosto de 1994"
9,14,17,5375,650,752,1402,"21 de agosto de 1994"
9,14,17,5376,687,809,1496,"21 de agosto de 1994"
9,14,17,5377,473,567,1040,"21 de agosto de 1994"
9,14,17,5378,406,522,928,"21 de agosto de 1994"
9,14,17,5379,489,691,1180,"21 de agosto de 1994"
9,14,17,5380,480,608,1088,"21 de agosto de 1994"
9,14,17,5381,538,665,1203,"21 de agosto de 1994"
9,14,17,5382,597,631,1228,"21 de agosto de 1994"
9,14,17,5383,691,739,1430,"21 de agosto de 1994"
9,14,17,5384,530,622,1152,"21 de agosto de 1994"
9,14,17,5385,666,727,1393,"21 de agosto de 1994"
9,14,17,5386,501,527,1028,"21 de agosto de 1994"
9,14,17,5387,662,747,1409,"21 de agosto de 1994"
9,14,17,5388,451,622,1073,"21 de agosto de 1994"
9,14,17,5389,389,484,873,"21 de agosto de 1994"
9,14,17,5390,375,441,816,"21 de agosto de 1994"
9,14,17,5391,300,382,682,"21 de agosto de 1994"
9,14,17,5392,560,639,1199,"21 de agosto de 1994"
9,14,17,5393,324,392,716,"21 de agosto de 1994"
9,14,17,5394,598,677,1275,"21 de agosto de 1994"
9,14,17,5395,226,259,485,"21 de agosto de 1994"
9,14,17,5396,257,256,513,"21 de agosto de 1994"
9,14,17,5397,199,247,446,"21 de agosto de 1994"
9,14,17,5398,249,273,522,"21 de agosto de 1994"
9,14,17,5399,235,308,543,"21 de agosto de 1994"
9,15,6,1696,660,730,1390,"21 de agosto de 1994"
9,15,6,1697,597,735,1332,"21 de agosto de 1994"
9,15,6,1698,531,606,1137,"21 de agosto de 1994"
9,15,6,1699,424,444,868,"21 de agosto de 1994"
9,15,6,1700,179,201,380,"21 de agosto de 1994"
9,15,6,1701,542,615,1157,"21 de agosto de 1994"
9,15,6,1702,527,632,1159,"21 de agosto de 1994"
9,15,6,1703,573,590,1163,"21 de agosto de 1994"
9,15,6,1704,475,598,1073,"21 de agosto de 1994"
9,15,6,1705,565,638,1203,"21 de agosto de 1994"
9,15,6,1706,465,476,941,"21 de agosto de 1994"
9,15,6,1707,521,588,1109,"21 de agosto de 1994"
9,15,6,1708,511,590,1101,"21 de agosto de 1994"
9,15,6,1709,459,511,970,"21 de agosto de 1994"
9,15,6,1710,422,506,928,"21 de agosto de 1994"
9,15,6,1711,411,429,840,"21 de agosto de 1994"
9,15,6,1712,452,472,924,"21 de agosto de 1994"
9,15,6,1713,430,454,884,"21 de agosto de 1994"
9,15,6,1714,416,448,864,"21 de agosto de 1994"
9,15,6,1715,375,436,811,"21 de agosto de 1994"
9,15,6,1716,510,517,1027,"21 de agosto de 1994"
9,15,6,1717,526,574,1100,"21 de agosto de 1994"
9,15,6,1718,530,603,1133,"21 de agosto de 1994"
9,15,6,1719,467,529,996,"21 de agosto de 1994"
9,15,6,1720,600,652,1252,"21 de agosto de 1994"
9,15,6,1721,454,533,987,"21 de agosto de 1994"
9,15,6,1722,418,481,899,"21 de agosto de 1994"
9,15,6,1723,528,592,1120,"21 de agosto de 1994"
9,15,6,1724,524,570,1094,"21 de agosto de 1994"
9,15,6,1725,484,548,1032,"21 de agosto de 1994"
9,15,6,1726,544,574,1118,"21 de agosto de 1994"
9,15,6,1727,520,557,1077,"21 de agosto de 1994"
9,15,6,1728,416,479,895,"21 de agosto de 1994"
9,15,6,1729,464,495,959,"21 de agosto de 1994"
9,15,6,1730,622,658,1280,"21 de agosto de 1994"
9,15,6,1731,600,690,1290,"21 de agosto de 1994"
9,15,6,1732,415,472,887,"21 de agosto de 1994"
9,15,6,1733,460,509,969,"21 de agosto de 1994"
9,15,6,1734,547,626,1173,"21 de agosto de 1994"
9,15,6,1735,411,474,885,"21 de agosto de 1994"
9,15,6,1736,516,567,1083,"21 de agosto de 1994"
9,15,6,1737,514,565,1079,"21 de agosto de 1994"
9,15,6,1738,478,478,956,"21 de agosto de 1994"
9,15,6,1739,290,320,610,"21 de agosto de 1994"
9,15,6,1740,585,639,1224,"21 de agosto de 1994"
9,15,6,1741,475,532,1007,"21 de agosto de 1994"
9,15,6,1742,550,649,1199,"21 de agosto de 1994"
9,15,6,1743,556,631,1187,"21 de agosto de 1994"
9,15,6,1744,480,551,1031,"21 de agosto de 1994"
9,15,6,1745,437,463,900,"21 de agosto de 1994"
9,15,6,1746,490,497,987,"21 de agosto de 1994"
9,15,6,1747,402,467,869,"21 de agosto de 1994"
9,15,6,1748,508,542,1050,"21 de agosto de 1994"
9,15,6,1749,513,571,1084,"21 de agosto de 1994"
9,15,6,1750,471,522,993,"21 de agosto de 1994"
9,15,6,1751,466,513,979,"21 de agosto de 1994"
9,15,6,1752,489,558,1047,"21 de agosto de 1994"
9,15,6,1753,597,586,1183,"21 de agosto de 1994"
9,15,6,1754,649,714,1363,"21 de agosto de 1994"
9,15,6,1755,538,595,1133,"21 de agosto de 1994"
9,15,6,1756,421,455,876,"21 de agosto de 1994"
9,15,6,1757,413,423,836,"21 de agosto de 1994"
9,15,6,1758,472,481,953,"21 de agosto de 1994"
9,15,6,1759,354,379,733,"21 de agosto de 1994"
9,15,6,1760,96,117,213,"21 de agosto de 1994"
9,15,6,1761,386,419,805,"21 de agosto de 1994"
9,15,6,1762,545,641,1186,"21 de agosto de 1994"
9,15,6,1763,509,568,1077,"21 de agosto de 1994"
9,15,6,1764,446,538,984,"21 de agosto de 1994"
9,15,6,1765,469,534,1003,"21 de agosto de 1994"
9,15,6,1766,507,551,1058,"21 de agosto de 1994"
9,15,6,1767,495,536,1031,"21 de agosto de 1994"
9,15,6,1768,694,764,1458,"21 de agosto de 1994"
9,15,6,1769,594,609,1203,"21 de agosto de 1994"
9,15,6,1770,571,625,1196,"21 de agosto de 1994"
9,15,6,1771,610,692,1302,"21 de agosto de 1994"
9,15,6,1772,642,723,1365,"21 de agosto de 1994"
9,15,6,1773,380,506,886,"21 de agosto de 1994"
9,15,6,1774,418,506,924,"21 de agosto de 1994"
9,15,6,1775,268,381,649,"21 de agosto de 1994"
9,15,6,1776,513,613,1126,"21 de agosto de 1994"
9,15,6,1777,399,465,864,"21 de agosto de 1994"
9,15,6,1778,355,442,797,"21 de agosto de 1994"
9,15,6,1779,450,470,920,"21 de agosto de 1994"
9,15,6,1780,722,715,1437,"21 de agosto de 1994"
9,15,6,1781,526,584,1110,"21 de agosto de 1994"
9,15,6,1782,500,548,1048,"21 de agosto de 1994"
9,15,6,1783,618,668,1286,"21 de agosto de 1994"
9,15,6,1784,602,674,1276,"21 de agosto de 1994"
9,15,6,1785,584,619,1203,"21 de agosto de 1994"
9,15,6,1786,674,768,1442,"21 de agosto de 1994"
9,15,6,1787,636,696,1332,"21 de agosto de 1994"
9,15,6,1788,540,581,1121,"21 de agosto de 1994"
9,15,6,1789,619,689,1308,"21 de agosto de 1994"
9,15,6,1790,508,594,1102,"21 de agosto de 1994"
9,15,6,1791,750,770,1520,"21 de agosto de 1994"
9,15,6,1792,613,624,1237,"21 de agosto de 1994"
9,15,6,1793,498,511,1009,"21 de agosto de 1994"
9,15,6,1794,523,564,1087,"21 de agosto de 1994"
9,15,6,1795,372,383,755,"21 de agosto de 1994"
9,15,6,1796,542,547,1089,"21 de agosto de 1994"
9,15,6,1797,482,506,988,"21 de agosto de 1994"
9,15,6,1798,455,483,938,"21 de agosto de 1994"
9,15,6,1799,514,592,1106,"21 de agosto de 1994"
9,15,6,1800,572,595,1167,"21 de agosto de 1994"
9,15,6,1801,620,661,1281,"21 de agosto de 1994"
9,15,6,1802,645,701,1346,"21 de agosto de 1994"
9,15,6,1803,728,866,1594,"21 de agosto de 1994"
9,15,6,1804,624,663,1287,"21 de agosto de 1994"
9,15,6,1805,558,598,1156,"21 de agosto de 1994"
9,15,6,1806,501,542,1043,"21 de agosto de 1994"
9,15,6,1807,457,538,995,"21 de agosto de 1994"
9,15,6,1808,581,664,1245,"21 de agosto de 1994"
9,15,6,1809,544,580,1124,"21 de agosto de 1994"
9,15,6,1810,637,712,1349,"21 de agosto de 1994"
9,15,6,1811,748,785,1533,"21 de agosto de 1994"
9,15,6,1812,522,567,1089,"21 de agosto de 1994"
9,15,6,1813,594,716,1310,"21 de agosto de 1994"
9,15,6,1814,423,505,928,"21 de agosto de 1994"
9,15,6,1815,512,641,1153,"21 de agosto de 1994"
9,15,6,1816,255,332,587,"21 de agosto de 1994"
9,15,6,1817,356,417,773,"21 de agosto de 1994"
9,15,6,1818,132,202,334,"21 de agosto de 1994"
9,15,6,1819,500,624,1124,"21 de agosto de 1994"
9,15,6,1820,419,542,961,"21 de agosto de 1994"
9,15,6,1821,373,517,890,"21 de agosto de 1994"
9,15,6,1822,399,541,940,"21 de agosto de 1994"
9,15,6,1823,428,542,970,"21 de agosto de 1994"
9,15,6,1824,386,500,886,"21 de agosto de 1994"
9,15,6,1825,329,394,723,"21 de agosto de 1994"
9,15,6,1826,467,615,1082,"21 de agosto de 1994"
9,15,6,1827,299,305,604,"21 de agosto de 1994"
9,15,6,1828,196,183,379,"21 de agosto de 1994"
9,15,6,1829,192,221,413,"21 de agosto de 1994"
9,15,6,1830,539,693,1232,"21 de agosto de 1994"
9,16,14,4334,504,689,1193,"21 de agosto de 1994"
9,16,14,4335,419,636,1055,"21 de agosto de 1994"
9,16,14,4336,463,622,1085,"21 de agosto de 1994"
9,16,14,4337,359,517,876,"21 de agosto de 1994"
9,16,14,4338,451,617,1068,"21 de agosto de 1994"
9,16,14,4339,500,651,1151,"21 de agosto de 1994"
9,16,14,4340,434,627,1061,"21 de agosto de 1994"
9,16,14,4341,361,491,852,"21 de agosto de 1994"
9,16,14,4342,401,597,998,"21 de agosto de 1994"
9,16,14,4343,391,539,930,"21 de agosto de 1994"
9,16,14,4344,359,560,919,"21 de agosto de 1994"
9,16,14,4345,428,677,1105,"21 de agosto de 1994"
9,16,14,4346,334,444,778,"21 de agosto de 1994"
9,16,14,4347,516,690,1206,"21 de agosto de 1994"
9,16,14,4348,501,667,1168,"21 de agosto de 1994"
9,16,14,4349,339,540,879,"21 de agosto de 1994"
9,16,14,4350,431,614,1045,"21 de agosto de 1994"
9,16,14,4351,386,568,954,"21 de agosto de 1994"
9,16,14,4352,455,652,1107,"21 de agosto de 1994"
9,16,14,4353,389,573,962,"21 de agosto de 1994"
9,16,14,4354,479,647,1126,"21 de agosto de 1994"
9,16,14,4355,563,697,1260,"21 de agosto de 1994"
9,16,14,4356,500,640,1140,"21 de agosto de 1994"
9,16,14,4357,538,722,1260,"21 de agosto de 1994"
9,16,14,4358,610,822,1432,"21 de agosto de 1994"
9,16,14,4359,588,703,1291,"21 de agosto de 1994"
9,16,14,4360,538,677,1215,"21 de agosto de 1994"
9,16,14,4361,598,702,1300,"21 de agosto de 1994"
9,16,14,4362,588,759,1347,"21 de agosto de 1994"
9,16,14,4363,470,616,1086,"21 de agosto de 1994"
9,16,14,4364,382,503,885,"21 de agosto de 1994"
9,16,14,4365,551,788,1339,"21 de agosto de 1994"
9,16,14,4366,438,659,1097,"21 de agosto de 1994"
9,16,14,4367,426,620,1046,"21 de agosto de 1994"
9,16,14,4368,435,618,1053,"21 de agosto de 1994"
9,16,14,4369,419,564,983,"21 de agosto de 1994"
9,16,14,4370,467,676,1143,"21 de agosto de 1994"
9,16,14,4371,412,561,973,"21 de agosto de 1994"
9,16,14,4372,374,553,927,"21 de agosto de 1994"
9,16,14,4373,484,670,1154,"21 de agosto de 1994"
9,16,14,4374,553,791,1344,"21 de agosto de 1994"
9,16,14,4375,571,693,1264,"21 de agosto de 1994"
9,16,14,4376,600,741,1341,"21 de agosto de 1994"
9,16,14,4377,698,773,1471,"21 de agosto de 1994"
9,16,14,4378,538,671,1209,"21 de agosto de 1994"
9,16,14,4379,720,864,1584,"21 de agosto de 1994"
9,16,14,4380,508,643,1151,"21 de agosto de 1994"
9,16,14,4381,625,788,1413,"21 de agosto de 1994"
9,16,14,4382,552,658,1210,"21 de agosto de 1994"
9,16,14,4383,470,610,1080,"21 de agosto de 1994"
9,16,14,4384,505,712,1217,"21 de agosto de 1994"
9,16,14,4385,544,680,1224,"21 de agosto de 1994"
9,16,14,4386,576,797,1373,"21 de agosto de 1994"
9,16,14,4387,553,779,1332,"21 de agosto de 1994"
9,16,14,4388,410,538,948,"21 de agosto de 1994"
9,16,14,4389,579,780,1359,"21 de agosto de 1994"
9,16,14,4390,423,666,1089,"21 de agosto de 1994"
9,16,14,4391,527,694,1221,"21 de agosto de 1994"
9,16,14,4392,389,606,995,"21 de agosto de 1994"
9,16,14,4393,339,464,803,"21 de agosto de 1994"
9,16,14,4394,464,624,1088,"21 de agosto de 1994"
9,16,14,4395,351,526,877,"21 de agosto de 1994"
9,16,14,4396,422,611,1033,"21 de agosto de 1994"
9,16,14,4397,465,656,1121,"21 de agosto de 1994"
9,16,14,4398,410,574,984,"21 de agosto de 1994"
9,16,14,4399,510,739,1249,"21 de agosto de 1994"
9,16,14,4400,195,262,457,"21 de agosto de 1994"
9,16,14,4401,524,625,1149,"21 de agosto de 1994"
9,16,14,4402,371,454,825,"21 de agosto de 1994"
9,16,14,4403,203,245,448,"21 de agosto de 1994"
9,16,14,4404,606,742,1348,"21 de agosto de 1994"
9,16,14,4405,606,803,1409,"21 de agosto de 1994"
9,16,14,4406,560,652,1212,"21 de agosto de 1994"
9,16,14,4407,309,362,671,"21 de agosto de 1994"
9,17,10,3180,425,462,887,"21 de agosto de 1994"
9,17,10,3181,339,437,776,"21 de agosto de 1994"
9,17,10,3182,476,621,1097,"21 de agosto de 1994"
9,17,10,3183,589,641,1230,"21 de agosto de 1994"
9,17,10,3184,468,508,976,"21 de agosto de 1994"
9,17,10,3185,496,548,1044,"21 de agosto de 1994"
9,17,10,3186,485,523,1008,"21 de agosto de 1994"
9,17,10,3187,462,525,987,"21 de agosto de 1994"
9,17,10,3188,575,620,1195,"21 de agosto de 1994"
9,17,10,3189,637,722,1359,"21 de agosto de 1994"
9,17,10,3190,402,475,877,"21 de agosto de 1994"
9,17,10,3191,537,627,1164,"21 de agosto de 1994"
9,17,10,3192,535,557,1092,"21 de agosto de 1994"
9,17,10,3193,548,605,1153,"21 de agosto de 1994"
9,17,10,3194,600,670,1270,"21 de agosto de 1994"
9,17,10,3195,657,677,1334,"21 de agosto de 1994"
9,17,10,3196,511,563,1074,"21 de agosto de 1994"
9,17,10,3197,446,526,972,"21 de agosto de 1994"
9,17,10,3198,391,459,850,"21 de agosto de 1994"
9,17,10,3199,421,471,892,"21 de agosto de 1994"
9,17,10,3200,387,442,829,"21 de agosto de 1994"
9,17,10,3201,372,395,767,"21 de agosto de 1994"
9,17,10,3202,558,591,1149,"21 de agosto de 1994"
9,17,10,3203,394,484,878,"21 de agosto de 1994"
9,17,10,3204,442,547,989,"21 de agosto de 1994"
9,17,10,3205,413,460,873,"21 de agosto de 1994"
9,17,10,3206,393,430,823,"21 de agosto de 1994"
9,17,10,3207,423,451,874,"21 de agosto de 1994"
9,17,10,3208,374,436,810,"21 de agosto de 1994"
9,17,10,3209,363,418,781,"21 de agosto de 1994"
9,17,10,3210,615,660,1275,"21 de agosto de 1994"
9,17,10,3211,422,443,865,"21 de agosto de 1994"
9,17,10,3212,721,736,1457,"21 de agosto de 1994"
9,17,10,3213,592,610,1202,"21 de agosto de 1994"
9,17,10,3214,481,582,1063,"21 de agosto de 1994"
9,17,10,3215,347,418,765,"21 de agosto de 1994"
9,17,10,3216,436,507,943,"21 de agosto de 1994"
9,17,14,4408,387,469,856,"21 de agosto de 1994"
9,17,14,4409,365,547,912,"21 de agosto de 1994"
9,17,14,4410,442,592,1034,"21 de agosto de 1994"
9,17,14,4411,506,659,1165,"21 de agosto de 1994"
9,17,14,4412,587,780,1367,"21 de agosto de 1994"
9,17,14,4413,429,506,935,"21 de agosto de 1994"
9,17,14,4414,574,779,1353,"21 de agosto de 1994"
9,17,14,4415,263,409,672,"21 de agosto de 1994"
9,17,14,4416,279,400,679,"21 de agosto de 1994"
9,17,14,4417,397,494,891,"21 de agosto de 1994"
9,17,14,4418,355,516,871,"21 de agosto de 1994"
9,17,14,4419,579,759,1338,"21 de agosto de 1994"
9,17,14,4420,643,761,1404,"21 de agosto de 1994"
9,17,14,4421,523,626,1149,"21 de agosto de 1994"
9,17,14,4422,678,830,1508,"21 de agosto de 1994"
9,17,14,4423,370,494,864,"21 de agosto de 1994"
9,17,14,4424,394,604,998,"21 de agosto de 1994"
9,17,14,4425,350,443,793,"21 de agosto de 1994"
9,17,14,4426,370,434,804,"21 de agosto de 1994"
9,17,14,4427,492,576,1068,"21 de agosto de 1994"
9,17,14,4428,472,618,1090,"21 de agosto de 1994"
9,17,14,4429,318,468,786,"21 de agosto de 1994"
9,17,16,5013,375,474,849,"21 de agosto de 1994"
9,17,16,5014,407,522,929,"21 de agosto de 1994"
9,17,16,5015,399,479,878,"21 de agosto de 1994"
9,17,16,5016,380,460,840,"21 de agosto de 1994"
9,17,16,5017,478,592,1070,"21 de agosto de 1994"
9,17,16,5018,453,631,1084,"21 de agosto de 1994"
9,17,16,5019,420,528,948,"21 de agosto de 1994"
9,17,16,5020,360,534,894,"21 de agosto de 1994"
9,17,16,5021,467,638,1105,"21 de agosto de 1994"
9,17,16,5022,611,791,1402,"21 de agosto de 1994"
9,17,16,5023,523,624,1147,"21 de agosto de 1994"
9,17,16,5024,544,639,1183,"21 de agosto de 1994"
9,17,16,5025,447,549,996,"21 de agosto de 1994"
9,17,16,5026,508,630,1138,"21 de agosto de 1994"
9,17,16,5027,369,492,861,"21 de agosto de 1994"
9,17,16,5028,540,659,1199,"21 de agosto de 1994"
9,17,16,5029,489,572,1061,"21 de agosto de 1994"
9,17,16,5030,574,601,1175,"21 de agosto de 1994"
9,17,16,5031,435,506,941,"21 de agosto de 1994"
9,17,16,5032,369,436,805,"21 de agosto de 1994"
9,17,16,5033,481,561,1042,"21 de agosto de 1994"
9,17,16,5034,444,498,942,"21 de agosto de 1994"
9,17,16,5035,481,594,1075,"21 de agosto de 1994"
9,17,16,5036,484,574,1058,"21 de agosto de 1994"
9,18,16,1566,0,0,0,"21 de agosto de 1994"
9,18,16,5037,675,774,1449,"21 de agosto de 1994"
9,18,16,5038,581,629,1210,"21 de agosto de 1994"
9,18,16,5039,657,778,1435,"21 de agosto de 1994"
9,18,16,5040,539,611,1150,"21 de agosto de 1994"
9,18,16,5041,498,589,1087,"21 de agosto de 1994"
9,18,16,5042,584,681,1265,"21 de agosto de 1994"
9,18,16,5043,609,750,1359,"21 de agosto de 1994"
9,18,16,5044,574,685,1259,"21 de agosto de 1994"
9,18,16,5045,628,705,1333,"21 de agosto de 1994"
9,18,16,5046,588,616,1204,"21 de agosto de 1994"
9,18,16,5047,476,552,1028,"21 de agosto de 1994"
9,18,16,5048,557,605,1162,"21 de agosto de 1994"
9,18,16,5049,657,745,1402,"21 de agosto de 1994"
9,18,16,5050,553,624,1177,"21 de agosto de 1994"
9,18,16,5051,712,791,1503,"21 de agosto de 1994"
9,18,16,5052,505,612,1117,"21 de agosto de 1994"
9,18,16,5053,390,419,809,"21 de agosto de 1994"
9,18,16,5054,430,493,923,"21 de agosto de 1994"
9,18,16,5055,719,803,1522,"21 de agosto de 1994"
9,18,16,5056,693,736,1429,"21 de agosto de 1994"
9,18,16,5057,393,443,836,"21 de agosto de 1994"
9,18,16,5058,544,591,1135,"21 de agosto de 1994"
9,18,16,5059,448,519,967,"21 de agosto de 1994"
9,18,16,5060,544,614,1158,"21 de agosto de 1994"
9,18,16,5061,576,643,1219,"21 de agosto de 1994"
9,18,16,5062,565,617,1182,"21 de agosto de 1994"
9,18,16,5063,689,752,1441,"21 de agosto de 1994"
9,18,16,5064,655,709,1364,"21 de agosto de 1994"
9,18,16,5065,463,498,961,"21 de agosto de 1994"
9,18,16,5066,613,816,1429,"21 de agosto de 1994"
9,18,16,5067,381,483,864,"21 de agosto de 1994"
9,18,16,5068,619,697,1316,"21 de agosto de 1994"
9,18,16,5069,680,772,1452,"21 de agosto de 1994"
9,18,16,5070,581,661,1242,"21 de agosto de 1994"
9,18,16,5071,592,652,1244,"21 de agosto de 1994"
9,18,16,5072,558,658,1216,"21 de agosto de 1994"
9,18,16,5073,407,414,821,"21 de agosto de 1994"
9,18,16,5074,552,585,1137,"21 de agosto de 1994"
9,18,16,5075,508,576,1084,"21 de agosto de 1994"
9,18,16,5076,424,460,884,"21 de agosto de 1994"
9,18,16,5077,570,645,1215,"21 de agosto de 1994"
9,18,16,5078,525,590,1115,"21 de agosto de 1994"
9,18,16,5079,333,459,792,"21 de agosto de 1994"
9,18,16,5080,333,477,810,"21 de agosto de 1994"
9,18,16,5081,341,470,811,"21 de agosto de 1994"
9,18,16,5082,410,354,764,"21 de agosto de 1994"
9,18,16,5083,390,539,929,"21 de agosto de 1994"
9,18,16,5084,275,379,654,"21 de agosto de 1994"
9,18,16,5085,373,477,850,"21 de agosto de 1994"
9,18,16,5086,308,412,720,"21 de agosto de 1994"
9,18,16,5087,326,428,754,"21 de agosto de 1994"
9,18,16,5088,360,494,854,"21 de agosto de 1994"
9,18,16,5089,372,513,885,"21 de agosto de 1994"
9,18,16,5090,367,489,856,"21 de agosto de 1994"
9,18,16,5091,328,16,344,"21 de agosto de 1994"
9,18,16,5092,382,1,383,"21 de agosto de 1994"
9,18,16,5093,571,0,571,"21 de agosto de 1994"
9,18,16,5094,255,24,279,"21 de agosto de 1994"
9,18,16,5095,1101,8,1109,"21 de agosto de 1994"
9,18,16,5096,417,0,417,"21 de agosto de 1994"
9,18,16,5097,721,7,728,"21 de agosto de 1994"
9,18,16,5098,320,359,679,"21 de agosto de 1994"
9,18,16,5099,349,398,747,"21 de agosto de 1994"
9,18,16,5100,239,261,500,"21 de agosto de 1994"
9,18,16,5101,352,397,749,"21 de agosto de 1994"
9,18,16,5102,177,271,448,"21 de agosto de 1994"
9,18,16,5103,284,311,595,"21 de agosto de 1994"
9,18,16,5114,0,0,0,"21 de agosto de 1994"
9,19,2,56,581,560,1141,"21 de agosto de 1994"
9,19,2,57,522,601,1123,"21 de agosto de 1994"
9,19,2,58,576,589,1165,"21 de agosto de 1994"
9,19,2,59,470,499,969,"21 de agosto de 1994"
9,19,2,60,495,505,1000,"21 de agosto de 1994"
9,19,2,61,494,530,1024,"21 de agosto de 1994"
9,19,2,62,579,602,1181,"21 de agosto de 1994"
9,19,2,63,371,382,753,"21 de agosto de 1994"
9,19,2,64,545,556,1101,"21 de agosto de 1994"
9,19,2,65,612,628,1240,"21 de agosto de 1994"
9,19,2,66,493,530,1023,"21 de agosto de 1994"
9,19,2,67,593,620,1213,"21 de agosto de 1994"
9,19,2,68,482,519,1001,"21 de agosto de 1994"
9,19,2,69,500,510,1010,"21 de agosto de 1994"
9,19,2,70,568,586,1154,"21 de agosto de 1994"
9,19,2,71,457,511,968,"21 de agosto de 1994"
9,19,2,72,577,636,1213,"21 de agosto de 1994"
9,19,2,73,531,617,1148,"21 de agosto de 1994"
9,19,2,74,504,529,1033,"21 de agosto de 1994"
9,19,2,75,483,535,1018,"21 de agosto de 1994"
9,19,2,76,585,651,1236,"21 de agosto de 1994"
9,19,2,77,541,651,1192,"21 de agosto de 1994"
9,19,2,78,473,542,1015,"21 de agosto de 1994"
9,19,2,79,485,518,1003,"21 de agosto de 1994"
9,19,2,80,451,455,906,"21 de agosto de 1994"
9,19,2,81,414,430,844,"21 de agosto de 1994"
9,19,2,82,441,497,938,"21 de agosto de 1994"
9,19,2,83,296,313,609,"21 de agosto de 1994"
9,19,2,84,427,518,945,"21 de agosto de 1994"
9,19,2,85,385,474,859,"21 de agosto de 1994"
9,19,2,86,523,630,1153,"21 de agosto de 1994"
9,19,2,87,483,563,1046,"21 de agosto de 1994"
9,19,2,88,489,573,1062,"21 de agosto de 1994"
9,19,2,89,290,333,623,"21 de agosto de 1994"
9,19,2,90,545,602,1147,"21 de agosto de 1994"
9,19,2,91,459,543,1002,"21 de agosto de 1994"
9,19,2,92,491,561,1052,"21 de agosto de 1994"
9,19,2,93,378,434,812,"21 de agosto de 1994"
9,19,2,94,391,432,823,"21 de agosto de 1994"
9,19,2,95,582,680,1262,"21 de agosto de 1994"
9,19,2,96,567,696,1263,"21 de agosto de 1994"
9,19,2,97,686,678,1364,"21 de agosto de 1994"
9,19,2,98,277,354,631,"21 de agosto de 1994"
9,19,2,99,396,477,873,"21 de agosto de 1994"
9,19,2,100,502,633,1135,"21 de agosto de 1994"
9,19,2,101,483,620,1103,"21 de agosto de 1994"
9,19,2,102,511,607,1118,"21 de agosto de 1994"
9,19,2,103,515,560,1075,"21 de agosto de 1994"
9,19,2,104,449,474,923,"21 de agosto de 1994"
9,19,2,105,451,559,1010,"21 de agosto de 1994"
9,19,2,106,254,293,547,"21 de agosto de 1994"
9,19,2,107,384,463,847,"21 de agosto de 1994"
9,19,2,108,448,545,993,"21 de agosto de 1994"
9,19,2,109,640,685,1325,"21 de agosto de 1994"
9,19,2,110,353,418,771,"21 de agosto de 1994"
9,19,2,111,659,731,1390,"21 de agosto de 1994"
9,19,2,112,357,403,760,"21 de agosto de 1994"
9,19,2,113,342,412,754,"21 de agosto de 1994"
9,19,2,114,282,337,619,"21 de agosto de 1994"
9,19,2,115,339,407,746,"21 de agosto de 1994"
9,19,2,116,327,457,784,"21 de agosto de 1994"
9,19,2,117,312,398,710,"21 de agosto de 1994"
9,19,2,118,344,402,746,"21 de agosto de 1994"
9,19,2,119,652,764,1416,"21 de agosto de 1994"
9,19,2,120,321,445,766,"21 de agosto de 1994"
9,19,2,121,374,488,862,"21 de agosto de 1994"
9,19,2,122,404,458,862,"21 de agosto de 1994"
9,19,2,123,436,522,958,"21 de agosto de 1994"
9,19,2,124,461,592,1053,"21 de agosto de 1994"
9,19,2,125,357,456,813,"21 de agosto de 1994"
9,19,2,126,436,525,961,"21 de agosto de 1994"
9,19,2,127,493,556,1049,"21 de agosto de 1994"
9,19,2,128,436,505,941,"21 de agosto de 1994"
9,19,2,129,492,647,1139,"21 de agosto de 1994"
9,19,2,130,162,183,345,"21 de agosto de 1994"
9,19,2,131,387,470,857,"21 de agosto de 1994"
9,19,2,132,403,500,903,"21 de agosto de 1994"
9,19,2,133,518,650,1168,"21 de agosto de 1994"
9,19,2,134,342,421,763,"21 de agosto de 1994"
9,19,2,135,299,363,662,"21 de agosto de 1994"
9,19,2,136,434,549,983,"21 de agosto de 1994"
9,19,2,137,285,401,686,"21 de agosto de 1994"
9,19,2,138,339,404,743,"21 de agosto de 1994"
9,19,2,139,297,357,654,"21 de agosto de 1994"
9,19,2,140,280,334,614,"21 de agosto de 1994"
9,19,2,141,283,340,623,"21 de agosto de 1994"
9,19,2,142,408,498,906,"21 de agosto de 1994"
9,19,2,143,324,401,725,"21 de agosto de 1994"
9,19,2,144,342,444,786,"21 de agosto de 1994"
9,19,2,145,372,464,836,"21 de agosto de 1994"
9,19,2,146,373,484,857,"21 de agosto de 1994"
9,19,2,147,392,501,893,"21 de agosto de 1994"
9,19,2,148,460,523,983,"21 de agosto de 1994"
9,19,2,149,237,246,483,"21 de agosto de 1994"
9,19,2,150,204,250,454,"21 de agosto de 1994"
9,19,2,151,202,227,429,"21 de agosto de 1994"
9,20,5,609,0,0,0,"21 de agosto de 1994"
9,20,5,1214,764,828,1592,"21 de agosto de 1994"
9,20,5,1215,403,431,834,"21 de agosto de 1994"
9,20,5,1216,530,588,1118,"21 de agosto de 1994"
9,20,5,1217,623,732,1355,"21 de agosto de 1994"
9,20,5,1218,572,642,1214,"21 de agosto de 1994"
9,20,5,1219,481,524,1005,"21 de agosto de 1994"
9,20,5,1220,477,525,1002,"21 de agosto de 1994"
9,20,5,1221,517,586,1103,"21 de agosto de 1994"
9,20,5,1222,570,628,1198,"21 de agosto de 1994"
9,20,5,1223,532,604,1136,"21 de agosto de 1994"
9,20,5,1224,416,481,897,"21 de agosto de 1994"
9,20,5,1225,479,512,991,"21 de agosto de 1994"
9,20,5,1226,590,652,1242,"21 de agosto de 1994"
9,20,5,1227,515,607,1122,"21 de agosto de 1994"
9,20,5,1228,444,551,995,"21 de agosto de 1994"
9,20,5,1229,640,766,1406,"21 de agosto de 1994"
9,20,5,1230,611,704,1315,"21 de agosto de 1994"
9,20,5,1231,625,712,1337,"21 de agosto de 1994"
9,20,5,1232,484,519,1003,"21 de agosto de 1994"
9,20,5,1233,523,583,1106,"21 de agosto de 1994"
9,20,5,1234,520,560,1080,"21 de agosto de 1994"
9,20,5,1235,516,566,1082,"21 de agosto de 1994"
9,20,5,1236,507,544,1051,"21 de agosto de 1994"
9,20,5,1237,595,670,1265,"21 de agosto de 1994"
9,20,5,1238,523,655,1178,"21 de agosto de 1994"
9,20,5,1239,420,477,897,"21 de agosto de 1994"
9,20,5,1240,481,507,988,"21 de agosto de 1994"
9,20,5,1241,423,541,964,"21 de agosto de 1994"
9,20,5,1242,442,503,945,"21 de agosto de 1994"
9,20,5,1243,461,567,1028,"21 de agosto de 1994"
9,20,5,1244,596,630,1226,"21 de agosto de 1994"
9,20,5,1245,431,450,881,"21 de agosto de 1994"
9,20,5,1246,627,705,1332,"21 de agosto de 1994"
9,20,5,1247,311,384,695,"21 de agosto de 1994"
9,20,5,1248,535,566,1101,"21 de agosto de 1994"
9,20,5,1249,386,442,828,"21 de agosto de 1994"
9,20,5,1250,444,523,967,"21 de agosto de 1994"
9,20,5,1251,354,428,782,"21 de agosto de 1994"
9,20,5,1252,456,506,962,"21 de agosto de 1994"
9,20,5,1253,512,647,1159,"21 de agosto de 1994"
9,20,5,1254,269,297,566,"21 de agosto de 1994"
9,20,5,1255,436,498,934,"21 de agosto de 1994"
9,20,5,1256,280,364,644,"21 de agosto de 1994"
9,20,5,1257,355,413,768,"21 de agosto de 1994"
9,20,5,1258,415,496,911,"21 de agosto de 1994"
9,20,5,1259,306,418,724,"21 de agosto de 1994"
9,20,5,1260,407,496,903,"21 de agosto de 1994"
9,20,5,1261,368,441,809,"21 de agosto de 1994"
9,20,5,1262,353,400,753,"21 de agosto de 1994"
9,20,5,1263,373,497,870,"21 de agosto de 1994"
9,20,5,1264,383,427,810,"21 de agosto de 1994"
9,20,5,1265,508,529,1037,"21 de agosto de 1994"
9,20,5,1266,527,572,1099,"21 de agosto de 1994"
9,20,5,1267,530,552,1082,"21 de agosto de 1994"
9,20,5,1268,418,470,888,"21 de agosto de 1994"
9,20,5,1269,455,481,936,"21 de agosto de 1994"
9,20,5,1270,544,645,1189,"21 de agosto de 1994"
9,20,5,1271,593,650,1243,"21 de agosto de 1994"
9,20,5,1272,564,607,1171,"21 de agosto de 1994"
9,20,5,1273,520,564,1084,"21 de agosto de 1994"
9,20,5,1274,574,697,1271,"21 de agosto de 1994"
9,20,5,1275,674,729,1403,"21 de agosto de 1994"
9,20,5,1276,430,478,908,"21 de agosto de 1994"
9,20,5,1277,493,520,1013,"21 de agosto de 1994"
9,20,5,1278,479,525,1004,"21 de agosto de 1994"
9,20,5,1279,358,403,761,"21 de agosto de 1994"
9,20,5,1280,413,419,832,"21 de agosto de 1994"
9,20,5,1281,455,511,966,"21 de agosto de 1994"
9,20,5,1282,483,559,1042,"21 de agosto de 1994"
9,20,5,1283,395,441,836,"21 de agosto de 1994"
9,20,5,1284,421,457,878,"21 de agosto de 1994"
9,20,5,1285,470,543,1013,"21 de agosto de 1994"
9,20,5,1286,284,354,638,"21 de agosto de 1994"
9,20,5,1287,436,454,890,"21 de agosto de 1994"
9,20,5,1288,369,433,802,"21 de agosto de 1994"
9,20,5,1289,640,856,1496,"21 de agosto de 1994"
9,20,5,1290,405,541,946,"21 de agosto de 1994"
9,20,5,1291,301,410,711,"21 de agosto de 1994"
9,20,5,1292,550,763,1313,"21 de agosto de 1994"
9,20,5,1293,532,829,1361,"21 de agosto de 1994"
9,20,5,1294,356,429,785,"21 de agosto de 1994"
9,20,5,1295,559,666,1225,"21 de agosto de 1994"
9,20,5,1296,252,245,497,"21 de agosto de 1994"
9,20,5,1297,266,356,622,"21 de agosto de 1994"
9,20,5,1298,364,506,870,"21 de agosto de 1994"
9,20,5,1299,475,607,1082,"21 de agosto de 1994"
9,20,5,1300,400,467,867,"21 de agosto de 1994"
9,20,5,1301,438,477,915,"21 de agosto de 1994"
9,20,5,1302,420,472,892,"21 de agosto de 1994"
9,20,5,1303,233,265,498,"21 de agosto de 1994"
9,20,5,1304,258,315,573,"21 de agosto de 1994"
9,20,5,1305,583,661,1244,"21 de agosto de 1994"
9,20,5,1306,475,550,1025,"21 de agosto de 1994"
9,20,5,1307,568,662,1230,"21 de agosto de 1994"
9,20,5,1308,457,571,1028,"21 de agosto de 1994"
9,20,5,1309,503,546,1049,"21 de agosto de 1994"
9,20,5,1310,450,475,925,"21 de agosto de 1994"
9,20,5,1311,571,690,1261,"21 de agosto de 1994"
9,20,5,1312,396,453,849,"21 de agosto de 1994"
9,20,5,1313,474,559,1033,"21 de agosto de 1994"
9,20,5,1314,476,534,1010,"21 de agosto de 1994"
9,20,5,1315,452,526,978,"21 de agosto de 1994"
9,20,5,1316,497,553,1050,"21 de agosto de 1994"
9,20,5,1317,413,475,888,"21 de agosto de 1994"
9,20,5,1318,489,552,1041,"21 de agosto de 1994"
9,20,5,1319,474,572,1046,"21 de agosto de 1994"
9,20,5,1320,362,393,755,"21 de agosto de 1994"
9,20,5,1321,352,431,783,"21 de agosto de 1994"
9,20,5,1322,510,586,1096,"21 de agosto de 1994"
9,20,5,1323,405,476,881,"21 de agosto de 1994"
9,20,5,1324,360,339,699,"21 de agosto de 1994"
9,20,5,1325,366,462,828,"21 de agosto de 1994"
9,20,5,1326,271,432,703,"21 de agosto de 1994"
9,21,6,1831,512,547,1059,"21 de agosto de 1994"
9,21,6,1832,508,613,1121,"21 de agosto de 1994"
9,21,6,1833,588,656,1244,"21 de agosto de 1994"
9,21,6,1834,447,489,936,"21 de agosto de 1994"
9,21,6,1835,417,486,903,"21 de agosto de 1994"
9,21,6,1836,527,583,1110,"21 de agosto de 1994"
9,21,6,1837,492,558,1050,"21 de agosto de 1994"
9,21,6,1838,476,533,1009,"21 de agosto de 1994"
9,21,6,1839,668,774,1442,"21 de agosto de 1994"
9,21,6,1840,456,528,984,"21 de agosto de 1994"
9,21,6,1841,529,544,1073,"21 de agosto de 1994"
9,21,6,1842,529,568,1097,"21 de agosto de 1994"
9,21,6,1843,334,406,740,"21 de agosto de 1994"
9,21,6,1844,317,413,730,"21 de agosto de 1994"
9,21,6,1845,609,718,1327,"21 de agosto de 1994"
9,21,6,1846,445,517,962,"21 de agosto de 1994"
9,21,6,1847,428,464,892,"21 de agosto de 1994"
9,21,6,1848,404,422,826,"21 de agosto de 1994"
9,21,6,1849,462,512,974,"21 de agosto de 1994"
9,21,6,1850,459,465,924,"21 de agosto de 1994"
9,21,6,1851,522,595,1117,"21 de agosto de 1994"
9,21,6,1852,461,496,957,"21 de agosto de 1994"
9,21,6,1853,509,568,1077,"21 de agosto de 1994"
9,21,6,1854,404,461,865,"21 de agosto de 1994"
9,21,6,1855,485,537,1022,"21 de agosto de 1994"
9,21,6,1856,386,410,796,"21 de agosto de 1994"
9,21,6,1857,392,458,850,"21 de agosto de 1994"
9,21,6,1858,596,687,1283,"21 de agosto de 1994"
9,21,6,1859,531,569,1100,"21 de agosto de 1994"
9,21,6,1860,496,535,1031,"21 de agosto de 1994"
9,21,6,1861,525,650,1175,"21 de agosto de 1994"
9,21,6,1862,523,559,1082,"21 de agosto de 1994"
9,21,6,1863,365,405,770,"21 de agosto de 1994"
9,21,6,1864,371,448,819,"21 de agosto de 1994"
9,21,6,1865,386,412,798,"21 de agosto de 1994"
9,21,6,1866,310,370,680,"21 de agosto de 1994"
9,21,6,1867,444,536,980,"21 de agosto de 1994"
9,21,6,1868,516,586,1102,"21 de agosto de 1994"
9,21,6,1869,648,702,1350,"21 de agosto de 1994"
9,21,6,1870,552,621,1173,"21 de agosto de 1994"
9,21,6,1871,402,425,827,"21 de agosto de 1994"
9,21,6,1872,263,287,550,"21 de agosto de 1994"
9,21,6,1873,371,423,794,"21 de agosto de 1994"
9,21,6,1874,519,586,1105,"21 de agosto de 1994"
9,21,6,1875,530,586,1116,"21 de agosto de 1994"
9,21,6,1876,550,645,1195,"21 de agosto de 1994"
9,21,6,1877,429,458,887,"21 de agosto de 1994"
9,21,6,1878,477,581,1058,"21 de agosto de 1994"
9,21,6,1879,599,722,1321,"21 de agosto de 1994"
9,21,6,1880,528,549,1077,"21 de agosto de 1994"
9,21,6,1881,523,555,1078,"21 de agosto de 1994"
9,21,6,1882,345,397,742,"21 de agosto de 1994"
9,21,6,1883,588,644,1232,"21 de agosto de 1994"
9,21,6,1884,515,595,1110,"21 de agosto de 1994"
9,21,6,1885,574,648,1222,"21 de agosto de 1994"
9,21,6,1886,223,243,466,"21 de agosto de 1994"
9,21,6,1887,463,502,965,"21 de agosto de 1994"
9,21,6,1888,479,534,1013,"21 de agosto de 1994"
9,21,6,1889,652,750,1402,"21 de agosto de 1994"
9,21,6,1890,539,576,1115,"21 de agosto de 1994"
9,21,6,1891,647,755,1402,"21 de agosto de 1994"
9,21,6,1892,562,620,1182,"21 de agosto de 1994"
9,21,6,1893,514,619,1133,"21 de agosto de 1994"
9,21,6,1894,393,446,839,"21 de agosto de 1994"
9,21,6,1895,479,570,1049,"21 de agosto de 1994"
9,21,6,1896,534,580,1114,"21 de agosto de 1994"
9,21,6,1897,413,485,898,"21 de agosto de 1994"
9,21,6,1898,527,606,1133,"21 de agosto de 1994"
9,21,6,1899,439,467,906,"21 de agosto de 1994"
9,21,6,1900,448,480,928,"21 de agosto de 1994"
9,21,6,1901,300,326,626,"21 de agosto de 1994"
9,21,6,1902,565,650,1215,"21 de agosto de 1994"
9,21,6,1903,418,460,878,"21 de agosto de 1994"
9,21,7,1876,0,0,0,"21 de agosto de 1994"
9,21,7,1971,455,473,928,"21 de agosto de 1994"
9,21,7,1972,347,443,790,"21 de agosto de 1994"
9,21,7,1973,299,397,696,"21 de agosto de 1994"
9,21,7,1974,519,654,1173,"21 de agosto de 1994"
9,21,7,1975,482,533,1015,"21 de agosto de 1994"
9,21,7,1976,598,674,1272,"21 de agosto de 1994"
9,21,7,1977,193,191,384,"21 de agosto de 1994"
9,21,7,1978,324,379,703,"21 de agosto de 1994"
9,21,7,1979,422,533,955,"21 de agosto de 1994"
9,21,7,1980,373,475,848,"21 de agosto de 1994"
9,21,7,1981,397,450,847,"21 de agosto de 1994"
9,21,7,1982,430,513,943,"21 de agosto de 1994"
9,21,7,1983,384,436,820,"21 de agosto de 1994"
9,21,7,1984,328,409,737,"21 de agosto de 1994"
9,21,7,1985,318,390,708,"21 de agosto de 1994"
9,21,7,1986,343,447,790,"21 de agosto de 1994"
9,21,7,1987,402,457,859,"21 de agosto de 1994"
9,21,7,1988,264,258,522,"21 de agosto de 1994"
9,21,7,1989,381,465,846,"21 de agosto de 1994"
9,21,7,1990,461,490,951,"21 de agosto de 1994"
9,21,7,1991,447,485,932,"21 de agosto de 1994"
9,21,7,1992,426,457,883,"21 de agosto de 1994"
9,21,7,1993,512,504,1016,"21 de agosto de 1994"
9,21,7,1994,431,467,898,"21 de agosto de 1994"
9,21,7,1995,428,445,873,"21 de agosto de 1994"
9,21,7,1996,376,400,776,"21 de agosto de 1994"
9,21,7,1997,463,522,985,"21 de agosto de 1994"
9,21,7,1998,496,509,1005,"21 de agosto de 1994"
9,21,7,1999,459,499,958,"21 de agosto de 1994"
9,21,7,2000,481,512,993,"21 de agosto de 1994"
9,21,7,2001,472,485,957,"21 de agosto de 1994"
9,21,7,2002,524,554,1078,"21 de agosto de 1994"
9,21,7,2003,457,460,917,"21 de agosto de 1994"
9,21,7,2004,496,504,1000,"21 de agosto de 1994"
9,21,7,2005,513,542,1055,"21 de agosto de 1994"
9,21,7,2006,403,440,843,"21 de agosto de 1994"
9,21,7,2007,411,505,916,"21 de agosto de 1994"
9,21,7,2008,310,325,635,"21 de agosto de 1994"
9,21,7,2009,254,263,517,"21 de agosto de 1994"
9,21,7,2010,553,634,1187,"21 de agosto de 1994"
9,21,7,2011,444,491,935,"21 de agosto de 1994"
9,21,7,2012,381,464,845,"21 de agosto de 1994"
9,21,7,2013,563,607,1170,"21 de agosto de 1994"
9,21,7,2014,501,507,1008,"21 de agosto de 1994"
9,21,7,2015,476,467,943,"21 de agosto de 1994"
9,21,7,2016,496,550,1046,"21 de agosto de 1994"
9,21,7,2017,469,561,1030,"21 de agosto de 1994"
9,21,7,2018,512,591,1103,"21 de agosto de 1994"
9,21,7,2019,429,450,879,"21 de agosto de 1994"
9,21,7,2020,449,453,902,"21 de agosto de 1994"
9,21,7,2021,453,481,934,"21 de agosto de 1994"
9,21,7,2022,310,402,712,"21 de agosto de 1994"
9,21,7,2023,419,504,923,"21 de agosto de 1994"
9,21,7,2024,546,609,1155,"21 de agosto de 1994"
9,21,7,2025,436,467,903,"21 de agosto de 1994"
9,21,7,2026,537,620,1157,"21 de agosto de 1994"
9,21,7,2027,585,661,1246,"21 de agosto de 1994"
9,21,7,2028,574,620,1194,"21 de agosto de 1994"
9,21,7,2029,511,536,1047,"21 de agosto de 1994"
9,21,7,2030,633,690,1323,"21 de agosto de 1994"
9,21,7,2031,418,491,909,"21 de agosto de 1994"
9,21,7,2032,443,485,928,"21 de agosto de 1994"
9,21,7,2033,366,414,780,"21 de agosto de 1994"
9,21,7,2034,370,408,778,"21 de agosto de 1994"
9,21,7,2035,534,603,1137,"21 de agosto de 1994"
9,21,7,2036,275,330,605,"21 de agosto de 1994"
9,21,7,2037,229,289,518,"21 de agosto de 1994"
9,21,7,2038,419,439,858,"21 de agosto de 1994"
9,21,7,2039,541,586,1127,"21 de agosto de 1994"
9,21,7,2040,462,495,957,"21 de agosto de 1994"
9,21,7,2041,365,402,767,"21 de agosto de 1994"
9,21,7,2042,595,640,1235,"21 de agosto de 1994"
9,21,7,2043,535,494,1029,"21 de agosto de 1994"
9,21,7,2044,673,791,1464,"21 de agosto de 1994"
9,21,7,2045,343,389,732,"21 de agosto de 1994"
9,21,7,2046,408,454,862,"21 de agosto de 1994"
9,21,7,2047,557,628,1185,"21 de agosto de 1994"
9,21,7,2048,603,691,1294,"21 de agosto de 1994"
9,21,7,2049,469,544,1013,"21 de agosto de 1994"
9,21,7,2050,714,811,1525,"21 de agosto de 1994"
9,21,7,2051,578,643,1221,"21 de agosto de 1994"
9,21,7,2052,518,563,1081,"21 de agosto de 1994"
9,21,7,2053,629,712,1341,"21 de agosto de 1994"
9,21,7,2054,200,268,468,"21 de agosto de 1994"
9,21,7,2055,493,577,1070,"21 de agosto de 1994"
9,21,7,2056,798,850,1648,"21 de agosto de 1994"
9,21,7,2057,599,675,1274,"21 de agosto de 1994"
9,21,7,2058,548,586,1134,"21 de agosto de 1994"
9,21,7,2059,196,219,415,"21 de agosto de 1994"
9,21,7,2060,235,264,499,"21 de agosto de 1994"
9,21,7,2061,175,179,354,"21 de agosto de 1994"
9,21,7,2062,300,328,628,"21 de agosto de 1994"
9,21,7,2063,352,385,737,"21 de agosto de 1994"
9,21,7,2064,87,118,205,"21 de agosto de 1994"
9,21,7,5516,54,59,113,"21 de agosto de 1994"
9,22,3,345,511,660,1171,"21 de agosto de 1994"
9,22,3,346,141,175,316,"21 de agosto de 1994"
9,22,3,347,534,729,1263,"21 de agosto de 1994"
9,22,3,348,530,655,1185,"21 de agosto de 1994"
9,22,3,349,439,557,996,"21 de agosto de 1994"
9,22,3,350,494,653,1147,"21 de agosto de 1994"
9,22,3,351,666,744,1410,"21 de agosto de 1994"
9,22,3,352,444,522,966,"21 de agosto de 1994"
9,22,3,353,660,721,1381,"21 de agosto de 1994"
9,22,3,354,777,906,1683,"21 de agosto de 1994"
9,22,3,355,705,740,1445,"21 de agosto de 1994"
9,22,3,356,545,613,1158,"21 de agosto de 1994"
9,22,3,357,555,576,1131,"21 de agosto de 1994"
9,22,3,358,405,428,833,"21 de agosto de 1994"
9,22,3,359,469,577,1046,"21 de agosto de 1994"
9,22,3,360,525,576,1101,"21 de agosto de 1994"
9,22,3,361,512,561,1073,"21 de agosto de 1994"
9,22,3,362,488,533,1021,"21 de agosto de 1994"
9,22,3,363,623,691,1314,"21 de agosto de 1994"
9,22,3,364,744,763,1507,"21 de agosto de 1994"
9,22,3,365,582,615,1197,"21 de agosto de 1994"
9,22,3,366,602,688,1290,"21 de agosto de 1994"
9,22,3,367,534,588,1122,"21 de agosto de 1994"
9,22,3,368,548,679,1227,"21 de agosto de 1994"
9,22,3,369,474,600,1074,"21 de agosto de 1994"
9,22,3,370,205,249,454,"21 de agosto de 1994"
9,22,3,371,388,450,838,"21 de agosto de 1994"
9,22,3,372,444,517,961,"21 de agosto de 1994"
9,22,3,373,560,632,1192,"21 de agosto de 1994"
9,22,3,374,585,634,1219,"21 de agosto de 1994"
9,22,3,375,217,256,473,"21 de agosto de 1994"
9,22,3,376,664,756,1420,"21 de agosto de 1994"
9,22,3,377,597,652,1249,"21 de agosto de 1994"
9,22,3,378,624,773,1397,"21 de agosto de 1994"
9,22,3,379,532,583,1115,"21 de agosto de 1994"
9,22,3,380,378,413,791,"21 de agosto de 1994"
9,22,3,381,722,803,1525,"21 de agosto de 1994"
9,22,3,382,690,728,1418,"21 de agosto de 1994"
9,22,3,383,648,711,1359,"21 de agosto de 1994"
9,22,3,384,716,806,1522,"21 de agosto de 1994"
9,22,3,385,648,708,1356,"21 de agosto de 1994"
9,22,3,386,536,593,1129,"21 de agosto de 1994"
9,22,3,387,304,352,656,"21 de agosto de 1994"
9,22,3,388,557,636,1193,"21 de agosto de 1994"
9,22,3,389,459,492,951,"21 de agosto de 1994"
9,22,3,390,774,826,1600,"21 de agosto de 1994"
9,22,3,391,502,509,1011,"21 de agosto de 1994"
9,22,3,392,624,660,1284,"21 de agosto de 1994"
9,22,3,393,763,804,1567,"21 de agosto de 1994"
9,22,3,394,518,562,1080,"21 de agosto de 1994"
9,22,3,395,659,715,1374,"21 de agosto de 1994"
9,22,3,396,301,370,671,"21 de agosto de 1994"
9,22,3,397,649,734,1383,"21 de agosto de 1994"
9,22,3,398,473,538,1011,"21 de agosto de 1994"
9,22,3,399,640,772,1412,"21 de agosto de 1994"
9,22,3,400,513,627,1140,"21 de agosto de 1994"
9,22,3,401,545,613,1158,"21 de agosto de 1994"
9,22,3,402,584,699,1283,"21 de agosto de 1994"
9,22,3,403,571,665,1236,"21 de agosto de 1994"
9,22,3,404,745,794,1539,"21 de agosto de 1994"
9,22,3,405,393,432,825,"21 de agosto de 1994"
9,22,3,406,563,637,1200,"21 de agosto de 1994"
9,22,3,407,518,566,1084,"21 de agosto de 1994"
9,22,3,408,365,366,731,"21 de agosto de 1994"
9,22,3,409,575,619,1194,"21 de agosto de 1994"
9,22,3,410,405,459,864,"21 de agosto de 1994"
9,22,3,411,542,589,1131,"21 de agosto de 1994"
9,22,3,412,361,409,770,"21 de agosto de 1994"
9,22,3,413,330,415,745,"21 de agosto de 1994"
9,22,3,414,150,237,387,"21 de agosto de 1994"
9,22,3,415,423,481,904,"21 de agosto de 1994"
9,22,3,416,811,918,1729,"21 de agosto de 1994"
9,22,3,417,678,692,1370,"21 de agosto de 1994"
9,22,3,418,653,745,1398,"21 de agosto de 1994"
9,22,3,419,561,584,1145,"21 de agosto de 1994"
9,22,3,420,492,508,1000,"21 de agosto de 1994"
9,22,3,421,607,640,1247,"21 de agosto de 1994"
9,22,3,422,557,645,1202,"21 de agosto de 1994"
9,22,3,423,359,409,768,"21 de agosto de 1994"
9,22,3,424,314,339,653,"21 de agosto de 1994"
9,22,3,425,631,701,1332,"21 de agosto de 1994"
9,22,3,426,438,471,909,"21 de agosto de 1994"
9,22,3,427,670,861,1531,"21 de agosto de 1994"
9,22,3,428,430,612,1042,"21 de agosto de 1994"
9,22,3,429,352,435,787,"21 de agosto de 1994"
9,22,3,430,679,699,1378,"21 de agosto de 1994"
9,22,3,431,513,503,1016,"21 de agosto de 1994"
9,22,3,432,499,560,1059,"21 de agosto de 1994"
9,22,3,433,589,643,1232,"21 de agosto de 1994"
9,22,3,434,669,772,1441,"21 de agosto de 1994"
9,22,3,435,607,651,1258,"21 de agosto de 1994"
9,22,3,436,658,770,1428,"21 de agosto de 1994"
9,22,3,437,664,721,1385,"21 de agosto de 1994"
9,22,3,438,639,699,1338,"21 de agosto de 1994"
9,22,3,439,588,675,1263,"21 de agosto de 1994"
9,22,3,440,412,412,824,"21 de agosto de 1994"
9,22,3,441,738,743,1481,"21 de agosto de 1994"
9,22,3,442,433,441,874,"21 de agosto de 1994"
9,22,3,443,556,565,1121,"21 de agosto de 1994"
9,22,3,444,733,833,1566,"21 de agosto de 1994"
9,22,3,445,601,635,1236,"21 de agosto de 1994"
9,22,3,446,408,417,825,"21 de agosto de 1994"
9,22,3,447,665,673,1338,"21 de agosto de 1994"
9,22,3,448,434,455,889,"21 de agosto de 1994"
9,22,3,449,568,639,1207,"21 de agosto de 1994"
9,22,3,450,487,497,984,"21 de agosto de 1994"
9,22,3,451,469,550,1019,"21 de agosto de 1994"
9,22,3,452,675,798,1473,"21 de agosto de 1994"
9,22,3,453,633,671,1304,"21 de agosto de 1994"
9,22,3,454,492,568,1060,"21 de agosto de 1994"
9,22,3,455,449,481,930,"21 de agosto de 1994"
9,22,3,456,572,687,1259,"21 de agosto de 1994"
9,22,3,457,379,417,796,"21 de agosto de 1994"
9,22,3,458,406,484,890,"21 de agosto de 1994"
9,22,3,459,390,475,865,"21 de agosto de 1994"
9,22,3,460,345,409,754,"21 de agosto de 1994"
9,22,3,461,230,287,517,"21 de agosto de 1994"
9,22,3,462,284,312,596,"21 de agosto de 1994"
9,22,3,463,413,459,872,"21 de agosto de 1994"
9,22,3,464,482,554,1036,"21 de agosto de 1994"
9,22,3,465,531,582,1113,"21 de agosto de 1994"
9,22,3,466,519,652,1171,"21 de agosto de 1994"
9,22,3,467,447,534,981,"21 de agosto de 1994"
9,22,3,468,439,526,965,"21 de agosto de 1994"
9,22,3,469,422,542,964,"21 de agosto de 1994"
9,22,3,470,437,509,946,"21 de agosto de 1994"
9,22,3,471,744,780,1524,"21 de agosto de 1994"
9,22,3,472,368,515,883,"21 de agosto de 1994"
9,22,3,473,562,673,1235,"21 de agosto de 1994"
9,22,3,474,472,564,1036,"21 de agosto de 1994"
9,22,3,475,516,630,1146,"21 de agosto de 1994"
9,22,3,476,510,626,1136,"21 de agosto de 1994"
9,22,3,477,345,399,744,"21 de agosto de 1994"
9,22,3,478,450,528,978,"21 de agosto de 1994"
9,22,3,479,149,212,361,"21 de agosto de 1994"
9,22,3,480,231,324,555,"21 de agosto de 1994"
9,22,3,481,236,228,464,"21 de agosto de 1994"
9,22,3,482,549,607,1156,"21 de agosto de 1994"
9,22,3,483,202,265,467,"21 de agosto de 1994"
9,22,3,484,446,474,920,"21 de agosto de 1994"
9,22,3,485,566,623,1189,"21 de agosto de 1994"
9,22,3,486,383,429,812,"21 de agosto de 1994"
9,22,3,487,496,526,1022,"21 de agosto de 1994"
9,22,3,488,423,483,906,"21 de agosto de 1994"
9,22,3,489,421,437,858,"21 de agosto de 1994"
9,22,3,490,490,525,1015,"21 de agosto de 1994"
9,22,3,491,305,406,711,"21 de agosto de 1994"
9,22,3,492,299,340,639,"21 de agosto de 1994"
9,22,3,493,541,557,1098,"21 de agosto de 1994"
9,22,3,494,340,372,712,"21 de agosto de 1994"
9,22,3,495,243,313,556,"21 de agosto de 1994"
9,22,3,496,355,367,722,"21 de agosto de 1994"
9,22,3,497,317,331,648,"21 de agosto de 1994"
9,22,3,498,336,360,696,"21 de agosto de 1994"
9,22,3,499,394,481,875,"21 de agosto de 1994"
9,22,3,500,395,427,822,"21 de agosto de 1994"
9,22,3,501,515,529,1044,"21 de agosto de 1994"
9,22,3,502,413,474,887,"21 de agosto de 1994"
9,22,3,503,505,531,1036,"21 de agosto de 1994"
9,22,3,504,381,386,767,"21 de agosto de 1994"
9,22,3,505,291,290,581,"21 de agosto de 1994"
9,22,3,506,218,261,479,"21 de agosto de 1994"
9,22,3,507,319,338,657,"21 de agosto de 1994"
9,22,3,508,281,313,594,"21 de agosto de 1994"
9,22,3,509,275,323,598,"21 de agosto de 1994"
9,22,3,510,307,336,643,"21 de agosto de 1994"
9,22,3,511,208,233,441,"21 de agosto de 1994"
9,22,3,512,286,360,646,"21 de agosto de 1994"
9,22,3,513,308,308,616,"21 de agosto de 1994"
9,22,3,514,338,359,697,"21 de agosto de 1994"
9,22,3,515,370,409,779,"21 de agosto de 1994"
9,22,10,3217,395,502,897,"21 de agosto de 1994"
9,22,10,3218,368,442,810,"21 de agosto de 1994"
9,22,10,3219,291,328,619,"21 de agosto de 1994"
9,22,10,3220,122,151,273,"21 de agosto de 1994"
9,22,10,3221,484,639,1123,"21 de agosto de 1994"
9,22,10,3222,288,422,710,"21 de agosto de 1994"
9,22,10,3223,190,317,507,"21 de agosto de 1994"
9,22,10,3224,413,554,967,"21 de agosto de 1994"
9,22,10,3225,444,582,1026,"21 de agosto de 1994"
9,22,10,3226,343,489,832,"21 de agosto de 1994"
9,22,10,3227,402,492,894,"21 de agosto de 1994"
9,22,10,3228,453,566,1019,"21 de agosto de 1994"
9,22,10,3229,378,496,874,"21 de agosto de 1994"
9,22,10,3230,443,566,1009,"21 de agosto de 1994"
9,22,10,3231,387,495,882,"21 de agosto de 1994"
9,22,10,3232,427,527,954,"21 de agosto de 1994"
9,22,10,3233,453,648,1101,"21 de agosto de 1994"
9,22,10,3234,301,359,660,"21 de agosto de 1994"
9,22,12,3742,379,423,802,"21 de agosto de 1994"
9,22,12,3743,405,409,814,"21 de agosto de 1994"
9,22,12,3744,494,556,1050,"21 de agosto de 1994"
9,22,12,3745,475,568,1043,"21 de agosto de 1994"
9,22,12,3746,714,780,1494,"21 de agosto de 1994"
9,22,12,3747,482,515,997,"21 de agosto de 1994"
9,22,12,3748,529,587,1116,"21 de agosto de 1994"
9,22,12,3749,497,524,1021,"21 de agosto de 1994"
9,22,12,3750,487,534,1021,"21 de agosto de 1994"
9,22,12,3751,509,556,1065,"21 de agosto de 1994"
9,22,12,3752,643,669,1312,"21 de agosto de 1994"
9,22,12,3753,388,443,831,"21 de agosto de 1994"
9,22,12,3754,423,456,879,"21 de agosto de 1994"
9,22,12,3755,370,436,806,"21 de agosto de 1994"
9,22,12,3756,350,412,762,"21 de agosto de 1994"
9,22,12,3757,493,544,1037,"21 de agosto de 1994"
9,22,12,3758,597,648,1245,"21 de agosto de 1994"
9,22,12,3759,265,280,545,"21 de agosto de 1994"
9,22,12,3760,176,194,370,"21 de agosto de 1994"
9,22,12,3761,269,279,548,"21 de agosto de 1994"
9,22,12,3762,587,633,1220,"21 de agosto de 1994"
9,22,12,3763,471,544,1015,"21 de agosto de 1994"
9,22,12,3764,316,430,746,"21 de agosto de 1994"
9,22,12,3765,383,628,1011,"21 de agosto de 1994"
9,22,12,3766,465,559,1024,"21 de agosto de 1994"
9,22,12,3767,504,582,1086,"21 de agosto de 1994"
9,22,12,3768,24,28,52,"21 de agosto de 1994"
9,23,4,747,312,311,623,"21 de agosto de 1994"
9,23,4,748,598,754,1352,"21 de agosto de 1994"
9,23,4,749,208,262,470,"21 de agosto de 1994"
9,23,4,750,361,381,742,"21 de agosto de 1994"
9,23,4,751,251,315,566,"21 de agosto de 1994"
9,23,4,752,270,288,558,"21 de agosto de 1994"
9,23,4,753,445,502,947,"21 de agosto de 1994"
9,23,4,754,757,838,1595,"21 de agosto de 1994"
9,23,4,755,471,507,978,"21 de agosto de 1994"
9,23,4,756,298,322,620,"21 de agosto de 1994"
9,23,4,757,622,644,1266,"21 de agosto de 1994"
9,23,4,758,535,560,1095,"21 de agosto de 1994"
9,23,4,759,430,556,986,"21 de agosto de 1994"
9,23,4,760,209,267,476,"21 de agosto de 1994"
9,23,4,761,491,564,1055,"21 de agosto de 1994"
9,23,4,762,429,482,911,"21 de agosto de 1994"
9,23,4,763,576,671,1247,"21 de agosto de 1994"
9,23,4,764,572,574,1146,"21 de agosto de 1994"
9,23,4,765,590,604,1194,"21 de agosto de 1994"
9,23,4,766,341,398,739,"21 de agosto de 1994"
9,23,4,767,580,595,1175,"21 de agosto de 1994"
9,23,4,768,214,239,453,"21 de agosto de 1994"
9,23,4,769,430,502,932,"21 de agosto de 1994"
9,23,4,770,513,561,1074,"21 de agosto de 1994"
9,23,4,771,446,490,936,"21 de agosto de 1994"
9,23,4,772,414,498,912,"21 de agosto de 1994"
9,23,4,773,517,546,1063,"21 de agosto de 1994"
9,23,4,774,153,147,300,"21 de agosto de 1994"
9,23,4,775,514,551,1065,"21 de agosto de 1994"
9,23,4,776,517,547,1064,"21 de agosto de 1994"
9,23,4,777,371,412,783,"21 de agosto de 1994"
9,23,4,778,580,619,1199,"21 de agosto de 1994"
9,23,4,779,363,440,803,"21 de agosto de 1994"
9,23,4,780,366,396,762,"21 de agosto de 1994"
9,23,4,781,592,696,1288,"21 de agosto de 1994"
9,23,4,782,435,478,913,"21 de agosto de 1994"
9,23,4,783,433,477,910,"21 de agosto de 1994"
9,23,4,784,350,434,784,"21 de agosto de 1994"
9,23,4,785,388,431,819,"21 de agosto de 1994"
9,23,4,786,531,566,1097,"21 de agosto de 1994"
9,23,4,787,452,450,902,"21 de agosto de 1994"
9,23,4,788,509,525,1034,"21 de agosto de 1994"
9,23,4,789,390,415,805,"21 de agosto de 1994"
9,23,4,790,612,662,1274,"21 de agosto de 1994"
9,23,4,791,657,768,1425,"21 de agosto de 1994"
9,23,4,792,502,587,1089,"21 de agosto de 1994"
9,23,4,793,629,667,1296,"21 de agosto de 1994"
9,23,4,794,472,563,1035,"21 de agosto de 1994"
9,23,4,795,602,704,1306,"21 de agosto de 1994"
9,23,4,796,588,627,1215,"21 de agosto de 1994"
9,23,4,797,677,778,1455,"21 de agosto de 1994"
9,23,4,798,491,500,991,"21 de agosto de 1994"
9,23,4,799,569,669,1238,"21 de agosto de 1994"
9,23,4,800,400,460,860,"21 de agosto de 1994"
9,23,4,801,517,638,1155,"21 de agosto de 1994"
9,23,4,802,437,476,913,"21 de agosto de 1994"
9,23,4,803,360,388,748,"21 de agosto de 1994"
9,23,4,804,389,471,860,"21 de agosto de 1994"
9,23,4,805,424,416,840,"21 de agosto de 1994"
9,23,4,806,590,594,1184,"21 de agosto de 1994"
9,23,4,807,479,555,1034,"21 de agosto de 1994"
9,23,4,808,302,348,650,"21 de agosto de 1994"
9,23,4,809,542,594,1136,"21 de agosto de 1994"
9,23,4,810,471,500,971,"21 de agosto de 1994"
9,23,4,811,581,590,1171,"21 de agosto de 1994"
9,23,4,812,483,522,1005,"21 de agosto de 1994"
9,23,4,813,178,168,346,"21 de agosto de 1994"
9,23,4,814,653,726,1379,"21 de agosto de 1994"
9,23,4,815,475,514,989,"21 de agosto de 1994"
9,23,4,816,611,697,1308,"21 de agosto de 1994"
9,23,4,817,236,264,500,"21 de agosto de 1994"
9,23,4,818,240,260,500,"21 de agosto de 1994"
9,23,4,819,452,458,910,"21 de agosto de 1994"
9,23,4,820,311,343,654,"21 de agosto de 1994"
9,23,4,5536,196,201,397,"21 de agosto de 1994"
9,23,10,668,0,0,0,"21 de agosto de 1994"
9,23,10,3000,0,0,0,"21 de agosto de 1994"
9,23,10,3235,312,351,663,"21 de agosto de 1994"
9,23,10,3236,691,741,1432,"21 de agosto de 1994"
9,23,10,3237,382,457,839,"21 de agosto de 1994"
9,23,10,3238,402,473,875,"21 de agosto de 1994"
9,23,10,3239,560,646,1206,"21 de agosto de 1994"
9,23,10,3240,407,457,864,"21 de agosto de 1994"
9,23,10,3241,562,608,1170,"21 de agosto de 1994"
9,23,10,3242,591,686,1277,"21 de agosto de 1994"
9,23,10,3243,223,246,469,"21 de agosto de 1994"
9,23,10,3244,378,508,886,"21 de agosto de 1994"
9,23,10,3245,553,611,1164,"21 de agosto de 1994"
9,23,10,3246,341,381,722,"21 de agosto de 1994"
9,23,10,3247,301,323,624,"21 de agosto de 1994"
9,23,10,3248,465,540,1005,"21 de agosto de 1994"
9,23,10,3249,551,574,1125,"21 de agosto de 1994"
9,23,10,3250,523,551,1074,"21 de agosto de 1994"
9,23,10,3251,453,542,995,"21 de agosto de 1994"
9,23,10,3252,425,441,866,"21 de agosto de 1994"
9,23,10,3253,677,780,1457,"21 de agosto de 1994"
9,23,10,3254,695,802,1497,"21 de agosto de 1994"
9,23,10,3255,423,528,951,"21 de agosto de 1994"
9,23,10,3256,494,643,1137,"21 de agosto de 1994"
9,23,10,3257,375,475,850,"21 de agosto de 1994"
9,23,10,3258,365,475,840,"21 de agosto de 1994"
9,23,10,3259,364,428,792,"21 de agosto de 1994"
9,23,10,3260,506,526,1032,"21 de agosto de 1994"
9,23,10,3261,424,535,959,"21 de agosto de 1994"
9,23,10,3262,397,447,844,"21 de agosto de 1994"
9,23,10,3263,622,668,1290,"21 de agosto de 1994"
9,23,10,3264,508,609,1117,"21 de agosto de 1994"
9,23,10,3265,531,540,1071,"21 de agosto de 1994"
9,23,10,3266,489,523,1012,"21 de agosto de 1994"
9,23,10,3267,533,591,1124,"21 de agosto de 1994"
9,23,10,3268,545,561,1106,"21 de agosto de 1994"
9,23,10,3269,567,593,1160,"21 de agosto de 1994"
9,23,10,3270,535,551,1086,"21 de agosto de 1994"
9,23,10,3271,584,593,1177,"21 de agosto de 1994"
9,23,10,3272,531,572,1103,"21 de agosto de 1994"
9,23,10,3273,332,352,684,"21 de agosto de 1994"
9,23,10,3274,563,607,1170,"21 de agosto de 1994"
9,23,10,3275,383,436,819,"21 de agosto de 1994"
9,23,10,3276,590,599,1189,"21 de agosto de 1994"
9,23,10,3277,526,587,1113,"21 de agosto de 1994"
9,23,10,3278,548,593,1141,"21 de agosto de 1994"
9,23,10,3279,599,627,1226,"21 de agosto de 1994"
9,23,10,3280,357,381,738,"21 de agosto de 1994"
9,23,10,3281,478,565,1043,"21 de agosto de 1994"
9,23,10,3282,380,424,804,"21 de agosto de 1994"
9,23,10,3283,548,618,1166,"21 de agosto de 1994"
9,23,10,3284,352,369,721,"21 de agosto de 1994"
9,23,10,3285,426,474,900,"21 de agosto de 1994"
9,23,10,3286,594,644,1238,"21 de agosto de 1994"
9,23,10,3287,412,458,870,"21 de agosto de 1994"
9,23,10,3288,442,451,893,"21 de agosto de 1994"
9,23,10,3289,551,573,1124,"21 de agosto de 1994"
9,23,10,3290,407,442,849,"21 de agosto de 1994"
9,23,10,3291,631,683,1314,"21 de agosto de 1994"
9,23,10,3292,367,381,748,"21 de agosto de 1994"
9,23,10,3293,461,589,1050,"21 de agosto de 1994"
9,23,10,3294,378,497,875,"21 de agosto de 1994"
9,23,10,3295,325,445,770,"21 de agosto de 1994"
9,23,10,3296,387,422,809,"21 de agosto de 1994"
9,23,10,3297,487,532,1019,"21 de agosto de 1994"
9,23,10,3298,656,733,1389,"21 de agosto de 1994"
9,23,10,3299,462,510,972,"21 de agosto de 1994"
9,23,10,3300,547,593,1140,"21 de agosto de 1994"
9,23,10,3301,586,641,1227,"21 de agosto de 1994"
9,23,10,3302,582,607,1189,"21 de agosto de 1994"
9,23,10,3303,457,544,1001,"21 de agosto de 1994"
9,23,10,3304,323,361,684,"21 de agosto de 1994"
9,23,10,3305,583,594,1177,"21 de agosto de 1994"
9,23,10,3306,525,603,1128,"21 de agosto de 1994"
9,23,10,3307,474,523,997,"21 de agosto de 1994"
9,23,10,3308,445,499,944,"21 de agosto de 1994"
9,23,10,3309,452,488,940,"21 de agosto de 1994"
9,23,10,3310,476,547,1023,"21 de agosto de 1994"
9,23,10,3311,510,586,1096,"21 de agosto de 1994"
9,23,10,3312,484,553,1037,"21 de agosto de 1994"
9,23,10,3313,414,499,913,"21 de agosto de 1994"
9,23,10,3314,580,607,1187,"21 de agosto de 1994"
9,23,10,3315,665,747,1412,"21 de agosto de 1994"
9,23,10,3316,529,600,1129,"21 de agosto de 1994"
9,23,10,3317,478,542,1020,"21 de agosto de 1994"
9,23,10,3318,555,589,1144,"21 de agosto de 1994"
9,23,10,3319,375,354,729,"21 de agosto de 1994"
9,23,10,3320,423,470,893,"21 de agosto de 1994"
9,23,10,3321,599,645,1244,"21 de agosto de 1994"
9,23,10,3322,500,587,1087,"21 de agosto de 1994"
9,23,10,3323,684,771,1455,"21 de agosto de 1994"
9,23,10,3324,442,458,900,"21 de agosto de 1994"
9,23,10,3325,473,541,1014,"21 de agosto de 1994"
9,23,10,3326,493,539,1032,"21 de agosto de 1994"
9,23,10,3327,465,515,980,"21 de agosto de 1994"
9,23,10,3328,528,584,1112,"21 de agosto de 1994"
9,23,10,3329,522,560,1082,"21 de agosto de 1994"
9,23,10,3330,582,576,1158,"21 de agosto de 1994"
9,23,10,3331,316,355,671,"21 de agosto de 1994"
9,23,10,3332,453,509,962,"21 de agosto de 1994"
9,23,10,3333,552,552,1104,"21 de agosto de 1994"
9,23,10,3334,459,520,979,"21 de agosto de 1994"
9,23,10,3335,390,421,811,"21 de agosto de 1994"
9,23,10,3336,453,502,955,"21 de agosto de 1994"
9,23,10,3337,620,673,1293,"21 de agosto de 1994"
9,23,10,3338,601,677,1278,"21 de agosto de 1994"
9,23,10,3339,386,449,835,"21 de agosto de 1994"
9,23,10,3340,469,517,986,"21 de agosto de 1994"
9,23,10,3341,592,649,1241,"21 de agosto de 1994"
9,23,10,3342,341,434,775,"21 de agosto de 1994"
9,23,10,3343,462,504,966,"21 de agosto de 1994"
9,23,10,3344,510,557,1067,"21 de agosto de 1994"
9,23,10,3345,445,471,916,"21 de agosto de 1994"
9,23,10,3346,366,440,806,"21 de agosto de 1994"
9,23,10,3347,470,535,1005,"21 de agosto de 1994"
9,23,10,3348,543,639,1182,"21 de agosto de 1994"
9,23,10,3349,501,594,1095,"21 de agosto de 1994"
9,23,10,3350,578,672,1250,"21 de agosto de 1994"
9,23,10,3351,603,684,1287,"21 de agosto de 1994"
9,23,10,3352,541,634,1175,"21 de agosto de 1994"
9,23,10,3353,267,301,568,"21 de agosto de 1994"
9,23,10,3354,560,636,1196,"21 de agosto de 1994"
9,23,10,3355,194,216,410,"21 de agosto de 1994"
9,23,10,3356,465,545,1010,"21 de agosto de 1994"
9,23,10,3357,393,465,858,"21 de agosto de 1994"
9,23,10,3358,575,702,1277,"21 de agosto de 1994"
9,23,10,3359,400,432,832,"21 de agosto de 1994"
9,23,10,3360,397,454,851,"21 de agosto de 1994"
9,23,10,3361,304,346,650,"21 de agosto de 1994"
9,23,10,3362,439,446,885,"21 de agosto de 1994"
9,23,10,3363,328,346,674,"21 de agosto de 1994"
9,23,10,3364,522,570,1092,"21 de agosto de 1994"
9,23,10,3365,309,361,670,"21 de agosto de 1994"
9,23,10,3366,240,294,534,"21 de agosto de 1994"
9,23,10,3367,274,358,632,"21 de agosto de 1994"
9,23,10,3368,277,312,589,"21 de agosto de 1994"
9,23,10,3369,331,407,738,"21 de agosto de 1994"
9,23,10,3370,401,425,826,"21 de agosto de 1994"
9,23,10,3371,596,702,1298,"21 de agosto de 1994"
9,23,10,3372,256,248,504,"21 de agosto de 1994"
9,23,10,3373,197,221,418,"21 de agosto de 1994"
9,23,10,3374,430,504,934,"21 de agosto de 1994"
9,23,10,3375,554,641,1195,"21 de agosto de 1994"
9,23,10,3376,417,412,829,"21 de agosto de 1994"
9,23,10,3377,486,535,1021,"21 de agosto de 1994"
9,23,10,3378,417,540,957,"21 de agosto de 1994"
9,23,10,3379,535,595,1130,"21 de agosto de 1994"
9,23,10,3380,598,630,1228,"21 de agosto de 1994"
9,23,10,3381,481,483,964,"21 de agosto de 1994"
9,23,10,3382,467,518,985,"21 de agosto de 1994"
9,23,10,3383,332,380,712,"21 de agosto de 1994"
9,23,10,3384,361,411,772,"21 de agosto de 1994"
9,23,10,3385,409,458,867,"21 de agosto de 1994"
9,23,10,3386,499,541,1040,"21 de agosto de 1994"
9,23,10,3387,439,497,936,"21 de agosto de 1994"
9,23,10,3388,583,643,1226,"21 de agosto de 1994"
9,23,10,3389,534,566,1100,"21 de agosto de 1994"
9,23,10,3390,539,618,1157,"21 de agosto de 1994"
9,23,10,3391,733,829,1562,"21 de agosto de 1994"
9,23,10,3392,396,455,851,"21 de agosto de 1994"
9,23,10,3393,408,476,884,"21 de agosto de 1994"
9,23,10,3394,424,453,877,"21 de agosto de 1994"
9,23,10,3395,351,372,723,"21 de agosto de 1994"
9,23,10,3396,365,373,738,"21 de agosto de 1994"
9,23,10,3397,295,362,657,"21 de agosto de 1994"
9,23,10,3398,260,313,573,"21 de agosto de 1994"
9,23,10,3399,282,278,560,"21 de agosto de 1994"
9,23,10,3400,181,170,351,"21 de agosto de 1994"
9,23,10,3401,249,271,520,"21 de agosto de 1994"
9,23,10,3402,259,266,525,"21 de agosto de 1994"
9,24,12,3104,1,0,1,"21 de agosto de 1994"
9,24,12,3769,424,523,947,"21 de agosto de 1994"
9,24,12,3770,297,398,695,"21 de agosto de 1994"
9,24,12,3771,401,482,883,"21 de agosto de 1994"
9,24,12,3772,183,242,425,"21 de agosto de 1994"
9,24,12,3773,318,431,749,"21 de agosto de 1994"
9,24,12,3774,568,661,1229,"21 de agosto de 1994"
9,24,12,3775,331,448,779,"21 de agosto de 1994"
9,24,12,3776,398,474,872,"21 de agosto de 1994"
9,24,12,3777,335,461,796,"21 de agosto de 1994"
9,24,12,3778,269,346,615,"21 de agosto de 1994"
9,24,12,3779,311,381,692,"21 de agosto de 1994"
9,24,12,3780,517,658,1175,"21 de agosto de 1994"
9,24,12,3781,379,484,863,"21 de agosto de 1994"
9,24,12,3782,252,353,605,"21 de agosto de 1994"
9,24,12,3783,348,456,804,"21 de agosto de 1994"
9,24,12,3784,123,156,279,"21 de agosto de 1994"
9,24,12,3785,459,458,917,"21 de agosto de 1994"
9,24,12,3786,515,530,1045,"21 de agosto de 1994"
9,24,12,3787,423,483,906,"21 de agosto de 1994"
9,24,12,3788,486,547,1033,"21 de agosto de 1994"
9,24,12,3789,214,258,472,"21 de agosto de 1994"
9,24,12,3790,466,538,1004,"21 de agosto de 1994"
9,24,12,3791,490,544,1034,"21 de agosto de 1994"
9,24,12,3792,462,451,913,"21 de agosto de 1994"
9,24,12,3793,389,406,795,"21 de agosto de 1994"
9,24,12,3794,473,538,1011,"21 de agosto de 1994"
9,24,12,3795,429,471,900,"21 de agosto de 1994"
9,24,12,3796,495,545,1040,"21 de agosto de 1994"
9,24,12,3797,476,519,995,"21 de agosto de 1994"
9,24,12,3798,419,484,903,"21 de agosto de 1994"
9,24,12,3799,542,576,1118,"21 de agosto de 1994"
9,24,12,3800,550,581,1131,"21 de agosto de 1994"
9,24,12,3801,462,516,978,"21 de agosto de 1994"
9,24,12,3802,497,567,1064,"21 de agosto de 1994"
9,24,12,3803,471,518,989,"21 de agosto de 1994"
9,24,12,3804,480,531,1011,"21 de agosto de 1994"
9,24,12,3805,456,474,930,"21 de agosto de 1994"
9,24,12,3806,420,481,901,"21 de agosto de 1994"
9,24,12,3807,342,378,720,"21 de agosto de 1994"
9,24,12,3808,344,394,738,"21 de agosto de 1994"
9,24,12,3809,589,594,1183,"21 de agosto de 1994"
9,24,12,3810,420,441,861,"21 de agosto de 1994"
9,24,12,3811,400,492,892,"21 de agosto de 1994"
9,24,12,3812,521,587,1108,"21 de agosto de 1994"
9,24,12,3813,547,620,1167,"21 de agosto de 1994"
9,24,12,3814,562,596,1158,"21 de agosto de 1994"
9,24,12,3815,392,407,799,"21 de agosto de 1994"
9,24,12,3816,638,664,1302,"21 de agosto de 1994"
9,24,12,3817,613,632,1245,"21 de agosto de 1994"
9,24,12,3818,572,656,1228,"21 de agosto de 1994"
9,24,12,3819,415,443,858,"21 de agosto de 1994"
9,24,12,3820,466,549,1015,"21 de agosto de 1994"
9,24,12,3821,421,466,887,"21 de agosto de 1994"
9,24,12,3822,453,491,944,"21 de agosto de 1994"
9,24,12,3823,514,581,1095,"21 de agosto de 1994"
9,24,12,3824,444,511,955,"21 de agosto de 1994"
9,24,12,3825,328,375,703,"21 de agosto de 1994"
9,24,12,3826,468,489,957,"21 de agosto de 1994"
9,24,12,3827,482,523,1005,"21 de agosto de 1994"
9,24,12,3828,446,510,956,"21 de agosto de 1994"
9,24,12,3829,530,596,1126,"21 de agosto de 1994"
9,24,12,3830,466,537,1003,"21 de agosto de 1994"
9,24,12,3831,348,376,724,"21 de agosto de 1994"
9,24,12,3832,515,551,1066,"21 de agosto de 1994"
9,24,12,3833,434,495,929,"21 de agosto de 1994"
9,24,12,3834,313,350,663,"21 de agosto de 1994"
9,24,12,3835,418,483,901,"21 de agosto de 1994"
9,24,12,3836,416,485,901,"21 de agosto de 1994"
9,24,12,3837,246,296,542,"21 de agosto de 1994"
9,24,12,3838,385,453,838,"21 de agosto de 1994"
9,24,12,3839,365,418,783,"21 de agosto de 1994"
9,24,12,3840,562,612,1174,"21 de agosto de 1994"
9,24,12,3841,458,488,946,"21 de agosto de 1994"
9,24,12,3842,312,458,770,"21 de agosto de 1994"
9,24,12,3843,519,694,1213,"21 de agosto de 1994"
9,24,12,3844,410,523,933,"21 de agosto de 1994"
9,24,12,3845,388,447,835,"21 de agosto de 1994"
9,24,12,3846,279,351,630,"21 de agosto de 1994"
9,24,12,3847,401,418,819,"21 de agosto de 1994"
9,24,12,3848,401,542,943,"21 de agosto de 1994"
9,24,12,3849,347,384,731,"21 de agosto de 1994"
9,24,12,3850,291,418,709,"21 de agosto de 1994"
9,24,12,3851,266,300,566,"21 de agosto de 1994"
9,24,12,3852,251,318,569,"21 de agosto de 1994"
9,24,12,3853,243,345,588,"21 de agosto de 1994"
9,24,12,3854,211,251,462,"21 de agosto de 1994"
9,24,12,3855,326,349,675,"21 de agosto de 1994"
9,24,12,3856,494,554,1048,"21 de agosto de 1994"
9,24,12,3857,542,627,1169,"21 de agosto de 1994"
9,24,12,3858,503,574,1077,"21 de agosto de 1994"
9,24,12,3859,422,397,819,"21 de agosto de 1994"
9,24,12,3860,503,539,1042,"21 de agosto de 1994"
9,24,12,3861,585,656,1241,"21 de agosto de 1994"
9,24,12,3862,409,438,847,"21 de agosto de 1994"
9,24,12,3863,411,458,869,"21 de agosto de 1994"
9,24,12,3864,357,368,725,"21 de agosto de 1994"
9,24,12,3865,426,463,889,"21 de agosto de 1994"
9,24,12,3866,425,498,923,"21 de agosto de 1994"
9,24,12,3867,541,590,1131,"21 de agosto de 1994"
9,24,12,3868,565,609,1174,"21 de agosto de 1994"
9,24,12,3869,463,506,969,"21 de agosto de 1994"
9,24,12,3870,559,662,1221,"21 de agosto de 1994"
9,24,12,3871,494,557,1051,"21 de agosto de 1994"
9,24,12,3872,573,667,1240,"21 de agosto de 1994"
9,24,12,3873,525,574,1099,"21 de agosto de 1994"
9,24,12,3874,547,581,1128,"21 de agosto de 1994"
9,24,12,3875,538,573,1111,"21 de agosto de 1994"
9,24,12,3876,555,579,1134,"21 de agosto de 1994"
9,24,12,3877,533,577,1110,"21 de agosto de 1994"
9,24,12,3878,506,557,1063,"21 de agosto de 1994"
9,24,12,3879,427,433,860,"21 de agosto de 1994"
9,24,12,3880,416,482,898,"21 de agosto de 1994"
9,24,12,3881,410,441,851,"21 de agosto de 1994"
9,24,12,3882,391,445,836,"21 de agosto de 1994"
9,24,12,3883,392,434,826,"21 de agosto de 1994"
9,24,12,3884,488,551,1039,"21 de agosto de 1994"
9,24,12,3885,491,536,1027,"21 de agosto de 1994"
9,24,12,3886,39,40,79,"21 de agosto de 1994"
9,24,12,3887,80,74,154,"21 de agosto de 1994"
9,24,12,3888,266,242,508,"21 de agosto de 1994"
9,24,12,3889,574,661,1235,"21 de agosto de 1994"
9,24,12,3890,252,319,571,"21 de agosto de 1994"
9,24,12,3891,226,270,496,"21 de agosto de 1994"
9,24,12,3892,375,391,766,"21 de agosto de 1994"
9,24,12,3893,415,385,800,"21 de agosto de 1994"
9,24,12,3894,246,291,537,"21 de agosto de 1994"
9,24,12,3895,65,84,149,"21 de agosto de 1994"
9,24,12,3896,60,102,162,"21 de agosto de 1994"
9,24,12,3897,108,145,253,"21 de agosto de 1994"
9,24,12,3898,178,194,372,"21 de agosto de 1994"
9,24,12,3899,510,569,1079,"21 de agosto de 1994"
9,24,12,3900,92,128,220,"21 de agosto de 1994"
9,24,12,3901,213,292,505,"21 de agosto de 1994"
9,24,12,3902,181,193,374,"21 de agosto de 1994"
9,24,12,3903,417,451,868,"21 de agosto de 1994"
9,24,12,3904,457,544,1001,"21 de agosto de 1994"
9,24,12,3905,313,312,625,"21 de agosto de 1994"
9,24,12,3906,667,719,1386,"21 de agosto de 1994"
9,24,12,3907,283,342,625,"21 de agosto de 1994"
9,24,12,3908,430,473,903,"21 de agosto de 1994"
9,24,12,3909,351,381,732,"21 de agosto de 1994"
9,24,12,3910,527,608,1135,"21 de agosto de 1994"
9,24,12,3911,531,536,1067,"21 de agosto de 1994"
9,24,12,3912,397,444,841,"21 de agosto de 1994"
9,24,12,3913,358,413,771,"21 de agosto de 1994"
9,24,12,3914,447,452,899,"21 de agosto de 1994"
9,24,12,3915,492,545,1037,"21 de agosto de 1994"
9,24,12,3916,438,525,963,"21 de agosto de 1994"
9,24,12,3917,472,488,960,"21 de agosto de 1994"
9,24,12,3918,536,608,1144,"21 de agosto de 1994"
9,24,12,3919,396,410,806,"21 de agosto de 1994"
9,24,12,3920,199,249,448,"21 de agosto de 1994"
9,24,12,3921,598,661,1259,"21 de agosto de 1994"
9,24,12,3922,354,373,727,"21 de agosto de 1994"
9,24,12,3923,434,498,932,"21 de agosto de 1994"
9,24,12,3924,444,528,972,"21 de agosto de 1994"
9,24,12,3925,413,456,869,"21 de agosto de 1994"
9,24,12,3926,412,474,886,"21 de agosto de 1994"
9,24,12,3927,501,590,1091,"21 de agosto de 1994"
9,24,12,3928,444,454,898,"21 de agosto de 1994"
9,24,12,3929,315,374,689,"21 de agosto de 1994"
9,24,12,3930,472,515,987,"21 de agosto de 1994"
9,24,12,3931,414,446,860,"21 de agosto de 1994"
9,24,12,3932,391,438,829,"21 de agosto de 1994"
9,24,12,3933,248,280,528,"21 de agosto de 1994"
9,24,12,3934,328,350,678,"21 de agosto de 1994"
9,24,12,3935,655,672,1327,"21 de agosto de 1994"
9,24,12,3936,345,345,690,"21 de agosto de 1994"
9,24,12,3937,318,362,680,"21 de agosto de 1994"
9,24,12,3938,480,503,983,"21 de agosto de 1994"
9,24,12,3939,467,503,970,"21 de agosto de 1994"
9,24,12,3940,264,304,568,"21 de agosto de 1994"
9,24,12,3941,227,248,475,"21 de agosto de 1994"
9,24,12,3942,317,343,660,"21 de agosto de 1994"
9,24,12,3943,473,556,1029,"21 de agosto de 1994"
9,24,12,3944,832,853,1685,"21 de agosto de 1994"
9,24,12,3945,579,649,1228,"21 de agosto de 1994"
9,24,12,3946,486,525,1011,"21 de agosto de 1994"
9,24,12,3947,455,510,965,"21 de agosto de 1994"
9,24,12,3948,530,544,1074,"21 de agosto de 1994"
9,24,12,3949,347,414,761,"21 de agosto de 1994"
9,24,12,3950,342,375,717,"21 de agosto de 1994"
9,24,12,3951,584,628,1212,"21 de agosto de 1994"
9,24,12,3952,644,648,1292,"21 de agosto de 1994"
9,24,12,3953,600,673,1273,"21 de agosto de 1994"
9,24,12,3954,393,458,851,"21 de agosto de 1994"
9,24,12,3955,427,435,862,"21 de agosto de 1994"
9,24,12,3956,717,399,1116,"21 de agosto de 1994"
9,24,12,3957,359,438,797,"21 de agosto de 1994"
9,24,12,3958,604,618,1222,"21 de agosto de 1994"
9,24,12,3959,486,483,969,"21 de agosto de 1994"
9,24,12,3960,293,314,607,"21 de agosto de 1994"
9,24,12,3961,506,529,1035,"21 de agosto de 1994"
9,24,12,3962,616,661,1277,"21 de agosto de 1994"
9,24,12,3963,530,594,1124,"21 de agosto de 1994"
9,24,12,3964,356,360,716,"21 de agosto de 1994"
9,24,12,3965,367,398,765,"21 de agosto de 1994"
9,24,12,3966,478,499,977,"21 de agosto de 1994"
9,24,12,3967,284,326,610,"21 de agosto de 1994"
9,24,12,3968,299,300,599,"21 de agosto de 1994"
9,24,12,3969,544,611,1155,"21 de agosto de 1994"
9,24,12,3970,616,681,1297,"21 de agosto de 1994"
9,24,12,3971,290,306,596,"21 de agosto de 1994"
9,24,12,3972,571,595,1166,"21 de agosto de 1994"
9,24,12,3973,517,516,1033,"21 de agosto de 1994"
9,24,12,3974,482,513,995,"21 de agosto de 1994"
9,24,12,3975,551,595,1146,"21 de agosto de 1994"
9,24,12,3976,290,312,602,"21 de agosto de 1994"
9,24,12,3977,415,458,873,"21 de agosto de 1994"
9,24,12,3978,496,539,1035,"21 de agosto de 1994"
9,24,12,3979,514,579,1093,"21 de agosto de 1994"
9,24,12,3980,437,483,920,"21 de agosto de 1994"
9,24,12,3981,506,483,989,"21 de agosto de 1994"
9,24,12,3982,492,523,1015,"21 de agosto de 1994"
9,24,12,3983,530,570,1100,"21 de agosto de 1994"
9,24,12,3984,619,697,1316,"21 de agosto de 1994"
9,24,12,3985,401,462,863,"21 de agosto de 1994"
9,24,12,3986,753,824,1577,"21 de agosto de 1994"
9,24,12,3987,578,637,1215,"21 de agosto de 1994"
9,24,12,3988,714,734,1448,"21 de agosto de 1994"
9,24,12,3989,453,497,950,"21 de agosto de 1994"
9,24,12,3990,353,384,737,"21 de agosto de 1994"
9,24,12,3991,616,659,1275,"21 de agosto de 1994"
9,24,12,3992,579,642,1221,"21 de agosto de 1994"
9,24,12,3993,447,439,886,"21 de agosto de 1994"
9,24,12,3994,48,38,86,"21 de agosto de 1994"
9,24,12,3995,171,193,364,"21 de agosto de 1994"
9,24,12,3996,220,253,473,"21 de agosto de 1994"
9,24,12,3997,264,302,566,"21 de agosto de 1994"
9,24,12,3998,363,411,774,"21 de agosto de 1994"
9,24,12,3999,312,334,646,"21 de agosto de 1994"
9,24,12,4000,233,258,491,"21 de agosto de 1994"
9,24,12,4001,272,292,564,"21 de agosto de 1994"
9,24,12,4002,1525,140,1665,"21 de agosto de 1994"
9,24,13,4095,478,568,1046,"21 de agosto de 1994"
9,24,13,4096,563,631,1194,"21 de agosto de 1994"
9,24,13,4097,422,512,934,"21 de agosto de 1994"
9,24,13,4098,404,510,914,"21 de agosto de 1994"
9,24,13,4099,287,355,642,"21 de agosto de 1994"
9,24,13,4100,408,535,943,"21 de agosto de 1994"
9,24,13,4101,440,542,982,"21 de agosto de 1994"
9,24,13,4102,361,397,758,"21 de agosto de 1994"
9,24,13,4103,399,460,859,"21 de agosto de 1994"
9,24,13,4104,418,494,912,"21 de agosto de 1994"
9,24,13,4105,402,438,840,"21 de agosto de 1994"
9,24,13,4106,550,355,905,"21 de agosto de 1994"
9,24,13,4107,587,642,1229,"21 de agosto de 1994"
9,24,13,4108,522,519,1041,"21 de agosto de 1994"
9,24,13,4109,708,701,1409,"21 de agosto de 1994"
9,24,13,4110,553,615,1168,"21 de agosto de 1994"
9,24,13,4111,448,535,983,"21 de agosto de 1994"
9,24,13,4112,469,499,968,"21 de agosto de 1994"
9,24,13,4113,448,498,946,"21 de agosto de 1994"
9,24,13,4114,424,482,906,"21 de agosto de 1994"
9,24,13,4115,224,266,490,"21 de agosto de 1994"
9,24,13,4116,288,347,635,"21 de agosto de 1994"
9,24,13,4117,360,428,788,"21 de agosto de 1994"
9,24,13,4118,455,512,967,"21 de agosto de 1994"
9,24,13,4119,512,583,1095,"21 de agosto de 1994"
9,24,13,4120,386,391,777,"21 de agosto de 1994"
9,24,13,4121,278,316,594,"21 de agosto de 1994"
9,24,13,4122,651,681,1332,"21 de agosto de 1994"
9,24,13,4123,417,450,867,"21 de agosto de 1994"
9,24,13,4124,528,651,1179,"21 de agosto de 1994"
9,24,13,4125,476,552,1028,"21 de agosto de 1994"
9,24,13,4126,380,431,811,"21 de agosto de 1994"
9,24,13,4127,445,471,916,"21 de agosto de 1994"
9,24,13,4128,545,597,1142,"21 de agosto de 1994"
9,24,13,4129,459,540,999,"21 de agosto de 1994"
9,24,13,4130,511,558,1069,"21 de agosto de 1994"
9,24,13,4131,349,383,732,"21 de agosto de 1994"
9,24,13,4132,421,498,919,"21 de agosto de 1994"
9,24,13,4133,376,410,786,"21 de agosto de 1994"
9,24,13,4134,301,337,638,"21 de agosto de 1994"
9,24,13,4135,488,564,1052,"21 de agosto de 1994"
9,24,13,4136,378,435,813,"21 de agosto de 1994"
9,24,13,4137,495,540,1035,"21 de agosto de 1994"
9,24,13,4138,511,584,1095,"21 de agosto de 1994"
9,24,13,4139,522,536,1058,"21 de agosto de 1994"
9,24,13,4140,664,707,1371,"21 de agosto de 1994"
9,24,13,4141,424,471,895,"21 de agosto de 1994"
9,24,13,4142,570,649,1219,"21 de agosto de 1994"
9,24,13,4143,436,490,926,"21 de agosto de 1994"
9,24,13,4144,461,530,991,"21 de agosto de 1994"
9,24,13,4145,397,444,841,"21 de agosto de 1994"
9,24,13,4146,669,715,1384,"21 de agosto de 1994"
9,24,13,4147,303,333,636,"21 de agosto de 1994"
9,24,13,4148,570,638,1208,"21 de agosto de 1994"
9,24,13,4149,443,479,922,"21 de agosto de 1994"
9,24,13,4150,415,456,871,"21 de agosto de 1994"
9,24,13,4151,508,550,1058,"21 de agosto de 1994"
9,24,13,4152,485,557,1042,"21 de agosto de 1994"
9,24,13,4153,547,592,1139,"21 de agosto de 1994"
9,24,13,4154,523,588,1111,"21 de agosto de 1994"
9,24,13,4155,488,546,1034,"21 de agosto de 1994"
9,24,13,4156,400,469,869,"21 de agosto de 1994"
9,24,13,4157,495,549,1044,"21 de agosto de 1994"
9,24,13,4158,520,579,1099,"21 de agosto de 1994"
9,24,13,4159,444,492,936,"21 de agosto de 1994"
9,24,13,4160,410,446,856,"21 de agosto de 1994"
9,24,13,4161,609,644,1253,"21 de agosto de 1994"
9,24,13,4162,484,537,1021,"21 de agosto de 1994"
9,24,13,4163,440,482,922,"21 de agosto de 1994"
9,24,13,4164,659,714,1373,"21 de agosto de 1994"
9,24,13,4165,535,602,1137,"21 de agosto de 1994"
9,24,13,4166,457,549,1006,"21 de agosto de 1994"
9,24,13,4167,488,531,1019,"21 de agosto de 1994"
9,24,13,4168,609,642,1251,"21 de agosto de 1994"
9,24,13,4169,473,518,991,"21 de agosto de 1994"
9,24,13,4170,405,447,852,"21 de agosto de 1994"
9,24,13,4171,453,505,958,"21 de agosto de 1994"
9,24,13,4172,401,440,841,"21 de agosto de 1994"
9,24,13,4173,600,613,1213,"21 de agosto de 1994"
9,24,13,4174,425,472,897,"21 de agosto de 1994"
9,24,13,4175,532,567,1099,"21 de agosto de 1994"
9,24,13,4176,410,462,872,"21 de agosto de 1994"
9,24,13,4177,604,669,1273,"21 de agosto de 1994"
9,24,13,4178,550,598,1148,"21 de agosto de 1994"
9,24,13,4179,510,580,1090,"21 de agosto de 1994"
9,24,13,4180,325,338,663,"21 de agosto de 1994"
9,24,13,4181,426,473,899,"21 de agosto de 1994"
9,24,13,4182,465,509,974,"21 de agosto de 1994"
9,24,13,4183,574,581,1155,"21 de agosto de 1994"
9,24,13,4184,443,494,937,"21 de agosto de 1994"
9,24,13,4185,454,522,976,"21 de agosto de 1994"
9,24,13,4186,493,598,1091,"21 de agosto de 1994"
9,24,13,4187,511,573,1084,"21 de agosto de 1994"
9,24,13,4188,546,599,1145,"21 de agosto de 1994"
9,24,13,4189,443,541,984,"21 de agosto de 1994"
9,24,13,4190,396,433,829,"21 de agosto de 1994"
9,24,13,4191,549,603,1152,"21 de agosto de 1994"
9,24,13,4192,383,372,755,"21 de agosto de 1994"
9,24,13,4193,265,287,552,"21 de agosto de 1994"
9,24,13,4194,418,498,916,"21 de agosto de 1994"
9,24,13,4195,340,396,736,"21 de agosto de 1994"
9,24,13,4196,618,661,1279,"21 de agosto de 1994"
9,24,13,4197,526,596,1122,"21 de agosto de 1994"
9,24,13,4198,487,555,1042,"21 de agosto de 1994"
9,24,13,4199,426,472,898,"21 de agosto de 1994"
9,24,13,4200,529,579,1108,"21 de agosto de 1994"
9,24,13,4201,657,722,1379,"21 de agosto de 1994"
9,24,13,4202,316,400,716,"21 de agosto de 1994"
9,24,13,4203,330,395,725,"21 de agosto de 1994"
9,24,13,4204,399,481,880,"21 de agosto de 1994"
9,24,13,4205,474,570,1044,"21 de agosto de 1994"
9,24,13,4206,418,485,903,"21 de agosto de 1994"
9,24,13,4207,311,420,731,"21 de agosto de 1994"
9,24,13,4208,413,477,890,"21 de agosto de 1994"
9,24,13,4209,523,581,1104,"21 de agosto de 1994"
9,24,13,4210,486,535,1021,"21 de agosto de 1994"
9,24,13,4211,503,577,1080,"21 de agosto de 1994"
9,24,13,4212,423,453,876,"21 de agosto de 1994"
9,24,13,4213,604,657,1261,"21 de agosto de 1994"
9,24,13,4214,408,476,884,"21 de agosto de 1994"
9,24,13,4215,383,429,812,"21 de agosto de 1994"
9,24,13,4216,465,509,974,"21 de agosto de 1994"
9,24,13,4217,408,481,889,"21 de agosto de 1994"
9,24,13,4218,537,612,1149,"21 de agosto de 1994"
9,24,13,4219,532,549,1081,"21 de agosto de 1994"
9,24,13,4220,424,473,897,"21 de agosto de 1994"
9,24,13,4221,399,445,844,"21 de agosto de 1994"
9,24,13,4222,592,665,1257,"21 de agosto de 1994"
9,24,13,4223,633,699,1332,"21 de agosto de 1994"
9,24,13,4224,518,561,1079,"21 de agosto de 1994"
9,24,13,4225,620,667,1287,"21 de agosto de 1994"
9,24,13,4226,539,588,1127,"21 de agosto de 1994"
9,24,13,4227,560,632,1192,"21 de agosto de 1994"
9,24,13,4228,729,779,1508,"21 de agosto de 1994"
9,24,13,4229,545,595,1140,"21 de agosto de 1994"
9,24,13,4230,348,423,771,"21 de agosto de 1994"
9,24,13,4231,482,526,1008,"21 de agosto de 1994"
9,24,13,4232,342,392,734,"21 de agosto de 1994"
9,24,13,4233,416,514,930,"21 de agosto de 1994"
9,24,13,4234,576,611,1187,"21 de agosto de 1994"
9,24,13,4235,593,657,1250,"21 de agosto de 1994"
9,24,13,4236,651,716,1367,"21 de agosto de 1994"
9,24,13,4237,541,564,1105,"21 de agosto de 1994"
9,24,13,4238,651,716,1367,"21 de agosto de 1994"
9,24,13,4239,667,724,1391,"21 de agosto de 1994"
9,24,13,4240,356,349,705,"21 de agosto de 1994"
9,24,13,4241,508,577,1085,"21 de agosto de 1994"
9,24,13,4242,502,625,1127,"21 de agosto de 1994"
9,24,13,4243,455,520,975,"21 de agosto de 1994"
9,24,13,4244,453,533,986,"21 de agosto de 1994"
9,24,13,4245,450,493,943,"21 de agosto de 1994"
9,24,13,4246,820,863,1683,"21 de agosto de 1994"
9,24,13,4247,361,372,733,"21 de agosto de 1994"
9,24,13,4248,682,732,1414,"21 de agosto de 1994"
9,24,13,4249,485,537,1022,"21 de agosto de 1994"
9,24,13,4250,583,598,1181,"21 de agosto de 1994"
9,24,13,4251,482,554,1036,"21 de agosto de 1994"
9,24,13,4252,439,466,905,"21 de agosto de 1994"
9,24,13,4253,571,599,1170,"21 de agosto de 1994"
9,24,13,4254,598,625,1223,"21 de agosto de 1994"
9,24,13,4255,560,557,1117,"21 de agosto de 1994"
9,24,13,4256,484,537,1021,"21 de agosto de 1994"
9,24,13,4257,502,578,1080,"21 de agosto de 1994"
9,24,13,4258,390,425,815,"21 de agosto de 1994"
9,24,13,4259,514,572,1086,"21 de agosto de 1994"
9,24,13,4260,790,824,1614,"21 de agosto de 1994"
9,24,13,4261,582,671,1253,"21 de agosto de 1994"
9,24,13,4262,554,564,1118,"21 de agosto de 1994"
9,24,13,4263,495,539,1034,"21 de agosto de 1994"
9,24,13,4264,446,439,885,"21 de agosto de 1994"
9,24,13,4265,516,534,1050,"21 de agosto de 1994"
9,24,13,4266,467,473,940,"21 de agosto de 1994"
9,24,13,4267,252,277,529,"21 de agosto de 1994"
9,24,13,4268,61,70,131,"21 de agosto de 1994"
9,25,5,1327,492,513,1005,"21 de agosto de 1994"
9,25,5,1328,459,493,952,"21 de agosto de 1994"
9,25,5,1329,366,439,805,"21 de agosto de 1994"
9,25,5,1330,579,639,1218,"21 de agosto de 1994"
9,25,5,1331,565,590,1155,"21 de agosto de 1994"
9,25,5,1332,491,511,1002,"21 de agosto de 1994"
9,25,5,1333,538,555,1093,"21 de agosto de 1994"
9,25,5,1334,486,540,1026,"21 de agosto de 1994"
9,25,5,1335,609,607,1216,"21 de agosto de 1994"
9,25,5,1336,568,650,1218,"21 de agosto de 1994"
9,25,5,1337,459,528,987,"21 de agosto de 1994"
9,25,5,1338,772,863,1635,"21 de agosto de 1994"
9,25,5,1339,438,468,906,"21 de agosto de 1994"
9,25,5,1340,566,601,1167,"21 de agosto de 1994"
9,25,5,1341,474,508,982,"21 de agosto de 1994"
9,25,5,1342,615,664,1279,"21 de agosto de 1994"
9,25,5,1343,500,488,988,"21 de agosto de 1994"
9,25,5,1344,473,573,1046,"21 de agosto de 1994"
9,25,5,1345,495,555,1050,"21 de agosto de 1994"
9,25,5,1346,539,576,1115,"21 de agosto de 1994"
9,25,5,1347,436,527,963,"21 de agosto de 1994"
9,25,5,1348,591,628,1219,"21 de agosto de 1994"
9,25,5,1349,288,301,589,"21 de agosto de 1994"
9,25,5,1350,416,435,851,"21 de agosto de 1994"
9,25,5,1351,480,504,984,"21 de agosto de 1994"
9,25,5,1352,400,444,844,"21 de agosto de 1994"
9,25,5,1353,389,452,841,"21 de agosto de 1994"
9,25,5,1354,389,430,819,"21 de agosto de 1994"
9,25,5,1355,488,526,1014,"21 de agosto de 1994"
9,25,5,1356,414,461,875,"21 de agosto de 1994"
9,25,5,1357,477,472,949,"21 de agosto de 1994"
9,25,5,1358,535,548,1083,"21 de agosto de 1994"
9,25,5,1359,459,524,983,"21 de agosto de 1994"
9,25,5,1360,502,547,1049,"21 de agosto de 1994"
9,25,5,1361,576,592,1168,"21 de agosto de 1994"
9,25,5,1362,517,576,1093,"21 de agosto de 1994"
9,25,5,1363,470,517,987,"21 de agosto de 1994"
9,25,5,1364,491,509,1000,"21 de agosto de 1994"
9,25,5,1365,563,590,1153,"21 de agosto de 1994"
9,25,5,1366,519,568,1087,"21 de agosto de 1994"
9,25,5,1367,588,626,1214,"21 de agosto de 1994"
9,25,5,1368,411,461,872,"21 de agosto de 1994"
9,25,5,1369,548,568,1116,"21 de agosto de 1994"
9,25,5,1370,491,533,1024,"21 de agosto de 1994"
9,25,5,1371,725,712,1437,"21 de agosto de 1994"
9,25,5,1372,448,504,952,"21 de agosto de 1994"
9,25,5,1373,488,532,1020,"21 de agosto de 1994"
9,25,5,1374,497,563,1060,"21 de agosto de 1994"
9,25,5,1375,560,607,1167,"21 de agosto de 1994"
9,25,5,1376,495,546,1041,"21 de agosto de 1994"
9,25,5,1377,636,687,1323,"21 de agosto de 1994"
9,25,5,1378,450,542,992,"21 de agosto de 1994"
9,25,5,1379,432,476,908,"21 de agosto de 1994"
9,25,5,1380,445,504,949,"21 de agosto de 1994"
9,25,5,1381,511,561,1072,"21 de agosto de 1994"
9,25,5,1382,358,411,769,"21 de agosto de 1994"
9,25,5,1383,573,636,1209,"21 de agosto de 1994"
9,25,5,1384,610,627,1237,"21 de agosto de 1994"
9,25,5,1385,551,577,1128,"21 de agosto de 1994"
9,25,5,1386,412,515,927,"21 de agosto de 1994"
9,25,5,1387,405,419,824,"21 de agosto de 1994"
9,25,5,1388,425,459,884,"21 de agosto de 1994"
9,25,5,1389,471,498,969,"21 de agosto de 1994"
9,25,5,1390,455,504,959,"21 de agosto de 1994"
9,25,5,1391,492,544,1036,"21 de agosto de 1994"
9,25,5,1392,449,496,945,"21 de agosto de 1994"
9,25,5,1393,456,533,989,"21 de agosto de 1994"
9,25,5,1394,514,574,1088,"21 de agosto de 1994"
9,25,5,1395,621,659,1280,"21 de agosto de 1994"
9,25,5,1396,451,475,926,"21 de agosto de 1994"
9,25,5,1397,556,576,1132,"21 de agosto de 1994"
9,25,5,1398,468,557,1025,"21 de agosto de 1994"
9,25,5,1399,531,576,1107,"21 de agosto de 1994"
9,25,5,1400,546,520,1066,"21 de agosto de 1994"
9,25,5,1401,659,737,1396,"21 de agosto de 1994"
9,25,5,1402,499,533,1032,"21 de agosto de 1994"
9,25,5,1403,578,639,1217,"21 de agosto de 1994"
9,25,5,1404,506,578,1084,"21 de agosto de 1994"
9,25,5,1405,484,500,984,"21 de agosto de 1994"
9,25,5,1406,565,649,1214,"21 de agosto de 1994"
9,25,5,1407,483,550,1033,"21 de agosto de 1994"
9,25,5,1408,396,436,832,"21 de agosto de 1994"
9,25,5,1409,535,616,1151,"21 de agosto de 1994"
9,25,5,1410,589,671,1260,"21 de agosto de 1994"
9,25,5,1411,630,653,1283,"21 de agosto de 1994"
9,25,5,1412,430,519,949,"21 de agosto de 1994"
9,25,5,1413,546,630,1176,"21 de agosto de 1994"
9,25,5,1414,458,519,977,"21 de agosto de 1994"
9,25,5,1415,461,535,996,"21 de agosto de 1994"
9,25,5,1416,551,589,1140,"21 de agosto de 1994"
9,25,5,1417,471,530,1001,"21 de agosto de 1994"
9,25,5,1418,516,624,1140,"21 de agosto de 1994"
9,25,5,1419,560,612,1172,"21 de agosto de 1994"
9,25,5,1420,546,635,1181,"21 de agosto de 1994"
9,25,5,1421,600,679,1279,"21 de agosto de 1994"
9,25,5,1422,525,635,1160,"21 de agosto de 1994"
9,25,5,1423,637,720,1357,"21 de agosto de 1994"
9,25,5,1424,428,457,885,"21 de agosto de 1994"
9,25,5,1425,668,798,1466,"21 de agosto de 1994"
9,25,5,1426,560,627,1187,"21 de agosto de 1994"
9,25,5,1427,537,610,1147,"21 de agosto de 1994"
9,25,5,1428,510,571,1081,"21 de agosto de 1994"
9,25,5,1429,536,616,1152,"21 de agosto de 1994"
9,25,5,1430,685,742,1427,"21 de agosto de 1994"
9,25,5,1431,717,806,1523,"21 de agosto de 1994"
9,25,5,1432,622,699,1321,"21 de agosto de 1994"
9,25,5,1433,622,683,1305,"21 de agosto de 1994"
9,25,5,1434,749,816,1565,"21 de agosto de 1994"
9,25,5,1435,678,717,1395,"21 de agosto de 1994"
9,25,5,1436,376,431,807,"21 de agosto de 1994"
9,25,5,1437,546,637,1183,"21 de agosto de 1994"
9,25,5,1438,471,527,998,"21 de agosto de 1994"
9,25,5,1439,515,524,1039,"21 de agosto de 1994"
9,25,5,1440,661,785,1446,"21 de agosto de 1994"
9,25,5,1441,589,622,1211,"21 de agosto de 1994"
9,25,5,1442,732,783,1515,"21 de agosto de 1994"
9,25,5,1443,687,733,1420,"21 de agosto de 1994"
9,25,5,1444,394,471,865,"21 de agosto de 1994"
9,25,5,1445,421,462,883,"21 de agosto de 1994"
9,25,5,1446,373,441,814,"21 de agosto de 1994"
9,25,5,1447,473,528,1001,"21 de agosto de 1994"
9,25,5,1448,431,488,919,"21 de agosto de 1994"
9,25,5,1449,506,556,1062,"21 de agosto de 1994"
9,25,5,1450,209,208,417,"21 de agosto de 1994"
9,25,5,5537,393,448,841,"21 de agosto de 1994"
9,25,5,5538,482,508,990,"21 de agosto de 1994"
9,25,5,5539,373,437,810,"21 de agosto de 1994"
9,25,5,5540,409,452,861,"21 de agosto de 1994"
9,25,5,5541,418,485,903,"21 de agosto de 1994"
9,25,5,5542,457,507,964,"21 de agosto de 1994"
9,25,5,5543,430,544,974,"21 de agosto de 1994"
9,26,7,2041,0,0,0,"21 de agosto de 1994"
9,26,7,2065,605,621,1226,"21 de agosto de 1994"
9,26,7,2066,292,351,643,"21 de agosto de 1994"
9,26,7,2067,624,670,1294,"21 de agosto de 1994"
9,26,7,2068,534,612,1146,"21 de agosto de 1994"
9,26,7,2069,529,536,1065,"21 de agosto de 1994"
9,26,7,2070,399,460,859,"21 de agosto de 1994"
9,26,7,2071,495,572,1067,"21 de agosto de 1994"
9,26,7,2072,561,688,1249,"21 de agosto de 1994"
9,26,7,2073,419,504,923,"21 de agosto de 1994"
9,26,7,2074,268,316,584,"21 de agosto de 1994"
9,26,7,2075,294,369,663,"21 de agosto de 1994"
9,26,7,2076,454,512,966,"21 de agosto de 1994"
9,26,7,2077,464,519,983,"21 de agosto de 1994"
9,26,7,2078,449,487,936,"21 de agosto de 1994"
9,26,7,2079,540,557,1097,"21 de agosto de 1994"
9,26,7,2080,615,738,1353,"21 de agosto de 1994"
9,26,7,2081,522,565,1087,"21 de agosto de 1994"
9,26,7,2082,503,588,1091,"21 de agosto de 1994"
9,26,7,2083,280,305,585,"21 de agosto de 1994"
9,26,7,2084,441,486,927,"21 de agosto de 1994"
9,26,7,2085,161,169,330,"21 de agosto de 1994"
9,26,7,2086,396,446,842,"21 de agosto de 1994"
9,26,7,2087,377,393,770,"21 de agosto de 1994"
9,26,7,2088,497,556,1053,"21 de agosto de 1994"
9,26,7,2089,509,536,1045,"21 de agosto de 1994"
9,26,7,2090,307,369,676,"21 de agosto de 1994"
9,26,7,2091,564,668,1232,"21 de agosto de 1994"
9,26,7,2092,485,547,1032,"21 de agosto de 1994"
9,26,7,2093,592,679,1271,"21 de agosto de 1994"
9,26,7,2094,470,477,947,"21 de agosto de 1994"
9,26,7,2095,306,324,630,"21 de agosto de 1994"
9,26,7,2096,277,391,668,"21 de agosto de 1994"
9,26,7,2097,339,368,707,"21 de agosto de 1994"
9,26,7,2098,292,352,644,"21 de agosto de 1994"
9,26,7,2099,371,431,802,"21 de agosto de 1994"
9,26,7,2100,393,428,821,"21 de agosto de 1994"
9,26,7,2101,544,634,1178,"21 de agosto de 1994"
9,26,7,2102,583,624,1207,"21 de agosto de 1994"
9,26,7,2103,319,338,657,"21 de agosto de 1994"
9,26,7,2104,419,483,902,"21 de agosto de 1994"
9,26,7,2105,430,488,918,"21 de agosto de 1994"
9,26,7,2106,466,534,1000,"21 de agosto de 1994"
9,26,7,2107,532,572,1104,"21 de agosto de 1994"
9,26,7,2108,602,648,1250,"21 de agosto de 1994"
9,26,7,2109,416,426,842,"21 de agosto de 1994"
9,26,7,2110,437,484,921,"21 de agosto de 1994"
9,26,7,2111,500,544,1044,"21 de agosto de 1994"
9,26,7,2112,550,594,1144,"21 de agosto de 1994"
9,26,7,2113,534,565,1099,"21 de agosto de 1994"
9,26,7,2114,466,504,970,"21 de agosto de 1994"
9,26,7,2115,558,582,1140,"21 de agosto de 1994"
9,26,7,2116,558,638,1196,"21 de agosto de 1994"
9,26,7,2117,512,580,1092,"21 de agosto de 1994"
9,26,7,2118,484,549,1033,"21 de agosto de 1994"
9,26,7,2119,274,313,587,"21 de agosto de 1994"
9,26,7,2120,499,551,1050,"21 de agosto de 1994"
9,26,7,2121,576,647,1223,"21 de agosto de 1994"
9,26,7,2122,320,349,669,"21 de agosto de 1994"
9,26,7,2123,356,424,780,"21 de agosto de 1994"
9,26,7,2124,276,322,598,"21 de agosto de 1994"
9,26,7,2125,395,459,854,"21 de agosto de 1994"
9,26,7,2126,361,401,762,"21 de agosto de 1994"
9,26,7,2127,509,539,1048,"21 de agosto de 1994"
9,26,7,2128,543,614,1157,"21 de agosto de 1994"
9,26,7,2129,567,614,1181,"21 de agosto de 1994"
9,26,7,2130,393,485,878,"21 de agosto de 1994"
9,26,7,2131,385,464,849,"21 de agosto de 1994"
9,26,7,2132,625,679,1304,"21 de agosto de 1994"
9,26,7,2133,648,694,1342,"21 de agosto de 1994"
9,26,7,2134,645,651,1296,"21 de agosto de 1994"
9,26,7,2135,534,599,1133,"21 de agosto de 1994"
9,26,7,2136,413,465,878,"21 de agosto de 1994"
9,26,7,2137,482,500,982,"21 de agosto de 1994"
9,26,7,2138,581,631,1212,"21 de agosto de 1994"
9,26,7,2139,538,609,1147,"21 de agosto de 1994"
9,26,7,2140,572,617,1189,"21 de agosto de 1994"
9,26,7,2141,551,621,1172,"21 de agosto de 1994"
9,26,7,2142,428,462,890,"21 de agosto de 1994"
9,26,7,2143,549,604,1153,"21 de agosto de 1994"
9,26,7,2144,524,612,1136,"21 de agosto de 1994"
9,26,7,2145,472,537,1009,"21 de agosto de 1994"
9,26,7,2146,571,627,1198,"21 de agosto de 1994"
9,26,7,2147,469,480,949,"21 de agosto de 1994"
9,26,7,2148,483,540,1023,"21 de agosto de 1994"
9,26,7,2149,537,562,1099,"21 de agosto de 1994"
9,26,7,2150,549,516,1065,"21 de agosto de 1994"
9,26,7,2151,666,689,1355,"21 de agosto de 1994"
9,26,7,2152,419,438,857,"21 de agosto de 1994"
9,26,7,2153,401,410,811,"21 de agosto de 1994"
9,26,7,2154,511,579,1090,"21 de agosto de 1994"
9,26,7,2155,560,587,1147,"21 de agosto de 1994"
9,26,7,2156,538,595,1133,"21 de agosto de 1994"
9,26,7,2157,563,665,1228,"21 de agosto de 1994"
9,26,7,2158,468,565,1033,"21 de agosto de 1994"
9,26,7,2159,495,542,1037,"21 de agosto de 1994"
9,26,7,2160,351,384,735,"21 de agosto de 1994"
9,26,7,2161,482,560,1042,"21 de agosto de 1994"
9,26,7,2162,566,646,1212,"21 de agosto de 1994"
9,26,7,2163,423,487,910,"21 de agosto de 1994"
9,26,7,2164,630,654,1284,"21 de agosto de 1994"
9,26,7,2165,605,635,1240,"21 de agosto de 1994"
9,26,7,2166,336,389,725,"21 de agosto de 1994"
9,26,7,2167,585,621,1206,"21 de agosto de 1994"
9,26,7,2168,439,511,950,"21 de agosto de 1994"
9,26,7,2169,317,336,653,"21 de agosto de 1994"
9,26,7,2170,364,436,800,"21 de agosto de 1994"
9,26,7,2171,386,435,821,"21 de agosto de 1994"
9,26,7,2172,442,510,952,"21 de agosto de 1994"
9,26,7,2173,514,580,1094,"21 de agosto de 1994"
9,26,7,2174,562,600,1162,"21 de agosto de 1994"
9,26,7,2175,566,553,1119,"21 de agosto de 1994"
9,26,7,2176,497,568,1065,"21 de agosto de 1994"
9,26,7,2177,437,496,933,"21 de agosto de 1994"
9,26,7,2178,612,681,1293,"21 de agosto de 1994"
9,26,7,2179,499,561,1060,"21 de agosto de 1994"
9,26,7,2180,556,624,1180,"21 de agosto de 1994"
9,26,7,2181,536,604,1140,"21 de agosto de 1994"
9,26,7,2182,569,679,1248,"21 de agosto de 1994"
9,26,7,2183,464,543,1007,"21 de agosto de 1994"
9,26,7,2184,416,471,887,"21 de agosto de 1994"
9,26,7,2185,599,596,1195,"21 de agosto de 1994"
9,26,7,2186,450,484,934,"21 de agosto de 1994"
9,26,7,2187,605,657,1262,"21 de agosto de 1994"
9,26,7,2188,554,594,1148,"21 de agosto de 1994"
9,26,7,2189,557,659,1216,"21 de agosto de 1994"
9,26,7,2190,551,600,1151,"21 de agosto de 1994"
9,26,7,2191,529,543,1072,"21 de agosto de 1994"
9,26,7,2192,461,548,1009,"21 de agosto de 1994"
9,26,7,2193,605,730,1335,"21 de agosto de 1994"
9,26,7,2194,530,605,1135,"21 de agosto de 1994"
9,26,7,2195,467,504,971,"21 de agosto de 1994"
9,26,7,2196,457,492,949,"21 de agosto de 1994"
9,26,7,2197,462,524,986,"21 de agosto de 1994"
9,26,7,2198,288,367,655,"21 de agosto de 1994"
9,26,7,2199,326,331,657,"21 de agosto de 1994"
9,26,7,2200,360,419,779,"21 de agosto de 1994"
9,26,7,2201,534,644,1178,"21 de agosto de 1994"
9,26,7,2202,506,546,1052,"21 de agosto de 1994"
9,26,7,2203,460,511,971,"21 de agosto de 1994"
9,26,7,2204,351,405,756,"21 de agosto de 1994"
9,26,7,2205,466,476,942,"21 de agosto de 1994"
9,26,7,2206,642,738,1380,"21 de agosto de 1994"
9,26,7,2207,854,968,1822,"21 de agosto de 1994"
9,26,7,2208,511,541,1052,"21 de agosto de 1994"
9,26,7,2209,397,446,843,"21 de agosto de 1994"
9,26,7,2210,446,543,989,"21 de agosto de 1994"
9,26,7,2211,521,595,1116,"21 de agosto de 1994"
9,26,7,2212,539,562,1101,"21 de agosto de 1994"
9,26,7,2213,356,470,826,"21 de agosto de 1994"
9,26,7,2214,449,561,1010,"21 de agosto de 1994"
9,26,7,2215,272,307,579,"21 de agosto de 1994"
9,26,7,2216,228,275,503,"21 de agosto de 1994"
9,26,7,2217,245,298,543,"21 de agosto de 1994"
9,26,7,2218,725,896,1621,"21 de agosto de 1994"
9,26,7,2219,315,348,663,"21 de agosto de 1994"
9,26,7,2220,700,749,1449,"21 de agosto de 1994"
9,26,7,2221,463,477,940,"21 de agosto de 1994"
9,26,7,2222,429,446,875,"21 de agosto de 1994"
9,26,7,2223,247,264,511,"21 de agosto de 1994"
9,26,7,2224,492,545,1037,"21 de agosto de 1994"
9,26,7,2225,522,519,1041,"21 de agosto de 1994"
9,26,7,2226,538,564,1102,"21 de agosto de 1994"
9,26,7,2227,380,420,800,"21 de agosto de 1994"
9,26,7,2228,427,498,925,"21 de agosto de 1994"
9,26,7,2229,456,483,939,"21 de agosto de 1994"
9,26,7,2230,485,570,1055,"21 de agosto de 1994"
9,26,7,2231,464,462,926,"21 de agosto de 1994"
9,26,7,2232,478,545,1023,"21 de agosto de 1994"
9,26,7,2233,343,367,710,"21 de agosto de 1994"
9,26,7,2234,485,539,1024,"21 de agosto de 1994"
9,26,7,2235,485,545,1030,"21 de agosto de 1994"
9,26,7,2236,414,451,865,"21 de agosto de 1994"
9,26,7,2237,492,501,993,"21 de agosto de 1994"
9,26,7,2238,455,508,963,"21 de agosto de 1994"
9,26,7,2239,551,591,1142,"21 de agosto de 1994"
9,26,7,2240,615,682,1297,"21 de agosto de 1994"
9,26,7,2241,445,547,992,"21 de agosto de 1994"
9,26,7,2242,366,443,809,"21 de agosto de 1994"
9,26,7,2243,403,429,832,"21 de agosto de 1994"
9,26,7,2244,608,677,1285,"21 de agosto de 1994"
9,26,7,2245,706,755,1461,"21 de agosto de 1994"
9,26,7,2246,516,573,1089,"21 de agosto de 1994"
9,26,7,2247,396,428,824,"21 de agosto de 1994"
9,26,7,2248,394,430,824,"21 de agosto de 1994"
9,26,7,2249,363,423,786,"21 de agosto de 1994"
9,26,7,2250,405,397,802,"21 de agosto de 1994"
9,26,7,2251,444,485,929,"21 de agosto de 1994"
9,26,7,2252,627,700,1327,"21 de agosto de 1994"
9,26,7,2253,549,598,1147,"21 de agosto de 1994"
9,26,7,2254,562,632,1194,"21 de agosto de 1994"
9,26,7,2255,610,690,1300,"21 de agosto de 1994"
9,26,7,2256,495,508,1003,"21 de agosto de 1994"
9,26,7,2257,556,605,1161,"21 de agosto de 1994"
9,26,7,2258,494,571,1065,"21 de agosto de 1994"
9,26,7,2259,500,584,1084,"21 de agosto de 1994"
9,26,7,2260,619,713,1332,"21 de agosto de 1994"
9,26,7,2261,451,546,997,"21 de agosto de 1994"
9,26,7,2262,473,564,1037,"21 de agosto de 1994"
9,26,7,2263,503,581,1084,"21 de agosto de 1994"
9,26,7,2264,263,342,605,"21 de agosto de 1994"
9,26,7,2265,323,386,709,"21 de agosto de 1994"
9,26,7,2266,324,372,696,"21 de agosto de 1994"
9,26,7,2267,327,370,697,"21 de agosto de 1994"
9,26,7,2268,588,652,1240,"21 de agosto de 1994"
9,26,7,2269,454,529,983,"21 de agosto de 1994"
9,26,7,2270,566,682,1248,"21 de agosto de 1994"
9,26,7,2271,365,433,798,"21 de agosto de 1994"
9,26,7,2272,438,514,952,"21 de agosto de 1994"
9,26,7,2273,433,499,932,"21 de agosto de 1994"
9,26,7,2274,554,618,1172,"21 de agosto de 1994"
9,26,7,2275,545,633,1178,"21 de agosto de 1994"
9,26,7,2276,552,618,1170,"21 de agosto de 1994"
9,26,7,2277,522,599,1121,"21 de agosto de 1994"
9,26,7,2278,408,447,855,"21 de agosto de 1994"
9,26,7,2279,542,557,1099,"21 de agosto de 1994"
9,26,7,2280,535,610,1145,"21 de agosto de 1994"
9,26,7,2281,495,540,1035,"21 de agosto de 1994"
9,26,7,2282,521,593,1114,"21 de agosto de 1994"
9,26,7,2283,508,513,1021,"21 de agosto de 1994"
9,26,7,2284,332,367,699,"21 de agosto de 1994"
9,26,7,2285,72,84,156,"21 de agosto de 1994"
9,26,7,2286,420,452,872,"21 de agosto de 1994"
9,26,7,2287,468,456,924,"21 de agosto de 1994"
9,26,7,2288,504,522,1026,"21 de agosto de 1994"
9,26,7,2289,573,598,1171,"21 de agosto de 1994"
9,26,7,2290,512,554,1066,"21 de agosto de 1994"
9,26,7,2291,371,429,800,"21 de agosto de 1994"
9,26,7,2292,529,579,1108,"21 de agosto de 1994"
9,26,7,2293,444,509,953,"21 de agosto de 1994"
9,26,7,2294,493,536,1029,"21 de agosto de 1994"
9,26,7,2295,437,462,899,"21 de agosto de 1994"
9,26,7,2296,515,575,1090,"21 de agosto de 1994"
9,26,7,2297,559,611,1170,"21 de agosto de 1994"
9,26,7,2298,631,693,1324,"21 de agosto de 1994"
9,26,7,2299,435,508,943,"21 de agosto de 1994"
9,26,7,2300,340,403,743,"21 de agosto de 1994"
9,26,7,2301,558,677,1235,"21 de agosto de 1994"
9,26,7,2302,602,716,1318,"21 de agosto de 1994"
9,26,7,2303,562,661,1223,"21 de agosto de 1994"
9,26,7,2304,560,640,1200,"21 de agosto de 1994"
9,26,7,2305,449,557,1006,"21 de agosto de 1994"
9,26,7,2306,626,748,1374,"21 de agosto de 1994"
9,26,7,2307,289,309,598,"21 de agosto de 1994"
9,26,7,2308,364,381,745,"21 de agosto de 1994"
9,26,7,2309,667,832,1499,"21 de agosto de 1994"
9,26,7,2310,526,636,1162,"21 de agosto de 1994"
9,26,7,2311,417,479,896,"21 de agosto de 1994"
9,26,7,2312,348,395,743,"21 de agosto de 1994"
9,26,7,2313,558,636,1194,"21 de agosto de 1994"
9,26,7,2314,406,458,864,"21 de agosto de 1994"
9,26,7,2315,535,602,1137,"21 de agosto de 1994"
9,26,7,2316,658,730,1388,"21 de agosto de 1994"
9,26,7,2317,557,637,1194,"21 de agosto de 1994"
9,26,7,2318,405,453,858,"21 de agosto de 1994"
9,26,7,2319,435,480,915,"21 de agosto de 1994"
9,26,7,2320,676,757,1433,"21 de agosto de 1994"
9,26,7,2321,642,719,1361,"21 de agosto de 1994"
9,26,7,2322,319,369,688,"21 de agosto de 1994"
9,26,7,2323,312,366,678,"21 de agosto de 1994"
9,26,7,2324,328,381,709,"21 de agosto de 1994"
9,26,7,2325,335,377,712,"21 de agosto de 1994"
9,26,7,2326,540,599,1139,"21 de agosto de 1994"
9,26,7,2327,145,196,341,"21 de agosto de 1994"
9,26,7,2328,164,229,393,"21 de agosto de 1994"
9,26,7,2329,324,388,712,"21 de agosto de 1994"
9,26,7,2330,341,438,779,"21 de agosto de 1994"
9,26,7,2331,489,610,1099,"21 de agosto de 1994"
9,26,7,2332,329,383,712,"21 de agosto de 1994"
9,26,7,2333,416,487,903,"21 de agosto de 1994"
9,26,7,2334,364,423,787,"21 de agosto de 1994"
9,26,7,2335,328,367,695,"21 de agosto de 1994"
9,26,7,2336,33,34,67,"21 de agosto de 1994"
9,26,7,2337,54,90,144,"21 de agosto de 1994"
9,26,7,2338,258,306,564,"21 de agosto de 1994"
9,26,7,2339,59,67,126,"21 de agosto de 1994"
9,26,7,5517,32,65,97,"21 de agosto de 1994"
9,27,3,516,446,549,995,"21 de agosto de 1994"
9,27,3,517,243,294,537,"21 de agosto de 1994"
9,27,3,518,263,349,612,"21 de agosto de 1994"
9,27,3,519,656,838,1494,"21 de agosto de 1994"
9,27,3,520,458,603,1061,"21 de agosto de 1994"
9,27,3,521,479,623,1102,"21 de agosto de 1994"
9,27,3,522,321,424,745,"21 de agosto de 1994"
9,27,3,523,549,708,1257,"21 de agosto de 1994"
9,27,3,524,242,349,591,"21 de agosto de 1994"
9,27,3,525,340,402,742,"21 de agosto de 1994"
9,27,3,526,537,693,1230,"21 de agosto de 1994"
9,27,3,527,441,530,971,"21 de agosto de 1994"
9,27,3,528,574,712,1286,"21 de agosto de 1994"
9,27,3,529,448,547,995,"21 de agosto de 1994"
9,27,3,530,657,790,1447,"21 de agosto de 1994"
9,27,3,531,366,425,791,"21 de agosto de 1994"
9,27,3,532,402,489,891,"21 de agosto de 1994"
9,27,3,533,335,384,719,"21 de agosto de 1994"
9,27,3,534,522,644,1166,"21 de agosto de 1994"
9,27,3,535,519,670,1189,"21 de agosto de 1994"
9,27,3,536,368,447,815,"21 de agosto de 1994"
9,27,3,537,334,402,736,"21 de agosto de 1994"
9,27,3,538,460,524,984,"21 de agosto de 1994"
9,27,3,539,538,615,1153,"21 de agosto de 1994"
9,27,3,540,534,553,1087,"21 de agosto de 1994"
9,27,3,541,402,408,810,"21 de agosto de 1994"
9,27,3,542,268,344,612,"21 de agosto de 1994"
9,27,3,543,456,547,1003,"21 de agosto de 1994"
9,27,3,544,312,371,683,"21 de agosto de 1994"
9,27,3,545,483,575,1058,"21 de agosto de 1994"
9,27,3,546,662,781,1443,"21 de agosto de 1994"
9,27,3,547,476,640,1116,"21 de agosto de 1994"
9,27,3,548,380,462,842,"21 de agosto de 1994"
9,27,3,549,405,550,955,"21 de agosto de 1994"
9,27,3,550,435,479,914,"21 de agosto de 1994"
9,27,3,551,486,689,1175,"21 de agosto de 1994"
9,27,3,552,462,559,1021,"21 de agosto de 1994"
9,27,3,553,498,644,1142,"21 de agosto de 1994"
9,27,3,554,451,425,876,"21 de agosto de 1994"
9,27,3,555,319,438,757,"21 de agosto de 1994"
9,27,3,556,742,824,1566,"21 de agosto de 1994"
9,27,3,557,544,595,1139,"21 de agosto de 1994"
9,27,3,558,624,675,1299,"21 de agosto de 1994"
9,27,3,559,467,557,1024,"21 de agosto de 1994"
9,27,3,560,680,776,1456,"21 de agosto de 1994"
9,27,3,561,529,563,1092,"21 de agosto de 1994"
9,27,3,562,556,619,1175,"21 de agosto de 1994"
9,27,3,563,422,528,950,"21 de agosto de 1994"
9,27,3,564,515,581,1096,"21 de agosto de 1994"
9,27,3,565,385,546,931,"21 de agosto de 1994"
9,27,3,566,472,652,1124,"21 de agosto de 1994"
9,27,3,567,486,655,1141,"21 de agosto de 1994"
9,27,3,568,499,654,1153,"21 de agosto de 1994"
9,27,3,569,512,680,1192,"21 de agosto de 1994"
9,27,3,570,532,602,1134,"21 de agosto de 1994"
9,27,3,571,593,651,1244,"21 de agosto de 1994"
9,27,3,572,606,723,1329,"21 de agosto de 1994"
9,27,3,573,469,573,1042,"21 de agosto de 1994"
9,27,3,574,289,365,654,"21 de agosto de 1994"
9,27,3,575,495,543,1038,"21 de agosto de 1994"
9,27,3,576,500,599,1099,"21 de agosto de 1994"
9,27,3,577,542,657,1199,"21 de agosto de 1994"
9,27,3,578,345,415,760,"21 de agosto de 1994"
9,27,3,579,442,538,980,"21 de agosto de 1994"
9,27,3,580,537,672,1209,"21 de agosto de 1994"
9,27,3,581,542,575,1117,"21 de agosto de 1994"
9,27,3,582,535,630,1165,"21 de agosto de 1994"
9,27,3,583,449,527,976,"21 de agosto de 1994"
9,27,3,584,380,457,837,"21 de agosto de 1994"
9,27,3,585,470,586,1056,"21 de agosto de 1994"
9,27,3,586,563,745,1308,"21 de agosto de 1994"
9,27,3,587,712,823,1535,"21 de agosto de 1994"
9,27,3,588,344,432,776,"21 de agosto de 1994"
9,27,3,589,399,549,948,"21 de agosto de 1994"
9,27,3,590,470,557,1027,"21 de agosto de 1994"
9,27,3,591,398,489,887,"21 de agosto de 1994"
9,27,3,592,498,659,1157,"21 de agosto de 1994"
9,27,3,593,631,768,1399,"21 de agosto de 1994"
9,27,3,594,622,707,1329,"21 de agosto de 1994"
9,27,3,595,678,801,1479,"21 de agosto de 1994"
9,27,3,596,617,687,1304,"21 de agosto de 1994"
9,27,3,597,714,801,1515,"21 de agosto de 1994"
9,27,3,598,583,645,1228,"21 de agosto de 1994"
9,27,3,599,695,765,1460,"21 de agosto de 1994"
9,27,3,600,576,651,1227,"21 de agosto de 1994"
9,27,3,601,561,636,1197,"21 de agosto de 1994"
9,27,3,602,529,605,1134,"21 de agosto de 1994"
9,27,3,603,599,647,1246,"21 de agosto de 1994"
9,27,3,604,601,680,1281,"21 de agosto de 1994"
9,27,3,605,611,730,1341,"21 de agosto de 1994"
9,27,3,606,578,742,1320,"21 de agosto de 1994"
9,27,3,607,513,571,1084,"21 de agosto de 1994"
9,27,3,608,610,724,1334,"21 de agosto de 1994"
9,27,3,609,532,653,1185,"21 de agosto de 1994"
9,27,3,610,633,727,1360,"21 de agosto de 1994"
9,27,3,611,656,708,1364,"21 de agosto de 1994"
9,27,3,612,570,624,1194,"21 de agosto de 1994"
9,27,3,613,240,262,502,"21 de agosto de 1994"
9,27,3,614,296,409,705,"21 de agosto de 1994"
9,27,3,615,392,481,873,"21 de agosto de 1994"
9,27,3,616,571,632,1203,"21 de agosto de 1994"
9,27,3,617,322,348,670,"21 de agosto de 1994"
9,27,3,618,719,794,1513,"21 de agosto de 1994"
9,27,3,619,620,441,1061,"21 de agosto de 1994"
9,27,3,620,564,752,1316,"21 de agosto de 1994"
9,27,3,621,573,692,1265,"21 de agosto de 1994"
9,27,3,622,660,806,1466,"21 de agosto de 1994"
9,27,3,623,671,750,1421,"21 de agosto de 1994"
9,27,3,624,479,598,1077,"21 de agosto de 1994"
9,27,3,625,379,441,820,"21 de agosto de 1994"
9,27,3,626,612,757,1369,"21 de agosto de 1994"
9,27,3,627,484,619,1103,"21 de agosto de 1994"
9,27,3,628,487,582,1069,"21 de agosto de 1994"
9,27,3,629,586,682,1268,"21 de agosto de 1994"
9,27,3,630,427,536,963,"21 de agosto de 1994"
9,27,3,631,643,805,1448,"21 de agosto de 1994"
9,27,3,632,247,280,527,"21 de agosto de 1994"
9,27,3,633,365,404,769,"21 de agosto de 1994"
9,27,3,634,498,553,1051,"21 de agosto de 1994"
9,27,3,635,445,558,1003,"21 de agosto de 1994"
9,27,3,636,499,633,1132,"21 de agosto de 1994"
9,27,3,637,586,687,1273,"21 de agosto de 1994"
9,27,3,638,435,539,974,"21 de agosto de 1994"
9,27,3,639,469,503,972,"21 de agosto de 1994"
9,27,3,640,364,456,820,"21 de agosto de 1994"
9,27,3,641,675,804,1479,"21 de agosto de 1994"
9,27,3,642,488,617,1105,"21 de agosto de 1994"
9,27,3,643,447,588,1035,"21 de agosto de 1994"
9,27,3,644,577,677,1254,"21 de agosto de 1994"
9,27,3,645,480,530,1010,"21 de agosto de 1994"
9,27,3,646,479,603,1082,"21 de agosto de 1994"
9,27,3,647,328,408,736,"21 de agosto de 1994"
9,27,3,648,288,338,626,"21 de agosto de 1994"
9,27,3,649,347,385,732,"21 de agosto de 1994"
9,27,3,650,378,469,847,"21 de agosto de 1994"
9,27,3,651,372,455,827,"21 de agosto de 1994"
9,27,3,652,638,785,1423,"21 de agosto de 1994"
9,27,3,653,549,652,1201,"21 de agosto de 1994"
9,27,3,654,480,552,1032,"21 de agosto de 1994"
9,27,3,655,456,513,969,"21 de agosto de 1994"
9,27,3,656,464,573,1037,"21 de agosto de 1994"
9,27,3,657,466,564,1030,"21 de agosto de 1994"
9,27,3,658,471,560,1031,"21 de agosto de 1994"
9,27,3,659,605,672,1277,"21 de agosto de 1994"
9,27,3,660,471,587,1058,"21 de agosto de 1994"
9,27,3,661,570,659,1229,"21 de agosto de 1994"
9,27,3,662,350,441,791,"21 de agosto de 1994"
9,27,3,663,430,505,935,"21 de agosto de 1994"
9,27,3,664,367,472,839,"21 de agosto de 1994"
9,27,3,665,601,697,1298,"21 de agosto de 1994"
9,27,3,666,452,523,975,"21 de agosto de 1994"
9,27,3,667,439,473,912,"21 de agosto de 1994"
9,27,3,668,682,808,1490,"21 de agosto de 1994"
9,27,3,669,618,724,1342,"21 de agosto de 1994"
9,27,3,670,536,605,1141,"21 de agosto de 1994"
9,27,3,671,346,402,748,"21 de agosto de 1994"
9,27,3,672,343,415,758,"21 de agosto de 1994"
9,27,3,673,483,537,1020,"21 de agosto de 1994"
9,27,3,674,462,592,1054,"21 de agosto de 1994"
9,27,3,675,458,569,1027,"21 de agosto de 1994"
9,27,3,676,401,556,957,"21 de agosto de 1994"
9,27,3,677,622,687,1309,"21 de agosto de 1994"
9,27,3,678,721,855,1576,"21 de agosto de 1994"
9,27,3,679,357,436,793,"21 de agosto de 1994"
9,27,3,680,263,313,576,"21 de agosto de 1994"
9,27,3,681,433,536,969,"21 de agosto de 1994"
9,27,3,682,380,422,802,"21 de agosto de 1994"
9,27,3,683,240,317,557,"21 de agosto de 1994"
9,27,3,684,540,544,1084,"21 de agosto de 1994"
9,27,3,685,303,339,642,"21 de agosto de 1994"
9,27,3,686,492,594,1086,"21 de agosto de 1994"
9,27,3,687,447,479,926,"21 de agosto de 1994"
9,27,3,688,705,857,1562,"21 de agosto de 1994"
9,27,3,689,550,670,1220,"21 de agosto de 1994"
9,27,3,690,366,431,797,"21 de agosto de 1994"
9,27,3,691,340,365,705,"21 de agosto de 1994"
9,27,3,692,176,219,395,"21 de agosto de 1994"
9,27,3,4003,1,1,2,"21 de agosto de 1994"
9,27,7,2340,370,421,791,"21 de agosto de 1994"
9,27,7,2341,511,663,1174,"21 de agosto de 1994"
9,27,7,2342,314,361,675,"21 de agosto de 1994"
9,27,7,2343,456,550,1006,"21 de agosto de 1994"
9,27,7,2344,390,482,872,"21 de agosto de 1994"
9,27,7,2345,410,512,922,"21 de agosto de 1994"
9,27,7,2346,459,565,1024,"21 de agosto de 1994"
9,27,7,2347,447,564,1011,"21 de agosto de 1994"
9,27,7,2348,535,579,1114,"21 de agosto de 1994"
9,27,7,2349,338,447,785,"21 de agosto de 1994"
9,27,7,2350,552,649,1201,"21 de agosto de 1994"
9,27,7,2351,584,678,1262,"21 de agosto de 1994"
9,27,7,2352,412,467,879,"21 de agosto de 1994"
9,27,7,2353,480,587,1067,"21 de agosto de 1994"
9,27,7,2354,489,571,1060,"21 de agosto de 1994"
9,27,7,2355,534,583,1117,"21 de agosto de 1994"
9,27,7,2356,463,529,992,"21 de agosto de 1994"
9,27,7,2357,446,520,966,"21 de agosto de 1994"
9,27,7,2358,503,573,1076,"21 de agosto de 1994"
9,27,7,2359,461,485,946,"21 de agosto de 1994"
9,27,7,2360,527,604,1131,"21 de agosto de 1994"
9,27,7,2361,496,569,1065,"21 de agosto de 1994"
9,27,7,2362,519,531,1050,"21 de agosto de 1994"
9,27,7,2363,526,581,1107,"21 de agosto de 1994"
9,27,7,2364,394,444,838,"21 de agosto de 1994"
9,27,7,2365,415,453,868,"21 de agosto de 1994"
9,27,7,2366,439,469,908,"21 de agosto de 1994"
9,27,7,2367,487,492,979,"21 de agosto de 1994"
9,27,7,2368,472,510,982,"21 de agosto de 1994"
9,27,7,2369,415,446,861,"21 de agosto de 1994"
9,27,7,2370,535,608,1143,"21 de agosto de 1994"
9,27,7,2371,249,279,528,"21 de agosto de 1994"
9,27,7,2372,341,362,703,"21 de agosto de 1994"
9,27,7,2373,444,534,978,"21 de agosto de 1994"
9,27,7,2374,184,183,367,"21 de agosto de 1994"
9,27,7,2375,250,309,559,"21 de agosto de 1994"
9,27,7,2376,338,399,737,"21 de agosto de 1994"
9,27,7,2377,312,373,685,"21 de agosto de 1994"
9,27,7,2378,300,353,653,"21 de agosto de 1994"
9,27,7,2379,431,478,909,"21 de agosto de 1994"
9,27,7,2380,374,427,801,"21 de agosto de 1994"
9,27,7,2381,484,545,1029,"21 de agosto de 1994"
9,27,7,2382,387,420,807,"21 de agosto de 1994"
9,27,7,2383,29,50,79,"21 de agosto de 1994"
9,27,7,2384,370,454,824,"21 de agosto de 1994"
9,27,7,2385,689,705,1394,"21 de agosto de 1994"
9,27,12,4003,418,481,899,"21 de agosto de 1994"
9,27,12,4004,443,529,972,"21 de agosto de 1994"
9,27,12,4005,517,616,1133,"21 de agosto de 1994"
9,27,12,4006,499,627,1126,"21 de agosto de 1994"
9,27,12,4007,590,681,1271,"21 de agosto de 1994"
9,27,12,4008,524,643,1167,"21 de agosto de 1994"
9,27,12,4009,591,756,1347,"21 de agosto de 1994"
9,27,12,4010,224,260,484,"21 de agosto de 1994"
9,27,12,4011,263,288,551,"21 de agosto de 1994"
9,27,12,4012,296,346,642,"21 de agosto de 1994"
9,27,12,4013,431,498,929,"21 de agosto de 1994"
9,27,12,4014,430,564,994,"21 de agosto de 1994"
9,27,12,4015,186,220,406,"21 de agosto de 1994"
9,27,12,4016,468,542,1010,"21 de agosto de 1994"
9,27,12,4017,399,509,908,"21 de agosto de 1994"
9,27,12,4018,316,368,684,"21 de agosto de 1994"
9,27,12,4019,330,385,715,"21 de agosto de 1994"
9,27,12,4020,268,296,564,"21 de agosto de 1994"
9,27,12,4021,298,346,644,"21 de agosto de 1994"
9,27,12,4022,298,329,627,"21 de agosto de 1994"
9,27,12,4023,252,294,546,"21 de agosto de 1994"
9,27,12,4024,565,683,1248,"21 de agosto de 1994"
9,27,12,4025,334,426,760,"21 de agosto de 1994"
9,27,12,4026,250,267,517,"21 de agosto de 1994"
9,27,12,4027,502,583,1085,"21 de agosto de 1994"
9,27,12,4028,350,410,760,"21 de agosto de 1994"
9,27,12,4029,374,429,803,"21 de agosto de 1994"
9,27,12,4030,335,425,760,"21 de agosto de 1994"
9,27,12,4031,410,511,921,"21 de agosto de 1994"
9,27,12,4032,567,677,1244,"21 de agosto de 1994"
9,27,12,4033,672,689,1361,"21 de agosto de 1994"
9,27,12,4034,518,644,1162,"21 de agosto de 1994"
9,27,12,4035,278,305,583,"21 de agosto de 1994"
9,27,12,4036,507,653,1160,"21 de agosto de 1994"
9,27,12,4037,367,448,815,"21 de agosto de 1994"
9,27,12,4038,434,493,927,"21 de agosto de 1994"
9,27,12,4039,408,548,956,"21 de agosto de 1994"
9,27,12,4040,458,616,1074,"21 de agosto de 1994"
9,27,12,4041,355,451,806,"21 de agosto de 1994"
9,27,12,4042,445,557,1002,"21 de agosto de 1994"
9,27,12,4043,409,532,941,"21 de agosto de 1994"
9,27,12,4044,390,502,892,"21 de agosto de 1994"
9,27,12,4045,343,463,806,"21 de agosto de 1994"
9,27,12,4046,371,442,813,"21 de agosto de 1994"
9,27,12,4047,330,366,696,"21 de agosto de 1994"
9,27,12,4048,289,345,634,"21 de agosto de 1994"
9,27,12,4049,476,547,1023,"21 de agosto de 1994"
9,27,12,4050,472,554,1026,"21 de agosto de 1994"
9,27,12,4051,492,567,1059,"21 de agosto de 1994"
9,27,12,4052,404,468,872,"21 de agosto de 1994"
9,27,12,4053,317,370,687,"21 de agosto de 1994"
9,27,12,4054,413,479,892,"21 de agosto de 1994"
9,27,12,4055,479,514,993,"21 de agosto de 1994"
9,27,12,4056,397,444,841,"21 de agosto de 1994"
9,27,12,4057,516,573,1089,"21 de agosto de 1994"
9,27,12,4058,549,626,1175,"21 de agosto de 1994"
9,27,12,4059,349,437,786,"21 de agosto de 1994"
9,27,12,4060,373,478,851,"21 de agosto de 1994"
9,27,12,4061,310,401,711,"21 de agosto de 1994"
9,27,12,4062,368,467,835,"21 de agosto de 1994"
9,27,12,4063,320,418,738,"21 de agosto de 1994"
9,27,12,4064,377,482,859,"21 de agosto de 1994"
9,27,12,4065,504,573,1077,"21 de agosto de 1994"
9,27,12,4066,435,534,969,"21 de agosto de 1994"
9,27,12,4067,427,510,937,"21 de agosto de 1994"
9,27,12,4068,461,624,1085,"21 de agosto de 1994"
9,27,12,4069,394,508,902,"21 de agosto de 1994"
9,27,12,4070,456,560,1016,"21 de agosto de 1994"
9,27,12,4071,659,668,1327,"21 de agosto de 1994"
9,27,12,4072,327,327,654,"21 de agosto de 1994"
9,27,12,4073,453,530,983,"21 de agosto de 1994"
9,27,12,4074,211,281,492,"21 de agosto de 1994"
9,27,12,4075,370,448,818,"21 de agosto de 1994"
9,27,12,4076,472,577,1049,"21 de agosto de 1994"
9,27,12,4077,523,502,1025,"21 de agosto de 1994"
9,27,12,4078,438,553,991,"21 de agosto de 1994"
9,27,12,4079,394,430,824,"21 de agosto de 1994"
9,27,12,4080,411,479,890,"21 de agosto de 1994"
9,27,12,4081,505,589,1094,"21 de agosto de 1994"
9,27,12,4082,324,382,706,"21 de agosto de 1994"
9,27,12,4083,380,524,904,"21 de agosto de 1994"
9,27,12,4084,479,572,1051,"21 de agosto de 1994"
9,27,12,4085,383,502,885,"21 de agosto de 1994"
9,27,12,4086,584,734,1318,"21 de agosto de 1994"
9,27,12,4087,494,563,1057,"21 de agosto de 1994"
9,27,12,4088,222,245,467,"21 de agosto de 1994"
9,27,12,4089,246,306,552,"21 de agosto de 1994"
9,27,12,4090,529,663,1192,"21 de agosto de 1994"
9,27,12,4091,474,537,1011,"21 de agosto de 1994"
9,27,12,4092,434,582,1016,"21 de agosto de 1994"
9,27,12,4093,99,122,221,"21 de agosto de 1994"
9,27,12,4094,123,120,243,"21 de agosto de 1994"
9,27,12,5518,37,52,89,"21 de agosto de 1994"
9,27,12,5519,20,21,41,"21 de agosto de 1994"
9,28,2,152,287,355,642,"21 de agosto de 1994"
9,28,2,153,298,299,597,"21 de agosto de 1994"
9,28,2,154,462,522,984,"21 de agosto de 1994"
9,28,2,155,505,546,1051,"21 de agosto de 1994"
9,28,2,156,550,574,1124,"21 de agosto de 1994"
9,28,2,157,233,294,527,"21 de agosto de 1994"
9,28,2,158,232,268,500,"21 de agosto de 1994"
9,28,2,159,507,538,1045,"21 de agosto de 1994"
9,28,2,160,507,553,1060,"21 de agosto de 1994"
9,28,2,161,547,570,1117,"21 de agosto de 1994"
9,28,2,162,648,705,1353,"21 de agosto de 1994"
9,28,2,163,541,533,1074,"21 de agosto de 1994"
9,28,2,164,717,736,1453,"21 de agosto de 1994"
9,28,2,165,699,779,1478,"21 de agosto de 1994"
9,28,2,166,724,749,1473,"21 de agosto de 1994"
9,28,2,167,490,508,998,"21 de agosto de 1994"
9,28,2,168,664,751,1415,"21 de agosto de 1994"
9,28,2,169,642,691,1333,"21 de agosto de 1994"
9,28,2,170,536,630,1166,"21 de agosto de 1994"
9,28,2,171,601,617,1218,"21 de agosto de 1994"
9,28,2,172,495,510,1005,"21 de agosto de 1994"
9,28,2,173,353,341,694,"21 de agosto de 1994"
9,28,2,174,389,408,797,"21 de agosto de 1994"
9,28,2,175,442,487,929,"21 de agosto de 1994"
9,28,2,176,571,637,1208,"21 de agosto de 1994"
9,28,2,177,620,630,1250,"21 de agosto de 1994"
9,28,2,178,259,298,557,"21 de agosto de 1994"
9,28,2,179,566,593,1159,"21 de agosto de 1994"
9,28,2,180,435,490,925,"21 de agosto de 1994"
9,28,2,181,232,296,528,"21 de agosto de 1994"
9,28,2,182,330,341,671,"21 de agosto de 1994"
9,28,2,183,507,574,1081,"21 de agosto de 1994"
9,28,2,184,358,376,734,"21 de agosto de 1994"
9,28,2,185,343,421,764,"21 de agosto de 1994"
9,28,2,186,572,563,1135,"21 de agosto de 1994"
9,28,2,187,218,260,478,"21 de agosto de 1994"
9,28,2,188,482,528,1010,"21 de agosto de 1994"
9,28,2,189,574,585,1159,"21 de agosto de 1994"
9,28,2,190,436,481,917,"21 de agosto de 1994"
9,28,2,191,540,583,1123,"21 de agosto de 1994"
9,28,2,192,192,228,420,"21 de agosto de 1994"
9,28,2,193,473,563,1036,"21 de agosto de 1994"
9,28,2,194,511,573,1084,"21 de agosto de 1994"
9,28,2,195,477,545,1022,"21 de agosto de 1994"
9,28,2,196,500,526,1026,"21 de agosto de 1994"
9,28,2,197,411,441,852,"21 de agosto de 1994"
9,28,2,198,502,562,1064,"21 de agosto de 1994"
9,28,2,199,456,533,989,"21 de agosto de 1994"
9,28,2,200,440,482,922,"21 de agosto de 1994"
9,28,2,201,422,443,865,"21 de agosto de 1994"
9,28,2,202,514,538,1052,"21 de agosto de 1994"
9,28,2,203,574,655,1229,"21 de agosto de 1994"
9,28,2,204,546,629,1175,"21 de agosto de 1994"
9,28,2,205,654,730,1384,"21 de agosto de 1994"
9,28,2,206,557,609,1166,"21 de agosto de 1994"
9,28,2,207,654,700,1354,"21 de agosto de 1994"
9,28,2,208,555,608,1163,"21 de agosto de 1994"
9,28,2,209,385,432,817,"21 de agosto de 1994"
9,28,2,210,389,467,856,"21 de agosto de 1994"
9,28,2,211,342,386,728,"21 de agosto de 1994"
9,28,2,212,349,372,721,"21 de agosto de 1994"
9,28,2,213,524,509,1033,"21 de agosto de 1994"
9,28,2,214,482,531,1013,"21 de agosto de 1994"
9,28,2,215,437,481,918,"21 de agosto de 1994"
9,28,2,216,550,576,1126,"21 de agosto de 1994"
9,28,2,217,431,513,944,"21 de agosto de 1994"
9,28,2,218,521,578,1099,"21 de agosto de 1994"
9,28,2,219,698,720,1418,"21 de agosto de 1994"
9,28,2,220,463,498,961,"21 de agosto de 1994"
9,28,2,221,345,434,779,"21 de agosto de 1994"
9,28,2,222,627,669,1296,"21 de agosto de 1994"
9,28,2,223,229,284,513,"21 de agosto de 1994"
9,28,2,224,399,517,916,"21 de agosto de 1994"
9,28,2,225,463,570,1033,"21 de agosto de 1994"
9,28,2,226,512,632,1144,"21 de agosto de 1994"
9,28,2,227,468,532,1000,"21 de agosto de 1994"
9,28,2,228,533,592,1125,"21 de agosto de 1994"
9,28,2,229,548,579,1127,"21 de agosto de 1994"
9,28,2,230,455,517,972,"21 de agosto de 1994"
9,28,2,231,466,496,962,"21 de agosto de 1994"
9,28,2,232,480,569,1049,"21 de agosto de 1994"
9,28,2,233,349,377,726,"21 de agosto de 1994"
9,28,2,234,177,221,398,"21 de agosto de 1994"
9,28,2,235,287,316,603,"21 de agosto de 1994"
9,28,2,236,536,572,1108,"21 de agosto de 1994"
9,28,2,237,704,793,1497,"21 de agosto de 1994"
9,28,2,238,523,587,1110,"21 de agosto de 1994"
9,28,2,239,480,500,980,"21 de agosto de 1994"
9,28,2,240,419,435,854,"21 de agosto de 1994"
9,28,2,241,541,615,1156,"21 de agosto de 1994"
9,28,2,242,465,565,1030,"21 de agosto de 1994"
9,28,2,243,178,193,371,"21 de agosto de 1994"
9,28,2,244,387,450,837,"21 de agosto de 1994"
9,28,2,245,513,621,1134,"21 de agosto de 1994"
9,28,2,246,502,531,1033,"21 de agosto de 1994"
9,28,2,247,480,569,1049,"21 de agosto de 1994"
9,28,2,248,479,523,1002,"21 de agosto de 1994"
9,28,2,249,237,264,501,"21 de agosto de 1994"
9,28,2,250,471,503,974,"21 de agosto de 1994"
9,28,2,251,390,419,809,"21 de agosto de 1994"
9,28,2,252,443,482,925,"21 de agosto de 1994"
9,28,2,253,465,516,981,"21 de agosto de 1994"
9,28,2,254,562,611,1173,"21 de agosto de 1994"
9,28,2,255,474,519,993,"21 de agosto de 1994"
9,28,2,256,467,468,935,"21 de agosto de 1994"
9,28,2,257,580,654,1234,"21 de agosto de 1994"
9,28,2,258,591,647,1238,"21 de agosto de 1994"
9,28,2,259,544,598,1142,"21 de agosto de 1994"
9,28,2,260,434,432,866,"21 de agosto de 1994"
9,28,2,261,458,549,1007,"21 de agosto de 1994"
9,28,2,262,430,478,908,"21 de agosto de 1994"
9,28,2,263,568,639,1207,"21 de agosto de 1994"
9,28,2,264,543,592,1135,"21 de agosto de 1994"
9,28,2,265,459,537,996,"21 de agosto de 1994"
9,28,2,266,536,610,1146,"21 de agosto de 1994"
9,28,2,267,372,421,793,"21 de agosto de 1994"
9,28,2,268,407,475,882,"21 de agosto de 1994"
9,28,2,269,468,525,993,"21 de agosto de 1994"
9,28,2,270,456,529,985,"21 de agosto de 1994"
9,28,2,271,471,501,972,"21 de agosto de 1994"
9,28,2,272,447,476,923,"21 de agosto de 1994"
9,28,2,273,609,592,1201,"21 de agosto de 1994"
9,28,2,274,494,516,1010,"21 de agosto de 1994"
9,28,2,275,486,554,1040,"21 de agosto de 1994"
9,28,2,276,432,431,863,"21 de agosto de 1994"
9,28,2,277,408,411,819,"21 de agosto de 1994"
9,28,2,278,426,404,830,"21 de agosto de 1994"
9,28,2,279,403,405,808,"21 de agosto de 1994"
9,28,2,280,341,355,696,"21 de agosto de 1994"
9,28,2,281,422,457,879,"21 de agosto de 1994"
9,28,2,282,429,439,868,"21 de agosto de 1994"
9,28,2,283,491,522,1013,"21 de agosto de 1994"
9,28,2,284,456,517,973,"21 de agosto de 1994"
9,28,2,285,505,534,1039,"21 de agosto de 1994"
9,28,2,286,381,421,802,"21 de agosto de 1994"
9,28,2,287,569,585,1154,"21 de agosto de 1994"
9,28,2,288,414,439,853,"21 de agosto de 1994"
9,28,2,289,228,255,483,"21 de agosto de 1994"
9,28,2,290,364,419,783,"21 de agosto de 1994"
9,28,2,291,253,247,500,"21 de agosto de 1994"
9,28,2,292,235,259,494,"21 de agosto de 1994"
9,28,2,293,342,412,754,"21 de agosto de 1994"
9,28,2,294,273,285,558,"21 de agosto de 1994"
9,28,2,295,246,260,506,"21 de agosto de 1994"
9,28,2,296,291,269,560,"21 de agosto de 1994"
9,28,2,297,298,316,614,"21 de agosto de 1994"
9,28,2,298,265,288,553,"21 de agosto de 1994"
9,28,2,299,311,350,661,"21 de agosto de 1994"
9,28,2,300,244,333,577,"21 de agosto de 1994"
9,28,2,301,222,267,489,"21 de agosto de 1994"
9,28,2,302,91,125,216,"21 de agosto de 1994"
9,28,2,303,134,181,315,"21 de agosto de 1994"
9,28,2,304,162,186,348,"21 de agosto de 1994"
9,28,2,305,194,240,434,"21 de agosto de 1994"
9,28,2,306,109,144,253,"21 de agosto de 1994"
9,28,2,307,90,114,204,"21 de agosto de 1994"
9,28,2,5512,141,177,318,"21 de agosto de 1994"
9,28,2,5513,135,155,290,"21 de agosto de 1994"
9,28,2,5514,154,182,336,"21 de agosto de 1994"
9,28,16,5104,464,457,921,"21 de agosto de 1994"
9,28,16,5105,537,609,1146,"21 de agosto de 1994"
9,28,16,5106,525,675,1200,"21 de agosto de 1994"
9,28,16,5107,659,763,1422,"21 de agosto de 1994"
9,28,16,5108,652,681,1333,"21 de agosto de 1994"
9,28,16,5109,567,662,1229,"21 de agosto de 1994"
9,28,16,5110,515,541,1056,"21 de agosto de 1994"
9,28,16,5111,405,446,851,"21 de agosto de 1994"
9,28,16,5112,574,644,1218,"21 de agosto de 1994"
9,28,16,5113,506,566,1072,"21 de agosto de 1994"
9,28,16,5114,648,673,1321,"21 de agosto de 1994"
9,28,16,5115,121,150,271,"21 de agosto de 1994"
9,28,16,5116,132,163,295,"21 de agosto de 1994"
9,29,2,308,615,658,1273,"21 de agosto de 1994"
9,29,2,309,243,248,491,"21 de agosto de 1994"
9,29,2,310,396,380,776,"21 de agosto de 1994"
9,29,2,311,311,364,675,"21 de agosto de 1994"
9,29,2,312,507,487,994,"21 de agosto de 1994"
9,29,2,313,589,598,1187,"21 de agosto de 1994"
9,29,2,314,585,637,1222,"21 de agosto de 1994"
9,29,2,315,559,634,1193,"21 de agosto de 1994"
9,29,2,316,470,472,942,"21 de agosto de 1994"
9,29,2,317,421,461,882,"21 de agosto de 1994"
9,29,2,318,590,605,1195,"21 de agosto de 1994"
9,29,2,319,532,585,1117,"21 de agosto de 1994"
9,29,2,320,526,556,1082,"21 de agosto de 1994"
9,29,2,321,463,567,1030,"21 de agosto de 1994"
9,29,2,322,473,537,1010,"21 de agosto de 1994"
9,29,2,323,496,515,1011,"21 de agosto de 1994"
9,29,2,324,391,432,823,"21 de agosto de 1994"
9,29,2,325,444,496,940,"21 de agosto de 1994"
9,29,2,326,629,711,1340,"21 de agosto de 1994"
9,29,2,327,368,466,834,"21 de agosto de 1994"
9,29,2,328,400,470,870,"21 de agosto de 1994"
9,29,2,329,495,558,1053,"21 de agosto de 1994"
9,29,2,330,373,425,798,"21 de agosto de 1994"
9,29,2,331,416,470,886,"21 de agosto de 1994"
9,29,2,332,450,507,957,"21 de agosto de 1994"
9,29,2,333,423,506,929,"21 de agosto de 1994"
9,29,2,334,504,628,1132,"21 de agosto de 1994"
9,29,2,335,373,431,804,"21 de agosto de 1994"
9,29,2,336,471,540,1011,"21 de agosto de 1994"
9,29,2,337,381,421,802,"21 de agosto de 1994"
9,29,2,338,427,451,878,"21 de agosto de 1994"
9,29,2,339,440,488,928,"21 de agosto de 1994"
9,29,2,340,463,534,997,"21 de agosto de 1994"
9,29,2,341,479,548,1027,"21 de agosto de 1994"
9,29,2,342,423,466,889,"21 de agosto de 1994"
9,29,2,343,409,465,874,"21 de agosto de 1994"
9,29,2,344,650,704,1354,"21 de agosto de 1994"
9,29,5,1451,579,691,1270,"21 de agosto de 1994"
9,29,5,1452,318,420,738,"21 de agosto de 1994"
9,29,5,1453,337,387,724,"21 de agosto de 1994"
9,29,5,1454,363,416,779,"21 de agosto de 1994"
9,29,5,1455,416,455,871,"21 de agosto de 1994"
9,29,5,1456,431,520,951,"21 de agosto de 1994"
9,29,5,1457,337,418,755,"21 de agosto de 1994"
9,29,5,1458,467,561,1028,"21 de agosto de 1994"
9,29,5,1459,363,451,814,"21 de agosto de 1994"
9,29,5,1460,412,495,907,"21 de agosto de 1994"
9,29,5,1461,276,340,616,"21 de agosto de 1994"
9,29,5,1462,407,455,862,"21 de agosto de 1994"
9,29,5,1463,566,645,1211,"21 de agosto de 1994"
9,29,5,1464,480,578,1058,"21 de agosto de 1994"
9,29,5,1465,397,532,929,"21 de agosto de 1994"
9,29,5,1466,398,488,886,"21 de agosto de 1994"
9,29,5,1467,377,463,840,"21 de agosto de 1994"
9,29,5,1468,401,440,841,"21 de agosto de 1994"
9,29,5,1469,611,631,1242,"21 de agosto de 1994"
9,29,5,1470,421,512,933,"21 de agosto de 1994"
9,29,5,1471,610,647,1257,"21 de agosto de 1994"
9,29,5,1472,561,564,1125,"21 de agosto de 1994"
9,29,5,1473,400,517,917,"21 de agosto de 1994"
9,29,5,1474,517,587,1104,"21 de agosto de 1994"
9,29,5,1475,515,572,1087,"21 de agosto de 1994"
9,29,5,1476,445,521,966,"21 de agosto de 1994"
9,29,5,1477,552,637,1189,"21 de agosto de 1994"
9,29,5,1478,411,435,846,"21 de agosto de 1994"
9,29,5,1479,403,481,884,"21 de agosto de 1994"
9,29,5,1480,189,228,417,"21 de agosto de 1994"
9,29,5,1481,552,560,1112,"21 de agosto de 1994"
9,29,5,1482,460,516,976,"21 de agosto de 1994"
9,29,5,1483,533,579,1112,"21 de agosto de 1994"
9,29,5,1484,561,631,1192,"21 de agosto de 1994"
9,29,5,1485,501,563,1064,"21 de agosto de 1994"
9,29,5,1486,404,488,892,"21 de agosto de 1994"
9,29,5,1487,442,535,977,"21 de agosto de 1994"
9,29,5,1488,248,272,520,"21 de agosto de 1994"
9,29,5,1489,386,409,795,"21 de agosto de 1994"
9,29,5,1490,477,584,1061,"21 de agosto de 1994"
9,29,5,1491,638,700,1338,"21 de agosto de 1994"
9,29,5,1492,487,546,1033,"21 de agosto de 1994"
9,29,5,1493,522,562,1084,"21 de agosto de 1994"
9,29,5,1494,463,540,1003,"21 de agosto de 1994"
9,29,5,1495,166,232,398,"21 de agosto de 1994"
9,29,5,1616,0,0,0,"21 de agosto de 1994"
9,30,5,1496,627,668,1295,"21 de agosto de 1994"
9,30,5,1497,534,574,1108,"21 de agosto de 1994"
9,30,5,1498,420,468,888,"21 de agosto de 1994"
9,30,5,1499,605,655,1260,"21 de agosto de 1994"
9,30,5,1500,602,692,1294,"21 de agosto de 1994"
9,30,5,1501,265,311,576,"21 de agosto de 1994"
9,30,5,1502,519,639,1158,"21 de agosto de 1994"
9,30,5,1503,470,522,992,"21 de agosto de 1994"
9,30,5,1504,531,652,1183,"21 de agosto de 1994"
9,30,5,1505,454,512,966,"21 de agosto de 1994"
9,30,5,1506,378,426,804,"21 de agosto de 1994"
9,30,5,1507,506,533,1039,"21 de agosto de 1994"
9,30,5,1508,634,715,1349,"21 de agosto de 1994"
9,30,5,1509,460,501,961,"21 de agosto de 1994"
9,30,5,1510,402,443,845,"21 de agosto de 1994"
9,30,5,1511,518,571,1089,"21 de agosto de 1994"
9,30,5,1512,618,633,1251,"21 de agosto de 1994"
9,30,5,1513,439,495,934,"21 de agosto de 1994"
9,30,5,1514,173,170,343,"21 de agosto de 1994"
9,30,5,1515,383,451,834,"21 de agosto de 1994"
9,30,5,1516,595,638,1233,"21 de agosto de 1994"
9,30,5,1517,469,540,1009,"21 de agosto de 1994"
9,30,5,1518,554,602,1156,"21 de agosto de 1994"
9,30,5,1519,528,593,1121,"21 de agosto de 1994"
9,30,5,1520,448,526,974,"21 de agosto de 1994"
9,30,5,1521,566,610,1176,"21 de agosto de 1994"
9,30,5,1522,517,580,1097,"21 de agosto de 1994"
9,30,5,1523,569,588,1157,"21 de agosto de 1994"
9,30,5,1524,352,390,742,"21 de agosto de 1994"
9,30,5,1525,536,593,1129,"21 de agosto de 1994"
9,30,5,1526,409,423,832,"21 de agosto de 1994"
9,30,5,1527,467,502,969,"21 de agosto de 1994"
9,30,5,1528,438,525,963,"21 de agosto de 1994"
9,30,5,1529,492,550,1042,"21 de agosto de 1994"
9,30,5,1530,504,584,1088,"21 de agosto de 1994"
9,30,5,1531,464,508,972,"21 de agosto de 1994"
9,30,5,1532,460,523,983,"21 de agosto de 1994"
9,30,5,1533,489,492,981,"21 de agosto de 1994"
9,30,5,1534,508,596,1104,"21 de agosto de 1994"
9,30,5,1535,559,642,1201,"21 de agosto de 1994"
9,30,5,1536,549,617,1166,"21 de agosto de 1994"
9,30,5,1537,430,529,959,"21 de agosto de 1994"
9,30,5,1538,374,420,794,"21 de agosto de 1994"
9,30,5,1539,474,508,982,"21 de agosto de 1994"
9,30,5,1540,589,679,1268,"21 de agosto de 1994"
9,30,5,1541,530,601,1131,"21 de agosto de 1994"
9,30,5,1542,461,490,951,"21 de agosto de 1994"
9,30,5,1543,438,473,911,"21 de agosto de 1994"
9,30,5,1544,589,672,1261,"21 de agosto de 1994"
9,30,5,1545,310,383,693,"21 de agosto de 1994"
9,30,5,1546,391,479,870,"21 de agosto de 1994"
9,30,5,1547,336,397,733,"21 de agosto de 1994"
9,30,5,1548,449,512,961,"21 de agosto de 1994"
9,30,5,1549,455,493,948,"21 de agosto de 1994"
9,30,5,1550,415,485,900,"21 de agosto de 1994"
9,30,5,1551,384,432,816,"21 de agosto de 1994"
9,30,5,1552,483,513,996,"21 de agosto de 1994"
9,30,5,1553,339,378,717,"21 de agosto de 1994"
9,30,5,1554,355,440,795,"21 de agosto de 1994"
9,30,5,1555,443,524,967,"21 de agosto de 1994"
9,30,5,1556,518,556,1074,"21 de agosto de 1994"
9,30,5,1557,315,385,700,"21 de agosto de 1994"
9,30,5,1558,250,329,579,"21 de agosto de 1994"
9,30,5,1559,242,255,497,"21 de agosto de 1994"
9,30,5,1560,542,565,1107,"21 de agosto de 1994"
9,30,5,1561,414,490,904,"21 de agosto de 1994"
9,30,5,1562,441,471,912,"21 de agosto de 1994"
9,30,5,1563,470,556,1026,"21 de agosto de 1994"
9,30,5,1564,593,668,1261,"21 de agosto de 1994"
9,30,5,1565,532,609,1141,"21 de agosto de 1994"
9,30,5,1566,470,583,1053,"21 de agosto de 1994"
9,30,5,1567,385,467,852,"21 de agosto de 1994"
9,30,5,1568,498,598,1096,"21 de agosto de 1994"
9,30,5,1569,696,789,1485,"21 de agosto de 1994"
9,30,5,1570,506,585,1091,"21 de agosto de 1994"
9,30,5,1571,351,454,805,"21 de agosto de 1994"
9,30,5,1572,368,406,774,"21 de agosto de 1994"
9,30,5,1573,418,482,900,"21 de agosto de 1994"
9,30,5,1574,482,532,1014,"21 de agosto de 1994"
9,30,5,1575,406,420,826,"21 de agosto de 1994"
9,30,5,1576,492,537,1029,"21 de agosto de 1994"
9,30,5,1577,583,604,1187,"21 de agosto de 1994"
9,30,5,1578,678,737,1415,"21 de agosto de 1994"
9,30,5,1579,669,687,1356,"21 de agosto de 1994"
9,30,5,1580,355,375,730,"21 de agosto de 1994"
9,30,5,1581,575,607,1182,"21 de agosto de 1994"
9,30,5,1582,487,494,981,"21 de agosto de 1994"
9,30,5,1583,648,707,1355,"21 de agosto de 1994"
9,30,5,1584,721,752,1473,"21 de agosto de 1994"
9,30,5,1585,370,411,781,"21 de agosto de 1994"
9,30,5,1586,354,435,789,"21 de agosto de 1994"
9,30,5,1587,264,307,571,"21 de agosto de 1994"
9,30,5,1588,377,383,760,"21 de agosto de 1994"
9,31,5,1589,733,800,1533,"21 de agosto de 1994"
9,31,5,1590,388,415,803,"21 de agosto de 1994"
9,31,5,1591,664,762,1426,"21 de agosto de 1994"
9,31,5,1592,649,712,1361,"21 de agosto de 1994"
9,31,5,1593,520,590,1110,"21 de agosto de 1994"
9,31,5,1594,533,619,1152,"21 de agosto de 1994"
9,31,5,1595,547,635,1182,"21 de agosto de 1994"
9,31,5,1596,643,661,1304,"21 de agosto de 1994"
9,31,5,1597,515,582,1097,"21 de agosto de 1994"
9,31,5,1598,531,619,1150,"21 de agosto de 1994"
9,31,5,1599,387,422,809,"21 de agosto de 1994"
9,31,5,1600,443,510,953,"21 de agosto de 1994"
9,31,5,1601,403,496,899,"21 de agosto de 1994"
9,31,5,1602,630,748,1378,"21 de agosto de 1994"
9,31,5,1603,435,463,898,"21 de agosto de 1994"
9,31,5,1604,676,773,1449,"21 de agosto de 1994"
9,31,5,1605,567,696,1263,"21 de agosto de 1994"
9,31,5,1606,555,651,1206,"21 de agosto de 1994"
9,31,5,1607,484,500,984,"21 de agosto de 1994"
9,31,5,1608,615,733,1348,"21 de agosto de 1994"
9,31,5,1609,563,644,1207,"21 de agosto de 1994"
9,31,5,1610,582,673,1255,"21 de agosto de 1994"
9,31,5,1611,585,686,1271,"21 de agosto de 1994"
9,31,5,1612,546,669,1215,"21 de agosto de 1994"
9,31,5,1613,595,632,1227,"21 de agosto de 1994"
9,31,5,1614,701,804,1505,"21 de agosto de 1994"
9,31,5,1615,658,762,1420,"21 de agosto de 1994"
9,31,5,1616,531,582,1113,"21 de agosto de 1994"
9,31,5,1617,352,409,761,"21 de agosto de 1994"
9,31,5,1618,587,682,1269,"21 de agosto de 1994"
9,31,5,1619,588,655,1243,"21 de agosto de 1994"
9,31,5,1620,419,480,899,"21 de agosto de 1994"
9,31,5,1621,603,665,1268,"21 de agosto de 1994"
9,31,5,1622,564,647,1211,"21 de agosto de 1994"
9,31,5,1623,512,599,1111,"21 de agosto de 1994"
9,31,5,1624,521,583,1104,"21 de agosto de 1994"
9,31,5,1625,561,606,1167,"21 de agosto de 1994"
9,31,5,1626,571,667,1238,"21 de agosto de 1994"
9,31,5,1627,558,639,1197,"21 de agosto de 1994"
9,31,5,1628,502,583,1085,"21 de agosto de 1994"
9,31,5,1629,576,639,1215,"21 de agosto de 1994"
9,31,5,1630,466,558,1024,"21 de agosto de 1994"
9,31,5,1631,669,734,1403,"21 de agosto de 1994"
9,31,5,1632,656,767,1423,"21 de agosto de 1994"
9,31,5,1633,612,672,1284,"21 de agosto de 1994"
9,31,5,1634,475,554,1029,"21 de agosto de 1994"
9,31,5,1635,604,721,1325,"21 de agosto de 1994"
9,31,5,1636,575,626,1201,"21 de agosto de 1994"
9,31,5,1637,624,737,1361,"21 de agosto de 1994"
9,31,5,1638,535,607,1142,"21 de agosto de 1994"
9,31,5,1639,456,518,974,"21 de agosto de 1994"
9,31,5,1640,393,500,893,"21 de agosto de 1994"
9,31,5,1641,581,626,1207,"21 de agosto de 1994"
9,31,5,1642,467,502,969,"21 de agosto de 1994"
9,31,5,1643,511,554,1065,"21 de agosto de 1994"
9,31,5,1644,563,639,1202,"21 de agosto de 1994"
9,31,5,1645,376,493,869,"21 de agosto de 1994"
9,31,5,1646,418,508,926,"21 de agosto de 1994"
9,31,5,1647,554,624,1178,"21 de agosto de 1994"
9,31,5,1648,513,619,1132,"21 de agosto de 1994"
9,31,5,1649,513,492,1005,"21 de agosto de 1994"
9,31,5,1650,378,463,841,"21 de agosto de 1994"
9,31,5,1651,566,578,1144,"21 de agosto de 1994"
9,31,5,1652,616,643,1259,"21 de agosto de 1994"
9,31,5,1653,425,497,922,"21 de agosto de 1994"
9,31,5,1654,631,691,1322,"21 de agosto de 1994"
9,31,5,1655,569,610,1179,"21 de agosto de 1994"
9,31,5,1656,577,631,1208,"21 de agosto de 1994"
9,31,5,1657,596,657,1253,"21 de agosto de 1994"
9,31,5,1658,394,456,850,"21 de agosto de 1994"
9,31,5,1659,571,592,1163,"21 de agosto de 1994"
9,31,5,1660,468,541,1009,"21 de agosto de 1994"
9,31,5,1661,476,533,1009,"21 de agosto de 1994"
9,31,5,1662,405,414,819,"21 de agosto de 1994"
9,31,5,1663,294,313,607,"21 de agosto de 1994"
9,31,5,1664,316,391,707,"21 de agosto de 1994"
9,31,5,1665,342,378,720,"21 de agosto de 1994"
9,31,5,1666,496,601,1097,"21 de agosto de 1994"
9,31,5,1667,482,554,1036,"21 de agosto de 1994"
9,31,5,1668,365,380,745,"21 de agosto de 1994"
9,31,5,1669,370,442,812,"21 de agosto de 1994"
9,31,5,1670,297,350,647,"21 de agosto de 1994"
9,31,5,1671,368,427,795,"21 de agosto de 1994"
9,31,17,5400,616,678,1294,"21 de agosto de 1994"
9,31,17,5401,502,628,1130,"21 de agosto de 1994"
9,31,17,5402,542,619,1161,"21 de agosto de 1994"
9,31,17,5403,642,713,1355,"21 de agosto de 1994"
9,31,17,5404,368,460,828,"21 de agosto de 1994"
9,31,17,5405,427,468,895,"21 de agosto de 1994"
9,31,17,5406,374,375,749,"21 de agosto de 1994"
9,31,17,5407,720,607,1327,"21 de agosto de 1994"
9,31,17,5408,531,602,1133,"21 de agosto de 1994"
9,31,17,5409,556,695,1251,"21 de agosto de 1994"
9,31,17,5410,567,626,1193,"21 de agosto de 1994"
9,31,17,5411,635,676,1311,"21 de agosto de 1994"
9,31,17,5412,635,683,1318,"21 de agosto de 1994"
9,31,17,5413,450,529,979,"21 de agosto de 1994"
9,31,17,5414,553,647,1200,"21 de agosto de 1994"
9,31,17,5415,670,702,1372,"21 de agosto de 1994"
9,31,17,5416,578,719,1297,"21 de agosto de 1994"
9,31,17,5417,540,665,1205,"21 de agosto de 1994"
9,31,17,5418,591,642,1233,"21 de agosto de 1994"
9,31,17,5419,616,612,1228,"21 de agosto de 1994"
9,31,17,5420,521,617,1138,"21 de agosto de 1994"
9,31,17,5421,429,461,890,"21 de agosto de 1994"
9,31,17,5422,506,557,1063,"21 de agosto de 1994"
9,31,17,5423,436,448,884,"21 de agosto de 1994"
9,31,17,5424,434,439,873,"21 de agosto de 1994"
9,31,17,5425,395,450,845,"21 de agosto de 1994"
9,31,17,5426,345,367,712,"21 de agosto de 1994"
9,31,17,5427,314,344,658,"21 de agosto de 1994"
9,32,16,5117,699,762,1461,"21 de agosto de 1994"
9,32,16,5118,545,619,1164,"21 de agosto de 1994"
9,32,16,5119,540,605,1145,"21 de agosto de 1994"
9,32,16,5120,566,683,1249,"21 de agosto de 1994"
9,32,16,5121,585,718,1303,"21 de agosto de 1994"
9,32,16,5122,444,527,971,"21 de agosto de 1994"
9,32,16,5123,505,571,1076,"21 de agosto de 1994"
9,32,16,5124,589,773,1362,"21 de agosto de 1994"
9,32,16,5125,267,332,599,"21 de agosto de 1994"
9,32,16,5126,365,420,785,"21 de agosto de 1994"
9,32,16,5127,525,598,1123,"21 de agosto de 1994"
9,32,16,5128,639,723,1362,"21 de agosto de 1994"
9,32,16,5129,646,759,1405,"21 de agosto de 1994"
9,32,16,5130,641,699,1340,"21 de agosto de 1994"
9,32,16,5131,570,642,1212,"21 de agosto de 1994"
9,32,16,5132,629,733,1362,"21 de agosto de 1994"
9,32,16,5133,584,639,1223,"21 de agosto de 1994"
9,32,16,5134,553,627,1180,"21 de agosto de 1994"
9,32,16,5135,580,663,1243,"21 de agosto de 1994"
9,32,16,5136,430,524,954,"21 de agosto de 1994"
9,32,16,5137,381,494,875,"21 de agosto de 1994"
9,32,16,5138,670,773,1443,"21 de agosto de 1994"
9,32,16,5139,465,567,1032,"21 de agosto de 1994"
9,32,16,5140,624,684,1308,"21 de agosto de 1994"
9,32,16,5141,598,746,1344,"21 de agosto de 1994"
9,32,16,5142,538,624,1162,"21 de agosto de 1994"
9,32,16,5143,647,754,1401,"21 de agosto de 1994"
9,32,16,5144,524,563,1087,"21 de agosto de 1994"
9,32,16,5145,635,759,1394,"21 de agosto de 1994"
9,32,16,5146,508,568,1076,"21 de agosto de 1994"
9,32,16,5147,446,526,972,"21 de agosto de 1994"
9,32,16,5148,425,543,968,"21 de agosto de 1994"
9,32,16,5149,424,515,939,"21 de agosto de 1994"
9,32,16,5150,603,636,1239,"21 de agosto de 1994"
9,32,16,5151,540,692,1232,"21 de agosto de 1994"
9,32,16,5152,601,687,1288,"21 de agosto de 1994"
9,32,16,5153,468,507,975,"21 de agosto de 1994"
9,32,16,5154,461,553,1014,"21 de agosto de 1994"
9,32,16,5155,494,660,1154,"21 de agosto de 1994"
9,32,16,5156,370,427,797,"21 de agosto de 1994"
9,32,16,5157,693,757,1450,"21 de agosto de 1994"
9,32,16,5158,483,585,1068,"21 de agosto de 1994"
9,32,16,5159,343,469,812,"21 de agosto de 1994"
9,32,16,5160,314,454,768,"21 de agosto de 1994"
9,32,16,5161,215,275,490,"21 de agosto de 1994"
9,32,16,5162,469,735,1204,"21 de agosto de 1994"
9,32,16,5163,284,379,663,"21 de agosto de 1994"
9,32,16,5164,300,423,723,"21 de agosto de 1994"
9,32,16,5165,386,521,907,"21 de agosto de 1994"
9,32,16,5166,363,491,854,"21 de agosto de 1994"
9,32,16,5167,377,504,881,"21 de agosto de 1994"
9,32,16,5168,270,412,682,"21 de agosto de 1994"
9,32,16,5169,332,536,868,"21 de agosto de 1994"
9,32,16,5170,296,462,758,"21 de agosto de 1994"
9,32,16,5171,336,482,818,"21 de agosto de 1994"
9,32,16,5172,348,498,846,"21 de agosto de 1994"
9,32,16,5173,277,406,683,"21 de agosto de 1994"
9,32,16,5174,280,442,722,"21 de agosto de 1994"
9,32,16,5175,306,503,809,"21 de agosto de 1994"
9,32,16,5176,281,314,595,"21 de agosto de 1994"
9,32,16,5177,320,471,791,"21 de agosto de 1994"
9,32,16,5178,355,508,863,"21 de agosto de 1994"
9,32,16,5179,192,303,495,"21 de agosto de 1994"
9,32,16,5180,319,462,781,"21 de agosto de 1994"
9,32,16,5181,290,441,731,"21 de agosto de 1994"
9,32,16,5182,319,399,718,"21 de agosto de 1994"
9,33,15,4831,424,554,978,"21 de agosto de 1994"
9,33,15,4832,484,620,1104,"21 de agosto de 1994"
9,33,15,4833,410,524,934,"21 de agosto de 1994"
9,33,15,4834,419,529,948,"21 de agosto de 1994"
9,33,15,4835,524,587,1111,"21 de agosto de 1994"
9,33,15,4836,442,510,952,"21 de agosto de 1994"
9,33,15,4837,296,314,610,"21 de agosto de 1994"
9,33,15,4838,383,335,718,"21 de agosto de 1994"
9,33,15,4839,423,441,864,"21 de agosto de 1994"
9,33,15,4840,556,513,1069,"21 de agosto de 1994"
9,33,15,4841,461,516,977,"21 de agosto de 1994"
9,33,15,4842,432,486,918,"21 de agosto de 1994"
9,33,15,4843,556,606,1162,"21 de agosto de 1994"
9,33,15,4844,484,545,1029,"21 de agosto de 1994"
9,33,15,4845,443,507,950,"21 de agosto de 1994"
9,33,15,4846,518,590,1108,"21 de agosto de 1994"
9,33,15,4847,273,318,591,"21 de agosto de 1994"
9,33,15,4848,478,481,959,"21 de agosto de 1994"
9,33,15,4849,377,426,803,"21 de agosto de 1994"
9,33,15,4850,716,748,1464,"21 de agosto de 1994"
9,33,15,4851,588,617,1205,"21 de agosto de 1994"
9,33,15,4852,457,537,994,"21 de agosto de 1994"
9,33,15,4853,428,469,897,"21 de agosto de 1994"
9,33,15,4854,458,511,969,"21 de agosto de 1994"
9,33,15,4855,480,543,1023,"21 de agosto de 1994"
9,33,15,4856,469,581,1050,"21 de agosto de 1994"
9,33,15,4857,494,642,1136,"21 de agosto de 1994"
9,33,15,4858,408,479,887,"21 de agosto de 1994"
9,33,15,4859,447,577,1024,"21 de agosto de 1994"
9,33,15,4860,449,533,982,"21 de agosto de 1994"
9,33,15,4861,353,490,843,"21 de agosto de 1994"
9,33,15,4862,464,561,1025,"21 de agosto de 1994"
9,33,15,4863,412,525,937,"21 de agosto de 1994"
9,33,15,4864,381,415,796,"21 de agosto de 1994"
9,33,15,4865,344,439,783,"21 de agosto de 1994"
9,33,15,4866,363,408,771,"21 de agosto de 1994"
9,33,15,4867,426,477,903,"21 de agosto de 1994"
9,33,15,4868,350,419,769,"21 de agosto de 1994"
9,33,15,4869,435,507,942,"21 de agosto de 1994"
9,33,15,4870,537,603,1140,"21 de agosto de 1994"
9,33,15,4871,488,548,1036,"21 de agosto de 1994"
9,33,15,4872,568,690,1258,"21 de agosto de 1994"
9,33,15,4873,164,155,319,"21 de agosto de 1994"
9,33,15,4874,306,415,721,"21 de agosto de 1994"
9,33,15,4875,338,426,764,"21 de agosto de 1994"
9,33,15,4876,273,410,683,"21 de agosto de 1994"
9,33,15,4877,309,381,690,"21 de agosto de 1994"
9,33,15,4878,265,338,603,"21 de agosto de 1994"
9,33,15,4879,337,398,735,"21 de agosto de 1994"
9,33,15,4880,218,280,498,"21 de agosto de 1994"
9,33,15,4881,293,377,670,"21 de agosto de 1994"
9,33,15,4882,220,264,484,"21 de agosto de 1994"
9,33,15,4883,210,252,462,"21 de agosto de 1994"
9,33,15,4884,235,308,543,"21 de agosto de 1994"
9,33,15,4885,370,458,828,"21 de agosto de 1994"
9,33,15,4886,382,391,773,"21 de agosto de 1994"
9,33,15,4887,193,195,388,"21 de agosto de 1994"
9,33,15,4888,451,393,844,"21 de agosto de 1994"
9,33,15,4889,207,327,534,"21 de agosto de 1994"
9,33,15,4890,221,248,469,"21 de agosto de 1994"
9,34,6,1904,590,641,1231,"21 de agosto de 1994"
9,34,6,1905,439,508,947,"21 de agosto de 1994"
9,34,6,1906,516,576,1092,"21 de agosto de 1994"
9,34,6,1907,484,531,1015,"21 de agosto de 1994"
9,34,6,1908,372,424,796,"21 de agosto de 1994"
9,34,6,1909,434,497,931,"21 de agosto de 1994"
9,34,6,1910,388,419,807,"21 de agosto de 1994"
9,34,6,1911,410,457,867,"21 de agosto de 1994"
9,34,6,1912,380,402,782,"21 de agosto de 1994"
9,34,6,1913,585,622,1207,"21 de agosto de 1994"
9,34,6,1914,385,439,824,"21 de agosto de 1994"
9,34,6,1915,330,369,699,"21 de agosto de 1994"
9,34,6,1916,515,544,1059,"21 de agosto de 1994"
9,34,6,1917,307,379,686,"21 de agosto de 1994"
9,34,6,1918,457,503,960,"21 de agosto de 1994"
9,34,6,1919,349,381,730,"21 de agosto de 1994"
9,34,6,1920,353,359,712,"21 de agosto de 1994"
9,34,6,1921,634,716,1350,"21 de agosto de 1994"
9,34,6,1922,494,512,1006,"21 de agosto de 1994"
9,34,6,1923,370,390,760,"21 de agosto de 1994"
9,34,6,1924,562,602,1164,"21 de agosto de 1994"
9,34,6,1925,354,419,773,"21 de agosto de 1994"
9,34,6,1926,481,534,1015,"21 de agosto de 1994"
9,34,6,1927,442,486,928,"21 de agosto de 1994"
9,34,6,1928,442,469,911,"21 de agosto de 1994"
9,34,6,1929,437,480,917,"21 de agosto de 1994"
9,34,6,1930,392,486,878,"21 de agosto de 1994"
9,34,6,1931,518,537,1055,"21 de agosto de 1994"
9,34,6,1932,392,427,819,"21 de agosto de 1994"
9,34,6,1933,347,383,730,"21 de agosto de 1994"
9,34,6,1934,428,488,916,"21 de agosto de 1994"
9,34,6,1935,303,333,636,"21 de agosto de 1994"
9,34,6,1936,554,608,1162,"21 de agosto de 1994"
9,34,6,1937,646,732,1378,"21 de agosto de 1994"
9,34,6,1938,500,581,1081,"21 de agosto de 1994"
9,34,6,1939,477,500,977,"21 de agosto de 1994"
9,34,6,1940,364,391,755,"21 de agosto de 1994"
9,34,6,1941,381,467,848,"21 de agosto de 1994"
9,34,6,1942,506,527,1033,"21 de agosto de 1994"
9,34,6,1943,602,652,1254,"21 de agosto de 1994"
9,34,6,1944,489,509,998,"21 de agosto de 1994"
9,34,17,5428,626,716,1342,"21 de agosto de 1994"
9,34,17,5429,640,683,1323,"21 de agosto de 1994"
9,34,17,5430,278,318,596,"21 de agosto de 1994"
9,34,17,5431,745,795,1540,"21 de agosto de 1994"
9,34,17,5432,284,341,625,"21 de agosto de 1994"
9,34,17,5433,353,397,750,"21 de agosto de 1994"
9,34,17,5434,366,456,822,"21 de agosto de 1994"
9,34,17,5435,309,349,658,"21 de agosto de 1994"
9,34,17,5436,649,746,1395,"21 de agosto de 1994"
9,34,17,5437,484,505,989,"21 de agosto de 1994"
9,34,17,5438,397,442,839,"21 de agosto de 1994"
9,34,17,5439,656,687,1343,"21 de agosto de 1994"
9,34,17,5440,713,776,1489,"21 de agosto de 1994"
9,34,17,5441,604,660,1264,"21 de agosto de 1994"
9,34,17,5442,330,394,724,"21 de agosto de 1994"
9,34,17,5443,523,583,1106,"21 de agosto de 1994"
9,34,17,5444,611,691,1302,"21 de agosto de 1994"
9,34,17,5445,475,536,1011,"21 de agosto de 1994"
9,34,17,5446,636,721,1357,"21 de agosto de 1994"
9,34,17,5447,722,807,1529,"21 de agosto de 1994"
9,34,17,5448,477,510,987,"21 de agosto de 1994"
9,34,17,5449,417,445,862,"21 de agosto de 1994"
9,34,17,5450,490,557,1047,"21 de agosto de 1994"
9,34,17,5451,670,750,1420,"21 de agosto de 1994"
9,34,17,5452,515,571,1086,"21 de agosto de 1994"
9,34,17,5453,627,658,1285,"21 de agosto de 1994"
9,34,17,5454,473,566,1039,"21 de agosto de 1994"
9,34,17,5455,371,471,842,"21 de agosto de 1994"
9,34,17,5456,625,705,1330,"21 de agosto de 1994"
9,34,17,5457,628,668,1296,"21 de agosto de 1994"
9,34,17,5458,228,261,489,"21 de agosto de 1994"
9,34,17,5459,291,352,643,"21 de agosto de 1994"
9,34,17,5460,540,560,1100,"21 de agosto de 1994"
9,34,17,5461,510,537,1047,"21 de agosto de 1994"
9,34,17,5462,393,461,854,"21 de agosto de 1994"
9,34,17,5463,397,462,859,"21 de agosto de 1994"
9,34,17,5464,564,688,1252,"21 de agosto de 1994"
9,34,17,5465,671,789,1460,"21 de agosto de 1994"
9,34,17,5466,418,519,937,"21 de agosto de 1994"
9,34,17,5467,359,399,758,"21 de agosto de 1994"
9,34,17,5468,453,553,1006,"21 de agosto de 1994"
9,34,17,5469,562,620,1182,"21 de agosto de 1994"
9,34,17,5470,615,657,1272,"21 de agosto de 1994"
9,34,17,5471,461,532,993,"21 de agosto de 1994"
9,34,17,5472,466,509,975,"21 de agosto de 1994"
9,34,17,5473,448,510,958,"21 de agosto de 1994"
9,34,17,5474,510,612,1122,"21 de agosto de 1994"
9,34,17,5475,510,557,1067,"21 de agosto de 1994"
9,34,17,5476,380,452,832,"21 de agosto de 1994"
9,34,17,5477,501,608,1109,"21 de agosto de 1994"
9,34,17,5478,640,715,1355,"21 de agosto de 1994"
9,34,17,5479,340,386,726,"21 de agosto de 1994"
9,34,17,5480,421,473,894,"21 de agosto de 1994"
9,34,17,5481,552,656,1208,"21 de agosto de 1994"
9,34,17,5482,458,503,961,"21 de agosto de 1994"
9,34,17,5483,376,387,763,"21 de agosto de 1994"
9,34,17,5484,607,675,1282,"21 de agosto de 1994"
9,34,17,5485,507,606,1113,"21 de agosto de 1994"
9,34,17,5486,445,531,976,"21 de agosto de 1994"
9,34,17,5487,515,590,1105,"21 de agosto de 1994"
9,34,17,5488,514,574,1088,"21 de agosto de 1994"
9,34,17,5489,621,642,1263,"21 de agosto de 1994"
9,34,17,5490,452,511,963,"21 de agosto de 1994"
9,34,17,5491,569,651,1220,"21 de agosto de 1994"
9,34,17,5492,528,628,1156,"21 de agosto de 1994"
9,34,17,5493,173,222,395,"21 de agosto de 1994"
9,34,17,5494,208,257,465,"21 de agosto de 1994"
9,34,17,5495,390,469,859,"21 de agosto de 1994"
9,34,17,5496,262,271,533,"21 de agosto de 1994"
9,34,17,5497,433,512,945,"21 de agosto de 1994"
9,34,17,5498,374,474,848,"21 de agosto de 1994"
9,34,17,5499,326,348,674,"21 de agosto de 1994"
9,34,17,5500,345,375,720,"21 de agosto de 1994"
9,34,17,5501,157,12,169,"21 de agosto de 1994"
9,34,17,5502,366,408,774,"21 de agosto de 1994"
9,34,17,5520,53,70,123,"21 de agosto de 1994"
9,34,17,5521,49,53,102,"21 de agosto de 1994"
9,34,17,5522,47,63,110,"21 de agosto de 1994"
9,34,17,5523,48,63,111,"21 de agosto de 1994"
9,34,17,5524,73,85,158,"21 de agosto de 1994"
9,34,17,5525,37,41,78,"21 de agosto de 1994"
9,34,17,5526,53,71,124,"21 de agosto de 1994"
9,34,17,5527,46,63,109,"21 de agosto de 1994"
9,35,6,1945,360,434,794,"21 de agosto de 1994"
9,35,6,1946,278,317,595,"21 de agosto de 1994"
9,35,6,1947,352,385,737,"21 de agosto de 1994"
9,35,6,1948,520,655,1175,"21 de agosto de 1994"
9,35,6,1949,223,289,512,"21 de agosto de 1994"
9,35,6,1950,483,561,1044,"21 de agosto de 1994"
9,35,6,1951,275,362,637,"21 de agosto de 1994"
9,35,6,1952,350,381,731,"21 de agosto de 1994"
9,35,6,1953,301,379,680,"21 de agosto de 1994"
9,35,6,1954,236,299,535,"21 de agosto de 1994"
9,35,6,1955,283,368,651,"21 de agosto de 1994"
9,35,6,1956,233,273,506,"21 de agosto de 1994"
9,35,6,1957,489,554,1043,"21 de agosto de 1994"
9,35,6,1958,347,405,752,"21 de agosto de 1994"
9,35,6,1959,444,542,986,"21 de agosto de 1994"
9,35,6,1960,683,777,1460,"21 de agosto de 1994"
9,35,6,1961,415,441,856,"21 de agosto de 1994"
9,35,6,1962,419,462,881,"21 de agosto de 1994"
9,35,6,1963,229,266,495,"21 de agosto de 1994"
9,35,6,1964,586,646,1232,"21 de agosto de 1994"
9,35,6,1965,279,278,557,"21 de agosto de 1994"
9,35,6,1966,252,308,560,"21 de agosto de 1994"
9,35,6,1967,496,553,1049,"21 de agosto de 1994"
9,35,6,1968,421,440,861,"21 de agosto de 1994"
9,35,6,1969,650,718,1368,"21 de agosto de 1994"
9,35,6,1970,390,467,857,"21 de agosto de 1994"
9,35,6,4430,0,0,0,"21 de agosto de 1994"
9,35,14,4430,596,710,1306,"21 de agosto de 1994"
9,35,14,4431,503,618,1121,"21 de agosto de 1994"
9,35,14,4432,577,745,1322,"21 de agosto de 1994"
9,35,14,4433,631,733,1364,"21 de agosto de 1994"
9,35,14,4434,627,783,1410,"21 de agosto de 1994"
9,35,14,4435,543,700,1243,"21 de agosto de 1994"
9,35,14,4436,564,710,1274,"21 de agosto de 1994"
9,35,14,4437,611,832,1443,"21 de agosto de 1994"
9,35,14,4438,345,449,794,"21 de agosto de 1994"
9,35,14,4439,514,646,1160,"21 de agosto de 1994"
9,35,14,4440,603,770,1373,"21 de agosto de 1994"
9,35,14,4441,543,677,1220,"21 de agosto de 1994"
9,35,14,4442,548,683,1231,"21 de agosto de 1994"
9,35,14,4443,523,707,1230,"21 de agosto de 1994"
9,35,14,4444,638,809,1447,"21 de agosto de 1994"
9,35,14,4445,326,415,741,"21 de agosto de 1994"
9,35,15,4891,566,644,1210,"21 de agosto de 1994"
9,35,15,4892,550,633,1183,"21 de agosto de 1994"
9,35,15,4893,693,744,1437,"21 de agosto de 1994"
9,35,15,4894,670,702,1372,"21 de agosto de 1994"
9,35,15,4895,560,603,1163,"21 de agosto de 1994"
9,35,15,4896,365,446,811,"21 de agosto de 1994"
9,35,15,4897,358,409,767,"21 de agosto de 1994"
9,35,15,4898,469,580,1049,"21 de agosto de 1994"
9,35,15,4899,525,678,1203,"21 de agosto de 1994"
9,35,15,4900,471,527,998,"21 de agosto de 1994"
9,35,15,4901,395,500,895,"21 de agosto de 1994"
9,35,15,4902,414,461,875,"21 de agosto de 1994"
9,35,15,4903,484,539,1023,"21 de agosto de 1994"
9,35,15,4904,483,608,1091,"21 de agosto de 1994"
9,35,15,4905,834,519,1353,"21 de agosto de 1994"
9,35,15,4906,501,593,1094,"21 de agosto de 1994"
9,35,15,4907,587,700,1287,"21 de agosto de 1994"
9,35,15,4908,527,635,1162,"21 de agosto de 1994"
9,35,15,4909,339,379,718,"21 de agosto de 1994"
9,35,15,4910,400,457,857,"21 de agosto de 1994"
9,35,15,4911,375,419,794,"21 de agosto de 1994"
9,35,17,5503,543,605,1148,"21 de agosto de 1994"
9,35,17,5504,369,473,842,"21 de agosto de 1994"
9,35,17,5505,425,451,876,"21 de agosto de 1994"
9,35,17,5506,658,700,1358,"21 de agosto de 1994"
9,35,17,5507,668,714,1382,"21 de agosto de 1994"
9,35,17,5508,652,711,1363,"21 de agosto de 1994"
9,35,17,5509,456,528,984,"21 de agosto de 1994"
9,35,17,5510,461,526,987,"21 de agosto de 1994"
9,35,17,5511,413,425,838,"21 de agosto de 1994"
9,36,3,693,113,123,236,"21 de agosto de 1994"
9,36,10,3403,337,403,740,"21 de agosto de 1994"
9,36,10,3404,430,449,879,"21 de agosto de 1994"
9,36,10,3405,368,426,794,"21 de agosto de 1994"
9,36,10,3406,345,415,760,"21 de agosto de 1994"
9,36,10,3407,440,510,950,"21 de agosto de 1994"
9,36,10,3408,247,320,567,"21 de agosto de 1994"
9,36,10,3409,467,610,1077,"21 de agosto de 1994"
9,36,10,3410,446,493,939,"21 de agosto de 1994"
9,36,10,3411,518,629,1147,"21 de agosto de 1994"
9,36,10,3412,429,471,900,"21 de agosto de 1994"
9,36,10,3413,386,494,880,"21 de agosto de 1994"
9,36,10,3414,400,470,870,"21 de agosto de 1994"
9,36,10,3415,408,496,904,"21 de agosto de 1994"
9,36,10,3416,582,696,1278,"21 de agosto de 1994"
9,36,10,3417,474,574,1048,"21 de agosto de 1994"
9,36,10,3418,713,805,1518,"21 de agosto de 1994"
9,36,10,3419,506,577,1083,"21 de agosto de 1994"
9,36,10,3420,316,428,744,"21 de agosto de 1994"
9,36,10,3421,553,664,1217,"21 de agosto de 1994"
9,36,10,3422,233,298,531,"21 de agosto de 1994"
9,36,10,3423,594,735,1329,"21 de agosto de 1994"
9,36,10,3424,309,390,699,"21 de agosto de 1994"
9,36,10,3425,416,475,891,"21 de agosto de 1994"
9,36,10,3426,355,420,775,"21 de agosto de 1994"
9,36,10,3427,306,388,694,"21 de agosto de 1994"
9,36,10,3428,375,534,909,"21 de agosto de 1994"
9,36,10,3429,246,332,578,"21 de agosto de 1994"
9,36,10,3430,326,485,811,"21 de agosto de 1994"
9,36,10,3431,346,489,835,"21 de agosto de 1994"
9,36,10,3432,151,209,360,"21 de agosto de 1994"
9,36,10,3433,300,411,711,"21 de agosto de 1994"
9,36,10,3434,257,322,579,"21 de agosto de 1994"
9,36,10,3435,141,188,329,"21 de agosto de 1994"
9,36,10,3436,349,467,816,"21 de agosto de 1994"
9,36,10,3437,293,350,643,"21 de agosto de 1994"
9,36,10,3438,386,463,849,"21 de agosto de 1994"
9,36,10,3439,306,419,725,"21 de agosto de 1994"
9,36,10,3440,480,623,1103,"21 de agosto de 1994"
9,36,10,3441,295,379,674,"21 de agosto de 1994"
9,36,10,3442,351,437,788,"21 de agosto de 1994"
9,36,10,3443,282,347,629,"21 de agosto de 1994"
9,36,10,3444,404,488,892,"21 de agosto de 1994"
9,36,10,3445,364,464,828,"21 de agosto de 1994"
9,36,10,3446,426,529,955,"21 de agosto de 1994"
9,36,10,3447,273,340,613,"21 de agosto de 1994"
9,36,10,3448,136,158,294,"21 de agosto de 1994"
9,36,10,3449,566,641,1207,"21 de agosto de 1994"
9,36,10,3450,398,456,854,"21 de agosto de 1994"
9,36,10,3451,436,553,989,"21 de agosto de 1994"
9,36,10,3452,584,728,1312,"21 de agosto de 1994"
9,36,10,3453,233,274,507,"21 de agosto de 1994"
9,36,10,3454,390,516,906,"21 de agosto de 1994"
9,36,10,3455,249,399,648,"21 de agosto de 1994"
9,36,10,3456,404,561,965,"21 de agosto de 1994"
9,36,10,3457,529,615,1144,"21 de agosto de 1994"
9,36,10,3458,413,511,924,"21 de agosto de 1994"
9,36,10,3459,328,404,732,"21 de agosto de 1994"
9,36,10,3460,253,383,636,"21 de agosto de 1994"
9,36,10,3461,238,337,575,"21 de agosto de 1994"
9,36,10,3462,312,461,773,"21 de agosto de 1994"
9,36,10,3463,508,678,1186,"21 de agosto de 1994"
9,36,10,3464,285,347,632,"21 de agosto de 1994"
9,36,10,3465,367,492,859,"21 de agosto de 1994"
9,36,10,3466,270,406,676,"21 de agosto de 1994"
9,36,10,3467,271,423,694,"21 de agosto de 1994"
9,36,10,3468,310,397,707,"21 de agosto de 1994"
9,36,10,3469,368,527,895,"21 de agosto de 1994"
9,36,10,3470,240,400,640,"21 de agosto de 1994"
9,36,10,3471,316,468,784,"21 de agosto de 1994"
9,36,10,3472,377,547,924,"21 de agosto de 1994"
9,36,10,3473,400,468,868,"21 de agosto de 1994"
9,36,10,3474,234,285,519,"21 de agosto de 1994"
9,36,10,3475,326,389,715,"21 de agosto de 1994"
9,36,10,3476,293,318,611,"21 de agosto de 1994"
9,36,10,3477,300,347,647,"21 de agosto de 1994"
9,36,14,4446,643,826,1469,"21 de agosto de 1994"
9,36,14,4447,313,424,737,"21 de agosto de 1994"
9,36,14,4448,562,742,1304,"21 de agosto de 1994"
9,36,14,4449,514,706,1220,"21 de agosto de 1994"
9,36,14,4450,308,485,793,"21 de agosto de 1994"
9,36,14,4451,285,383,668,"21 de agosto de 1994"
9,36,14,4452,556,765,1321,"21 de agosto de 1994"
9,36,14,4453,606,725,1331,"21 de agosto de 1994"
9,36,14,4454,564,724,1288,"21 de agosto de 1994"
9,36,14,4455,316,399,715,"21 de agosto de 1994"
9,36,14,4456,443,544,987,"21 de agosto de 1994"
9,36,14,4457,431,589,1020,"21 de agosto de 1994"
9,36,14,4458,382,527,909,"21 de agosto de 1994"
9,36,14,4459,263,425,688,"21 de agosto de 1994"
9,36,14,4460,455,681,1136,"21 de agosto de 1994"
9,36,14,4461,541,831,1372,"21 de agosto de 1994"
9,36,14,4462,422,628,1050,"21 de agosto de 1994"
9,36,14,4463,431,628,1059,"21 de agosto de 1994"
9,36,14,4464,461,731,1192,"21 de agosto de 1994"
9,36,14,4465,333,493,826,"21 de agosto de 1994"
9,36,14,4466,562,811,1373,"21 de agosto de 1994"
9,36,14,4467,231,342,573,"21 de agosto de 1994"
9,36,14,4468,435,594,1029,"21 de agosto de 1994"
9,36,14,4469,208,388,596,"21 de agosto de 1994"
9,36,14,4470,448,632,1080,"21 de agosto de 1994"
9,36,14,4471,608,802,1410,"21 de agosto de 1994"
9,36,14,4472,534,741,1275,"21 de agosto de 1994"
9,36,14,4473,473,613,1086,"21 de agosto de 1994"
9,36,14,4474,242,313,555,"21 de agosto de 1994"
9,36,14,4475,469,696,1165,"21 de agosto de 1994"
9,36,14,4476,393,571,964,"21 de agosto de 1994"
9,36,14,4477,426,551,977,"21 de agosto de 1994"
9,36,14,4478,311,459,770,"21 de agosto de 1994"
9,36,14,4479,319,413,732,"21 de agosto de 1994"
9,36,14,4480,250,404,654,"21 de agosto de 1994"
9,36,14,4481,237,356,593,"21 de agosto de 1994"
9,36,14,4664,0,0,0,"21 de agosto de 1994"
9,37,7,2386,553,629,1182,"21 de agosto de 1994"
9,37,7,2387,589,627,1216,"21 de agosto de 1994"
9,37,7,2388,381,442,823,"21 de agosto de 1994"
9,37,7,2389,512,542,1054,"21 de agosto de 1994"
9,37,7,2390,382,371,753,"21 de agosto de 1994"
9,37,7,2391,531,608,1139,"21 de agosto de 1994"
9,37,7,2392,577,630,1207,"21 de agosto de 1994"
9,37,7,2393,599,643,1242,"21 de agosto de 1994"
9,37,7,2394,435,423,858,"21 de agosto de 1994"
9,37,7,2395,374,332,706,"21 de agosto de 1994"
9,37,7,2396,567,531,1098,"21 de agosto de 1994"
9,37,7,2397,564,620,1184,"21 de agosto de 1994"
9,37,7,2398,569,610,1179,"21 de agosto de 1994"
9,37,7,2399,622,628,1250,"21 de agosto de 1994"
9,37,7,2400,625,684,1309,"21 de agosto de 1994"
9,37,7,2401,527,536,1063,"21 de agosto de 1994"
9,37,7,2402,525,560,1085,"21 de agosto de 1994"
9,37,7,2403,633,758,1391,"21 de agosto de 1994"
9,37,7,2404,566,662,1228,"21 de agosto de 1994"
9,37,7,2405,549,602,1151,"21 de agosto de 1994"
9,37,7,2406,692,741,1433,"21 de agosto de 1994"
9,37,7,2407,563,681,1244,"21 de agosto de 1994"
9,37,7,2408,578,664,1242,"21 de agosto de 1994"
9,37,7,2409,720,763,1483,"21 de agosto de 1994"
9,37,7,2410,512,567,1079,"21 de agosto de 1994"
9,37,7,2411,327,386,713,"21 de agosto de 1994"
9,37,7,2412,207,246,453,"21 de agosto de 1994"
9,37,7,2413,489,567,1056,"21 de agosto de 1994"
9,37,7,2414,285,303,588,"21 de agosto de 1994"
9,37,7,2415,390,428,818,"21 de agosto de 1994"
9,37,7,2416,336,435,771,"21 de agosto de 1994"
9,37,7,2417,312,382,694,"21 de agosto de 1994"
9,37,7,2418,345,400,745,"21 de agosto de 1994"
9,37,7,2419,335,393,728,"21 de agosto de 1994"
9,37,7,2420,492,550,1042,"21 de agosto de 1994"
9,37,7,2421,518,608,1126,"21 de agosto de 1994"
9,37,7,2422,299,382,681,"21 de agosto de 1994"
9,37,7,2423,317,372,689,"21 de agosto de 1994"
9,37,7,2424,473,553,1026,"21 de agosto de 1994"
9,37,7,2425,537,640,1177,"21 de agosto de 1994"
9,37,7,2426,400,458,858,"21 de agosto de 1994"
9,37,7,2427,340,415,755,"21 de agosto de 1994"
9,37,7,2428,263,353,616,"21 de agosto de 1994"
9,37,7,2429,459,519,978,"21 de agosto de 1994"
9,37,7,2430,568,610,1178,"21 de agosto de 1994"
9,37,7,2431,365,444,809,"21 de agosto de 1994"
9,37,7,2432,518,600,1118,"21 de agosto de 1994"
9,37,7,2433,598,674,1272,"21 de agosto de 1994"
9,37,7,2434,434,533,967,"21 de agosto de 1994"
9,37,7,2435,328,417,745,"21 de agosto de 1994"
9,37,7,2436,609,733,1342,"21 de agosto de 1994"
9,37,7,2437,541,564,1105,"21 de agosto de 1994"
9,37,7,2438,490,542,1032,"21 de agosto de 1994"
9,37,7,2439,534,579,1113,"21 de agosto de 1994"
9,37,7,2440,474,555,1029,"21 de agosto de 1994"
9,37,7,2441,388,447,835,"21 de agosto de 1994"
9,37,7,2442,416,505,921,"21 de agosto de 1994"
9,37,7,2443,348,453,801,"21 de agosto de 1994"
9,37,7,2444,366,453,819,"21 de agosto de 1994"
9,37,7,2445,585,697,1282,"21 de agosto de 1994"
9,37,7,2446,313,343,656,"21 de agosto de 1994"
9,37,7,2447,437,484,921,"21 de agosto de 1994"
9,37,7,2448,408,483,891,"21 de agosto de 1994"
9,37,7,2449,587,640,1227,"21 de agosto de 1994"
9,37,7,2450,449,547,996,"21 de agosto de 1994"
9,37,7,2451,564,612,1176,"21 de agosto de 1994"
9,37,7,2452,332,395,727,"21 de agosto de 1994"
9,37,7,2453,349,468,817,"21 de agosto de 1994"
9,37,7,2454,614,789,1403,"21 de agosto de 1994"
9,37,7,2455,234,287,521,"21 de agosto de 1994"
9,37,7,2456,333,451,784,"21 de agosto de 1994"
9,37,7,2457,412,495,907,"21 de agosto de 1994"
9,37,7,2458,430,518,948,"21 de agosto de 1994"
9,37,7,2459,443,529,972,"21 de agosto de 1994"
9,37,7,2460,451,490,941,"21 de agosto de 1994"
9,37,7,2461,489,557,1046,"21 de agosto de 1994"
9,37,7,2462,477,537,1014,"21 de agosto de 1994"
9,37,7,2463,431,499,930,"21 de agosto de 1994"
9,37,7,2464,450,568,1018,"21 de agosto de 1994"
9,37,7,2465,456,513,969,"21 de agosto de 1994"
9,37,7,2466,516,642,1158,"21 de agosto de 1994"
9,37,7,2467,451,533,984,"21 de agosto de 1994"
9,37,7,2468,419,558,977,"21 de agosto de 1994"
9,37,7,2469,456,546,1002,"21 de agosto de 1994"
9,37,7,2470,506,664,1170,"21 de agosto de 1994"
9,37,7,2471,241,296,537,"21 de agosto de 1994"
9,37,7,2472,342,438,780,"21 de agosto de 1994"
9,37,7,2473,421,549,970,"21 de agosto de 1994"
9,37,7,2474,332,404,736,"21 de agosto de 1994"
9,37,7,2475,328,474,802,"21 de agosto de 1994"
9,37,7,2476,484,588,1072,"21 de agosto de 1994"
9,37,7,2477,356,453,809,"21 de agosto de 1994"
9,37,7,2478,191,241,432,"21 de agosto de 1994"
9,37,7,2479,306,352,658,"21 de agosto de 1994"
9,37,7,2480,344,468,812,"21 de agosto de 1994"
9,37,7,2481,327,463,790,"21 de agosto de 1994"
9,37,7,2482,489,623,1112,"21 de agosto de 1994"
9,37,7,2483,498,585,1083,"21 de agosto de 1994"
9,37,7,2484,492,571,1063,"21 de agosto de 1994"
9,37,7,2485,517,577,1094,"21 de agosto de 1994"
9,37,7,2486,555,647,1202,"21 de agosto de 1994"
9,37,7,2487,459,533,992,"21 de agosto de 1994"
9,37,7,2488,413,518,931,"21 de agosto de 1994"
9,37,7,2489,486,675,1161,"21 de agosto de 1994"
9,37,7,2490,302,367,669,"21 de agosto de 1994"
9,37,7,2491,446,507,953,"21 de agosto de 1994"
9,37,7,2492,538,676,1214,"21 de agosto de 1994"
9,37,7,2493,462,549,1011,"21 de agosto de 1994"
9,37,7,2494,255,262,517,"21 de agosto de 1994"
9,37,7,2495,245,218,463,"21 de agosto de 1994"
9,37,7,2496,169,192,361,"21 de agosto de 1994"
9,37,7,2497,124,143,267,"21 de agosto de 1994"
9,37,7,2498,184,229,413,"21 de agosto de 1994"
9,37,7,2499,335,396,731,"21 de agosto de 1994"
9,37,7,2500,167,194,361,"21 de agosto de 1994"
9,37,14,4482,570,718,1288,"21 de agosto de 1994"
9,37,14,4483,405,551,956,"21 de agosto de 1994"
9,38,8,2972,411,539,950,"21 de agosto de 1994"
9,38,8,2973,457,591,1048,"21 de agosto de 1994"
9,38,8,2974,341,436,777,"21 de agosto de 1994"
9,38,8,2975,321,393,714,"21 de agosto de 1994"
9,38,8,2976,455,552,1007,"21 de agosto de 1994"
9,38,8,2977,311,427,738,"21 de agosto de 1994"
9,38,8,2978,434,545,979,"21 de agosto de 1994"
9,38,8,2979,427,550,977,"21 de agosto de 1994"
9,38,8,2980,258,329,587,"21 de agosto de 1994"
9,38,8,2981,377,535,912,"21 de agosto de 1994"
9,38,8,2982,404,564,968,"21 de agosto de 1994"
9,38,8,2983,366,493,859,"21 de agosto de 1994"
9,38,8,2984,420,454,874,"21 de agosto de 1994"
9,38,8,2985,392,451,843,"21 de agosto de 1994"
9,38,8,2986,427,465,892,"21 de agosto de 1994"
9,38,8,2987,298,335,633,"21 de agosto de 1994"
9,38,8,2988,452,455,907,"21 de agosto de 1994"
9,38,8,2989,420,458,878,"21 de agosto de 1994"
9,38,8,2990,371,419,790,"21 de agosto de 1994"
9,38,8,2991,447,478,925,"21 de agosto de 1994"
9,38,8,2992,439,456,895,"21 de agosto de 1994"
9,38,8,2993,501,504,1005,"21 de agosto de 1994"
9,38,8,2994,471,487,958,"21 de agosto de 1994"
9,38,8,2995,274,288,562,"21 de agosto de 1994"
9,38,8,2996,415,459,874,"21 de agosto de 1994"
9,38,8,2997,199,229,428,"21 de agosto de 1994"
9,38,8,2998,306,431,737,"21 de agosto de 1994"
9,38,8,2999,383,448,831,"21 de agosto de 1994"
9,38,8,3000,429,568,997,"21 de agosto de 1994"
9,38,8,3001,606,766,1372,"21 de agosto de 1994"
9,38,8,3002,383,467,850,"21 de agosto de 1994"
9,38,8,3003,202,299,501,"21 de agosto de 1994"
9,38,8,3004,577,673,1250,"21 de agosto de 1994"
9,38,8,3005,433,480,913,"21 de agosto de 1994"
9,38,8,3006,333,396,729,"21 de agosto de 1994"
9,38,8,3007,438,401,839,"21 de agosto de 1994"
9,38,8,3008,439,435,874,"21 de agosto de 1994"
9,38,8,3009,340,367,707,"21 de agosto de 1994"
9,38,8,3010,234,275,509,"21 de agosto de 1994"
9,38,8,3011,429,488,917,"21 de agosto de 1994"
9,38,8,3012,392,434,826,"21 de agosto de 1994"
9,38,8,3013,715,745,1460,"21 de agosto de 1994"
9,38,8,3014,568,603,1171,"21 de agosto de 1994"
9,38,8,3015,387,397,784,"21 de agosto de 1994"
9,38,8,3016,454,467,921,"21 de agosto de 1994"
9,38,8,3017,518,542,1060,"21 de agosto de 1994"
9,38,8,3018,381,406,787,"21 de agosto de 1994"
9,38,8,3019,524,565,1089,"21 de agosto de 1994"
9,38,8,3020,202,238,440,"21 de agosto de 1994"
9,38,8,3021,251,275,526,"21 de agosto de 1994"
9,38,8,3022,84,100,184,"21 de agosto de 1994"
9,38,8,3023,611,676,1287,"21 de agosto de 1994"
9,38,8,3024,267,329,596,"21 de agosto de 1994"
9,38,8,3025,630,750,1380,"21 de agosto de 1994"
9,38,8,3026,393,468,861,"21 de agosto de 1994"
9,38,8,3027,315,388,703,"21 de agosto de 1994"
9,38,8,3028,455,523,978,"21 de agosto de 1994"
9,38,8,3029,508,581,1089,"21 de agosto de 1994"
9,38,8,3030,561,616,1177,"21 de agosto de 1994"
9,38,8,3031,520,625,1145,"21 de agosto de 1994"
9,38,8,3032,611,645,1256,"21 de agosto de 1994"
9,38,8,3033,413,518,931,"21 de agosto de 1994"
9,38,8,3034,497,549,1046,"21 de agosto de 1994"
9,38,8,3035,666,740,1406,"21 de agosto de 1994"
9,38,8,3036,296,293,589,"21 de agosto de 1994"
9,38,8,3037,266,282,548,"21 de agosto de 1994"
9,38,8,3038,324,364,688,"21 de agosto de 1994"
9,38,8,3039,592,625,1217,"21 de agosto de 1994"
9,38,8,3040,679,725,1404,"21 de agosto de 1994"
9,38,8,3041,322,363,685,"21 de agosto de 1994"
9,38,8,3042,342,368,710,"21 de agosto de 1994"
9,38,8,3043,281,330,611,"21 de agosto de 1994"
9,38,8,3044,305,364,669,"21 de agosto de 1994"
9,38,8,3045,416,466,882,"21 de agosto de 1994"
9,38,8,3046,588,693,1281,"21 de agosto de 1994"
9,38,8,3047,533,574,1107,"21 de agosto de 1994"
9,38,8,3048,375,454,829,"21 de agosto de 1994"
9,38,8,3049,426,464,890,"21 de agosto de 1994"
9,38,8,3050,507,561,1068,"21 de agosto de 1994"
9,38,8,3051,434,473,907,"21 de agosto de 1994"
9,38,8,3052,465,500,965,"21 de agosto de 1994"
9,38,8,3053,482,563,1045,"21 de agosto de 1994"
9,38,8,3054,278,361,639,"21 de agosto de 1994"
9,38,8,3055,280,494,774,"21 de agosto de 1994"
9,38,8,3056,448,520,968,"21 de agosto de 1994"
9,38,8,3057,205,289,494,"21 de agosto de 1994"
9,38,8,3058,509,628,1137,"21 de agosto de 1994"
9,38,8,3059,553,635,1188,"21 de agosto de 1994"
9,38,8,3060,586,659,1245,"21 de agosto de 1994"
9,38,8,3061,619,689,1308,"21 de agosto de 1994"
9,38,8,3062,606,698,1304,"21 de agosto de 1994"
9,38,8,3063,407,475,882,"21 de agosto de 1994"
9,38,8,3064,451,489,940,"21 de agosto de 1994"
9,38,8,3065,336,349,685,"21 de agosto de 1994"
9,38,8,3066,616,688,1304,"21 de agosto de 1994"
9,38,8,3067,513,534,1047,"21 de agosto de 1994"
9,38,8,3068,460,524,984,"21 de agosto de 1994"
9,38,8,3069,366,425,791,"21 de agosto de 1994"
9,38,8,3070,420,467,887,"21 de agosto de 1994"
9,38,8,3071,734,773,1507,"21 de agosto de 1994"
9,38,8,3072,248,280,528,"21 de agosto de 1994"
9,38,8,3073,325,366,691,"21 de agosto de 1994"
9,38,8,3074,464,505,969,"21 de agosto de 1994"
9,38,8,3075,244,239,483,"21 de agosto de 1994"
9,38,8,3076,404,454,858,"21 de agosto de 1994"
9,38,8,3077,604,672,1276,"21 de agosto de 1994"
9,38,8,3078,503,565,1068,"21 de agosto de 1994"
9,38,8,3079,461,499,960,"21 de agosto de 1994"
9,38,8,3080,337,350,687,"21 de agosto de 1994"
9,38,8,3081,439,479,918,"21 de agosto de 1994"
9,38,8,3082,336,351,687,"21 de agosto de 1994"
9,38,8,3083,474,558,1032,"21 de agosto de 1994"
9,38,8,3084,290,328,618,"21 de agosto de 1994"
9,38,8,3085,374,412,786,"21 de agosto de 1994"
9,38,8,3086,462,498,960,"21 de agosto de 1994"
9,38,8,3087,552,586,1138,"21 de agosto de 1994"
9,38,8,3088,436,452,888,"21 de agosto de 1994"
9,38,8,3089,401,422,823,"21 de agosto de 1994"
9,38,8,3090,503,531,1034,"21 de agosto de 1994"
9,38,8,3091,617,725,1342,"21 de agosto de 1994"
9,38,8,3092,477,518,995,"21 de agosto de 1994"
9,38,8,3093,491,553,1044,"21 de agosto de 1994"
9,38,8,3094,251,260,511,"21 de agosto de 1994"
9,38,8,3095,243,260,503,"21 de agosto de 1994"
9,38,8,3096,426,450,876,"21 de agosto de 1994"
9,38,8,3097,395,432,827,"21 de agosto de 1994"
9,38,8,3098,129,141,270,"21 de agosto de 1994"
9,38,8,3099,205,248,453,"21 de agosto de 1994"
9,38,8,3100,272,301,573,"21 de agosto de 1994"
9,38,8,3101,281,367,648,"21 de agosto de 1994"
9,38,8,3102,257,244,501,"21 de agosto de 1994"
9,38,8,3103,317,350,667,"21 de agosto de 1994"
9,38,8,3104,319,321,640,"21 de agosto de 1994"
9,38,8,3105,554,626,1180,"21 de agosto de 1994"
9,38,8,3106,369,378,747,"21 de agosto de 1994"
9,38,8,3107,72,79,151,"21 de agosto de 1994"
9,38,8,3108,178,201,379,"21 de agosto de 1994"
9,38,8,3109,304,325,629,"21 de agosto de 1994"
9,38,8,3110,264,283,547,"21 de agosto de 1994"
9,38,8,3111,393,411,804,"21 de agosto de 1994"
9,38,8,3112,335,377,712,"21 de agosto de 1994"
9,38,8,3113,281,292,573,"21 de agosto de 1994"
9,38,8,3114,357,413,770,"21 de agosto de 1994"
9,38,8,3115,304,335,639,"21 de agosto de 1994"
9,38,8,3116,293,322,615,"21 de agosto de 1994"
9,38,8,3117,448,494,942,"21 de agosto de 1994"
9,38,8,3118,345,382,727,"21 de agosto de 1994"
9,38,10,3478,478,559,1037,"21 de agosto de 1994"
9,38,10,3479,436,462,898,"21 de agosto de 1994"
9,38,10,3480,608,708,1316,"21 de agosto de 1994"
9,38,10,3481,246,327,573,"21 de agosto de 1994"
9,38,10,3482,415,519,934,"21 de agosto de 1994"
9,38,10,3483,312,379,691,"21 de agosto de 1994"
9,38,10,3484,510,636,1146,"21 de agosto de 1994"
9,38,10,3485,14,10,24,"21 de agosto de 1994"
9,38,10,3486,704,768,1472,"21 de agosto de 1994"
9,38,10,3487,351,548,899,"21 de agosto de 1994"
9,38,10,3488,359,484,843,"21 de agosto de 1994"
9,38,10,3489,427,578,1005,"21 de agosto de 1994"
9,38,10,3490,632,723,1355,"21 de agosto de 1994"
9,38,10,3491,416,505,921,"21 de agosto de 1994"
9,38,10,3492,111,131,242,"21 de agosto de 1994"
9,38,10,3493,270,339,609,"21 de agosto de 1994"
9,38,10,3494,456,488,944,"21 de agosto de 1994"
9,38,10,3495,324,355,679,"21 de agosto de 1994"
9,38,10,3496,320,336,656,"21 de agosto de 1994"
9,38,10,3497,407,472,879,"21 de agosto de 1994"
9,38,10,3498,511,601,1112,"21 de agosto de 1994"
9,38,10,3499,521,574,1095,"21 de agosto de 1994"
9,38,10,3500,502,601,1103,"21 de agosto de 1994"
9,38,10,3501,518,654,1172,"21 de agosto de 1994"
9,38,10,3502,273,356,629,"21 de agosto de 1994"
9,38,10,3503,391,500,891,"21 de agosto de 1994"
9,38,10,3504,392,503,895,"21 de agosto de 1994"
9,38,10,3505,419,566,985,"21 de agosto de 1994"
9,38,10,3506,425,507,932,"21 de agosto de 1994"
9,38,10,3507,609,630,1239,"21 de agosto de 1994"
9,38,10,3508,518,614,1132,"21 de agosto de 1994"
9,38,10,3509,339,362,701,"21 de agosto de 1994"
9,38,10,3510,578,643,1221,"21 de agosto de 1994"
9,38,10,3511,405,498,903,"21 de agosto de 1994"
9,38,10,3512,301,330,631,"21 de agosto de 1994"
9,38,10,3513,758,802,1560,"21 de agosto de 1994"
9,38,10,3514,526,608,1134,"21 de agosto de 1994"
9,38,10,3515,193,204,397,"21 de agosto de 1994"
9,38,10,3516,315,391,706,"21 de agosto de 1994"
9,38,10,3517,363,421,784,"21 de agosto de 1994"
9,38,10,3518,404,435,839,"21 de agosto de 1994"
9,38,10,3519,505,578,1083,"21 de agosto de 1994"
9,38,10,3520,520,552,1072,"21 de agosto de 1994"
9,38,10,3521,380,400,780,"21 de agosto de 1994"
9,38,10,3522,430,458,888,"21 de agosto de 1994"
9,38,10,3523,368,432,800,"21 de agosto de 1994"
9,38,10,3524,356,404,760,"21 de agosto de 1994"
9,38,10,3525,489,536,1025,"21 de agosto de 1994"
9,38,10,3526,506,551,1057,"21 de agosto de 1994"
9,38,10,3527,345,454,799,"21 de agosto de 1994"
9,38,10,3528,418,528,946,"21 de agosto de 1994"
9,38,10,3529,477,587,1064,"21 de agosto de 1994"
9,38,10,3530,347,394,741,"21 de agosto de 1994"
9,38,10,3531,124,137,261,"21 de agosto de 1994"
9,38,10,3532,508,566,1074,"21 de agosto de 1994"
9,38,10,3533,445,528,973,"21 de agosto de 1994"
9,38,10,3534,329,399,728,"21 de agosto de 1994"
9,38,10,3535,371,404,775,"21 de agosto de 1994"
9,38,10,3536,396,452,848,"21 de agosto de 1994"
9,38,10,3537,334,414,748,"21 de agosto de 1994"
9,38,10,3538,285,338,623,"21 de agosto de 1994"
9,38,10,3539,328,346,674,"21 de agosto de 1994"
9,38,10,3540,605,673,1278,"21 de agosto de 1994"
9,38,10,3541,383,433,816,"21 de agosto de 1994"
9,38,10,3542,587,637,1224,"21 de agosto de 1994"
9,38,10,3543,496,596,1092,"21 de agosto de 1994"
9,38,10,3544,345,377,722,"21 de agosto de 1994"
9,38,10,3545,437,513,950,"21 de agosto de 1994"
9,38,10,3546,295,343,638,"21 de agosto de 1994"
9,38,10,3547,566,666,1232,"21 de agosto de 1994"
9,38,10,3548,300,365,665,"21 de agosto de 1994"
9,38,10,3549,468,583,1051,"21 de agosto de 1994"
9,38,10,3550,557,639,1196,"21 de agosto de 1994"
9,38,10,3551,353,412,765,"21 de agosto de 1994"
9,38,10,3552,412,469,881,"21 de agosto de 1994"
9,38,10,3553,451,566,1017,"21 de agosto de 1994"
9,38,10,3554,591,690,1281,"21 de agosto de 1994"
9,38,10,3555,257,288,545,"21 de agosto de 1994"
9,38,10,3556,706,829,1535,"21 de agosto de 1994"
9,38,10,3557,456,600,1056,"21 de agosto de 1994"
9,38,10,3558,426,467,893,"21 de agosto de 1994"
9,38,10,3559,374,425,799,"21 de agosto de 1994"
9,38,10,3560,540,586,1126,"21 de agosto de 1994"
9,38,10,3561,691,754,1445,"21 de agosto de 1994"
9,38,10,3562,313,405,718,"21 de agosto de 1994"
9,38,10,3563,390,445,835,"21 de agosto de 1994"
9,38,10,3564,476,513,989,"21 de agosto de 1994"
9,38,10,3565,290,333,623,"21 de agosto de 1994"
9,38,10,3566,477,493,970,"21 de agosto de 1994"
9,38,10,3567,279,314,593,"21 de agosto de 1994"
9,38,10,3568,618,725,1343,"21 de agosto de 1994"
9,38,10,3569,179,201,380,"21 de agosto de 1994"
9,38,10,3570,304,333,637,"21 de agosto de 1994"
9,38,10,3571,321,370,691,"21 de agosto de 1994"
9,38,10,3572,163,169,332,"21 de agosto de 1994"
9,38,10,3573,294,385,679,"21 de agosto de 1994"
9,38,10,3574,343,377,720,"21 de agosto de 1994"
9,38,10,3575,395,489,884,"21 de agosto de 1994"
9,38,10,3576,217,279,496,"21 de agosto de 1994"
9,38,10,3577,397,448,845,"21 de agosto de 1994"
9,38,10,3578,627,738,1365,"21 de agosto de 1994"
9,38,10,3579,364,377,741,"21 de agosto de 1994"
9,38,10,3580,399,417,816,"21 de agosto de 1994"
9,38,10,3581,560,620,1180,"21 de agosto de 1994"
9,38,10,3582,466,548,1014,"21 de agosto de 1994"
9,38,10,3583,599,673,1272,"21 de agosto de 1994"
9,38,10,3584,713,724,1437,"21 de agosto de 1994"
9,38,10,3585,439,475,914,"21 de agosto de 1994"
9,38,10,3586,483,536,1019,"21 de agosto de 1994"
9,38,10,3587,525,606,1131,"21 de agosto de 1994"
9,38,10,3588,437,460,897,"21 de agosto de 1994"
9,38,10,3589,464,555,1019,"21 de agosto de 1994"
9,38,10,3590,483,524,1007,"21 de agosto de 1994"
9,38,10,3591,497,497,994,"21 de agosto de 1994"
9,38,10,3592,514,525,1039,"21 de agosto de 1994"
9,38,10,3593,482,529,1011,"21 de agosto de 1994"
9,38,10,3594,332,364,696,"21 de agosto de 1994"
9,38,10,3595,549,569,1118,"21 de agosto de 1994"
9,38,10,3596,598,655,1253,"21 de agosto de 1994"
9,38,10,3597,474,529,1003,"21 de agosto de 1994"
9,38,10,3598,498,532,1030,"21 de agosto de 1994"
9,38,10,3599,404,450,854,"21 de agosto de 1994"
9,38,10,3600,559,659,1218,"21 de agosto de 1994"
9,38,10,3601,376,401,777,"21 de agosto de 1994"
9,38,10,3602,291,335,626,"21 de agosto de 1994"
9,38,10,3603,101,117,218,"21 de agosto de 1994"
9,38,10,3604,375,392,767,"21 de agosto de 1994"
9,38,10,3605,548,569,1117,"21 de agosto de 1994"
9,38,10,3606,390,408,798,"21 de agosto de 1994"
9,38,10,3607,183,206,389,"21 de agosto de 1994"
9,38,10,3608,129,154,283,"21 de agosto de 1994"
9,39,3,694,692,888,1580,"21 de agosto de 1994"
9,39,3,695,498,687,1185,"21 de agosto de 1994"
9,39,3,696,619,790,1409,"21 de agosto de 1994"
9,39,3,697,449,532,981,"21 de agosto de 1994"
9,39,3,698,483,628,1111,"21 de agosto de 1994"
9,39,3,699,532,643,1175,"21 de agosto de 1994"
9,39,3,700,533,634,1167,"21 de agosto de 1994"
9,39,3,701,360,430,790,"21 de agosto de 1994"
9,39,3,702,494,706,1200,"21 de agosto de 1994"
9,39,3,703,188,237,425,"21 de agosto de 1994"
9,39,3,704,468,831,1299,"21 de agosto de 1994"
9,39,3,705,514,647,1161,"21 de agosto de 1994"
9,39,3,706,420,644,1064,"21 de agosto de 1994"
9,39,3,707,644,877,1521,"21 de agosto de 1994"
9,39,3,708,567,715,1282,"21 de agosto de 1994"
9,39,3,709,583,802,1385,"21 de agosto de 1994"
9,39,3,710,439,529,968,"21 de agosto de 1994"
9,39,3,711,294,352,646,"21 de agosto de 1994"
9,39,3,712,599,810,1409,"21 de agosto de 1994"
9,39,3,713,623,885,1508,"21 de agosto de 1994"
9,39,3,714,493,624,1117,"21 de agosto de 1994"
9,39,3,715,388,455,843,"21 de agosto de 1994"
9,39,3,716,281,364,645,"21 de agosto de 1994"
9,39,3,717,461,611,1072,"21 de agosto de 1994"
9,39,3,718,584,827,1411,"21 de agosto de 1994"
9,39,3,719,464,570,1034,"21 de agosto de 1994"
9,39,3,720,255,305,560,"21 de agosto de 1994"
9,39,3,721,622,764,1386,"21 de agosto de 1994"
9,39,3,722,395,450,845,"21 de agosto de 1994"
9,39,3,723,549,756,1305,"21 de agosto de 1994"
9,39,3,724,531,829,1360,"21 de agosto de 1994"
9,39,3,725,439,613,1052,"21 de agosto de 1994"
9,39,3,726,596,745,1341,"21 de agosto de 1994"
9,39,3,727,614,783,1397,"21 de agosto de 1994"
9,39,3,728,266,309,575,"21 de agosto de 1994"
9,39,3,729,300,370,670,"21 de agosto de 1994"
9,39,3,730,258,341,599,"21 de agosto de 1994"
9,39,3,731,473,643,1116,"21 de agosto de 1994"
9,39,3,732,446,584,1030,"21 de agosto de 1994"
9,39,3,733,468,559,1027,"21 de agosto de 1994"
9,39,3,734,488,674,1162,"21 de agosto de 1994"
9,39,3,735,491,653,1144,"21 de agosto de 1994"
9,39,3,736,278,395,673,"21 de agosto de 1994"
9,39,3,737,644,867,1511,"21 de agosto de 1994"
9,39,3,738,440,581,1021,"21 de agosto de 1994"
9,39,3,739,278,387,665,"21 de agosto de 1994"
9,39,3,740,277,385,662,"21 de agosto de 1994"
9,39,3,741,347,501,848,"21 de agosto de 1994"
9,39,3,742,300,375,675,"21 de agosto de 1994"
9,39,3,743,287,358,645,"21 de agosto de 1994"
9,39,3,744,298,405,703,"21 de agosto de 1994"
9,39,3,745,418,537,955,"21 de agosto de 1994"
9,39,3,746,550,707,1257,"21 de agosto de 1994"
9,39,3,5515,69,61,130,"21 de agosto de 1994"
9,39,14,4399,0,0,0,"21 de agosto de 1994"
9,39,14,4453,0,0,0,"21 de agosto de 1994"
9,39,14,4484,690,809,1499,"21 de agosto de 1994"
9,39,14,4485,519,584,1103,"21 de agosto de 1994"
9,39,14,4486,580,688,1268,"21 de agosto de 1994"
9,39,14,4487,561,682,1243,"21 de agosto de 1994"
9,39,14,4488,529,685,1214,"21 de agosto de 1994"
9,39,14,4489,589,800,1389,"21 de agosto de 1994"
9,39,14,4490,475,636,1111,"21 de agosto de 1994"
9,39,14,4491,524,640,1164,"21 de agosto de 1994"
9,39,14,4492,639,733,1372,"21 de agosto de 1994"
9,39,14,4493,572,710,1282,"21 de agosto de 1994"
9,39,14,4494,341,457,798,"21 de agosto de 1994"
9,39,14,4495,454,616,1070,"21 de agosto de 1994"
9,39,14,4496,363,454,817,"21 de agosto de 1994"
9,39,14,4497,223,322,545,"21 de agosto de 1994"
9,39,14,4498,460,600,1060,"21 de agosto de 1994"
9,39,14,4499,415,504,919,"21 de agosto de 1994"
9,39,14,4500,489,605,1094,"21 de agosto de 1994"
9,39,14,4501,503,675,1178,"21 de agosto de 1994"
9,39,14,4502,602,757,1359,"21 de agosto de 1994"
9,39,14,4503,670,786,1456,"21 de agosto de 1994"
9,39,14,4504,517,696,1213,"21 de agosto de 1994"
9,39,14,4505,543,634,1177,"21 de agosto de 1994"
9,39,14,4506,396,470,866,"21 de agosto de 1994"
9,39,14,4507,688,947,1635,"21 de agosto de 1994"
9,39,14,4508,608,791,1399,"21 de agosto de 1994"
9,39,14,4509,287,360,647,"21 de agosto de 1994"
9,39,14,4510,533,640,1173,"21 de agosto de 1994"
9,39,14,4511,596,772,1368,"21 de agosto de 1994"
9,39,14,4512,556,728,1284,"21 de agosto de 1994"
9,39,14,4513,402,533,935,"21 de agosto de 1994"
9,39,14,4514,559,728,1287,"21 de agosto de 1994"
9,39,14,4515,386,470,856,"21 de agosto de 1994"
9,39,14,4516,427,512,939,"21 de agosto de 1994"
9,39,14,4517,198,249,447,"21 de agosto de 1994"
9,39,14,4518,315,369,684,"21 de agosto de 1994"
9,39,14,4519,616,847,1463,"21 de agosto de 1994"
9,39,14,4520,309,415,724,"21 de agosto de 1994"
9,39,14,4521,350,438,788,"21 de agosto de 1994"
9,39,14,4522,322,480,802,"21 de agosto de 1994"
9,39,14,4694,0,0,0,"21 de agosto de 1994"
9,40,7,1971,0,0,0,"21 de agosto de 1994"
9,40,7,2501,562,644,1206,"21 de agosto de 1994"
9,40,7,2502,496,526,1022,"21 de agosto de 1994"
9,40,7,2503,217,231,448,"21 de agosto de 1994"
9,40,7,2504,539,576,1115,"21 de agosto de 1994"
9,40,7,2505,626,669,1295,"21 de agosto de 1994"
9,40,7,2506,403,445,848,"21 de agosto de 1994"
9,40,7,2507,484,494,978,"21 de agosto de 1994"
9,40,7,2508,195,257,452,"21 de agosto de 1994"
9,40,7,2509,381,455,836,"21 de agosto de 1994"
9,40,7,2510,406,517,923,"21 de agosto de 1994"
9,40,7,2511,550,588,1138,"21 de agosto de 1994"
9,40,7,2512,569,619,1188,"21 de agosto de 1994"
9,40,7,2513,403,436,839,"21 de agosto de 1994"
9,40,7,2514,664,710,1374,"21 de agosto de 1994"
9,40,7,2515,355,363,718,"21 de agosto de 1994"
9,40,7,2516,527,603,1130,"21 de agosto de 1994"
9,40,7,2517,268,323,591,"21 de agosto de 1994"
9,40,7,2518,457,513,970,"21 de agosto de 1994"
9,40,7,2519,580,614,1194,"21 de agosto de 1994"
9,40,7,2520,377,397,774,"21 de agosto de 1994"
9,40,7,2521,469,511,980,"21 de agosto de 1994"
9,40,7,2522,388,440,828,"21 de agosto de 1994"
9,40,7,2523,372,418,790,"21 de agosto de 1994"
9,40,7,2524,286,342,628,"21 de agosto de 1994"
9,40,7,2525,363,410,773,"21 de agosto de 1994"
9,40,7,2526,459,506,965,"21 de agosto de 1994"
9,40,7,2527,345,363,708,"21 de agosto de 1994"
9,40,7,2528,422,490,912,"21 de agosto de 1994"
9,40,7,2529,434,488,922,"21 de agosto de 1994"
9,40,7,2530,547,578,1125,"21 de agosto de 1994"
9,40,7,2531,547,566,1113,"21 de agosto de 1994"
9,40,7,2532,403,427,830,"21 de agosto de 1994"
9,40,7,2533,460,493,953,"21 de agosto de 1994"
9,40,7,2534,450,455,905,"21 de agosto de 1994"
9,40,7,2535,528,525,1053,"21 de agosto de 1994"
9,40,7,2536,497,555,1052,"21 de agosto de 1994"
9,40,7,2537,505,531,1036,"21 de agosto de 1994"
9,40,7,2538,450,474,924,"21 de agosto de 1994"
9,40,7,2539,552,589,1141,"21 de agosto de 1994"
9,40,7,2540,359,390,749,"21 de agosto de 1994"
9,40,7,2541,429,451,880,"21 de agosto de 1994"
9,40,7,2542,239,248,487,"21 de agosto de 1994"
9,40,7,2543,294,316,610,"21 de agosto de 1994"
9,40,7,2544,579,601,1180,"21 de agosto de 1994"
9,40,7,2545,416,489,905,"21 de agosto de 1994"
9,40,7,2546,241,280,521,"21 de agosto de 1994"
9,40,7,2547,477,487,964,"21 de agosto de 1994"
9,40,7,2548,570,614,1184,"21 de agosto de 1994"
9,40,7,2549,485,543,1028,"21 de agosto de 1994"
9,40,7,2550,398,408,806,"21 de agosto de 1994"
9,40,7,2551,495,528,1023,"21 de agosto de 1994"
9,40,7,2552,400,473,873,"21 de agosto de 1994"
9,40,7,2553,401,461,862,"21 de agosto de 1994"
9,40,7,2554,480,524,1004,"21 de agosto de 1994"
9,40,7,2555,373,398,771,"21 de agosto de 1994"
9,40,7,2556,425,456,881,"21 de agosto de 1994"
9,40,7,2557,386,452,838,"21 de agosto de 1994"
9,40,7,2558,415,474,889,"21 de agosto de 1994"
9,40,7,2559,473,502,975,"21 de agosto de 1994"
9,40,7,2560,419,463,882,"21 de agosto de 1994"
9,40,7,2561,447,461,908,"21 de agosto de 1994"
9,40,7,2562,537,594,1131,"21 de agosto de 1994"
9,40,7,2563,467,547,1014,"21 de agosto de 1994"
9,40,7,2564,420,463,883,"21 de agosto de 1994"
9,40,7,2565,434,469,903,"21 de agosto de 1994"
9,40,7,2566,502,542,1044,"21 de agosto de 1994"
9,40,7,2567,547,552,1099,"21 de agosto de 1994"
9,40,7,2568,478,517,995,"21 de agosto de 1994"
9,40,7,2569,373,426,799,"21 de agosto de 1994"
9,40,7,2570,642,655,1297,"21 de agosto de 1994"
9,40,7,2571,636,706,1342,"21 de agosto de 1994"
9,40,7,2572,521,597,1118,"21 de agosto de 1994"
9,40,7,2573,451,521,972,"21 de agosto de 1994"
9,40,7,2574,529,584,1113,"21 de agosto de 1994"
9,40,7,2575,553,619,1172,"21 de agosto de 1994"
9,40,7,2576,427,438,865,"21 de agosto de 1994"
9,40,7,2577,514,554,1068,"21 de agosto de 1994"
9,40,7,2578,490,530,1020,"21 de agosto de 1994"
9,40,7,2579,327,384,711,"21 de agosto de 1994"
9,40,7,2580,560,621,1181,"21 de agosto de 1994"
9,40,7,2581,505,513,1018,"21 de agosto de 1994"
9,40,7,2582,386,429,815,"21 de agosto de 1994"
9,40,7,2583,467,477,944,"21 de agosto de 1994"
9,40,7,2584,428,459,887,"21 de agosto de 1994"
9,40,7,2585,389,425,814,"21 de agosto de 1994"
9,40,7,2586,756,818,1574,"21 de agosto de 1994"
9,40,7,2587,616,677,1293,"21 de agosto de 1994"
9,40,7,2588,557,609,1166,"21 de agosto de 1994"
9,40,7,2589,444,485,929,"21 de agosto de 1994"
9,40,7,2590,487,506,993,"21 de agosto de 1994"
9,40,7,2591,443,455,898,"21 de agosto de 1994"
9,40,7,2592,335,355,690,"21 de agosto de 1994"
9,40,7,2593,372,372,744,"21 de agosto de 1994"
9,40,7,2594,470,490,960,"21 de agosto de 1994"
9,40,7,2595,473,496,969,"21 de agosto de 1994"
9,40,7,2596,485,559,1044,"21 de agosto de 1994"
9,40,7,2597,505,517,1022,"21 de agosto de 1994"
9,40,7,2598,422,442,864,"21 de agosto de 1994"
9,40,7,2599,426,490,916,"21 de agosto de 1994"
9,40,7,2600,455,504,959,"21 de agosto de 1994"
9,40,7,2601,532,547,1079,"21 de agosto de 1994"
9,40,7,2602,400,439,839,"21 de agosto de 1994"
9,40,7,2603,371,391,762,"21 de agosto de 1994"
9,40,7,2604,478,505,983,"21 de agosto de 1994"
9,40,7,2605,400,422,822,"21 de agosto de 1994"
9,40,7,2606,346,390,736,"21 de agosto de 1994"
9,40,7,2607,383,418,801,"21 de agosto de 1994"
9,40,7,2608,568,593,1161,"21 de agosto de 1994"
9,40,7,2609,406,427,833,"21 de agosto de 1994"
9,40,7,2610,486,524,1010,"21 de agosto de 1994"
9,40,7,2611,497,506,1003,"21 de agosto de 1994"
9,40,7,2612,536,598,1134,"21 de agosto de 1994"
9,40,7,2613,519,584,1103,"21 de agosto de 1994"
9,40,7,2614,449,489,938,"21 de agosto de 1994"
9,40,7,2615,460,531,991,"21 de agosto de 1994"
9,40,7,2616,383,454,837,"21 de agosto de 1994"
9,40,7,2617,618,682,1300,"21 de agosto de 1994"
9,40,7,2618,450,471,921,"21 de agosto de 1994"
9,40,7,2619,539,559,1098,"21 de agosto de 1994"
9,40,7,2620,486,504,990,"21 de agosto de 1994"
9,40,7,2621,488,494,982,"21 de agosto de 1994"
9,40,7,2622,380,392,772,"21 de agosto de 1994"
9,40,7,2623,425,473,898,"21 de agosto de 1994"
9,40,7,2624,374,416,790,"21 de agosto de 1994"
9,40,7,2625,455,472,927,"21 de agosto de 1994"
9,40,7,2626,491,509,1000,"21 de agosto de 1994"
9,40,7,2627,417,486,903,"21 de agosto de 1994"
9,40,7,2628,481,542,1023,"21 de agosto de 1994"
9,40,7,2629,630,726,1356,"21 de agosto de 1994"
9,40,7,2630,521,548,1069,"21 de agosto de 1994"
9,40,7,2631,469,550,1019,"21 de agosto de 1994"
9,40,7,2632,481,538,1019,"21 de agosto de 1994"
9,40,7,2633,408,466,874,"21 de agosto de 1994"
9,40,7,2634,321,335,656,"21 de agosto de 1994"
9,40,7,2635,403,381,784,"21 de agosto de 1994"
9,40,7,2636,434,496,930,"21 de agosto de 1994"
9,40,7,2637,482,476,958,"21 de agosto de 1994"
9,40,7,2638,392,439,831,"21 de agosto de 1994"
9,40,7,2639,295,387,682,"21 de agosto de 1994"
9,40,7,2640,517,617,1134,"21 de agosto de 1994"
9,40,7,2641,455,547,1002,"21 de agosto de 1994"
9,40,7,2642,244,288,532,"21 de agosto de 1994"
9,40,7,2643,454,493,947,"21 de agosto de 1994"
9,40,7,2644,336,407,743,"21 de agosto de 1994"
9,40,7,2645,591,649,1240,"21 de agosto de 1994"
9,40,7,2646,271,346,617,"21 de agosto de 1994"
9,40,7,2647,522,622,1144,"21 de agosto de 1994"
9,40,7,2648,481,497,978,"21 de agosto de 1994"
9,40,7,2649,484,554,1038,"21 de agosto de 1994"
9,40,7,2650,494,514,1008,"21 de agosto de 1994"
9,40,7,2651,56,68,124,"21 de agosto de 1994"
9,40,7,2652,172,188,360,"21 de agosto de 1994"
9,40,7,2653,440,462,902,"21 de agosto de 1994"
9,40,7,2654,566,552,1118,"21 de agosto de 1994"
9,40,7,2655,518,596,1114,"21 de agosto de 1994"
9,40,7,2656,458,512,970,"21 de agosto de 1994"
9,40,7,2657,481,516,997,"21 de agosto de 1994"
9,40,7,2658,443,506,949,"21 de agosto de 1994"
9,40,7,2659,626,650,1276,"21 de agosto de 1994"
9,40,7,2660,562,563,1125,"21 de agosto de 1994"
9,40,7,2661,452,468,920,"21 de agosto de 1994"
9,40,7,2662,747,915,1662,"21 de agosto de 1994"
9,40,7,2663,317,368,685,"21 de agosto de 1994"
9,40,7,2664,176,217,393,"21 de agosto de 1994"
9,40,7,2665,426,482,908,"21 de agosto de 1994"
9,40,7,2666,825,930,1755,"21 de agosto de 1994"
9,40,7,2667,583,638,1221,"21 de agosto de 1994"
9,40,7,2668,314,339,653,"21 de agosto de 1994"
9,40,7,2669,456,476,932,"21 de agosto de 1994"
9,40,7,2670,215,293,508,"21 de agosto de 1994"
9,40,7,2671,401,476,877,"21 de agosto de 1994"
9,40,7,2672,516,569,1085,"21 de agosto de 1994"
9,40,7,2673,495,501,996,"21 de agosto de 1994"
9,40,7,2674,560,584,1144,"21 de agosto de 1994"
9,40,7,2675,443,452,895,"21 de agosto de 1994"
9,40,7,2676,412,490,902,"21 de agosto de 1994"
9,40,7,2677,254,309,563,"21 de agosto de 1994"
9,40,7,2678,472,486,958,"21 de agosto de 1994"
9,40,7,2679,566,626,1192,"21 de agosto de 1994"
9,40,7,2680,406,468,874,"21 de agosto de 1994"
9,40,7,2681,420,441,861,"21 de agosto de 1994"
9,40,7,2682,434,464,898,"21 de agosto de 1994"
9,40,7,2683,432,444,876,"21 de agosto de 1994"
9,40,7,2684,493,577,1070,"21 de agosto de 1994"
9,40,7,2685,589,682,1271,"21 de agosto de 1994"
9,40,7,2686,419,442,861,"21 de agosto de 1994"
9,40,7,2687,475,527,1002,"21 de agosto de 1994"
9,40,7,2688,527,550,1077,"21 de agosto de 1994"
9,40,7,2689,470,536,1006,"21 de agosto de 1994"
9,40,7,2690,559,643,1202,"21 de agosto de 1994"
9,40,7,2691,436,472,908,"21 de agosto de 1994"
9,40,7,2692,527,545,1072,"21 de agosto de 1994"
9,40,7,2693,404,439,843,"21 de agosto de 1994"
9,40,7,2694,390,453,843,"21 de agosto de 1994"
9,40,7,2695,319,334,653,"21 de agosto de 1994"
9,40,7,2696,409,441,850,"21 de agosto de 1994"
9,40,7,2697,389,409,798,"21 de agosto de 1994"
9,40,7,2698,361,399,760,"21 de agosto de 1994"
9,40,7,2699,493,517,1010,"21 de agosto de 1994"
9,40,7,2700,474,535,1009,"21 de agosto de 1994"
9,40,7,2701,489,485,974,"21 de agosto de 1994"
9,40,7,2702,472,493,965,"21 de agosto de 1994"
9,40,7,2703,467,506,973,"21 de agosto de 1994"
9,40,7,2704,465,472,937,"21 de agosto de 1994"
9,40,7,2705,509,608,1117,"21 de agosto de 1994"
9,40,7,2706,474,540,1014,"21 de agosto de 1994"
9,40,7,2707,511,535,1046,"21 de agosto de 1994"
9,40,7,2708,380,359,739,"21 de agosto de 1994"
9,40,7,2709,435,472,907,"21 de agosto de 1994"
9,40,7,2710,405,466,871,"21 de agosto de 1994"
9,40,7,2711,378,423,801,"21 de agosto de 1994"
9,40,7,2712,407,474,881,"21 de agosto de 1994"
9,40,7,2713,516,536,1052,"21 de agosto de 1994"
9,40,7,2714,501,560,1061,"21 de agosto de 1994"
9,40,7,2715,469,499,968,"21 de agosto de 1994"
9,40,7,2716,460,531,991,"21 de agosto de 1994"
9,40,7,2717,516,576,1092,"21 de agosto de 1994"
9,40,7,2718,443,495,938,"21 de agosto de 1994"
9,40,7,2719,486,500,986,"21 de agosto de 1994"
9,40,7,2720,513,576,1089,"21 de agosto de 1994"
9,40,7,2721,437,466,903,"21 de agosto de 1994"
9,40,7,2722,390,426,816,"21 de agosto de 1994"
9,40,7,2723,415,471,886,"21 de agosto de 1994"
9,40,7,2724,521,550,1071,"21 de agosto de 1994"
9,40,7,2725,512,544,1056,"21 de agosto de 1994"
9,40,7,2726,470,504,974,"21 de agosto de 1994"
9,40,7,2727,450,515,965,"21 de agosto de 1994"
9,40,7,2728,610,640,1250,"21 de agosto de 1994"
9,40,7,2729,402,449,851,"21 de agosto de 1994"
9,40,7,2730,514,571,1085,"21 de agosto de 1994"
9,40,7,2731,477,510,987,"21 de agosto de 1994"
9,40,7,2732,561,565,1126,"21 de agosto de 1994"
9,40,7,2733,730,797,1527,"21 de agosto de 1994"
9,40,7,2734,353,436,789,"21 de agosto de 1994"
9,40,7,2735,515,556,1071,"21 de agosto de 1994"
9,40,7,2736,458,560,1018,"21 de agosto de 1994"
9,40,7,2737,370,422,792,"21 de agosto de 1994"
9,40,7,2738,433,505,938,"21 de agosto de 1994"
9,40,7,2739,341,405,746,"21 de agosto de 1994"
9,40,7,2740,203,223,426,"21 de agosto de 1994"
9,40,7,2741,540,572,1112,"21 de agosto de 1994"
9,40,7,2742,338,438,776,"21 de agosto de 1994"
9,40,7,2743,500,556,1056,"21 de agosto de 1994"
9,40,7,2744,443,516,959,"21 de agosto de 1994"
9,40,7,2745,447,523,970,"21 de agosto de 1994"
9,40,7,2746,427,435,862,"21 de agosto de 1994"
9,40,7,2747,505,618,1123,"21 de agosto de 1994"
9,40,7,2748,519,626,1145,"21 de agosto de 1994"
9,40,7,2749,480,559,1039,"21 de agosto de 1994"
9,40,7,2750,641,705,1346,"21 de agosto de 1994"
9,40,7,2751,459,502,961,"21 de agosto de 1994"
9,40,7,2752,345,418,763,"21 de agosto de 1994"
9,40,7,2753,294,388,682,"21 de agosto de 1994"
9,40,7,2754,711,938,1649,"21 de agosto de 1994"
9,40,7,2755,566,589,1155,"21 de agosto de 1994"
9,40,7,2756,409,457,866,"21 de agosto de 1994"
9,40,7,2757,648,711,1359,"21 de agosto de 1994"
9,40,7,2758,438,449,887,"21 de agosto de 1994"
9,40,7,2759,644,713,1357,"21 de agosto de 1994"
9,40,7,2760,657,687,1344,"21 de agosto de 1994"
9,40,7,2761,614,645,1259,"21 de agosto de 1994"
9,40,7,2762,450,478,928,"21 de agosto de 1994"
9,40,7,2763,202,230,432,"21 de agosto de 1994"
9,40,7,2764,479,516,995,"21 de agosto de 1994"
9,40,7,2765,517,548,1065,"21 de agosto de 1994"
9,40,7,2766,491,575,1066,"21 de agosto de 1994"
9,40,7,2767,356,425,781,"21 de agosto de 1994"
9,40,7,2768,467,543,1010,"21 de agosto de 1994"
9,40,7,2769,383,420,803,"21 de agosto de 1994"
9,40,7,2770,468,531,999,"21 de agosto de 1994"
9,40,7,2771,538,609,1147,"21 de agosto de 1994"
9,40,7,2772,503,533,1036,"21 de agosto de 1994"
9,40,7,2773,441,508,949,"21 de agosto de 1994"
9,40,7,2774,532,563,1095,"21 de agosto de 1994"
9,40,7,2775,442,479,921,"21 de agosto de 1994"
9,40,7,2776,400,440,840,"21 de agosto de 1994"
9,40,7,2777,426,469,895,"21 de agosto de 1994"
9,40,7,2778,396,439,835,"21 de agosto de 1994"
9,40,7,2779,505,513,1018,"21 de agosto de 1994"
9,40,7,2780,476,515,991,"21 de agosto de 1994"
9,40,7,2781,443,475,918,"21 de agosto de 1994"
9,40,7,2782,508,526,1034,"21 de agosto de 1994"
9,40,7,2783,422,472,894,"21 de agosto de 1994"
9,40,7,2784,458,502,960,"21 de agosto de 1994"
9,40,7,2785,446,444,890,"21 de agosto de 1994"
9,40,7,2786,502,533,1035,"21 de agosto de 1994"
9,40,7,2787,364,389,753,"21 de agosto de 1994"
9,40,7,2788,425,466,891,"21 de agosto de 1994"
9,40,7,2789,415,420,835,"21 de agosto de 1994"
9,40,7,2790,479,518,997,"21 de agosto de 1994"
9,40,7,2791,445,455,900,"21 de agosto de 1994"
9,40,7,2792,431,489,920,"21 de agosto de 1994"
9,40,7,2793,531,554,1085,"21 de agosto de 1994"
9,40,7,2794,582,599,1181,"21 de agosto de 1994"
9,40,7,2795,496,527,1023,"21 de agosto de 1994"
9,40,7,2796,465,464,929,"21 de agosto de 1994"
9,40,7,2797,456,487,943,"21 de agosto de 1994"
9,40,7,2798,619,609,1228,"21 de agosto de 1994"
9,40,7,2799,373,379,752,"21 de agosto de 1994"
9,40,7,2800,499,500,999,"21 de agosto de 1994"
9,40,7,2801,417,425,842,"21 de agosto de 1994"
9,40,7,2802,496,526,1022,"21 de agosto de 1994"
9,40,7,2803,469,516,985,"21 de agosto de 1994"
9,40,7,2804,395,421,816,"21 de agosto de 1994"
9,40,7,2805,484,500,984,"21 de agosto de 1994"
9,40,7,2806,385,378,763,"21 de agosto de 1994"
9,40,7,2807,331,349,680,"21 de agosto de 1994"
9,40,7,2808,409,430,839,"21 de agosto de 1994"
9,40,7,2809,382,426,808,"21 de agosto de 1994"
9,40,7,2810,180,214,394,"21 de agosto de 1994"
9,40,7,2811,414,460,874,"21 de agosto de 1994"
9,40,7,2812,497,519,1016,"21 de agosto de 1994"
9,40,7,2813,345,384,729,"21 de agosto de 1994"
9,40,7,2814,485,515,1000,"21 de agosto de 1994"
9,40,7,2815,453,517,970,"21 de agosto de 1994"
9,40,7,2816,342,378,720,"21 de agosto de 1994"
9,40,7,2817,415,434,849,"21 de agosto de 1994"
9,40,7,2818,578,636,1214,"21 de agosto de 1994"
9,40,7,2819,441,484,925,"21 de agosto de 1994"
9,40,7,2820,466,516,982,"21 de agosto de 1994"
9,40,7,2821,516,568,1084,"21 de agosto de 1994"
9,40,7,2822,461,507,968,"21 de agosto de 1994"
9,40,7,2823,420,450,870,"21 de agosto de 1994"
9,40,7,2824,459,508,967,"21 de agosto de 1994"
9,40,7,2825,447,490,937,"21 de agosto de 1994"
9,40,7,2826,449,447,896,"21 de agosto de 1994"
9,40,7,2827,486,528,1014,"21 de agosto de 1994"
9,40,7,2828,349,417,766,"21 de agosto de 1994"
9,40,7,2829,371,408,779,"21 de agosto de 1994"
9,40,7,2830,508,568,1076,"21 de agosto de 1994"
9,40,7,2831,489,520,1009,"21 de agosto de 1994"
9,40,7,2832,439,505,944,"21 de agosto de 1994"
9,40,7,2833,420,487,907,"21 de agosto de 1994"
9,40,7,2834,490,519,1009,"21 de agosto de 1994"
9,40,7,2835,409,465,874,"21 de agosto de 1994"
9,40,7,2836,378,457,835,"21 de agosto de 1994"
9,40,7,2837,438,549,987,"21 de agosto de 1994"
9,40,7,2838,350,421,771,"21 de agosto de 1994"
9,40,7,2839,172,220,392,"21 de agosto de 1994"
9,40,7,2840,227,296,523,"21 de agosto de 1994"
9,40,7,2841,415,429,844,"21 de agosto de 1994"
9,40,7,2842,407,462,869,"21 de agosto de 1994"
9,40,7,2843,272,338,610,"21 de agosto de 1994"
9,40,7,2844,248,282,530,"21 de agosto de 1994"
9,40,7,2845,281,340,621,"21 de agosto de 1994"
9,40,7,2846,215,260,475,"21 de agosto de 1994"
9,40,7,2847,250,314,564,"21 de agosto de 1994"
9,40,7,2848,166,207,373,"21 de agosto de 1994"
9,40,7,2849,443,498,941,"21 de agosto de 1994"
9,40,7,2850,427,488,915,"21 de agosto de 1994"
9,40,7,2851,444,482,926,"21 de agosto de 1994"
9,40,7,2852,602,677,1279,"21 de agosto de 1994"
9,40,7,2853,790,875,1665,"21 de agosto de 1994"
9,40,7,2854,416,456,872,"21 de agosto de 1994"
9,40,7,2855,531,559,1090,"21 de agosto de 1994"
9,40,7,2856,385,442,827,"21 de agosto de 1994"
9,40,7,2857,452,498,950,"21 de agosto de 1994"
9,40,7,2858,323,357,680,"21 de agosto de 1994"
9,40,7,2859,454,514,968,"21 de agosto de 1994"
9,40,7,2860,390,420,810,"21 de agosto de 1994"
9,40,7,2861,411,461,872,"21 de agosto de 1994"
9,40,7,2862,331,346,677,"21 de agosto de 1994"
9,40,7,2863,458,485,943,"21 de agosto de 1994"
9,40,7,2864,862,929,1791,"21 de agosto de 1994"
9,40,7,2865,359,395,754,"21 de agosto de 1994"
9,40,7,2866,428,465,893,"21 de agosto de 1994"
9,40,7,2867,428,509,937,"21 de agosto de 1994"
9,40,7,2868,444,521,965,"21 de agosto de 1994"
9,40,7,2869,491,540,1031,"21 de agosto de 1994"
9,40,7,2870,482,531,1013,"21 de agosto de 1994"
9,40,7,2871,524,578,1102,"21 de agosto de 1994"
9,40,7,2872,511,564,1075,"21 de agosto de 1994"
9,40,7,2873,624,695,1319,"21 de agosto de 1994"
9,40,7,2874,559,590,1149,"21 de agosto de 1994"
9,40,7,2875,548,576,1124,"21 de agosto de 1994"
9,40,7,2876,508,559,1067,"21 de agosto de 1994"
9,40,7,2877,363,427,790,"21 de agosto de 1994"
9,40,7,2878,461,502,963,"21 de agosto de 1994"
9,40,7,2879,471,505,976,"21 de agosto de 1994"
9,40,7,2880,315,362,677,"21 de agosto de 1994"
9,40,7,2881,297,347,644,"21 de agosto de 1994"
9,40,7,2882,385,470,855,"21 de agosto de 1994"
9,40,7,2883,246,276,522,"21 de agosto de 1994"
9,40,7,2884,408,479,887,"21 de agosto de 1994"
9,40,7,2885,313,370,683,"21 de agosto de 1994"
9,40,7,2886,451,503,954,"21 de agosto de 1994"
9,40,7,2887,317,392,709,"21 de agosto de 1994"
9,40,7,2888,273,320,593,"21 de agosto de 1994"
9,40,7,2889,234,270,504,"21 de agosto de 1994"
9,40,7,2890,277,336,613,"21 de agosto de 1994"
9,40,7,2891,312,365,677,"21 de agosto de 1994"
9,40,7,2892,224,261,485,"21 de agosto de 1994"
9,40,7,2893,341,389,730,"21 de agosto de 1994"
9,40,7,2894,519,577,1096,"21 de agosto de 1994"
9,40,7,2895,576,606,1182,"21 de agosto de 1994"
9,40,7,2896,574,627,1201,"21 de agosto de 1994"
9,40,7,2897,334,354,688,"21 de agosto de 1994"
9,40,7,2898,525,581,1106,"21 de agosto de 1994"
9,40,7,2899,640,725,1365,"21 de agosto de 1994"
9,40,7,2900,531,602,1133,"21 de agosto de 1994"
9,40,7,2901,266,272,538,"21 de agosto de 1994"
9,40,7,2902,486,501,987,"21 de agosto de 1994"
9,40,7,2903,327,367,694,"21 de agosto de 1994"
9,40,7,2904,343,395,738,"21 de agosto de 1994"
9,40,7,2905,381,443,824,"21 de agosto de 1994"
9,40,7,2906,234,252,486,"21 de agosto de 1994"
9,40,7,2907,421,479,900,"21 de agosto de 1994"
9,40,7,2908,500,545,1045,"21 de agosto de 1994"
9,40,7,2909,596,667,1263,"21 de agosto de 1994"
9,40,7,2910,462,514,976,"21 de agosto de 1994"
9,40,7,2911,432,468,900,"21 de agosto de 1994"
9,40,7,2912,418,437,855,"21 de agosto de 1994"
9,40,7,2913,510,529,1039,"21 de agosto de 1994"
9,40,7,2914,435,498,933,"21 de agosto de 1994"
9,40,7,2915,344,416,760,"21 de agosto de 1994"
9,40,7,2916,514,572,1086,"21 de agosto de 1994"
9,40,7,2917,437,466,903,"21 de agosto de 1994"
9,40,7,2918,500,619,1119,"21 de agosto de 1994"
9,40,7,2919,542,546,1088,"21 de agosto de 1994"
9,40,7,2920,492,490,982,"21 de agosto de 1994"
9,40,7,2921,477,461,938,"21 de agosto de 1994"
9,40,7,2922,521,517,1038,"21 de agosto de 1994"
9,40,7,2923,308,339,647,"21 de agosto de 1994"
9,40,7,2924,468,499,967,"21 de agosto de 1994"
9,40,7,2925,569,617,1186,"21 de agosto de 1994"
9,40,7,2926,530,544,1074,"21 de agosto de 1994"
9,40,7,2927,499,497,996,"21 de agosto de 1994"
9,40,7,2928,544,583,1127,"21 de agosto de 1994"
9,40,7,2929,559,551,1110,"21 de agosto de 1994"
9,40,7,2930,419,422,841,"21 de agosto de 1994"
9,40,7,2931,589,576,1165,"21 de agosto de 1994"
9,40,7,2932,466,472,938,"21 de agosto de 1994"
9,40,7,2933,433,470,903,"21 de agosto de 1994"
9,40,7,2934,540,580,1120,"21 de agosto de 1994"
9,40,7,2935,600,646,1246,"21 de agosto de 1994"
9,40,7,2936,421,464,885,"21 de agosto de 1994"
9,40,7,2937,417,439,856,"21 de agosto de 1994"
9,40,7,2938,405,406,811,"21 de agosto de 1994"
9,40,7,2939,209,224,433,"21 de agosto de 1994"
9,40,7,2940,464,521,985,"21 de agosto de 1994"
9,40,7,2941,492,527,1019,"21 de agosto de 1994"
9,40,7,2942,530,558,1088,"21 de agosto de 1994"
9,40,7,2943,387,434,821,"21 de agosto de 1994"
9,40,7,2944,621,601,1222,"21 de agosto de 1994"
9,40,7,2945,677,690,1367,"21 de agosto de 1994"
9,40,7,2946,368,465,833,"21 de agosto de 1994"
9,40,7,2947,533,532,1065,"21 de agosto de 1994"
9,40,7,2948,561,600,1161,"21 de agosto de 1994"
9,40,7,2949,298,359,657,"21 de agosto de 1994"
9,40,7,2950,273,291,564,"21 de agosto de 1994"
9,40,7,2951,397,438,835,"21 de agosto de 1994"
9,40,7,2952,429,491,920,"21 de agosto de 1994"
9,40,7,2953,391,425,816,"21 de agosto de 1994"
9,40,7,2954,357,402,759,"21 de agosto de 1994"
9,40,7,2955,391,459,850,"21 de agosto de 1994"
9,40,7,2956,475,491,966,"21 de agosto de 1994"
9,40,7,2957,583,675,1258,"21 de agosto de 1994"
9,40,7,2958,521,651,1172,"21 de agosto de 1994"
9,40,7,2959,342,354,696,"21 de agosto de 1994"
9,40,7,2960,258,285,543,"21 de agosto de 1994"
9,40,7,2961,435,493,928,"21 de agosto de 1994"
9,40,7,2962,340,372,712,"21 de agosto de 1994"
9,40,7,2963,241,254,495,"21 de agosto de 1994"
9,40,7,2964,248,297,545,"21 de agosto de 1994"
9,40,7,2965,324,401,725,"21 de agosto de 1994"
9,40,7,2966,206,192,398,"21 de agosto de 1994"
9,40,7,2967,339,378,717,"21 de agosto de 1994"
9,40,7,2968,239,283,522,"21 de agosto de 1994"
9,40,7,2969,205,243,448,"21 de agosto de 1994"
9,40,7,2970,310,356,666,"21 de agosto de 1994"
9,40,7,2971,110,119,229,"21 de agosto de 1994"
9,40,7,5528,563,571,1134,"21 de agosto de 1994"
9,40,7,5529,17,11,28,"21 de agosto de 1994"
9,40,7,5530,30,34,64,"21 de agosto de 1994"
9,40,7,5531,103,98,201,"21 de agosto de 1994"
9,40,7,5532,150,165,315,"21 de agosto de 1994"
9,40,7,5533,334,361,695,"21 de agosto de 1994"
9,40,7,5534,108,92,200,"21 de agosto de 1994"
9,40,7,5535,362,420,782,"21 de agosto de 1994"
9,40,9,3119,405,446,851,"21 de agosto de 1994"
9,40,9,3120,464,484,948,"21 de agosto de 1994"
9,40,9,3121,509,544,1053,"21 de agosto de 1994"
9,40,9,3122,696,738,1434,"21 de agosto de 1994"
9,40,9,3123,606,622,1228,"21 de agosto de 1994"
9,40,9,3124,512,531,1043,"21 de agosto de 1994"
9,40,9,3125,484,542,1026,"21 de agosto de 1994"
9,40,9,3126,493,530,1023,"21 de agosto de 1994"
9,40,9,3127,381,365,746,"21 de agosto de 1994"
9,40,9,3128,418,444,862,"21 de agosto de 1994"
9,40,9,3129,432,445,877,"21 de agosto de 1994"
9,40,9,3130,411,467,878,"21 de agosto de 1994"
9,40,9,3131,500,574,1074,"21 de agosto de 1994"
9,40,9,3132,518,557,1075,"21 de agosto de 1994"
9,40,9,3133,522,549,1071,"21 de agosto de 1994"
9,40,9,3134,577,611,1188,"21 de agosto de 1994"
9,40,9,3135,475,487,962,"21 de agosto de 1994"
9,40,9,3136,413,442,855,"21 de agosto de 1994"
9,40,9,3137,436,460,896,"21 de agosto de 1994"
9,40,9,3138,505,488,993,"21 de agosto de 1994"
9,40,9,3139,413,419,832,"21 de agosto de 1994"
9,40,9,3140,433,431,864,"21 de agosto de 1994"
9,40,9,3141,379,377,756,"21 de agosto de 1994"
9,40,9,3142,359,384,743,"21 de agosto de 1994"
9,40,9,3143,385,424,809,"21 de agosto de 1994"
9,40,9,3144,354,342,696,"21 de agosto de 1994"
9,40,9,3145,362,324,686,"21 de agosto de 1994"
9,40,9,3146,384,381,765,"21 de agosto de 1994"
9,40,9,3147,373,428,801,"21 de agosto de 1994"
9,40,9,3148,355,358,713,"21 de agosto de 1994"
9,40,9,3149,503,500,1003,"21 de agosto de 1994"
9,40,9,3150,414,396,810,"21 de agosto de 1994"
9,40,9,3151,344,361,705,"21 de agosto de 1994"
9,40,9,3152,324,340,664,"21 de agosto de 1994"
9,40,9,3153,443,524,967,"21 de agosto de 1994"
9,40,9,3154,448,483,931,"21 de agosto de 1994"
9,40,9,3155,421,454,875,"21 de agosto de 1994"
9,40,9,3156,429,436,865,"21 de agosto de 1994"
9,40,9,3157,469,483,952,"21 de agosto de 1994"
9,40,9,3158,418,450,868,"21 de agosto de 1994"
9,40,9,3159,677,708,1385,"21 de agosto de 1994"
9,40,9,3160,508,554,1062,"21 de agosto de 1994"
9,40,9,3161,548,551,1099,"21 de agosto de 1994"
9,40,9,3162,340,398,738,"21 de agosto de 1994"
9,40,11,3609,698,717,1415,"21 de agosto de 1994"
9,40,11,3610,474,511,985,"21 de agosto de 1994"
9,40,11,3611,453,486,939,"21 de agosto de 1994"
9,40,11,3612,342,434,776,"21 de agosto de 1994"
9,40,11,3613,358,422,780,"21 de agosto de 1994"
9,40,11,3614,591,614,1205,"21 de agosto de 1994"
9,40,11,3615,526,557,1083,"21 de agosto de 1994"
9,40,11,3616,415,436,851,"21 de agosto de 1994"
9,40,11,3617,561,625,1186,"21 de agosto de 1994"
9,40,11,3618,639,734,1373,"21 de agosto de 1994"
9,40,11,3619,462,502,964,"21 de agosto de 1994"
9,40,11,3620,607,588,1195,"21 de agosto de 1994"
9,40,11,3621,435,472,907,"21 de agosto de 1994"
9,40,11,3622,629,665,1294,"21 de agosto de 1994"
9,40,11,3623,501,563,1064,"21 de agosto de 1994"
9,40,11,3624,463,551,1014,"21 de agosto de 1994"
9,40,11,3625,440,499,939,"21 de agosto de 1994"
9,40,11,3626,482,499,981,"21 de agosto de 1994"
9,40,11,3627,437,502,939,"21 de agosto de 1994"
9,40,11,3628,583,640,1223,"21 de agosto de 1994"
9,40,11,3629,460,549,1009,"21 de agosto de 1994"
9,40,11,3630,420,465,885,"21 de agosto de 1994"
9,40,11,3631,190,228,418,"21 de agosto de 1994"
9,40,11,3632,597,602,1199,"21 de agosto de 1994"
9,40,11,3633,552,586,1138,"21 de agosto de 1994"
9,40,11,3634,451,496,947,"21 de agosto de 1994"
9,40,11,3635,507,556,1063,"21 de agosto de 1994"
9,40,11,3636,587,710,1297,"21 de agosto de 1994"
9,40,11,3637,550,680,1230,"21 de agosto de 1994"
9,40,11,3638,325,348,673,"21 de agosto de 1994"
9,40,11,3639,443,460,903,"21 de agosto de 1994"
9,40,11,3640,502,559,1061,"21 de agosto de 1994"
9,40,11,3641,515,622,1137,"21 de agosto de 1994"
9,40,11,3642,591,670,1261,"21 de agosto de 1994"
9,40,11,3643,490,578,1068,"21 de agosto de 1994"
9,40,11,3644,456,513,969,"21 de agosto de 1994"
9,40,11,3645,498,530,1028,"21 de agosto de 1994"
9,40,11,3646,376,385,761,"21 de agosto de 1994"
9,40,11,3647,456,501,957,"21 de agosto de 1994"
9,40,11,3648,489,532,1021,"21 de agosto de 1994"
9,40,11,3649,482,528,1010,"21 de agosto de 1994"
9,40,11,3650,426,473,899,"21 de agosto de 1994"
9,40,11,3651,491,550,1041,"21 de agosto de 1994"
9,40,11,3652,416,463,879,"21 de agosto de 1994"
9,40,11,3653,581,641,1222,"21 de agosto de 1994"
9,40,11,3654,659,727,1386,"21 de agosto de 1994"
9,40,11,3655,487,516,1003,"21 de agosto de 1994"
9,40,11,3656,526,539,1065,"21 de agosto de 1994"
9,40,11,3657,566,618,1184,"21 de agosto de 1994"
9,40,11,3658,482,507,989,"21 de agosto de 1994"
9,40,11,3659,360,391,751,"21 de agosto de 1994"
9,40,11,3660,464,539,1003,"21 de agosto de 1994"
9,40,11,3661,465,524,989,"21 de agosto de 1994"
9,40,11,3662,436,469,905,"21 de agosto de 1994"
9,40,11,3663,477,472,949,"21 de agosto de 1994"
9,40,11,3664,552,567,1119,"21 de agosto de 1994"
9,40,11,3665,556,630,1186,"21 de agosto de 1994"
9,40,11,3666,469,522,991,"21 de agosto de 1994"
9,40,11,3667,501,529,1030,"21 de agosto de 1994"
9,40,11,3668,423,488,911,"21 de agosto de 1994"
9,40,11,3669,421,472,893,"21 de agosto de 1994"
9,40,11,3670,459,511,970,"21 de agosto de 1994"
9,40,11,3671,392,463,855,"21 de agosto de 1994"
9,40,11,3672,402,447,849,"21 de agosto de 1994"
9,40,11,3673,511,521,1032,"21 de agosto de 1994"
9,40,11,3674,514,592,1106,"21 de agosto de 1994"
9,40,11,3675,597,606,1203,"21 de agosto de 1994"
9,40,11,3676,601,632,1233,"21 de agosto de 1994"
9,40,11,3677,531,598,1129,"21 de agosto de 1994"
9,40,11,3678,430,467,897,"21 de agosto de 1994"
9,40,11,3679,483,514,997,"21 de agosto de 1994"
9,40,11,3680,602,631,1233,"21 de agosto de 1994"
9,40,11,3681,417,462,879,"21 de agosto de 1994"
9,40,11,3682,602,621,1223,"21 de agosto de 1994"
9,40,11,3683,518,554,1072,"21 de agosto de 1994"
9,40,11,3684,720,837,1557,"21 de agosto de 1994"
9,40,11,3685,448,454,902,"21 de agosto de 1994"
9,40,11,3686,553,582,1135,"21 de agosto de 1994"
9,40,11,3687,555,569,1124,"21 de agosto de 1994"
9,40,11,3688,517,512,1029,"21 de agosto de 1994"
9,40,11,3689,542,583,1125,"21 de agosto de 1994"
9,40,11,3690,556,584,1140,"21 de agosto de 1994"
9,40,11,3691,547,597,1144,"21 de agosto de 1994"
9,40,11,3692,549,585,1134,"21 de agosto de 1994"
9,40,11,3693,594,667,1261,"21 de agosto de 1994"
9,40,11,3694,466,580,1046,"21 de agosto de 1994"
9,40,11,3695,634,681,1315,"21 de agosto de 1994"
9,40,11,3696,485,488,973,"21 de agosto de 1994"
9,40,11,3697,464,507,971,"21 de agosto de 1994"
9,40,11,3698,408,421,829,"21 de agosto de 1994"
9,40,11,3699,447,484,931,"21 de agosto de 1994"
9,40,11,3700,580,641,1221,"21 de agosto de 1994"
9,40,11,3701,562,601,1163,"21 de agosto de 1994"
9,40,11,3702,530,609,1139,"21 de agosto de 1994"
9,40,11,3703,581,645,1226,"21 de agosto de 1994"
9,40,11,3704,508,589,1097,"21 de agosto de 1994"
9,40,11,3705,458,553,1011,"21 de agosto de 1994"
9,40,11,3706,502,586,1088,"21 de agosto de 1994"
9,40,11,3707,395,410,805,"21 de agosto de 1994"
9,40,11,3708,727,765,1492,"21 de agosto de 1994"
9,40,11,3709,508,560,1068,"21 de agosto de 1994"
9,40,11,3710,513,519,1032,"21 de agosto de 1994"
9,40,11,3711,462,506,968,"21 de agosto de 1994"
9,40,11,3712,505,538,1043,"21 de agosto de 1994"
9,40,11,3713,574,633,1207,"21 de agosto de 1994"
9,40,11,3714,548,584,1132,"21 de agosto de 1994"
9,40,11,3715,450,476,926,"21 de agosto de 1994"
9,40,11,3716,498,576,1074,"21 de agosto de 1994"
9,40,11,3717,582,665,1247,"21 de agosto de 1994"
9,40,11,3718,595,621,1216,"21 de agosto de 1994"
9,40,11,3719,591,659,1250,"21 de agosto de 1994"
9,40,11,3720,391,432,823,"21 de agosto de 1994"
9,40,11,3721,501,544,1045,"21 de agosto de 1994"
9,40,11,3722,480,544,1024,"21 de agosto de 1994"
9,40,11,3723,483,512,995,"21 de agosto de 1994"
9,40,11,3724,595,581,1176,"21 de agosto de 1994"
9,40,11,3725,454,492,946,"21 de agosto de 1994"
9,40,11,3726,475,501,976,"21 de agosto de 1994"
9,40,11,3727,529,588,1117,"21 de agosto de 1994"
9,40,11,3728,464,529,993,"21 de agosto de 1994"
9,40,11,3729,399,467,866,"21 de agosto de 1994"
9,40,11,3730,268,298,566,"21 de agosto de 1994"
9,40,11,3731,405,448,853,"21 de agosto de 1994"
9,40,11,3732,286,294,580,"21 de agosto de 1994"
9,40,11,3733,96,111,207,"21 de agosto de 1994"
9,40,11,3734,123,147,270,"21 de agosto de 1994"
9,40,11,3735,77,99,176,"21 de agosto de 1994"
9,40,11,3736,85,111,196,"21 de agosto de 1994"
9,40,11,3737,105,147,252,"21 de agosto de 1994"
9,40,11,3738,83,111,194,"21 de agosto de 1994"
9,40,11,3739,86,123,209,"21 de agosto de 1994"
9,40,11,3740,250,239,489,"21 de agosto de 1994"
9,40,11,3741,337,361,698,"21 de agosto de 1994"
10,1,5,108,397,414,811,"21 de agosto de 1994"
10,1,5,109,297,352,649,"21 de agosto de 1994"
10,1,5,110,858,1041,1899,"21 de agosto de 1994"
10,1,5,111,516,577,1093,"21 de agosto de 1994"
10,1,5,112,245,299,544,"21 de agosto de 1994"
10,1,5,113,323,380,703,"21 de agosto de 1994"
10,1,5,114,426,491,917,"21 de agosto de 1994"
10,1,5,115,219,279,498,"21 de agosto de 1994"
10,1,5,116,214,288,502,"21 de agosto de 1994"
10,1,5,117,279,375,654,"21 de agosto de 1994"
10,1,5,118,264,281,545,"21 de agosto de 1994"
10,1,5,119,251,280,531,"21 de agosto de 1994"
10,1,5,120,289,369,658,"21 de agosto de 1994"
10,1,5,121,232,250,482,"21 de agosto de 1994"
10,1,5,122,186,204,390,"21 de agosto de 1994"
10,1,5,123,174,220,394,"21 de agosto de 1994"
10,1,5,124,407,476,883,"21 de agosto de 1994"
10,1,5,125,278,326,604,"21 de agosto de 1994"
10,1,5,126,394,464,858,"21 de agosto de 1994"
10,1,5,127,381,435,816,"21 de agosto de 1994"
10,1,5,128,253,280,533,"21 de agosto de 1994"
10,1,5,129,342,414,756,"21 de agosto de 1994"
10,1,5,130,335,367,702,"21 de agosto de 1994"
10,1,5,131,475,518,993,"21 de agosto de 1994"
10,1,5,132,408,503,911,"21 de agosto de 1994"
10,1,5,133,300,352,652,"21 de agosto de 1994"
10,1,5,134,369,419,788,"21 de agosto de 1994"
10,1,5,135,709,810,1519,"21 de agosto de 1994"
10,1,5,136,608,716,1324,"21 de agosto de 1994"
10,1,5,137,514,591,1105,"21 de agosto de 1994"
10,1,5,138,206,264,470,"21 de agosto de 1994"
10,1,5,139,407,502,909,"21 de agosto de 1994"
10,1,5,140,477,531,1008,"21 de agosto de 1994"
10,1,5,141,469,565,1034,"21 de agosto de 1994"
10,1,5,142,419,491,910,"21 de agosto de 1994"
10,1,5,143,470,521,991,"21 de agosto de 1994"
10,1,5,144,517,634,1151,"21 de agosto de 1994"
10,1,5,145,780,843,1623,"21 de agosto de 1994"
10,1,5,146,803,903,1706,"21 de agosto de 1994"
10,1,5,147,348,436,784,"21 de agosto de 1994"
10,1,5,148,327,407,734,"21 de agosto de 1994"
10,1,5,149,310,393,703,"21 de agosto de 1994"
10,1,5,150,542,696,1238,"21 de agosto de 1994"
10,1,5,151,442,522,964,"21 de agosto de 1994"
10,1,5,152,434,473,907,"21 de agosto de 1994"
10,1,5,153,242,356,598,"21 de agosto de 1994"
10,1,5,154,554,697,1251,"21 de agosto de 1994"
10,1,5,155,491,582,1073,"21 de agosto de 1994"
10,1,5,156,467,535,1002,"21 de agosto de 1994"
10,1,5,157,626,713,1339,"21 de agosto de 1994"
10,1,5,158,416,437,853,"21 de agosto de 1994"
10,1,5,159,406,471,877,"21 de agosto de 1994"
10,1,5,160,387,441,828,"21 de agosto de 1994"
10,1,5,161,639,708,1347,"21 de agosto de 1994"
10,1,5,162,629,748,1377,"21 de agosto de 1994"
10,1,5,163,466,537,1003,"21 de agosto de 1994"
10,1,5,164,309,318,627,"21 de agosto de 1994"
10,1,5,165,81,87,168,"21 de agosto de 1994"
10,1,5,166,170,174,344,"21 de agosto de 1994"
10,1,5,167,453,501,954,"21 de agosto de 1994"
10,1,5,168,527,582,1109,"21 de agosto de 1994"
10,1,5,169,638,702,1340,"21 de agosto de 1994"
10,1,5,170,560,664,1224,"21 de agosto de 1994"
10,1,5,171,328,350,678,"21 de agosto de 1994"
10,1,5,172,375,485,860,"21 de agosto de 1994"
10,1,5,173,324,403,727,"21 de agosto de 1994"
10,1,5,174,301,345,646,"21 de agosto de 1994"
10,1,5,175,339,360,699,"21 de agosto de 1994"
10,1,5,176,611,668,1279,"21 de agosto de 1994"
10,1,5,177,460,555,1015,"21 de agosto de 1994"
10,1,5,178,491,585,1076,"21 de agosto de 1994"
10,1,5,179,435,462,897,"21 de agosto de 1994"
10,1,5,180,492,547,1039,"21 de agosto de 1994"
10,1,5,181,316,431,747,"21 de agosto de 1994"
10,1,5,182,391,465,856,"21 de agosto de 1994"
10,1,5,183,346,412,758,"21 de agosto de 1994"
10,1,5,184,509,577,1086,"21 de agosto de 1994"
10,1,5,185,389,455,844,"21 de agosto de 1994"
10,1,5,186,244,275,519,"21 de agosto de 1994"
10,1,5,187,384,440,824,"21 de agosto de 1994"
10,1,5,188,568,701,1269,"21 de agosto de 1994"
10,1,5,189,343,390,733,"21 de agosto de 1994"
10,1,5,190,340,416,756,"21 de agosto de 1994"
10,1,5,191,392,509,901,"21 de agosto de 1994"
10,1,5,192,406,511,917,"21 de agosto de 1994"
10,1,5,193,311,345,656,"21 de agosto de 1994"
10,1,5,194,425,531,956,"21 de agosto de 1994"
10,1,5,195,545,609,1154,"21 de agosto de 1994"
10,1,5,196,323,407,730,"21 de agosto de 1994"
10,1,5,197,445,537,982,"21 de agosto de 1994"
10,1,5,198,427,513,940,"21 de agosto de 1994"
10,1,5,199,446,461,907,"21 de agosto de 1994"
10,1,5,200,157,187,344,"21 de agosto de 1994"
10,1,5,201,203,265,468,"21 de agosto de 1994"
10,1,5,202,714,798,1512,"21 de agosto de 1994"
10,1,5,203,428,526,954,"21 de agosto de 1994"
10,1,5,204,354,428,782,"21 de agosto de 1994"
10,1,5,205,306,424,730,"21 de agosto de 1994"
10,1,5,206,308,405,713,"21 de agosto de 1994"
10,1,5,207,264,337,601,"21 de agosto de 1994"
10,1,5,208,387,482,869,"21 de agosto de 1994"
10,1,5,209,317,397,714,"21 de agosto de 1994"
10,1,5,210,423,514,937,"21 de agosto de 1994"
10,1,5,211,327,421,748,"21 de agosto de 1994"
10,1,5,212,332,382,714,"21 de agosto de 1994"
10,1,5,213,354,417,771,"21 de agosto de 1994"
10,1,5,214,239,316,555,"21 de agosto de 1994"
10,1,5,215,300,412,712,"21 de agosto de 1994"
10,1,5,216,221,301,522,"21 de agosto de 1994"
10,1,5,217,337,371,708,"21 de agosto de 1994"
10,1,5,218,379,425,804,"21 de agosto de 1994"
10,1,5,219,39,35,74,"21 de agosto de 1994"
10,1,5,220,281,283,564,"21 de agosto de 1994"
10,1,5,221,257,324,581,"21 de agosto de 1994"
10,1,5,222,541,641,1182,"21 de agosto de 1994"
10,1,5,223,539,639,1178,"21 de agosto de 1994"
10,1,5,224,611,718,1329,"21 de agosto de 1994"
10,1,5,225,521,691,1212,"21 de agosto de 1994"
10,1,5,226,272,350,622,"21 de agosto de 1994"
10,1,5,227,472,630,1102,"21 de agosto de 1994"
10,1,5,228,433,548,981,"21 de agosto de 1994"
10,1,5,229,241,304,545,"21 de agosto de 1994"
10,1,5,230,200,328,528,"21 de agosto de 1994"
10,1,5,231,349,397,746,"21 de agosto de 1994"
10,1,5,232,208,289,497,"21 de agosto de 1994"
10,1,5,233,358,372,730,"21 de agosto de 1994"
10,1,5,234,235,310,545,"21 de agosto de 1994"
10,1,5,235,214,243,457,"21 de agosto de 1994"
10,1,5,236,293,349,642,"21 de agosto de 1994"
10,1,5,237,220,241,461,"21 de agosto de 1994"
10,1,5,238,465,510,975,"21 de agosto de 1994"
10,1,5,239,347,464,811,"21 de agosto de 1994"
10,1,5,240,331,421,752,"21 de agosto de 1994"
10,1,5,241,273,328,601,"21 de agosto de 1994"
10,1,5,242,312,425,737,"21 de agosto de 1994"
10,1,5,243,439,527,966,"21 de agosto de 1994"
10,1,5,244,275,298,573,"21 de agosto de 1994"
10,1,5,245,400,504,904,"21 de agosto de 1994"
10,1,5,246,140,192,332,"21 de agosto de 1994"
10,1,5,247,440,537,977,"21 de agosto de 1994"
10,1,5,248,523,628,1151,"21 de agosto de 1994"
10,1,5,249,581,725,1306,"21 de agosto de 1994"
10,1,5,250,363,398,761,"21 de agosto de 1994"
10,1,5,251,306,339,645,"21 de agosto de 1994"
10,1,5,252,388,423,811,"21 de agosto de 1994"
10,1,5,253,149,142,291,"21 de agosto de 1994"
10,1,5,254,376,395,771,"21 de agosto de 1994"
10,1,5,255,385,427,812,"21 de agosto de 1994"
10,1,5,256,449,540,989,"21 de agosto de 1994"
10,1,5,257,330,417,747,"21 de agosto de 1994"
10,1,5,258,384,474,858,"21 de agosto de 1994"
10,1,5,259,410,438,848,"21 de agosto de 1994"
10,1,5,260,479,616,1095,"21 de agosto de 1994"
10,1,5,261,372,489,861,"21 de agosto de 1994"
10,1,5,262,513,627,1140,"21 de agosto de 1994"
10,1,5,263,336,412,748,"21 de agosto de 1994"
10,1,5,264,337,419,756,"21 de agosto de 1994"
10,1,5,265,270,355,625,"21 de agosto de 1994"
10,1,5,266,309,390,699,"21 de agosto de 1994"
10,1,5,267,319,398,717,"21 de agosto de 1994"
10,1,5,268,284,326,610,"21 de agosto de 1994"
10,1,5,269,499,604,1103,"21 de agosto de 1994"
10,1,5,270,561,646,1207,"21 de agosto de 1994"
10,1,5,271,519,707,1226,"21 de agosto de 1994"
10,1,5,272,339,385,724,"21 de agosto de 1994"
10,1,5,273,391,434,825,"21 de agosto de 1994"
10,1,5,274,405,458,863,"21 de agosto de 1994"
10,1,5,275,336,377,713,"21 de agosto de 1994"
10,1,5,276,499,565,1064,"21 de agosto de 1994"
10,1,5,277,138,144,282,"21 de agosto de 1994"
10,1,5,278,339,366,705,"21 de agosto de 1994"
10,1,5,279,243,292,535,"21 de agosto de 1994"
10,1,5,280,254,315,569,"21 de agosto de 1994"
10,1,5,281,357,400,757,"21 de agosto de 1994"
10,1,5,282,123,140,263,"21 de agosto de 1994"
10,1,5,283,272,320,592,"21 de agosto de 1994"
10,1,5,284,305,331,636,"21 de agosto de 1994"
10,1,5,285,291,334,625,"21 de agosto de 1994"
10,1,5,286,560,660,1220,"21 de agosto de 1994"
10,1,5,287,239,303,542,"21 de agosto de 1994"
10,1,5,288,386,451,837,"21 de agosto de 1994"
10,1,5,289,392,470,862,"21 de agosto de 1994"
10,1,5,290,411,443,854,"21 de agosto de 1994"
10,1,5,291,315,397,712,"21 de agosto de 1994"
10,1,5,292,393,496,889,"21 de agosto de 1994"
10,1,5,293,463,535,998,"21 de agosto de 1994"
10,1,5,294,539,619,1158,"21 de agosto de 1994"
10,1,5,295,424,520,944,"21 de agosto de 1994"
10,1,5,296,519,606,1125,"21 de agosto de 1994"
10,1,5,297,344,423,767,"21 de agosto de 1994"
10,1,5,298,182,190,372,"21 de agosto de 1994"
10,1,5,299,358,425,783,"21 de agosto de 1994"
10,1,5,300,248,323,571,"21 de agosto de 1994"
10,1,5,301,425,506,931,"21 de agosto de 1994"
10,1,5,302,293,349,642,"21 de agosto de 1994"
10,1,5,303,228,302,530,"21 de agosto de 1994"
10,1,5,304,257,300,557,"21 de agosto de 1994"
10,1,5,305,368,383,751,"21 de agosto de 1994"
10,2,7,436,246,309,555,"21 de agosto de 1994"
10,2,7,437,233,253,486,"21 de agosto de 1994"
10,2,7,438,547,519,1066,"21 de agosto de 1994"
10,2,7,439,699,796,1495,"21 de agosto de 1994"
10,2,7,440,397,452,849,"21 de agosto de 1994"
10,2,7,441,268,283,551,"21 de agosto de 1994"
10,2,7,442,310,333,643,"21 de agosto de 1994"
10,2,7,443,629,726,1355,"21 de agosto de 1994"
10,2,7,444,138,141,279,"21 de agosto de 1994"
10,2,7,445,290,325,615,"21 de agosto de 1994"
10,2,7,446,403,443,846,"21 de agosto de 1994"
10,2,7,447,362,406,768,"21 de agosto de 1994"
10,2,7,448,317,320,637,"21 de agosto de 1994"
10,2,7,449,325,360,685,"21 de agosto de 1994"
10,2,7,450,340,397,737,"21 de agosto de 1994"
10,2,7,451,431,484,915,"21 de agosto de 1994"
10,2,7,452,815,869,1684,"21 de agosto de 1994"
10,2,7,453,614,657,1271,"21 de agosto de 1994"
10,2,7,454,327,368,695,"21 de agosto de 1994"
10,2,7,455,261,329,590,"21 de agosto de 1994"
10,2,7,456,139,134,273,"21 de agosto de 1994"
10,2,7,457,123,128,251,"21 de agosto de 1994"
10,2,7,458,311,294,605,"21 de agosto de 1994"
10,2,7,459,435,465,900,"21 de agosto de 1994"
10,2,7,460,419,412,831,"21 de agosto de 1994"
10,2,7,461,423,466,889,"21 de agosto de 1994"
10,2,7,462,385,428,813,"21 de agosto de 1994"
10,2,7,463,331,386,717,"21 de agosto de 1994"
10,2,7,464,442,509,951,"21 de agosto de 1994"
10,2,7,465,217,253,470,"21 de agosto de 1994"
10,2,7,466,233,265,498,"21 de agosto de 1994"
10,2,7,467,490,542,1032,"21 de agosto de 1994"
10,2,7,468,300,345,645,"21 de agosto de 1994"
10,2,7,469,293,345,638,"21 de agosto de 1994"
10,2,7,470,183,214,397,"21 de agosto de 1994"
10,2,7,471,338,363,701,"21 de agosto de 1994"
10,2,7,472,496,546,1042,"21 de agosto de 1994"
10,2,7,473,653,690,1343,"21 de agosto de 1994"
10,2,7,474,542,577,1119,"21 de agosto de 1994"
10,2,7,475,429,487,916,"21 de agosto de 1994"
10,2,7,476,383,439,822,"21 de agosto de 1994"
10,2,7,477,254,294,548,"21 de agosto de 1994"
10,2,7,478,303,296,599,"21 de agosto de 1994"
10,2,7,479,312,371,683,"21 de agosto de 1994"
10,2,7,480,345,387,732,"21 de agosto de 1994"
10,2,7,481,374,430,804,"21 de agosto de 1994"
10,2,7,482,373,431,804,"21 de agosto de 1994"
10,2,7,483,343,385,728,"21 de agosto de 1994"
10,2,7,484,343,409,752,"21 de agosto de 1994"
10,2,7,485,523,542,1065,"21 de agosto de 1994"
10,2,7,486,555,564,1119,"21 de agosto de 1994"
10,2,7,487,343,397,740,"21 de agosto de 1994"
10,2,7,488,340,372,712,"21 de agosto de 1994"
10,2,7,489,259,286,545,"21 de agosto de 1994"
10,2,7,490,312,345,657,"21 de agosto de 1994"
10,2,7,491,544,556,1100,"21 de agosto de 1994"
10,2,7,492,470,477,947,"21 de agosto de 1994"
10,2,7,493,426,510,936,"21 de agosto de 1994"
10,2,7,494,360,451,811,"21 de agosto de 1994"
10,2,7,495,400,451,851,"21 de agosto de 1994"
10,2,7,496,305,351,656,"21 de agosto de 1994"
10,2,7,497,230,284,514,"21 de agosto de 1994"
10,2,7,498,417,490,907,"21 de agosto de 1994"
10,2,7,499,482,542,1024,"21 de agosto de 1994"
10,2,7,500,542,586,1128,"21 de agosto de 1994"
10,2,7,501,492,574,1066,"21 de agosto de 1994"
10,2,7,502,540,674,1214,"21 de agosto de 1994"
10,2,7,503,372,418,790,"21 de agosto de 1994"
10,2,7,504,339,382,721,"21 de agosto de 1994"
10,2,7,505,438,529,967,"21 de agosto de 1994"
10,2,7,506,367,460,827,"21 de agosto de 1994"
10,2,7,507,357,461,818,"21 de agosto de 1994"
10,2,7,508,304,336,640,"21 de agosto de 1994"
10,2,7,509,303,340,643,"21 de agosto de 1994"
10,2,7,510,736,839,1575,"21 de agosto de 1994"
10,2,7,511,299,324,623,"21 de agosto de 1994"
10,2,7,512,287,343,630,"21 de agosto de 1994"
10,2,7,513,396,406,802,"21 de agosto de 1994"
10,2,7,514,304,370,674,"21 de agosto de 1994"
10,2,7,515,520,546,1066,"21 de agosto de 1994"
10,2,7,516,268,295,563,"21 de agosto de 1994"
10,2,7,517,304,385,689,"21 de agosto de 1994"
10,2,7,518,219,272,491,"21 de agosto de 1994"
10,2,7,519,439,555,994,"21 de agosto de 1994"
10,2,7,520,507,604,1111,"21 de agosto de 1994"
10,2,7,521,493,522,1015,"21 de agosto de 1994"
10,2,7,522,359,499,858,"21 de agosto de 1994"
10,2,7,523,308,418,726,"21 de agosto de 1994"
10,2,7,524,259,293,552,"21 de agosto de 1994"
10,2,7,525,557,557,1114,"21 de agosto de 1994"
10,2,7,526,368,397,765,"21 de agosto de 1994"
10,2,7,527,285,339,624,"21 de agosto de 1994"
10,2,7,528,343,387,730,"21 de agosto de 1994"
10,2,7,529,351,448,799,"21 de agosto de 1994"
10,2,7,530,497,536,1033,"21 de agosto de 1994"
10,2,7,531,405,497,902,"21 de agosto de 1994"
10,2,7,532,313,338,651,"21 de agosto de 1994"
10,2,7,533,341,397,738,"21 de agosto de 1994"
10,2,7,534,268,315,583,"21 de agosto de 1994"
10,2,7,535,577,628,1205,"21 de agosto de 1994"
10,2,7,536,457,550,1007,"21 de agosto de 1994"
10,2,7,537,319,391,710,"21 de agosto de 1994"
10,2,7,538,293,374,667,"21 de agosto de 1994"
10,2,7,539,331,385,716,"21 de agosto de 1994"
10,2,7,540,268,285,553,"21 de agosto de 1994"
10,2,7,541,463,508,971,"21 de agosto de 1994"
10,2,7,542,198,236,434,"21 de agosto de 1994"
10,2,7,543,278,313,591,"21 de agosto de 1994"
10,2,7,544,329,400,729,"21 de agosto de 1994"
10,2,7,545,226,230,456,"21 de agosto de 1994"
10,2,7,546,255,333,588,"21 de agosto de 1994"
10,2,7,547,269,292,561,"21 de agosto de 1994"
10,2,7,548,387,413,800,"21 de agosto de 1994"
10,2,7,549,237,270,507,"21 de agosto de 1994"
10,2,7,550,395,421,816,"21 de agosto de 1994"
10,2,7,551,352,396,748,"21 de agosto de 1994"
10,2,7,552,488,541,1029,"21 de agosto de 1994"
10,2,7,553,397,424,821,"21 de agosto de 1994"
10,2,7,554,247,286,533,"21 de agosto de 1994"
10,2,7,555,219,219,438,"21 de agosto de 1994"
10,2,7,556,153,143,296,"21 de agosto de 1994"
10,2,7,557,58,55,113,"21 de agosto de 1994"
10,2,7,558,406,361,767,"21 de agosto de 1994"
10,2,7,559,343,343,686,"21 de agosto de 1994"
10,2,7,560,442,414,856,"21 de agosto de 1994"
10,2,7,561,625,576,1201,"21 de agosto de 1994"
10,2,7,562,478,444,922,"21 de agosto de 1994"
10,2,7,563,223,171,394,"21 de agosto de 1994"
10,2,7,564,335,325,660,"21 de agosto de 1994"
10,2,7,565,391,383,774,"21 de agosto de 1994"
10,2,7,566,461,390,851,"21 de agosto de 1994"
10,2,7,567,461,469,930,"21 de agosto de 1994"
10,2,7,568,127,147,274,"21 de agosto de 1994"
10,2,7,569,364,398,762,"21 de agosto de 1994"
10,2,7,570,327,310,637,"21 de agosto de 1994"
10,2,7,571,516,456,972,"21 de agosto de 1994"
10,2,7,572,327,287,614,"21 de agosto de 1994"
10,2,7,573,275,268,543,"21 de agosto de 1994"
10,2,7,574,681,604,1285,"21 de agosto de 1994"
10,2,7,575,241,226,467,"21 de agosto de 1994"
10,2,7,576,172,149,321,"21 de agosto de 1994"
10,2,7,577,254,222,476,"21 de agosto de 1994"
10,2,7,578,265,247,512,"21 de agosto de 1994"
10,2,7,579,382,380,762,"21 de agosto de 1994"
10,2,7,580,289,288,577,"21 de agosto de 1994"
10,2,7,581,468,429,897,"21 de agosto de 1994"
10,2,7,582,384,384,768,"21 de agosto de 1994"
10,2,7,583,522,509,1031,"21 de agosto de 1994"
10,2,7,584,259,235,494,"21 de agosto de 1994"
10,2,7,585,577,499,1076,"21 de agosto de 1994"
10,2,7,586,251,211,462,"21 de agosto de 1994"
10,2,7,587,140,124,264,"21 de agosto de 1994"
10,2,7,588,562,571,1133,"21 de agosto de 1994"
10,2,7,589,394,409,803,"21 de agosto de 1994"
10,2,7,590,437,406,843,"21 de agosto de 1994"
10,2,7,591,304,288,592,"21 de agosto de 1994"
10,2,7,592,330,292,622,"21 de agosto de 1994"
10,2,7,593,173,171,344,"21 de agosto de 1994"
10,2,7,594,240,253,493,"21 de agosto de 1994"
10,2,7,595,298,296,594,"21 de agosto de 1994"
10,2,7,596,238,211,449,"21 de agosto de 1994"
10,2,7,597,694,639,1333,"21 de agosto de 1994"
10,2,7,598,212,221,433,"21 de agosto de 1994"
10,2,7,599,38,32,70,"21 de agosto de 1994"
10,2,7,600,528,545,1073,"21 de agosto de 1994"
10,2,7,601,585,596,1181,"21 de agosto de 1994"
10,2,7,602,155,132,287,"21 de agosto de 1994"
10,2,7,603,533,553,1086,"21 de agosto de 1994"
10,2,7,604,305,260,565,"21 de agosto de 1994"
10,2,7,605,346,327,673,"21 de agosto de 1994"
10,2,7,606,62,47,109,"21 de agosto de 1994"
10,2,7,607,388,428,816,"21 de agosto de 1994"
10,2,7,608,385,321,706,"21 de agosto de 1994"
10,2,7,609,250,264,514,"21 de agosto de 1994"
10,2,7,610,119,149,268,"21 de agosto de 1994"
10,2,7,611,429,511,940,"21 de agosto de 1994"
10,2,37,1333,437,470,907,"21 de agosto de 1994"
10,2,37,1334,350,349,699,"21 de agosto de 1994"
10,2,37,1335,380,406,786,"21 de agosto de 1994"
10,2,37,1336,240,254,494,"21 de agosto de 1994"
10,2,37,1337,291,315,606,"21 de agosto de 1994"
10,2,37,1338,305,336,641,"21 de agosto de 1994"
10,2,37,1339,339,368,707,"21 de agosto de 1994"
10,2,37,1340,219,271,490,"21 de agosto de 1994"
10,2,37,1341,233,267,500,"21 de agosto de 1994"
10,2,37,1342,119,115,234,"21 de agosto de 1994"
10,2,37,1343,65,44,109,"21 de agosto de 1994"
10,2,37,1344,231,216,447,"21 de agosto de 1994"
10,2,37,1345,79,58,137,"21 de agosto de 1994"
10,2,37,1346,169,221,390,"21 de agosto de 1994"
10,2,37,1347,397,410,807,"21 de agosto de 1994"
10,2,37,1348,60,62,122,"21 de agosto de 1994"
10,2,37,1349,174,177,351,"21 de agosto de 1994"
10,2,37,1350,63,54,117,"21 de agosto de 1994"
10,2,37,1351,25,30,55,"21 de agosto de 1994"
10,2,37,1352,253,231,484,"21 de agosto de 1994"
10,2,37,1353,514,487,1001,"21 de agosto de 1994"
10,2,37,1354,376,402,778,"21 de agosto de 1994"
10,2,37,1355,96,112,208,"21 de agosto de 1994"
10,2,37,1356,137,112,249,"21 de agosto de 1994"
10,2,37,1357,322,342,664,"21 de agosto de 1994"
10,2,37,1358,340,356,696,"21 de agosto de 1994"
10,2,37,1359,337,328,665,"21 de agosto de 1994"
10,3,1,1,271,333,604,"21 de agosto de 1994"
10,3,1,2,386,465,851,"21 de agosto de 1994"
10,3,1,3,337,398,735,"21 de agosto de 1994"
10,3,1,4,211,224,435,"21 de agosto de 1994"
10,3,1,5,407,491,898,"21 de agosto de 1994"
10,3,1,6,524,598,1122,"21 de agosto de 1994"
10,3,1,7,210,247,457,"21 de agosto de 1994"
10,3,1,8,371,377,748,"21 de agosto de 1994"
10,3,1,9,286,302,588,"21 de agosto de 1994"
10,3,1,10,83,77,160,"21 de agosto de 1994"
10,3,1,11,75,69,144,"21 de agosto de 1994"
10,3,1,12,75,80,155,"21 de agosto de 1994"
10,3,1,13,306,303,609,"21 de agosto de 1994"
10,3,1,14,189,193,382,"21 de agosto de 1994"
10,3,1,15,298,316,614,"21 de agosto de 1994"
10,3,1,16,115,104,219,"21 de agosto de 1994"
10,3,1,17,56,44,100,"21 de agosto de 1994"
10,3,1,18,29,22,51,"21 de agosto de 1994"
10,3,1,19,48,47,95,"21 de agosto de 1994"
10,3,1,20,135,129,264,"21 de agosto de 1994"
10,3,1,21,61,62,123,"21 de agosto de 1994"
10,3,1,22,445,402,847,"21 de agosto de 1994"
10,3,1,23,198,170,368,"21 de agosto de 1994"
10,3,1,24,150,162,312,"21 de agosto de 1994"
10,3,1,25,244,208,452,"21 de agosto de 1994"
10,3,1,26,419,415,834,"21 de agosto de 1994"
10,3,1,27,409,383,792,"21 de agosto de 1994"
10,3,1,28,208,237,445,"21 de agosto de 1994"
10,3,1,29,390,396,786,"21 de agosto de 1994"
10,3,1,30,417,395,812,"21 de agosto de 1994"
10,3,1,31,252,245,497,"21 de agosto de 1994"
10,3,1,32,172,160,332,"21 de agosto de 1994"
10,3,1,33,127,108,235,"21 de agosto de 1994"
10,3,1,34,92,74,166,"21 de agosto de 1994"
10,3,1,35,108,88,196,"21 de agosto de 1994"
10,3,1,36,37,31,68,"21 de agosto de 1994"
10,3,1,37,403,449,852,"21 de agosto de 1994"
10,3,1,38,223,226,449,"21 de agosto de 1994"
10,3,1,39,91,80,171,"21 de agosto de 1994"
10,3,1,40,205,182,387,"21 de agosto de 1994"
10,3,1,41,20,10,30,"21 de agosto de 1994"
10,3,2,42,192,190,382,"21 de agosto de 1994"
10,3,2,43,41,15,56,"21 de agosto de 1994"
10,3,2,44,63,61,124,"21 de agosto de 1994"
10,3,2,45,26,30,56,"21 de agosto de 1994"
10,3,2,46,44,36,80,"21 de agosto de 1994"
10,3,2,47,60,62,122,"21 de agosto de 1994"
10,3,2,48,57,53,110,"21 de agosto de 1994"
10,3,2,49,26,13,39,"21 de agosto de 1994"
10,3,2,50,37,39,76,"21 de agosto de 1994"
10,3,2,51,28,14,42,"21 de agosto de 1994"
10,3,2,52,48,29,77,"21 de agosto de 1994"
10,3,2,53,74,67,141,"21 de agosto de 1994"
10,3,2,54,33,28,61,"21 de agosto de 1994"
10,3,2,55,106,91,197,"21 de agosto de 1994"
10,3,2,56,114,115,229,"21 de agosto de 1994"
10,3,9,638,283,302,585,"21 de agosto de 1994"
10,3,9,639,181,211,392,"21 de agosto de 1994"
10,3,9,640,80,49,129,"21 de agosto de 1994"
10,3,9,641,134,113,247,"21 de agosto de 1994"
10,3,9,642,158,127,285,"21 de agosto de 1994"
10,3,9,643,119,78,197,"21 de agosto de 1994"
10,3,9,644,334,257,591,"21 de agosto de 1994"
10,3,9,645,67,51,118,"21 de agosto de 1994"
10,3,9,646,82,57,139,"21 de agosto de 1994"
10,3,9,647,49,41,90,"21 de agosto de 1994"
10,3,9,648,27,35,62,"21 de agosto de 1994"
10,3,9,649,48,44,92,"21 de agosto de 1994"
10,3,9,650,28,36,64,"21 de agosto de 1994"
10,3,9,651,61,74,135,"21 de agosto de 1994"
10,3,9,652,27,33,60,"21 de agosto de 1994"
10,3,9,653,132,97,229,"21 de agosto de 1994"
10,3,9,654,209,111,320,"21 de agosto de 1994"
10,3,9,655,89,95,184,"21 de agosto de 1994"
10,3,9,656,195,138,333,"21 de agosto de 1994"
10,3,9,657,34,34,68,"21 de agosto de 1994"
10,3,9,658,91,61,152,"21 de agosto de 1994"
10,3,9,659,125,117,242,"21 de agosto de 1994"
10,3,9,660,53,53,106,"21 de agosto de 1994"
10,3,9,661,219,203,422,"21 de agosto de 1994"
10,3,9,662,81,65,146,"21 de agosto de 1994"
10,3,9,663,70,80,150,"21 de agosto de 1994"
10,3,17,866,306,380,686,"21 de agosto de 1994"
10,3,17,867,145,194,339,"21 de agosto de 1994"
10,3,17,868,354,427,781,"21 de agosto de 1994"
10,3,17,869,428,522,950,"21 de agosto de 1994"
10,3,17,870,277,325,602,"21 de agosto de 1994"
10,3,17,871,174,199,373,"21 de agosto de 1994"
10,3,17,872,234,231,465,"21 de agosto de 1994"
10,3,17,873,106,109,215,"21 de agosto de 1994"
10,3,17,874,234,241,475,"21 de agosto de 1994"
10,3,17,875,169,206,375,"21 de agosto de 1994"
10,3,17,876,132,123,255,"21 de agosto de 1994"
10,3,17,877,154,159,313,"21 de agosto de 1994"
10,3,17,878,111,106,217,"21 de agosto de 1994"
10,3,17,879,238,225,463,"21 de agosto de 1994"
10,3,17,880,154,165,319,"21 de agosto de 1994"
10,3,17,881,253,284,537,"21 de agosto de 1994"
10,3,17,882,185,224,409,"21 de agosto de 1994"
10,3,17,883,100,80,180,"21 de agosto de 1994"
10,3,17,884,155,139,294,"21 de agosto de 1994"
10,3,17,885,108,102,210,"21 de agosto de 1994"
10,3,17,886,153,176,329,"21 de agosto de 1994"
10,3,17,887,223,198,421,"21 de agosto de 1994"
10,3,17,888,263,262,525,"21 de agosto de 1994"
10,3,17,889,124,132,256,"21 de agosto de 1994"
10,3,17,890,251,244,495,"21 de agosto de 1994"
10,3,17,891,401,426,827,"21 de agosto de 1994"
10,3,17,892,50,51,101,"21 de agosto de 1994"
10,3,17,893,73,58,131,"21 de agosto de 1994"
10,3,17,894,210,215,425,"21 de agosto de 1994"
10,3,20,947,216,205,421,"21 de agosto de 1994"
10,3,20,948,111,90,201,"21 de agosto de 1994"
10,3,20,949,40,34,74,"21 de agosto de 1994"
10,3,20,950,95,78,173,"21 de agosto de 1994"
10,3,20,951,60,29,89,"21 de agosto de 1994"
10,3,20,952,94,54,148,"21 de agosto de 1994"
10,3,20,953,70,70,140,"21 de agosto de 1994"
10,3,20,954,114,94,208,"21 de agosto de 1994"
10,3,20,955,76,79,155,"21 de agosto de 1994"
10,3,20,956,58,37,95,"21 de agosto de 1994"
10,3,20,957,35,30,65,"21 de agosto de 1994"
10,3,20,958,41,32,73,"21 de agosto de 1994"
10,3,20,959,97,110,207,"21 de agosto de 1994"
10,3,20,960,20,22,42,"21 de agosto de 1994"
10,3,26,1086,254,274,528,"21 de agosto de 1994"
10,3,26,1087,81,75,156,"21 de agosto de 1994"
10,3,26,1088,104,90,194,"21 de agosto de 1994"
10,3,26,1089,113,100,213,"21 de agosto de 1994"
10,3,26,1090,59,37,96,"21 de agosto de 1994"
10,3,26,1091,43,39,82,"21 de agosto de 1994"
10,3,26,1092,115,93,208,"21 de agosto de 1994"
10,3,26,1093,120,95,215,"21 de agosto de 1994"
10,3,26,1094,134,120,254,"21 de agosto de 1994"
10,3,26,1095,116,85,201,"21 de agosto de 1994"
10,3,26,1096,124,139,263,"21 de agosto de 1994"
10,3,26,1097,139,126,265,"21 de agosto de 1994"
10,3,33,1200,191,201,392,"21 de agosto de 1994"
10,3,33,1201,322,341,663,"21 de agosto de 1994"
10,3,33,1202,268,297,565,"21 de agosto de 1994"
10,3,33,1203,259,295,554,"21 de agosto de 1994"
10,3,33,1204,348,415,763,"21 de agosto de 1994"
10,3,33,1205,405,450,855,"21 de agosto de 1994"
10,3,33,1206,180,221,401,"21 de agosto de 1994"
10,3,33,1207,112,118,230,"21 de agosto de 1994"
10,3,33,1208,330,369,699,"21 de agosto de 1994"
10,3,33,1209,239,260,499,"21 de agosto de 1994"
10,3,33,1210,239,275,514,"21 de agosto de 1994"
10,3,33,1211,204,241,445,"21 de agosto de 1994"
10,3,33,1212,515,550,1065,"21 de agosto de 1994"
10,3,33,1213,235,232,467,"21 de agosto de 1994"
10,3,33,1214,192,208,400,"21 de agosto de 1994"
10,3,33,1215,64,94,158,"21 de agosto de 1994"
10,3,33,1216,24,20,44,"21 de agosto de 1994"
10,3,33,1217,53,62,115,"21 de agosto de 1994"
10,3,33,1218,49,53,102,"21 de agosto de 1994"
10,3,33,1219,287,287,574,"21 de agosto de 1994"
10,3,33,1220,178,212,390,"21 de agosto de 1994"
10,3,33,1221,58,58,116,"21 de agosto de 1994"
10,3,33,1222,222,241,463,"21 de agosto de 1994"
10,3,33,1223,29,28,57,"21 de agosto de 1994"
10,3,33,1224,168,201,369,"21 de agosto de 1994"
10,3,33,1225,80,119,199,"21 de agosto de 1994"
10,3,33,1226,64,67,131,"21 de agosto de 1994"
10,3,33,1227,80,82,162,"21 de agosto de 1994"
10,3,33,1228,90,97,187,"21 de agosto de 1994"
10,3,33,1229,171,200,371,"21 de agosto de 1994"
10,3,33,1230,63,59,122,"21 de agosto de 1994"
10,3,33,1231,128,114,242,"21 de agosto de 1994"
10,3,33,1232,96,78,174,"21 de agosto de 1994"
10,3,33,1233,101,87,188,"21 de agosto de 1994"
10,3,33,1234,157,133,290,"21 de agosto de 1994"
10,3,33,1235,172,152,324,"21 de agosto de 1994"
10,3,33,1236,284,243,527,"21 de agosto de 1994"
10,3,33,1237,84,114,198,"21 de agosto de 1994"
10,3,33,1238,159,191,350,"21 de agosto de 1994"
10,3,33,1239,561,28,589,"21 de agosto de 1994"
10,3,33,1240,210,216,426,"21 de agosto de 1994"
10,3,33,1241,94,87,181,"21 de agosto de 1994"
10,3,33,1242,168,182,350,"21 de agosto de 1994"
10,3,33,1243,164,208,372,"21 de agosto de 1994"
10,3,33,1244,183,197,380,"21 de agosto de 1994"
10,3,33,1245,222,240,462,"21 de agosto de 1994"
10,3,33,1246,107,100,207,"21 de agosto de 1994"
10,3,33,1247,65,90,155,"21 de agosto de 1994"
10,3,33,1248,93,115,208,"21 de agosto de 1994"
10,3,33,1249,192,230,422,"21 de agosto de 1994"
10,3,33,1250,137,162,299,"21 de agosto de 1994"
10,3,33,1251,69,59,128,"21 de agosto de 1994"
10,3,33,1252,31,25,56,"21 de agosto de 1994"
10,3,33,1253,82,66,148,"21 de agosto de 1994"
10,3,33,1254,25,17,42,"21 de agosto de 1994"
10,3,33,1255,83,67,150,"21 de agosto de 1994"
10,3,33,1256,31,27,58,"21 de agosto de 1994"
10,3,33,1257,129,106,235,"21 de agosto de 1994"
10,3,33,1258,98,118,216,"21 de agosto de 1994"
10,3,33,1259,122,119,241,"21 de agosto de 1994"
10,3,33,1260,300,344,644,"21 de agosto de 1994"
10,3,33,1261,157,164,321,"21 de agosto de 1994"
10,3,33,1262,27,8,35,"21 de agosto de 1994"
10,3,35,1274,318,273,591,"21 de agosto de 1994"
10,3,35,1275,312,237,549,"21 de agosto de 1994"
10,3,35,1276,121,76,197,"21 de agosto de 1994"
10,3,35,1277,261,227,488,"21 de agosto de 1994"
10,3,35,1278,61,55,116,"21 de agosto de 1994"
10,3,35,1279,162,130,292,"21 de agosto de 1994"
10,3,35,1280,129,131,260,"21 de agosto de 1994"
10,3,35,1281,254,219,473,"21 de agosto de 1994"
10,3,35,1282,142,102,244,"21 de agosto de 1994"
10,3,35,1283,91,65,156,"21 de agosto de 1994"
10,3,35,1284,105,72,177,"21 de agosto de 1994"
10,3,35,1285,207,156,363,"21 de agosto de 1994"
10,3,35,1286,202,147,349,"21 de agosto de 1994"
10,3,35,1287,148,102,250,"21 de agosto de 1994"
10,3,35,1288,135,77,212,"21 de agosto de 1994"
10,3,35,1289,203,129,332,"21 de agosto de 1994"
10,3,35,1290,319,238,557,"21 de agosto de 1994"
10,3,35,1291,54,34,88,"21 de agosto de 1994"
10,3,35,1292,176,146,322,"21 de agosto de 1994"
10,3,35,1293,175,104,279,"21 de agosto de 1994"
10,3,35,1294,209,175,384,"21 de agosto de 1994"
10,3,35,1295,103,92,195,"21 de agosto de 1994"
10,3,35,1296,60,24,84,"21 de agosto de 1994"
10,3,35,1297,79,72,151,"21 de agosto de 1994"
10,3,35,1298,214,165,379,"21 de agosto de 1994"
10,3,35,1299,258,161,419,"21 de agosto de 1994"
10,3,35,1300,334,217,551,"21 de agosto de 1994"
10,3,35,1301,74,30,104,"21 de agosto de 1994"
10,3,35,1302,36,30,66,"21 de agosto de 1994"
10,3,35,1303,12,4,16,"21 de agosto de 1994"
10,3,35,1304,93,47,140,"21 de agosto de 1994"
10,3,35,1305,36,23,59,"21 de agosto de 1994"
10,3,36,1306,241,256,497,"21 de agosto de 1994"
10,3,36,1307,174,201,375,"21 de agosto de 1994"
10,3,36,1308,154,191,345,"21 de agosto de 1994"
10,3,36,1309,321,340,661,"21 de agosto de 1994"
10,3,36,1310,252,283,535,"21 de agosto de 1994"
10,3,36,1311,188,183,371,"21 de agosto de 1994"
10,3,36,1312,195,245,440,"21 de agosto de 1994"
10,3,36,1313,82,82,164,"21 de agosto de 1994"
10,3,36,1314,68,62,130,"21 de agosto de 1994"
10,3,36,1315,161,113,274,"21 de agosto de 1994"
10,3,36,1316,112,85,197,"21 de agosto de 1994"
10,3,36,1317,93,101,194,"21 de agosto de 1994"
10,3,36,1318,108,131,239,"21 de agosto de 1994"
10,3,36,1319,127,125,252,"21 de agosto de 1994"
10,3,36,1320,54,73,127,"21 de agosto de 1994"
10,3,36,1321,134,159,293,"21 de agosto de 1994"
10,3,36,1322,70,105,175,"21 de agosto de 1994"
10,3,36,1323,61,103,164,"21 de agosto de 1994"
10,3,36,1324,157,172,329,"21 de agosto de 1994"
10,3,36,1325,107,153,260,"21 de agosto de 1994"
10,3,36,1326,178,241,419,"21 de agosto de 1994"
10,3,36,1327,39,50,89,"21 de agosto de 1994"
10,3,36,1328,60,76,136,"21 de agosto de 1994"
10,3,36,1329,112,133,245,"21 de agosto de 1994"
10,3,36,1330,192,245,437,"21 de agosto de 1994"
10,3,36,1331,60,76,136,"21 de agosto de 1994"
10,3,36,1332,53,44,97,"21 de agosto de 1994"
10,3,38,1360,230,216,446,"21 de agosto de 1994"
10,3,38,1361,143,142,285,"21 de agosto de 1994"
10,3,38,1362,179,188,367,"21 de agosto de 1994"
10,3,38,1363,67,55,122,"21 de agosto de 1994"
10,3,38,1364,59,51,110,"21 de agosto de 1994"
10,3,38,1365,160,114,274,"21 de agosto de 1994"
10,3,38,1366,41,15,56,"21 de agosto de 1994"
10,3,38,1367,72,73,145,"21 de agosto de 1994"
10,3,38,1368,101,60,161,"21 de agosto de 1994"
10,3,38,1369,276,249,525,"21 de agosto de 1994"
10,3,38,1370,98,86,184,"21 de agosto de 1994"
10,3,38,1371,110,119,229,"21 de agosto de 1994"
10,3,38,1372,141,146,287,"21 de agosto de 1994"
10,3,38,1373,232,191,423,"21 de agosto de 1994"
10,4,3,57,199,223,422,"21 de agosto de 1994"
10,4,3,58,117,120,237,"21 de agosto de 1994"
10,4,3,59,59,55,114,"21 de agosto de 1994"
10,4,3,60,131,132,263,"21 de agosto de 1994"
10,4,3,61,43,53,96,"21 de agosto de 1994"
10,4,3,62,85,94,179,"21 de agosto de 1994"
10,4,3,63,245,265,510,"21 de agosto de 1994"
10,4,3,64,94,87,181,"21 de agosto de 1994"
10,4,3,65,143,136,279,"21 de agosto de 1994"
10,4,4,66,484,529,1013,"21 de agosto de 1994"
10,4,4,67,292,315,607,"21 de agosto de 1994"
10,4,4,68,318,325,643,"21 de agosto de 1994"
10,4,4,69,565,617,1182,"21 de agosto de 1994"
10,4,4,70,275,283,558,"21 de agosto de 1994"
10,4,4,71,37,30,67,"21 de agosto de 1994"
10,4,4,72,193,210,403,"21 de agosto de 1994"
10,4,4,73,416,383,799,"21 de agosto de 1994"
10,4,4,74,101,117,218,"21 de agosto de 1994"
10,4,4,75,333,329,662,"21 de agosto de 1994"
10,4,4,76,426,369,795,"21 de agosto de 1994"
10,4,4,77,62,52,114,"21 de agosto de 1994"
10,4,4,78,195,178,373,"21 de agosto de 1994"
10,4,4,79,97,89,186,"21 de agosto de 1994"
10,4,4,80,389,357,746,"21 de agosto de 1994"
10,4,4,81,88,68,156,"21 de agosto de 1994"
10,4,4,82,75,73,148,"21 de agosto de 1994"
10,4,4,83,102,115,217,"21 de agosto de 1994"
10,4,4,84,108,96,204,"21 de agosto de 1994"
10,4,4,85,89,65,154,"21 de agosto de 1994"
10,4,4,86,108,101,209,"21 de agosto de 1994"
10,4,4,87,197,197,394,"21 de agosto de 1994"
10,4,4,88,40,28,68,"21 de agosto de 1994"
10,4,4,89,119,124,243,"21 de agosto de 1994"
10,4,4,90,107,108,215,"21 de agosto de 1994"
10,4,4,91,99,107,206,"21 de agosto de 1994"
10,4,4,92,57,46,103,"21 de agosto de 1994"
10,4,4,93,58,43,101,"21 de agosto de 1994"
10,4,4,94,263,266,529,"21 de agosto de 1994"
10,4,4,95,347,350,697,"21 de agosto de 1994"
10,4,4,96,195,170,365,"21 de agosto de 1994"
10,4,4,97,220,239,459,"21 de agosto de 1994"
10,4,4,98,38,18,56,"21 de agosto de 1994"
10,4,4,99,414,408,822,"21 de agosto de 1994"
10,4,4,100,391,391,782,"21 de agosto de 1994"
10,4,4,101,189,186,375,"21 de agosto de 1994"
10,4,4,102,213,172,385,"21 de agosto de 1994"
10,4,4,103,237,220,457,"21 de agosto de 1994"
10,4,4,104,82,88,170,"21 de agosto de 1994"
10,4,4,105,239,257,496,"21 de agosto de 1994"
10,4,4,106,210,187,397,"21 de agosto de 1994"
10,4,4,107,56,52,108,"21 de agosto de 1994"
10,4,6,420,304,326,630,"21 de agosto de 1994"
10,4,6,421,32,32,64,"21 de agosto de 1994"
10,4,6,422,270,245,515,"21 de agosto de 1994"
10,4,6,423,78,62,140,"21 de agosto de 1994"
10,4,6,424,262,246,508,"21 de agosto de 1994"
10,4,6,425,138,122,260,"21 de agosto de 1994"
10,4,6,426,224,226,450,"21 de agosto de 1994"
10,4,6,427,132,130,262,"21 de agosto de 1994"
10,4,6,428,102,93,195,"21 de agosto de 1994"
10,4,6,429,202,209,411,"21 de agosto de 1994"
10,4,6,430,184,184,368,"21 de agosto de 1994"
10,4,6,431,269,305,574,"21 de agosto de 1994"
10,4,6,432,50,34,84,"21 de agosto de 1994"
10,4,6,433,77,67,144,"21 de agosto de 1994"
10,4,6,434,51,60,111,"21 de agosto de 1994"
10,4,6,435,354,459,813,"21 de agosto de 1994"
10,4,8,612,486,542,1028,"21 de agosto de 1994"
10,4,8,613,329,381,710,"21 de agosto de 1994"
10,4,8,614,531,590,1121,"21 de agosto de 1994"
10,4,8,615,465,518,983,"21 de agosto de 1994"
10,4,8,616,351,395,746,"21 de agosto de 1994"
10,4,8,617,295,353,648,"21 de agosto de 1994"
10,4,8,618,228,259,487,"21 de agosto de 1994"
10,4,8,619,353,393,746,"21 de agosto de 1994"
10,4,8,620,250,274,524,"21 de agosto de 1994"
10,4,8,621,295,307,602,"21 de agosto de 1994"
10,4,8,622,280,221,501,"21 de agosto de 1994"
10,4,8,623,41,35,76,"21 de agosto de 1994"
10,4,8,624,290,290,580,"21 de agosto de 1994"
10,4,8,625,382,379,761,"21 de agosto de 1994"
10,4,8,626,140,150,290,"21 de agosto de 1994"
10,4,8,627,166,156,322,"21 de agosto de 1994"
10,4,8,628,461,445,906,"21 de agosto de 1994"
10,4,8,629,420,421,841,"21 de agosto de 1994"
10,4,8,630,494,502,996,"21 de agosto de 1994"
10,4,8,631,184,189,373,"21 de agosto de 1994"
10,4,8,632,316,290,606,"21 de agosto de 1994"
10,4,8,633,306,294,600,"21 de agosto de 1994"
10,4,8,634,339,395,734,"21 de agosto de 1994"
10,4,8,635,442,424,866,"21 de agosto de 1994"
10,4,8,636,552,559,1111,"21 de agosto de 1994"
10,4,8,637,160,152,312,"21 de agosto de 1994"
10,4,21,961,271,352,623,"21 de agosto de 1994"
10,4,21,962,290,331,621,"21 de agosto de 1994"
10,4,21,963,333,402,735,"21 de agosto de 1994"
10,4,21,964,282,278,560,"21 de agosto de 1994"
10,4,21,965,237,233,470,"21 de agosto de 1994"
10,4,21,966,87,99,186,"21 de agosto de 1994"
10,4,21,967,401,385,786,"21 de agosto de 1994"
10,4,21,968,239,212,451,"21 de agosto de 1994"
10,4,21,969,199,220,419,"21 de agosto de 1994"
10,4,21,970,99,101,200,"21 de agosto de 1994"
10,4,21,971,254,260,514,"21 de agosto de 1994"
10,4,21,972,288,286,574,"21 de agosto de 1994"
10,4,21,973,162,215,377,"21 de agosto de 1994"
10,4,21,974,139,132,271,"21 de agosto de 1994"
10,4,21,975,126,139,265,"21 de agosto de 1994"
10,4,21,976,76,88,164,"21 de agosto de 1994"
10,4,22,977,303,264,567,"21 de agosto de 1994"
10,4,22,978,253,234,487,"21 de agosto de 1994"
10,4,22,979,322,321,643,"21 de agosto de 1994"
10,4,22,980,488,486,974,"21 de agosto de 1994"
10,4,22,981,43,34,77,"21 de agosto de 1994"
10,4,22,982,69,44,113,"21 de agosto de 1994"
10,4,22,983,138,122,260,"21 de agosto de 1994"
10,4,22,984,25,21,46,"21 de agosto de 1994"
10,4,22,985,142,99,241,"21 de agosto de 1994"
10,4,22,986,195,180,375,"21 de agosto de 1994"
10,4,22,987,57,52,109,"21 de agosto de 1994"
10,4,22,988,54,49,103,"21 de agosto de 1994"
10,4,22,989,230,252,482,"21 de agosto de 1994"
10,4,22,990,265,271,536,"21 de agosto de 1994"
10,4,22,991,232,254,486,"21 de agosto de 1994"
10,4,23,992,341,355,696,"21 de agosto de 1994"
10,4,23,993,541,598,1139,"21 de agosto de 1994"
10,4,23,994,501,492,993,"21 de agosto de 1994"
10,4,23,995,645,686,1331,"21 de agosto de 1994"
10,4,23,996,363,383,746,"21 de agosto de 1994"
10,4,23,997,246,269,515,"21 de agosto de 1994"
10,4,23,998,206,208,414,"21 de agosto de 1994"
10,4,23,999,209,211,420,"21 de agosto de 1994"
10,4,23,1000,442,464,906,"21 de agosto de 1994"
10,4,23,1001,247,250,497,"21 de agosto de 1994"
10,4,23,1002,206,234,440,"21 de agosto de 1994"
10,4,23,1003,301,298,599,"21 de agosto de 1994"
10,4,23,1004,290,242,532,"21 de agosto de 1994"
10,4,23,1005,337,322,659,"21 de agosto de 1994"
10,4,23,1006,261,225,486,"21 de agosto de 1994"
10,4,23,1007,184,203,387,"21 de agosto de 1994"
10,4,23,1008,266,304,570,"21 de agosto de 1994"
10,4,23,1009,189,196,385,"21 de agosto de 1994"
10,4,23,1010,357,341,698,"21 de agosto de 1994"
10,4,23,1011,81,73,154,"21 de agosto de 1994"
10,4,23,1012,134,159,293,"21 de agosto de 1994"
10,4,23,1013,244,305,549,"21 de agosto de 1994"
10,4,23,1014,269,291,560,"21 de agosto de 1994"
10,4,25,1063,329,393,722,"21 de agosto de 1994"
10,4,25,1064,301,350,651,"21 de agosto de 1994"
10,4,25,1065,257,288,545,"21 de agosto de 1994"
10,4,25,1066,101,87,188,"21 de agosto de 1994"
10,4,25,1067,69,69,138,"21 de agosto de 1994"
10,4,25,1068,330,361,691,"21 de agosto de 1994"
10,4,25,1069,118,122,240,"21 de agosto de 1994"
10,4,25,1070,160,139,299,"21 de agosto de 1994"
10,4,25,1071,209,198,407,"21 de agosto de 1994"
10,4,25,1072,47,48,95,"21 de agosto de 1994"
10,4,25,1073,50,53,103,"21 de agosto de 1994"
10,4,25,1074,45,44,89,"21 de agosto de 1994"
10,4,25,1075,118,115,233,"21 de agosto de 1994"
10,4,25,1076,46,38,84,"21 de agosto de 1994"
10,4,25,1077,77,75,152,"21 de agosto de 1994"
10,4,25,1078,97,84,181,"21 de agosto de 1994"
10,4,25,1079,119,106,225,"21 de agosto de 1994"
10,4,25,1080,235,226,461,"21 de agosto de 1994"
10,4,25,1081,143,125,268,"21 de agosto de 1994"
10,4,25,1082,143,134,277,"21 de agosto de 1994"
10,4,25,1083,254,239,493,"21 de agosto de 1994"
10,4,25,1084,83,83,166,"21 de agosto de 1994"
10,4,25,1085,24,25,49,"21 de agosto de 1994"
10,4,28,1140,195,227,422,"21 de agosto de 1994"
10,4,28,1141,251,275,526,"21 de agosto de 1994"
10,4,28,1142,33,24,57,"21 de agosto de 1994"
10,4,28,1143,83,73,156,"21 de agosto de 1994"
10,4,28,1144,87,72,159,"21 de agosto de 1994"
10,4,28,1145,65,58,123,"21 de agosto de 1994"
10,4,28,1146,44,38,82,"21 de agosto de 1994"
10,4,28,1147,145,187,332,"21 de agosto de 1994"
10,4,28,1148,95,109,204,"21 de agosto de 1994"
10,4,28,1149,59,53,112,"21 de agosto de 1994"
10,4,28,1150,115,112,227,"21 de agosto de 1994"
10,4,28,1151,188,166,354,"21 de agosto de 1994"
10,4,28,1152,103,114,217,"21 de agosto de 1994"
10,4,28,1153,19,31,50,"21 de agosto de 1994"
10,4,28,1154,56,68,124,"21 de agosto de 1994"
10,4,28,1155,47,44,91,"21 de agosto de 1994"
10,4,29,1156,304,316,620,"21 de agosto de 1994"
10,4,29,1157,301,296,597,"21 de agosto de 1994"
10,4,29,1158,230,268,498,"21 de agosto de 1994"
10,4,29,1159,73,65,138,"21 de agosto de 1994"
10,4,29,1160,218,231,449,"21 de agosto de 1994"
10,4,29,1161,163,166,329,"21 de agosto de 1994"
10,4,29,1162,96,108,204,"21 de agosto de 1994"
10,4,29,1163,97,98,195,"21 de agosto de 1994"
10,4,29,1164,81,68,149,"21 de agosto de 1994"
10,4,29,1165,93,92,185,"21 de agosto de 1994"
10,4,29,1166,88,96,184,"21 de agosto de 1994"
10,4,29,1167,198,210,408,"21 de agosto de 1994"
10,4,29,1168,107,103,210,"21 de agosto de 1994"
10,4,29,1169,289,290,579,"21 de agosto de 1994"
10,4,29,1170,59,43,102,"21 de agosto de 1994"
10,4,29,1171,222,262,484,"21 de agosto de 1994"
10,4,29,1172,194,174,368,"21 de agosto de 1994"
10,4,29,1173,147,171,318,"21 de agosto de 1994"
10,4,29,1174,162,164,326,"21 de agosto de 1994"
10,4,29,1175,59,77,136,"21 de agosto de 1994"
10,4,29,1176,88,70,158,"21 de agosto de 1994"
10,4,29,1177,49,45,94,"21 de agosto de 1994"
10,4,29,1178,39,33,72,"21 de agosto de 1994"
10,4,32,1191,192,194,386,"21 de agosto de 1994"
10,4,32,1192,503,504,1007,"21 de agosto de 1994"
10,4,32,1193,242,270,512,"21 de agosto de 1994"
10,4,32,1194,161,186,347,"21 de agosto de 1994"
10,4,32,1195,141,120,261,"21 de agosto de 1994"
10,4,32,1196,27,29,56,"21 de agosto de 1994"
10,4,32,1197,265,237,502,"21 de agosto de 1994"
10,4,32,1198,143,138,281,"21 de agosto de 1994"
10,4,32,1199,271,274,545,"21 de agosto de 1994"
10,5,5,136,1,0,1,"21 de agosto de 1994"
10,5,5,306,440,512,952,"21 de agosto de 1994"
10,5,5,307,396,539,935,"21 de agosto de 1994"
10,5,5,308,426,529,955,"21 de agosto de 1994"
10,5,5,309,424,567,991,"21 de agosto de 1994"
10,5,5,310,380,471,851,"21 de agosto de 1994"
10,5,5,311,302,372,674,"21 de agosto de 1994"
10,5,5,312,484,618,1102,"21 de agosto de 1994"
10,5,5,313,305,333,638,"21 de agosto de 1994"
10,5,5,314,352,399,751,"21 de agosto de 1994"
10,5,5,315,596,689,1285,"21 de agosto de 1994"
10,5,5,316,601,736,1337,"21 de agosto de 1994"
10,5,5,317,254,298,552,"21 de agosto de 1994"
10,5,5,318,236,285,521,"21 de agosto de 1994"
10,5,5,319,605,771,1376,"21 de agosto de 1994"
10,5,5,320,509,606,1115,"21 de agosto de 1994"
10,5,5,321,458,557,1015,"21 de agosto de 1994"
10,5,5,322,190,273,463,"21 de agosto de 1994"
10,5,5,323,379,424,803,"21 de agosto de 1994"
10,5,5,324,358,412,770,"21 de agosto de 1994"
10,5,5,325,532,590,1122,"21 de agosto de 1994"
10,5,5,326,216,267,483,"21 de agosto de 1994"
10,5,5,327,598,704,1302,"21 de agosto de 1994"
10,5,5,328,512,635,1147,"21 de agosto de 1994"
10,5,5,329,313,383,696,"21 de agosto de 1994"
10,5,5,330,369,401,770,"21 de agosto de 1994"
10,5,5,331,446,487,933,"21 de agosto de 1994"
10,5,5,332,411,481,892,"21 de agosto de 1994"
10,5,5,333,387,476,863,"21 de agosto de 1994"
10,5,5,334,416,471,887,"21 de agosto de 1994"
10,5,5,335,424,504,928,"21 de agosto de 1994"
10,5,5,336,499,527,1026,"21 de agosto de 1994"
10,5,5,337,342,432,774,"21 de agosto de 1994"
10,5,5,338,372,461,833,"21 de agosto de 1994"
10,5,5,339,257,307,564,"21 de agosto de 1994"
10,5,5,340,101,127,228,"21 de agosto de 1994"
10,5,5,341,242,276,518,"21 de agosto de 1994"
10,5,5,342,185,219,404,"21 de agosto de 1994"
10,5,5,343,275,324,599,"21 de agosto de 1994"
10,5,5,344,550,633,1183,"21 de agosto de 1994"
10,5,5,345,412,480,892,"21 de agosto de 1994"
10,5,5,346,390,446,836,"21 de agosto de 1994"
10,5,5,347,427,455,882,"21 de agosto de 1994"
10,5,5,348,199,233,432,"21 de agosto de 1994"
10,5,5,349,213,247,460,"21 de agosto de 1994"
10,5,5,350,155,188,343,"21 de agosto de 1994"
10,5,5,351,169,210,379,"21 de agosto de 1994"
10,5,5,352,98,79,177,"21 de agosto de 1994"
10,5,5,353,94,78,172,"21 de agosto de 1994"
10,5,5,354,312,308,620,"21 de agosto de 1994"
10,5,5,355,294,295,589,"21 de agosto de 1994"
10,5,5,356,179,140,319,"21 de agosto de 1994"
10,5,5,357,205,171,376,"21 de agosto de 1994"
10,5,5,358,140,115,255,"21 de agosto de 1994"
10,5,5,359,34,24,58,"21 de agosto de 1994"
10,5,5,360,48,35,83,"21 de agosto de 1994"
10,5,5,361,373,357,730,"21 de agosto de 1994"
10,5,5,362,279,267,546,"21 de agosto de 1994"
10,5,5,363,204,226,430,"21 de agosto de 1994"
10,5,5,364,172,208,380,"21 de agosto de 1994"
10,5,5,365,169,183,352,"21 de agosto de 1994"
10,5,5,366,87,71,158,"21 de agosto de 1994"
10,5,5,367,38,32,70,"21 de agosto de 1994"
10,5,5,368,84,90,174,"21 de agosto de 1994"
10,5,5,369,517,451,968,"21 de agosto de 1994"
10,5,5,370,682,2,684,"21 de agosto de 1994"
10,5,5,371,289,291,580,"21 de agosto de 1994"
10,5,5,372,161,157,318,"21 de agosto de 1994"
10,5,5,373,85,57,142,"21 de agosto de 1994"
10,5,5,374,223,197,420,"21 de agosto de 1994"
10,5,5,375,91,75,166,"21 de agosto de 1994"
10,5,5,376,428,436,864,"21 de agosto de 1994"
10,5,5,377,345,367,712,"21 de agosto de 1994"
10,5,5,378,262,285,547,"21 de agosto de 1994"
10,5,5,379,327,346,673,"21 de agosto de 1994"
10,5,5,380,292,347,639,"21 de agosto de 1994"
10,5,5,381,364,404,768,"21 de agosto de 1994"
10,5,5,382,145,190,335,"21 de agosto de 1994"
10,5,5,383,308,304,612,"21 de agosto de 1994"
10,5,5,384,192,198,390,"21 de agosto de 1994"
10,5,5,385,346,336,682,"21 de agosto de 1994"
10,5,5,386,128,90,218,"21 de agosto de 1994"
10,5,5,387,73,45,118,"21 de agosto de 1994"
10,5,5,388,266,224,490,"21 de agosto de 1994"
10,5,5,389,300,351,651,"21 de agosto de 1994"
10,5,5,390,144,150,294,"21 de agosto de 1994"
10,5,5,391,242,228,470,"21 de agosto de 1994"
10,5,5,392,297,353,650,"21 de agosto de 1994"
10,5,5,393,362,409,771,"21 de agosto de 1994"
10,5,5,394,180,197,377,"21 de agosto de 1994"
10,5,5,395,279,287,566,"21 de agosto de 1994"
10,5,5,396,159,134,293,"21 de agosto de 1994"
10,5,5,397,297,301,598,"21 de agosto de 1994"
10,5,5,398,461,454,915,"21 de agosto de 1994"
10,5,5,399,293,343,636,"21 de agosto de 1994"
10,5,5,400,249,288,537,"21 de agosto de 1994"
10,5,5,401,266,202,468,"21 de agosto de 1994"
10,5,5,402,257,279,536,"21 de agosto de 1994"
10,5,5,403,307,317,624,"21 de agosto de 1994"
10,5,5,404,113,106,219,"21 de agosto de 1994"
10,5,5,405,254,258,512,"21 de agosto de 1994"
10,5,5,406,21,26,47,"21 de agosto de 1994"
10,5,5,407,105,90,195,"21 de agosto de 1994"
10,5,5,408,81,73,154,"21 de agosto de 1994"
10,5,5,409,535,517,1052,"21 de agosto de 1994"
10,5,5,410,464,474,938,"21 de agosto de 1994"
10,5,5,411,386,379,765,"21 de agosto de 1994"
10,5,5,412,325,330,655,"21 de agosto de 1994"
10,5,5,413,167,166,333,"21 de agosto de 1994"
10,5,5,414,202,196,398,"21 de agosto de 1994"
10,5,5,415,47,36,83,"21 de agosto de 1994"
10,5,5,416,221,179,400,"21 de agosto de 1994"
10,5,5,417,178,134,312,"21 de agosto de 1994"
10,5,5,418,99,75,174,"21 de agosto de 1994"
10,5,5,419,61,65,126,"21 de agosto de 1994"
10,5,14,796,221,265,486,"21 de agosto de 1994"
10,5,14,797,209,266,475,"21 de agosto de 1994"
10,5,14,798,126,130,256,"21 de agosto de 1994"
10,5,14,799,132,111,243,"21 de agosto de 1994"
10,5,14,800,216,302,518,"21 de agosto de 1994"
10,5,14,801,81,77,158,"21 de agosto de 1994"
10,5,14,802,41,37,78,"21 de agosto de 1994"
10,5,14,803,77,81,158,"21 de agosto de 1994"
10,5,14,804,53,48,101,"21 de agosto de 1994"
10,5,14,805,111,112,223,"21 de agosto de 1994"
10,5,14,806,57,69,126,"21 de agosto de 1994"
10,5,14,807,91,69,160,"21 de agosto de 1994"
10,5,14,808,162,157,319,"21 de agosto de 1994"
10,5,14,809,198,144,342,"21 de agosto de 1994"
10,5,14,810,158,109,267,"21 de agosto de 1994"
10,5,14,811,375,364,739,"21 de agosto de 1994"
10,5,14,812,60,43,103,"21 de agosto de 1994"
10,5,14,813,102,105,207,"21 de agosto de 1994"
10,5,14,814,67,56,123,"21 de agosto de 1994"
10,5,14,815,62,30,92,"21 de agosto de 1994"
10,5,14,816,238,222,460,"21 de agosto de 1994"
10,5,14,817,187,139,326,"21 de agosto de 1994"
10,5,14,818,6,3,9,"21 de agosto de 1994"
10,5,14,819,14,6,20,"21 de agosto de 1994"
10,5,14,820,118,80,198,"21 de agosto de 1994"
10,5,14,821,289,234,523,"21 de agosto de 1994"
10,5,14,822,261,179,440,"21 de agosto de 1994"
10,5,14,823,112,78,190,"21 de agosto de 1994"
10,5,14,824,57,19,76,"21 de agosto de 1994"
10,5,14,825,175,152,327,"21 de agosto de 1994"
10,5,14,826,310,322,632,"21 de agosto de 1994"
10,5,14,827,180,159,339,"21 de agosto de 1994"
10,5,16,845,310,333,643,"21 de agosto de 1994"
10,5,16,846,484,511,995,"21 de agosto de 1994"
10,5,16,847,310,347,657,"21 de agosto de 1994"
10,5,16,848,315,334,649,"21 de agosto de 1994"
10,5,16,849,237,218,455,"21 de agosto de 1994"
10,5,16,850,378,439,817,"21 de agosto de 1994"
10,5,16,851,310,309,619,"21 de agosto de 1994"
10,5,16,852,99,73,172,"21 de agosto de 1994"
10,5,16,853,57,72,129,"21 de agosto de 1994"
10,5,16,854,141,152,293,"21 de agosto de 1994"
10,5,16,855,222,188,410,"21 de agosto de 1994"
10,5,16,856,201,194,395,"21 de agosto de 1994"
10,5,16,857,406,391,797,"21 de agosto de 1994"
10,5,16,858,24,28,52,"21 de agosto de 1994"
10,5,16,859,34,22,56,"21 de agosto de 1994"
10,5,16,860,259,250,509,"21 de agosto de 1994"
10,5,16,861,425,432,857,"21 de agosto de 1994"
10,5,16,862,79,77,156,"21 de agosto de 1994"
10,5,16,863,261,265,526,"21 de agosto de 1994"
10,5,16,864,185,198,383,"21 de agosto de 1994"
10,5,16,865,99,104,203,"21 de agosto de 1994"
10,5,24,1015,310,314,624,"21 de agosto de 1994"
10,5,24,1016,757,312,1069,"21 de agosto de 1994"
10,5,24,1017,357,426,783,"21 de agosto de 1994"
10,5,24,1018,576,602,1178,"21 de agosto de 1994"
10,5,24,1019,664,729,1393,"21 de agosto de 1994"
10,5,24,1020,315,362,677,"21 de agosto de 1994"
10,5,24,1021,308,305,613,"21 de agosto de 1994"
10,5,24,1022,378,373,751,"21 de agosto de 1994"
10,5,24,1023,518,534,1052,"21 de agosto de 1994"
10,5,24,1024,391,390,781,"21 de agosto de 1994"
10,5,24,1025,167,128,295,"21 de agosto de 1994"
10,5,24,1026,56,40,96,"21 de agosto de 1994"
10,5,24,1027,221,210,431,"21 de agosto de 1994"
10,5,24,1028,225,192,417,"21 de agosto de 1994"
10,5,24,1029,266,217,483,"21 de agosto de 1994"
10,5,24,1030,193,183,376,"21 de agosto de 1994"
10,5,24,1031,121,157,278,"21 de agosto de 1994"
10,5,24,1032,149,173,322,"21 de agosto de 1994"
10,5,24,1033,149,151,300,"21 de agosto de 1994"
10,5,24,1034,216,240,456,"21 de agosto de 1994"
10,5,24,1035,108,94,202,"21 de agosto de 1994"
10,5,24,1036,70,67,137,"21 de agosto de 1994"
10,5,24,1037,327,261,588,"21 de agosto de 1994"
10,5,24,1038,139,114,253,"21 de agosto de 1994"
10,5,24,1039,152,147,299,"21 de agosto de 1994"
10,5,24,1040,250,225,475,"21 de agosto de 1994"
10,5,24,1041,73,73,146,"21 de agosto de 1994"
10,5,24,1042,93,87,180,"21 de agosto de 1994"
10,5,24,1043,177,149,326,"21 de agosto de 1994"
10,5,24,1044,207,160,367,"21 de agosto de 1994"
10,5,24,1045,126,81,207,"21 de agosto de 1994"
10,5,24,1046,295,215,510,"21 de agosto de 1994"
10,5,24,1047,232,191,423,"21 de agosto de 1994"
10,5,24,1048,97,81,178,"21 de agosto de 1994"
10,5,24,1049,155,136,291,"21 de agosto de 1994"
10,5,24,1050,220,171,391,"21 de agosto de 1994"
10,5,24,1051,122,81,203,"21 de agosto de 1994"
10,5,24,1052,32,24,56,"21 de agosto de 1994"
10,5,24,1053,98,43,141,"21 de agosto de 1994"
10,5,24,1054,115,91,206,"21 de agosto de 1994"
10,5,24,1055,168,141,309,"21 de agosto de 1994"
10,5,24,1056,31,31,62,"21 de agosto de 1994"
10,5,24,1057,30,17,47,"21 de agosto de 1994"
10,5,24,1058,45,19,64,"21 de agosto de 1994"
10,5,24,1059,61,36,97,"21 de agosto de 1994"
10,5,24,1060,63,27,90,"21 de agosto de 1994"
10,5,24,1061,150,94,244,"21 de agosto de 1994"
10,5,24,1062,59,38,97,"21 de agosto de 1994"
10,5,27,1098,284,261,545,"21 de agosto de 1994"
10,5,27,1099,276,263,539,"21 de agosto de 1994"
10,5,27,1100,249,193,442,"21 de agosto de 1994"
10,5,27,1101,36,24,60,"21 de agosto de 1994"
10,5,27,1102,102,81,183,"21 de agosto de 1994"
10,5,27,1103,74,74,148,"21 de agosto de 1994"
10,5,27,1104,116,104,220,"21 de agosto de 1994"
10,5,27,1105,50,30,80,"21 de agosto de 1994"
10,5,27,1106,50,50,100,"21 de agosto de 1994"
10,5,27,1107,121,90,211,"21 de agosto de 1994"
10,5,27,1108,201,196,397,"21 de agosto de 1994"
10,5,27,1109,176,176,352,"21 de agosto de 1994"
10,5,27,1110,164,148,312,"21 de agosto de 1994"
10,5,27,1111,39,33,72,"21 de agosto de 1994"
10,5,27,1112,327,294,621,"21 de agosto de 1994"
10,5,27,1113,62,49,111,"21 de agosto de 1994"
10,5,27,1114,138,99,237,"21 de agosto de 1994"
10,5,27,1115,71,46,117,"21 de agosto de 1994"
10,5,27,1116,211,189,400,"21 de agosto de 1994"
10,5,27,1117,129,115,244,"21 de agosto de 1994"
10,5,27,1118,79,55,134,"21 de agosto de 1994"
10,5,27,1119,50,43,93,"21 de agosto de 1994"
10,5,27,1120,96,62,158,"21 de agosto de 1994"
10,5,27,1121,68,42,110,"21 de agosto de 1994"
10,5,27,1122,170,142,312,"21 de agosto de 1994"
10,5,27,1123,28,22,50,"21 de agosto de 1994"
10,5,27,1124,9,6,15,"21 de agosto de 1994"
10,5,27,1125,92,41,133,"21 de agosto de 1994"
10,5,27,1126,126,117,243,"21 de agosto de 1994"
10,5,27,1127,193,153,346,"21 de agosto de 1994"
10,5,27,1128,114,70,184,"21 de agosto de 1994"
10,5,27,1129,84,70,154,"21 de agosto de 1994"
10,5,27,1130,129,98,227,"21 de agosto de 1994"
10,5,27,1131,196,153,349,"21 de agosto de 1994"
10,5,27,1132,120,92,212,"21 de agosto de 1994"
10,5,27,1133,29,26,55,"21 de agosto de 1994"
10,5,27,1134,89,75,164,"21 de agosto de 1994"
10,5,27,1135,72,37,109,"21 de agosto de 1994"
10,5,27,1136,108,87,195,"21 de agosto de 1994"
10,5,27,1137,79,60,139,"21 de agosto de 1994"
10,5,27,1138,89,68,157,"21 de agosto de 1994"
10,5,27,1139,44,42,86,"21 de agosto de 1994"
10,5,34,1263,200,241,441,"21 de agosto de 1994"
10,5,34,1264,231,258,489,"21 de agosto de 1994"
10,5,34,1265,322,367,689,"21 de agosto de 1994"
10,5,34,1266,370,378,748,"21 de agosto de 1994"
10,5,34,1267,70,65,135,"21 de agosto de 1994"
10,5,34,1268,158,177,335,"21 de agosto de 1994"
10,5,34,1269,89,110,199,"21 de agosto de 1994"
10,5,34,1270,40,46,86,"21 de agosto de 1994"
10,5,34,1271,89,90,179,"21 de agosto de 1994"
10,5,34,1272,60,61,121,"21 de agosto de 1994"
10,5,34,1273,54,69,123,"21 de agosto de 1994"
10,5,39,1374,293,317,610,"21 de agosto de 1994"
10,5,39,1375,361,397,758,"21 de agosto de 1994"
10,5,39,1376,301,331,632,"21 de agosto de 1994"
10,5,39,1377,436,495,931,"21 de agosto de 1994"
10,5,39,1378,326,326,652,"21 de agosto de 1994"
10,5,39,1379,300,321,621,"21 de agosto de 1994"
10,5,39,1380,412,476,888,"21 de agosto de 1994"
10,5,39,1381,249,268,517,"21 de agosto de 1994"
10,5,39,1382,281,282,563,"21 de agosto de 1994"
10,5,39,1383,452,539,991,"21 de agosto de 1994"
10,5,39,1384,272,306,578,"21 de agosto de 1994"
10,5,39,1385,220,296,516,"21 de agosto de 1994"
10,5,39,1386,168,258,426,"21 de agosto de 1994"
10,5,39,1387,442,465,907,"21 de agosto de 1994"
10,5,39,1388,69,65,134,"21 de agosto de 1994"
10,5,39,1389,142,145,287,"21 de agosto de 1994"
10,5,39,1390,192,181,373,"21 de agosto de 1994"
10,6,10,664,230,228,458,"21 de agosto de 1994"
10,6,10,665,66,50,116,"21 de agosto de 1994"
10,6,10,666,122,86,208,"21 de agosto de 1994"
10,6,10,667,175,140,315,"21 de agosto de 1994"
10,6,10,668,413,433,846,"21 de agosto de 1994"
10,6,10,669,95,85,180,"21 de agosto de 1994"
10,6,10,670,158,163,321,"21 de agosto de 1994"
10,6,10,671,212,197,409,"21 de agosto de 1994"
10,6,11,672,141,158,299,"21 de agosto de 1994"
10,6,11,673,85,88,173,"21 de agosto de 1994"
10,6,11,674,123,131,254,"21 de agosto de 1994"
10,6,11,675,90,88,178,"21 de agosto de 1994"
10,6,11,676,52,52,104,"21 de agosto de 1994"
10,6,11,677,57,46,103,"21 de agosto de 1994"
10,6,11,678,183,197,380,"21 de agosto de 1994"
10,6,11,679,82,85,167,"21 de agosto de 1994"
10,6,11,680,52,55,107,"21 de agosto de 1994"
10,6,11,681,130,124,254,"21 de agosto de 1994"
10,6,11,682,45,58,103,"21 de agosto de 1994"
10,6,11,683,98,107,205,"21 de agosto de 1994"
10,6,11,684,180,188,368,"21 de agosto de 1994"
10,6,11,685,95,95,190,"21 de agosto de 1994"
10,6,11,686,166,188,354,"21 de agosto de 1994"
10,6,11,687,162,167,329,"21 de agosto de 1994"
10,6,11,688,41,42,83,"21 de agosto de 1994"
10,6,12,689,405,455,860,"21 de agosto de 1994"
10,6,12,690,488,525,1013,"21 de agosto de 1994"
10,6,12,691,61,62,123,"21 de agosto de 1994"
10,6,12,692,294,303,597,"21 de agosto de 1994"
10,6,12,693,294,339,633,"21 de agosto de 1994"
10,6,12,694,175,178,353,"21 de agosto de 1994"
10,6,12,695,400,428,828,"21 de agosto de 1994"
10,6,12,696,594,601,1195,"21 de agosto de 1994"
10,6,12,697,622,636,1258,"21 de agosto de 1994"
10,6,12,698,215,237,452,"21 de agosto de 1994"
10,6,12,699,201,209,410,"21 de agosto de 1994"
10,6,12,700,177,199,376,"21 de agosto de 1994"
10,6,12,701,501,511,1012,"21 de agosto de 1994"
10,6,12,702,225,260,485,"21 de agosto de 1994"
10,6,12,703,385,399,784,"21 de agosto de 1994"
10,6,12,704,497,555,1052,"21 de agosto de 1994"
10,6,12,705,639,734,1373,"21 de agosto de 1994"
10,6,12,706,262,284,546,"21 de agosto de 1994"
10,6,12,707,177,193,370,"21 de agosto de 1994"
10,6,12,708,278,321,599,"21 de agosto de 1994"
10,6,12,709,272,295,567,"21 de agosto de 1994"
10,6,12,710,399,397,796,"21 de agosto de 1994"
10,6,12,711,446,456,902,"21 de agosto de 1994"
10,6,12,712,384,482,866,"21 de agosto de 1994"
10,6,12,713,408,491,899,"21 de agosto de 1994"
10,6,12,714,333,422,755,"21 de agosto de 1994"
10,6,12,715,317,367,684,"21 de agosto de 1994"
10,6,12,716,247,263,510,"21 de agosto de 1994"
10,6,12,717,216,218,434,"21 de agosto de 1994"
10,6,12,718,337,349,686,"21 de agosto de 1994"
10,6,12,719,460,526,986,"21 de agosto de 1994"
10,6,12,720,435,571,1006,"21 de agosto de 1994"
10,6,12,721,406,434,840,"21 de agosto de 1994"
10,6,12,722,713,769,1482,"21 de agosto de 1994"
10,6,12,723,588,647,1235,"21 de agosto de 1994"
10,6,12,724,493,543,1036,"21 de agosto de 1994"
10,6,12,725,204,214,418,"21 de agosto de 1994"
10,6,12,726,284,310,594,"21 de agosto de 1994"
10,6,12,727,275,315,590,"21 de agosto de 1994"
10,6,12,728,180,166,346,"21 de agosto de 1994"
10,6,12,729,91,83,174,"21 de agosto de 1994"
10,6,12,730,505,486,991,"21 de agosto de 1994"
10,6,12,731,246,229,475,"21 de agosto de 1994"
10,6,12,732,270,293,563,"21 de agosto de 1994"
10,6,12,733,512,553,1065,"21 de agosto de 1994"
10,6,12,734,309,327,636,"21 de agosto de 1994"
10,6,12,735,568,560,1128,"21 de agosto de 1994"
10,6,12,736,157,154,311,"21 de agosto de 1994"
10,6,12,737,422,393,815,"21 de agosto de 1994"
10,6,12,738,613,628,1241,"21 de agosto de 1994"
10,6,12,739,519,518,1037,"21 de agosto de 1994"
10,6,12,740,146,155,301,"21 de agosto de 1994"
10,6,12,741,322,343,665,"21 de agosto de 1994"
10,6,12,742,319,341,660,"21 de agosto de 1994"
10,6,12,743,184,160,344,"21 de agosto de 1994"
10,6,12,744,230,207,437,"21 de agosto de 1994"
10,6,12,745,306,268,574,"21 de agosto de 1994"
10,6,12,746,492,537,1029,"21 de agosto de 1994"
10,6,12,747,440,441,881,"21 de agosto de 1994"
10,6,12,748,351,354,705,"21 de agosto de 1994"
10,6,12,749,368,412,780,"21 de agosto de 1994"
10,6,12,750,193,203,396,"21 de agosto de 1994"
10,6,12,751,274,336,610,"21 de agosto de 1994"
10,6,12,752,235,251,486,"21 de agosto de 1994"
10,6,12,753,308,344,652,"21 de agosto de 1994"
10,6,12,754,543,493,1036,"21 de agosto de 1994"
10,6,12,755,404,385,789,"21 de agosto de 1994"
10,6,12,756,381,334,715,"21 de agosto de 1994"
10,6,12,757,366,349,715,"21 de agosto de 1994"
10,6,12,758,124,125,249,"21 de agosto de 1994"
10,6,12,759,89,99,188,"21 de agosto de 1994"
10,6,12,760,323,334,657,"21 de agosto de 1994"
10,6,12,761,535,560,1095,"21 de agosto de 1994"
10,6,12,762,245,270,515,"21 de agosto de 1994"
10,6,12,763,388,413,801,"21 de agosto de 1994"
10,6,12,764,328,331,659,"21 de agosto de 1994"
10,6,12,765,113,88,201,"21 de agosto de 1994"
10,6,12,766,21,23,44,"21 de agosto de 1994"
10,6,12,767,249,260,509,"21 de agosto de 1994"
10,6,12,768,54,52,106,"21 de agosto de 1994"
10,6,13,769,649,592,1241,"21 de agosto de 1994"
10,6,13,770,242,298,540,"21 de agosto de 1994"
10,6,13,771,238,244,482,"21 de agosto de 1994"
10,6,13,772,152,114,266,"21 de agosto de 1994"
10,6,13,773,74,76,150,"21 de agosto de 1994"
10,6,13,774,63,67,130,"21 de agosto de 1994"
10,6,13,775,40,35,75,"21 de agosto de 1994"
10,6,13,776,38,30,68,"21 de agosto de 1994"
10,6,13,777,536,532,1068,"21 de agosto de 1994"
10,6,13,778,424,449,873,"21 de agosto de 1994"
10,6,13,779,36,22,58,"21 de agosto de 1994"
10,6,13,780,338,264,602,"21 de agosto de 1994"
10,6,13,781,150,107,257,"21 de agosto de 1994"
10,6,13,782,136,88,224,"21 de agosto de 1994"
10,6,13,783,122,101,223,"21 de agosto de 1994"
10,6,13,784,40,32,72,"21 de agosto de 1994"
10,6,13,785,276,217,493,"21 de agosto de 1994"
10,6,13,786,302,290,592,"21 de agosto de 1994"
10,6,13,787,202,214,416,"21 de agosto de 1994"
10,6,13,788,612,667,1279,"21 de agosto de 1994"
10,6,13,789,390,418,808,"21 de agosto de 1994"
10,6,13,790,264,255,519,"21 de agosto de 1994"
10,6,13,791,284,239,523,"21 de agosto de 1994"
10,6,13,792,419,389,808,"21 de agosto de 1994"
10,6,13,793,207,179,386,"21 de agosto de 1994"
10,6,13,794,117,101,218,"21 de agosto de 1994"
10,6,13,795,108,89,197,"21 de agosto de 1994"
10,6,15,828,284,299,583,"21 de agosto de 1994"
10,6,15,829,256,274,530,"21 de agosto de 1994"
10,6,15,830,195,215,410,"21 de agosto de 1994"
10,6,15,831,283,266,549,"21 de agosto de 1994"
10,6,15,832,109,110,219,"21 de agosto de 1994"
10,6,15,833,278,256,534,"21 de agosto de 1994"
10,6,15,834,271,264,535,"21 de agosto de 1994"
10,6,15,835,204,218,422,"21 de agosto de 1994"
10,6,15,836,204,183,387,"21 de agosto de 1994"
10,6,15,837,216,176,392,"21 de agosto de 1994"
10,6,15,838,178,175,353,"21 de agosto de 1994"
10,6,15,839,434,445,879,"21 de agosto de 1994"
10,6,15,840,251,225,476,"21 de agosto de 1994"
10,6,15,841,100,92,192,"21 de agosto de 1994"
10,6,15,842,150,158,308,"21 de agosto de 1994"
10,6,15,843,54,38,92,"21 de agosto de 1994"
10,6,15,844,139,127,266,"21 de agosto de 1994"
10,6,18,895,370,384,754,"21 de agosto de 1994"
10,6,18,896,83,69,152,"21 de agosto de 1994"
10,6,18,897,134,128,262,"21 de agosto de 1994"
10,6,18,898,108,86,194,"21 de agosto de 1994"
10,6,18,899,178,143,321,"21 de agosto de 1994"
10,6,18,900,40,42,82,"21 de agosto de 1994"
10,6,18,901,115,75,190,"21 de agosto de 1994"
10,6,18,902,271,245,516,"21 de agosto de 1994"
10,6,18,903,60,47,107,"21 de agosto de 1994"
10,6,18,904,117,108,225,"21 de agosto de 1994"
10,6,18,905,79,86,165,"21 de agosto de 1994"
10,6,18,906,192,205,397,"21 de agosto de 1994"
10,6,18,907,223,249,472,"21 de agosto de 1994"
10,6,18,908,233,246,479,"21 de agosto de 1994"
10,6,18,909,222,229,451,"21 de agosto de 1994"
10,6,18,910,314,298,612,"21 de agosto de 1994"
10,6,18,911,351,338,689,"21 de agosto de 1994"
10,6,18,912,87,78,165,"21 de agosto de 1994"
10,6,18,913,150,133,283,"21 de agosto de 1994"
10,6,19,914,85,93,178,"21 de agosto de 1994"
10,6,19,915,271,296,567,"21 de agosto de 1994"
10,6,19,916,406,435,841,"21 de agosto de 1994"
10,6,19,917,374,456,830,"21 de agosto de 1994"
10,6,19,918,57,49,106,"21 de agosto de 1994"
10,6,19,919,96,92,188,"21 de agosto de 1994"
10,6,19,920,27,29,56,"21 de agosto de 1994"
10,6,19,921,48,26,74,"21 de agosto de 1994"
10,6,19,922,38,32,70,"21 de agosto de 1994"
10,6,19,923,92,93,185,"21 de agosto de 1994"
10,6,19,924,72,89,161,"21 de agosto de 1994"
10,6,19,925,34,27,61,"21 de agosto de 1994"
10,6,19,926,41,31,72,"21 de agosto de 1994"
10,6,19,927,52,44,96,"21 de agosto de 1994"
10,6,19,928,68,50,118,"21 de agosto de 1994"
10,6,19,929,38,43,81,"21 de agosto de 1994"
10,6,19,930,41,46,87,"21 de agosto de 1994"
10,6,19,931,61,56,117,"21 de agosto de 1994"
10,6,19,932,56,54,110,"21 de agosto de 1994"
10,6,19,933,108,110,218,"21 de agosto de 1994"
10,6,19,934,110,139,249,"21 de agosto de 1994"
10,6,19,935,110,131,241,"21 de agosto de 1994"
10,6,19,936,78,87,165,"21 de agosto de 1994"
10,6,19,937,266,295,561,"21 de agosto de 1994"
10,6,19,938,35,45,80,"21 de agosto de 1994"
10,6,19,939,156,169,325,"21 de agosto de 1994"
10,6,19,940,126,138,264,"21 de agosto de 1994"
10,6,19,941,57,39,96,"21 de agosto de 1994"
10,6,19,942,132,159,291,"21 de agosto de 1994"
10,6,19,943,89,138,227,"21 de agosto de 1994"
10,6,19,944,37,37,74,"21 de agosto de 1994"
10,6,19,945,83,68,151,"21 de agosto de 1994"
10,6,19,946,126,162,288,"21 de agosto de 1994"
10,6,30,1179,147,153,300,"21 de agosto de 1994"
10,6,30,1180,157,178,335,"21 de agosto de 1994"
10,6,30,1181,127,127,254,"21 de agosto de 1994"
10,6,30,1182,146,151,297,"21 de agosto de 1994"
10,6,31,1183,222,193,415,"21 de agosto de 1994"
10,6,31,1184,98,86,184,"21 de agosto de 1994"
10,6,31,1185,31,25,56,"21 de agosto de 1994"
10,6,31,1186,44,39,83,"21 de agosto de 1994"
10,6,31,1187,82,77,159,"21 de agosto de 1994"
10,6,31,1188,52,44,96,"21 de agosto de 1994"
10,6,31,1189,30,24,54,"21 de agosto de 1994"
10,6,31,1190,62,45,107,"21 de agosto de 1994"
11,1,15,823,372,438,810,"21 de agosto de 1994"
11,1,15,824,409,465,874,"21 de agosto de 1994"
11,1,15,825,273,307,580,"21 de agosto de 1994"
11,1,15,826,383,407,790,"21 de agosto de 1994"
11,1,15,827,420,423,843,"21 de agosto de 1994"
11,1,15,828,458,463,921,"21 de agosto de 1994"
11,1,15,829,271,293,564,"21 de agosto de 1994"
11,1,15,830,267,293,560,"21 de agosto de 1994"
11,1,15,831,383,388,771,"21 de agosto de 1994"
11,1,15,832,537,567,1104,"21 de agosto de 1994"
11,1,15,833,390,459,849,"21 de agosto de 1994"
11,1,15,834,567,672,1239,"21 de agosto de 1994"
11,1,15,835,566,608,1174,"21 de agosto de 1994"
11,1,15,836,384,480,864,"21 de agosto de 1994"
11,1,15,837,421,477,898,"21 de agosto de 1994"
11,1,15,838,382,405,787,"21 de agosto de 1994"
11,1,15,839,235,278,513,"21 de agosto de 1994"
11,1,15,840,114,145,259,"21 de agosto de 1994"
11,1,15,841,331,383,714,"21 de agosto de 1994"
11,1,15,842,352,397,749,"21 de agosto de 1994"
11,1,15,843,343,356,699,"21 de agosto de 1994"
11,1,15,844,348,418,766,"21 de agosto de 1994"
11,1,15,845,424,497,921,"21 de agosto de 1994"
11,1,15,846,295,339,634,"21 de agosto de 1994"
11,1,15,847,312,348,660,"21 de agosto de 1994"
11,1,15,848,204,278,482,"21 de agosto de 1994"
11,1,15,849,158,182,340,"21 de agosto de 1994"
11,1,15,850,401,454,855,"21 de agosto de 1994"
11,1,15,851,425,499,924,"21 de agosto de 1994"
11,1,15,852,417,503,920,"21 de agosto de 1994"
11,1,15,853,473,550,1023,"21 de agosto de 1994"
11,1,15,854,593,672,1265,"21 de agosto de 1994"
11,1,15,855,454,501,955,"21 de agosto de 1994"
11,1,15,856,235,276,511,"21 de agosto de 1994"
11,1,15,857,455,468,923,"21 de agosto de 1994"
11,1,15,858,365,424,789,"21 de agosto de 1994"
11,1,15,859,230,273,503,"21 de agosto de 1994"
11,1,15,860,240,293,533,"21 de agosto de 1994"
11,1,15,861,398,507,905,"21 de agosto de 1994"
11,1,15,862,406,526,932,"21 de agosto de 1994"
11,1,15,863,217,262,479,"21 de agosto de 1994"
11,1,15,864,268,315,583,"21 de agosto de 1994"
11,1,15,865,347,391,738,"21 de agosto de 1994"
11,1,15,866,413,530,943,"21 de agosto de 1994"
11,1,15,867,461,560,1021,"21 de agosto de 1994"
11,1,15,868,238,283,521,"21 de agosto de 1994"
11,1,15,869,238,307,545,"21 de agosto de 1994"
11,1,15,870,324,343,667,"21 de agosto de 1994"
11,1,15,871,164,187,351,"21 de agosto de 1994"
11,1,15,872,416,486,902,"21 de agosto de 1994"
11,1,15,873,629,723,1352,"21 de agosto de 1994"
11,1,15,874,208,232,440,"21 de agosto de 1994"
11,1,15,875,440,507,947,"21 de agosto de 1994"
11,1,15,876,427,457,884,"21 de agosto de 1994"
11,1,15,877,323,352,675,"21 de agosto de 1994"
11,1,15,878,434,494,928,"21 de agosto de 1994"
11,1,15,879,46,45,91,"21 de agosto de 1994"
11,1,15,880,134,114,248,"21 de agosto de 1994"
11,1,15,881,166,257,423,"21 de agosto de 1994"
11,1,15,882,114,172,286,"21 de agosto de 1994"
11,1,15,883,181,157,338,"21 de agosto de 1994"
11,1,15,884,69,86,155,"21 de agosto de 1994"
11,1,15,885,226,359,585,"21 de agosto de 1994"
11,1,15,886,111,180,291,"21 de agosto de 1994"
11,1,15,887,198,293,491,"21 de agosto de 1994"
11,1,15,888,293,341,634,"21 de agosto de 1994"
11,1,15,889,329,344,673,"21 de agosto de 1994"
11,1,15,890,303,288,591,"21 de agosto de 1994"
11,1,15,891,76,78,154,"21 de agosto de 1994"
11,1,15,892,44,49,93,"21 de agosto de 1994"
11,1,15,893,205,231,436,"21 de agosto de 1994"
11,1,15,894,306,337,643,"21 de agosto de 1994"
11,1,15,895,212,221,433,"21 de agosto de 1994"
11,1,15,896,434,452,886,"21 de agosto de 1994"
11,1,15,897,319,352,671,"21 de agosto de 1994"
11,1,15,898,351,376,727,"21 de agosto de 1994"
11,1,15,899,456,500,956,"21 de agosto de 1994"
11,1,15,900,188,207,395,"21 de agosto de 1994"
11,1,15,901,264,283,547,"21 de agosto de 1994"
11,1,15,902,387,404,791,"21 de agosto de 1994"
11,1,15,903,303,326,629,"21 de agosto de 1994"
11,1,15,904,288,277,565,"21 de agosto de 1994"
11,1,15,905,306,298,604,"21 de agosto de 1994"
11,1,15,906,184,172,356,"21 de agosto de 1994"
11,1,15,907,265,272,537,"21 de agosto de 1994"
11,1,15,908,451,464,915,"21 de agosto de 1994"
11,1,15,909,388,426,814,"21 de agosto de 1994"
11,1,15,910,355,449,804,"21 de agosto de 1994"
11,1,15,911,279,256,535,"21 de agosto de 1994"
11,1,15,912,461,499,960,"21 de agosto de 1994"
11,1,15,913,212,226,438,"21 de agosto de 1994"
11,1,15,914,426,441,867,"21 de agosto de 1994"
11,1,15,915,325,381,706,"21 de agosto de 1994"
11,1,26,2059,185,201,386,"21 de agosto de 1994"
11,1,26,2060,346,384,730,"21 de agosto de 1994"
11,1,26,2061,388,449,837,"21 de agosto de 1994"
11,1,26,2062,419,485,904,"21 de agosto de 1994"
11,1,26,2063,276,320,596,"21 de agosto de 1994"
11,1,26,2064,441,525,966,"21 de agosto de 1994"
11,1,26,2065,247,298,545,"21 de agosto de 1994"
11,1,26,2066,288,340,628,"21 de agosto de 1994"
11,1,26,2067,342,377,719,"21 de agosto de 1994"
11,1,26,2068,462,544,1006,"21 de agosto de 1994"
11,1,26,2069,394,441,835,"21 de agosto de 1994"
11,1,26,2070,254,318,572,"21 de agosto de 1994"
11,1,26,2071,289,321,610,"21 de agosto de 1994"
11,1,26,2072,321,316,637,"21 de agosto de 1994"
11,1,26,2073,42,43,85,"21 de agosto de 1994"
11,1,26,2074,224,256,480,"21 de agosto de 1994"
11,1,26,2075,95,90,185,"21 de agosto de 1994"
11,1,26,2076,122,130,252,"21 de agosto de 1994"
11,1,26,2077,65,62,127,"21 de agosto de 1994"
11,1,26,2078,114,114,228,"21 de agosto de 1994"
11,1,26,2079,305,363,668,"21 de agosto de 1994"
11,1,26,2080,99,95,194,"21 de agosto de 1994"
11,1,26,2081,112,114,226,"21 de agosto de 1994"
11,1,26,2082,99,103,202,"21 de agosto de 1994"
11,1,26,2083,40,45,85,"21 de agosto de 1994"
11,1,26,2084,159,154,313,"21 de agosto de 1994"
11,1,26,2085,309,345,654,"21 de agosto de 1994"
11,1,26,2086,467,497,964,"21 de agosto de 1994"
11,1,26,2087,181,227,408,"21 de agosto de 1994"
11,1,26,2088,405,414,819,"21 de agosto de 1994"
11,1,26,2089,107,126,233,"21 de agosto de 1994"
11,1,26,2090,77,85,162,"21 de agosto de 1994"
11,1,26,2091,49,80,129,"21 de agosto de 1994"
11,1,26,2092,212,272,484,"21 de agosto de 1994"
11,1,26,2093,179,215,394,"21 de agosto de 1994"
11,1,26,2094,61,52,113,"21 de agosto de 1994"
11,1,26,2095,388,480,868,"21 de agosto de 1994"
11,1,26,2096,163,192,355,"21 de agosto de 1994"
11,1,26,2097,161,150,311,"21 de agosto de 1994"
11,1,26,2098,298,311,609,"21 de agosto de 1994"
11,1,26,2099,222,228,450,"21 de agosto de 1994"
11,1,26,2100,135,190,325,"21 de agosto de 1994"
11,1,26,2101,206,271,477,"21 de agosto de 1994"
11,1,26,2102,303,312,615,"21 de agosto de 1994"
11,1,26,2103,65,73,138,"21 de agosto de 1994"
11,1,26,2104,68,91,159,"21 de agosto de 1994"
11,1,26,2105,232,261,493,"21 de agosto de 1994"
11,1,26,2106,209,239,448,"21 de agosto de 1994"
11,1,26,2107,148,182,330,"21 de agosto de 1994"
11,1,26,2108,182,259,441,"21 de agosto de 1994"
11,1,37,2654,502,535,1037,"21 de agosto de 1994"
11,1,37,2655,414,462,876,"21 de agosto de 1994"
11,1,37,2656,181,202,383,"21 de agosto de 1994"
11,1,37,2657,462,511,973,"21 de agosto de 1994"
11,1,37,2658,455,519,974,"21 de agosto de 1994"
11,1,37,2659,297,361,658,"21 de agosto de 1994"
11,1,37,2660,547,556,1103,"21 de agosto de 1994"
11,1,37,2661,361,417,778,"21 de agosto de 1994"
11,1,37,2662,481,561,1042,"21 de agosto de 1994"
11,1,37,2663,557,658,1215,"21 de agosto de 1994"
11,1,37,2664,471,472,943,"21 de agosto de 1994"
11,1,37,2665,315,317,632,"21 de agosto de 1994"
11,1,37,2666,481,563,1044,"21 de agosto de 1994"
11,1,37,2667,261,352,613,"21 de agosto de 1994"
11,1,37,2668,449,505,954,"21 de agosto de 1994"
11,1,37,2669,556,620,1176,"21 de agosto de 1994"
11,1,37,2670,485,532,1017,"21 de agosto de 1994"
11,1,37,2671,324,328,652,"21 de agosto de 1994"
11,1,37,2672,172,190,362,"21 de agosto de 1994"
11,1,37,2673,432,547,979,"21 de agosto de 1994"
11,1,37,2674,254,297,551,"21 de agosto de 1994"
11,1,37,2675,458,525,983,"21 de agosto de 1994"
11,1,37,2676,408,459,867,"21 de agosto de 1994"
11,1,37,2677,228,252,480,"21 de agosto de 1994"
11,1,37,2678,401,426,827,"21 de agosto de 1994"
11,1,37,2679,380,460,840,"21 de agosto de 1994"
11,1,37,2680,364,430,794,"21 de agosto de 1994"
11,1,37,2681,599,669,1268,"21 de agosto de 1994"
11,1,37,2682,673,716,1389,"21 de agosto de 1994"
11,1,37,2683,473,532,1005,"21 de agosto de 1994"
11,1,37,2684,575,563,1138,"21 de agosto de 1994"
11,1,37,2685,444,472,916,"21 de agosto de 1994"
11,1,37,2686,185,231,416,"21 de agosto de 1994"
11,1,37,2687,417,456,873,"21 de agosto de 1994"
11,1,37,2688,240,266,506,"21 de agosto de 1994"
11,1,37,2689,331,405,736,"21 de agosto de 1994"
11,1,37,2690,521,590,1111,"21 de agosto de 1994"
11,1,37,2691,277,279,556,"21 de agosto de 1994"
11,1,37,2692,470,577,1047,"21 de agosto de 1994"
11,1,37,2693,289,319,608,"21 de agosto de 1994"
11,1,37,2694,607,614,1221,"21 de agosto de 1994"
11,1,37,2695,332,335,667,"21 de agosto de 1994"
11,1,37,2696,257,283,540,"21 de agosto de 1994"
11,1,37,2697,146,159,305,"21 de agosto de 1994"
11,1,37,2698,288,302,590,"21 de agosto de 1994"
11,1,37,2699,429,459,888,"21 de agosto de 1994"
11,1,37,2700,658,651,1309,"21 de agosto de 1994"
11,1,37,2701,189,203,392,"21 de agosto de 1994"
11,1,37,2702,278,322,600,"21 de agosto de 1994"
11,1,37,2703,427,465,892,"21 de agosto de 1994"
11,1,37,2704,429,453,882,"21 de agosto de 1994"
11,1,37,2705,429,454,883,"21 de agosto de 1994"
11,1,37,2706,272,304,576,"21 de agosto de 1994"
11,1,37,2707,196,190,386,"21 de agosto de 1994"
11,1,37,2708,111,109,220,"21 de agosto de 1994"
11,1,37,2709,535,572,1107,"21 de agosto de 1994"
11,1,37,2710,233,232,465,"21 de agosto de 1994"
11,1,37,2711,186,186,372,"21 de agosto de 1994"
11,1,37,2712,574,565,1139,"21 de agosto de 1994"
11,1,37,2713,166,171,337,"21 de agosto de 1994"
11,1,37,2714,300,325,625,"21 de agosto de 1994"
11,1,37,2715,129,135,264,"21 de agosto de 1994"
11,1,37,2716,240,260,500,"21 de agosto de 1994"
11,1,37,2717,605,646,1251,"21 de agosto de 1994"
11,1,37,2718,304,319,623,"21 de agosto de 1994"
11,1,37,2719,458,545,1003,"21 de agosto de 1994"
11,1,37,2720,586,580,1166,"21 de agosto de 1994"
11,1,37,2721,331,362,693,"21 de agosto de 1994"
11,1,37,2722,236,252,488,"21 de agosto de 1994"
11,1,37,2723,148,167,315,"21 de agosto de 1994"
11,1,37,2724,311,341,652,"21 de agosto de 1994"
11,1,37,2725,625,658,1283,"21 de agosto de 1994"
11,1,37,2726,454,475,929,"21 de agosto de 1994"
11,1,37,2727,407,439,846,"21 de agosto de 1994"
11,1,37,2728,320,337,657,"21 de agosto de 1994"
11,1,37,2729,115,145,260,"21 de agosto de 1994"
11,1,37,2730,400,613,1013,"21 de agosto de 1994"
11,1,37,2731,124,145,269,"21 de agosto de 1994"
11,2,20,1261,422,469,891,"21 de agosto de 1994"
11,2,20,1262,290,329,619,"21 de agosto de 1994"
11,2,20,1263,322,387,709,"21 de agosto de 1994"
11,2,20,1264,251,250,501,"21 de agosto de 1994"
11,2,20,1265,217,241,458,"21 de agosto de 1994"
11,2,20,1266,383,409,792,"21 de agosto de 1994"
11,2,20,1267,239,277,516,"21 de agosto de 1994"
11,2,20,1268,139,152,291,"21 de agosto de 1994"
11,2,20,1269,472,518,990,"21 de agosto de 1994"
11,2,20,1270,257,265,522,"21 de agosto de 1994"
11,2,20,1271,212,232,444,"21 de agosto de 1994"
11,2,20,1272,313,315,628,"21 de agosto de 1994"
11,2,20,1273,581,670,1251,"21 de agosto de 1994"
11,2,20,1274,240,279,519,"21 de agosto de 1994"
11,2,20,1275,102,107,209,"21 de agosto de 1994"
11,2,20,1276,203,241,444,"21 de agosto de 1994"
11,2,20,1277,317,346,663,"21 de agosto de 1994"
11,2,20,1278,231,270,501,"21 de agosto de 1994"
11,2,20,1279,370,397,767,"21 de agosto de 1994"
11,2,20,1280,465,513,978,"21 de agosto de 1994"
11,2,20,1281,241,285,526,"21 de agosto de 1994"
11,2,20,1282,352,366,718,"21 de agosto de 1994"
11,2,20,1283,153,159,312,"21 de agosto de 1994"
11,2,20,1284,510,534,1044,"21 de agosto de 1994"
11,2,20,1285,429,484,913,"21 de agosto de 1994"
11,2,20,1286,345,382,727,"21 de agosto de 1994"
11,2,20,1287,358,382,740,"21 de agosto de 1994"
11,2,20,1288,474,501,975,"21 de agosto de 1994"
11,2,20,1289,521,559,1080,"21 de agosto de 1994"
11,2,20,1290,150,150,300,"21 de agosto de 1994"
11,2,20,1291,123,148,271,"21 de agosto de 1994"
11,2,20,1292,329,351,680,"21 de agosto de 1994"
11,2,20,1293,376,424,800,"21 de agosto de 1994"
11,2,20,1294,338,390,728,"21 de agosto de 1994"
11,2,20,1295,297,346,643,"21 de agosto de 1994"
11,2,20,1296,188,214,402,"21 de agosto de 1994"
11,2,20,1297,399,402,801,"21 de agosto de 1994"
11,2,20,1298,575,603,1178,"21 de agosto de 1994"
11,2,20,1299,227,261,488,"21 de agosto de 1994"
11,2,20,1300,305,352,657,"21 de agosto de 1994"
11,2,20,1301,328,370,698,"21 de agosto de 1994"
11,2,20,1302,385,420,805,"21 de agosto de 1994"
11,2,20,1303,365,394,759,"21 de agosto de 1994"
11,2,20,1304,291,322,613,"21 de agosto de 1994"
11,2,20,1305,313,339,652,"21 de agosto de 1994"
11,2,20,1306,434,459,893,"21 de agosto de 1994"
11,2,20,1307,375,433,808,"21 de agosto de 1994"
11,2,20,1308,582,648,1230,"21 de agosto de 1994"
11,2,20,1309,551,595,1146,"21 de agosto de 1994"
11,2,20,1310,601,663,1264,"21 de agosto de 1994"
11,2,20,1311,197,233,430,"21 de agosto de 1994"
11,2,20,1312,458,493,951,"21 de agosto de 1994"
11,2,20,1313,233,263,496,"21 de agosto de 1994"
11,2,20,1314,329,403,732,"21 de agosto de 1994"
11,2,20,1315,288,331,619,"21 de agosto de 1994"
11,2,20,1316,368,385,753,"21 de agosto de 1994"
11,2,20,1317,335,385,720,"21 de agosto de 1994"
11,2,20,1318,242,255,497,"21 de agosto de 1994"
11,2,20,1319,353,411,764,"21 de agosto de 1994"
11,2,20,1320,524,526,1050,"21 de agosto de 1994"
11,2,20,1321,347,387,734,"21 de agosto de 1994"
11,2,20,1322,635,701,1336,"21 de agosto de 1994"
11,2,20,1323,569,618,1187,"21 de agosto de 1994"
11,2,20,1324,412,449,861,"21 de agosto de 1994"
11,2,20,1325,350,409,759,"21 de agosto de 1994"
11,2,20,1326,331,373,704,"21 de agosto de 1994"
11,2,20,1327,210,261,471,"21 de agosto de 1994"
11,2,20,1328,373,459,832,"21 de agosto de 1994"
11,2,20,1329,381,416,797,"21 de agosto de 1994"
11,2,20,1330,530,609,1139,"21 de agosto de 1994"
11,2,20,1331,205,214,419,"21 de agosto de 1994"
11,2,20,1332,411,460,871,"21 de agosto de 1994"
11,2,20,1333,483,540,1023,"21 de agosto de 1994"
11,2,20,1334,382,431,813,"21 de agosto de 1994"
11,2,20,1335,399,429,828,"21 de agosto de 1994"
11,2,20,1336,358,399,757,"21 de agosto de 1994"
11,2,20,1337,582,629,1211,"21 de agosto de 1994"
11,2,20,1338,271,271,542,"21 de agosto de 1994"
11,2,20,1339,511,545,1056,"21 de agosto de 1994"
11,2,20,1340,584,598,1182,"21 de agosto de 1994"
11,2,20,1341,568,649,1217,"21 de agosto de 1994"
11,2,20,1342,595,635,1230,"21 de agosto de 1994"
11,2,20,1343,290,348,638,"21 de agosto de 1994"
11,2,20,1344,372,437,809,"21 de agosto de 1994"
11,2,20,1345,271,316,587,"21 de agosto de 1994"
11,2,20,1346,343,394,737,"21 de agosto de 1994"
11,2,20,1347,400,467,867,"21 de agosto de 1994"
11,2,20,1348,440,463,903,"21 de agosto de 1994"
11,2,20,1349,678,738,1416,"21 de agosto de 1994"
11,2,20,1350,449,489,938,"21 de agosto de 1994"
11,2,20,1351,298,354,652,"21 de agosto de 1994"
11,2,20,1352,474,547,1021,"21 de agosto de 1994"
11,2,20,1353,477,547,1024,"21 de agosto de 1994"
11,2,20,1354,579,642,1221,"21 de agosto de 1994"
11,2,20,1355,556,601,1157,"21 de agosto de 1994"
11,2,20,1356,627,735,1362,"21 de agosto de 1994"
11,2,20,1357,477,574,1051,"21 de agosto de 1994"
11,2,20,1358,470,458,928,"21 de agosto de 1994"
11,2,20,1359,449,516,965,"21 de agosto de 1994"
11,2,20,1360,452,503,955,"21 de agosto de 1994"
11,2,20,1361,329,342,671,"21 de agosto de 1994"
11,2,20,1362,534,557,1091,"21 de agosto de 1994"
11,2,20,1363,541,584,1125,"21 de agosto de 1994"
11,2,20,1364,528,576,1104,"21 de agosto de 1994"
11,2,20,1365,394,444,838,"21 de agosto de 1994"
11,2,20,1366,339,380,719,"21 de agosto de 1994"
11,2,20,1367,244,277,521,"21 de agosto de 1994"
11,2,20,1368,243,296,539,"21 de agosto de 1994"
11,2,20,1369,507,558,1065,"21 de agosto de 1994"
11,2,20,1370,563,618,1181,"21 de agosto de 1994"
11,2,20,1371,239,292,531,"21 de agosto de 1994"
11,2,20,1372,618,674,1292,"21 de agosto de 1994"
11,2,20,1373,384,420,804,"21 de agosto de 1994"
11,2,20,1374,455,508,963,"21 de agosto de 1994"
11,2,20,1375,337,332,669,"21 de agosto de 1994"
11,2,20,1376,290,309,599,"21 de agosto de 1994"
11,2,20,1377,306,346,652,"21 de agosto de 1994"
11,2,20,1378,332,398,730,"21 de agosto de 1994"
11,2,20,1379,451,484,935,"21 de agosto de 1994"
11,2,20,1380,176,176,352,"21 de agosto de 1994"
11,2,20,1381,207,226,433,"21 de agosto de 1994"
11,2,20,1382,449,521,970,"21 de agosto de 1994"
11,2,20,1383,266,307,573,"21 de agosto de 1994"
11,2,20,1384,321,367,688,"21 de agosto de 1994"
11,2,20,1385,619,641,1260,"21 de agosto de 1994"
11,2,20,1386,476,537,1013,"21 de agosto de 1994"
11,2,20,1387,322,393,715,"21 de agosto de 1994"
11,2,20,1388,460,477,937,"21 de agosto de 1994"
11,2,20,1389,386,431,817,"21 de agosto de 1994"
11,2,20,1390,463,489,952,"21 de agosto de 1994"
11,2,20,1391,427,472,899,"21 de agosto de 1994"
11,2,20,1392,198,222,420,"21 de agosto de 1994"
11,2,20,1393,436,482,918,"21 de agosto de 1994"
11,2,20,1394,375,416,791,"21 de agosto de 1994"
11,2,20,1395,488,546,1034,"21 de agosto de 1994"
11,2,20,1396,608,646,1254,"21 de agosto de 1994"
11,2,20,1397,585,603,1188,"21 de agosto de 1994"
11,2,20,1398,500,576,1076,"21 de agosto de 1994"
11,2,20,1399,184,226,410,"21 de agosto de 1994"
11,2,20,1400,314,397,711,"21 de agosto de 1994"
11,2,20,1401,218,266,484,"21 de agosto de 1994"
11,2,20,1402,204,246,450,"21 de agosto de 1994"
11,2,20,1403,203,237,440,"21 de agosto de 1994"
11,2,20,1404,328,360,688,"21 de agosto de 1994"
11,2,20,1405,330,377,707,"21 de agosto de 1994"
11,2,20,1406,227,286,513,"21 de agosto de 1994"
11,2,20,1407,347,437,784,"21 de agosto de 1994"
11,2,20,1408,480,537,1017,"21 de agosto de 1994"
11,2,20,1409,494,540,1034,"21 de agosto de 1994"
11,2,20,1410,411,479,890,"21 de agosto de 1994"
11,2,20,1411,377,396,773,"21 de agosto de 1994"
11,2,20,1412,350,434,784,"21 de agosto de 1994"
11,2,20,1413,408,454,862,"21 de agosto de 1994"
11,2,20,1414,410,442,852,"21 de agosto de 1994"
11,2,20,1415,375,417,792,"21 de agosto de 1994"
11,2,20,1416,497,566,1063,"21 de agosto de 1994"
11,2,20,1417,437,466,903,"21 de agosto de 1994"
11,2,20,1418,400,489,889,"21 de agosto de 1994"
11,2,20,1419,190,219,409,"21 de agosto de 1994"
11,2,20,1420,274,348,622,"21 de agosto de 1994"
11,2,20,1421,281,363,644,"21 de agosto de 1994"
11,2,20,1422,221,276,497,"21 de agosto de 1994"
11,2,20,1423,152,203,355,"21 de agosto de 1994"
11,2,20,1424,259,339,598,"21 de agosto de 1994"
11,2,20,1425,225,297,522,"21 de agosto de 1994"
11,2,20,1426,242,292,534,"21 de agosto de 1994"
11,2,20,1427,204,284,488,"21 de agosto de 1994"
11,2,20,1428,278,378,656,"21 de agosto de 1994"
11,2,20,1429,231,277,508,"21 de agosto de 1994"
11,2,20,1430,327,407,734,"21 de agosto de 1994"
11,2,20,1431,209,284,493,"21 de agosto de 1994"
11,2,20,1432,325,352,677,"21 de agosto de 1994"
11,2,20,1433,326,383,709,"21 de agosto de 1994"
11,2,20,1434,287,297,584,"21 de agosto de 1994"
11,2,20,1435,289,341,630,"21 de agosto de 1994"
11,2,20,1436,335,371,706,"21 de agosto de 1994"
11,2,20,1437,274,312,586,"21 de agosto de 1994"
11,2,20,1438,423,473,896,"21 de agosto de 1994"
11,2,20,1439,409,511,920,"21 de agosto de 1994"
11,2,20,1440,339,388,727,"21 de agosto de 1994"
11,2,20,1441,213,219,432,"21 de agosto de 1994"
11,2,20,1442,282,284,566,"21 de agosto de 1994"
11,2,20,1443,239,258,497,"21 de agosto de 1994"
11,2,20,1444,209,265,474,"21 de agosto de 1994"
11,2,20,1445,112,179,291,"21 de agosto de 1994"
11,2,20,1446,249,362,611,"21 de agosto de 1994"
11,2,20,1447,307,305,612,"21 de agosto de 1994"
11,2,20,1448,249,269,518,"21 de agosto de 1994"
11,2,20,1449,245,308,553,"21 de agosto de 1994"
11,2,20,1450,382,450,832,"21 de agosto de 1994"
11,2,20,1451,431,510,941,"21 de agosto de 1994"
11,2,20,1452,482,511,993,"21 de agosto de 1994"
11,2,20,1453,376,377,753,"21 de agosto de 1994"
11,2,20,1454,177,208,385,"21 de agosto de 1994"
11,2,20,1455,201,249,450,"21 de agosto de 1994"
11,2,20,1456,260,347,607,"21 de agosto de 1994"
11,2,20,1457,150,191,341,"21 de agosto de 1994"
11,2,20,1458,188,210,398,"21 de agosto de 1994"
11,2,20,1459,265,344,609,"21 de agosto de 1994"
11,2,20,1460,325,435,760,"21 de agosto de 1994"
11,2,20,1461,434,493,927,"21 de agosto de 1994"
11,2,20,1462,200,243,443,"21 de agosto de 1994"
11,2,20,1463,292,366,658,"21 de agosto de 1994"
11,2,20,1464,170,208,378,"21 de agosto de 1994"
11,2,20,1465,406,491,897,"21 de agosto de 1994"
11,2,20,1466,239,272,511,"21 de agosto de 1994"
11,2,20,1467,234,272,506,"21 de agosto de 1994"
11,2,20,1468,424,459,883,"21 de agosto de 1994"
11,2,20,1469,234,257,491,"21 de agosto de 1994"
11,2,20,1470,57,54,111,"21 de agosto de 1994"
11,2,20,1471,53,52,105,"21 de agosto de 1994"
11,2,20,1472,127,122,249,"21 de agosto de 1994"
11,2,20,1473,289,294,583,"21 de agosto de 1994"
11,2,20,1474,234,216,450,"21 de agosto de 1994"
11,2,20,1475,136,142,278,"21 de agosto de 1994"
11,2,20,1476,90,82,172,"21 de agosto de 1994"
11,2,20,1477,300,351,651,"21 de agosto de 1994"
11,2,20,1478,129,133,262,"21 de agosto de 1994"
11,2,20,1479,217,215,432,"21 de agosto de 1994"
11,2,20,1480,378,408,786,"21 de agosto de 1994"
11,2,20,1481,156,154,310,"21 de agosto de 1994"
11,2,20,1482,159,188,347,"21 de agosto de 1994"
11,2,20,1483,208,201,409,"21 de agosto de 1994"
11,2,20,1484,33,38,71,"21 de agosto de 1994"
11,2,20,1485,173,195,368,"21 de agosto de 1994"
11,2,20,1486,236,255,491,"21 de agosto de 1994"
11,2,20,1487,286,305,591,"21 de agosto de 1994"
11,2,20,1488,61,67,128,"21 de agosto de 1994"
11,2,20,1489,254,290,544,"21 de agosto de 1994"
11,2,20,1490,150,189,339,"21 de agosto de 1994"
11,2,20,1491,354,391,745,"21 de agosto de 1994"
11,2,20,1492,245,280,525,"21 de agosto de 1994"
11,2,20,1493,250,285,535,"21 de agosto de 1994"
11,2,20,1494,646,793,1439,"21 de agosto de 1994"
11,2,20,1495,482,437,919,"21 de agosto de 1994"
11,2,20,1496,418,434,852,"21 de agosto de 1994"
11,2,20,1497,295,332,627,"21 de agosto de 1994"
11,2,20,1498,342,387,729,"21 de agosto de 1994"
11,2,20,1499,296,317,613,"21 de agosto de 1994"
11,2,20,1500,483,564,1047,"21 de agosto de 1994"
11,2,20,1501,354,398,752,"21 de agosto de 1994"
11,2,20,1502,308,352,660,"21 de agosto de 1994"
11,2,20,1503,139,141,280,"21 de agosto de 1994"
11,2,20,1504,558,741,1299,"21 de agosto de 1994"
11,2,20,1505,277,397,674,"21 de agosto de 1994"
11,2,20,1506,427,628,1055,"21 de agosto de 1994"
11,2,20,1507,175,189,364,"21 de agosto de 1994"
11,2,20,1508,336,377,713,"21 de agosto de 1994"
11,2,20,1509,450,465,915,"21 de agosto de 1994"
11,2,20,1510,429,480,909,"21 de agosto de 1994"
11,2,20,1511,182,203,385,"21 de agosto de 1994"
11,2,20,1512,284,311,595,"21 de agosto de 1994"
11,2,20,1513,164,163,327,"21 de agosto de 1994"
11,3,20,1514,265,271,536,"21 de agosto de 1994"
11,3,20,1515,308,386,694,"21 de agosto de 1994"
11,3,20,1516,393,502,895,"21 de agosto de 1994"
11,3,20,1517,380,456,836,"21 de agosto de 1994"
11,3,20,1518,601,666,1267,"21 de agosto de 1994"
11,3,20,1519,370,458,828,"21 de agosto de 1994"
11,3,20,1520,223,255,478,"21 de agosto de 1994"
11,3,20,1521,259,300,559,"21 de agosto de 1994"
11,3,20,1522,387,471,858,"21 de agosto de 1994"
11,3,20,1523,370,409,779,"21 de agosto de 1994"
11,3,20,1524,294,324,618,"21 de agosto de 1994"
11,3,20,1525,427,474,901,"21 de agosto de 1994"
11,3,20,1526,470,581,1051,"21 de agosto de 1994"
11,3,20,1527,266,307,573,"21 de agosto de 1994"
11,3,20,1528,268,319,587,"21 de agosto de 1994"
11,3,20,1529,399,444,843,"21 de agosto de 1994"
11,3,20,1530,428,545,973,"21 de agosto de 1994"
11,3,20,1531,478,534,1012,"21 de agosto de 1994"
11,3,20,1532,450,547,997,"21 de agosto de 1994"
11,3,20,1533,449,506,955,"21 de agosto de 1994"
11,3,20,1534,359,382,741,"21 de agosto de 1994"
11,3,20,1535,337,361,698,"21 de agosto de 1994"
11,3,20,1536,284,344,628,"21 de agosto de 1994"
11,3,20,1537,573,638,1211,"21 de agosto de 1994"
11,3,20,1538,652,722,1374,"21 de agosto de 1994"
11,3,20,1539,475,536,1011,"21 de agosto de 1994"
11,3,20,1540,382,441,823,"21 de agosto de 1994"
11,3,20,1541,259,324,583,"21 de agosto de 1994"
11,3,20,1542,246,273,519,"21 de agosto de 1994"
11,3,20,1543,419,483,902,"21 de agosto de 1994"
11,3,20,1544,247,326,573,"21 de agosto de 1994"
11,3,20,1545,339,399,738,"21 de agosto de 1994"
11,3,20,1546,488,548,1036,"21 de agosto de 1994"
11,3,20,1547,644,743,1387,"21 de agosto de 1994"
11,3,20,1548,451,559,1010,"21 de agosto de 1994"
11,3,20,1549,291,362,653,"21 de agosto de 1994"
11,3,20,1550,326,346,672,"21 de agosto de 1994"
11,3,20,1551,293,330,623,"21 de agosto de 1994"
11,3,20,1552,572,619,1191,"21 de agosto de 1994"
11,3,20,1553,546,616,1162,"21 de agosto de 1994"
11,3,20,1554,719,778,1497,"21 de agosto de 1994"
11,3,20,1555,673,712,1385,"21 de agosto de 1994"
11,3,20,1556,560,596,1156,"21 de agosto de 1994"
11,3,20,1557,550,568,1118,"21 de agosto de 1994"
11,3,20,1558,466,504,970,"21 de agosto de 1994"
11,3,20,1559,412,455,867,"21 de agosto de 1994"
11,3,20,1560,452,476,928,"21 de agosto de 1994"
11,3,20,1561,464,529,993,"21 de agosto de 1994"
11,3,20,1562,340,401,741,"21 de agosto de 1994"
11,3,20,1563,271,283,554,"21 de agosto de 1994"
11,3,20,1564,207,209,416,"21 de agosto de 1994"
11,3,20,1565,292,304,596,"21 de agosto de 1994"
11,3,20,1566,482,522,1004,"21 de agosto de 1994"
11,3,20,1567,439,533,972,"21 de agosto de 1994"
11,3,20,1568,398,443,841,"21 de agosto de 1994"
11,3,20,1569,591,621,1212,"21 de agosto de 1994"
11,3,20,1570,352,384,736,"21 de agosto de 1994"
11,3,20,1571,330,353,683,"21 de agosto de 1994"
11,3,20,1572,321,337,658,"21 de agosto de 1994"
11,3,20,1573,268,323,591,"21 de agosto de 1994"
11,3,20,1574,533,618,1151,"21 de agosto de 1994"
11,3,20,1575,382,454,836,"21 de agosto de 1994"
11,3,20,1576,309,347,656,"21 de agosto de 1994"
11,3,20,1577,484,593,1077,"21 de agosto de 1994"
11,3,20,1578,292,315,607,"21 de agosto de 1994"
11,3,20,1579,282,318,600,"21 de agosto de 1994"
11,3,20,1580,260,298,558,"21 de agosto de 1994"
11,3,20,1581,436,473,909,"21 de agosto de 1994"
11,3,20,1582,197,221,418,"21 de agosto de 1994"
11,3,20,1583,409,478,887,"21 de agosto de 1994"
11,3,20,1584,270,330,600,"21 de agosto de 1994"
11,3,20,1585,345,374,719,"21 de agosto de 1994"
11,3,20,1586,378,390,768,"21 de agosto de 1994"
11,3,20,1587,328,355,683,"21 de agosto de 1994"
11,3,20,1588,479,510,989,"21 de agosto de 1994"
11,3,20,1589,479,528,1007,"21 de agosto de 1994"
11,3,20,1590,524,588,1112,"21 de agosto de 1994"
11,3,20,1591,688,814,1502,"21 de agosto de 1994"
11,3,20,1592,575,653,1228,"21 de agosto de 1994"
11,3,20,1593,642,704,1346,"21 de agosto de 1994"
11,3,20,1594,520,564,1084,"21 de agosto de 1994"
11,3,20,1595,381,455,836,"21 de agosto de 1994"
11,3,20,1596,473,512,985,"21 de agosto de 1994"
11,3,20,1597,291,356,647,"21 de agosto de 1994"
11,3,20,1598,509,498,1007,"21 de agosto de 1994"
11,3,20,1599,307,342,649,"21 de agosto de 1994"
11,3,20,1600,580,617,1197,"21 de agosto de 1994"
11,3,20,1601,559,647,1206,"21 de agosto de 1994"
11,3,20,1602,267,345,612,"21 de agosto de 1994"
11,3,20,1603,469,484,953,"21 de agosto de 1994"
11,3,20,1604,564,638,1202,"21 de agosto de 1994"
11,3,20,1605,212,230,442,"21 de agosto de 1994"
11,3,20,1606,466,548,1014,"21 de agosto de 1994"
11,3,20,1607,267,338,605,"21 de agosto de 1994"
11,3,20,1608,453,545,998,"21 de agosto de 1994"
11,3,20,1609,485,517,1002,"21 de agosto de 1994"
11,3,20,1610,489,509,998,"21 de agosto de 1994"
11,3,20,1611,497,579,1076,"21 de agosto de 1994"
11,3,20,1612,592,686,1278,"21 de agosto de 1994"
11,3,20,1613,379,404,783,"21 de agosto de 1994"
11,3,20,1614,601,666,1267,"21 de agosto de 1994"
11,3,20,1615,315,358,673,"21 de agosto de 1994"
11,3,20,1616,360,392,752,"21 de agosto de 1994"
11,3,20,1617,327,375,702,"21 de agosto de 1994"
11,3,20,1618,255,294,549,"21 de agosto de 1994"
11,3,20,1619,247,313,560,"21 de agosto de 1994"
11,3,20,1620,502,578,1080,"21 de agosto de 1994"
11,3,20,1621,311,348,659,"21 de agosto de 1994"
11,3,20,1622,202,241,443,"21 de agosto de 1994"
11,3,20,1623,549,585,1134,"21 de agosto de 1994"
11,3,20,1624,394,441,835,"21 de agosto de 1994"
11,3,20,1625,319,361,680,"21 de agosto de 1994"
11,3,20,1626,500,606,1106,"21 de agosto de 1994"
11,3,20,1627,541,572,1113,"21 de agosto de 1994"
11,3,20,1628,434,463,897,"21 de agosto de 1994"
11,3,20,1629,419,494,913,"21 de agosto de 1994"
11,3,20,1630,242,291,533,"21 de agosto de 1994"
11,3,20,1631,486,536,1022,"21 de agosto de 1994"
11,3,20,1632,513,591,1104,"21 de agosto de 1994"
11,3,20,1633,546,615,1161,"21 de agosto de 1994"
11,3,20,1634,346,370,716,"21 de agosto de 1994"
11,3,20,1635,292,321,613,"21 de agosto de 1994"
11,3,20,1636,271,302,573,"21 de agosto de 1994"
11,3,20,1637,311,336,647,"21 de agosto de 1994"
11,3,20,1638,321,321,642,"21 de agosto de 1994"
11,3,20,1639,383,433,816,"21 de agosto de 1994"
11,3,20,1640,358,422,780,"21 de agosto de 1994"
11,3,20,1641,384,437,821,"21 de agosto de 1994"
11,3,20,1642,581,677,1258,"21 de agosto de 1994"
11,3,20,1643,629,700,1329,"21 de agosto de 1994"
11,3,20,1644,401,476,877,"21 de agosto de 1994"
11,3,20,1645,493,592,1085,"21 de agosto de 1994"
11,3,20,1646,581,609,1190,"21 de agosto de 1994"
11,3,20,1647,626,755,1381,"21 de agosto de 1994"
11,3,20,1648,160,163,323,"21 de agosto de 1994"
11,3,20,1649,490,516,1006,"21 de agosto de 1994"
11,3,20,1650,485,540,1025,"21 de agosto de 1994"
11,3,20,1651,198,234,432,"21 de agosto de 1994"
11,3,20,1652,252,239,491,"21 de agosto de 1994"
11,3,20,1653,349,394,743,"21 de agosto de 1994"
11,3,20,1654,501,538,1039,"21 de agosto de 1994"
11,3,20,1655,340,372,712,"21 de agosto de 1994"
11,3,20,1656,219,253,472,"21 de agosto de 1994"
11,3,20,1657,363,444,807,"21 de agosto de 1994"
11,3,20,1658,607,627,1234,"21 de agosto de 1994"
11,3,20,1659,221,253,474,"21 de agosto de 1994"
11,3,20,1660,409,422,831,"21 de agosto de 1994"
11,3,20,1661,342,378,720,"21 de agosto de 1994"
11,3,20,1662,477,539,1016,"21 de agosto de 1994"
11,3,20,1663,423,435,858,"21 de agosto de 1994"
11,3,20,1664,439,464,903,"21 de agosto de 1994"
11,3,20,1665,493,535,1028,"21 de agosto de 1994"
11,3,20,1666,109,110,219,"21 de agosto de 1994"
11,3,20,1667,644,603,1247,"21 de agosto de 1994"
11,3,20,1668,361,398,759,"21 de agosto de 1994"
11,3,20,1669,414,426,840,"21 de agosto de 1994"
11,3,20,1670,247,300,547,"21 de agosto de 1994"
11,3,20,1671,350,388,738,"21 de agosto de 1994"
11,3,20,1672,409,482,891,"21 de agosto de 1994"
11,3,20,1673,341,364,705,"21 de agosto de 1994"
11,4,17,929,284,325,609,"21 de agosto de 1994"
11,4,17,930,557,607,1164,"21 de agosto de 1994"
11,4,17,931,135,163,298,"21 de agosto de 1994"
11,4,17,932,158,185,343,"21 de agosto de 1994"
11,4,17,933,368,421,789,"21 de agosto de 1994"
11,4,17,934,441,454,895,"21 de agosto de 1994"
11,4,17,935,324,376,700,"21 de agosto de 1994"
11,4,17,936,270,325,595,"21 de agosto de 1994"
11,4,17,937,268,313,581,"21 de agosto de 1994"
11,4,17,938,384,407,791,"21 de agosto de 1994"
11,4,17,939,402,466,868,"21 de agosto de 1994"
11,4,17,940,368,428,796,"21 de agosto de 1994"
11,4,17,941,396,402,798,"21 de agosto de 1994"
11,4,17,942,272,297,569,"21 de agosto de 1994"
11,4,17,943,282,306,588,"21 de agosto de 1994"
11,4,17,944,410,479,889,"21 de agosto de 1994"
11,4,17,945,268,298,566,"21 de agosto de 1994"
11,4,17,946,233,283,516,"21 de agosto de 1994"
11,4,17,947,435,555,990,"21 de agosto de 1994"
11,4,17,948,500,565,1065,"21 de agosto de 1994"
11,4,17,949,436,559,995,"21 de agosto de 1994"
11,4,17,950,452,565,1017,"21 de agosto de 1994"
11,4,17,951,263,281,544,"21 de agosto de 1994"
11,4,17,952,410,493,903,"21 de agosto de 1994"
11,4,17,953,459,558,1017,"21 de agosto de 1994"
11,4,17,954,286,330,616,"21 de agosto de 1994"
11,4,17,955,393,464,857,"21 de agosto de 1994"
11,4,17,956,456,515,971,"21 de agosto de 1994"
11,4,17,957,412,499,911,"21 de agosto de 1994"
11,4,17,958,429,480,909,"21 de agosto de 1994"
11,4,17,959,359,355,714,"21 de agosto de 1994"
11,4,17,960,498,542,1040,"21 de agosto de 1994"
11,4,17,961,315,375,690,"21 de agosto de 1994"
11,4,17,962,334,402,736,"21 de agosto de 1994"
11,4,17,963,515,625,1140,"21 de agosto de 1994"
11,4,17,964,320,398,718,"21 de agosto de 1994"
11,4,17,965,179,208,387,"21 de agosto de 1994"
11,4,17,966,405,449,854,"21 de agosto de 1994"
11,4,17,967,254,308,562,"21 de agosto de 1994"
11,4,17,968,1571,219,1790,"21 de agosto de 1994"
11,4,17,969,388,434,822,"21 de agosto de 1994"
11,4,17,970,225,251,476,"21 de agosto de 1994"
11,4,17,971,452,531,983,"21 de agosto de 1994"
11,4,17,972,266,301,567,"21 de agosto de 1994"
11,4,17,973,398,451,849,"21 de agosto de 1994"
11,4,17,974,470,518,988,"21 de agosto de 1994"
11,4,17,975,508,590,1098,"21 de agosto de 1994"
11,4,17,976,315,396,711,"21 de agosto de 1994"
11,4,17,977,396,496,892,"21 de agosto de 1994"
11,4,17,978,472,563,1035,"21 de agosto de 1994"
11,4,17,979,424,494,918,"21 de agosto de 1994"
11,4,17,980,301,384,685,"21 de agosto de 1994"
11,4,17,981,261,291,552,"21 de agosto de 1994"
11,4,17,982,414,518,932,"21 de agosto de 1994"
11,4,17,983,358,462,820,"21 de agosto de 1994"
11,4,17,984,331,420,751,"21 de agosto de 1994"
11,4,17,985,209,256,465,"21 de agosto de 1994"
11,4,17,986,189,213,402,"21 de agosto de 1994"
11,4,17,987,305,321,626,"21 de agosto de 1994"
11,4,17,988,296,371,667,"21 de agosto de 1994"
11,4,17,989,376,465,841,"21 de agosto de 1994"
11,4,17,990,225,300,525,"21 de agosto de 1994"
11,4,17,991,354,447,801,"21 de agosto de 1994"
11,4,17,992,368,451,819,"21 de agosto de 1994"
11,4,17,993,514,620,1134,"21 de agosto de 1994"
11,4,17,994,517,647,1164,"21 de agosto de 1994"
11,4,17,995,394,507,901,"21 de agosto de 1994"
11,4,17,996,188,276,464,"21 de agosto de 1994"
11,4,17,997,432,470,902,"21 de agosto de 1994"
11,4,17,998,233,281,514,"21 de agosto de 1994"
11,4,17,999,341,372,713,"21 de agosto de 1994"
11,4,17,1000,412,512,924,"21 de agosto de 1994"
11,4,17,1001,241,305,546,"21 de agosto de 1994"
11,4,17,1002,247,345,592,"21 de agosto de 1994"
11,4,17,1003,224,298,522,"21 de agosto de 1994"
11,4,17,1004,251,333,584,"21 de agosto de 1994"
11,4,17,1005,414,478,892,"21 de agosto de 1994"
11,4,17,1006,431,503,934,"21 de agosto de 1994"
11,4,17,1007,393,421,814,"21 de agosto de 1994"
11,4,17,1008,276,361,637,"21 de agosto de 1994"
11,4,17,1009,431,472,903,"21 de agosto de 1994"
11,4,17,1010,406,488,894,"21 de agosto de 1994"
11,4,17,1011,253,316,569,"21 de agosto de 1994"
11,4,17,1012,347,427,774,"21 de agosto de 1994"
11,4,17,1013,332,385,717,"21 de agosto de 1994"
11,4,17,1014,271,324,595,"21 de agosto de 1994"
11,4,17,1015,307,375,682,"21 de agosto de 1994"
11,4,17,1016,267,291,558,"21 de agosto de 1994"
11,4,17,1017,328,390,718,"21 de agosto de 1994"
11,4,17,1018,329,415,744,"21 de agosto de 1994"
11,4,17,1019,359,388,747,"21 de agosto de 1994"
11,4,17,1020,295,368,663,"21 de agosto de 1994"
11,4,17,1021,420,491,911,"21 de agosto de 1994"
11,4,17,1022,246,322,568,"21 de agosto de 1994"
11,4,17,1023,180,245,425,"21 de agosto de 1994"
11,4,17,1024,350,469,819,"21 de agosto de 1994"
11,4,17,1025,309,352,661,"21 de agosto de 1994"
11,4,17,1026,343,381,724,"21 de agosto de 1994"
11,4,17,1027,152,205,357,"21 de agosto de 1994"
11,4,17,1028,195,287,482,"21 de agosto de 1994"
11,4,17,1029,383,435,818,"21 de agosto de 1994"
11,4,17,1030,202,255,457,"21 de agosto de 1994"
11,4,17,1031,227,310,537,"21 de agosto de 1994"
11,4,17,1032,316,446,762,"21 de agosto de 1994"
11,4,17,1033,217,281,498,"21 de agosto de 1994"
11,4,17,1034,412,547,959,"21 de agosto de 1994"
11,4,17,1035,456,537,993,"21 de agosto de 1994"
11,4,17,1036,390,461,851,"21 de agosto de 1994"
11,4,17,1037,385,454,839,"21 de agosto de 1994"
11,4,17,1038,518,594,1112,"21 de agosto de 1994"
11,4,17,1039,477,597,1074,"21 de agosto de 1994"
11,4,17,1040,460,551,1011,"21 de agosto de 1994"
11,4,17,1041,467,584,1051,"21 de agosto de 1994"
11,4,17,1042,248,289,537,"21 de agosto de 1994"
11,4,17,1043,258,315,573,"21 de agosto de 1994"
11,4,17,1044,430,508,938,"21 de agosto de 1994"
11,4,17,1045,341,454,795,"21 de agosto de 1994"
11,4,17,1046,404,488,892,"21 de agosto de 1994"
11,4,17,1047,352,436,788,"21 de agosto de 1994"
11,4,17,1048,291,396,687,"21 de agosto de 1994"
11,4,17,1049,326,402,728,"21 de agosto de 1994"
11,4,17,1050,364,450,814,"21 de agosto de 1994"
11,4,17,1051,457,519,976,"21 de agosto de 1994"
11,4,17,1052,624,744,1368,"21 de agosto de 1994"
11,4,17,1053,232,281,513,"21 de agosto de 1994"
11,4,17,1054,440,464,904,"21 de agosto de 1994"
11,4,17,1055,294,378,672,"21 de agosto de 1994"
11,4,17,1056,409,493,902,"21 de agosto de 1994"
11,4,17,1057,512,576,1088,"21 de agosto de 1994"
11,4,17,1058,429,549,978,"21 de agosto de 1994"
11,4,17,1059,563,625,1188,"21 de agosto de 1994"
11,4,17,1060,507,559,1066,"21 de agosto de 1994"
11,4,17,1061,530,625,1155,"21 de agosto de 1994"
11,4,17,1062,410,518,928,"21 de agosto de 1994"
11,4,17,1063,453,570,1023,"21 de agosto de 1994"
11,4,17,1064,265,274,539,"21 de agosto de 1994"
11,4,17,1065,362,445,807,"21 de agosto de 1994"
11,4,17,1066,363,443,806,"21 de agosto de 1994"
11,4,17,1067,455,482,937,"21 de agosto de 1994"
11,4,17,1068,426,482,908,"21 de agosto de 1994"
11,4,17,1069,305,382,687,"21 de agosto de 1994"
11,4,17,1070,392,457,849,"21 de agosto de 1994"
11,4,17,1071,473,504,977,"21 de agosto de 1994"
11,4,17,1072,492,601,1093,"21 de agosto de 1994"
11,4,17,1073,588,664,1252,"21 de agosto de 1994"
11,4,17,1074,610,669,1279,"21 de agosto de 1994"
11,4,17,1075,345,396,741,"21 de agosto de 1994"
11,4,17,1076,254,337,591,"21 de agosto de 1994"
11,4,17,1077,447,515,962,"21 de agosto de 1994"
11,4,17,1078,379,421,800,"21 de agosto de 1994"
11,4,17,1079,216,288,504,"21 de agosto de 1994"
11,4,17,1080,559,636,1195,"21 de agosto de 1994"
11,4,17,1081,281,331,612,"21 de agosto de 1994"
11,4,17,1082,489,573,1062,"21 de agosto de 1994"
11,4,17,1083,337,388,725,"21 de agosto de 1994"
11,4,17,1084,327,375,702,"21 de agosto de 1994"
11,4,17,1085,275,315,590,"21 de agosto de 1994"
11,4,17,1086,263,322,585,"21 de agosto de 1994"
11,4,17,1087,362,425,787,"21 de agosto de 1994"
11,4,17,1088,226,291,517,"21 de agosto de 1994"
11,4,17,1089,318,384,702,"21 de agosto de 1994"
11,4,17,1090,227,265,492,"21 de agosto de 1994"
11,4,17,1091,293,332,625,"21 de agosto de 1994"
11,4,17,1092,238,273,511,"21 de agosto de 1994"
11,4,17,1093,352,434,786,"21 de agosto de 1994"
11,4,17,1094,461,534,995,"21 de agosto de 1994"
11,4,17,1095,330,398,728,"21 de agosto de 1994"
11,4,17,1096,277,327,604,"21 de agosto de 1994"
11,4,17,1097,254,306,560,"21 de agosto de 1994"
11,4,17,1098,246,278,524,"21 de agosto de 1994"
11,4,17,1099,454,516,970,"21 de agosto de 1994"
11,4,17,1100,265,301,566,"21 de agosto de 1994"
11,4,17,1101,302,345,647,"21 de agosto de 1994"
11,4,17,1102,277,316,593,"21 de agosto de 1994"
11,4,17,1103,427,507,934,"21 de agosto de 1994"
11,4,17,1104,293,315,608,"21 de agosto de 1994"
11,4,17,1105,538,618,1156,"21 de agosto de 1994"
11,4,17,1106,407,456,863,"21 de agosto de 1994"
11,4,17,1107,434,467,901,"21 de agosto de 1994"
11,4,17,1108,328,406,734,"21 de agosto de 1994"
11,4,17,1109,265,311,576,"21 de agosto de 1994"
11,4,17,1110,153,182,335,"21 de agosto de 1994"
11,4,17,1111,296,360,656,"21 de agosto de 1994"
11,4,17,1112,197,228,425,"21 de agosto de 1994"
11,4,17,1113,385,481,866,"21 de agosto de 1994"
11,4,17,1114,402,421,823,"21 de agosto de 1994"
11,4,17,1115,476,534,1010,"21 de agosto de 1994"
11,4,17,1116,571,621,1192,"21 de agosto de 1994"
11,4,17,1117,636,766,1402,"21 de agosto de 1994"
11,4,17,1118,211,234,445,"21 de agosto de 1994"
11,4,17,1119,431,493,924,"21 de agosto de 1994"
11,4,17,1120,351,418,769,"21 de agosto de 1994"
11,4,17,1121,330,376,706,"21 de agosto de 1994"
11,4,17,1122,522,623,1145,"21 de agosto de 1994"
11,4,17,1123,400,448,848,"21 de agosto de 1994"
11,4,17,1124,341,416,757,"21 de agosto de 1994"
11,4,17,1125,305,322,627,"21 de agosto de 1994"
11,4,17,1126,371,374,745,"21 de agosto de 1994"
11,4,17,1127,232,303,535,"21 de agosto de 1994"
11,4,17,1128,259,273,532,"21 de agosto de 1994"
11,4,17,1129,431,515,946,"21 de agosto de 1994"
11,4,17,1130,376,413,789,"21 de agosto de 1994"
11,4,17,1131,415,447,862,"21 de agosto de 1994"
11,4,17,1132,483,478,961,"21 de agosto de 1994"
11,4,17,1133,295,315,610,"21 de agosto de 1994"
11,4,17,1134,287,320,607,"21 de agosto de 1994"
11,4,17,1135,200,190,390,"21 de agosto de 1994"
11,4,17,1136,348,399,747,"21 de agosto de 1994"
11,4,17,1137,347,365,712,"21 de agosto de 1994"
11,4,17,1138,438,460,898,"21 de agosto de 1994"
11,4,17,1139,508,551,1059,"21 de agosto de 1994"
11,4,17,1140,507,554,1061,"21 de agosto de 1994"
11,4,17,1141,434,480,914,"21 de agosto de 1994"
11,4,17,1142,389,445,834,"21 de agosto de 1994"
11,4,17,1143,293,331,624,"21 de agosto de 1994"
11,4,17,1144,346,377,723,"21 de agosto de 1994"
11,4,17,1145,243,263,506,"21 de agosto de 1994"
11,4,17,1146,129,143,272,"21 de agosto de 1994"
11,4,17,1147,412,465,877,"21 de agosto de 1994"
11,4,17,1148,502,566,1068,"21 de agosto de 1994"
11,4,17,1149,324,317,641,"21 de agosto de 1994"
11,4,17,1150,337,357,694,"21 de agosto de 1994"
11,4,17,1151,354,439,793,"21 de agosto de 1994"
11,4,17,1152,500,606,1106,"21 de agosto de 1994"
11,4,17,1153,385,449,834,"21 de agosto de 1994"
11,4,17,1154,327,435,762,"21 de agosto de 1994"
11,4,17,1155,309,395,704,"21 de agosto de 1994"
11,4,17,1156,105,136,241,"21 de agosto de 1994"
11,4,17,1157,446,501,947,"21 de agosto de 1994"
11,4,17,1158,586,688,1274,"21 de agosto de 1994"
11,4,17,1159,420,457,877,"21 de agosto de 1994"
11,4,17,1160,250,335,585,"21 de agosto de 1994"
11,4,17,1161,359,440,799,"21 de agosto de 1994"
11,4,17,1162,501,595,1096,"21 de agosto de 1994"
11,4,17,1163,390,501,891,"21 de agosto de 1994"
11,4,17,1164,600,761,1361,"21 de agosto de 1994"
11,4,17,1165,599,790,1389,"21 de agosto de 1994"
11,4,17,1166,505,545,1050,"21 de agosto de 1994"
11,4,17,1167,542,627,1169,"21 de agosto de 1994"
11,4,17,1168,431,515,946,"21 de agosto de 1994"
11,4,17,1169,463,557,1020,"21 de agosto de 1994"
11,4,17,1170,375,457,832,"21 de agosto de 1994"
11,4,17,1171,208,221,429,"21 de agosto de 1994"
11,4,17,1172,416,494,910,"21 de agosto de 1994"
11,4,17,1173,378,418,796,"21 de agosto de 1994"
11,4,17,1174,443,538,981,"21 de agosto de 1994"
11,4,17,1175,359,390,749,"21 de agosto de 1994"
11,4,17,1176,471,609,1080,"21 de agosto de 1994"
11,4,17,1177,449,551,1000,"21 de agosto de 1994"
11,5,8,567,198,226,424,"21 de agosto de 1994"
11,5,8,568,231,236,467,"21 de agosto de 1994"
11,5,8,569,261,284,545,"21 de agosto de 1994"
11,5,8,570,310,370,680,"21 de agosto de 1994"
11,5,8,571,251,307,558,"21 de agosto de 1994"
11,5,8,572,254,314,568,"21 de agosto de 1994"
11,5,8,573,215,254,469,"21 de agosto de 1994"
11,5,8,574,396,471,867,"21 de agosto de 1994"
11,5,8,575,366,428,794,"21 de agosto de 1994"
11,5,8,576,171,197,368,"21 de agosto de 1994"
11,5,8,577,156,274,430,"21 de agosto de 1994"
11,5,8,578,146,149,295,"21 de agosto de 1994"
11,5,8,579,258,296,554,"21 de agosto de 1994"
11,5,8,580,63,83,146,"21 de agosto de 1994"
11,5,8,581,92,101,193,"21 de agosto de 1994"
11,5,8,582,268,336,604,"21 de agosto de 1994"
11,5,8,583,182,211,393,"21 de agosto de 1994"
11,5,8,584,86,141,227,"21 de agosto de 1994"
11,5,8,585,48,76,124,"21 de agosto de 1994"
11,5,8,586,216,339,555,"21 de agosto de 1994"
11,5,8,587,192,280,472,"21 de agosto de 1994"
11,5,8,588,69,77,146,"21 de agosto de 1994"
11,5,8,589,225,367,592,"21 de agosto de 1994"
11,5,8,590,117,231,348,"21 de agosto de 1994"
11,5,8,591,157,258,415,"21 de agosto de 1994"
11,5,8,592,91,101,192,"21 de agosto de 1994"
11,5,8,593,137,151,288,"21 de agosto de 1994"
11,5,8,594,322,406,728,"21 de agosto de 1994"
11,5,8,595,81,130,211,"21 de agosto de 1994"
11,5,8,596,243,312,555,"21 de agosto de 1994"
11,5,8,597,280,431,711,"21 de agosto de 1994"
11,5,8,598,81,113,194,"21 de agosto de 1994"
11,5,8,599,156,194,350,"21 de agosto de 1994"
11,5,8,600,95,81,176,"21 de agosto de 1994"
11,5,8,601,233,288,521,"21 de agosto de 1994"
11,5,8,602,240,301,541,"21 de agosto de 1994"
11,5,8,603,269,375,644,"21 de agosto de 1994"
11,5,8,604,266,338,604,"21 de agosto de 1994"
11,5,8,605,79,105,184,"21 de agosto de 1994"
11,5,8,606,211,233,444,"21 de agosto de 1994"
11,5,8,607,148,147,295,"21 de agosto de 1994"
11,5,8,608,103,111,214,"21 de agosto de 1994"
11,5,12,717,208,267,475,"21 de agosto de 1994"
11,5,12,718,335,415,750,"21 de agosto de 1994"
11,5,12,719,268,334,602,"21 de agosto de 1994"
11,5,12,720,307,327,634,"21 de agosto de 1994"
11,5,12,721,138,152,290,"21 de agosto de 1994"
11,5,12,722,357,436,793,"21 de agosto de 1994"
11,5,12,723,397,471,868,"21 de agosto de 1994"
11,5,12,724,302,371,673,"21 de agosto de 1994"
11,5,12,725,273,315,588,"21 de agosto de 1994"
11,5,12,726,328,377,705,"21 de agosto de 1994"
11,5,12,727,164,192,356,"21 de agosto de 1994"
11,5,12,728,164,200,364,"21 de agosto de 1994"
11,5,12,729,177,226,403,"21 de agosto de 1994"
11,5,12,730,45,48,93,"21 de agosto de 1994"
11,5,12,731,176,209,385,"21 de agosto de 1994"
11,5,12,732,210,281,491,"21 de agosto de 1994"
11,5,12,733,101,162,263,"21 de agosto de 1994"
11,5,12,734,88,110,198,"21 de agosto de 1994"
11,5,12,735,28,36,64,"21 de agosto de 1994"
11,5,12,736,410,488,898,"21 de agosto de 1994"
11,5,12,737,160,183,343,"21 de agosto de 1994"
11,5,12,738,487,593,1080,"21 de agosto de 1994"
11,5,12,739,339,451,790,"21 de agosto de 1994"
11,5,23,1912,332,358,690,"21 de agosto de 1994"
11,5,23,1913,523,603,1126,"21 de agosto de 1994"
11,5,23,1914,220,256,476,"21 de agosto de 1994"
11,5,23,1915,433,553,986,"21 de agosto de 1994"
11,5,23,1916,397,458,855,"21 de agosto de 1994"
11,5,23,1917,376,450,826,"21 de agosto de 1994"
11,5,23,1918,338,465,803,"21 de agosto de 1994"
11,5,23,1919,270,322,592,"21 de agosto de 1994"
11,5,23,1920,296,341,637,"21 de agosto de 1994"
11,5,23,1921,323,373,696,"21 de agosto de 1994"
11,5,23,1922,378,463,841,"21 de agosto de 1994"
11,5,23,1923,292,333,625,"21 de agosto de 1994"
11,5,23,1924,406,494,900,"21 de agosto de 1994"
11,5,23,1925,234,321,555,"21 de agosto de 1994"
11,5,23,1926,437,558,995,"21 de agosto de 1994"
11,5,23,1927,366,438,804,"21 de agosto de 1994"
11,5,23,1928,320,361,681,"21 de agosto de 1994"
11,5,23,1929,430,529,959,"21 de agosto de 1994"
11,5,23,1930,390,422,812,"21 de agosto de 1994"
11,5,23,1931,298,396,694,"21 de agosto de 1994"
11,5,23,1932,193,226,419,"21 de agosto de 1994"
11,5,23,1933,98,109,207,"21 de agosto de 1994"
11,5,23,1934,95,112,207,"21 de agosto de 1994"
11,5,23,1935,98,111,209,"21 de agosto de 1994"
11,5,23,1936,91,105,196,"21 de agosto de 1994"
11,5,23,1937,95,97,192,"21 de agosto de 1994"
11,5,23,1938,60,52,112,"21 de agosto de 1994"
11,5,23,1939,135,147,282,"21 de agosto de 1994"
11,5,23,1940,343,432,775,"21 de agosto de 1994"
11,5,23,1941,144,154,298,"21 de agosto de 1994"
11,5,23,1942,255,274,529,"21 de agosto de 1994"
11,5,23,1943,342,421,763,"21 de agosto de 1994"
11,5,23,1944,290,354,644,"21 de agosto de 1994"
11,5,23,1945,240,253,493,"21 de agosto de 1994"
11,5,23,1946,120,102,222,"21 de agosto de 1994"
11,5,23,1947,353,463,816,"21 de agosto de 1994"
11,5,23,1948,369,419,788,"21 de agosto de 1994"
11,5,23,1949,250,356,606,"21 de agosto de 1994"
11,5,23,1950,118,127,245,"21 de agosto de 1994"
11,5,23,1951,96,110,206,"21 de agosto de 1994"
11,5,23,1952,200,312,512,"21 de agosto de 1994"
11,5,23,1953,197,221,418,"21 de agosto de 1994"
11,5,23,1954,196,212,408,"21 de agosto de 1994"
11,5,23,1955,177,195,372,"21 de agosto de 1994"
11,5,23,1956,275,378,653,"21 de agosto de 1994"
11,5,23,1957,311,293,604,"21 de agosto de 1994"
11,5,23,1958,104,99,203,"21 de agosto de 1994"
11,5,23,1959,256,261,517,"21 de agosto de 1994"
11,5,23,1960,272,400,672,"21 de agosto de 1994"
11,5,23,1961,181,232,413,"21 de agosto de 1994"
11,5,23,1962,268,346,614,"21 de agosto de 1994"
11,5,23,1963,401,454,855,"21 de agosto de 1994"
11,5,23,1964,313,386,699,"21 de agosto de 1994"
11,5,23,1965,130,167,297,"21 de agosto de 1994"
11,5,23,1966,231,290,521,"21 de agosto de 1994"
11,5,23,1967,314,462,776,"21 de agosto de 1994"
11,5,23,1968,397,537,934,"21 de agosto de 1994"
11,5,23,1969,506,602,1108,"21 de agosto de 1994"
11,5,23,1970,272,317,589,"21 de agosto de 1994"
11,5,23,1971,291,399,690,"21 de agosto de 1994"
11,5,23,1972,253,323,576,"21 de agosto de 1994"
11,5,23,1973,332,408,740,"21 de agosto de 1994"
11,5,23,1974,638,770,1408,"21 de agosto de 1994"
11,5,23,1975,339,410,749,"21 de agosto de 1994"
11,5,23,1976,438,472,910,"21 de agosto de 1994"
11,5,23,1977,314,349,663,"21 de agosto de 1994"
11,5,23,1978,100,146,246,"21 de agosto de 1994"
11,5,23,1979,307,398,705,"21 de agosto de 1994"
11,5,23,1980,168,196,364,"21 de agosto de 1994"
11,5,23,1981,292,304,596,"21 de agosto de 1994"
11,5,23,1982,617,742,1359,"21 de agosto de 1994"
11,5,23,1983,310,410,720,"21 de agosto de 1994"
11,5,23,1984,184,246,430,"21 de agosto de 1994"
11,5,23,1985,228,254,482,"21 de agosto de 1994"
11,5,23,1986,338,446,784,"21 de agosto de 1994"
11,5,23,1987,448,524,972,"21 de agosto de 1994"
11,5,23,1988,391,482,873,"21 de agosto de 1994"
11,5,23,1989,174,224,398,"21 de agosto de 1994"
11,5,23,1990,351,476,827,"21 de agosto de 1994"
11,5,23,1991,300,403,703,"21 de agosto de 1994"
11,5,23,1992,248,300,548,"21 de agosto de 1994"
11,5,23,1993,296,371,667,"21 de agosto de 1994"
11,5,23,1994,326,362,688,"21 de agosto de 1994"
11,5,23,1995,244,273,517,"21 de agosto de 1994"
11,5,23,1996,353,435,788,"21 de agosto de 1994"
11,5,23,1997,186,243,429,"21 de agosto de 1994"
11,5,23,1998,345,453,798,"21 de agosto de 1994"
11,5,23,1999,190,219,409,"21 de agosto de 1994"
11,5,23,2000,76,92,168,"21 de agosto de 1994"
11,5,23,2001,254,350,604,"21 de agosto de 1994"
11,5,23,2002,316,446,762,"21 de agosto de 1994"
11,5,23,2003,301,405,706,"21 de agosto de 1994"
11,5,23,2004,179,252,431,"21 de agosto de 1994"
11,5,23,2005,335,426,761,"21 de agosto de 1994"
11,5,23,2006,312,426,738,"21 de agosto de 1994"
11,5,23,2007,304,296,600,"21 de agosto de 1994"
11,5,23,2008,329,374,703,"21 de agosto de 1994"
11,5,23,2009,366,545,911,"21 de agosto de 1994"
11,5,23,2010,181,263,444,"21 de agosto de 1994"
11,5,23,2011,243,316,559,"21 de agosto de 1994"
11,5,23,2012,246,338,584,"21 de agosto de 1994"
11,5,23,2013,210,330,540,"21 de agosto de 1994"
11,5,23,2014,189,335,524,"21 de agosto de 1994"
11,5,23,2015,70,123,193,"21 de agosto de 1994"
11,5,23,2016,312,373,685,"21 de agosto de 1994"
11,5,23,2017,334,527,861,"21 de agosto de 1994"
11,5,23,2018,474,634,1108,"21 de agosto de 1994"
11,5,23,2019,211,277,488,"21 de agosto de 1994"
11,5,23,2020,221,329,550,"21 de agosto de 1994"
11,5,23,2021,291,453,744,"21 de agosto de 1994"
11,5,23,2022,153,243,396,"21 de agosto de 1994"
11,5,23,2023,230,374,604,"21 de agosto de 1994"
11,5,23,2024,191,317,508,"21 de agosto de 1994"
11,5,23,2025,348,461,809,"21 de agosto de 1994"
11,5,25,2034,245,251,496,"21 de agosto de 1994"
11,5,25,2035,285,278,563,"21 de agosto de 1994"
11,5,25,2036,626,681,1307,"21 de agosto de 1994"
11,5,25,2037,401,420,821,"21 de agosto de 1994"
11,5,25,2038,517,623,1140,"21 de agosto de 1994"
11,5,25,2039,369,398,767,"21 de agosto de 1994"
11,5,25,2040,343,402,745,"21 de agosto de 1994"
11,5,25,2041,516,569,1085,"21 de agosto de 1994"
11,5,25,2042,649,707,1356,"21 de agosto de 1994"
11,5,25,2043,355,395,750,"21 de agosto de 1994"
11,5,25,2044,360,494,854,"21 de agosto de 1994"
11,5,25,2045,270,325,595,"21 de agosto de 1994"
11,5,25,2046,138,172,310,"21 de agosto de 1994"
11,5,25,2047,177,210,387,"21 de agosto de 1994"
11,5,25,2048,257,356,613,"21 de agosto de 1994"
11,5,25,2049,386,501,887,"21 de agosto de 1994"
11,5,25,2050,248,354,602,"21 de agosto de 1994"
11,5,25,2051,290,321,611,"21 de agosto de 1994"
11,5,25,2052,361,452,813,"21 de agosto de 1994"
11,5,25,2053,291,389,680,"21 de agosto de 1994"
11,5,25,2054,212,289,501,"21 de agosto de 1994"
11,5,25,2055,296,369,665,"21 de agosto de 1994"
11,5,25,2056,125,153,278,"21 de agosto de 1994"
11,5,25,2057,157,183,340,"21 de agosto de 1994"
11,5,25,2058,75,72,147,"21 de agosto de 1994"
11,5,31,2446,125,170,295,"21 de agosto de 1994"
11,5,31,2447,75,75,150,"21 de agosto de 1994"
11,5,31,2448,431,504,935,"21 de agosto de 1994"
11,5,31,2449,553,604,1157,"21 de agosto de 1994"
11,5,31,2450,328,360,688,"21 de agosto de 1994"
11,5,31,2451,454,520,974,"21 de agosto de 1994"
11,5,31,2452,544,571,1115,"21 de agosto de 1994"
11,5,31,2453,541,582,1123,"21 de agosto de 1994"
11,5,31,2454,355,409,764,"21 de agosto de 1994"
11,5,31,2455,82,126,208,"21 de agosto de 1994"
11,5,31,2456,323,339,662,"21 de agosto de 1994"
11,5,31,2457,423,504,927,"21 de agosto de 1994"
11,5,31,2458,350,432,782,"21 de agosto de 1994"
11,5,31,2459,259,304,563,"21 de agosto de 1994"
11,5,31,2460,419,496,915,"21 de agosto de 1994"
11,5,31,2461,368,447,815,"21 de agosto de 1994"
11,5,31,2462,309,392,701,"21 de agosto de 1994"
11,5,31,2463,580,664,1244,"21 de agosto de 1994"
11,5,31,2464,178,214,392,"21 de agosto de 1994"
11,5,31,2465,378,403,781,"21 de agosto de 1994"
11,5,31,2466,478,500,978,"21 de agosto de 1994"
11,5,31,2467,333,392,725,"21 de agosto de 1994"
11,5,31,2468,472,541,1013,"21 de agosto de 1994"
11,5,31,2469,283,318,601,"21 de agosto de 1994"
11,5,31,2470,205,205,410,"21 de agosto de 1994"
11,5,31,2471,392,472,864,"21 de agosto de 1994"
11,5,31,2472,327,397,724,"21 de agosto de 1994"
11,5,31,2473,351,407,758,"21 de agosto de 1994"
11,5,31,2474,504,568,1072,"21 de agosto de 1994"
11,5,31,2475,252,276,528,"21 de agosto de 1994"
11,5,31,2476,458,531,989,"21 de agosto de 1994"
11,5,31,2477,487,524,1011,"21 de agosto de 1994"
11,5,31,2478,227,241,468,"21 de agosto de 1994"
11,5,31,2479,311,383,694,"21 de agosto de 1994"
11,5,31,2480,227,274,501,"21 de agosto de 1994"
11,5,31,2481,375,372,747,"21 de agosto de 1994"
11,5,31,2482,405,482,887,"21 de agosto de 1994"
11,5,31,2483,251,308,559,"21 de agosto de 1994"
11,5,31,2484,113,170,283,"21 de agosto de 1994"
11,5,31,2485,309,430,739,"21 de agosto de 1994"
11,5,31,2486,520,572,1092,"21 de agosto de 1994"
11,5,31,2487,292,389,681,"21 de agosto de 1994"
11,5,31,2488,254,208,462,"21 de agosto de 1994"
11,5,31,2489,198,222,420,"21 de agosto de 1994"
11,5,31,2490,268,316,584,"21 de agosto de 1994"
11,5,31,2491,179,229,408,"21 de agosto de 1994"
11,5,31,2492,268,301,569,"21 de agosto de 1994"
11,5,31,2493,179,207,386,"21 de agosto de 1994"
11,5,31,2494,304,303,607,"21 de agosto de 1994"
11,5,31,2495,255,296,551,"21 de agosto de 1994"
11,5,31,2496,377,442,819,"21 de agosto de 1994"
11,5,31,2497,199,243,442,"21 de agosto de 1994"
11,5,31,2498,210,256,466,"21 de agosto de 1994"
11,5,31,2499,269,358,627,"21 de agosto de 1994"
11,5,31,2500,189,224,413,"21 de agosto de 1994"
11,5,31,2501,169,243,412,"21 de agosto de 1994"
11,5,31,2502,225,361,586,"21 de agosto de 1994"
11,5,31,2503,174,208,382,"21 de agosto de 1994"
11,5,31,2504,165,234,399,"21 de agosto de 1994"
11,6,1,1,476,541,1017,"21 de agosto de 1994"
11,6,1,2,593,671,1264,"21 de agosto de 1994"
11,6,1,3,513,591,1104,"21 de agosto de 1994"
11,6,1,4,483,554,1037,"21 de agosto de 1994"
11,6,1,5,414,480,894,"21 de agosto de 1994"
11,6,1,6,475,514,989,"21 de agosto de 1994"
11,6,1,7,450,509,959,"21 de agosto de 1994"
11,6,1,8,528,588,1116,"21 de agosto de 1994"
11,6,1,9,511,604,1115,"21 de agosto de 1994"
11,6,1,10,469,495,964,"21 de agosto de 1994"
11,6,1,11,352,412,764,"21 de agosto de 1994"
11,6,1,12,412,512,924,"21 de agosto de 1994"
11,6,1,13,212,269,481,"21 de agosto de 1994"
11,6,1,14,168,222,390,"21 de agosto de 1994"
11,6,1,15,190,261,451,"21 de agosto de 1994"
11,6,1,16,403,495,898,"21 de agosto de 1994"
11,6,1,17,335,435,770,"21 de agosto de 1994"
11,6,1,18,236,317,553,"21 de agosto de 1994"
11,6,1,19,301,396,697,"21 de agosto de 1994"
11,6,1,20,494,618,1112,"21 de agosto de 1994"
11,6,1,21,404,431,835,"21 de agosto de 1994"
11,6,1,22,456,570,1026,"21 de agosto de 1994"
11,6,1,23,118,151,269,"21 de agosto de 1994"
11,6,1,24,503,587,1090,"21 de agosto de 1994"
11,6,1,25,245,293,538,"21 de agosto de 1994"
11,6,1,26,398,462,860,"21 de agosto de 1994"
11,6,1,27,326,352,678,"21 de agosto de 1994"
11,6,1,28,162,176,338,"21 de agosto de 1994"
11,6,1,29,256,340,596,"21 de agosto de 1994"
11,6,1,30,216,273,489,"21 de agosto de 1994"
11,6,1,31,302,358,660,"21 de agosto de 1994"
11,6,1,32,282,311,593,"21 de agosto de 1994"
11,6,1,33,180,216,396,"21 de agosto de 1994"
11,6,1,34,455,590,1045,"21 de agosto de 1994"
11,6,1,35,234,220,454,"21 de agosto de 1994"
11,6,1,36,212,238,450,"21 de agosto de 1994"
11,6,1,37,299,408,707,"21 de agosto de 1994"
11,6,1,38,508,577,1085,"21 de agosto de 1994"
11,6,1,39,218,213,431,"21 de agosto de 1994"
11,6,1,40,373,511,884,"21 de agosto de 1994"
11,6,1,41,397,628,1025,"21 de agosto de 1994"
11,6,1,42,320,403,723,"21 de agosto de 1994"
11,6,1,43,96,115,211,"21 de agosto de 1994"
11,6,1,44,194,223,417,"21 de agosto de 1994"
11,6,1,45,126,182,308,"21 de agosto de 1994"
11,6,1,46,248,300,548,"21 de agosto de 1994"
11,6,1,47,391,488,879,"21 de agosto de 1994"
11,6,1,48,337,409,746,"21 de agosto de 1994"
11,6,1,49,197,245,442,"21 de agosto de 1994"
11,6,1,50,326,440,766,"21 de agosto de 1994"
11,6,16,916,352,420,772,"21 de agosto de 1994"
11,6,16,917,430,504,934,"21 de agosto de 1994"
11,6,16,918,291,380,671,"21 de agosto de 1994"
11,6,16,919,400,512,912,"21 de agosto de 1994"
11,6,16,920,149,177,326,"21 de agosto de 1994"
11,6,16,921,251,295,546,"21 de agosto de 1994"
11,6,16,922,440,594,1034,"21 de agosto de 1994"
11,6,16,923,533,627,1160,"21 de agosto de 1994"
11,6,16,924,206,230,436,"21 de agosto de 1994"
11,6,16,925,391,498,889,"21 de agosto de 1994"
11,6,16,926,141,192,333,"21 de agosto de 1994"
11,6,16,927,336,462,798,"21 de agosto de 1994"
11,6,16,928,402,552,954,"21 de agosto de 1994"
11,6,24,2026,400,493,893,"21 de agosto de 1994"
11,6,24,2027,271,333,604,"21 de agosto de 1994"
11,6,24,2028,411,529,940,"21 de agosto de 1994"
11,6,24,2029,365,477,842,"21 de agosto de 1994"
11,6,24,2030,364,482,846,"21 de agosto de 1994"
11,6,24,2031,242,323,565,"21 de agosto de 1994"
11,6,24,2032,237,333,570,"21 de agosto de 1994"
11,6,24,2033,119,157,276,"21 de agosto de 1994"
11,6,27,2109,140,138,278,"21 de agosto de 1994"
11,6,27,2110,693,754,1447,"21 de agosto de 1994"
11,6,27,2111,680,750,1430,"21 de agosto de 1994"
11,6,27,2112,579,619,1198,"21 de agosto de 1994"
11,6,27,2113,250,286,536,"21 de agosto de 1994"
11,6,27,2114,333,358,691,"21 de agosto de 1994"
11,6,27,2115,285,283,568,"21 de agosto de 1994"
11,6,27,2116,304,358,662,"21 de agosto de 1994"
11,6,27,2117,395,442,837,"21 de agosto de 1994"
11,6,27,2118,387,420,807,"21 de agosto de 1994"
11,6,27,2119,371,392,763,"21 de agosto de 1994"
11,6,27,2120,350,399,749,"21 de agosto de 1994"
11,6,27,2121,336,370,706,"21 de agosto de 1994"
11,6,27,2122,279,286,565,"21 de agosto de 1994"
11,6,27,2123,441,514,955,"21 de agosto de 1994"
11,6,27,2124,299,345,644,"21 de agosto de 1994"
11,6,27,2125,361,453,814,"21 de agosto de 1994"
11,6,27,2126,331,401,732,"21 de agosto de 1994"
11,6,27,2127,340,382,722,"21 de agosto de 1994"
11,6,27,2128,339,388,727,"21 de agosto de 1994"
11,6,27,2129,523,557,1080,"21 de agosto de 1994"
11,6,27,2130,321,357,678,"21 de agosto de 1994"
11,6,27,2131,373,407,780,"21 de agosto de 1994"
11,6,27,2132,308,305,613,"21 de agosto de 1994"
11,6,27,2133,419,464,883,"21 de agosto de 1994"
11,6,27,2134,314,360,674,"21 de agosto de 1994"
11,6,27,2135,506,569,1075,"21 de agosto de 1994"
11,6,27,2136,537,599,1136,"21 de agosto de 1994"
11,6,27,2137,280,318,598,"21 de agosto de 1994"
11,6,27,2138,230,262,492,"21 de agosto de 1994"
11,6,27,2139,343,402,745,"21 de agosto de 1994"
11,6,27,2140,466,521,987,"21 de agosto de 1994"
11,6,27,2141,478,517,995,"21 de agosto de 1994"
11,6,27,2142,263,339,602,"21 de agosto de 1994"
11,6,27,2143,383,407,790,"21 de agosto de 1994"
11,6,27,2144,501,560,1061,"21 de agosto de 1994"
11,6,27,2145,294,320,614,"21 de agosto de 1994"
11,6,27,2146,492,580,1072,"21 de agosto de 1994"
11,6,27,2147,416,450,866,"21 de agosto de 1994"
11,6,27,2148,426,460,886,"21 de agosto de 1994"
11,6,27,2149,330,366,696,"21 de agosto de 1994"
11,6,27,2150,416,457,873,"21 de agosto de 1994"
11,6,27,2151,445,483,928,"21 de agosto de 1994"
11,6,27,2152,295,328,623,"21 de agosto de 1994"
11,6,27,2153,373,420,793,"21 de agosto de 1994"
11,6,27,2154,348,390,738,"21 de agosto de 1994"
11,6,27,2155,305,357,662,"21 de agosto de 1994"
11,6,27,2156,396,464,860,"21 de agosto de 1994"
11,6,27,2157,354,432,786,"21 de agosto de 1994"
11,6,27,2158,270,313,583,"21 de agosto de 1994"
11,6,27,2159,488,543,1031,"21 de agosto de 1994"
11,6,27,2160,548,604,1152,"21 de agosto de 1994"
11,6,27,2161,317,354,671,"21 de agosto de 1994"
11,6,27,2162,373,440,813,"21 de agosto de 1994"
11,6,27,2163,466,521,987,"21 de agosto de 1994"
11,6,27,2164,421,436,857,"21 de agosto de 1994"
11,6,27,2165,325,411,736,"21 de agosto de 1994"
11,6,27,2166,504,578,1082,"21 de agosto de 1994"
11,6,27,2167,456,497,953,"21 de agosto de 1994"
11,6,27,2168,455,491,946,"21 de agosto de 1994"
11,6,27,2169,318,347,665,"21 de agosto de 1994"
11,6,27,2170,478,532,1010,"21 de agosto de 1994"
11,6,27,2171,490,562,1052,"21 de agosto de 1994"
11,6,27,2172,295,356,651,"21 de agosto de 1994"
11,6,27,2173,301,355,656,"21 de agosto de 1994"
11,6,27,2174,297,301,598,"21 de agosto de 1994"
11,6,27,2175,368,368,736,"21 de agosto de 1994"
11,6,27,2176,427,460,887,"21 de agosto de 1994"
11,6,27,2177,470,498,968,"21 de agosto de 1994"
11,6,27,2178,295,351,646,"21 de agosto de 1994"
11,6,27,2179,601,653,1254,"21 de agosto de 1994"
11,6,27,2180,292,335,627,"21 de agosto de 1994"
11,6,27,2181,521,568,1089,"21 de agosto de 1994"
11,6,27,2182,469,484,953,"21 de agosto de 1994"
11,6,27,2183,452,487,939,"21 de agosto de 1994"
11,6,27,2184,571,577,1148,"21 de agosto de 1994"
11,6,27,2185,350,374,724,"21 de agosto de 1994"
11,6,27,2186,504,587,1091,"21 de agosto de 1994"
11,6,27,2187,521,569,1090,"21 de agosto de 1994"
11,6,27,2188,449,485,934,"21 de agosto de 1994"
11,6,27,2189,190,211,401,"21 de agosto de 1994"
11,6,27,2190,396,450,846,"21 de agosto de 1994"
11,6,27,2191,462,475,937,"21 de agosto de 1994"
11,6,27,2192,430,454,884,"21 de agosto de 1994"
11,6,27,2193,673,744,1417,"21 de agosto de 1994"
11,6,27,2194,437,504,941,"21 de agosto de 1994"
11,6,27,2195,437,477,914,"21 de agosto de 1994"
11,6,27,2196,294,325,619,"21 de agosto de 1994"
11,6,27,2197,459,523,982,"21 de agosto de 1994"
11,6,27,2198,567,558,1125,"21 de agosto de 1994"
11,6,27,2199,161,182,343,"21 de agosto de 1994"
11,6,27,2200,279,283,562,"21 de agosto de 1994"
11,6,27,2201,171,187,358,"21 de agosto de 1994"
11,6,27,2202,183,214,397,"21 de agosto de 1994"
11,6,27,2203,216,267,483,"21 de agosto de 1994"
11,6,27,2204,556,660,1216,"21 de agosto de 1994"
11,6,27,2205,136,172,308,"21 de agosto de 1994"
11,6,27,2206,210,298,508,"21 de agosto de 1994"
11,6,27,2207,316,346,662,"21 de agosto de 1994"
11,6,27,2208,328,353,681,"21 de agosto de 1994"
11,6,27,2209,250,272,522,"21 de agosto de 1994"
11,6,27,2210,269,387,656,"21 de agosto de 1994"
11,6,27,2211,175,211,386,"21 de agosto de 1994"
11,6,27,2212,289,361,650,"21 de agosto de 1994"
11,6,27,2213,284,356,640,"21 de agosto de 1994"
11,6,27,2214,124,119,243,"21 de agosto de 1994"
11,6,27,2215,241,270,511,"21 de agosto de 1994"
11,6,27,2216,363,401,764,"21 de agosto de 1994"
11,6,27,2217,301,391,692,"21 de agosto de 1994"
11,6,27,2218,370,458,828,"21 de agosto de 1994"
11,6,27,2219,464,544,1008,"21 de agosto de 1994"
11,6,27,2220,253,273,526,"21 de agosto de 1994"
11,6,27,2221,230,305,535,"21 de agosto de 1994"
11,6,27,2222,275,342,617,"21 de agosto de 1994"
11,6,27,2223,481,565,1046,"21 de agosto de 1994"
11,6,27,2224,380,392,772,"21 de agosto de 1994"
11,6,27,2225,362,440,802,"21 de agosto de 1994"
11,6,27,2226,452,488,940,"21 de agosto de 1994"
11,6,27,2227,370,425,795,"21 de agosto de 1994"
11,6,27,2228,376,380,756,"21 de agosto de 1994"
11,6,27,2229,239,268,507,"21 de agosto de 1994"
11,6,27,2230,585,608,1193,"21 de agosto de 1994"
11,6,27,2231,439,498,937,"21 de agosto de 1994"
11,6,27,2232,355,408,763,"21 de agosto de 1994"
11,6,27,2233,469,520,989,"21 de agosto de 1994"
11,6,27,2234,340,395,735,"21 de agosto de 1994"
11,6,27,2235,182,203,385,"21 de agosto de 1994"
11,6,27,2236,396,464,860,"21 de agosto de 1994"
11,6,27,2237,177,246,423,"21 de agosto de 1994"
11,6,27,2238,367,470,837,"21 de agosto de 1994"
11,6,27,2239,387,402,789,"21 de agosto de 1994"
11,6,27,2240,295,343,638,"21 de agosto de 1994"
11,6,27,2241,302,341,643,"21 de agosto de 1994"
11,6,27,2242,405,422,827,"21 de agosto de 1994"
11,6,27,2243,451,495,946,"21 de agosto de 1994"
11,6,27,2244,478,551,1029,"21 de agosto de 1994"
11,6,27,2245,533,578,1111,"21 de agosto de 1994"
11,6,27,2246,336,372,708,"21 de agosto de 1994"
11,6,27,2247,275,290,565,"21 de agosto de 1994"
11,6,27,2248,358,466,824,"21 de agosto de 1994"
11,6,27,2249,271,354,625,"21 de agosto de 1994"
11,6,27,2250,185,187,372,"21 de agosto de 1994"
11,6,27,2251,332,530,862,"21 de agosto de 1994"
11,6,27,2252,573,371,944,"21 de agosto de 1994"
11,6,27,2253,426,481,907,"21 de agosto de 1994"
11,6,27,2254,322,408,730,"21 de agosto de 1994"
11,6,27,2255,149,208,357,"21 de agosto de 1994"
11,6,27,2256,130,240,370,"21 de agosto de 1994"
11,6,27,2257,306,352,658,"21 de agosto de 1994"
11,6,27,2258,304,348,652,"21 de agosto de 1994"
11,6,27,2259,227,345,572,"21 de agosto de 1994"
11,6,27,2260,312,358,670,"21 de agosto de 1994"
11,6,27,2261,308,391,699,"21 de agosto de 1994"
11,6,27,2262,228,328,556,"21 de agosto de 1994"
11,7,2,51,208,299,507,"21 de agosto de 1994"
11,7,2,52,344,403,747,"21 de agosto de 1994"
11,7,2,53,412,499,911,"21 de agosto de 1994"
11,7,2,54,340,411,751,"21 de agosto de 1994"
11,7,2,55,260,320,580,"21 de agosto de 1994"
11,7,2,56,481,605,1086,"21 de agosto de 1994"
11,7,2,57,247,306,553,"21 de agosto de 1994"
11,7,2,58,187,219,406,"21 de agosto de 1994"
11,7,2,59,453,511,964,"21 de agosto de 1994"
11,7,2,60,345,476,821,"21 de agosto de 1994"
11,7,2,61,363,461,824,"21 de agosto de 1994"
11,7,2,62,398,452,850,"21 de agosto de 1994"
11,7,2,63,280,407,687,"21 de agosto de 1994"
11,7,2,64,349,387,736,"21 de agosto de 1994"
11,7,2,65,440,504,944,"21 de agosto de 1994"
11,7,2,66,363,434,797,"21 de agosto de 1994"
11,7,2,67,454,520,974,"21 de agosto de 1994"
11,7,2,68,379,470,849,"21 de agosto de 1994"
11,7,2,69,263,320,583,"21 de agosto de 1994"
11,7,2,70,395,480,875,"21 de agosto de 1994"
11,7,2,71,300,389,689,"21 de agosto de 1994"
11,7,2,72,435,533,968,"21 de agosto de 1994"
11,7,2,73,374,460,834,"21 de agosto de 1994"
11,7,2,74,651,722,1373,"21 de agosto de 1994"
11,7,2,75,299,333,632,"21 de agosto de 1994"
11,7,2,76,374,442,816,"21 de agosto de 1994"
11,7,2,77,514,636,1150,"21 de agosto de 1994"
11,7,2,78,299,364,663,"21 de agosto de 1994"
11,7,2,79,232,305,537,"21 de agosto de 1994"
11,7,2,80,418,497,915,"21 de agosto de 1994"
11,7,2,81,391,469,860,"21 de agosto de 1994"
11,7,2,82,181,228,409,"21 de agosto de 1994"
11,7,2,83,426,506,932,"21 de agosto de 1994"
11,7,2,84,371,428,799,"21 de agosto de 1994"
11,7,2,85,352,410,762,"21 de agosto de 1994"
11,7,2,86,443,467,910,"21 de agosto de 1994"
11,7,2,87,86,114,200,"21 de agosto de 1994"
11,7,2,88,70,73,143,"21 de agosto de 1994"
11,7,2,89,229,246,475,"21 de agosto de 1994"
11,7,2,90,128,152,280,"21 de agosto de 1994"
11,7,2,91,274,449,723,"21 de agosto de 1994"
11,7,2,92,172,248,420,"21 de agosto de 1994"
11,7,2,93,300,357,657,"21 de agosto de 1994"
11,7,2,94,325,409,734,"21 de agosto de 1994"
11,7,2,95,203,279,482,"21 de agosto de 1994"
11,7,2,96,210,328,538,"21 de agosto de 1994"
11,7,2,97,253,348,601,"21 de agosto de 1994"
11,7,2,98,116,166,282,"21 de agosto de 1994"
11,7,2,99,280,407,687,"21 de agosto de 1994"
11,7,2,100,271,510,781,"21 de agosto de 1994"
11,7,2,101,281,371,652,"21 de agosto de 1994"
11,7,2,102,306,429,735,"21 de agosto de 1994"
11,7,2,103,337,441,778,"21 de agosto de 1994"
11,7,2,104,281,373,654,"21 de agosto de 1994"
11,7,2,105,122,163,285,"21 de agosto de 1994"
11,7,2,106,221,266,487,"21 de agosto de 1994"
11,7,2,107,205,302,507,"21 de agosto de 1994"
11,7,2,108,223,358,581,"21 de agosto de 1994"
11,7,2,109,248,330,578,"21 de agosto de 1994"
11,7,2,110,147,181,328,"21 de agosto de 1994"
11,7,2,111,246,254,500,"21 de agosto de 1994"
11,7,2,112,192,247,439,"21 de agosto de 1994"
11,7,2,113,233,223,456,"21 de agosto de 1994"
11,7,2,114,429,599,1028,"21 de agosto de 1994"
11,7,2,115,391,475,866,"21 de agosto de 1994"
11,7,2,116,300,396,696,"21 de agosto de 1994"
11,7,2,117,209,285,494,"21 de agosto de 1994"
11,7,2,118,343,483,826,"21 de agosto de 1994"
11,7,2,119,200,253,453,"21 de agosto de 1994"
11,7,2,120,224,274,498,"21 de agosto de 1994"
11,7,2,121,360,441,801,"21 de agosto de 1994"
11,7,2,122,216,270,486,"21 de agosto de 1994"
11,7,2,123,371,340,711,"21 de agosto de 1994"
11,7,2,124,120,177,297,"21 de agosto de 1994"
11,7,2,125,147,203,350,"21 de agosto de 1994"
11,7,2,126,280,320,600,"21 de agosto de 1994"
11,7,2,127,117,157,274,"21 de agosto de 1994"
11,7,2,128,347,410,757,"21 de agosto de 1994"
11,7,2,129,204,270,474,"21 de agosto de 1994"
11,7,2,130,196,251,447,"21 de agosto de 1994"
11,7,2,131,289,347,636,"21 de agosto de 1994"
11,7,2,132,200,234,434,"21 de agosto de 1994"
11,7,2,133,158,221,379,"21 de agosto de 1994"
11,7,2,134,155,176,331,"21 de agosto de 1994"
11,7,2,135,221,313,534,"21 de agosto de 1994"
11,7,2,136,462,612,1074,"21 de agosto de 1994"
11,7,2,137,387,576,963,"21 de agosto de 1994"
11,7,2,138,420,624,1044,"21 de agosto de 1994"
11,7,2,139,165,205,370,"21 de agosto de 1994"
11,7,2,140,252,302,554,"21 de agosto de 1994"
11,7,4,244,333,426,759,"21 de agosto de 1994"
11,7,4,245,351,448,799,"21 de agosto de 1994"
11,7,4,246,152,188,340,"21 de agosto de 1994"
11,7,4,247,381,454,835,"21 de agosto de 1994"
11,7,4,248,399,465,864,"21 de agosto de 1994"
11,7,4,249,306,425,731,"21 de agosto de 1994"
11,7,4,250,334,356,690,"21 de agosto de 1994"
11,7,4,251,329,394,723,"21 de agosto de 1994"
11,7,4,252,557,593,1150,"21 de agosto de 1994"
11,7,4,253,208,274,482,"21 de agosto de 1994"
11,7,4,254,333,391,724,"21 de agosto de 1994"
11,7,4,255,190,260,450,"21 de agosto de 1994"
11,7,4,256,281,367,648,"21 de agosto de 1994"
11,7,4,257,377,471,848,"21 de agosto de 1994"
11,7,4,258,307,317,624,"21 de agosto de 1994"
11,7,4,259,252,291,543,"21 de agosto de 1994"
11,7,4,260,212,194,406,"21 de agosto de 1994"
11,7,4,261,297,306,603,"21 de agosto de 1994"
11,7,4,262,245,272,517,"21 de agosto de 1994"
11,7,4,263,410,402,812,"21 de agosto de 1994"
11,7,4,264,390,377,767,"21 de agosto de 1994"
11,7,4,265,252,269,521,"21 de agosto de 1994"
11,7,4,266,151,196,347,"21 de agosto de 1994"
11,7,4,267,99,113,212,"21 de agosto de 1994"
11,7,4,268,210,271,481,"21 de agosto de 1994"
11,7,4,269,253,277,530,"21 de agosto de 1994"
11,7,4,270,162,170,332,"21 de agosto de 1994"
11,7,4,271,280,376,656,"21 de agosto de 1994"
11,7,4,272,182,214,396,"21 de agosto de 1994"
11,7,4,273,282,313,595,"21 de agosto de 1994"
11,7,4,274,170,176,346,"21 de agosto de 1994"
11,7,4,275,219,315,534,"21 de agosto de 1994"
11,7,4,276,220,228,448,"21 de agosto de 1994"
11,7,4,277,138,272,410,"21 de agosto de 1994"
11,7,4,278,144,222,366,"21 de agosto de 1994"
11,7,4,279,167,227,394,"21 de agosto de 1994"
11,7,4,280,220,265,485,"21 de agosto de 1994"
11,7,4,281,121,195,316,"21 de agosto de 1994"
11,7,4,282,127,204,331,"21 de agosto de 1994"
11,7,4,283,226,309,535,"21 de agosto de 1994"
11,7,4,284,135,163,298,"21 de agosto de 1994"
11,7,4,285,193,260,453,"21 de agosto de 1994"
11,7,4,286,267,346,613,"21 de agosto de 1994"
11,7,4,287,95,129,224,"21 de agosto de 1994"
11,7,5,288,439,530,969,"21 de agosto de 1994"
11,7,5,289,411,501,912,"21 de agosto de 1994"
11,7,5,290,489,589,1078,"21 de agosto de 1994"
11,7,5,291,412,481,893,"21 de agosto de 1994"
11,7,5,292,355,387,742,"21 de agosto de 1994"
11,7,5,293,426,535,961,"21 de agosto de 1994"
11,7,5,294,652,788,1440,"21 de agosto de 1994"
11,7,5,295,318,394,712,"21 de agosto de 1994"
11,7,5,296,413,510,923,"21 de agosto de 1994"
11,7,5,297,369,434,803,"21 de agosto de 1994"
11,7,5,298,125,145,270,"21 de agosto de 1994"
11,7,5,299,208,277,485,"21 de agosto de 1994"
11,7,5,300,243,323,566,"21 de agosto de 1994"
11,7,5,301,226,258,484,"21 de agosto de 1994"
11,7,5,302,555,649,1204,"21 de agosto de 1994"
11,7,5,303,255,304,559,"21 de agosto de 1994"
11,7,5,304,479,471,950,"21 de agosto de 1994"
11,7,5,305,351,392,743,"21 de agosto de 1994"
11,7,5,306,143,147,290,"21 de agosto de 1994"
11,7,5,307,403,469,872,"21 de agosto de 1994"
11,7,5,308,148,180,328,"21 de agosto de 1994"
11,7,5,309,335,429,764,"21 de agosto de 1994"
11,7,5,310,278,369,647,"21 de agosto de 1994"
11,7,5,311,542,637,1179,"21 de agosto de 1994"
11,7,5,312,148,177,325,"21 de agosto de 1994"
11,7,5,313,281,363,644,"21 de agosto de 1994"
11,7,5,314,360,456,816,"21 de agosto de 1994"
11,7,5,315,283,319,602,"21 de agosto de 1994"
11,7,5,316,239,296,535,"21 de agosto de 1994"
11,7,5,317,142,172,314,"21 de agosto de 1994"
11,7,5,318,163,196,359,"21 de agosto de 1994"
11,7,5,319,310,365,675,"21 de agosto de 1994"
11,7,5,320,350,369,719,"21 de agosto de 1994"
11,7,5,321,201,205,406,"21 de agosto de 1994"
11,7,5,322,426,474,900,"21 de agosto de 1994"
11,7,5,323,213,215,428,"21 de agosto de 1994"
11,7,5,324,390,456,846,"21 de agosto de 1994"
11,7,5,325,222,298,520,"21 de agosto de 1994"
11,7,5,326,423,552,975,"21 de agosto de 1994"
11,7,5,327,345,485,830,"21 de agosto de 1994"
11,7,5,328,337,392,729,"21 de agosto de 1994"
11,7,5,329,288,357,645,"21 de agosto de 1994"
11,7,5,330,297,375,672,"21 de agosto de 1994"
11,7,10,652,230,276,506,"21 de agosto de 1994"
11,7,10,653,172,228,400,"21 de agosto de 1994"
11,7,10,654,340,367,707,"21 de agosto de 1994"
11,7,10,655,299,365,664,"21 de agosto de 1994"
11,7,10,656,232,305,537,"21 de agosto de 1994"
11,7,10,657,223,246,469,"21 de agosto de 1994"
11,7,10,658,185,247,432,"21 de agosto de 1994"
11,7,10,659,181,182,363,"21 de agosto de 1994"
11,7,10,660,313,376,689,"21 de agosto de 1994"
11,7,10,661,223,267,490,"21 de agosto de 1994"
11,7,19,1204,289,318,607,"21 de agosto de 1994"
11,7,19,1205,287,316,603,"21 de agosto de 1994"
11,7,19,1206,341,440,781,"21 de agosto de 1994"
11,7,19,1207,235,275,510,"21 de agosto de 1994"
11,7,19,1208,312,391,703,"21 de agosto de 1994"
11,7,19,1209,241,275,516,"21 de agosto de 1994"
11,7,19,1210,302,328,630,"21 de agosto de 1994"
11,7,19,1211,120,153,273,"21 de agosto de 1994"
11,7,19,1212,137,201,338,"21 de agosto de 1994"
11,7,19,1213,102,144,246,"21 de agosto de 1994"
11,7,19,1214,212,253,465,"21 de agosto de 1994"
11,7,19,1215,211,208,419,"21 de agosto de 1994"
11,7,19,1216,142,237,379,"21 de agosto de 1994"
11,7,19,1217,133,184,317,"21 de agosto de 1994"
11,7,19,1218,380,467,847,"21 de agosto de 1994"
11,7,19,1219,99,144,243,"21 de agosto de 1994"
11,7,19,1220,237,339,576,"21 de agosto de 1994"
11,7,19,1221,109,211,320,"21 de agosto de 1994"
11,7,19,1222,201,240,441,"21 de agosto de 1994"
11,7,19,1223,172,209,381,"21 de agosto de 1994"
11,7,19,1224,194,263,457,"21 de agosto de 1994"
11,7,19,1225,277,361,638,"21 de agosto de 1994"
11,7,19,1226,295,363,658,"21 de agosto de 1994"
11,7,19,1227,197,203,400,"21 de agosto de 1994"
11,7,19,1228,85,106,191,"21 de agosto de 1994"
11,7,19,1229,227,255,482,"21 de agosto de 1994"
11,7,19,1230,259,341,600,"21 de agosto de 1994"
11,7,19,1231,27,26,53,"21 de agosto de 1994"
11,7,19,1232,81,135,216,"21 de agosto de 1994"
11,7,19,1233,182,247,429,"21 de agosto de 1994"
11,7,19,1234,139,185,324,"21 de agosto de 1994"
11,7,19,1235,254,419,673,"21 de agosto de 1994"
11,7,19,1236,140,203,343,"21 de agosto de 1994"
11,7,19,1237,76,107,183,"21 de agosto de 1994"
11,7,19,1238,50,61,111,"21 de agosto de 1994"
11,7,19,1239,99,134,233,"21 de agosto de 1994"
11,7,19,1240,79,117,196,"21 de agosto de 1994"
11,7,19,1241,272,348,620,"21 de agosto de 1994"
11,7,19,1242,169,175,344,"21 de agosto de 1994"
11,7,19,1243,208,250,458,"21 de agosto de 1994"
11,7,19,1244,263,328,591,"21 de agosto de 1994"
11,7,19,1245,129,177,306,"21 de agosto de 1994"
11,7,19,1246,186,265,451,"21 de agosto de 1994"
11,7,19,1247,167,159,326,"21 de agosto de 1994"
11,7,19,1248,183,180,363,"21 de agosto de 1994"
11,7,19,1249,130,153,283,"21 de agosto de 1994"
11,7,19,1250,216,307,523,"21 de agosto de 1994"
11,7,19,1251,143,184,327,"21 de agosto de 1994"
11,7,19,1252,100,121,221,"21 de agosto de 1994"
11,7,19,1253,24,27,51,"21 de agosto de 1994"
11,7,19,1254,351,431,782,"21 de agosto de 1994"
11,7,19,1255,208,269,477,"21 de agosto de 1994"
11,7,19,1256,137,166,303,"21 de agosto de 1994"
11,7,19,1257,273,321,594,"21 de agosto de 1994"
11,7,19,1258,196,213,409,"21 de agosto de 1994"
11,7,19,1259,246,253,499,"21 de agosto de 1994"
11,7,19,1260,90,111,201,"21 de agosto de 1994"
11,7,38,2732,240,321,561,"21 de agosto de 1994"
11,7,38,2733,201,277,478,"21 de agosto de 1994"
11,7,38,2734,174,213,387,"21 de agosto de 1994"
11,7,38,2735,230,280,510,"21 de agosto de 1994"
11,7,38,2736,322,380,702,"21 de agosto de 1994"
11,7,38,2737,300,367,667,"21 de agosto de 1994"
11,7,38,2738,335,396,731,"21 de agosto de 1994"
11,7,38,2739,164,200,364,"21 de agosto de 1994"
11,7,38,2740,147,264,411,"21 de agosto de 1994"
11,7,38,2741,302,327,629,"21 de agosto de 1994"
11,7,38,2742,243,301,544,"21 de agosto de 1994"
11,7,38,2743,156,188,344,"21 de agosto de 1994"
11,8,7,336,96,110,206,"21 de agosto de 1994"
11,8,7,337,151,177,328,"21 de agosto de 1994"
11,8,7,338,51,60,111,"21 de agosto de 1994"
11,8,7,339,59,65,124,"21 de agosto de 1994"
11,8,7,340,405,435,840,"21 de agosto de 1994"
11,8,7,341,671,775,1446,"21 de agosto de 1994"
11,8,7,342,291,323,614,"21 de agosto de 1994"
11,8,7,343,262,290,552,"21 de agosto de 1994"
11,8,7,344,241,301,542,"21 de agosto de 1994"
11,8,7,345,282,334,616,"21 de agosto de 1994"
11,8,7,346,327,403,730,"21 de agosto de 1994"
11,8,7,347,285,340,625,"21 de agosto de 1994"
11,8,7,348,400,472,872,"21 de agosto de 1994"
11,8,7,349,462,528,990,"21 de agosto de 1994"
11,8,7,350,469,554,1023,"21 de agosto de 1994"
11,8,7,351,436,557,993,"21 de agosto de 1994"
11,8,7,352,452,534,986,"21 de agosto de 1994"
11,8,7,353,448,537,985,"21 de agosto de 1994"
11,8,7,354,255,283,538,"21 de agosto de 1994"
11,8,7,355,596,634,1230,"21 de agosto de 1994"
11,8,7,356,245,298,543,"21 de agosto de 1994"
11,8,7,357,200,235,435,"21 de agosto de 1994"
11,8,7,358,230,270,500,"21 de agosto de 1994"
11,8,7,359,557,619,1176,"21 de agosto de 1994"
11,8,7,360,513,596,1109,"21 de agosto de 1994"
11,8,7,361,314,345,659,"21 de agosto de 1994"
11,8,7,362,551,608,1159,"21 de agosto de 1994"
11,8,7,363,350,408,758,"21 de agosto de 1994"
11,8,7,364,342,472,814,"21 de agosto de 1994"
11,8,7,365,267,282,549,"21 de agosto de 1994"
11,8,7,366,807,958,1765,"21 de agosto de 1994"
11,8,7,367,331,378,709,"21 de agosto de 1994"
11,8,7,368,349,424,773,"21 de agosto de 1994"
11,8,7,369,378,431,809,"21 de agosto de 1994"
11,8,7,370,509,617,1126,"21 de agosto de 1994"
11,8,7,371,406,487,893,"21 de agosto de 1994"
11,8,7,372,265,294,559,"21 de agosto de 1994"
11,8,7,373,476,533,1009,"21 de agosto de 1994"
11,8,7,374,331,347,678,"21 de agosto de 1994"
11,8,7,375,445,439,884,"21 de agosto de 1994"
11,8,7,376,214,230,444,"21 de agosto de 1994"
11,8,7,377,363,397,760,"21 de agosto de 1994"
11,8,7,378,399,450,849,"21 de agosto de 1994"
11,8,7,379,438,474,912,"21 de agosto de 1994"
11,8,7,380,276,335,611,"21 de agosto de 1994"
11,8,7,381,489,576,1065,"21 de agosto de 1994"
11,8,7,382,336,438,774,"21 de agosto de 1994"
11,8,7,383,296,343,639,"21 de agosto de 1994"
11,8,7,384,378,423,801,"21 de agosto de 1994"
11,8,7,385,216,243,459,"21 de agosto de 1994"
11,8,7,386,425,506,931,"21 de agosto de 1994"
11,8,7,387,474,525,999,"21 de agosto de 1994"
11,8,7,388,468,538,1006,"21 de agosto de 1994"
11,8,7,389,373,408,781,"21 de agosto de 1994"
11,8,7,390,498,580,1078,"21 de agosto de 1994"
11,8,7,391,409,499,908,"21 de agosto de 1994"
11,8,7,392,503,573,1076,"21 de agosto de 1994"
11,8,7,393,370,458,828,"21 de agosto de 1994"
11,8,7,394,307,367,674,"21 de agosto de 1994"
11,8,7,395,192,243,435,"21 de agosto de 1994"
11,8,7,396,271,331,602,"21 de agosto de 1994"
11,8,7,397,335,425,760,"21 de agosto de 1994"
11,8,7,398,479,549,1028,"21 de agosto de 1994"
11,8,7,399,531,591,1122,"21 de agosto de 1994"
11,8,7,400,405,445,850,"21 de agosto de 1994"
11,8,7,401,353,396,749,"21 de agosto de 1994"
11,8,7,402,510,648,1158,"21 de agosto de 1994"
11,8,7,403,263,348,611,"21 de agosto de 1994"
11,8,7,404,232,269,501,"21 de agosto de 1994"
11,8,7,405,273,416,689,"21 de agosto de 1994"
11,8,7,406,330,403,733,"21 de agosto de 1994"
11,8,7,407,452,492,944,"21 de agosto de 1994"
11,8,7,408,341,419,760,"21 de agosto de 1994"
11,8,7,409,267,292,559,"21 de agosto de 1994"
11,8,7,410,476,528,1004,"21 de agosto de 1994"
11,8,7,411,432,492,924,"21 de agosto de 1994"
11,8,7,412,675,741,1416,"21 de agosto de 1994"
11,8,7,413,359,444,803,"21 de agosto de 1994"
11,8,7,414,326,387,713,"21 de agosto de 1994"
11,8,7,415,548,612,1160,"21 de agosto de 1994"
11,8,7,416,498,595,1093,"21 de agosto de 1994"
11,8,7,417,305,346,651,"21 de agosto de 1994"
11,8,7,418,305,360,665,"21 de agosto de 1994"
11,8,7,419,307,373,680,"21 de agosto de 1994"
11,8,7,420,224,301,525,"21 de agosto de 1994"
11,8,7,421,347,418,765,"21 de agosto de 1994"
11,8,7,422,443,533,976,"21 de agosto de 1994"
11,8,7,423,336,385,721,"21 de agosto de 1994"
11,8,7,424,346,428,774,"21 de agosto de 1994"
11,8,7,425,242,297,539,"21 de agosto de 1994"
11,8,7,426,377,400,777,"21 de agosto de 1994"
11,8,7,427,314,382,696,"21 de agosto de 1994"
11,8,7,428,223,270,493,"21 de agosto de 1994"
11,8,7,429,188,213,401,"21 de agosto de 1994"
11,8,7,430,76,100,176,"21 de agosto de 1994"
11,8,7,431,444,548,992,"21 de agosto de 1994"
11,8,7,432,340,380,720,"21 de agosto de 1994"
11,8,7,433,254,296,550,"21 de agosto de 1994"
11,8,7,434,328,373,701,"21 de agosto de 1994"
11,8,7,435,446,451,897,"21 de agosto de 1994"
11,8,7,436,452,518,970,"21 de agosto de 1994"
11,8,7,437,354,440,794,"21 de agosto de 1994"
11,8,7,438,367,490,857,"21 de agosto de 1994"
11,8,7,439,209,280,489,"21 de agosto de 1994"
11,8,7,440,118,160,278,"21 de agosto de 1994"
11,8,7,441,349,420,769,"21 de agosto de 1994"
11,8,7,442,422,510,932,"21 de agosto de 1994"
11,8,7,443,467,575,1042,"21 de agosto de 1994"
11,8,7,444,284,327,611,"21 de agosto de 1994"
11,8,7,445,391,508,899,"21 de agosto de 1994"
11,8,7,446,315,349,664,"21 de agosto de 1994"
11,8,7,447,190,250,440,"21 de agosto de 1994"
11,8,7,448,347,440,787,"21 de agosto de 1994"
11,8,7,449,308,341,649,"21 de agosto de 1994"
11,8,7,450,622,672,1294,"21 de agosto de 1994"
11,8,7,451,424,461,885,"21 de agosto de 1994"
11,8,7,452,451,548,999,"21 de agosto de 1994"
11,8,7,453,475,536,1011,"21 de agosto de 1994"
11,8,7,454,398,488,886,"21 de agosto de 1994"
11,8,7,455,443,499,942,"21 de agosto de 1994"
11,8,7,456,442,496,938,"21 de agosto de 1994"
11,8,7,457,309,369,678,"21 de agosto de 1994"
11,8,7,458,167,208,375,"21 de agosto de 1994"
11,8,7,459,466,531,997,"21 de agosto de 1994"
11,8,7,460,161,206,367,"21 de agosto de 1994"
11,8,7,461,209,229,438,"21 de agosto de 1994"
11,8,7,462,160,214,374,"21 de agosto de 1994"
11,8,7,463,287,306,593,"21 de agosto de 1994"
11,8,7,464,239,289,528,"21 de agosto de 1994"
11,8,7,465,418,496,914,"21 de agosto de 1994"
11,8,7,466,559,624,1183,"21 de agosto de 1994"
11,8,7,467,355,415,770,"21 de agosto de 1994"
11,8,7,468,310,363,673,"21 de agosto de 1994"
11,8,7,469,273,287,560,"21 de agosto de 1994"
11,8,7,470,246,306,552,"21 de agosto de 1994"
11,8,7,471,259,282,541,"21 de agosto de 1994"
11,8,7,472,335,410,745,"21 de agosto de 1994"
11,8,7,473,387,447,834,"21 de agosto de 1994"
11,8,7,474,487,574,1061,"21 de agosto de 1994"
11,8,7,475,430,489,919,"21 de agosto de 1994"
11,8,7,476,534,582,1116,"21 de agosto de 1994"
11,8,7,477,469,513,982,"21 de agosto de 1994"
11,8,7,478,210,233,443,"21 de agosto de 1994"
11,8,7,479,430,522,952,"21 de agosto de 1994"
11,8,7,480,414,510,924,"21 de agosto de 1994"
11,8,7,481,347,408,755,"21 de agosto de 1994"
11,8,7,482,304,344,648,"21 de agosto de 1994"
11,8,7,483,495,608,1103,"21 de agosto de 1994"
11,8,7,484,176,233,409,"21 de agosto de 1994"
11,8,7,485,212,261,473,"21 de agosto de 1994"
11,8,7,486,369,444,813,"21 de agosto de 1994"
11,8,7,487,262,301,563,"21 de agosto de 1994"
11,8,7,488,235,268,503,"21 de agosto de 1994"
11,8,7,489,345,429,774,"21 de agosto de 1994"
11,8,7,490,376,515,891,"21 de agosto de 1994"
11,8,7,491,340,423,763,"21 de agosto de 1994"
11,8,7,492,210,269,479,"21 de agosto de 1994"
11,8,7,493,169,213,382,"21 de agosto de 1994"
11,8,7,494,217,280,497,"21 de agosto de 1994"
11,8,7,495,350,434,784,"21 de agosto de 1994"
11,8,7,496,201,251,452,"21 de agosto de 1994"
11,8,7,497,401,409,810,"21 de agosto de 1994"
11,8,7,498,291,312,603,"21 de agosto de 1994"
11,8,7,499,382,418,800,"21 de agosto de 1994"
11,8,7,500,380,451,831,"21 de agosto de 1994"
11,8,7,501,546,667,1213,"21 de agosto de 1994"
11,8,7,502,271,297,568,"21 de agosto de 1994"
11,8,7,503,557,636,1193,"21 de agosto de 1994"
11,8,7,504,411,465,876,"21 de agosto de 1994"
11,8,7,505,521,585,1106,"21 de agosto de 1994"
11,8,7,506,292,333,625,"21 de agosto de 1994"
11,8,7,507,460,558,1018,"21 de agosto de 1994"
11,8,7,508,179,211,390,"21 de agosto de 1994"
11,8,7,509,358,382,740,"21 de agosto de 1994"
11,8,7,510,309,350,659,"21 de agosto de 1994"
11,8,7,511,372,466,838,"21 de agosto de 1994"
11,8,7,512,343,395,738,"21 de agosto de 1994"
11,8,7,513,489,584,1073,"21 de agosto de 1994"
11,8,7,514,463,591,1054,"21 de agosto de 1994"
11,8,7,515,44,61,105,"21 de agosto de 1994"
11,8,7,516,116,151,267,"21 de agosto de 1994"
11,8,7,517,263,290,553,"21 de agosto de 1994"
11,8,7,518,510,618,1128,"21 de agosto de 1994"
11,8,7,519,467,571,1038,"21 de agosto de 1994"
11,8,7,520,415,500,915,"21 de agosto de 1994"
11,8,7,521,537,632,1169,"21 de agosto de 1994"
11,8,7,522,87,104,191,"21 de agosto de 1994"
11,8,7,523,322,359,681,"21 de agosto de 1994"
11,8,7,524,189,228,417,"21 de agosto de 1994"
11,8,7,525,213,282,495,"21 de agosto de 1994"
11,8,7,526,526,569,1095,"21 de agosto de 1994"
11,8,7,527,295,321,616,"21 de agosto de 1994"
11,8,7,528,310,337,647,"21 de agosto de 1994"
11,8,7,529,476,596,1072,"21 de agosto de 1994"
11,8,7,530,426,510,936,"21 de agosto de 1994"
11,8,7,531,320,318,638,"21 de agosto de 1994"
11,8,7,532,314,403,717,"21 de agosto de 1994"
11,8,7,533,255,293,548,"21 de agosto de 1994"
11,8,7,534,179,188,367,"21 de agosto de 1994"
11,8,7,535,87,91,178,"21 de agosto de 1994"
11,8,7,536,213,250,463,"21 de agosto de 1994"
11,8,7,537,193,218,411,"21 de agosto de 1994"
11,8,7,538,313,405,718,"21 de agosto de 1994"
11,8,7,539,287,344,631,"21 de agosto de 1994"
11,8,7,540,241,276,517,"21 de agosto de 1994"
11,8,7,541,255,320,575,"21 de agosto de 1994"
11,8,7,542,304,397,701,"21 de agosto de 1994"
11,8,7,543,318,400,718,"21 de agosto de 1994"
11,8,7,544,94,157,251,"21 de agosto de 1994"
11,8,7,545,210,325,535,"21 de agosto de 1994"
11,8,7,546,403,527,930,"21 de agosto de 1994"
11,8,7,547,372,481,853,"21 de agosto de 1994"
11,8,7,548,31,47,78,"21 de agosto de 1994"
11,8,7,549,116,140,256,"21 de agosto de 1994"
11,8,7,550,223,371,594,"21 de agosto de 1994"
11,8,7,551,290,355,645,"21 de agosto de 1994"
11,8,7,552,304,374,678,"21 de agosto de 1994"
11,8,7,553,193,232,425,"21 de agosto de 1994"
11,8,7,554,298,353,651,"21 de agosto de 1994"
11,8,7,555,240,303,543,"21 de agosto de 1994"
11,8,7,556,307,407,714,"21 de agosto de 1994"
11,8,7,557,265,318,583,"21 de agosto de 1994"
11,8,7,558,463,626,1089,"21 de agosto de 1994"
11,8,7,559,164,233,397,"21 de agosto de 1994"
11,8,7,560,211,254,465,"21 de agosto de 1994"
11,8,7,561,84,143,227,"21 de agosto de 1994"
11,8,7,562,26,29,55,"21 de agosto de 1994"
11,8,7,563,431,566,997,"21 de agosto de 1994"
11,8,7,564,259,325,584,"21 de agosto de 1994"
11,8,7,565,158,192,350,"21 de agosto de 1994"
11,8,7,566,93,210,303,"21 de agosto de 1994"
11,8,9,609,263,331,594,"21 de agosto de 1994"
11,8,9,610,273,347,620,"21 de agosto de 1994"
11,8,9,611,497,619,1116,"21 de agosto de 1994"
11,8,9,612,369,463,832,"21 de agosto de 1994"
11,8,9,613,349,454,803,"21 de agosto de 1994"
11,8,9,614,242,316,558,"21 de agosto de 1994"
11,8,9,615,300,418,718,"21 de agosto de 1994"
11,8,9,616,453,581,1034,"21 de agosto de 1994"
11,8,9,617,507,617,1124,"21 de agosto de 1994"
11,8,9,618,312,375,687,"21 de agosto de 1994"
11,8,9,619,407,497,904,"21 de agosto de 1994"
11,8,9,620,319,378,697,"21 de agosto de 1994"
11,8,9,621,296,329,625,"21 de agosto de 1994"
11,8,9,622,187,208,395,"21 de agosto de 1994"
11,8,9,623,275,326,601,"21 de agosto de 1994"
11,8,9,624,138,140,278,"21 de agosto de 1994"
11,8,9,625,193,221,414,"21 de agosto de 1994"
11,8,9,626,184,216,400,"21 de agosto de 1994"
11,8,9,627,287,369,656,"21 de agosto de 1994"
11,8,9,628,178,202,380,"21 de agosto de 1994"
11,8,9,629,157,219,376,"21 de agosto de 1994"
11,8,9,630,527,677,1204,"21 de agosto de 1994"
11,8,9,631,249,284,533,"21 de agosto de 1994"
11,8,9,632,208,254,462,"21 de agosto de 1994"
11,8,9,633,266,258,524,"21 de agosto de 1994"
11,8,9,634,188,221,409,"21 de agosto de 1994"
11,8,9,635,130,131,261,"21 de agosto de 1994"
11,8,9,636,359,514,873,"21 de agosto de 1994"
11,8,9,637,349,435,784,"21 de agosto de 1994"
11,8,9,638,381,344,725,"21 de agosto de 1994"
11,8,9,639,352,327,679,"21 de agosto de 1994"
11,8,9,640,148,171,319,"21 de agosto de 1994"
11,8,9,641,372,472,844,"21 de agosto de 1994"
11,8,9,642,206,218,424,"21 de agosto de 1994"
11,8,9,643,408,493,901,"21 de agosto de 1994"
11,8,9,644,235,270,505,"21 de agosto de 1994"
11,8,9,645,448,527,975,"21 de agosto de 1994"
11,8,9,646,437,507,944,"21 de agosto de 1994"
11,8,9,647,232,267,499,"21 de agosto de 1994"
11,8,9,648,357,433,790,"21 de agosto de 1994"
11,8,9,649,398,459,857,"21 de agosto de 1994"
11,8,9,650,236,275,511,"21 de agosto de 1994"
11,8,9,651,77,107,184,"21 de agosto de 1994"
11,9,3,141,354,484,838,"21 de agosto de 1994"
11,9,3,142,203,286,489,"21 de agosto de 1994"
11,9,3,143,572,694,1266,"21 de agosto de 1994"
11,9,3,144,239,292,531,"21 de agosto de 1994"
11,9,3,145,375,474,849,"21 de agosto de 1994"
11,9,3,146,406,515,921,"21 de agosto de 1994"
11,9,3,147,382,471,853,"21 de agosto de 1994"
11,9,3,148,325,396,721,"21 de agosto de 1994"
11,9,3,149,431,584,1015,"21 de agosto de 1994"
11,9,3,150,305,395,700,"21 de agosto de 1994"
11,9,3,151,262,328,590,"21 de agosto de 1994"
11,9,3,152,367,478,845,"21 de agosto de 1994"
11,9,3,153,420,553,973,"21 de agosto de 1994"
11,9,3,154,452,563,1015,"21 de agosto de 1994"
11,9,3,155,486,606,1092,"21 de agosto de 1994"
11,9,3,156,331,402,733,"21 de agosto de 1994"
11,9,3,157,680,889,1569,"21 de agosto de 1994"
11,9,3,158,442,570,1012,"21 de agosto de 1994"
11,9,3,159,444,533,977,"21 de agosto de 1994"
11,9,3,160,319,403,722,"21 de agosto de 1994"
11,9,3,161,227,242,469,"21 de agosto de 1994"
11,9,3,162,217,302,519,"21 de agosto de 1994"
11,9,3,163,383,498,881,"21 de agosto de 1994"
11,9,3,164,106,118,224,"21 de agosto de 1994"
11,9,3,165,283,325,608,"21 de agosto de 1994"
11,9,3,166,138,146,284,"21 de agosto de 1994"
11,9,3,167,171,232,403,"21 de agosto de 1994"
11,9,3,168,458,524,982,"21 de agosto de 1994"
11,9,3,169,456,563,1019,"21 de agosto de 1994"
11,9,3,170,259,287,546,"21 de agosto de 1994"
11,9,3,171,361,377,738,"21 de agosto de 1994"
11,9,3,172,276,348,624,"21 de agosto de 1994"
11,9,3,173,387,440,827,"21 de agosto de 1994"
11,9,3,174,376,406,782,"21 de agosto de 1994"
11,9,3,175,380,458,838,"21 de agosto de 1994"
11,9,3,176,176,186,362,"21 de agosto de 1994"
11,9,3,177,309,342,651,"21 de agosto de 1994"
11,9,3,178,97,110,207,"21 de agosto de 1994"
11,9,3,179,223,262,485,"21 de agosto de 1994"
11,9,3,180,309,339,648,"21 de agosto de 1994"
11,9,3,181,149,160,309,"21 de agosto de 1994"
11,9,3,182,166,195,361,"21 de agosto de 1994"
11,9,3,183,353,366,719,"21 de agosto de 1994"
11,9,3,184,234,306,540,"21 de agosto de 1994"
11,9,3,185,304,417,721,"21 de agosto de 1994"
11,9,3,186,183,239,422,"21 de agosto de 1994"
11,9,3,187,132,208,340,"21 de agosto de 1994"
11,9,3,188,354,387,741,"21 de agosto de 1994"
11,9,3,189,279,281,560,"21 de agosto de 1994"
11,9,3,190,285,338,623,"21 de agosto de 1994"
11,9,3,191,199,233,432,"21 de agosto de 1994"
11,9,3,192,161,256,417,"21 de agosto de 1994"
11,9,3,193,125,179,304,"21 de agosto de 1994"
11,9,3,194,365,365,730,"21 de agosto de 1994"
11,9,3,195,89,149,238,"21 de agosto de 1994"
11,9,3,196,48,66,114,"21 de agosto de 1994"
11,9,3,197,308,418,726,"21 de agosto de 1994"
11,9,3,198,133,183,316,"21 de agosto de 1994"
11,9,3,199,69,103,172,"21 de agosto de 1994"
11,9,3,200,241,266,507,"21 de agosto de 1994"
11,9,3,201,191,214,405,"21 de agosto de 1994"
11,9,3,202,245,280,525,"21 de agosto de 1994"
11,9,3,203,173,193,366,"21 de agosto de 1994"
11,9,3,204,167,207,374,"21 de agosto de 1994"
11,9,3,205,165,184,349,"21 de agosto de 1994"
11,9,3,206,222,330,552,"21 de agosto de 1994"
11,9,3,207,136,204,340,"21 de agosto de 1994"
11,9,3,208,204,248,452,"21 de agosto de 1994"
11,9,3,209,86,94,180,"21 de agosto de 1994"
11,9,3,210,149,206,355,"21 de agosto de 1994"
11,9,3,211,98,102,200,"21 de agosto de 1994"
11,9,3,212,129,152,281,"21 de agosto de 1994"
11,9,3,213,265,255,520,"21 de agosto de 1994"
11,9,3,214,253,246,499,"21 de agosto de 1994"
11,9,3,215,127,141,268,"21 de agosto de 1994"
11,9,3,216,314,361,675,"21 de agosto de 1994"
11,9,3,217,97,117,214,"21 de agosto de 1994"
11,9,3,218,295,345,640,"21 de agosto de 1994"
11,9,3,219,249,329,578,"21 de agosto de 1994"
11,9,3,220,199,287,486,"21 de agosto de 1994"
11,9,3,221,56,66,122,"21 de agosto de 1994"
11,9,3,222,235,298,533,"21 de agosto de 1994"
11,9,3,223,172,187,359,"21 de agosto de 1994"
11,9,3,224,208,224,432,"21 de agosto de 1994"
11,9,3,225,147,179,326,"21 de agosto de 1994"
11,9,3,226,194,287,481,"21 de agosto de 1994"
11,9,3,227,327,356,683,"21 de agosto de 1994"
11,9,3,228,82,106,188,"21 de agosto de 1994"
11,9,3,229,180,271,451,"21 de agosto de 1994"
11,9,3,230,143,194,337,"21 de agosto de 1994"
11,9,3,231,131,161,292,"21 de agosto de 1994"
11,9,3,232,65,64,129,"21 de agosto de 1994"
11,9,3,233,167,179,346,"21 de agosto de 1994"
11,9,3,234,64,57,121,"21 de agosto de 1994"
11,9,3,235,191,209,400,"21 de agosto de 1994"
11,9,3,236,202,262,464,"21 de agosto de 1994"
11,9,3,237,165,195,360,"21 de agosto de 1994"
11,9,3,238,189,197,386,"21 de agosto de 1994"
11,9,3,239,88,111,199,"21 de agosto de 1994"
11,9,3,240,78,104,182,"21 de agosto de 1994"
11,9,3,241,147,147,294,"21 de agosto de 1994"
11,9,3,242,171,162,333,"21 de agosto de 1994"
11,9,3,243,113,114,227,"21 de agosto de 1994"
11,9,6,331,203,180,383,"21 de agosto de 1994"
11,9,6,332,177,149,326,"21 de agosto de 1994"
11,9,6,333,291,293,584,"21 de agosto de 1994"
11,9,6,334,150,153,303,"21 de agosto de 1994"
11,9,6,335,250,290,540,"21 de agosto de 1994"
11,9,13,740,487,534,1021,"21 de agosto de 1994"
11,9,13,741,522,624,1146,"21 de agosto de 1994"
11,9,13,742,296,365,661,"21 de agosto de 1994"
11,9,13,743,165,172,337,"21 de agosto de 1994"
11,9,13,744,203,213,416,"21 de agosto de 1994"
11,9,13,745,158,150,308,"21 de agosto de 1994"
11,9,13,746,200,217,417,"21 de agosto de 1994"
11,9,13,747,549,647,1196,"21 de agosto de 1994"
11,9,13,748,401,410,811,"21 de agosto de 1994"
11,9,13,749,357,394,751,"21 de agosto de 1994"
11,9,13,750,244,295,539,"21 de agosto de 1994"
11,9,13,751,265,291,556,"21 de agosto de 1994"
11,9,32,2505,253,321,574,"21 de agosto de 1994"
11,9,32,2506,259,291,550,"21 de agosto de 1994"
11,9,32,2507,430,563,993,"21 de agosto de 1994"
11,9,32,2508,452,552,1004,"21 de agosto de 1994"
11,9,32,2509,202,245,447,"21 de agosto de 1994"
11,9,32,2510,246,290,536,"21 de agosto de 1994"
11,9,32,2511,309,444,753,"21 de agosto de 1994"
11,9,32,2512,337,418,755,"21 de agosto de 1994"
11,9,32,2513,308,394,702,"21 de agosto de 1994"
11,9,32,2514,234,283,517,"21 de agosto de 1994"
11,9,32,2515,330,372,702,"21 de agosto de 1994"
11,9,32,2516,281,290,571,"21 de agosto de 1994"
11,9,32,2517,162,177,339,"21 de agosto de 1994"
11,9,32,2518,42,74,116,"21 de agosto de 1994"
11,9,32,2519,223,252,475,"21 de agosto de 1994"
11,9,32,2520,222,232,454,"21 de agosto de 1994"
11,9,32,2521,187,313,500,"21 de agosto de 1994"
11,9,32,2522,203,209,412,"21 de agosto de 1994"
11,9,32,2523,374,405,779,"21 de agosto de 1994"
11,9,32,2524,311,397,708,"21 de agosto de 1994"
11,9,32,2525,210,242,452,"21 de agosto de 1994"
11,9,32,2526,222,245,467,"21 de agosto de 1994"
11,9,32,2527,248,255,503,"21 de agosto de 1994"
11,9,32,2528,400,489,889,"21 de agosto de 1994"
11,9,32,2529,279,303,582,"21 de agosto de 1994"
11,9,32,2530,288,345,633,"21 de agosto de 1994"
11,9,32,2531,383,425,808,"21 de agosto de 1994"
11,9,32,2532,290,293,583,"21 de agosto de 1994"
11,9,32,2533,195,246,441,"21 de agosto de 1994"
11,9,32,2534,175,173,348,"21 de agosto de 1994"
11,9,32,2535,259,384,643,"21 de agosto de 1994"
11,9,32,2536,328,344,672,"21 de agosto de 1994"
11,9,32,2537,230,272,502,"21 de agosto de 1994"
11,9,32,2538,214,291,505,"21 de agosto de 1994"
11,9,32,2539,156,139,295,"21 de agosto de 1994"
11,9,32,2540,186,186,372,"21 de agosto de 1994"
11,9,32,2541,229,294,523,"21 de agosto de 1994"
11,9,32,2542,327,373,700,"21 de agosto de 1994"
11,9,33,2543,280,389,669,"21 de agosto de 1994"
11,9,33,2544,398,514,912,"21 de agosto de 1994"
11,9,33,2545,480,566,1046,"21 de agosto de 1994"
11,9,33,2546,389,510,899,"21 de agosto de 1994"
11,9,33,2547,277,360,637,"21 de agosto de 1994"
11,9,33,2548,593,739,1332,"21 de agosto de 1994"
11,9,33,2549,444,575,1019,"21 de agosto de 1994"
11,9,33,2550,165,220,385,"21 de agosto de 1994"
11,9,33,2551,370,430,800,"21 de agosto de 1994"
11,9,33,2552,385,520,905,"21 de agosto de 1994"
11,9,33,2553,504,673,1177,"21 de agosto de 1994"
11,9,33,2554,519,634,1153,"21 de agosto de 1994"
11,9,33,2555,325,407,732,"21 de agosto de 1994"
11,9,33,2556,527,675,1202,"21 de agosto de 1994"
11,9,33,2557,564,731,1295,"21 de agosto de 1994"
11,9,33,2558,328,394,722,"21 de agosto de 1994"
11,9,33,2559,316,411,727,"21 de agosto de 1994"
11,9,33,2560,367,420,787,"21 de agosto de 1994"
11,9,33,2561,228,276,504,"21 de agosto de 1994"
11,9,33,2562,14,21,35,"21 de agosto de 1994"
11,9,33,2563,99,109,208,"21 de agosto de 1994"
11,9,33,2564,96,106,202,"21 de agosto de 1994"
11,9,33,2565,29,32,61,"21 de agosto de 1994"
11,9,33,2566,85,99,184,"21 de agosto de 1994"
11,9,33,2567,40,38,78,"21 de agosto de 1994"
11,9,33,2568,82,79,161,"21 de agosto de 1994"
11,9,33,2569,194,202,396,"21 de agosto de 1994"
11,9,33,2570,77,78,155,"21 de agosto de 1994"
11,9,33,2571,185,222,407,"21 de agosto de 1994"
11,9,33,2572,241,279,520,"21 de agosto de 1994"
11,9,33,2573,376,470,846,"21 de agosto de 1994"
11,9,33,2574,407,453,860,"21 de agosto de 1994"
11,9,33,2575,227,206,433,"21 de agosto de 1994"
11,9,33,2576,136,134,270,"21 de agosto de 1994"
11,9,33,2577,176,225,401,"21 de agosto de 1994"
11,9,33,2578,182,259,441,"21 de agosto de 1994"
11,9,33,2579,248,281,529,"21 de agosto de 1994"
11,9,33,2580,93,84,177,"21 de agosto de 1994"
11,9,33,2581,376,418,794,"21 de agosto de 1994"
11,9,33,2582,266,398,664,"21 de agosto de 1994"
11,9,33,2583,224,284,508,"21 de agosto de 1994"
11,9,33,2584,392,490,882,"21 de agosto de 1994"
11,9,33,2585,241,270,511,"21 de agosto de 1994"
11,9,33,2586,325,398,723,"21 de agosto de 1994"
11,9,33,2587,567,638,1205,"21 de agosto de 1994"
11,9,33,2588,247,259,506,"21 de agosto de 1994"
11,9,33,2589,309,329,638,"21 de agosto de 1994"
11,9,33,2590,378,374,752,"21 de agosto de 1994"
11,9,33,2591,226,234,460,"21 de agosto de 1994"
11,9,33,2592,309,366,675,"21 de agosto de 1994"
11,9,33,2593,347,321,668,"21 de agosto de 1994"
11,9,33,2594,199,186,385,"21 de agosto de 1994"
11,9,33,2595,389,403,792,"21 de agosto de 1994"
11,9,33,2596,124,151,275,"21 de agosto de 1994"
11,9,33,2597,341,328,669,"21 de agosto de 1994"
11,9,33,2598,520,559,1079,"21 de agosto de 1994"
11,9,33,2599,370,390,760,"21 de agosto de 1994"
11,9,33,2600,264,290,554,"21 de agosto de 1994"
11,9,33,2601,399,402,801,"21 de agosto de 1994"
11,9,33,2602,477,569,1046,"21 de agosto de 1994"
11,9,34,2603,321,369,690,"21 de agosto de 1994"
11,9,34,2604,321,403,724,"21 de agosto de 1994"
11,9,34,2605,170,189,359,"21 de agosto de 1994"
11,9,34,2606,43,52,95,"21 de agosto de 1994"
11,9,34,2607,83,103,186,"21 de agosto de 1994"
11,9,35,2608,299,337,636,"21 de agosto de 1994"
11,9,35,2609,382,472,854,"21 de agosto de 1994"
11,9,35,2610,460,551,1011,"21 de agosto de 1994"
11,9,35,2611,328,407,735,"21 de agosto de 1994"
11,9,35,2612,429,533,962,"21 de agosto de 1994"
11,9,35,2613,311,330,641,"21 de agosto de 1994"
11,9,35,2614,484,573,1057,"21 de agosto de 1994"
11,9,35,2615,496,612,1108,"21 de agosto de 1994"
11,9,35,2616,224,283,507,"21 de agosto de 1994"
11,9,35,2617,403,469,872,"21 de agosto de 1994"
11,9,35,2618,357,455,812,"21 de agosto de 1994"
11,9,35,2619,339,422,761,"21 de agosto de 1994"
11,9,35,2620,482,545,1027,"21 de agosto de 1994"
11,9,35,2621,378,455,833,"21 de agosto de 1994"
11,9,35,2622,511,622,1133,"21 de agosto de 1994"
11,9,35,2623,432,502,934,"21 de agosto de 1994"
11,9,35,2624,360,442,802,"21 de agosto de 1994"
11,9,35,2625,516,598,1114,"21 de agosto de 1994"
11,9,35,2626,397,460,857,"21 de agosto de 1994"
11,9,35,2627,225,242,467,"21 de agosto de 1994"
11,9,35,2628,205,260,465,"21 de agosto de 1994"
11,9,35,2629,215,235,450,"21 de agosto de 1994"
11,9,35,2630,539,570,1109,"21 de agosto de 1994"
11,9,35,2631,317,312,629,"21 de agosto de 1994"
11,9,35,2632,333,359,692,"21 de agosto de 1994"
11,9,35,2633,500,624,1124,"21 de agosto de 1994"
11,9,35,2634,164,187,351,"21 de agosto de 1994"
11,9,35,2635,341,358,699,"21 de agosto de 1994"
11,9,35,2636,525,563,1088,"21 de agosto de 1994"
11,9,35,2637,554,605,1159,"21 de agosto de 1994"
11,9,35,2638,631,690,1321,"21 de agosto de 1994"
11,9,35,2639,410,452,862,"21 de agosto de 1994"
11,9,35,2640,438,536,974,"21 de agosto de 1994"
11,9,35,2641,252,302,554,"21 de agosto de 1994"
11,9,35,2642,421,509,930,"21 de agosto de 1994"
11,9,35,2643,369,410,779,"21 de agosto de 1994"
11,9,40,2778,508,531,1039,"21 de agosto de 1994"
11,9,40,2779,322,384,706,"21 de agosto de 1994"
11,9,40,2780,275,299,574,"21 de agosto de 1994"
11,9,40,2781,294,369,663,"21 de agosto de 1994"
11,9,40,2782,82,108,190,"21 de agosto de 1994"
11,9,40,2783,325,322,647,"21 de agosto de 1994"
11,9,40,2784,292,314,606,"21 de agosto de 1994"
11,9,40,2785,358,392,750,"21 de agosto de 1994"
11,9,40,2786,26,22,48,"21 de agosto de 1994"
11,9,40,2787,137,151,288,"21 de agosto de 1994"
11,9,40,2788,30,33,63,"21 de agosto de 1994"
11,9,40,2789,58,74,132,"21 de agosto de 1994"
11,9,43,2891,389,454,843,"21 de agosto de 1994"
11,9,43,2892,409,475,884,"21 de agosto de 1994"
11,9,43,2893,85,97,182,"21 de agosto de 1994"
11,9,43,2894,192,224,416,"21 de agosto de 1994"
11,9,43,2895,139,165,304,"21 de agosto de 1994"
11,9,43,2896,84,99,183,"21 de agosto de 1994"
11,9,43,2897,223,270,493,"21 de agosto de 1994"
11,9,43,2898,187,205,392,"21 de agosto de 1994"
11,9,43,2899,393,474,867,"21 de agosto de 1994"
11,9,43,2900,397,412,809,"21 de agosto de 1994"
11,9,43,2901,202,205,407,"21 de agosto de 1994"
11,9,43,2902,281,301,582,"21 de agosto de 1994"
11,9,43,2903,414,465,879,"21 de agosto de 1994"
11,9,43,2904,244,292,536,"21 de agosto de 1994"
11,9,43,2905,257,289,546,"21 de agosto de 1994"
11,9,45,2934,140,143,283,"21 de agosto de 1994"
11,9,45,2935,335,363,698,"21 de agosto de 1994"
11,9,45,2936,72,87,159,"21 de agosto de 1994"
11,9,45,2937,121,122,243,"21 de agosto de 1994"
11,9,45,2938,86,96,182,"21 de agosto de 1994"
11,9,45,2939,91,84,175,"21 de agosto de 1994"
11,9,45,2940,242,278,520,"21 de agosto de 1994"
11,9,45,2941,136,146,282,"21 de agosto de 1994"
11,9,45,2942,215,226,441,"21 de agosto de 1994"
11,9,45,2943,228,239,467,"21 de agosto de 1994"
11,9,45,2944,165,200,365,"21 de agosto de 1994"
11,9,45,2945,170,167,337,"21 de agosto de 1994"
11,9,45,2946,120,118,238,"21 de agosto de 1994"
11,9,45,2947,30,21,51,"21 de agosto de 1994"
11,9,45,2948,81,80,161,"21 de agosto de 1994"
11,10,14,752,203,251,454,"21 de agosto de 1994"
11,10,14,753,330,415,745,"21 de agosto de 1994"
11,10,14,754,441,558,999,"21 de agosto de 1994"
11,10,14,755,558,654,1212,"21 de agosto de 1994"
11,10,14,756,556,660,1216,"21 de agosto de 1994"
11,10,14,757,360,468,828,"21 de agosto de 1994"
11,10,14,758,429,555,984,"21 de agosto de 1994"
11,10,14,759,342,409,751,"21 de agosto de 1994"
11,10,14,760,487,606,1093,"21 de agosto de 1994"
11,10,14,761,474,630,1104,"21 de agosto de 1994"
11,10,14,762,560,690,1250,"21 de agosto de 1994"
11,10,14,763,374,477,851,"21 de agosto de 1994"
11,10,14,764,442,548,990,"21 de agosto de 1994"
11,10,14,765,646,747,1393,"21 de agosto de 1994"
11,10,14,766,328,433,761,"21 de agosto de 1994"
11,10,14,767,340,395,735,"21 de agosto de 1994"
11,10,14,768,346,454,800,"21 de agosto de 1994"
11,10,14,769,501,597,1098,"21 de agosto de 1994"
11,10,14,770,442,569,1011,"21 de agosto de 1994"
11,10,14,771,171,209,380,"21 de agosto de 1994"
11,10,14,772,473,578,1051,"21 de agosto de 1994"
11,10,14,773,421,483,904,"21 de agosto de 1994"
11,10,14,774,278,340,618,"21 de agosto de 1994"
11,10,14,775,458,541,999,"21 de agosto de 1994"
11,10,14,776,240,345,585,"21 de agosto de 1994"
11,10,14,777,283,396,679,"21 de agosto de 1994"
11,10,14,778,453,559,1012,"21 de agosto de 1994"
11,10,14,779,280,346,626,"21 de agosto de 1994"
11,10,14,780,327,396,723,"21 de agosto de 1994"
11,10,14,781,378,454,832,"21 de agosto de 1994"
11,10,14,782,247,313,560,"21 de agosto de 1994"
11,10,14,783,179,192,371,"21 de agosto de 1994"
11,10,14,784,290,327,617,"21 de agosto de 1994"
11,10,14,785,257,248,505,"21 de agosto de 1994"
11,10,14,786,306,419,725,"21 de agosto de 1994"
11,10,14,787,257,352,609,"21 de agosto de 1994"
11,10,14,788,180,207,387,"21 de agosto de 1994"
11,10,14,789,103,138,241,"21 de agosto de 1994"
11,10,14,790,497,585,1082,"21 de agosto de 1994"
11,10,14,791,323,332,655,"21 de agosto de 1994"
11,10,14,792,407,467,874,"21 de agosto de 1994"
11,10,14,793,399,579,978,"21 de agosto de 1994"
11,10,14,794,243,315,558,"21 de agosto de 1994"
11,10,14,795,319,394,713,"21 de agosto de 1994"
11,10,14,796,261,356,617,"21 de agosto de 1994"
11,10,14,797,473,500,973,"21 de agosto de 1994"
11,10,14,798,338,355,693,"21 de agosto de 1994"
11,10,14,799,161,205,366,"21 de agosto de 1994"
11,10,14,800,282,293,575,"21 de agosto de 1994"
11,10,14,801,385,476,861,"21 de agosto de 1994"
11,10,14,802,336,379,715,"21 de agosto de 1994"
11,10,14,803,393,399,792,"21 de agosto de 1994"
11,10,14,804,359,432,791,"21 de agosto de 1994"
11,10,14,805,399,406,805,"21 de agosto de 1994"
11,10,14,806,318,322,640,"21 de agosto de 1994"
11,10,14,807,365,455,820,"21 de agosto de 1994"
11,10,14,808,514,556,1070,"21 de agosto de 1994"
11,10,14,809,488,556,1044,"21 de agosto de 1994"
11,10,14,810,228,252,480,"21 de agosto de 1994"
11,10,14,811,340,370,710,"21 de agosto de 1994"
11,10,14,812,101,113,214,"21 de agosto de 1994"
11,10,14,813,402,432,834,"21 de agosto de 1994"
11,10,14,814,155,164,319,"21 de agosto de 1994"
11,10,14,815,218,215,433,"21 de agosto de 1994"
11,10,14,816,209,247,456,"21 de agosto de 1994"
11,10,14,817,220,273,493,"21 de agosto de 1994"
11,10,14,818,397,413,810,"21 de agosto de 1994"
11,10,14,819,182,238,420,"21 de agosto de 1994"
11,10,14,820,281,303,584,"21 de agosto de 1994"
11,10,14,821,397,477,874,"21 de agosto de 1994"
11,10,14,822,261,302,563,"21 de agosto de 1994"
11,10,22,1894,296,378,674,"21 de agosto de 1994"
11,10,22,1895,384,481,865,"21 de agosto de 1994"
11,10,22,1896,300,358,658,"21 de agosto de 1994"
11,10,22,1897,286,304,590,"21 de agosto de 1994"
11,10,22,1898,66,83,149,"21 de agosto de 1994"
11,10,22,1899,247,275,522,"21 de agosto de 1994"
11,10,22,1900,139,136,275,"21 de agosto de 1994"
11,10,22,1901,470,508,978,"21 de agosto de 1994"
11,10,22,1902,31,29,60,"21 de agosto de 1994"
11,10,22,1903,250,300,550,"21 de agosto de 1994"
11,10,22,1904,229,277,506,"21 de agosto de 1994"
11,10,22,1905,280,348,628,"21 de agosto de 1994"
11,10,22,1906,264,313,577,"21 de agosto de 1994"
11,10,22,1907,263,324,587,"21 de agosto de 1994"
11,10,22,1908,176,235,411,"21 de agosto de 1994"
11,10,22,1909,88,103,191,"21 de agosto de 1994"
11,10,22,1910,306,327,633,"21 de agosto de 1994"
11,10,22,1911,264,292,556,"21 de agosto de 1994"
11,10,29,2347,311,353,664,"21 de agosto de 1994"
11,10,29,2348,332,410,742,"21 de agosto de 1994"
11,10,29,2349,360,392,752,"21 de agosto de 1994"
11,10,29,2350,306,363,669,"21 de agosto de 1994"
11,10,29,2351,175,170,345,"21 de agosto de 1994"
11,10,29,2352,283,357,640,"21 de agosto de 1994"
11,10,29,2353,165,185,350,"21 de agosto de 1994"
11,10,29,2354,265,290,555,"21 de agosto de 1994"
11,10,29,2355,78,83,161,"21 de agosto de 1994"
11,10,29,2356,421,482,903,"21 de agosto de 1994"
11,10,29,2357,101,127,228,"21 de agosto de 1994"
11,10,29,2358,386,414,800,"21 de agosto de 1994"
11,10,29,2359,290,393,683,"21 de agosto de 1994"
11,10,29,2360,319,369,688,"21 de agosto de 1994"
11,10,29,2361,178,222,400,"21 de agosto de 1994"
11,10,29,2362,76,95,171,"21 de agosto de 1994"
11,10,29,2363,182,245,427,"21 de agosto de 1994"
11,10,29,2364,138,139,277,"21 de agosto de 1994"
11,10,29,2365,161,228,389,"21 de agosto de 1994"
11,10,29,2366,173,251,424,"21 de agosto de 1994"
11,10,29,2367,140,190,330,"21 de agosto de 1994"
11,10,29,2368,234,267,501,"21 de agosto de 1994"
11,10,29,2369,255,311,566,"21 de agosto de 1994"
11,10,29,2370,119,172,291,"21 de agosto de 1994"
11,10,29,2371,318,385,703,"21 de agosto de 1994"
11,10,29,2372,165,244,409,"21 de agosto de 1994"
11,10,29,2373,252,392,644,"21 de agosto de 1994"
11,10,29,2374,223,312,535,"21 de agosto de 1994"
11,10,30,2375,283,376,659,"21 de agosto de 1994"
11,10,30,2376,231,248,479,"21 de agosto de 1994"
11,10,30,2377,295,401,696,"21 de agosto de 1994"
11,10,30,2378,330,435,765,"21 de agosto de 1994"
11,10,30,2379,326,420,746,"21 de agosto de 1994"
11,10,30,2380,410,525,935,"21 de agosto de 1994"
11,10,30,2381,348,427,775,"21 de agosto de 1994"
11,10,30,2382,325,361,686,"21 de agosto de 1994"
11,10,30,2383,384,500,884,"21 de agosto de 1994"
11,10,30,2384,345,453,798,"21 de agosto de 1994"
11,10,30,2385,307,387,694,"21 de agosto de 1994"
11,10,30,2386,366,409,775,"21 de agosto de 1994"
11,10,30,2387,307,380,687,"21 de agosto de 1994"
11,10,30,2388,296,378,674,"21 de agosto de 1994"
11,10,30,2389,184,228,412,"21 de agosto de 1994"
11,10,30,2390,525,470,995,"21 de agosto de 1994"
11,10,30,2391,178,184,362,"21 de agosto de 1994"
11,10,30,2392,409,414,823,"21 de agosto de 1994"
11,10,30,2393,274,278,552,"21 de agosto de 1994"
11,10,30,2394,334,322,656,"21 de agosto de 1994"
11,10,30,2395,176,173,349,"21 de agosto de 1994"
11,10,30,2396,196,221,417,"21 de agosto de 1994"
11,10,30,2397,205,229,434,"21 de agosto de 1994"
11,10,30,2398,377,416,793,"21 de agosto de 1994"
11,10,30,2399,514,551,1065,"21 de agosto de 1994"
11,10,30,2400,288,266,554,"21 de agosto de 1994"
11,10,30,2401,253,237,490,"21 de agosto de 1994"
11,10,30,2402,127,119,246,"21 de agosto de 1994"
11,10,30,2403,191,183,374,"21 de agosto de 1994"
11,10,30,2404,124,104,228,"21 de agosto de 1994"
11,10,30,2405,439,442,881,"21 de agosto de 1994"
11,10,30,2406,281,319,600,"21 de agosto de 1994"
11,10,30,2407,301,320,621,"21 de agosto de 1994"
11,10,30,2408,262,259,521,"21 de agosto de 1994"
11,10,30,2409,407,460,867,"21 de agosto de 1994"
11,10,30,2410,201,211,412,"21 de agosto de 1994"
11,10,30,2411,197,179,376,"21 de agosto de 1994"
11,10,30,2412,227,302,529,"21 de agosto de 1994"
11,10,30,2413,392,459,851,"21 de agosto de 1994"
11,10,30,2414,477,505,982,"21 de agosto de 1994"
11,10,30,2415,283,313,596,"21 de agosto de 1994"
11,10,30,2416,138,150,288,"21 de agosto de 1994"
11,10,30,2417,217,318,535,"21 de agosto de 1994"
11,10,30,2418,118,157,275,"21 de agosto de 1994"
11,10,30,2419,174,178,352,"21 de agosto de 1994"
11,10,30,2420,266,315,581,"21 de agosto de 1994"
11,10,30,2421,285,407,692,"21 de agosto de 1994"
11,10,30,2422,256,321,577,"21 de agosto de 1994"
11,10,30,2423,200,247,447,"21 de agosto de 1994"
11,10,30,2424,226,312,538,"21 de agosto de 1994"
11,10,30,2425,283,289,572,"21 de agosto de 1994"
11,10,30,2426,210,268,478,"21 de agosto de 1994"
11,10,30,2427,278,330,608,"21 de agosto de 1994"
11,10,30,2428,122,146,268,"21 de agosto de 1994"
11,10,30,2429,281,301,582,"21 de agosto de 1994"
11,10,30,2430,165,172,337,"21 de agosto de 1994"
11,10,30,2431,241,307,548,"21 de agosto de 1994"
11,10,30,2432,209,260,469,"21 de agosto de 1994"
11,10,30,2433,228,261,489,"21 de agosto de 1994"
11,10,30,2434,300,300,600,"21 de agosto de 1994"
11,10,30,2435,248,303,551,"21 de agosto de 1994"
11,10,30,2436,300,328,628,"21 de agosto de 1994"
11,10,30,2437,189,199,388,"21 de agosto de 1994"
11,10,30,2438,201,255,456,"21 de agosto de 1994"
11,10,30,2439,308,326,634,"21 de agosto de 1994"
11,10,30,2440,344,385,729,"21 de agosto de 1994"
11,10,30,2441,257,351,608,"21 de agosto de 1994"
11,10,30,2442,247,256,503,"21 de agosto de 1994"
11,10,30,2443,175,167,342,"21 de agosto de 1994"
11,10,30,2444,204,188,392,"21 de agosto de 1994"
11,10,30,2445,116,120,236,"21 de agosto de 1994"
11,11,20,1674,249,271,520,"21 de agosto de 1994"
11,11,20,1675,331,385,716,"21 de agosto de 1994"
11,11,20,1676,441,494,935,"21 de agosto de 1994"
11,11,20,1677,338,349,687,"21 de agosto de 1994"
11,11,20,1678,350,373,723,"21 de agosto de 1994"
11,11,20,1679,391,454,845,"21 de agosto de 1994"
11,11,20,1680,301,322,623,"21 de agosto de 1994"
11,11,20,1681,513,554,1067,"21 de agosto de 1994"
11,11,20,1682,271,305,576,"21 de agosto de 1994"
11,11,20,1683,358,437,795,"21 de agosto de 1994"
11,11,20,1684,430,498,928,"21 de agosto de 1994"
11,11,20,1685,201,220,421,"21 de agosto de 1994"
11,11,20,1686,384,426,810,"21 de agosto de 1994"
11,11,20,1687,317,365,682,"21 de agosto de 1994"
11,11,20,1688,243,289,532,"21 de agosto de 1994"
11,11,20,1689,388,387,775,"21 de agosto de 1994"
11,11,20,1690,281,297,578,"21 de agosto de 1994"
11,11,20,1691,445,475,920,"21 de agosto de 1994"
11,11,20,1692,380,443,823,"21 de agosto de 1994"
11,11,20,1693,254,284,538,"21 de agosto de 1994"
11,11,20,1694,339,356,695,"21 de agosto de 1994"
11,11,20,1695,243,297,540,"21 de agosto de 1994"
11,11,20,1696,459,545,1004,"21 de agosto de 1994"
11,11,20,1697,398,494,892,"21 de agosto de 1994"
11,11,20,1698,416,475,891,"21 de agosto de 1994"
11,11,20,1699,298,331,629,"21 de agosto de 1994"
11,11,20,1700,579,685,1264,"21 de agosto de 1994"
11,11,20,1701,308,324,632,"21 de agosto de 1994"
11,11,20,1702,388,411,799,"21 de agosto de 1994"
11,11,20,1703,147,147,294,"21 de agosto de 1994"
11,11,20,1704,462,524,986,"21 de agosto de 1994"
11,11,20,1705,486,552,1038,"21 de agosto de 1994"
11,11,20,1706,420,454,874,"21 de agosto de 1994"
11,11,20,1707,279,288,567,"21 de agosto de 1994"
11,11,20,1708,505,558,1063,"21 de agosto de 1994"
11,11,20,1709,615,651,1266,"21 de agosto de 1994"
11,11,20,1710,361,450,811,"21 de agosto de 1994"
11,11,20,1711,217,230,447,"21 de agosto de 1994"
11,11,20,1712,161,207,368,"21 de agosto de 1994"
11,11,20,1713,453,521,974,"21 de agosto de 1994"
11,11,20,1714,430,503,933,"21 de agosto de 1994"
11,11,20,1715,392,434,826,"21 de agosto de 1994"
11,11,20,1716,270,334,604,"21 de agosto de 1994"
11,11,20,1717,382,445,827,"21 de agosto de 1994"
11,11,20,1718,506,581,1087,"21 de agosto de 1994"
11,11,20,1719,544,624,1168,"21 de agosto de 1994"
11,11,20,1720,449,472,921,"21 de agosto de 1994"
11,11,20,1721,320,370,690,"21 de agosto de 1994"
11,11,20,1722,546,526,1072,"21 de agosto de 1994"
11,11,20,1723,331,373,704,"21 de agosto de 1994"
11,11,20,1724,373,387,760,"21 de agosto de 1994"
11,11,20,1725,183,205,388,"21 de agosto de 1994"
11,11,20,1726,369,396,765,"21 de agosto de 1994"
11,11,20,1727,562,615,1177,"21 de agosto de 1994"
11,11,20,1728,247,305,552,"21 de agosto de 1994"
11,11,20,1729,371,454,825,"21 de agosto de 1994"
11,11,20,1730,371,436,807,"21 de agosto de 1994"
11,11,20,1731,560,590,1150,"21 de agosto de 1994"
11,11,20,1732,514,569,1083,"21 de agosto de 1994"
11,11,20,1733,618,662,1280,"21 de agosto de 1994"
11,11,20,1734,484,544,1028,"21 de agosto de 1994"
11,11,20,1735,393,439,832,"21 de agosto de 1994"
11,11,20,1736,326,369,695,"21 de agosto de 1994"
11,11,20,1737,424,487,911,"21 de agosto de 1994"
11,11,20,1738,292,355,647,"21 de agosto de 1994"
11,11,20,1739,489,518,1007,"21 de agosto de 1994"
11,11,20,1740,447,494,941,"21 de agosto de 1994"
11,11,20,1741,582,650,1232,"21 de agosto de 1994"
11,11,20,1742,462,506,968,"21 de agosto de 1994"
11,11,20,1743,239,315,554,"21 de agosto de 1994"
11,11,20,1744,356,433,789,"21 de agosto de 1994"
11,11,20,1745,568,644,1212,"21 de agosto de 1994"
11,11,20,1746,389,441,830,"21 de agosto de 1994"
11,11,20,1747,627,720,1347,"21 de agosto de 1994"
11,11,20,1748,559,587,1146,"21 de agosto de 1994"
11,11,20,1749,488,544,1032,"21 de agosto de 1994"
11,11,20,1750,239,281,520,"21 de agosto de 1994"
11,11,20,1751,382,420,802,"21 de agosto de 1994"
11,11,20,1752,395,469,864,"21 de agosto de 1994"
11,11,20,1753,583,638,1221,"21 de agosto de 1994"
11,11,20,1754,527,633,1160,"21 de agosto de 1994"
11,11,20,1755,343,446,789,"21 de agosto de 1994"
11,11,20,1756,310,349,659,"21 de agosto de 1994"
11,11,20,1757,196,211,407,"21 de agosto de 1994"
11,11,20,1758,320,452,772,"21 de agosto de 1994"
11,11,20,1759,519,625,1144,"21 de agosto de 1994"
11,11,20,1760,576,680,1256,"21 de agosto de 1994"
11,11,20,1761,360,435,795,"21 de agosto de 1994"
11,11,20,1762,339,410,749,"21 de agosto de 1994"
11,11,20,1763,333,377,710,"21 de agosto de 1994"
11,11,20,1764,431,514,945,"21 de agosto de 1994"
11,11,20,1765,516,553,1069,"21 de agosto de 1994"
11,11,20,1766,489,568,1057,"21 de agosto de 1994"
11,11,20,1767,540,563,1103,"21 de agosto de 1994"
11,11,20,1768,392,395,787,"21 de agosto de 1994"
11,11,20,1769,417,463,880,"21 de agosto de 1994"
11,11,20,1770,556,653,1209,"21 de agosto de 1994"
11,11,20,1771,427,471,898,"21 de agosto de 1994"
11,11,20,1772,331,377,708,"21 de agosto de 1994"
11,11,20,1773,396,441,837,"21 de agosto de 1994"
11,11,20,1774,416,468,884,"21 de agosto de 1994"
11,11,20,1775,517,554,1071,"21 de agosto de 1994"
11,11,20,1776,294,339,633,"21 de agosto de 1994"
11,11,20,1777,271,330,601,"21 de agosto de 1994"
11,11,20,1778,259,332,591,"21 de agosto de 1994"
11,11,20,1779,446,513,959,"21 de agosto de 1994"
11,11,20,1780,523,544,1067,"21 de agosto de 1994"
11,11,20,1781,396,461,857,"21 de agosto de 1994"
11,11,20,1782,542,586,1128,"21 de agosto de 1994"
11,11,20,1783,425,481,906,"21 de agosto de 1994"
11,11,20,1784,450,548,998,"21 de agosto de 1994"
11,11,20,1785,489,578,1067,"21 de agosto de 1994"
11,11,20,1786,555,585,1140,"21 de agosto de 1994"
11,11,20,1787,574,654,1228,"21 de agosto de 1994"
11,11,20,1788,205,269,474,"21 de agosto de 1994"
11,11,20,1789,433,484,917,"21 de agosto de 1994"
11,11,20,1790,416,512,928,"21 de agosto de 1994"
11,11,20,1791,458,531,989,"21 de agosto de 1994"
11,11,20,1792,568,603,1171,"21 de agosto de 1994"
11,11,20,1793,425,512,937,"21 de agosto de 1994"
11,11,20,1794,707,731,1438,"21 de agosto de 1994"
11,11,20,1795,458,511,969,"21 de agosto de 1994"
11,11,20,1796,463,541,1004,"21 de agosto de 1994"
11,11,20,1797,403,464,867,"21 de agosto de 1994"
11,11,20,1798,287,349,636,"21 de agosto de 1994"
11,11,20,1799,229,278,507,"21 de agosto de 1994"
11,11,20,1800,406,485,891,"21 de agosto de 1994"
11,11,20,1801,387,414,801,"21 de agosto de 1994"
11,11,20,1802,327,371,698,"21 de agosto de 1994"
11,11,20,1803,640,718,1358,"21 de agosto de 1994"
11,11,20,1804,293,331,624,"21 de agosto de 1994"
11,11,20,1805,329,431,760,"21 de agosto de 1994"
11,11,20,1806,324,421,745,"21 de agosto de 1994"
11,11,20,1807,350,338,688,"21 de agosto de 1994"
11,11,20,1808,178,203,381,"21 de agosto de 1994"
11,11,20,1809,355,426,781,"21 de agosto de 1994"
11,11,20,1810,475,484,959,"21 de agosto de 1994"
11,11,20,1811,336,367,703,"21 de agosto de 1994"
11,11,20,1812,268,309,577,"21 de agosto de 1994"
11,11,20,1813,351,399,750,"21 de agosto de 1994"
11,11,20,1814,317,357,674,"21 de agosto de 1994"
11,11,20,1815,211,273,484,"21 de agosto de 1994"
11,11,20,1816,398,456,854,"21 de agosto de 1994"
11,11,20,1817,549,599,1148,"21 de agosto de 1994"
11,11,20,1818,471,532,1003,"21 de agosto de 1994"
11,11,20,1819,204,249,453,"21 de agosto de 1994"
11,11,20,1820,262,281,543,"21 de agosto de 1994"
11,11,20,1821,322,396,718,"21 de agosto de 1994"
11,11,20,1822,733,802,1535,"21 de agosto de 1994"
11,11,20,1823,410,445,855,"21 de agosto de 1994"
11,11,20,1824,466,515,981,"21 de agosto de 1994"
11,11,20,1825,399,435,834,"21 de agosto de 1994"
11,11,20,1826,608,709,1317,"21 de agosto de 1994"
11,11,20,1827,472,520,992,"21 de agosto de 1994"
11,11,20,1828,524,524,1048,"21 de agosto de 1994"
11,11,20,1829,456,551,1007,"21 de agosto de 1994"
11,11,20,1830,393,439,832,"21 de agosto de 1994"
11,11,20,1831,507,588,1095,"21 de agosto de 1994"
11,11,20,1832,463,512,975,"21 de agosto de 1994"
11,11,20,1833,437,491,928,"21 de agosto de 1994"
11,11,20,1834,465,526,991,"21 de agosto de 1994"
11,11,20,1835,542,551,1093,"21 de agosto de 1994"
11,11,20,1836,508,543,1051,"21 de agosto de 1994"
11,11,20,1837,538,649,1187,"21 de agosto de 1994"
11,11,20,1838,316,364,680,"21 de agosto de 1994"
11,11,20,1839,489,546,1035,"21 de agosto de 1994"
11,11,20,1840,518,601,1119,"21 de agosto de 1994"
11,11,20,1841,628,691,1319,"21 de agosto de 1994"
11,11,20,1842,593,734,1327,"21 de agosto de 1994"
11,11,20,1843,335,405,740,"21 de agosto de 1994"
11,11,20,1844,376,420,796,"21 de agosto de 1994"
11,11,20,1845,482,565,1047,"21 de agosto de 1994"
11,11,20,1846,316,367,683,"21 de agosto de 1994"
11,11,20,1847,246,270,516,"21 de agosto de 1994"
11,11,20,1848,498,564,1062,"21 de agosto de 1994"
11,11,20,1849,545,591,1136,"21 de agosto de 1994"
11,11,20,1850,432,486,918,"21 de agosto de 1994"
11,11,20,1851,530,619,1149,"21 de agosto de 1994"
11,11,20,1852,437,491,928,"21 de agosto de 1994"
11,11,20,1853,444,442,886,"21 de agosto de 1994"
11,11,20,1854,376,400,776,"21 de agosto de 1994"
11,11,20,1855,458,540,998,"21 de agosto de 1994"
11,11,20,1856,614,727,1341,"21 de agosto de 1994"
11,11,20,1857,356,444,800,"21 de agosto de 1994"
11,11,20,1858,556,606,1162,"21 de agosto de 1994"
11,12,21,1859,246,320,566,"21 de agosto de 1994"
11,12,21,1860,392,482,874,"21 de agosto de 1994"
11,12,21,1861,471,600,1071,"21 de agosto de 1994"
11,12,21,1862,317,337,654,"21 de agosto de 1994"
11,12,21,1863,339,376,715,"21 de agosto de 1994"
11,12,21,1864,458,583,1041,"21 de agosto de 1994"
11,12,21,1865,324,372,696,"21 de agosto de 1994"
11,12,21,1866,327,330,657,"21 de agosto de 1994"
11,12,21,1867,433,465,898,"21 de agosto de 1994"
11,12,21,1868,362,475,837,"21 de agosto de 1994"
11,12,21,1869,501,641,1142,"21 de agosto de 1994"
11,12,21,1870,510,584,1094,"21 de agosto de 1994"
11,12,21,1871,252,273,525,"21 de agosto de 1994"
11,12,21,1872,258,321,579,"21 de agosto de 1994"
11,12,21,1873,499,614,1113,"21 de agosto de 1994"
11,12,21,1874,380,514,894,"21 de agosto de 1994"
11,12,21,1875,528,679,1207,"21 de agosto de 1994"
11,12,21,1876,281,391,672,"21 de agosto de 1994"
11,12,21,1877,316,362,678,"21 de agosto de 1994"
11,12,21,1878,332,383,715,"21 de agosto de 1994"
11,12,21,1879,337,461,798,"21 de agosto de 1994"
11,12,21,1880,365,547,912,"21 de agosto de 1994"
11,12,21,1881,170,275,445,"21 de agosto de 1994"
11,12,21,1882,159,236,395,"21 de agosto de 1994"
11,12,21,1883,297,419,716,"21 de agosto de 1994"
11,12,21,1884,300,440,740,"21 de agosto de 1994"
11,12,21,1885,324,410,734,"21 de agosto de 1994"
11,12,21,1886,177,214,391,"21 de agosto de 1994"
11,12,21,1887,176,229,405,"21 de agosto de 1994"
11,12,21,1888,83,194,277,"21 de agosto de 1994"
11,12,21,1889,164,251,415,"21 de agosto de 1994"
11,12,21,1890,245,336,581,"21 de agosto de 1994"
11,12,21,1891,184,318,502,"21 de agosto de 1994"
11,12,21,1892,225,417,642,"21 de agosto de 1994"
11,12,21,1893,219,435,654,"21 de agosto de 1994"
11,12,36,2644,164,205,369,"21 de agosto de 1994"
11,12,36,2645,215,306,521,"21 de agosto de 1994"
11,12,36,2646,198,313,511,"21 de agosto de 1994"
11,12,36,2647,171,238,409,"21 de agosto de 1994"
11,12,36,2648,125,184,309,"21 de agosto de 1994"
11,12,36,2649,218,278,496,"21 de agosto de 1994"
11,12,36,2650,143,227,370,"21 de agosto de 1994"
11,12,36,2651,64,127,191,"21 de agosto de 1994"
11,12,36,2652,173,270,443,"21 de agosto de 1994"
11,12,36,2653,189,310,499,"21 de agosto de 1994"
11,12,41,2790,474,612,1086,"21 de agosto de 1994"
11,12,41,2791,511,645,1156,"21 de agosto de 1994"
11,12,41,2792,581,729,1310,"21 de agosto de 1994"
11,12,41,2793,464,539,1003,"21 de agosto de 1994"
11,12,41,2794,383,519,902,"21 de agosto de 1994"
11,12,41,2795,242,318,560,"21 de agosto de 1994"
11,12,41,2796,385,462,847,"21 de agosto de 1994"
11,12,41,2797,439,563,1002,"21 de agosto de 1994"
11,12,41,2798,467,653,1120,"21 de agosto de 1994"
11,12,41,2799,449,608,1057,"21 de agosto de 1994"
11,12,41,2800,464,600,1064,"21 de agosto de 1994"
11,12,41,2801,512,612,1124,"21 de agosto de 1994"
11,12,41,2802,454,559,1013,"21 de agosto de 1994"
11,12,41,2803,354,421,775,"21 de agosto de 1994"
11,12,41,2804,398,562,960,"21 de agosto de 1994"
11,12,41,2805,179,245,424,"21 de agosto de 1994"
11,12,41,2806,345,449,794,"21 de agosto de 1994"
11,12,41,2807,489,604,1093,"21 de agosto de 1994"
11,12,41,2808,369,449,818,"21 de agosto de 1994"
11,12,41,2809,414,507,921,"21 de agosto de 1994"
11,12,41,2810,259,309,568,"21 de agosto de 1994"
11,12,41,2811,123,297,420,"21 de agosto de 1994"
11,12,41,2812,183,257,440,"21 de agosto de 1994"
11,12,41,2813,307,443,750,"21 de agosto de 1994"
11,12,41,2814,256,485,741,"21 de agosto de 1994"
11,12,41,2815,160,275,435,"21 de agosto de 1994"
11,12,42,2816,335,370,705,"21 de agosto de 1994"
11,12,42,2817,294,377,671,"21 de agosto de 1994"
11,12,42,2818,451,501,952,"21 de agosto de 1994"
11,12,42,2819,399,477,876,"21 de agosto de 1994"
11,12,42,2820,314,397,711,"21 de agosto de 1994"
11,12,42,2821,372,532,904,"21 de agosto de 1994"
11,12,42,2822,337,442,779,"21 de agosto de 1994"
11,12,42,2823,538,605,1143,"21 de agosto de 1994"
11,12,42,2824,562,685,1247,"21 de agosto de 1994"
11,12,42,2825,488,598,1086,"21 de agosto de 1994"
11,12,42,2826,332,363,695,"21 de agosto de 1994"
11,12,42,2827,191,230,421,"21 de agosto de 1994"
11,12,42,2828,406,555,961,"21 de agosto de 1994"
11,12,42,2829,463,601,1064,"21 de agosto de 1994"
11,12,42,2830,426,483,909,"21 de agosto de 1994"
11,12,42,2831,471,553,1024,"21 de agosto de 1994"
11,12,42,2832,440,523,963,"21 de agosto de 1994"
11,12,42,2833,416,527,943,"21 de agosto de 1994"
11,12,42,2834,438,505,943,"21 de agosto de 1994"
11,12,42,2835,208,248,456,"21 de agosto de 1994"
11,12,42,2836,212,276,488,"21 de agosto de 1994"
11,12,42,2837,459,568,1027,"21 de agosto de 1994"
11,12,42,2838,435,507,942,"21 de agosto de 1994"
11,12,42,2839,486,598,1084,"21 de agosto de 1994"
11,12,42,2840,369,438,807,"21 de agosto de 1994"
11,12,42,2841,229,281,510,"21 de agosto de 1994"
11,12,42,2842,339,417,756,"21 de agosto de 1994"
11,12,42,2843,414,457,871,"21 de agosto de 1994"
11,12,42,2844,321,404,725,"21 de agosto de 1994"
11,12,42,2845,355,396,751,"21 de agosto de 1994"
11,12,42,2846,143,172,315,"21 de agosto de 1994"
11,12,42,2847,335,390,725,"21 de agosto de 1994"
11,12,42,2848,429,547,976,"21 de agosto de 1994"
11,12,42,2849,364,505,869,"21 de agosto de 1994"
11,12,42,2850,375,528,903,"21 de agosto de 1994"
11,12,42,2851,292,492,784,"21 de agosto de 1994"
11,12,42,2852,408,638,1046,"21 de agosto de 1994"
11,12,42,2853,312,444,756,"21 de agosto de 1994"
11,12,42,2854,143,205,348,"21 de agosto de 1994"
11,12,42,2855,403,473,876,"21 de agosto de 1994"
11,12,42,2856,378,419,797,"21 de agosto de 1994"
11,12,42,2857,313,499,812,"21 de agosto de 1994"
11,12,42,2858,202,282,484,"21 de agosto de 1994"
11,12,42,2859,189,300,489,"21 de agosto de 1994"
11,12,42,2860,444,530,974,"21 de agosto de 1994"
11,12,42,2861,315,415,730,"21 de agosto de 1994"
11,12,42,2862,359,383,742,"21 de agosto de 1994"
11,12,42,2863,404,524,928,"21 de agosto de 1994"
11,12,42,2864,461,515,976,"21 de agosto de 1994"
11,12,42,2865,300,395,695,"21 de agosto de 1994"
11,12,42,2866,261,338,599,"21 de agosto de 1994"
11,12,42,2867,449,518,967,"21 de agosto de 1994"
11,12,42,2868,424,481,905,"21 de agosto de 1994"
11,12,42,2869,408,459,867,"21 de agosto de 1994"
11,12,42,2870,405,623,1028,"21 de agosto de 1994"
11,12,42,2871,487,613,1100,"21 de agosto de 1994"
11,12,42,2872,494,660,1154,"21 de agosto de 1994"
11,12,42,2873,509,639,1148,"21 de agosto de 1994"
11,12,42,2874,386,446,832,"21 de agosto de 1994"
11,12,42,2875,460,677,1137,"21 de agosto de 1994"
11,12,42,2876,379,488,867,"21 de agosto de 1994"
11,12,42,2877,395,471,866,"21 de agosto de 1994"
11,12,42,2878,372,424,796,"21 de agosto de 1994"
11,12,42,2879,270,381,651,"21 de agosto de 1994"
11,12,42,2880,356,495,851,"21 de agosto de 1994"
11,12,42,2881,250,386,636,"21 de agosto de 1994"
11,12,42,2882,271,537,808,"21 de agosto de 1994"
11,12,42,2883,308,675,983,"21 de agosto de 1994"
11,12,42,2884,259,398,657,"21 de agosto de 1994"
11,12,42,2885,247,368,615,"21 de agosto de 1994"
11,12,42,2886,257,421,678,"21 de agosto de 1994"
11,12,42,2887,328,543,871,"21 de agosto de 1994"
11,12,42,2888,303,464,767,"21 de agosto de 1994"
11,12,42,2889,223,417,640,"21 de agosto de 1994"
11,12,42,2890,313,500,813,"21 de agosto de 1994"
11,12,46,2949,363,468,831,"21 de agosto de 1994"
11,12,46,2950,273,384,657,"21 de agosto de 1994"
11,12,46,2951,285,370,655,"21 de agosto de 1994"
11,12,46,2952,182,241,423,"21 de agosto de 1994"
11,12,46,2953,132,166,298,"21 de agosto de 1994"
11,12,46,2954,424,520,944,"21 de agosto de 1994"
11,12,46,2955,403,510,913,"21 de agosto de 1994"
11,12,46,2956,511,609,1120,"21 de agosto de 1994"
11,12,46,2957,243,337,580,"21 de agosto de 1994"
11,12,46,2958,414,559,973,"21 de agosto de 1994"
11,12,46,2959,266,357,623,"21 de agosto de 1994"
11,12,46,2960,242,313,555,"21 de agosto de 1994"
11,12,46,2961,346,392,738,"21 de agosto de 1994"
11,12,46,2962,258,309,567,"21 de agosto de 1994"
11,12,46,2963,397,471,868,"21 de agosto de 1994"
11,12,46,2964,355,545,900,"21 de agosto de 1994"
11,12,46,2965,296,369,665,"21 de agosto de 1994"
11,12,46,2966,292,422,714,"21 de agosto de 1994"
11,12,46,2967,167,312,479,"21 de agosto de 1994"
11,12,46,2968,175,283,458,"21 de agosto de 1994"
11,12,46,2969,241,342,583,"21 de agosto de 1994"
11,12,46,2970,158,239,397,"21 de agosto de 1994"
11,12,46,2971,235,338,573,"21 de agosto de 1994"
11,12,46,2972,195,273,468,"21 de agosto de 1994"
11,12,46,2973,245,391,636,"21 de agosto de 1994"
11,12,46,2974,195,259,454,"21 de agosto de 1994"
11,12,46,2975,234,303,537,"21 de agosto de 1994"
11,12,46,2976,81,156,237,"21 de agosto de 1994"
11,12,46,2977,118,178,296,"21 de agosto de 1994"
11,12,46,2978,160,256,416,"21 de agosto de 1994"
11,12,46,2979,219,320,539,"21 de agosto de 1994"
11,12,46,2980,273,447,720,"21 de agosto de 1994"
11,12,46,2981,178,241,419,"21 de agosto de 1994"
11,12,46,2982,169,241,410,"21 de agosto de 1994"
11,12,46,2983,218,389,607,"21 de agosto de 1994"
11,12,46,2984,363,489,852,"21 de agosto de 1994"
11,12,46,2985,119,221,340,"21 de agosto de 1994"
11,12,46,2986,219,307,526,"21 de agosto de 1994"
11,12,46,2987,245,499,744,"21 de agosto de 1994"
11,12,46,2988,123,205,328,"21 de agosto de 1994"
11,12,46,2989,100,177,277,"21 de agosto de 1994"
11,12,46,2990,238,401,639,"21 de agosto de 1994"
11,12,46,2991,289,421,710,"21 de agosto de 1994"
11,12,46,2992,300,403,703,"21 de agosto de 1994"
11,12,46,2993,373,567,940,"21 de agosto de 1994"
11,12,46,2994,315,521,836,"21 de agosto de 1994"
11,12,46,2995,153,218,371,"21 de agosto de 1994"
11,12,46,2996,169,252,421,"21 de agosto de 1994"
11,12,46,2997,331,447,778,"21 de agosto de 1994"
11,12,46,2998,365,477,842,"21 de agosto de 1994"
11,12,46,2999,343,471,814,"21 de agosto de 1994"
11,12,46,3000,329,497,826,"21 de agosto de 1994"
11,12,46,3001,375,614,989,"21 de agosto de 1994"
11,12,46,3002,215,355,570,"21 de agosto de 1994"
11,12,46,3003,233,348,581,"21 de agosto de 1994"
11,12,46,3004,255,351,606,"21 de agosto de 1994"
11,12,46,3005,195,333,528,"21 de agosto de 1994"
11,13,11,662,258,297,555,"21 de agosto de 1994"
11,13,11,663,361,411,772,"21 de agosto de 1994"
11,13,11,664,457,510,967,"21 de agosto de 1994"
11,13,11,665,358,373,731,"21 de agosto de 1994"
11,13,11,666,300,357,657,"21 de agosto de 1994"
11,13,11,667,287,319,606,"21 de agosto de 1994"
11,13,11,668,370,404,774,"21 de agosto de 1994"
11,13,11,669,475,532,1007,"21 de agosto de 1994"
11,13,11,670,538,619,1157,"21 de agosto de 1994"
11,13,11,671,605,745,1350,"21 de agosto de 1994"
11,13,11,672,454,440,894,"21 de agosto de 1994"
11,13,11,673,284,353,637,"21 de agosto de 1994"
11,13,11,674,278,347,625,"21 de agosto de 1994"
11,13,11,675,310,375,685,"21 de agosto de 1994"
11,13,11,676,503,541,1044,"21 de agosto de 1994"
11,13,11,677,534,599,1133,"21 de agosto de 1994"
11,13,11,678,316,379,695,"21 de agosto de 1994"
11,13,11,679,430,486,916,"21 de agosto de 1994"
11,13,11,680,341,386,727,"21 de agosto de 1994"
11,13,11,681,484,583,1067,"21 de agosto de 1994"
11,13,11,682,582,636,1218,"21 de agosto de 1994"
11,13,11,683,550,642,1192,"21 de agosto de 1994"
11,13,11,684,488,543,1031,"21 de agosto de 1994"
11,13,11,685,484,555,1039,"21 de agosto de 1994"
11,13,11,686,267,265,532,"21 de agosto de 1994"
11,13,11,687,287,301,588,"21 de agosto de 1994"
11,13,11,688,409,442,851,"21 de agosto de 1994"
11,13,11,689,400,437,837,"21 de agosto de 1994"
11,13,11,690,335,386,721,"21 de agosto de 1994"
11,13,11,691,363,384,747,"21 de agosto de 1994"
11,13,11,692,252,296,548,"21 de agosto de 1994"
11,13,11,693,76,74,150,"21 de agosto de 1994"
11,13,11,694,493,552,1045,"21 de agosto de 1994"
11,13,11,695,446,535,981,"21 de agosto de 1994"
11,13,11,696,283,327,610,"21 de agosto de 1994"
11,13,11,697,436,554,990,"21 de agosto de 1994"
11,13,11,698,340,429,769,"21 de agosto de 1994"
11,13,11,699,338,407,745,"21 de agosto de 1994"
11,13,11,700,234,318,552,"21 de agosto de 1994"
11,13,11,701,332,417,749,"21 de agosto de 1994"
11,13,11,702,217,258,475,"21 de agosto de 1994"
11,13,11,703,195,249,444,"21 de agosto de 1994"
11,13,11,704,79,92,171,"21 de agosto de 1994"
11,13,11,705,387,481,868,"21 de agosto de 1994"
11,13,11,706,103,111,214,"21 de agosto de 1994"
11,13,11,707,235,346,581,"21 de agosto de 1994"
11,13,11,708,354,421,775,"21 de agosto de 1994"
11,13,11,709,258,346,604,"21 de agosto de 1994"
11,13,11,710,299,356,655,"21 de agosto de 1994"
11,13,11,711,130,186,316,"21 de agosto de 1994"
11,13,11,712,234,324,558,"21 de agosto de 1994"
11,13,11,713,280,409,689,"21 de agosto de 1994"
11,13,11,714,175,284,459,"21 de agosto de 1994"
11,13,11,715,269,420,689,"21 de agosto de 1994"
11,13,11,716,306,370,676,"21 de agosto de 1994"
11,13,18,1178,436,564,1000,"21 de agosto de 1994"
11,13,18,1179,292,329,621,"21 de agosto de 1994"
11,13,18,1180,250,299,549,"21 de agosto de 1994"
11,13,18,1181,132,166,298,"21 de agosto de 1994"
11,13,18,1182,427,492,919,"21 de agosto de 1994"
11,13,18,1183,584,620,1204,"21 de agosto de 1994"
11,13,18,1184,447,528,975,"21 de agosto de 1994"
11,13,18,1185,394,423,817,"21 de agosto de 1994"
11,13,18,1186,302,350,652,"21 de agosto de 1994"
11,13,18,1187,167,192,359,"21 de agosto de 1994"
11,13,18,1188,444,454,898,"21 de agosto de 1994"
11,13,18,1189,169,168,337,"21 de agosto de 1994"
11,13,18,1190,164,163,327,"21 de agosto de 1994"
11,13,18,1191,355,388,743,"21 de agosto de 1994"
11,13,18,1192,462,506,968,"21 de agosto de 1994"
11,13,18,1193,281,354,635,"21 de agosto de 1994"
11,13,18,1194,359,403,762,"21 de agosto de 1994"
11,13,18,1195,319,344,663,"21 de agosto de 1994"
11,13,18,1196,342,428,770,"21 de agosto de 1994"
11,13,18,1197,303,369,672,"21 de agosto de 1994"
11,13,18,1198,237,295,532,"21 de agosto de 1994"
11,13,18,1199,207,322,529,"21 de agosto de 1994"
11,13,18,1200,171,261,432,"21 de agosto de 1994"
11,13,18,1201,166,234,400,"21 de agosto de 1994"
11,13,18,1202,138,198,336,"21 de agosto de 1994"
11,13,18,1203,139,181,320,"21 de agosto de 1994"
11,13,28,2263,460,491,951,"21 de agosto de 1994"
11,13,28,2264,352,451,803,"21 de agosto de 1994"
11,13,28,2265,319,400,719,"21 de agosto de 1994"
11,13,28,2266,159,188,347,"21 de agosto de 1994"
11,13,28,2267,173,219,392,"21 de agosto de 1994"
11,13,28,2268,376,463,839,"21 de agosto de 1994"
11,13,28,2269,395,478,873,"21 de agosto de 1994"
11,13,28,2270,361,444,805,"21 de agosto de 1994"
11,13,28,2271,309,372,681,"21 de agosto de 1994"
11,13,28,2272,223,265,488,"21 de agosto de 1994"
11,13,28,2273,325,374,699,"21 de agosto de 1994"
11,13,28,2274,559,706,1265,"21 de agosto de 1994"
11,13,28,2275,422,495,917,"21 de agosto de 1994"
11,13,28,2276,301,351,652,"21 de agosto de 1994"
11,13,28,2277,292,342,634,"21 de agosto de 1994"
11,13,28,2278,418,482,900,"21 de agosto de 1994"
11,13,28,2279,336,418,754,"21 de agosto de 1994"
11,13,28,2280,360,428,788,"21 de agosto de 1994"
11,13,28,2281,190,240,430,"21 de agosto de 1994"
11,13,28,2282,354,431,785,"21 de agosto de 1994"
11,13,28,2283,274,336,610,"21 de agosto de 1994"
11,13,28,2284,327,348,675,"21 de agosto de 1994"
11,13,28,2285,329,376,705,"21 de agosto de 1994"
11,13,28,2286,270,322,592,"21 de agosto de 1994"
11,13,28,2287,460,515,975,"21 de agosto de 1994"
11,13,28,2288,348,392,740,"21 de agosto de 1994"
11,13,28,2289,287,305,592,"21 de agosto de 1994"
11,13,28,2290,301,355,656,"21 de agosto de 1994"
11,13,28,2291,183,280,463,"21 de agosto de 1994"
11,13,28,2292,181,273,454,"21 de agosto de 1994"
11,13,28,2293,188,258,446,"21 de agosto de 1994"
11,13,28,2294,216,280,496,"21 de agosto de 1994"
11,13,28,2295,243,375,618,"21 de agosto de 1994"
11,13,28,2296,172,235,407,"21 de agosto de 1994"
11,13,28,2297,356,469,825,"21 de agosto de 1994"
11,13,28,2298,346,447,793,"21 de agosto de 1994"
11,13,28,2299,294,440,734,"21 de agosto de 1994"
11,13,28,2300,149,180,329,"21 de agosto de 1994"
11,13,28,2301,221,244,465,"21 de agosto de 1994"
11,13,28,2302,227,356,583,"21 de agosto de 1994"
11,13,28,2303,153,202,355,"21 de agosto de 1994"
11,13,28,2304,206,330,536,"21 de agosto de 1994"
11,13,28,2305,223,348,571,"21 de agosto de 1994"
11,13,28,2306,326,400,726,"21 de agosto de 1994"
11,13,28,2307,151,174,325,"21 de agosto de 1994"
11,13,28,2308,298,307,605,"21 de agosto de 1994"
11,13,28,2309,179,250,429,"21 de agosto de 1994"
11,13,28,2310,257,359,616,"21 de agosto de 1994"
11,13,28,2311,338,407,745,"21 de agosto de 1994"
11,13,28,2312,278,363,641,"21 de agosto de 1994"
11,13,28,2313,207,281,488,"21 de agosto de 1994"
11,13,28,2314,460,524,984,"21 de agosto de 1994"
11,13,28,2315,406,495,901,"21 de agosto de 1994"
11,13,28,2316,206,226,432,"21 de agosto de 1994"
11,13,28,2317,253,317,570,"21 de agosto de 1994"
11,13,28,2318,200,233,433,"21 de agosto de 1994"
11,13,28,2319,349,427,776,"21 de agosto de 1994"
11,13,28,2320,339,382,721,"21 de agosto de 1994"
11,13,28,2321,160,169,329,"21 de agosto de 1994"
11,13,28,2322,198,262,460,"21 de agosto de 1994"
11,13,28,2323,240,319,559,"21 de agosto de 1994"
11,13,28,2324,261,328,589,"21 de agosto de 1994"
11,13,28,2325,300,370,670,"21 de agosto de 1994"
11,13,28,2326,299,476,775,"21 de agosto de 1994"
11,13,28,2327,375,551,926,"21 de agosto de 1994"
11,13,28,2328,285,393,678,"21 de agosto de 1994"
11,13,28,2329,333,446,779,"21 de agosto de 1994"
11,13,28,2330,299,374,673,"21 de agosto de 1994"
11,13,28,2331,302,388,690,"21 de agosto de 1994"
11,13,28,2332,382,526,908,"21 de agosto de 1994"
11,13,28,2333,349,451,800,"21 de agosto de 1994"
11,13,28,2334,210,313,523,"21 de agosto de 1994"
11,13,28,2335,220,294,514,"21 de agosto de 1994"
11,13,28,2336,191,244,435,"21 de agosto de 1994"
11,13,28,2337,242,303,545,"21 de agosto de 1994"
11,13,28,2338,343,426,769,"21 de agosto de 1994"
11,13,28,2339,180,221,401,"21 de agosto de 1994"
11,13,28,2340,194,230,424,"21 de agosto de 1994"
11,13,28,2341,243,334,577,"21 de agosto de 1994"
11,13,28,2342,258,376,634,"21 de agosto de 1994"
11,13,28,2343,132,160,292,"21 de agosto de 1994"
11,13,28,2344,138,223,361,"21 de agosto de 1994"
11,13,28,2345,174,240,414,"21 de agosto de 1994"
11,13,28,2346,100,182,282,"21 de agosto de 1994"
11,13,39,2744,310,358,668,"21 de agosto de 1994"
11,13,39,2745,299,323,622,"21 de agosto de 1994"
11,13,39,2746,361,426,787,"21 de agosto de 1994"
11,13,39,2747,363,423,786,"21 de agosto de 1994"
11,13,39,2748,99,117,216,"21 de agosto de 1994"
11,13,39,2749,362,444,806,"21 de agosto de 1994"
11,13,39,2750,296,394,690,"21 de agosto de 1994"
11,13,39,2751,278,355,633,"21 de agosto de 1994"
11,13,39,2752,338,394,732,"21 de agosto de 1994"
11,13,39,2753,239,283,522,"21 de agosto de 1994"
11,13,39,2754,111,199,310,"21 de agosto de 1994"
11,13,39,2755,44,76,120,"21 de agosto de 1994"
11,13,39,2756,78,179,257,"21 de agosto de 1994"
11,13,39,2757,112,184,296,"21 de agosto de 1994"
11,13,39,2758,155,282,437,"21 de agosto de 1994"
11,13,39,2759,134,225,359,"21 de agosto de 1994"
11,13,39,2760,60,137,197,"21 de agosto de 1994"
11,13,39,2761,497,701,1198,"21 de agosto de 1994"
11,13,39,2762,231,276,507,"21 de agosto de 1994"
11,13,39,2763,291,390,681,"21 de agosto de 1994"
11,13,39,2764,112,218,330,"21 de agosto de 1994"
11,13,39,2765,340,419,759,"21 de agosto de 1994"
11,13,39,2766,195,229,424,"21 de agosto de 1994"
11,13,39,2767,262,309,571,"21 de agosto de 1994"
11,13,39,2768,253,315,568,"21 de agosto de 1994"
11,13,39,2769,180,248,428,"21 de agosto de 1994"
11,13,39,2770,179,234,413,"21 de agosto de 1994"
11,13,39,2771,256,323,579,"21 de agosto de 1994"
11,13,39,2772,178,268,446,"21 de agosto de 1994"
11,13,39,2773,276,359,635,"21 de agosto de 1994"
11,13,39,2774,223,291,514,"21 de agosto de 1994"
11,13,39,2775,239,289,528,"21 de agosto de 1994"
11,13,39,2776,138,173,311,"21 de agosto de 1994"
11,13,39,2777,340,445,785,"21 de agosto de 1994"
11,13,44,2906,209,198,407,"21 de agosto de 1994"
11,13,44,2907,307,349,656,"21 de agosto de 1994"
11,13,44,2908,232,260,492,"21 de agosto de 1994"
11,13,44,2909,349,398,747,"21 de agosto de 1994"
11,13,44,2910,426,435,861,"21 de agosto de 1994"
11,13,44,2911,268,324,592,"21 de agosto de 1994"
11,13,44,2912,456,485,941,"21 de agosto de 1994"
11,13,44,2913,523,574,1097,"21 de agosto de 1994"
11,13,44,2914,186,198,384,"21 de agosto de 1994"
11,13,44,2915,370,426,796,"21 de agosto de 1994"
11,13,44,2916,359,458,817,"21 de agosto de 1994"
11,13,44,2917,336,369,705,"21 de agosto de 1994"
11,13,44,2918,414,461,875,"21 de agosto de 1994"
11,13,44,2919,427,486,913,"21 de agosto de 1994"
11,13,44,2920,217,270,487,"21 de agosto de 1994"
11,13,44,2921,465,490,955,"21 de agosto de 1994"
11,13,44,2922,368,435,803,"21 de agosto de 1994"
11,13,44,2923,469,640,1109,"21 de agosto de 1994"
11,13,44,2924,397,449,846,"21 de agosto de 1994"
11,13,44,2925,367,414,781,"21 de agosto de 1994"
11,13,44,2926,192,190,382,"21 de agosto de 1994"
11,13,44,2927,506,550,1056,"21 de agosto de 1994"
11,13,44,2928,315,430,745,"21 de agosto de 1994"
11,13,44,2929,557,640,1197,"21 de agosto de 1994"
11,13,44,2930,334,430,764,"21 de agosto de 1994"
11,13,44,2931,217,250,467,"21 de agosto de 1994"
11,13,44,2932,204,279,483,"21 de agosto de 1994"
11,13,44,2933,290,297,587,"21 de agosto de 1994"
12,1,21,883,253,295,548,"21 de agosto de 1994"
12,1,21,884,395,363,758,"21 de agosto de 1994"
12,1,21,885,433,425,858,"21 de agosto de 1994"
12,1,21,886,306,365,671,"21 de agosto de 1994"
12,1,21,887,383,424,807,"21 de agosto de 1994"
12,1,21,888,310,337,647,"21 de agosto de 1994"
12,1,21,889,489,566,1055,"21 de agosto de 1994"
12,1,21,890,349,354,703,"21 de agosto de 1994"
12,1,21,891,81,55,136,"21 de agosto de 1994"
12,1,21,892,113,106,219,"21 de agosto de 1994"
12,1,21,893,90,96,186,"21 de agosto de 1994"
12,1,21,894,191,179,370,"21 de agosto de 1994"
12,1,21,895,697,669,1366,"21 de agosto de 1994"
12,1,21,896,226,204,430,"21 de agosto de 1994"
12,1,21,897,168,142,310,"21 de agosto de 1994"
12,1,21,898,192,204,396,"21 de agosto de 1994"
12,1,21,899,171,159,330,"21 de agosto de 1994"
12,1,21,900,142,127,269,"21 de agosto de 1994"
12,1,21,901,53,50,103,"21 de agosto de 1994"
12,1,21,902,130,138,268,"21 de agosto de 1994"
12,1,21,903,390,368,758,"21 de agosto de 1994"
12,1,21,904,66,59,125,"21 de agosto de 1994"
12,1,21,905,127,114,241,"21 de agosto de 1994"
12,1,21,906,41,45,86,"21 de agosto de 1994"
12,1,21,907,397,424,821,"21 de agosto de 1994"
12,1,21,908,317,294,611,"21 de agosto de 1994"
12,1,21,909,368,355,723,"21 de agosto de 1994"
12,1,21,910,219,221,440,"21 de agosto de 1994"
12,1,21,911,89,77,166,"21 de agosto de 1994"
12,1,21,912,272,258,530,"21 de agosto de 1994"
12,1,21,913,284,311,595,"21 de agosto de 1994"
12,1,21,914,215,208,423,"21 de agosto de 1994"
12,1,21,915,243,305,548,"21 de agosto de 1994"
12,1,21,916,125,120,245,"21 de agosto de 1994"
12,1,21,917,531,519,1050,"21 de agosto de 1994"
12,1,21,918,249,250,499,"21 de agosto de 1994"
12,1,21,919,207,180,387,"21 de agosto de 1994"
12,1,21,920,77,86,163,"21 de agosto de 1994"
12,1,21,921,144,150,294,"21 de agosto de 1994"
12,1,21,922,287,310,597,"21 de agosto de 1994"
12,1,21,923,241,224,465,"21 de agosto de 1994"
12,1,21,924,32,27,59,"21 de agosto de 1994"
12,1,21,925,474,481,955,"21 de agosto de 1994"
12,1,21,926,422,468,890,"21 de agosto de 1994"
12,1,21,927,75,81,156,"21 de agosto de 1994"
12,1,21,928,272,309,581,"21 de agosto de 1994"
12,1,21,929,317,359,676,"21 de agosto de 1994"
12,1,21,930,76,90,166,"21 de agosto de 1994"
12,1,21,931,540,578,1118,"21 de agosto de 1994"
12,1,21,932,400,453,853,"21 de agosto de 1994"
12,1,21,933,425,459,884,"21 de agosto de 1994"
12,1,21,934,250,256,506,"21 de agosto de 1994"
12,1,21,935,253,280,533,"21 de agosto de 1994"
12,1,21,936,454,510,964,"21 de agosto de 1994"
12,1,21,937,266,310,576,"21 de agosto de 1994"
12,1,21,938,35,27,62,"21 de agosto de 1994"
12,1,21,939,182,202,384,"21 de agosto de 1994"
12,1,21,940,185,189,374,"21 de agosto de 1994"
12,1,21,941,165,189,354,"21 de agosto de 1994"
12,1,21,942,120,113,233,"21 de agosto de 1994"
12,1,29,1204,315,340,655,"21 de agosto de 1994"
12,1,29,1205,322,393,715,"21 de agosto de 1994"
12,1,29,1206,287,346,633,"21 de agosto de 1994"
12,1,29,1207,193,235,428,"21 de agosto de 1994"
12,1,29,1208,282,375,657,"21 de agosto de 1994"
12,1,29,1209,380,407,787,"21 de agosto de 1994"
12,1,29,1210,270,319,589,"21 de agosto de 1994"
12,1,29,1211,263,300,563,"21 de agosto de 1994"
12,1,29,1212,453,533,986,"21 de agosto de 1994"
12,1,29,1213,364,418,782,"21 de agosto de 1994"
12,1,29,1214,355,466,821,"21 de agosto de 1994"
12,1,29,1215,373,451,824,"21 de agosto de 1994"
12,1,29,1216,542,688,1230,"21 de agosto de 1994"
12,1,29,1217,520,579,1099,"21 de agosto de 1994"
12,1,29,1218,179,225,404,"21 de agosto de 1994"
12,1,29,1219,392,464,856,"21 de agosto de 1994"
12,1,29,1220,372,454,826,"21 de agosto de 1994"
12,1,29,1221,341,350,691,"21 de agosto de 1994"
12,1,29,1222,237,288,525,"21 de agosto de 1994"
12,1,29,1223,442,510,952,"21 de agosto de 1994"
12,1,29,1224,277,322,599,"21 de agosto de 1994"
12,1,29,1225,402,454,856,"21 de agosto de 1994"
12,1,29,1226,528,605,1133,"21 de agosto de 1994"
12,1,29,1227,584,655,1239,"21 de agosto de 1994"
12,1,29,1228,323,335,658,"21 de agosto de 1994"
12,1,29,1229,402,466,868,"21 de agosto de 1994"
12,1,29,1230,379,470,849,"21 de agosto de 1994"
12,1,29,1231,331,405,736,"21 de agosto de 1994"
12,1,29,1232,449,623,1072,"21 de agosto de 1994"
12,1,29,1233,168,224,392,"21 de agosto de 1994"
12,1,29,1234,371,392,763,"21 de agosto de 1994"
12,1,29,1235,282,271,553,"21 de agosto de 1994"
12,1,29,1236,350,453,803,"21 de agosto de 1994"
12,1,29,1237,632,749,1381,"21 de agosto de 1994"
12,1,29,1238,493,536,1029,"21 de agosto de 1994"
12,1,29,1239,295,308,603,"21 de agosto de 1994"
12,1,29,1240,434,497,931,"21 de agosto de 1994"
12,1,29,1241,472,522,994,"21 de agosto de 1994"
12,1,29,1242,453,499,952,"21 de agosto de 1994"
12,1,29,1243,210,240,450,"21 de agosto de 1994"
12,1,29,1244,358,402,760,"21 de agosto de 1994"
12,1,29,1245,211,238,449,"21 de agosto de 1994"
12,1,29,1246,207,225,432,"21 de agosto de 1994"
12,1,29,1247,364,432,796,"21 de agosto de 1994"
12,1,29,1248,314,370,684,"21 de agosto de 1994"
12,1,29,1249,317,369,686,"21 de agosto de 1994"
12,1,29,1250,438,535,973,"21 de agosto de 1994"
12,1,29,1251,509,534,1043,"21 de agosto de 1994"
12,1,29,1252,163,172,335,"21 de agosto de 1994"
12,1,29,1253,412,53,465,"21 de agosto de 1994"
12,1,29,1254,426,545,971,"21 de agosto de 1994"
12,1,29,1255,346,423,769,"21 de agosto de 1994"
12,1,29,1256,305,292,597,"21 de agosto de 1994"
12,1,29,1257,341,418,759,"21 de agosto de 1994"
12,1,29,1258,387,457,844,"21 de agosto de 1994"
12,1,29,1259,269,247,516,"21 de agosto de 1994"
12,1,29,1260,605,704,1309,"21 de agosto de 1994"
12,1,29,1261,418,517,935,"21 de agosto de 1994"
12,1,29,1262,300,321,621,"21 de agosto de 1994"
12,1,29,1263,352,397,749,"21 de agosto de 1994"
12,1,29,1264,365,450,815,"21 de agosto de 1994"
12,1,29,1265,273,286,559,"21 de agosto de 1994"
12,1,29,1266,341,417,758,"21 de agosto de 1994"
12,1,29,1267,217,230,447,"21 de agosto de 1994"
12,1,29,1268,395,479,874,"21 de agosto de 1994"
12,1,29,1269,300,365,665,"21 de agosto de 1994"
12,1,29,1270,200,227,427,"21 de agosto de 1994"
12,1,29,1271,168,217,385,"21 de agosto de 1994"
12,1,29,1272,32,29,61,"21 de agosto de 1994"
12,1,29,1273,154,127,281,"21 de agosto de 1994"
12,1,29,1274,93,86,179,"21 de agosto de 1994"
12,1,29,1275,92,78,170,"21 de agosto de 1994"
12,1,29,1276,165,74,239,"21 de agosto de 1994"
12,1,29,1277,78,73,151,"21 de agosto de 1994"
12,1,29,1278,248,246,494,"21 de agosto de 1994"
12,1,29,1279,435,425,860,"21 de agosto de 1994"
12,1,29,1280,305,312,617,"21 de agosto de 1994"
12,1,29,1281,205,225,430,"21 de agosto de 1994"
12,1,29,1282,300,269,569,"21 de agosto de 1994"
12,1,29,1283,219,161,380,"21 de agosto de 1994"
12,1,29,1284,92,69,161,"21 de agosto de 1994"
12,1,29,1285,170,146,316,"21 de agosto de 1994"
12,1,29,1286,295,361,656,"21 de agosto de 1994"
12,1,29,1287,312,342,654,"21 de agosto de 1994"
12,1,29,1288,412,501,913,"21 de agosto de 1994"
12,1,29,1289,459,446,905,"21 de agosto de 1994"
12,1,29,1290,40,32,72,"21 de agosto de 1994"
12,1,29,1291,88,62,150,"21 de agosto de 1994"
12,1,29,1292,165,141,306,"21 de agosto de 1994"
12,1,29,1293,128,118,246,"21 de agosto de 1994"
12,1,29,1294,194,207,401,"21 de agosto de 1994"
12,1,29,1295,298,271,569,"21 de agosto de 1994"
12,1,29,1296,216,196,412,"21 de agosto de 1994"
12,1,29,1297,176,146,322,"21 de agosto de 1994"
12,1,29,1298,50,44,94,"21 de agosto de 1994"
12,1,29,1299,109,120,229,"21 de agosto de 1994"
12,1,29,1300,258,308,566,"21 de agosto de 1994"
12,1,29,1301,341,308,649,"21 de agosto de 1994"
12,1,29,1302,538,560,1098,"21 de agosto de 1994"
12,1,29,1303,415,418,833,"21 de agosto de 1994"
12,1,29,1304,495,497,992,"21 de agosto de 1994"
12,1,29,1305,246,298,544,"21 de agosto de 1994"
12,1,29,1306,98,105,203,"21 de agosto de 1994"
12,1,29,1307,490,486,976,"21 de agosto de 1994"
12,1,29,1308,213,218,431,"21 de agosto de 1994"
12,1,40,1654,290,276,566,"21 de agosto de 1994"
12,1,40,1655,283,285,568,"21 de agosto de 1994"
12,1,40,1656,481,467,948,"21 de agosto de 1994"
12,1,40,1657,347,356,703,"21 de agosto de 1994"
12,1,40,1658,203,234,437,"21 de agosto de 1994"
12,1,40,1659,286,264,550,"21 de agosto de 1994"
12,1,40,1660,234,229,463,"21 de agosto de 1994"
12,1,40,1661,272,282,554,"21 de agosto de 1994"
12,1,40,1662,179,187,366,"21 de agosto de 1994"
12,1,40,1663,127,135,262,"21 de agosto de 1994"
12,1,40,1664,133,101,234,"21 de agosto de 1994"
12,1,40,1665,222,218,440,"21 de agosto de 1994"
12,1,40,1666,187,203,390,"21 de agosto de 1994"
12,1,40,1667,236,242,478,"21 de agosto de 1994"
12,1,40,1668,107,91,198,"21 de agosto de 1994"
12,1,40,1669,74,69,143,"21 de agosto de 1994"
12,1,40,1670,103,81,184,"21 de agosto de 1994"
12,1,40,1671,44,30,74,"21 de agosto de 1994"
12,1,40,1672,65,47,112,"21 de agosto de 1994"
12,1,40,1673,43,34,77,"21 de agosto de 1994"
12,1,40,1674,393,382,775,"21 de agosto de 1994"
12,1,40,1675,59,63,122,"21 de agosto de 1994"
12,1,40,1676,458,451,909,"21 de agosto de 1994"
12,1,45,1764,228,262,490,"21 de agosto de 1994"
12,1,45,1765,213,229,442,"21 de agosto de 1994"
12,1,45,1766,225,233,458,"21 de agosto de 1994"
12,1,45,1767,399,405,804,"21 de agosto de 1994"
12,1,45,1768,148,173,321,"21 de agosto de 1994"
12,1,45,1769,145,171,316,"21 de agosto de 1994"
12,1,45,1770,193,213,406,"21 de agosto de 1994"
12,1,45,1771,85,85,170,"21 de agosto de 1994"
12,1,45,1772,60,54,114,"21 de agosto de 1994"
12,1,45,1773,89,78,167,"21 de agosto de 1994"
12,1,45,1774,80,63,143,"21 de agosto de 1994"
12,1,45,1775,209,194,403,"21 de agosto de 1994"
12,1,45,1776,157,159,316,"21 de agosto de 1994"
12,1,45,1777,59,49,108,"21 de agosto de 1994"
12,1,45,1778,23,18,41,"21 de agosto de 1994"
12,1,45,1779,17,10,27,"21 de agosto de 1994"
12,1,45,1780,57,50,107,"21 de agosto de 1994"
12,1,45,1781,32,37,69,"21 de agosto de 1994"
12,1,45,1782,10,7,17,"21 de agosto de 1994"
12,1,45,1783,17,22,39,"21 de agosto de 1994"
12,1,52,1973,264,302,566,"21 de agosto de 1994"
12,1,52,1974,205,201,406,"21 de agosto de 1994"
12,1,52,1975,301,290,591,"21 de agosto de 1994"
12,1,52,1976,394,436,830,"21 de agosto de 1994"
12,1,52,1977,62,73,135,"21 de agosto de 1994"
12,1,52,1978,185,200,385,"21 de agosto de 1994"
12,1,52,1979,181,212,393,"21 de agosto de 1994"
12,1,52,1980,201,199,400,"21 de agosto de 1994"
12,1,52,1981,88,81,169,"21 de agosto de 1994"
12,1,52,1982,99,91,190,"21 de agosto de 1994"
12,1,52,1983,156,135,291,"21 de agosto de 1994"
12,1,52,1984,426,417,843,"21 de agosto de 1994"
12,1,52,1985,285,275,560,"21 de agosto de 1994"
12,1,52,1986,168,139,307,"21 de agosto de 1994"
12,1,52,1987,61,59,120,"21 de agosto de 1994"
12,1,52,1988,165,167,332,"21 de agosto de 1994"
12,1,52,1989,138,152,290,"21 de agosto de 1994"
12,1,52,1990,76,84,160,"21 de agosto de 1994"
12,1,52,1991,363,324,687,"21 de agosto de 1994"
12,1,52,1992,26,32,58,"21 de agosto de 1994"
12,1,52,1993,157,151,308,"21 de agosto de 1994"
12,1,52,1994,90,79,169,"21 de agosto de 1994"
12,1,52,1995,214,269,483,"21 de agosto de 1994"
12,1,52,1996,134,145,279,"21 de agosto de 1994"
12,1,52,1997,72,54,126,"21 de agosto de 1994"
12,1,52,1998,120,124,244,"21 de agosto de 1994"
12,1,52,1999,116,105,221,"21 de agosto de 1994"
12,1,52,2000,125,125,250,"21 de agosto de 1994"
12,1,52,2001,108,100,208,"21 de agosto de 1994"
12,1,52,2002,148,140,288,"21 de agosto de 1994"
12,1,52,2003,178,178,356,"21 de agosto de 1994"
12,1,52,2004,55,62,117,"21 de agosto de 1994"
12,1,52,2005,54,61,115,"21 de agosto de 1994"
12,1,52,2006,110,111,221,"21 de agosto de 1994"
12,1,52,2007,128,128,256,"21 de agosto de 1994"
12,1,52,2008,131,115,246,"21 de agosto de 1994"
12,1,52,2009,75,57,132,"21 de agosto de 1994"
12,1,52,2010,82,77,159,"21 de agosto de 1994"
12,1,52,2011,72,58,130,"21 de agosto de 1994"
12,1,52,2012,131,126,257,"21 de agosto de 1994"
12,1,52,2013,107,95,202,"21 de agosto de 1994"
12,1,52,2014,206,184,390,"21 de agosto de 1994"
12,1,62,2479,236,254,490,"21 de agosto de 1994"
12,1,62,2480,379,433,812,"21 de agosto de 1994"
12,1,62,2481,408,462,870,"21 de agosto de 1994"
12,1,62,2482,219,282,501,"21 de agosto de 1994"
12,1,62,2483,302,387,689,"21 de agosto de 1994"
12,1,62,2484,340,387,727,"21 de agosto de 1994"
12,1,62,2485,384,411,795,"21 de agosto de 1994"
12,1,62,2486,347,413,760,"21 de agosto de 1994"
12,1,62,2487,242,298,540,"21 de agosto de 1994"
12,1,62,2488,212,237,449,"21 de agosto de 1994"
12,1,62,2489,301,372,673,"21 de agosto de 1994"
12,1,62,2490,310,295,605,"21 de agosto de 1994"
12,1,62,2491,223,209,432,"21 de agosto de 1994"
12,1,62,2492,310,305,615,"21 de agosto de 1994"
12,1,62,2493,246,206,452,"21 de agosto de 1994"
12,1,62,2494,283,271,554,"21 de agosto de 1994"
12,1,62,2495,136,115,251,"21 de agosto de 1994"
12,1,62,2496,142,124,266,"21 de agosto de 1994"
12,1,62,2497,311,380,691,"21 de agosto de 1994"
12,1,62,2498,16,7,23,"21 de agosto de 1994"
12,1,62,2499,117,119,236,"21 de agosto de 1994"
12,1,62,2500,40,41,81,"21 de agosto de 1994"
12,1,62,2501,56,60,116,"21 de agosto de 1994"
12,1,62,2502,83,80,163,"21 de agosto de 1994"
12,1,62,2503,52,50,102,"21 de agosto de 1994"
12,1,62,2504,222,292,514,"21 de agosto de 1994"
12,1,62,2505,174,259,433,"21 de agosto de 1994"
12,1,62,2506,96,99,195,"21 de agosto de 1994"
12,1,62,2507,84,96,180,"21 de agosto de 1994"
12,1,62,2508,134,135,269,"21 de agosto de 1994"
12,2,15,778,359,409,768,"21 de agosto de 1994"
12,2,15,779,389,465,854,"21 de agosto de 1994"
12,2,15,780,452,489,941,"21 de agosto de 1994"
12,2,15,781,470,522,992,"21 de agosto de 1994"
12,2,15,782,292,343,635,"21 de agosto de 1994"
12,2,15,783,204,228,432,"21 de agosto de 1994"
12,2,15,784,287,332,619,"21 de agosto de 1994"
12,2,15,785,220,222,442,"21 de agosto de 1994"
12,2,15,786,72,74,146,"21 de agosto de 1994"
12,2,15,787,59,60,119,"21 de agosto de 1994"
12,2,15,788,57,42,99,"21 de agosto de 1994"
12,2,17,820,255,326,581,"21 de agosto de 1994"
12,2,17,821,247,306,553,"21 de agosto de 1994"
12,2,17,822,382,415,797,"21 de agosto de 1994"
12,2,17,823,153,186,339,"21 de agosto de 1994"
12,2,17,824,59,99,158,"21 de agosto de 1994"
12,2,17,825,172,177,349,"21 de agosto de 1994"
12,2,17,826,98,108,206,"21 de agosto de 1994"
12,2,17,827,122,138,260,"21 de agosto de 1994"
12,2,17,828,29,31,60,"21 de agosto de 1994"
12,2,17,829,99,115,214,"21 de agosto de 1994"
12,2,17,830,273,309,582,"21 de agosto de 1994"
12,2,17,831,258,314,572,"21 de agosto de 1994"
12,2,17,832,217,250,467,"21 de agosto de 1994"
12,2,17,833,222,230,452,"21 de agosto de 1994"
12,2,17,834,78,99,177,"21 de agosto de 1994"
12,2,17,835,167,171,338,"21 de agosto de 1994"
12,2,17,836,39,51,90,"21 de agosto de 1994"
12,2,17,837,47,65,112,"21 de agosto de 1994"
12,2,17,838,51,72,123,"21 de agosto de 1994"
12,2,17,839,210,233,443,"21 de agosto de 1994"
12,2,17,840,184,232,416,"21 de agosto de 1994"
12,2,17,841,46,51,97,"21 de agosto de 1994"
12,2,17,842,29,30,59,"21 de agosto de 1994"
12,2,17,843,148,149,297,"21 de agosto de 1994"
12,2,26,1050,124,125,249,"21 de agosto de 1994"
12,2,26,1051,80,114,194,"21 de agosto de 1994"
12,2,26,1052,129,155,284,"21 de agosto de 1994"
12,2,26,1053,176,226,402,"21 de agosto de 1994"
12,2,26,1054,160,177,337,"21 de agosto de 1994"
12,2,26,1055,217,241,458,"21 de agosto de 1994"
12,2,26,1056,124,153,277,"21 de agosto de 1994"
12,2,26,1057,168,190,358,"21 de agosto de 1994"
12,2,26,1058,207,239,446,"21 de agosto de 1994"
12,2,26,1059,253,277,530,"21 de agosto de 1994"
12,2,26,1060,46,63,109,"21 de agosto de 1994"
12,2,26,1061,49,53,102,"21 de agosto de 1994"
12,2,26,1062,138,154,292,"21 de agosto de 1994"
12,2,26,1063,87,95,182,"21 de agosto de 1994"
12,2,26,1064,43,42,85,"21 de agosto de 1994"
12,2,26,1065,47,51,98,"21 de agosto de 1994"
12,2,26,1066,29,27,56,"21 de agosto de 1994"
12,2,36,1480,298,334,632,"21 de agosto de 1994"
12,2,36,1481,173,186,359,"21 de agosto de 1994"
12,2,36,1482,242,309,551,"21 de agosto de 1994"
12,2,36,1483,223,261,484,"21 de agosto de 1994"
12,2,36,1484,263,325,588,"21 de agosto de 1994"
12,2,36,1485,236,284,520,"21 de agosto de 1994"
12,2,36,1486,293,367,660,"21 de agosto de 1994"
12,2,36,1487,512,643,1155,"21 de agosto de 1994"
12,2,36,1488,260,288,548,"21 de agosto de 1994"
12,2,36,1489,277,314,591,"21 de agosto de 1994"
12,2,36,1490,381,487,868,"21 de agosto de 1994"
12,2,36,1491,270,296,566,"21 de agosto de 1994"
12,2,36,1492,553,656,1209,"21 de agosto de 1994"
12,2,36,1493,307,389,696,"21 de agosto de 1994"
12,2,36,1494,223,289,512,"21 de agosto de 1994"
12,2,36,1495,347,411,758,"21 de agosto de 1994"
12,2,36,1496,126,164,290,"21 de agosto de 1994"
12,2,36,1497,336,379,715,"21 de agosto de 1994"
12,2,36,1498,365,429,794,"21 de agosto de 1994"
12,2,36,1499,218,265,483,"21 de agosto de 1994"
12,2,36,1500,396,487,883,"21 de agosto de 1994"
12,2,36,1501,551,354,905,"21 de agosto de 1994"
12,2,36,1502,388,453,841,"21 de agosto de 1994"
12,2,36,1503,362,411,773,"21 de agosto de 1994"
12,2,36,1504,341,399,740,"21 de agosto de 1994"
12,2,36,1505,369,392,761,"21 de agosto de 1994"
12,2,36,1506,218,281,499,"21 de agosto de 1994"
12,2,36,1507,300,371,671,"21 de agosto de 1994"
12,2,36,1508,263,322,585,"21 de agosto de 1994"
12,2,36,1509,230,255,485,"21 de agosto de 1994"
12,2,36,1510,324,439,763,"21 de agosto de 1994"
12,2,36,1511,461,529,990,"21 de agosto de 1994"
12,2,36,1512,468,566,1034,"21 de agosto de 1994"
12,2,36,1513,462,597,1059,"21 de agosto de 1994"
12,2,36,1514,300,326,626,"21 de agosto de 1994"
12,2,36,1515,393,427,820,"21 de agosto de 1994"
12,2,36,1516,200,229,429,"21 de agosto de 1994"
12,2,36,1517,98,110,208,"21 de agosto de 1994"
12,2,36,1518,160,196,356,"21 de agosto de 1994"
12,2,36,1519,157,169,326,"21 de agosto de 1994"
12,2,36,1520,182,224,406,"21 de agosto de 1994"
12,2,36,1521,343,392,735,"21 de agosto de 1994"
12,2,36,1522,350,405,755,"21 de agosto de 1994"
12,2,36,1523,257,316,573,"21 de agosto de 1994"
12,2,36,1524,390,420,810,"21 de agosto de 1994"
12,2,36,1525,211,278,489,"21 de agosto de 1994"
12,2,36,1526,314,380,694,"21 de agosto de 1994"
12,2,36,1527,417,531,948,"21 de agosto de 1994"
12,2,36,1528,375,416,791,"21 de agosto de 1994"
12,2,36,1529,243,303,546,"21 de agosto de 1994"
12,2,36,1530,264,296,560,"21 de agosto de 1994"
12,2,36,1531,356,398,754,"21 de agosto de 1994"
12,2,36,1532,359,418,777,"21 de agosto de 1994"
12,2,36,1533,358,447,805,"21 de agosto de 1994"
12,2,36,1534,364,429,793,"21 de agosto de 1994"
12,2,36,1535,280,342,622,"21 de agosto de 1994"
12,2,36,1536,318,377,695,"21 de agosto de 1994"
12,2,36,1537,326,409,735,"21 de agosto de 1994"
12,2,36,1538,283,336,619,"21 de agosto de 1994"
12,2,36,1539,302,360,662,"21 de agosto de 1994"
12,2,36,1540,186,238,424,"21 de agosto de 1994"
12,2,36,1541,240,287,527,"21 de agosto de 1994"
12,2,36,1542,313,369,682,"21 de agosto de 1994"
12,2,36,1543,510,632,1142,"21 de agosto de 1994"
12,2,36,1544,237,261,498,"21 de agosto de 1994"
12,2,36,1545,95,131,226,"21 de agosto de 1994"
12,2,36,1546,89,98,187,"21 de agosto de 1994"
12,2,36,1547,443,485,928,"21 de agosto de 1994"
12,2,36,1548,56,55,111,"21 de agosto de 1994"
12,2,36,1549,108,145,253,"21 de agosto de 1994"
12,2,36,1550,301,332,633,"21 de agosto de 1994"
12,2,36,1551,101,129,230,"21 de agosto de 1994"
12,2,36,1552,131,136,267,"21 de agosto de 1994"
12,2,36,1553,89,109,198,"21 de agosto de 1994"
12,2,36,1554,79,93,172,"21 de agosto de 1994"
12,2,36,1555,91,99,190,"21 de agosto de 1994"
12,2,36,1556,95,90,185,"21 de agosto de 1994"
12,2,36,1557,320,359,679,"21 de agosto de 1994"
12,2,36,1558,227,279,506,"21 de agosto de 1994"
12,2,36,1559,230,281,511,"21 de agosto de 1994"
12,2,36,1560,212,256,468,"21 de agosto de 1994"
12,2,36,1561,41,47,88,"21 de agosto de 1994"
12,2,36,1562,322,374,696,"21 de agosto de 1994"
12,2,36,1563,219,256,475,"21 de agosto de 1994"
12,2,36,1564,183,201,384,"21 de agosto de 1994"
12,2,59,2331,261,312,573,"21 de agosto de 1994"
12,2,59,2332,296,357,653,"21 de agosto de 1994"
12,2,59,2333,270,338,608,"21 de agosto de 1994"
12,2,59,2334,271,329,600,"21 de agosto de 1994"
12,2,59,2335,318,410,728,"21 de agosto de 1994"
12,2,59,2336,238,294,532,"21 de agosto de 1994"
12,2,59,2337,300,347,647,"21 de agosto de 1994"
12,2,59,2338,425,539,964,"21 de agosto de 1994"
12,2,59,2339,293,368,661,"21 de agosto de 1994"
12,2,59,2340,91,119,210,"21 de agosto de 1994"
12,2,59,2341,249,306,555,"21 de agosto de 1994"
12,2,59,2342,229,269,498,"21 de agosto de 1994"
12,2,59,2343,189,239,428,"21 de agosto de 1994"
12,2,59,2344,222,272,494,"21 de agosto de 1994"
12,2,59,2345,173,231,404,"21 de agosto de 1994"
12,2,59,2346,49,63,112,"21 de agosto de 1994"
12,2,59,2347,90,149,239,"21 de agosto de 1994"
12,2,59,2348,65,67,132,"21 de agosto de 1994"
12,2,59,2349,26,42,68,"21 de agosto de 1994"
12,2,59,2350,40,52,92,"21 de agosto de 1994"
12,2,59,2351,22,31,53,"21 de agosto de 1994"
12,2,59,2352,92,118,210,"21 de agosto de 1994"
12,2,59,2353,46,72,118,"21 de agosto de 1994"
12,2,59,2354,53,51,104,"21 de agosto de 1994"
12,2,59,2355,45,42,87,"21 de agosto de 1994"
12,2,59,2356,50,74,124,"21 de agosto de 1994"
12,2,59,2357,16,20,36,"21 de agosto de 1994"
12,2,59,2358,64,83,147,"21 de agosto de 1994"
12,2,59,2359,46,59,105,"21 de agosto de 1994"
12,2,59,2360,32,36,68,"21 de agosto de 1994"
12,2,59,2361,77,107,184,"21 de agosto de 1994"
12,2,59,2362,85,100,185,"21 de agosto de 1994"
12,2,59,2363,57,83,140,"21 de agosto de 1994"
12,2,59,2364,39,61,100,"21 de agosto de 1994"
12,2,59,2365,38,50,88,"21 de agosto de 1994"
12,2,59,2366,48,65,113,"21 de agosto de 1994"
12,2,59,2367,34,42,76,"21 de agosto de 1994"
12,2,59,2368,125,183,308,"21 de agosto de 1994"
12,2,59,2369,86,125,211,"21 de agosto de 1994"
12,2,59,2370,55,58,113,"21 de agosto de 1994"
12,2,59,2371,31,54,85,"21 de agosto de 1994"
12,2,59,2372,58,71,129,"21 de agosto de 1994"
12,2,59,2373,106,133,239,"21 de agosto de 1994"
12,2,59,2374,64,82,146,"21 de agosto de 1994"
12,2,59,2375,94,114,208,"21 de agosto de 1994"
12,2,59,2376,36,49,85,"21 de agosto de 1994"
12,2,59,2377,47,63,110,"21 de agosto de 1994"
12,2,59,2378,38,37,75,"21 de agosto de 1994"
12,2,59,2379,198,256,454,"21 de agosto de 1994"
12,2,59,2380,85,119,204,"21 de agosto de 1994"
12,2,59,2381,35,36,71,"21 de agosto de 1994"
12,2,59,2382,102,135,237,"21 de agosto de 1994"
12,2,59,2383,72,83,155,"21 de agosto de 1994"
12,2,59,2384,39,61,100,"21 de agosto de 1994"
12,2,59,2385,274,353,627,"21 de agosto de 1994"
12,2,59,2386,100,136,236,"21 de agosto de 1994"
12,2,59,2387,143,176,319,"21 de agosto de 1994"
12,2,59,2388,189,247,436,"21 de agosto de 1994"
12,2,59,2389,129,169,298,"21 de agosto de 1994"
12,2,59,2390,96,116,212,"21 de agosto de 1994"
12,2,59,2391,68,76,144,"21 de agosto de 1994"
12,2,59,2392,56,56,112,"21 de agosto de 1994"
12,2,59,2393,168,229,397,"21 de agosto de 1994"
12,2,59,2394,246,289,535,"21 de agosto de 1994"
12,2,59,2395,25,18,43,"21 de agosto de 1994"
12,2,59,2396,43,47,90,"21 de agosto de 1994"
12,2,59,2397,271,312,583,"21 de agosto de 1994"
12,2,59,2398,323,374,697,"21 de agosto de 1994"
12,2,59,2399,55,69,124,"21 de agosto de 1994"
12,2,59,2400,56,72,128,"21 de agosto de 1994"
12,2,59,2401,69,97,166,"21 de agosto de 1994"
12,2,59,2402,102,105,207,"21 de agosto de 1994"
12,2,59,2403,76,107,183,"21 de agosto de 1994"
12,2,59,2404,161,208,369,"21 de agosto de 1994"
12,2,59,2405,81,125,206,"21 de agosto de 1994"
12,2,59,2406,264,274,538,"21 de agosto de 1994"
12,2,59,2407,94,108,202,"21 de agosto de 1994"
12,2,59,2408,91,97,188,"21 de agosto de 1994"
12,2,59,2409,350,396,746,"21 de agosto de 1994"
12,2,59,2410,35,38,73,"21 de agosto de 1994"
12,2,59,2411,75,72,147,"21 de agosto de 1994"
12,2,59,2412,46,45,91,"21 de agosto de 1994"
12,2,59,2413,76,70,146,"21 de agosto de 1994"
12,2,59,2414,133,152,285,"21 de agosto de 1994"
12,2,59,2415,84,129,213,"21 de agosto de 1994"
12,2,59,2416,46,53,99,"21 de agosto de 1994"
12,2,59,2417,127,116,243,"21 de agosto de 1994"
12,2,59,2418,292,329,621,"21 de agosto de 1994"
12,2,59,2419,338,390,728,"21 de agosto de 1994"
12,2,60,2420,223,253,476,"21 de agosto de 1994"
12,2,60,2421,387,456,843,"21 de agosto de 1994"
12,2,60,2422,117,117,234,"21 de agosto de 1994"
12,2,60,2423,377,430,807,"21 de agosto de 1994"
12,2,60,2424,243,257,500,"21 de agosto de 1994"
12,2,60,2425,259,370,629,"21 de agosto de 1994"
12,2,60,2426,119,132,251,"21 de agosto de 1994"
12,2,60,2427,261,278,539,"21 de agosto de 1994"
12,2,60,2428,88,100,188,"21 de agosto de 1994"
12,2,60,2429,167,151,318,"21 de agosto de 1994"
12,2,60,2430,176,214,390,"21 de agosto de 1994"
12,2,60,2431,164,162,326,"21 de agosto de 1994"
12,2,60,2432,64,66,130,"21 de agosto de 1994"
12,2,60,2433,299,366,665,"21 de agosto de 1994"
12,2,60,2434,310,379,689,"21 de agosto de 1994"
12,2,60,2435,41,35,76,"21 de agosto de 1994"
12,2,60,2436,78,112,190,"21 de agosto de 1994"
12,2,60,2437,165,212,377,"21 de agosto de 1994"
12,2,60,2438,227,275,502,"21 de agosto de 1994"
12,2,60,2439,245,281,526,"21 de agosto de 1994"
12,2,60,2440,103,109,212,"21 de agosto de 1994"
12,2,60,2441,71,76,147,"21 de agosto de 1994"
12,2,60,2442,246,294,540,"21 de agosto de 1994"
12,2,60,2443,110,144,254,"21 de agosto de 1994"
12,2,60,2444,346,452,798,"21 de agosto de 1994"
12,2,60,2445,282,380,662,"21 de agosto de 1994"
12,2,60,2446,312,378,690,"21 de agosto de 1994"
12,2,60,2447,423,544,967,"21 de agosto de 1994"
12,2,60,2448,428,502,930,"21 de agosto de 1994"
12,2,60,2449,64,82,146,"21 de agosto de 1994"
12,2,60,2450,180,217,397,"21 de agosto de 1994"
12,3,3,411,277,291,568,"21 de agosto de 1994"
12,3,3,412,115,138,253,"21 de agosto de 1994"
12,3,3,413,196,187,383,"21 de agosto de 1994"
12,3,3,414,498,512,1010,"21 de agosto de 1994"
12,3,3,415,456,585,1041,"21 de agosto de 1994"
12,3,3,416,135,197,332,"21 de agosto de 1994"
12,3,3,417,175,317,492,"21 de agosto de 1994"
12,3,3,418,210,379,589,"21 de agosto de 1994"
12,3,3,419,135,216,351,"21 de agosto de 1994"
12,3,3,420,153,186,339,"21 de agosto de 1994"
12,3,3,421,265,337,602,"21 de agosto de 1994"
12,3,3,422,201,266,467,"21 de agosto de 1994"
12,3,3,423,203,285,488,"21 de agosto de 1994"
12,3,3,424,142,151,293,"21 de agosto de 1994"
12,3,3,425,137,158,295,"21 de agosto de 1994"
12,3,3,426,116,136,252,"21 de agosto de 1994"
12,3,3,427,192,213,405,"21 de agosto de 1994"
12,3,3,428,179,246,425,"21 de agosto de 1994"
12,3,3,429,38,52,90,"21 de agosto de 1994"
12,3,3,430,59,73,132,"21 de agosto de 1994"
12,3,3,431,65,62,127,"21 de agosto de 1994"
12,3,3,432,157,175,332,"21 de agosto de 1994"
12,3,3,433,106,103,209,"21 de agosto de 1994"
12,3,3,434,303,307,610,"21 de agosto de 1994"
12,3,3,435,170,198,368,"21 de agosto de 1994"
12,3,3,436,111,141,252,"21 de agosto de 1994"
12,3,3,437,74,75,149,"21 de agosto de 1994"
12,3,3,438,178,203,381,"21 de agosto de 1994"
12,3,3,439,40,46,86,"21 de agosto de 1994"
12,3,3,440,87,68,155,"21 de agosto de 1994"
12,3,3,441,51,60,111,"21 de agosto de 1994"
12,3,3,442,120,130,250,"21 de agosto de 1994"
12,3,3,443,251,296,547,"21 de agosto de 1994"
12,3,3,444,62,63,125,"21 de agosto de 1994"
12,3,3,445,166,111,277,"21 de agosto de 1994"
12,3,3,446,133,121,254,"21 de agosto de 1994"
12,3,3,447,124,119,243,"21 de agosto de 1994"
12,3,3,448,28,27,55,"21 de agosto de 1994"
12,3,3,449,76,43,119,"21 de agosto de 1994"
12,3,3,450,47,50,97,"21 de agosto de 1994"
12,3,3,451,19,14,33,"21 de agosto de 1994"
12,3,3,452,35,23,58,"21 de agosto de 1994"
12,3,3,453,48,35,83,"21 de agosto de 1994"
12,3,3,454,44,45,89,"21 de agosto de 1994"
12,3,3,455,105,94,199,"21 de agosto de 1994"
12,3,6,479,140,141,281,"21 de agosto de 1994"
12,3,6,480,246,261,507,"21 de agosto de 1994"
12,3,6,481,252,273,525,"21 de agosto de 1994"
12,3,6,482,156,159,315,"21 de agosto de 1994"
12,3,6,483,330,383,713,"21 de agosto de 1994"
12,3,6,484,196,238,434,"21 de agosto de 1994"
12,3,6,485,22,41,63,"21 de agosto de 1994"
12,3,6,486,92,91,183,"21 de agosto de 1994"
12,3,6,487,28,31,59,"21 de agosto de 1994"
12,3,6,488,93,114,207,"21 de agosto de 1994"
12,3,6,489,78,79,157,"21 de agosto de 1994"
12,3,6,490,93,119,212,"21 de agosto de 1994"
12,3,6,491,40,33,73,"21 de agosto de 1994"
12,3,6,492,212,223,435,"21 de agosto de 1994"
12,3,6,493,86,100,186,"21 de agosto de 1994"
12,3,6,494,99,129,228,"21 de agosto de 1994"
12,3,6,495,31,31,62,"21 de agosto de 1994"
12,3,6,496,102,115,217,"21 de agosto de 1994"
12,3,6,497,24,23,47,"21 de agosto de 1994"
12,3,6,498,54,46,100,"21 de agosto de 1994"
12,3,6,499,43,44,87,"21 de agosto de 1994"
12,3,16,789,115,115,230,"21 de agosto de 1994"
12,3,16,790,157,156,313,"21 de agosto de 1994"
12,3,16,791,91,84,175,"21 de agosto de 1994"
12,3,16,792,205,171,376,"21 de agosto de 1994"
12,3,16,793,159,112,271,"21 de agosto de 1994"
12,3,16,794,170,152,322,"21 de agosto de 1994"
12,3,16,795,117,114,231,"21 de agosto de 1994"
12,3,16,796,92,65,157,"21 de agosto de 1994"
12,3,16,797,113,98,211,"21 de agosto de 1994"
12,3,16,798,51,52,103,"21 de agosto de 1994"
12,3,16,799,70,76,146,"21 de agosto de 1994"
12,3,16,800,176,151,327,"21 de agosto de 1994"
12,3,16,801,105,91,196,"21 de agosto de 1994"
12,3,16,802,65,49,114,"21 de agosto de 1994"
12,3,16,803,45,33,78,"21 de agosto de 1994"
12,3,16,804,94,78,172,"21 de agosto de 1994"
12,3,16,805,97,104,201,"21 de agosto de 1994"
12,3,16,806,73,51,124,"21 de agosto de 1994"
12,3,16,807,71,71,142,"21 de agosto de 1994"
12,3,16,808,132,108,240,"21 de agosto de 1994"
12,3,16,809,46,33,79,"21 de agosto de 1994"
12,3,16,810,72,57,129,"21 de agosto de 1994"
12,3,16,811,68,55,123,"21 de agosto de 1994"
12,3,16,812,65,67,132,"21 de agosto de 1994"
12,3,16,813,70,53,123,"21 de agosto de 1994"
12,3,16,814,111,104,215,"21 de agosto de 1994"
12,3,16,815,105,99,204,"21 de agosto de 1994"
12,3,16,816,33,20,53,"21 de agosto de 1994"
12,3,16,817,69,66,135,"21 de agosto de 1994"
12,3,16,818,46,39,85,"21 de agosto de 1994"
12,3,16,819,371,282,653,"21 de agosto de 1994"
12,3,22,943,318,332,650,"21 de agosto de 1994"
12,3,22,944,131,139,270,"21 de agosto de 1994"
12,3,22,945,425,502,927,"21 de agosto de 1994"
12,3,22,946,419,454,873,"21 de agosto de 1994"
12,3,22,947,32,63,95,"21 de agosto de 1994"
12,3,22,948,24,44,68,"21 de agosto de 1994"
12,3,22,949,84,76,160,"21 de agosto de 1994"
12,3,22,950,76,90,166,"21 de agosto de 1994"
12,3,22,951,226,262,488,"21 de agosto de 1994"
12,3,22,952,71,82,153,"21 de agosto de 1994"
12,3,22,953,190,228,418,"21 de agosto de 1994"
12,3,22,954,226,231,457,"21 de agosto de 1994"
12,3,22,955,140,183,323,"21 de agosto de 1994"
12,3,22,956,130,128,258,"21 de agosto de 1994"
12,3,22,957,413,423,836,"21 de agosto de 1994"
12,3,22,958,107,98,205,"21 de agosto de 1994"
12,3,22,959,133,136,269,"21 de agosto de 1994"
12,3,22,960,170,164,334,"21 de agosto de 1994"
12,3,22,961,147,165,312,"21 de agosto de 1994"
12,3,22,962,113,111,224,"21 de agosto de 1994"
12,3,22,963,213,201,414,"21 de agosto de 1994"
12,3,22,964,200,186,386,"21 de agosto de 1994"
12,3,22,965,195,222,417,"21 de agosto de 1994"
12,3,22,966,91,96,187,"21 de agosto de 1994"
12,3,22,967,233,238,471,"21 de agosto de 1994"
12,3,22,968,149,145,294,"21 de agosto de 1994"
12,3,22,969,114,122,236,"21 de agosto de 1994"
12,3,22,970,306,358,664,"21 de agosto de 1994"
12,3,22,971,292,328,620,"21 de agosto de 1994"
12,3,22,972,60,61,121,"21 de agosto de 1994"
12,3,22,973,141,153,294,"21 de agosto de 1994"
12,3,22,974,93,113,206,"21 de agosto de 1994"
12,3,22,975,184,237,421,"21 de agosto de 1994"
12,3,22,976,185,189,374,"21 de agosto de 1994"
12,3,22,977,139,129,268,"21 de agosto de 1994"
12,3,22,978,47,53,100,"21 de agosto de 1994"
12,3,22,979,208,231,439,"21 de agosto de 1994"
12,3,22,980,97,101,198,"21 de agosto de 1994"
12,3,22,981,162,169,331,"21 de agosto de 1994"
12,3,22,982,121,135,256,"21 de agosto de 1994"
12,3,22,983,351,384,735,"21 de agosto de 1994"
12,3,22,984,29,30,59,"21 de agosto de 1994"
12,3,22,985,51,54,105,"21 de agosto de 1994"
12,3,22,986,51,48,99,"21 de agosto de 1994"
12,3,22,987,64,69,133,"21 de agosto de 1994"
12,3,22,988,281,322,603,"21 de agosto de 1994"
12,3,22,989,139,182,321,"21 de agosto de 1994"
12,3,22,990,122,117,239,"21 de agosto de 1994"
12,3,22,991,214,202,416,"21 de agosto de 1994"
12,3,22,992,52,38,90,"21 de agosto de 1994"
12,3,22,993,99,73,172,"21 de agosto de 1994"
12,3,22,994,252,176,428,"21 de agosto de 1994"
12,3,22,995,57,45,102,"21 de agosto de 1994"
12,3,22,996,221,180,401,"21 de agosto de 1994"
12,3,22,997,27,26,53,"21 de agosto de 1994"
12,3,22,998,107,61,168,"21 de agosto de 1994"
12,3,22,999,33,27,60,"21 de agosto de 1994"
12,3,22,1000,114,89,203,"21 de agosto de 1994"
12,3,30,1309,140,151,291,"21 de agosto de 1994"
12,3,30,1310,217,200,417,"21 de agosto de 1994"
12,3,30,1311,288,295,583,"21 de agosto de 1994"
12,3,30,1312,342,350,692,"21 de agosto de 1994"
12,3,30,1313,318,304,622,"21 de agosto de 1994"
12,3,30,1314,311,354,665,"21 de agosto de 1994"
12,3,30,1315,542,515,1057,"21 de agosto de 1994"
12,3,30,1316,407,415,822,"21 de agosto de 1994"
12,3,30,1317,245,271,516,"21 de agosto de 1994"
12,3,30,1318,362,349,711,"21 de agosto de 1994"
12,3,30,1319,155,160,315,"21 de agosto de 1994"
12,3,30,1320,87,191,278,"21 de agosto de 1994"
12,3,30,1321,9,8,17,"21 de agosto de 1994"
12,3,30,1322,135,49,184,"21 de agosto de 1994"
12,3,30,1323,234,227,461,"21 de agosto de 1994"
12,3,30,1324,184,206,390,"21 de agosto de 1994"
12,3,30,1325,26,15,41,"21 de agosto de 1994"
12,3,30,1326,189,181,370,"21 de agosto de 1994"
12,3,30,1327,25,24,49,"21 de agosto de 1994"
12,3,30,1328,116,135,251,"21 de agosto de 1994"
12,3,30,1329,384,488,872,"21 de agosto de 1994"
12,3,30,1330,242,323,565,"21 de agosto de 1994"
12,3,30,1331,188,213,401,"21 de agosto de 1994"
12,3,30,1332,178,183,361,"21 de agosto de 1994"
12,3,30,1333,54,35,89,"21 de agosto de 1994"
12,3,30,1334,359,398,757,"21 de agosto de 1994"
12,3,30,1335,304,360,664,"21 de agosto de 1994"
12,3,30,1336,125,113,238,"21 de agosto de 1994"
12,3,30,1337,92,92,184,"21 de agosto de 1994"
12,3,30,1338,42,36,78,"21 de agosto de 1994"
12,3,33,1382,280,336,616,"21 de agosto de 1994"
12,3,33,1383,317,332,649,"21 de agosto de 1994"
12,3,33,1384,428,428,856,"21 de agosto de 1994"
12,3,33,1385,30,28,58,"21 de agosto de 1994"
12,3,33,1386,147,156,303,"21 de agosto de 1994"
12,3,33,1387,31,30,61,"21 de agosto de 1994"
12,3,33,1388,137,153,290,"21 de agosto de 1994"
12,3,33,1389,36,39,75,"21 de agosto de 1994"
12,3,33,1390,41,29,70,"21 de agosto de 1994"
12,3,33,1391,39,34,73,"21 de agosto de 1994"
12,3,33,1392,22,28,50,"21 de agosto de 1994"
12,3,33,1393,107,101,208,"21 de agosto de 1994"
12,3,33,1394,66,47,113,"21 de agosto de 1994"
12,3,33,1395,36,30,66,"21 de agosto de 1994"
12,3,33,1396,38,26,64,"21 de agosto de 1994"
12,3,33,1397,75,47,122,"21 de agosto de 1994"
12,3,33,1398,112,99,211,"21 de agosto de 1994"
12,3,33,1399,50,36,86,"21 de agosto de 1994"
12,3,33,1400,17,8,25,"21 de agosto de 1994"
12,3,33,1401,36,30,66,"21 de agosto de 1994"
12,3,33,1402,199,182,381,"21 de agosto de 1994"
12,3,33,1403,60,50,110,"21 de agosto de 1994"
12,3,33,1404,115,97,212,"21 de agosto de 1994"
12,3,33,1405,110,76,186,"21 de agosto de 1994"
12,3,33,1406,119,111,230,"21 de agosto de 1994"
12,3,33,1407,52,36,88,"21 de agosto de 1994"
12,3,33,1408,67,66,133,"21 de agosto de 1994"
12,3,33,1409,51,49,100,"21 de agosto de 1994"
12,3,33,1410,121,105,226,"21 de agosto de 1994"
12,3,33,1411,119,105,224,"21 de agosto de 1994"
12,3,33,1412,37,33,70,"21 de agosto de 1994"
12,3,33,1413,78,78,156,"21 de agosto de 1994"
12,3,33,1414,122,88,210,"21 de agosto de 1994"
12,3,33,1415,32,32,64,"21 de agosto de 1994"
12,3,33,1416,47,39,86,"21 de agosto de 1994"
12,3,33,1417,173,141,314,"21 de agosto de 1994"
12,3,33,1418,156,109,265,"21 de agosto de 1994"
12,3,33,1419,119,95,214,"21 de agosto de 1994"
12,3,33,1420,99,82,181,"21 de agosto de 1994"
12,3,33,1421,112,81,193,"21 de agosto de 1994"
12,3,33,1422,79,69,148,"21 de agosto de 1994"
12,3,33,1423,57,39,96,"21 de agosto de 1994"
12,3,33,1424,50,25,75,"21 de agosto de 1994"
12,3,33,1425,49,45,94,"21 de agosto de 1994"
12,3,33,1426,104,89,193,"21 de agosto de 1994"
12,3,33,1427,27,30,57,"21 de agosto de 1994"
12,3,33,1428,256,192,448,"21 de agosto de 1994"
12,3,33,1429,94,63,157,"21 de agosto de 1994"
12,3,33,1430,72,72,144,"21 de agosto de 1994"
12,3,33,1431,249,165,414,"21 de agosto de 1994"
12,3,41,1677,361,401,762,"21 de agosto de 1994"
12,3,41,1678,343,422,765,"21 de agosto de 1994"
12,3,41,1679,182,186,368,"21 de agosto de 1994"
12,3,41,1680,486,477,963,"21 de agosto de 1994"
12,3,41,1681,260,358,618,"21 de agosto de 1994"
12,3,41,1682,201,225,426,"21 de agosto de 1994"
12,3,41,1683,72,60,132,"21 de agosto de 1994"
12,3,41,1684,158,136,294,"21 de agosto de 1994"
12,3,41,1685,81,64,145,"21 de agosto de 1994"
12,3,41,1686,166,133,299,"21 de agosto de 1994"
12,3,41,1687,79,83,162,"21 de agosto de 1994"
12,3,41,1688,137,134,271,"21 de agosto de 1994"
12,3,41,1689,228,203,431,"21 de agosto de 1994"
12,3,41,1690,65,56,121,"21 de agosto de 1994"
12,3,41,1691,154,109,263,"21 de agosto de 1994"
12,3,41,1692,88,73,161,"21 de agosto de 1994"
12,3,41,1693,89,83,172,"21 de agosto de 1994"
12,3,41,1694,267,202,469,"21 de agosto de 1994"
12,3,41,1695,274,198,472,"21 de agosto de 1994"
12,3,41,1696,78,69,147,"21 de agosto de 1994"
12,3,41,1697,57,14,71,"21 de agosto de 1994"
12,3,41,1698,95,79,174,"21 de agosto de 1994"
12,3,51,1950,158,204,362,"21 de agosto de 1994"
12,3,51,1951,447,529,976,"21 de agosto de 1994"
12,3,51,1952,316,377,693,"21 de agosto de 1994"
12,3,51,1953,346,389,735,"21 de agosto de 1994"
12,3,51,1954,521,581,1102,"21 de agosto de 1994"
12,3,51,1955,228,254,482,"21 de agosto de 1994"
12,3,51,1956,228,225,453,"21 de agosto de 1994"
12,3,51,1957,406,439,845,"21 de agosto de 1994"
12,3,51,1958,363,405,768,"21 de agosto de 1994"
12,3,51,1959,335,363,698,"21 de agosto de 1994"
12,3,51,1960,463,525,988,"21 de agosto de 1994"
12,3,51,1961,183,195,378,"21 de agosto de 1994"
12,3,51,1962,428,47,475,"21 de agosto de 1994"
12,3,51,1963,79,94,173,"21 de agosto de 1994"
12,3,51,1964,187,195,382,"21 de agosto de 1994"
12,3,51,1965,135,139,274,"21 de agosto de 1994"
12,3,51,1966,94,103,197,"21 de agosto de 1994"
12,3,51,1967,147,157,304,"21 de agosto de 1994"
12,3,51,1968,216,253,469,"21 de agosto de 1994"
12,3,51,1969,153,162,315,"21 de agosto de 1994"
12,3,51,1970,93,92,185,"21 de agosto de 1994"
12,3,51,1971,621,663,1284,"21 de agosto de 1994"
12,3,51,1972,255,304,559,"21 de agosto de 1994"
12,3,55,2092,96,125,221,"21 de agosto de 1994"
12,3,55,2093,228,244,472,"21 de agosto de 1994"
12,3,55,2094,286,284,570,"21 de agosto de 1994"
12,3,55,2095,148,155,303,"21 de agosto de 1994"
12,3,55,2096,117,174,291,"21 de agosto de 1994"
12,3,55,2097,243,240,483,"21 de agosto de 1994"
12,3,55,2098,47,49,96,"21 de agosto de 1994"
12,3,55,2099,67,83,150,"21 de agosto de 1994"
12,3,55,2100,136,141,277,"21 de agosto de 1994"
12,3,55,2101,282,263,545,"21 de agosto de 1994"
12,3,55,2102,102,112,214,"21 de agosto de 1994"
12,3,55,2103,82,82,164,"21 de agosto de 1994"
12,3,55,2104,172,185,357,"21 de agosto de 1994"
12,3,55,2105,94,96,190,"21 de agosto de 1994"
12,3,55,2106,48,54,102,"21 de agosto de 1994"
12,3,55,2107,46,59,105,"21 de agosto de 1994"
12,3,55,2108,35,51,86,"21 de agosto de 1994"
12,3,55,2109,51,52,103,"21 de agosto de 1994"
12,3,55,2110,94,61,155,"21 de agosto de 1994"
12,3,55,2111,36,35,71,"21 de agosto de 1994"
12,3,55,2112,48,39,87,"21 de agosto de 1994"
12,3,55,2113,34,28,62,"21 de agosto de 1994"
12,3,55,2114,47,42,89,"21 de agosto de 1994"
12,3,55,2115,96,74,170,"21 de agosto de 1994"
12,3,55,2116,112,86,198,"21 de agosto de 1994"
12,3,55,2117,81,68,149,"21 de agosto de 1994"
12,3,55,2118,61,45,106,"21 de agosto de 1994"
12,3,55,2119,79,95,174,"21 de agosto de 1994"
12,3,55,2120,54,54,108,"21 de agosto de 1994"
12,3,55,2121,39,32,71,"21 de agosto de 1994"
12,3,55,2122,114,84,198,"21 de agosto de 1994"
12,3,55,2123,59,36,95,"21 de agosto de 1994"
12,3,55,2124,44,33,77,"21 de agosto de 1994"
12,3,55,2125,51,45,96,"21 de agosto de 1994"
12,3,55,2126,17,15,32,"21 de agosto de 1994"
12,3,55,2127,15,10,25,"21 de agosto de 1994"
12,3,55,2128,41,24,65,"21 de agosto de 1994"
12,3,55,2129,65,29,94,"21 de agosto de 1994"
12,3,55,2130,28,15,43,"21 de agosto de 1994"
12,3,55,2131,68,56,124,"21 de agosto de 1994"
12,3,55,2132,45,38,83,"21 de agosto de 1994"
12,3,55,2133,145,110,255,"21 de agosto de 1994"
12,3,74,2725,333,296,629,"21 de agosto de 1994"
12,3,74,2726,533,548,1081,"21 de agosto de 1994"
12,3,74,2727,320,284,604,"21 de agosto de 1994"
12,3,74,2728,119,97,216,"21 de agosto de 1994"
12,3,74,2729,89,114,203,"21 de agosto de 1994"
12,3,74,2730,257,252,509,"21 de agosto de 1994"
12,3,74,2731,452,470,922,"21 de agosto de 1994"
12,3,74,2732,244,246,490,"21 de agosto de 1994"
12,3,74,2733,102,67,169,"21 de agosto de 1994"
12,3,74,2734,237,222,459,"21 de agosto de 1994"
12,3,74,2735,261,228,489,"21 de agosto de 1994"
12,3,74,2736,178,131,309,"21 de agosto de 1994"
12,3,74,2737,102,79,181,"21 de agosto de 1994"
12,3,74,2738,88,98,186,"21 de agosto de 1994"
12,3,74,2739,50,38,88,"21 de agosto de 1994"
12,3,74,2740,185,160,345,"21 de agosto de 1994"
12,3,74,2741,456,476,932,"21 de agosto de 1994"
12,3,74,2742,47,36,83,"21 de agosto de 1994"
12,3,74,2743,43,42,85,"21 de agosto de 1994"
12,3,74,2744,94,90,184,"21 de agosto de 1994"
12,3,74,2745,21,22,43,"21 de agosto de 1994"
12,3,74,2746,162,133,295,"21 de agosto de 1994"
12,3,74,2747,33,21,54,"21 de agosto de 1994"
12,3,74,2748,241,201,442,"21 de agosto de 1994"
12,3,74,2749,57,47,104,"21 de agosto de 1994"
12,3,74,2750,19,14,33,"21 de agosto de 1994"
12,3,74,2751,106,89,195,"21 de agosto de 1994"
12,4,1,1,426,537,963,"21 de agosto de 1994"
12,4,1,2,350,462,812,"21 de agosto de 1994"
12,4,1,3,458,591,1049,"21 de agosto de 1994"
12,4,1,4,329,357,686,"21 de agosto de 1994"
12,4,1,5,279,370,649,"21 de agosto de 1994"
12,4,1,6,293,349,642,"21 de agosto de 1994"
12,4,1,7,401,513,914,"21 de agosto de 1994"
12,4,1,8,307,403,710,"21 de agosto de 1994"
12,4,1,9,317,434,751,"21 de agosto de 1994"
12,4,1,10,242,339,581,"21 de agosto de 1994"
12,4,1,11,246,332,578,"21 de agosto de 1994"
12,4,1,12,362,459,821,"21 de agosto de 1994"
12,4,1,13,501,577,1078,"21 de agosto de 1994"
12,4,1,14,246,267,513,"21 de agosto de 1994"
12,4,1,15,361,438,799,"21 de agosto de 1994"
12,4,1,16,263,311,574,"21 de agosto de 1994"
12,4,1,17,333,410,743,"21 de agosto de 1994"
12,4,1,18,296,356,652,"21 de agosto de 1994"
12,4,1,19,305,441,746,"21 de agosto de 1994"
12,4,1,20,333,431,764,"21 de agosto de 1994"
12,4,1,21,425,484,909,"21 de agosto de 1994"
12,4,1,22,352,442,794,"21 de agosto de 1994"
12,4,1,23,589,744,1333,"21 de agosto de 1994"
12,4,1,24,441,553,994,"21 de agosto de 1994"
12,4,1,25,507,647,1154,"21 de agosto de 1994"
12,4,1,26,421,549,970,"21 de agosto de 1994"
12,4,1,27,567,673,1240,"21 de agosto de 1994"
12,4,1,28,315,361,676,"21 de agosto de 1994"
12,4,1,29,495,595,1090,"21 de agosto de 1994"
12,4,1,30,415,521,936,"21 de agosto de 1994"
12,4,1,31,524,691,1215,"21 de agosto de 1994"
12,4,1,32,441,586,1027,"21 de agosto de 1994"
12,4,1,33,567,666,1233,"21 de agosto de 1994"
12,4,1,34,316,379,695,"21 de agosto de 1994"
12,4,1,35,304,375,679,"21 de agosto de 1994"
12,4,1,36,565,572,1137,"21 de agosto de 1994"
12,4,1,37,361,444,805,"21 de agosto de 1994"
12,4,1,38,659,703,1362,"21 de agosto de 1994"
12,4,1,39,608,729,1337,"21 de agosto de 1994"
12,4,1,40,353,447,800,"21 de agosto de 1994"
12,4,1,41,561,708,1269,"21 de agosto de 1994"
12,4,1,42,593,671,1264,"21 de agosto de 1994"
12,4,1,43,413,471,884,"21 de agosto de 1994"
12,4,1,44,418,442,860,"21 de agosto de 1994"
12,4,1,45,376,415,791,"21 de agosto de 1994"
12,4,1,46,358,415,773,"21 de agosto de 1994"
12,4,1,47,290,364,654,"21 de agosto de 1994"
12,4,1,48,509,577,1086,"21 de agosto de 1994"
12,4,1,49,242,289,531,"21 de agosto de 1994"
12,4,1,50,334,415,749,"21 de agosto de 1994"
12,4,1,51,389,489,878,"21 de agosto de 1994"
12,4,1,52,272,297,569,"21 de agosto de 1994"
12,4,1,53,506,587,1093,"21 de agosto de 1994"
12,4,1,54,486,559,1045,"21 de agosto de 1994"
12,4,1,55,317,383,700,"21 de agosto de 1994"
12,4,1,56,514,559,1073,"21 de agosto de 1994"
12,4,1,57,388,503,891,"21 de agosto de 1994"
12,4,1,58,183,198,381,"21 de agosto de 1994"
12,4,1,59,211,251,462,"21 de agosto de 1994"
12,4,1,60,295,420,715,"21 de agosto de 1994"
12,4,1,61,346,465,811,"21 de agosto de 1994"
12,4,1,62,201,251,452,"21 de agosto de 1994"
12,4,1,63,253,279,532,"21 de agosto de 1994"
12,4,1,64,282,339,621,"21 de agosto de 1994"
12,4,1,65,221,264,485,"21 de agosto de 1994"
12,4,1,66,221,270,491,"21 de agosto de 1994"
12,4,1,67,319,369,688,"21 de agosto de 1994"
12,4,1,68,385,411,796,"21 de agosto de 1994"
12,4,1,69,248,279,527,"21 de agosto de 1994"
12,4,1,70,407,460,867,"21 de agosto de 1994"
12,4,1,71,359,459,818,"21 de agosto de 1994"
12,4,1,72,318,410,728,"21 de agosto de 1994"
12,4,1,73,310,407,717,"21 de agosto de 1994"
12,4,1,74,338,382,720,"21 de agosto de 1994"
12,4,1,75,252,283,535,"21 de agosto de 1994"
12,4,1,76,229,255,484,"21 de agosto de 1994"
12,4,1,77,394,475,869,"21 de agosto de 1994"
12,4,1,78,75,93,168,"21 de agosto de 1994"
12,4,1,79,243,312,555,"21 de agosto de 1994"
12,4,1,80,412,492,904,"21 de agosto de 1994"
12,4,1,81,348,370,718,"21 de agosto de 1994"
12,4,1,82,220,259,479,"21 de agosto de 1994"
12,4,1,83,273,281,554,"21 de agosto de 1994"
12,4,1,84,207,238,445,"21 de agosto de 1994"
12,4,1,85,287,370,657,"21 de agosto de 1994"
12,4,1,86,351,390,741,"21 de agosto de 1994"
12,4,1,87,278,336,614,"21 de agosto de 1994"
12,4,1,88,204,247,451,"21 de agosto de 1994"
12,4,1,89,409,400,809,"21 de agosto de 1994"
12,4,1,90,371,460,831,"21 de agosto de 1994"
12,4,1,91,280,355,635,"21 de agosto de 1994"
12,4,1,92,176,235,411,"21 de agosto de 1994"
12,4,1,93,287,317,604,"21 de agosto de 1994"
12,4,1,94,255,298,553,"21 de agosto de 1994"
12,4,1,95,224,213,437,"21 de agosto de 1994"
12,4,1,96,182,51,233,"21 de agosto de 1994"
12,4,1,97,443,472,915,"21 de agosto de 1994"
12,4,1,98,190,201,391,"21 de agosto de 1994"
12,4,1,99,332,419,751,"21 de agosto de 1994"
12,4,1,100,464,539,1003,"21 de agosto de 1994"
12,4,1,101,291,349,640,"21 de agosto de 1994"
12,4,1,102,363,439,802,"21 de agosto de 1994"
12,4,1,103,290,358,648,"21 de agosto de 1994"
12,4,1,104,436,480,916,"21 de agosto de 1994"
12,4,1,105,466,522,988,"21 de agosto de 1994"
12,4,1,106,408,453,861,"21 de agosto de 1994"
12,4,1,107,429,489,918,"21 de agosto de 1994"
12,4,1,108,395,517,912,"21 de agosto de 1994"
12,4,1,109,260,284,544,"21 de agosto de 1994"
12,5,4,456,374,407,781,"21 de agosto de 1994"
12,5,4,457,170,189,359,"21 de agosto de 1994"
12,5,4,458,47,45,92,"21 de agosto de 1994"
12,5,4,459,305,311,616,"21 de agosto de 1994"
12,5,4,460,51,47,98,"21 de agosto de 1994"
12,5,4,461,124,155,279,"21 de agosto de 1994"
12,5,4,462,36,41,77,"21 de agosto de 1994"
12,5,4,463,136,126,262,"21 de agosto de 1994"
12,5,4,464,110,126,236,"21 de agosto de 1994"
12,5,4,465,344,363,707,"21 de agosto de 1994"
12,5,4,466,62,81,143,"21 de agosto de 1994"
12,5,4,467,211,264,475,"21 de agosto de 1994"
12,5,4,468,193,228,421,"21 de agosto de 1994"
12,5,4,469,203,183,386,"21 de agosto de 1994"
12,5,4,470,73,66,139,"21 de agosto de 1994"
12,5,4,471,203,172,375,"21 de agosto de 1994"
12,5,4,472,302,299,601,"21 de agosto de 1994"
12,5,4,473,226,199,425,"21 de agosto de 1994"
12,5,5,474,328,405,733,"21 de agosto de 1994"
12,5,5,475,178,211,389,"21 de agosto de 1994"
12,5,5,476,257,282,539,"21 de agosto de 1994"
12,5,5,477,73,85,158,"21 de agosto de 1994"
12,5,5,478,146,178,324,"21 de agosto de 1994"
12,5,9,564,203,218,421,"21 de agosto de 1994"
12,5,9,565,112,120,232,"21 de agosto de 1994"
12,5,9,566,71,67,138,"21 de agosto de 1994"
12,5,9,567,41,36,77,"21 de agosto de 1994"
12,5,9,568,64,52,116,"21 de agosto de 1994"
12,5,9,569,108,103,211,"21 de agosto de 1994"
12,5,9,570,190,223,413,"21 de agosto de 1994"
12,5,9,571,42,52,94,"21 de agosto de 1994"
12,5,9,572,110,99,209,"21 de agosto de 1994"
12,5,10,573,379,430,809,"21 de agosto de 1994"
12,5,10,574,33,37,70,"21 de agosto de 1994"
12,5,10,575,70,81,151,"21 de agosto de 1994"
12,5,10,576,67,68,135,"21 de agosto de 1994"
12,5,10,577,224,254,478,"21 de agosto de 1994"
12,5,10,578,74,81,155,"21 de agosto de 1994"
12,5,10,579,104,123,227,"21 de agosto de 1994"
12,5,10,580,154,175,329,"21 de agosto de 1994"
12,5,10,581,49,39,88,"21 de agosto de 1994"
12,5,10,582,286,282,568,"21 de agosto de 1994"
12,5,10,583,104,119,223,"21 de agosto de 1994"
12,5,10,584,175,138,313,"21 de agosto de 1994"
12,5,10,585,198,155,353,"21 de agosto de 1994"
12,5,10,586,409,345,754,"21 de agosto de 1994"
12,5,10,587,181,176,357,"21 de agosto de 1994"
12,5,10,588,56,43,99,"21 de agosto de 1994"
12,5,10,589,109,89,198,"21 de agosto de 1994"
12,5,10,590,108,52,160,"21 de agosto de 1994"
12,5,10,591,139,123,262,"21 de agosto de 1994"
12,5,10,592,163,80,243,"21 de agosto de 1994"
12,5,10,593,65,47,112,"21 de agosto de 1994"
12,5,10,594,123,124,247,"21 de agosto de 1994"
12,5,10,595,156,115,271,"21 de agosto de 1994"
12,5,20,868,493,499,992,"21 de agosto de 1994"
12,5,20,869,90,86,176,"21 de agosto de 1994"
12,5,20,870,128,138,266,"21 de agosto de 1994"
12,5,20,871,110,131,241,"21 de agosto de 1994"
12,5,20,872,275,326,601,"21 de agosto de 1994"
12,5,20,873,357,348,705,"21 de agosto de 1994"
12,5,20,874,207,220,427,"21 de agosto de 1994"
12,5,20,875,83,29,112,"21 de agosto de 1994"
12,5,20,876,90,74,164,"21 de agosto de 1994"
12,5,20,877,394,395,789,"21 de agosto de 1994"
12,5,20,878,192,194,386,"21 de agosto de 1994"
12,5,20,879,123,73,196,"21 de agosto de 1994"
12,5,20,880,39,45,84,"21 de agosto de 1994"
12,5,20,881,151,91,242,"21 de agosto de 1994"
12,5,20,882,72,63,135,"21 de agosto de 1994"
12,5,25,1037,285,300,585,"21 de agosto de 1994"
12,5,25,1038,361,379,740,"21 de agosto de 1994"
12,5,25,1039,298,291,589,"21 de agosto de 1994"
12,5,25,1040,187,185,372,"21 de agosto de 1994"
12,5,25,1041,115,108,223,"21 de agosto de 1994"
12,5,25,1042,182,172,354,"21 de agosto de 1994"
12,5,25,1043,119,103,222,"21 de agosto de 1994"
12,5,25,1044,146,147,293,"21 de agosto de 1994"
12,5,25,1045,313,342,655,"21 de agosto de 1994"
12,5,25,1046,161,153,314,"21 de agosto de 1994"
12,5,25,1047,145,144,289,"21 de agosto de 1994"
12,5,25,1048,238,261,499,"21 de agosto de 1994"
12,5,25,1049,179,161,340,"21 de agosto de 1994"
12,5,37,1565,209,201,410,"21 de agosto de 1994"
12,5,37,1566,136,117,253,"21 de agosto de 1994"
12,5,37,1567,158,134,292,"21 de agosto de 1994"
12,5,37,1568,158,145,303,"21 de agosto de 1994"
12,5,37,1569,207,226,433,"21 de agosto de 1994"
12,5,37,1570,108,103,211,"21 de agosto de 1994"
12,5,37,1571,89,83,172,"21 de agosto de 1994"
12,5,37,1572,131,121,252,"21 de agosto de 1994"
12,5,37,1573,97,77,174,"21 de agosto de 1994"
12,5,37,1574,70,60,130,"21 de agosto de 1994"
12,5,37,1575,201,192,393,"21 de agosto de 1994"
12,5,42,1699,389,410,799,"21 de agosto de 1994"
12,5,42,1700,296,321,617,"21 de agosto de 1994"
12,5,42,1701,232,211,443,"21 de agosto de 1994"
12,5,42,1702,228,226,454,"21 de agosto de 1994"
12,5,42,1703,253,311,564,"21 de agosto de 1994"
12,5,42,1704,210,176,386,"21 de agosto de 1994"
12,5,42,1705,71,92,163,"21 de agosto de 1994"
12,5,42,1706,259,285,544,"21 de agosto de 1994"
12,5,42,1707,345,373,718,"21 de agosto de 1994"
12,5,42,1708,174,216,390,"21 de agosto de 1994"
12,5,42,1709,269,262,531,"21 de agosto de 1994"
12,5,42,1710,342,315,657,"21 de agosto de 1994"
12,5,42,1711,225,228,453,"21 de agosto de 1994"
12,5,42,1712,187,136,323,"21 de agosto de 1994"
12,5,42,1713,274,181,455,"21 de agosto de 1994"
12,5,42,1714,138,102,240,"21 de agosto de 1994"
12,5,42,1715,119,114,233,"21 de agosto de 1994"
12,5,42,1716,327,323,650,"21 de agosto de 1994"
12,5,42,1717,308,281,589,"21 de agosto de 1994"
12,5,42,1718,158,154,312,"21 de agosto de 1994"
12,5,44,1735,199,211,410,"21 de agosto de 1994"
12,5,44,1736,346,343,689,"21 de agosto de 1994"
12,5,44,1737,156,148,304,"21 de agosto de 1994"
12,5,44,1738,89,92,181,"21 de agosto de 1994"
12,5,44,1739,129,125,254,"21 de agosto de 1994"
12,5,44,1740,105,94,199,"21 de agosto de 1994"
12,5,44,1741,149,170,319,"21 de agosto de 1994"
12,5,44,1742,78,86,164,"21 de agosto de 1994"
12,5,44,1743,58,59,117,"21 de agosto de 1994"
12,5,44,1744,195,179,374,"21 de agosto de 1994"
12,5,44,1745,152,141,293,"21 de agosto de 1994"
12,5,44,1746,218,196,414,"21 de agosto de 1994"
12,5,44,1747,92,112,204,"21 de agosto de 1994"
12,5,44,1748,264,292,556,"21 de agosto de 1994"
12,5,44,1749,122,126,248,"21 de agosto de 1994"
12,5,44,1750,226,192,418,"21 de agosto de 1994"
12,5,44,1751,536,366,902,"21 de agosto de 1994"
12,5,44,1752,162,126,288,"21 de agosto de 1994"
12,5,44,1753,343,341,684,"21 de agosto de 1994"
12,5,44,1754,297,239,536,"21 de agosto de 1994"
12,5,44,1755,94,77,171,"21 de agosto de 1994"
12,5,44,1756,223,142,365,"21 de agosto de 1994"
12,5,44,1757,137,146,283,"21 de agosto de 1994"
12,5,44,1758,192,158,350,"21 de agosto de 1994"
12,5,44,1759,255,215,470,"21 de agosto de 1994"
12,5,44,1760,198,207,405,"21 de agosto de 1994"
12,5,44,1761,131,125,256,"21 de agosto de 1994"
12,5,44,1762,246,233,479,"21 de agosto de 1994"
12,5,44,1763,62,74,136,"21 de agosto de 1994"
12,5,53,2015,424,380,804,"21 de agosto de 1994"
12,5,53,2016,302,327,629,"21 de agosto de 1994"
12,5,53,2017,350,326,676,"21 de agosto de 1994"
12,5,53,2018,254,238,492,"21 de agosto de 1994"
12,5,53,2019,113,114,227,"21 de agosto de 1994"
12,5,53,2020,251,117,368,"21 de agosto de 1994"
12,5,53,2021,204,195,399,"21 de agosto de 1994"
12,5,53,2022,98,94,192,"21 de agosto de 1994"
12,5,53,2023,136,119,255,"21 de agosto de 1994"
12,5,53,2024,407,276,683,"21 de agosto de 1994"
12,5,53,2025,168,150,318,"21 de agosto de 1994"
12,5,53,2026,494,388,882,"21 de agosto de 1994"
12,5,53,2027,56,41,97,"21 de agosto de 1994"
12,5,53,2028,246,225,471,"21 de agosto de 1994"
12,5,53,2029,95,81,176,"21 de agosto de 1994"
12,5,53,2030,471,402,873,"21 de agosto de 1994"
12,5,53,2031,128,102,230,"21 de agosto de 1994"
12,5,53,2032,171,152,323,"21 de agosto de 1994"
12,5,53,2033,78,74,152,"21 de agosto de 1994"
12,5,53,2034,30,25,55,"21 de agosto de 1994"
12,5,53,2035,453,403,856,"21 de agosto de 1994"
12,5,53,2036,62,53,115,"21 de agosto de 1994"
12,5,53,2037,40,31,71,"21 de agosto de 1994"
12,5,53,2038,53,51,104,"21 de agosto de 1994"
12,5,53,2039,255,285,540,"21 de agosto de 1994"
12,5,53,2040,68,80,148,"21 de agosto de 1994"
12,5,63,2509,328,333,661,"21 de agosto de 1994"
12,5,63,2510,336,366,702,"21 de agosto de 1994"
12,5,63,2511,175,134,309,"21 de agosto de 1994"
12,5,63,2512,128,87,215,"21 de agosto de 1994"
12,5,63,2513,77,62,139,"21 de agosto de 1994"
12,5,63,2514,181,183,364,"21 de agosto de 1994"
12,5,63,2515,173,147,320,"21 de agosto de 1994"
12,5,63,2516,148,165,313,"21 de agosto de 1994"
12,5,63,2517,104,102,206,"21 de agosto de 1994"
12,5,63,2518,411,413,824,"21 de agosto de 1994"
12,5,63,2519,153,124,277,"21 de agosto de 1994"
12,5,63,2520,66,61,127,"21 de agosto de 1994"
12,5,63,2521,146,147,293,"21 de agosto de 1994"
12,5,63,2522,268,295,563,"21 de agosto de 1994"
12,5,64,2523,265,317,582,"21 de agosto de 1994"
12,5,64,2524,118,130,248,"21 de agosto de 1994"
12,5,64,2525,60,74,134,"21 de agosto de 1994"
12,5,64,2526,127,152,279,"21 de agosto de 1994"
12,5,64,2527,500,533,1033,"21 de agosto de 1994"
12,5,64,2528,204,224,428,"21 de agosto de 1994"
12,5,64,2529,32,30,62,"21 de agosto de 1994"
12,5,64,2530,63,60,123,"21 de agosto de 1994"
12,5,64,2531,223,181,404,"21 de agosto de 1994"
12,5,64,2532,72,67,139,"21 de agosto de 1994"
12,5,66,2554,173,197,370,"21 de agosto de 1994"
12,5,66,2555,262,280,542,"21 de agosto de 1994"
12,5,66,2556,91,104,195,"21 de agosto de 1994"
12,5,66,2557,61,62,123,"21 de agosto de 1994"
12,5,66,2558,63,90,153,"21 de agosto de 1994"
12,5,66,2559,44,63,107,"21 de agosto de 1994"
12,5,66,2560,246,248,494,"21 de agosto de 1994"
12,5,66,2561,274,355,629,"21 de agosto de 1994"
12,5,67,2562,500,505,1005,"21 de agosto de 1994"
12,5,67,2563,312,382,694,"21 de agosto de 1994"
12,5,67,2564,463,556,1019,"21 de agosto de 1994"
12,5,67,2565,184,221,405,"21 de agosto de 1994"
12,5,67,2566,485,526,1011,"21 de agosto de 1994"
12,5,67,2567,447,570,1017,"21 de agosto de 1994"
12,5,67,2568,288,349,637,"21 de agosto de 1994"
12,5,67,2569,233,280,513,"21 de agosto de 1994"
12,5,67,2570,332,399,731,"21 de agosto de 1994"
12,5,67,2571,264,363,627,"21 de agosto de 1994"
12,5,67,2572,452,507,959,"21 de agosto de 1994"
12,5,67,2573,187,200,387,"21 de agosto de 1994"
12,5,67,2574,184,176,360,"21 de agosto de 1994"
12,5,67,2575,217,165,382,"21 de agosto de 1994"
12,5,67,2576,69,63,132,"21 de agosto de 1994"
12,5,67,2577,189,237,426,"21 de agosto de 1994"
12,5,67,2578,277,242,519,"21 de agosto de 1994"
12,5,67,2579,240,222,462,"21 de agosto de 1994"
12,5,67,2580,155,152,307,"21 de agosto de 1994"
12,5,67,2581,14,27,41,"21 de agosto de 1994"
12,5,67,2582,190,208,398,"21 de agosto de 1994"
12,5,67,2583,140,153,293,"21 de agosto de 1994"
12,5,67,2584,118,117,235,"21 de agosto de 1994"
12,5,67,2585,209,252,461,"21 de agosto de 1994"
12,5,67,2586,520,484,1004,"21 de agosto de 1994"
12,5,67,2587,218,245,463,"21 de agosto de 1994"
12,5,67,2588,138,164,302,"21 de agosto de 1994"
12,5,67,2589,191,197,388,"21 de agosto de 1994"
12,5,67,2590,121,151,272,"21 de agosto de 1994"
12,5,67,2591,41,28,69,"21 de agosto de 1994"
12,5,67,2592,210,232,442,"21 de agosto de 1994"
12,5,67,2593,389,405,794,"21 de agosto de 1994"
12,5,67,2594,101,102,203,"21 de agosto de 1994"
12,5,67,2595,513,506,1019,"21 de agosto de 1994"
12,5,67,2596,81,85,166,"21 de agosto de 1994"
12,5,67,2597,52,59,111,"21 de agosto de 1994"
12,5,67,2598,161,135,296,"21 de agosto de 1994"
12,5,67,2599,88,94,182,"21 de agosto de 1994"
12,5,70,2655,644,736,1380,"21 de agosto de 1994"
12,5,70,2656,42,39,81,"21 de agosto de 1994"
12,5,70,2657,76,82,158,"21 de agosto de 1994"
12,5,70,2658,51,57,108,"21 de agosto de 1994"
12,5,70,2659,65,99,164,"21 de agosto de 1994"
12,5,70,2660,183,170,353,"21 de agosto de 1994"
12,5,70,2661,117,120,237,"21 de agosto de 1994"
12,5,70,2662,122,182,304,"21 de agosto de 1994"
12,5,70,2663,276,269,545,"21 de agosto de 1994"
12,5,70,2664,205,236,441,"21 de agosto de 1994"
12,5,70,2665,31,29,60,"21 de agosto de 1994"
12,5,70,2666,31,34,65,"21 de agosto de 1994"
12,5,70,2667,75,98,173,"21 de agosto de 1994"
12,5,70,2668,119,140,259,"21 de agosto de 1994"
12,5,72,2678,470,503,973,"21 de agosto de 1994"
12,5,72,2679,362,468,830,"21 de agosto de 1994"
12,5,72,2680,53,33,86,"21 de agosto de 1994"
12,5,72,2681,150,126,276,"21 de agosto de 1994"
12,5,72,2682,125,104,229,"21 de agosto de 1994"
12,5,72,2683,116,104,220,"21 de agosto de 1994"
12,5,72,2684,161,150,311,"21 de agosto de 1994"
12,5,72,2685,288,285,573,"21 de agosto de 1994"
12,5,72,2686,230,199,429,"21 de agosto de 1994"
12,5,72,2687,214,272,486,"21 de agosto de 1994"
12,5,72,2688,252,238,490,"21 de agosto de 1994"
12,5,72,2689,181,155,336,"21 de agosto de 1994"
12,5,72,2690,268,253,521,"21 de agosto de 1994"
12,5,72,2691,750,707,1457,"21 de agosto de 1994"
12,5,72,2692,363,322,685,"21 de agosto de 1994"
12,5,73,2693,122,137,259,"21 de agosto de 1994"
12,5,73,2694,308,310,618,"21 de agosto de 1994"
12,5,73,2695,90,81,171,"21 de agosto de 1994"
12,5,73,2696,231,266,497,"21 de agosto de 1994"
12,5,73,2697,96,118,214,"21 de agosto de 1994"
12,5,73,2698,195,195,390,"21 de agosto de 1994"
12,5,73,2699,129,142,271,"21 de agosto de 1994"
12,5,73,2700,247,243,490,"21 de agosto de 1994"
12,5,73,2701,1,1,2,"21 de agosto de 1994"
12,5,73,2702,48,47,95,"21 de agosto de 1994"
12,5,73,2703,27,37,64,"21 de agosto de 1994"
12,5,73,2704,56,66,122,"21 de agosto de 1994"
12,5,73,2705,105,122,227,"21 de agosto de 1994"
12,5,73,2706,157,173,330,"21 de agosto de 1994"
12,5,73,2710,105,109,214,"21 de agosto de 1994"
12,5,73,2712,2,2,4,"21 de agosto de 1994"
12,5,73,2714,202,207,409,"21 de agosto de 1994"
12,5,76,2694,22,18,40,"21 de agosto de 1994"
12,5,76,2701,106,132,238,"21 de agosto de 1994"
12,5,76,2703,139,163,302,"21 de agosto de 1994"
12,5,76,2704,332,373,705,"21 de agosto de 1994"
12,5,76,2706,93,78,171,"21 de agosto de 1994"
12,5,76,2707,102,103,205,"21 de agosto de 1994"
12,5,76,2708,116,133,249,"21 de agosto de 1994"
12,5,76,2709,173,42,215,"21 de agosto de 1994"
12,5,76,2710,153,135,288,"21 de agosto de 1994"
12,5,76,2711,76,75,151,"21 de agosto de 1994"
12,5,76,2712,122,162,284,"21 de agosto de 1994"
12,5,76,2713,183,179,362,"21 de agosto de 1994"
12,5,76,2715,95,86,181,"21 de agosto de 1994"
12,5,76,2716,252,255,507,"21 de agosto de 1994"
12,5,76,2717,63,56,119,"21 de agosto de 1994"
12,5,76,2718,92,82,174,"21 de agosto de 1994"
12,5,76,2719,63,63,126,"21 de agosto de 1994"
12,5,76,2720,50,51,101,"21 de agosto de 1994"
12,5,76,2721,129,150,279,"21 de agosto de 1994"
12,5,76,2722,123,127,250,"21 de agosto de 1994"
12,5,76,2723,122,113,235,"21 de agosto de 1994"
12,5,76,2724,137,144,281,"21 de agosto de 1994"
12,6,12,671,403,421,824,"21 de agosto de 1994"
12,6,12,672,228,232,460,"21 de agosto de 1994"
12,6,12,673,195,202,397,"21 de agosto de 1994"
12,6,12,674,457,469,926,"21 de agosto de 1994"
12,6,12,675,312,333,645,"21 de agosto de 1994"
12,6,12,676,74,63,137,"21 de agosto de 1994"
12,6,12,677,247,216,463,"21 de agosto de 1994"
12,6,12,678,72,64,136,"21 de agosto de 1994"
12,6,12,679,263,232,495,"21 de agosto de 1994"
12,6,12,680,119,109,228,"21 de agosto de 1994"
12,6,12,681,114,87,201,"21 de agosto de 1994"
12,6,12,682,160,150,310,"21 de agosto de 1994"
12,6,12,683,221,254,475,"21 de agosto de 1994"
12,6,12,684,425,439,864,"21 de agosto de 1994"
12,6,12,685,88,80,168,"21 de agosto de 1994"
12,6,12,686,87,77,164,"21 de agosto de 1994"
12,6,12,687,46,41,87,"21 de agosto de 1994"
12,6,12,688,123,123,246,"21 de agosto de 1994"
12,6,12,689,135,122,257,"21 de agosto de 1994"
12,6,12,690,41,36,77,"21 de agosto de 1994"
12,6,12,691,141,125,266,"21 de agosto de 1994"
12,6,12,692,322,323,645,"21 de agosto de 1994"
12,6,12,693,61,71,132,"21 de agosto de 1994"
12,6,12,694,276,267,543,"21 de agosto de 1994"
12,6,12,695,293,251,544,"21 de agosto de 1994"
12,6,12,696,101,98,199,"21 de agosto de 1994"
12,6,12,697,120,134,254,"21 de agosto de 1994"
12,6,12,698,98,115,213,"21 de agosto de 1994"
12,6,12,699,170,154,324,"21 de agosto de 1994"
12,6,12,700,275,236,511,"21 de agosto de 1994"
12,6,12,701,152,139,291,"21 de agosto de 1994"
12,6,12,702,140,134,274,"21 de agosto de 1994"
12,6,12,703,155,164,319,"21 de agosto de 1994"
12,6,12,704,59,58,117,"21 de agosto de 1994"
12,6,12,705,245,237,482,"21 de agosto de 1994"
12,6,12,706,197,187,384,"21 de agosto de 1994"
12,6,12,707,212,162,374,"21 de agosto de 1994"
12,6,12,708,86,86,172,"21 de agosto de 1994"
12,6,12,709,127,112,239,"21 de agosto de 1994"
12,6,12,710,163,149,312,"21 de agosto de 1994"
12,6,12,711,304,300,604,"21 de agosto de 1994"
12,6,12,712,161,129,290,"21 de agosto de 1994"
12,6,12,713,78,67,145,"21 de agosto de 1994"
12,6,12,714,183,177,360,"21 de agosto de 1994"
12,6,12,715,72,70,142,"21 de agosto de 1994"
12,6,12,716,36,26,62,"21 de agosto de 1994"
12,6,12,717,168,166,334,"21 de agosto de 1994"
12,6,12,718,214,228,442,"21 de agosto de 1994"
12,6,12,719,272,267,539,"21 de agosto de 1994"
12,6,12,720,187,233,420,"21 de agosto de 1994"
12,6,12,721,104,101,205,"21 de agosto de 1994"
12,6,12,722,55,81,136,"21 de agosto de 1994"
12,6,12,723,57,51,108,"21 de agosto de 1994"
12,6,12,724,94,94,188,"21 de agosto de 1994"
12,6,13,725,269,277,546,"21 de agosto de 1994"
12,6,13,726,343,354,697,"21 de agosto de 1994"
12,6,13,727,298,307,605,"21 de agosto de 1994"
12,6,13,728,309,317,626,"21 de agosto de 1994"
12,6,13,729,169,139,308,"21 de agosto de 1994"
12,6,13,730,321,309,630,"21 de agosto de 1994"
12,6,13,731,125,120,245,"21 de agosto de 1994"
12,6,13,732,278,259,537,"21 de agosto de 1994"
12,6,13,733,128,116,244,"21 de agosto de 1994"
12,6,13,734,120,102,222,"21 de agosto de 1994"
12,6,13,735,95,81,176,"21 de agosto de 1994"
12,6,13,736,74,75,149,"21 de agosto de 1994"
12,6,13,737,188,177,365,"21 de agosto de 1994"
12,6,13,738,65,72,137,"21 de agosto de 1994"
12,6,13,739,46,28,74,"21 de agosto de 1994"
12,6,13,740,61,50,111,"21 de agosto de 1994"
12,6,13,741,263,336,599,"21 de agosto de 1994"
12,6,13,742,280,255,535,"21 de agosto de 1994"
12,6,13,743,176,191,367,"21 de agosto de 1994"
12,6,13,744,197,221,418,"21 de agosto de 1994"
12,6,13,745,168,177,345,"21 de agosto de 1994"
12,6,13,746,230,214,444,"21 de agosto de 1994"
12,6,13,747,83,62,145,"21 de agosto de 1994"
12,6,13,748,109,103,212,"21 de agosto de 1994"
12,6,13,749,17,18,35,"21 de agosto de 1994"
12,6,13,750,28,30,58,"21 de agosto de 1994"
12,6,13,751,89,77,166,"21 de agosto de 1994"
12,6,13,752,327,348,675,"21 de agosto de 1994"
12,6,13,753,294,291,585,"21 de agosto de 1994"
12,6,13,754,397,452,849,"21 de agosto de 1994"
12,6,13,755,202,187,389,"21 de agosto de 1994"
12,6,13,756,248,266,514,"21 de agosto de 1994"
12,6,13,757,34,29,63,"21 de agosto de 1994"
12,6,13,758,67,53,120,"21 de agosto de 1994"
12,6,13,759,73,68,141,"21 de agosto de 1994"
12,6,13,760,55,41,96,"21 de agosto de 1994"
12,6,13,761,66,41,107,"21 de agosto de 1994"
12,6,13,762,160,153,313,"21 de agosto de 1994"
12,6,18,844,432,492,924,"21 de agosto de 1994"
12,6,18,845,167,200,367,"21 de agosto de 1994"
12,6,18,846,295,356,651,"21 de agosto de 1994"
12,6,18,847,275,260,535,"21 de agosto de 1994"
12,6,18,848,132,140,272,"21 de agosto de 1994"
12,6,18,849,142,134,276,"21 de agosto de 1994"
12,6,18,850,192,209,401,"21 de agosto de 1994"
12,6,18,851,54,54,108,"21 de agosto de 1994"
12,6,18,852,60,51,111,"21 de agosto de 1994"
12,6,18,853,119,132,251,"21 de agosto de 1994"
12,6,18,854,75,72,147,"21 de agosto de 1994"
12,6,18,855,36,26,62,"21 de agosto de 1994"
12,6,18,856,302,307,609,"21 de agosto de 1994"
12,6,18,857,98,90,188,"21 de agosto de 1994"
12,6,23,1001,241,279,520,"21 de agosto de 1994"
12,6,23,1002,218,251,469,"21 de agosto de 1994"
12,6,23,1003,197,210,407,"21 de agosto de 1994"
12,6,23,1004,227,249,476,"21 de agosto de 1994"
12,6,23,1005,203,245,448,"21 de agosto de 1994"
12,6,23,1006,216,286,502,"21 de agosto de 1994"
12,6,23,1007,196,198,394,"21 de agosto de 1994"
12,6,23,1008,117,127,244,"21 de agosto de 1994"
12,6,23,1009,46,63,109,"21 de agosto de 1994"
12,6,23,1010,153,169,322,"21 de agosto de 1994"
12,6,23,1011,41,35,76,"21 de agosto de 1994"
12,6,23,1012,167,191,358,"21 de agosto de 1994"
12,6,23,1013,191,166,357,"21 de agosto de 1994"
12,6,23,1014,303,328,631,"21 de agosto de 1994"
12,6,23,1015,116,119,235,"21 de agosto de 1994"
12,6,23,1016,153,128,281,"21 de agosto de 1994"
12,6,23,1017,146,157,303,"21 de agosto de 1994"
12,6,23,1018,74,68,142,"21 de agosto de 1994"
12,6,23,1019,102,99,201,"21 de agosto de 1994"
12,6,23,1020,182,207,389,"21 de agosto de 1994"
12,6,23,1021,40,28,68,"21 de agosto de 1994"
12,6,23,1022,189,169,358,"21 de agosto de 1994"
12,6,23,1023,228,218,446,"21 de agosto de 1994"
12,6,23,1024,187,184,371,"21 de agosto de 1994"
12,6,23,1025,203,212,415,"21 de agosto de 1994"
12,6,23,1026,113,94,207,"21 de agosto de 1994"
12,6,23,1027,196,180,376,"21 de agosto de 1994"
12,6,23,1028,29,25,54,"21 de agosto de 1994"
12,6,23,1029,256,222,478,"21 de agosto de 1994"
12,6,31,1339,510,545,1055,"21 de agosto de 1994"
12,6,31,1340,161,167,328,"21 de agosto de 1994"
12,6,31,1341,297,278,575,"21 de agosto de 1994"
12,6,31,1342,619,606,1225,"21 de agosto de 1994"
12,6,31,1343,268,41,309,"21 de agosto de 1994"
12,6,31,1344,242,189,431,"21 de agosto de 1994"
12,6,31,1345,119,128,247,"21 de agosto de 1994"
12,6,31,1346,118,132,250,"21 de agosto de 1994"
12,6,31,1347,217,204,421,"21 de agosto de 1994"
12,6,31,1348,75,50,125,"21 de agosto de 1994"
12,6,31,1349,153,130,283,"21 de agosto de 1994"
12,6,31,1350,62,55,117,"21 de agosto de 1994"
12,6,31,1351,43,34,77,"21 de agosto de 1994"
12,6,31,1352,157,142,299,"21 de agosto de 1994"
12,6,31,1353,146,125,271,"21 de agosto de 1994"
12,6,31,1354,65,47,112,"21 de agosto de 1994"
12,6,31,1355,139,156,295,"21 de agosto de 1994"
12,6,31,1356,175,165,340,"21 de agosto de 1994"
12,6,31,1357,134,114,248,"21 de agosto de 1994"
12,6,47,1809,535,591,1126,"21 de agosto de 1994"
12,6,47,1810,265,263,528,"21 de agosto de 1994"
12,6,47,1811,535,583,1118,"21 de agosto de 1994"
12,6,47,1812,197,218,415,"21 de agosto de 1994"
12,6,47,1813,480,494,974,"21 de agosto de 1994"
12,6,47,1814,275,313,588,"21 de agosto de 1994"
12,6,47,1815,252,267,519,"21 de agosto de 1994"
12,6,47,1816,285,335,620,"21 de agosto de 1994"
12,6,47,1817,398,467,865,"21 de agosto de 1994"
12,6,47,1818,216,276,492,"21 de agosto de 1994"
12,6,47,1819,466,524,990,"21 de agosto de 1994"
12,6,47,1820,251,255,506,"21 de agosto de 1994"
12,6,47,1821,526,506,1032,"21 de agosto de 1994"
12,6,47,1822,193,192,385,"21 de agosto de 1994"
12,6,47,1823,115,121,236,"21 de agosto de 1994"
12,6,47,1824,528,571,1099,"21 de agosto de 1994"
12,6,47,1825,50,60,110,"21 de agosto de 1994"
12,6,47,1826,133,131,264,"21 de agosto de 1994"
12,6,47,1827,51,56,107,"21 de agosto de 1994"
12,6,47,1828,146,159,305,"21 de agosto de 1994"
12,6,47,1829,122,106,228,"21 de agosto de 1994"
12,6,47,1830,496,483,979,"21 de agosto de 1994"
12,6,47,1831,43,35,78,"21 de agosto de 1994"
12,6,47,1832,93,68,161,"21 de agosto de 1994"
12,6,47,1833,175,160,335,"21 de agosto de 1994"
12,6,47,1834,57,67,124,"21 de agosto de 1994"
12,6,47,1835,41,30,71,"21 de agosto de 1994"
12,6,47,1836,58,46,104,"21 de agosto de 1994"
12,6,47,1837,89,71,160,"21 de agosto de 1994"
12,6,47,1838,157,152,309,"21 de agosto de 1994"
12,6,47,1839,172,174,346,"21 de agosto de 1994"
12,6,47,1840,493,468,961,"21 de agosto de 1994"
12,6,47,1841,62,67,129,"21 de agosto de 1994"
12,6,47,1842,63,53,116,"21 de agosto de 1994"
12,6,47,1843,110,98,208,"21 de agosto de 1994"
12,6,47,1844,28,22,50,"21 de agosto de 1994"
12,6,47,1845,123,116,239,"21 de agosto de 1994"
12,6,47,1846,101,104,205,"21 de agosto de 1994"
12,6,54,2041,203,279,482,"21 de agosto de 1994"
12,6,54,2042,154,163,317,"21 de agosto de 1994"
12,6,54,2043,188,173,361,"21 de agosto de 1994"
12,6,54,2044,300,324,624,"21 de agosto de 1994"
12,6,54,2045,281,279,560,"21 de agosto de 1994"
12,6,54,2046,333,413,746,"21 de agosto de 1994"
12,6,54,2047,224,187,411,"21 de agosto de 1994"
12,6,54,2048,311,321,632,"21 de agosto de 1994"
12,6,54,2049,244,285,529,"21 de agosto de 1994"
12,6,54,2050,285,291,576,"21 de agosto de 1994"
12,6,54,2051,175,192,367,"21 de agosto de 1994"
12,6,54,2052,481,518,999,"21 de agosto de 1994"
12,6,54,2053,153,123,276,"21 de agosto de 1994"
12,6,54,2054,284,288,572,"21 de agosto de 1994"
12,6,54,2055,65,67,132,"21 de agosto de 1994"
12,6,54,2056,101,104,205,"21 de agosto de 1994"
12,6,54,2057,260,239,499,"21 de agosto de 1994"
12,6,54,2058,115,109,224,"21 de agosto de 1994"
12,6,54,2059,167,145,312,"21 de agosto de 1994"
12,6,54,2060,237,246,483,"21 de agosto de 1994"
12,6,54,2061,231,207,438,"21 de agosto de 1994"
12,6,54,2062,78,91,169,"21 de agosto de 1994"
12,6,54,2063,117,145,262,"21 de agosto de 1994"
12,6,54,2064,39,33,72,"21 de agosto de 1994"
12,6,54,2065,195,166,361,"21 de agosto de 1994"
12,6,54,2066,34,41,75,"21 de agosto de 1994"
12,6,54,2067,111,122,233,"21 de agosto de 1994"
12,6,54,2068,149,141,290,"21 de agosto de 1994"
12,6,54,2069,123,116,239,"21 de agosto de 1994"
12,6,54,2070,95,137,232,"21 de agosto de 1994"
12,6,54,2071,224,223,447,"21 de agosto de 1994"
12,6,54,2072,105,99,204,"21 de agosto de 1994"
12,6,54,2073,230,211,441,"21 de agosto de 1994"
12,6,54,2074,263,359,622,"21 de agosto de 1994"
12,6,54,2075,233,257,490,"21 de agosto de 1994"
12,6,54,2076,356,392,748,"21 de agosto de 1994"
12,6,54,2077,113,121,234,"21 de agosto de 1994"
12,6,54,2078,101,105,206,"21 de agosto de 1994"
12,6,54,2079,72,81,153,"21 de agosto de 1994"
12,6,54,2080,246,208,454,"21 de agosto de 1994"
12,6,54,2081,25,27,52,"21 de agosto de 1994"
12,6,54,2082,37,41,78,"21 de agosto de 1994"
12,6,54,2083,198,199,397,"21 de agosto de 1994"
12,6,54,2084,268,252,520,"21 de agosto de 1994"
12,6,54,2085,36,32,68,"21 de agosto de 1994"
12,6,54,2086,54,45,99,"21 de agosto de 1994"
12,6,54,2087,39,38,77,"21 de agosto de 1994"
12,6,54,2088,82,53,135,"21 de agosto de 1994"
12,6,54,2089,107,110,217,"21 de agosto de 1994"
12,6,54,2090,184,175,359,"21 de agosto de 1994"
12,6,54,2091,152,122,274,"21 de agosto de 1994"
12,6,57,2223,358,396,754,"21 de agosto de 1994"
12,6,57,2224,318,376,694,"21 de agosto de 1994"
12,6,57,2225,116,113,229,"21 de agosto de 1994"
12,6,57,2226,132,142,274,"21 de agosto de 1994"
12,6,57,2227,143,154,297,"21 de agosto de 1994"
12,6,57,2228,165,167,332,"21 de agosto de 1994"
12,6,57,2229,103,88,191,"21 de agosto de 1994"
12,6,57,2230,103,89,192,"21 de agosto de 1994"
12,6,57,2231,247,258,505,"21 de agosto de 1994"
12,6,57,2232,357,361,718,"21 de agosto de 1994"
12,6,57,2233,278,300,578,"21 de agosto de 1994"
12,6,57,2234,268,274,542,"21 de agosto de 1994"
12,6,57,2235,223,195,418,"21 de agosto de 1994"
12,6,57,2236,138,147,285,"21 de agosto de 1994"
12,6,57,2237,325,364,689,"21 de agosto de 1994"
12,6,57,2238,402,387,789,"21 de agosto de 1994"
12,6,57,2239,373,383,756,"21 de agosto de 1994"
12,6,57,2240,277,291,568,"21 de agosto de 1994"
12,6,57,2241,340,341,681,"21 de agosto de 1994"
12,6,57,2242,191,209,400,"21 de agosto de 1994"
12,6,57,2243,141,148,289,"21 de agosto de 1994"
12,6,57,2244,338,299,637,"21 de agosto de 1994"
12,6,57,2245,107,120,227,"21 de agosto de 1994"
12,6,57,2246,102,95,197,"21 de agosto de 1994"
12,6,57,2247,390,427,817,"21 de agosto de 1994"
12,6,57,2248,222,225,447,"21 de agosto de 1994"
12,6,57,2249,177,204,381,"21 de agosto de 1994"
12,6,57,2250,197,206,403,"21 de agosto de 1994"
12,6,57,2251,76,67,143,"21 de agosto de 1994"
12,6,57,2252,130,136,266,"21 de agosto de 1994"
12,6,57,2253,80,97,177,"21 de agosto de 1994"
12,6,57,2254,130,166,296,"21 de agosto de 1994"
12,6,57,2255,121,131,252,"21 de agosto de 1994"
12,6,57,2256,82,78,160,"21 de agosto de 1994"
12,6,57,2257,242,223,465,"21 de agosto de 1994"
12,6,57,2258,86,87,173,"21 de agosto de 1994"
12,6,57,2259,112,123,235,"21 de agosto de 1994"
12,6,57,2260,106,112,218,"21 de agosto de 1994"
12,6,57,2261,55,56,111,"21 de agosto de 1994"
12,7,1,110,439,526,965,"21 de agosto de 1994"
12,7,1,111,432,485,917,"21 de agosto de 1994"
12,7,1,112,396,444,840,"21 de agosto de 1994"
12,7,1,113,77,121,198,"21 de agosto de 1994"
12,7,1,114,345,385,730,"21 de agosto de 1994"
12,7,1,115,234,222,456,"21 de agosto de 1994"
12,7,1,116,497,500,997,"21 de agosto de 1994"
12,7,1,117,366,455,821,"21 de agosto de 1994"
12,7,1,118,366,415,781,"21 de agosto de 1994"
12,7,1,119,362,473,835,"21 de agosto de 1994"
12,7,1,120,279,287,566,"21 de agosto de 1994"
12,7,1,121,450,479,929,"21 de agosto de 1994"
12,7,1,122,207,231,438,"21 de agosto de 1994"
12,7,1,123,434,492,926,"21 de agosto de 1994"
12,7,1,124,412,435,847,"21 de agosto de 1994"
12,7,1,125,349,418,767,"21 de agosto de 1994"
12,7,1,126,369,201,570,"21 de agosto de 1994"
12,7,1,127,285,343,628,"21 de agosto de 1994"
12,7,1,128,276,326,602,"21 de agosto de 1994"
12,7,1,129,376,502,878,"21 de agosto de 1994"
12,7,1,130,348,455,803,"21 de agosto de 1994"
12,7,1,131,367,448,815,"21 de agosto de 1994"
12,7,1,132,457,594,1051,"21 de agosto de 1994"
12,7,1,133,350,425,775,"21 de agosto de 1994"
12,7,1,134,442,558,1000,"21 de agosto de 1994"
12,7,1,135,168,194,362,"21 de agosto de 1994"
12,7,1,136,307,359,666,"21 de agosto de 1994"
12,7,1,137,351,397,748,"21 de agosto de 1994"
12,7,1,138,495,624,1119,"21 de agosto de 1994"
12,7,1,139,447,541,988,"21 de agosto de 1994"
12,7,1,140,377,493,870,"21 de agosto de 1994"
12,7,1,141,537,666,1203,"21 de agosto de 1994"
12,7,1,142,507,619,1126,"21 de agosto de 1994"
12,7,1,143,372,448,820,"21 de agosto de 1994"
12,7,1,144,327,406,733,"21 de agosto de 1994"
12,7,1,145,306,409,715,"21 de agosto de 1994"
12,7,1,146,424,536,960,"21 de agosto de 1994"
12,7,1,147,561,691,1252,"21 de agosto de 1994"
12,7,1,148,469,585,1054,"21 de agosto de 1994"
12,7,1,149,612,761,1373,"21 de agosto de 1994"
12,7,1,150,331,388,719,"21 de agosto de 1994"
12,7,1,151,282,366,648,"21 de agosto de 1994"
12,7,1,152,303,384,687,"21 de agosto de 1994"
12,7,1,153,350,468,818,"21 de agosto de 1994"
12,7,1,154,370,499,869,"21 de agosto de 1994"
12,7,1,155,379,468,847,"21 de agosto de 1994"
12,7,1,156,381,485,866,"21 de agosto de 1994"
12,7,1,157,444,554,998,"21 de agosto de 1994"
12,7,1,158,289,353,642,"21 de agosto de 1994"
12,7,1,159,348,471,819,"21 de agosto de 1994"
12,7,1,160,654,735,1389,"21 de agosto de 1994"
12,7,1,161,360,421,781,"21 de agosto de 1994"
12,7,1,162,243,332,575,"21 de agosto de 1994"
12,7,1,163,232,292,524,"21 de agosto de 1994"
12,7,1,164,375,492,867,"21 de agosto de 1994"
12,7,1,165,415,448,863,"21 de agosto de 1994"
12,7,1,166,413,464,877,"21 de agosto de 1994"
12,7,1,167,477,506,983,"21 de agosto de 1994"
12,7,1,168,332,401,733,"21 de agosto de 1994"
12,7,1,169,338,401,739,"21 de agosto de 1994"
12,7,1,170,151,175,326,"21 de agosto de 1994"
12,7,1,171,425,480,905,"21 de agosto de 1994"
12,7,1,172,402,475,877,"21 de agosto de 1994"
12,7,1,173,412,514,926,"21 de agosto de 1994"
12,7,1,174,330,407,737,"21 de agosto de 1994"
12,7,1,175,374,476,850,"21 de agosto de 1994"
12,7,1,176,467,534,1001,"21 de agosto de 1994"
12,7,1,177,392,514,906,"21 de agosto de 1994"
12,7,1,178,437,542,979,"21 de agosto de 1994"
12,7,1,179,515,622,1137,"21 de agosto de 1994"
12,7,1,180,501,581,1082,"21 de agosto de 1994"
12,7,1,181,294,410,704,"21 de agosto de 1994"
12,7,1,182,377,460,837,"21 de agosto de 1994"
12,7,1,183,330,441,771,"21 de agosto de 1994"
12,7,1,184,355,450,805,"21 de agosto de 1994"
12,7,1,185,456,564,1020,"21 de agosto de 1994"
12,7,1,186,483,549,1032,"21 de agosto de 1994"
12,7,1,187,392,408,800,"21 de agosto de 1994"
12,7,1,188,351,386,737,"21 de agosto de 1994"
12,7,1,189,164,155,319,"21 de agosto de 1994"
12,7,1,190,328,367,695,"21 de agosto de 1994"
12,7,1,191,231,292,523,"21 de agosto de 1994"
12,7,1,192,465,598,1063,"21 de agosto de 1994"
12,7,1,193,350,450,800,"21 de agosto de 1994"
12,7,1,194,390,448,838,"21 de agosto de 1994"
12,7,1,195,311,333,644,"21 de agosto de 1994"
12,7,1,196,228,296,524,"21 de agosto de 1994"
12,7,1,197,314,382,696,"21 de agosto de 1994"
12,7,1,198,614,737,1351,"21 de agosto de 1994"
12,7,1,199,359,446,805,"21 de agosto de 1994"
12,7,1,200,491,566,1057,"21 de agosto de 1994"
12,7,1,201,313,374,687,"21 de agosto de 1994"
12,7,1,202,515,636,1151,"21 de agosto de 1994"
12,7,1,203,341,386,727,"21 de agosto de 1994"
12,7,1,204,508,666,1174,"21 de agosto de 1994"
12,7,1,205,313,361,674,"21 de agosto de 1994"
12,7,1,206,333,411,744,"21 de agosto de 1994"
12,7,1,207,312,375,687,"21 de agosto de 1994"
12,7,1,208,454,563,1017,"21 de agosto de 1994"
12,7,1,209,504,618,1122,"21 de agosto de 1994"
12,7,1,210,401,455,856,"21 de agosto de 1994"
12,7,1,211,226,304,530,"21 de agosto de 1994"
12,7,1,212,473,544,1017,"21 de agosto de 1994"
12,7,1,213,287,347,634,"21 de agosto de 1994"
12,7,1,214,395,463,858,"21 de agosto de 1994"
12,7,1,215,513,615,1128,"21 de agosto de 1994"
12,7,1,216,417,569,986,"21 de agosto de 1994"
12,7,1,217,467,580,1047,"21 de agosto de 1994"
12,7,1,218,286,364,650,"21 de agosto de 1994"
12,7,1,219,508,584,1092,"21 de agosto de 1994"
12,7,1,220,379,426,805,"21 de agosto de 1994"
12,7,1,221,368,447,815,"21 de agosto de 1994"
12,7,1,222,257,328,585,"21 de agosto de 1994"
12,7,1,223,533,629,1162,"21 de agosto de 1994"
12,7,1,224,441,485,926,"21 de agosto de 1994"
12,7,1,225,268,336,604,"21 de agosto de 1994"
12,7,1,226,364,394,758,"21 de agosto de 1994"
12,7,1,227,245,336,581,"21 de agosto de 1994"
12,7,1,228,307,408,715,"21 de agosto de 1994"
12,7,1,229,188,283,471,"21 de agosto de 1994"
12,7,1,230,398,452,850,"21 de agosto de 1994"
12,7,1,231,530,572,1102,"21 de agosto de 1994"
12,7,1,232,725,812,1537,"21 de agosto de 1994"
12,7,1,233,300,326,626,"21 de agosto de 1994"
12,7,1,234,267,310,577,"21 de agosto de 1994"
12,7,1,235,349,453,802,"21 de agosto de 1994"
12,7,1,236,321,413,734,"21 de agosto de 1994"
12,7,1,237,351,473,824,"21 de agosto de 1994"
12,7,1,238,289,362,651,"21 de agosto de 1994"
12,7,1,239,348,440,788,"21 de agosto de 1994"
12,7,1,240,433,513,946,"21 de agosto de 1994"
12,7,1,241,242,309,551,"21 de agosto de 1994"
12,7,1,242,312,342,654,"21 de agosto de 1994"
12,7,1,243,525,675,1200,"21 de agosto de 1994"
12,7,1,244,612,754,1366,"21 de agosto de 1994"
12,7,1,245,463,556,1019,"21 de agosto de 1994"
12,7,1,246,410,487,897,"21 de agosto de 1994"
12,7,1,247,361,384,745,"21 de agosto de 1994"
12,7,1,248,361,456,817,"21 de agosto de 1994"
12,7,1,249,279,317,596,"21 de agosto de 1994"
12,7,1,250,258,317,575,"21 de agosto de 1994"
12,7,1,251,328,453,781,"21 de agosto de 1994"
12,7,1,252,311,389,700,"21 de agosto de 1994"
12,7,1,253,333,401,734,"21 de agosto de 1994"
12,7,1,254,400,470,870,"21 de agosto de 1994"
12,7,1,255,291,325,616,"21 de agosto de 1994"
12,7,1,256,913,1049,1962,"21 de agosto de 1994"
12,7,1,257,430,576,1006,"21 de agosto de 1994"
12,7,1,258,318,382,700,"21 de agosto de 1994"
12,7,1,259,334,436,770,"21 de agosto de 1994"
12,7,1,260,335,383,718,"21 de agosto de 1994"
12,7,1,261,573,653,1226,"21 de agosto de 1994"
12,7,1,262,586,633,1219,"21 de agosto de 1994"
12,7,1,263,350,412,762,"21 de agosto de 1994"
12,7,1,264,358,406,764,"21 de agosto de 1994"
12,7,1,265,476,591,1067,"21 de agosto de 1994"
12,7,1,266,524,540,1064,"21 de agosto de 1994"
12,7,1,267,429,511,940,"21 de agosto de 1994"
12,7,1,268,323,397,720,"21 de agosto de 1994"
12,7,1,269,318,370,688,"21 de agosto de 1994"
12,7,1,270,336,402,738,"21 de agosto de 1994"
12,7,1,271,286,386,672,"21 de agosto de 1994"
12,7,1,272,277,364,641,"21 de agosto de 1994"
12,7,1,273,307,352,659,"21 de agosto de 1994"
12,7,1,274,421,507,928,"21 de agosto de 1994"
12,7,1,275,186,211,397,"21 de agosto de 1994"
12,7,1,276,223,271,494,"21 de agosto de 1994"
12,7,1,277,461,518,979,"21 de agosto de 1994"
12,7,1,278,409,436,845,"21 de agosto de 1994"
12,7,1,279,650,786,1436,"21 de agosto de 1994"
12,7,1,280,327,379,706,"21 de agosto de 1994"
12,7,1,281,214,256,470,"21 de agosto de 1994"
12,7,1,282,287,342,629,"21 de agosto de 1994"
12,7,1,283,295,380,675,"21 de agosto de 1994"
12,7,1,284,520,575,1095,"21 de agosto de 1994"
12,7,1,285,357,447,804,"21 de agosto de 1994"
12,7,1,286,496,558,1054,"21 de agosto de 1994"
12,7,1,287,205,199,404,"21 de agosto de 1994"
12,7,1,288,217,233,450,"21 de agosto de 1994"
12,7,1,289,317,369,686,"21 de agosto de 1994"
12,7,1,290,297,370,667,"21 de agosto de 1994"
12,7,1,291,403,480,883,"21 de agosto de 1994"
12,7,1,292,386,459,845,"21 de agosto de 1994"
12,7,1,293,375,471,846,"21 de agosto de 1994"
12,7,1,294,506,503,1009,"21 de agosto de 1994"
12,7,1,295,393,452,845,"21 de agosto de 1994"
12,7,1,296,509,610,1119,"21 de agosto de 1994"
12,7,1,297,625,828,1453,"21 de agosto de 1994"
12,7,1,298,492,654,1146,"21 de agosto de 1994"
12,7,1,299,503,656,1159,"21 de agosto de 1994"
12,7,1,300,545,716,1261,"21 de agosto de 1994"
12,7,1,301,621,687,1308,"21 de agosto de 1994"
12,7,1,302,191,243,434,"21 de agosto de 1994"
12,7,1,303,1571,160,1731,"21 de agosto de 1994"
12,7,1,304,517,374,891,"21 de agosto de 1994"
12,7,1,305,241,284,525,"21 de agosto de 1994"
12,7,1,306,533,578,1111,"21 de agosto de 1994"
12,7,1,307,388,431,819,"21 de agosto de 1994"
12,7,1,308,636,718,1354,"21 de agosto de 1994"
12,7,1,309,128,121,249,"21 de agosto de 1994"
12,7,1,310,643,709,1352,"21 de agosto de 1994"
12,7,1,311,300,355,655,"21 de agosto de 1994"
12,7,1,312,230,236,466,"21 de agosto de 1994"
12,7,1,313,190,181,371,"21 de agosto de 1994"
12,7,1,314,105,82,187,"21 de agosto de 1994"
12,7,1,315,190,194,384,"21 de agosto de 1994"
12,7,1,316,195,172,367,"21 de agosto de 1994"
12,7,1,317,237,253,490,"21 de agosto de 1994"
12,7,1,318,281,320,601,"21 de agosto de 1994"
12,7,1,319,370,425,795,"21 de agosto de 1994"
12,7,1,320,466,534,1000,"21 de agosto de 1994"
12,7,1,321,125,158,283,"21 de agosto de 1994"
12,7,1,322,189,182,371,"21 de agosto de 1994"
12,7,1,323,298,300,598,"21 de agosto de 1994"
12,7,1,324,201,217,418,"21 de agosto de 1994"
12,7,1,325,76,74,150,"21 de agosto de 1994"
12,7,1,326,151,156,307,"21 de agosto de 1994"
12,7,1,327,200,217,417,"21 de agosto de 1994"
12,7,1,328,300,298,598,"21 de agosto de 1994"
12,7,1,329,249,267,516,"21 de agosto de 1994"
12,7,1,330,238,250,488,"21 de agosto de 1994"
12,7,1,331,362,368,730,"21 de agosto de 1994"
12,7,1,332,83,82,165,"21 de agosto de 1994"
12,7,1,333,285,265,550,"21 de agosto de 1994"
12,7,1,334,389,416,805,"21 de agosto de 1994"
12,7,1,335,280,311,591,"21 de agosto de 1994"
12,7,1,336,353,393,746,"21 de agosto de 1994"
12,7,1,337,381,422,803,"21 de agosto de 1994"
12,7,1,338,307,324,631,"21 de agosto de 1994"
12,7,1,339,408,395,803,"21 de agosto de 1994"
12,7,1,340,177,175,352,"21 de agosto de 1994"
12,7,1,341,114,114,228,"21 de agosto de 1994"
12,7,1,342,72,55,127,"21 de agosto de 1994"
12,7,1,343,455,510,965,"21 de agosto de 1994"
12,7,1,344,321,366,687,"21 de agosto de 1994"
12,7,1,345,171,145,316,"21 de agosto de 1994"
12,7,1,346,122,101,223,"21 de agosto de 1994"
12,7,1,347,386,423,809,"21 de agosto de 1994"
12,7,1,348,63,51,114,"21 de agosto de 1994"
12,7,1,349,113,112,225,"21 de agosto de 1994"
12,7,1,350,146,187,333,"21 de agosto de 1994"
12,7,1,351,254,241,495,"21 de agosto de 1994"
12,7,1,352,119,121,240,"21 de agosto de 1994"
12,7,1,353,76,71,147,"21 de agosto de 1994"
12,7,1,354,187,170,357,"21 de agosto de 1994"
12,7,1,355,265,271,536,"21 de agosto de 1994"
12,7,1,356,422,441,863,"21 de agosto de 1994"
12,7,1,357,234,223,457,"21 de agosto de 1994"
12,7,1,358,110,107,217,"21 de agosto de 1994"
12,7,1,359,184,125,309,"21 de agosto de 1994"
12,7,1,360,100,95,195,"21 de agosto de 1994"
12,7,1,361,65,66,131,"21 de agosto de 1994"
12,7,1,362,307,323,630,"21 de agosto de 1994"
12,7,1,363,215,220,435,"21 de agosto de 1994"
12,7,1,364,354,326,680,"21 de agosto de 1994"
12,7,1,365,126,131,257,"21 de agosto de 1994"
12,7,1,366,206,209,415,"21 de agosto de 1994"
12,7,1,367,186,193,379,"21 de agosto de 1994"
12,7,1,368,550,502,1052,"21 de agosto de 1994"
12,7,1,369,166,169,335,"21 de agosto de 1994"
12,7,1,370,272,274,546,"21 de agosto de 1994"
12,7,1,371,271,292,563,"21 de agosto de 1994"
12,7,1,372,287,290,577,"21 de agosto de 1994"
12,7,1,373,509,589,1098,"21 de agosto de 1994"
12,7,1,374,544,578,1122,"21 de agosto de 1994"
12,7,1,375,142,131,273,"21 de agosto de 1994"
12,7,1,376,120,119,239,"21 de agosto de 1994"
12,7,1,377,278,260,538,"21 de agosto de 1994"
12,7,1,378,288,223,511,"21 de agosto de 1994"
12,7,1,379,372,333,705,"21 de agosto de 1994"
12,7,1,380,395,390,785,"21 de agosto de 1994"
12,7,1,381,142,122,264,"21 de agosto de 1994"
12,7,1,382,160,200,360,"21 de agosto de 1994"
12,7,1,383,277,400,677,"21 de agosto de 1994"
12,8,7,500,189,213,402,"21 de agosto de 1994"
12,8,7,501,225,280,505,"21 de agosto de 1994"
12,8,7,502,160,188,348,"21 de agosto de 1994"
12,8,7,503,245,284,529,"21 de agosto de 1994"
12,8,7,504,392,437,829,"21 de agosto de 1994"
12,8,7,505,392,410,802,"21 de agosto de 1994"
12,8,7,506,512,517,1029,"21 de agosto de 1994"
12,8,7,507,249,306,555,"21 de agosto de 1994"
12,8,7,508,101,138,239,"21 de agosto de 1994"
12,8,7,509,109,102,211,"21 de agosto de 1994"
12,8,7,510,254,265,519,"21 de agosto de 1994"
12,8,7,511,322,368,690,"21 de agosto de 1994"
12,8,7,512,196,196,392,"21 de agosto de 1994"
12,8,7,513,133,153,286,"21 de agosto de 1994"
12,8,7,514,50,62,112,"21 de agosto de 1994"
12,8,7,515,44,48,92,"21 de agosto de 1994"
12,8,7,516,37,38,75,"21 de agosto de 1994"
12,8,7,517,62,76,138,"21 de agosto de 1994"
12,8,7,518,283,335,618,"21 de agosto de 1994"
12,8,7,519,43,54,97,"21 de agosto de 1994"
12,8,7,520,45,34,79,"21 de agosto de 1994"
12,8,7,521,53,62,115,"21 de agosto de 1994"
12,8,7,522,71,72,143,"21 de agosto de 1994"
12,8,7,523,65,56,121,"21 de agosto de 1994"
12,8,7,524,119,120,239,"21 de agosto de 1994"
12,8,7,525,20,25,45,"21 de agosto de 1994"
12,8,7,526,28,19,47,"21 de agosto de 1994"
12,8,7,527,51,42,93,"21 de agosto de 1994"
12,8,7,528,80,58,138,"21 de agosto de 1994"
12,8,7,529,44,41,85,"21 de agosto de 1994"
12,8,7,530,35,30,65,"21 de agosto de 1994"
12,8,7,531,53,37,90,"21 de agosto de 1994"
12,8,7,532,56,55,111,"21 de agosto de 1994"
12,8,7,533,122,125,247,"21 de agosto de 1994"
12,8,7,534,62,58,120,"21 de agosto de 1994"
12,8,7,535,159,187,346,"21 de agosto de 1994"
12,8,7,536,52,58,110,"21 de agosto de 1994"
12,8,7,537,50,57,107,"21 de agosto de 1994"
12,8,7,538,285,291,576,"21 de agosto de 1994"
12,8,7,539,70,77,147,"21 de agosto de 1994"
12,8,7,540,84,83,167,"21 de agosto de 1994"
12,8,7,541,40,36,76,"21 de agosto de 1994"
12,8,7,542,46,45,91,"21 de agosto de 1994"
12,8,7,543,51,36,87,"21 de agosto de 1994"
12,8,7,544,56,30,86,"21 de agosto de 1994"
12,8,7,545,37,25,62,"21 de agosto de 1994"
12,8,7,546,56,48,104,"21 de agosto de 1994"
12,8,7,547,152,183,335,"21 de agosto de 1994"
12,8,7,548,42,42,84,"21 de agosto de 1994"
12,8,7,549,208,206,414,"21 de agosto de 1994"
12,8,7,550,106,108,214,"21 de agosto de 1994"
12,8,7,551,44,45,89,"21 de agosto de 1994"
12,8,7,552,147,164,311,"21 de agosto de 1994"
12,8,27,1067,162,168,330,"21 de agosto de 1994"
12,8,27,1068,281,310,591,"21 de agosto de 1994"
12,8,27,1069,293,358,651,"21 de agosto de 1994"
12,8,27,1070,272,283,555,"21 de agosto de 1994"
12,8,27,1071,110,106,216,"21 de agosto de 1994"
12,8,27,1072,122,119,241,"21 de agosto de 1994"
12,8,27,1073,37,29,66,"21 de agosto de 1994"
12,8,27,1074,64,43,107,"21 de agosto de 1994"
12,8,27,1075,35,47,82,"21 de agosto de 1994"
12,8,27,1076,39,39,78,"21 de agosto de 1994"
12,8,27,1077,47,68,115,"21 de agosto de 1994"
12,8,27,1078,29,47,76,"21 de agosto de 1994"
12,8,27,1079,43,56,99,"21 de agosto de 1994"
12,8,27,1080,56,73,129,"21 de agosto de 1994"
12,8,27,1081,256,268,524,"21 de agosto de 1994"
12,8,27,1082,81,100,181,"21 de agosto de 1994"
12,8,27,1083,71,97,168,"21 de agosto de 1994"
12,8,27,1084,309,353,662,"21 de agosto de 1994"
12,8,27,1085,41,41,82,"21 de agosto de 1994"
12,8,27,1086,176,251,427,"21 de agosto de 1994"
12,8,27,1087,163,165,328,"21 de agosto de 1994"
12,8,27,1088,65,83,148,"21 de agosto de 1994"
12,8,27,1089,52,65,117,"21 de agosto de 1994"
12,8,27,1090,29,30,59,"21 de agosto de 1994"
12,8,27,1091,52,54,106,"21 de agosto de 1994"
12,8,27,1092,119,157,276,"21 de agosto de 1994"
12,8,27,1093,59,54,113,"21 de agosto de 1994"
12,8,27,1094,108,185,293,"21 de agosto de 1994"
12,8,27,1095,95,111,206,"21 de agosto de 1994"
12,8,27,1096,88,110,198,"21 de agosto de 1994"
12,8,27,1097,62,66,128,"21 de agosto de 1994"
12,8,27,1098,191,266,457,"21 de agosto de 1994"
12,8,27,1099,65,89,154,"21 de agosto de 1994"
12,8,27,1100,137,146,283,"21 de agosto de 1994"
12,8,27,1101,70,82,152,"21 de agosto de 1994"
12,8,27,1102,108,136,244,"21 de agosto de 1994"
12,8,27,1103,111,117,228,"21 de agosto de 1994"
12,8,27,1104,303,323,626,"21 de agosto de 1994"
12,8,27,1105,68,104,172,"21 de agosto de 1994"
12,8,27,1106,133,141,274,"21 de agosto de 1994"
12,8,27,1107,76,89,165,"21 de agosto de 1994"
12,8,27,1108,72,98,170,"21 de agosto de 1994"
12,8,27,1109,244,296,540,"21 de agosto de 1994"
12,8,27,1110,62,84,146,"21 de agosto de 1994"
12,8,27,1111,176,213,389,"21 de agosto de 1994"
12,8,32,1358,269,319,588,"21 de agosto de 1994"
12,8,32,1359,112,147,259,"21 de agosto de 1994"
12,8,32,1360,33,35,68,"21 de agosto de 1994"
12,8,32,1361,187,212,399,"21 de agosto de 1994"
12,8,32,1362,105,145,250,"21 de agosto de 1994"
12,8,32,1363,47,63,110,"21 de agosto de 1994"
12,8,32,1364,87,79,166,"21 de agosto de 1994"
12,8,32,1365,31,34,65,"21 de agosto de 1994"
12,8,32,1366,47,39,86,"21 de agosto de 1994"
12,8,32,1367,60,63,123,"21 de agosto de 1994"
12,8,32,1368,29,31,60,"21 de agosto de 1994"
12,8,32,1369,47,51,98,"21 de agosto de 1994"
12,8,32,1370,59,70,129,"21 de agosto de 1994"
12,8,32,1371,44,39,83,"21 de agosto de 1994"
12,8,32,1372,83,91,174,"21 de agosto de 1994"
12,8,32,1373,27,29,56,"21 de agosto de 1994"
12,8,32,1374,42,43,85,"21 de agosto de 1994"
12,8,32,1375,66,75,141,"21 de agosto de 1994"
12,8,32,1376,68,75,143,"21 de agosto de 1994"
12,8,32,1377,73,99,172,"21 de agosto de 1994"
12,8,32,1378,38,43,81,"21 de agosto de 1994"
12,8,32,1379,20,28,48,"21 de agosto de 1994"
12,8,32,1380,54,59,113,"21 de agosto de 1994"
12,8,32,1381,35,36,71,"21 de agosto de 1994"
12,8,38,1576,364,409,773,"21 de agosto de 1994"
12,8,38,1577,214,224,438,"21 de agosto de 1994"
12,8,38,1578,56,64,120,"21 de agosto de 1994"
12,8,38,1579,61,62,123,"21 de agosto de 1994"
12,8,38,1580,115,163,278,"21 de agosto de 1994"
12,8,38,1581,40,52,92,"21 de agosto de 1994"
12,8,38,1582,85,116,201,"21 de agosto de 1994"
12,8,38,1583,50,59,109,"21 de agosto de 1994"
12,8,38,1584,101,122,223,"21 de agosto de 1994"
12,8,38,1585,95,125,220,"21 de agosto de 1994"
12,8,38,1586,44,67,111,"21 de agosto de 1994"
12,8,38,1587,95,142,237,"21 de agosto de 1994"
12,8,38,1588,120,163,283,"21 de agosto de 1994"
12,8,48,1847,250,327,577,"21 de agosto de 1994"
12,8,48,1848,68,81,149,"21 de agosto de 1994"
12,8,48,1849,47,56,103,"21 de agosto de 1994"
12,8,48,1850,49,72,121,"21 de agosto de 1994"
12,8,48,1851,55,67,122,"21 de agosto de 1994"
12,8,48,1852,87,100,187,"21 de agosto de 1994"
12,8,48,1853,23,33,56,"21 de agosto de 1994"
12,8,48,1854,21,38,59,"21 de agosto de 1994"
12,8,48,1855,56,64,120,"21 de agosto de 1994"
12,8,48,1856,27,33,60,"21 de agosto de 1994"
12,8,48,1857,31,36,67,"21 de agosto de 1994"
12,8,48,1858,18,30,48,"21 de agosto de 1994"
12,8,48,1859,38,46,84,"21 de agosto de 1994"
12,8,48,1860,52,54,106,"21 de agosto de 1994"
12,8,48,1861,61,72,133,"21 de agosto de 1994"
12,8,48,1862,31,31,62,"21 de agosto de 1994"
12,8,48,1863,30,25,55,"21 de agosto de 1994"
12,8,48,1864,49,51,100,"21 de agosto de 1994"
12,8,48,1865,36,42,78,"21 de agosto de 1994"
12,8,48,1866,48,62,110,"21 de agosto de 1994"
12,8,48,1867,62,81,143,"21 de agosto de 1994"
12,8,48,1868,25,41,66,"21 de agosto de 1994"
12,8,48,1869,93,122,215,"21 de agosto de 1994"
12,8,48,1870,39,51,90,"21 de agosto de 1994"
12,8,48,1871,35,40,75,"21 de agosto de 1994"
12,8,48,1872,37,55,92,"21 de agosto de 1994"
12,8,48,1873,32,32,64,"21 de agosto de 1994"
12,8,48,1874,31,41,72,"21 de agosto de 1994"
12,8,50,1933,442,473,915,"21 de agosto de 1994"
12,8,50,1934,245,298,543,"21 de agosto de 1994"
12,8,50,1935,175,155,330,"21 de agosto de 1994"
12,8,50,1936,237,258,495,"21 de agosto de 1994"
12,8,50,1937,93,91,184,"21 de agosto de 1994"
12,8,50,1938,88,70,158,"21 de agosto de 1994"
12,8,50,1939,105,83,188,"21 de agosto de 1994"
12,8,50,1940,72,102,174,"21 de agosto de 1994"
12,8,50,1941,88,86,174,"21 de agosto de 1994"
12,8,50,1942,68,64,132,"21 de agosto de 1994"
12,8,50,1943,32,38,70,"21 de agosto de 1994"
12,8,50,1944,175,163,338,"21 de agosto de 1994"
12,8,50,1945,249,269,518,"21 de agosto de 1994"
12,8,50,1946,57,61,118,"21 de agosto de 1994"
12,8,50,1947,67,77,144,"21 de agosto de 1994"
12,8,50,1948,45,41,86,"21 de agosto de 1994"
12,8,50,1949,72,71,143,"21 de agosto de 1994"
12,8,56,2134,316,373,689,"21 de agosto de 1994"
12,8,56,2135,476,443,919,"21 de agosto de 1994"
12,8,56,2136,304,313,617,"21 de agosto de 1994"
12,8,56,2137,539,549,1088,"21 de agosto de 1994"
12,8,56,2138,483,495,978,"21 de agosto de 1994"
12,8,56,2139,507,546,1053,"21 de agosto de 1994"
12,8,56,2140,509,580,1089,"21 de agosto de 1994"
12,8,56,2141,342,382,724,"21 de agosto de 1994"
12,8,56,2142,518,526,1044,"21 de agosto de 1994"
12,8,56,2143,346,352,698,"21 de agosto de 1994"
12,8,56,2144,389,422,811,"21 de agosto de 1994"
12,8,56,2145,372,379,751,"21 de agosto de 1994"
12,8,56,2146,260,286,546,"21 de agosto de 1994"
12,8,56,2147,395,440,835,"21 de agosto de 1994"
12,8,56,2148,395,396,791,"21 de agosto de 1994"
12,8,56,2149,323,360,683,"21 de agosto de 1994"
12,8,56,2150,263,270,533,"21 de agosto de 1994"
12,8,56,2151,324,386,710,"21 de agosto de 1994"
12,8,56,2152,265,329,594,"21 de agosto de 1994"
12,8,56,2153,600,643,1243,"21 de agosto de 1994"
12,8,56,2154,346,430,776,"21 de agosto de 1994"
12,8,56,2155,576,685,1261,"21 de agosto de 1994"
12,8,56,2156,240,281,521,"21 de agosto de 1994"
12,8,56,2157,219,237,456,"21 de agosto de 1994"
12,8,56,2158,460,504,964,"21 de agosto de 1994"
12,8,56,2159,441,472,913,"21 de agosto de 1994"
12,8,56,2160,323,399,722,"21 de agosto de 1994"
12,8,56,2161,338,389,727,"21 de agosto de 1994"
12,8,56,2162,399,395,794,"21 de agosto de 1994"
12,8,56,2163,193,201,394,"21 de agosto de 1994"
12,8,56,2164,513,572,1085,"21 de agosto de 1994"
12,8,56,2165,93,98,191,"21 de agosto de 1994"
12,8,56,2166,207,205,412,"21 de agosto de 1994"
12,8,56,2167,107,97,204,"21 de agosto de 1994"
12,8,56,2168,320,299,619,"21 de agosto de 1994"
12,8,56,2169,423,405,828,"21 de agosto de 1994"
12,8,56,2170,61,54,115,"21 de agosto de 1994"
12,8,56,2171,38,34,72,"21 de agosto de 1994"
12,8,56,2172,30,30,60,"21 de agosto de 1994"
12,8,56,2173,37,53,90,"21 de agosto de 1994"
12,8,56,2174,40,39,79,"21 de agosto de 1994"
12,8,56,2175,91,99,190,"21 de agosto de 1994"
12,8,56,2176,38,35,73,"21 de agosto de 1994"
12,8,56,2177,185,192,377,"21 de agosto de 1994"
12,8,56,2178,113,102,215,"21 de agosto de 1994"
12,8,56,2179,53,52,105,"21 de agosto de 1994"
12,8,56,2180,201,201,402,"21 de agosto de 1994"
12,8,56,2181,118,121,239,"21 de agosto de 1994"
12,8,56,2182,292,298,590,"21 de agosto de 1994"
12,8,56,2183,125,142,267,"21 de agosto de 1994"
12,8,56,2184,143,152,295,"21 de agosto de 1994"
12,8,56,2185,132,139,271,"21 de agosto de 1994"
12,8,56,2186,46,58,104,"21 de agosto de 1994"
12,8,56,2187,33,32,65,"21 de agosto de 1994"
12,8,56,2188,27,31,58,"21 de agosto de 1994"
12,8,56,2189,45,54,99,"21 de agosto de 1994"
12,8,56,2190,81,93,174,"21 de agosto de 1994"
12,8,56,2191,383,373,756,"21 de agosto de 1994"
12,8,56,2192,108,123,231,"21 de agosto de 1994"
12,8,56,2193,119,131,250,"21 de agosto de 1994"
12,8,56,2194,147,158,305,"21 de agosto de 1994"
12,8,56,2195,573,552,1125,"21 de agosto de 1994"
12,8,56,2196,274,292,566,"21 de agosto de 1994"
12,8,56,2197,114,89,203,"21 de agosto de 1994"
12,8,56,2198,143,130,273,"21 de agosto de 1994"
12,8,56,2199,159,170,329,"21 de agosto de 1994"
12,8,56,2200,83,93,176,"21 de agosto de 1994"
12,8,56,2201,191,209,400,"21 de agosto de 1994"
12,8,56,2202,27,28,55,"21 de agosto de 1994"
12,8,56,2203,313,292,605,"21 de agosto de 1994"
12,8,56,2204,152,182,334,"21 de agosto de 1994"
12,8,56,2205,296,324,620,"21 de agosto de 1994"
12,8,56,2206,232,197,429,"21 de agosto de 1994"
12,8,56,2207,383,360,743,"21 de agosto de 1994"
12,8,56,2208,478,301,779,"21 de agosto de 1994"
12,8,56,2209,204,235,439,"21 de agosto de 1994"
12,8,56,2210,186,139,325,"21 de agosto de 1994"
12,8,56,2211,126,148,274,"21 de agosto de 1994"
12,8,56,2212,97,79,176,"21 de agosto de 1994"
12,8,56,2213,254,366,620,"21 de agosto de 1994"
12,8,56,2214,26,40,66,"21 de agosto de 1994"
12,8,56,2215,153,235,388,"21 de agosto de 1994"
12,8,56,2216,74,126,200,"21 de agosto de 1994"
12,8,56,2217,144,211,355,"21 de agosto de 1994"
12,8,56,2218,101,114,215,"21 de agosto de 1994"
12,8,56,2219,135,186,321,"21 de agosto de 1994"
12,8,56,2220,74,104,178,"21 de agosto de 1994"
12,8,56,2221,89,128,217,"21 de agosto de 1994"
12,8,56,2222,423,381,804,"21 de agosto de 1994"
12,8,61,2451,185,221,406,"21 de agosto de 1994"
12,8,61,2452,250,239,489,"21 de agosto de 1994"
12,8,61,2453,73,74,147,"21 de agosto de 1994"
12,8,61,2454,38,52,90,"21 de agosto de 1994"
12,8,61,2455,55,42,97,"21 de agosto de 1994"
12,8,61,2456,146,146,292,"21 de agosto de 1994"
12,8,61,2457,93,91,184,"21 de agosto de 1994"
12,8,61,2458,79,66,145,"21 de agosto de 1994"
12,8,61,2459,26,22,48,"21 de agosto de 1994"
12,8,61,2460,133,127,260,"21 de agosto de 1994"
12,8,61,2461,40,39,79,"21 de agosto de 1994"
12,8,61,2462,34,27,61,"21 de agosto de 1994"
12,8,61,2463,113,109,222,"21 de agosto de 1994"
12,8,61,2464,122,125,247,"21 de agosto de 1994"
12,8,61,2465,30,24,54,"21 de agosto de 1994"
12,8,61,2466,63,52,115,"21 de agosto de 1994"
12,8,61,2467,19,16,35,"21 de agosto de 1994"
12,8,61,2468,86,98,184,"21 de agosto de 1994"
12,8,61,2469,47,39,86,"21 de agosto de 1994"
12,8,61,2470,37,31,68,"21 de agosto de 1994"
12,8,61,2471,128,142,270,"21 de agosto de 1994"
12,8,61,2472,138,119,257,"21 de agosto de 1994"
12,8,61,2473,59,45,104,"21 de agosto de 1994"
12,8,61,2474,274,291,565,"21 de agosto de 1994"
12,8,61,2475,170,141,311,"21 de agosto de 1994"
12,8,61,2476,209,240,449,"21 de agosto de 1994"
12,8,61,2477,75,87,162,"21 de agosto de 1994"
12,8,61,2478,56,58,114,"21 de agosto de 1994"
12,8,65,2533,184,193,377,"21 de agosto de 1994"
12,8,65,2534,326,320,646,"21 de agosto de 1994"
12,8,65,2535,261,283,544,"21 de agosto de 1994"
12,8,65,2536,152,162,314,"21 de agosto de 1994"
12,8,65,2537,265,273,538,"21 de agosto de 1994"
12,8,65,2538,42,48,90,"21 de agosto de 1994"
12,8,65,2539,25,27,52,"21 de agosto de 1994"
12,8,65,2540,65,74,139,"21 de agosto de 1994"
12,8,65,2541,97,100,197,"21 de agosto de 1994"
12,8,65,2542,398,433,831,"21 de agosto de 1994"
12,8,65,2543,28,25,53,"21 de agosto de 1994"
12,8,65,2544,71,72,143,"21 de agosto de 1994"
12,8,65,2545,60,85,145,"21 de agosto de 1994"
12,8,65,2546,104,94,198,"21 de agosto de 1994"
12,8,65,2547,75,72,147,"21 de agosto de 1994"
12,8,65,2548,89,84,173,"21 de agosto de 1994"
12,8,65,2549,42,57,99,"21 de agosto de 1994"
12,8,65,2550,187,289,476,"21 de agosto de 1994"
12,8,65,2551,299,326,625,"21 de agosto de 1994"
12,8,65,2552,43,34,77,"21 de agosto de 1994"
12,8,65,2553,180,295,475,"21 de agosto de 1994"
12,8,68,2600,560,632,1192,"21 de agosto de 1994"
12,8,68,2601,360,437,797,"21 de agosto de 1994"
12,8,68,2602,349,411,760,"21 de agosto de 1994"
12,8,68,2603,26,32,58,"21 de agosto de 1994"
12,8,68,2604,304,372,676,"21 de agosto de 1994"
12,8,68,2605,165,173,338,"21 de agosto de 1994"
12,8,68,2606,140,180,320,"21 de agosto de 1994"
12,8,68,2607,293,384,677,"21 de agosto de 1994"
12,8,68,2608,57,71,128,"21 de agosto de 1994"
12,8,68,2609,87,93,180,"21 de agosto de 1994"
12,8,68,2610,165,198,363,"21 de agosto de 1994"
12,8,68,2611,355,422,777,"21 de agosto de 1994"
12,8,68,2612,284,330,614,"21 de agosto de 1994"
12,8,68,2613,156,243,399,"21 de agosto de 1994"
12,8,68,2614,265,346,611,"21 de agosto de 1994"
12,8,68,2615,300,433,733,"21 de agosto de 1994"
12,8,68,2616,182,229,411,"21 de agosto de 1994"
12,8,68,2617,88,112,200,"21 de agosto de 1994"
12,8,68,2618,58,65,123,"21 de agosto de 1994"
12,8,68,2619,55,71,126,"21 de agosto de 1994"
12,8,68,2620,44,52,96,"21 de agosto de 1994"
12,8,68,2621,51,61,112,"21 de agosto de 1994"
12,9,11,596,187,199,386,"21 de agosto de 1994"
12,9,11,597,121,143,264,"21 de agosto de 1994"
12,9,11,598,186,220,406,"21 de agosto de 1994"
12,9,11,599,347,404,751,"21 de agosto de 1994"
12,9,11,600,134,189,323,"21 de agosto de 1994"
12,9,11,601,533,35,568,"21 de agosto de 1994"
12,9,11,602,279,322,601,"21 de agosto de 1994"
12,9,11,603,201,197,398,"21 de agosto de 1994"
12,9,11,604,316,404,720,"21 de agosto de 1994"
12,9,11,605,200,231,431,"21 de agosto de 1994"
12,9,11,606,283,333,616,"21 de agosto de 1994"
12,9,11,607,286,307,593,"21 de agosto de 1994"
12,9,11,608,249,291,540,"21 de agosto de 1994"
12,9,11,609,239,261,500,"21 de agosto de 1994"
12,9,11,610,166,195,361,"21 de agosto de 1994"
12,9,11,611,246,292,538,"21 de agosto de 1994"
12,9,11,612,126,96,222,"21 de agosto de 1994"
12,9,11,613,140,112,252,"21 de agosto de 1994"
12,9,11,614,30,27,57,"21 de agosto de 1994"
12,9,11,615,72,49,121,"21 de agosto de 1994"
12,9,11,616,45,31,76,"21 de agosto de 1994"
12,9,11,617,35,32,67,"21 de agosto de 1994"
12,9,11,618,33,20,53,"21 de agosto de 1994"
12,9,11,619,156,118,274,"21 de agosto de 1994"
12,9,11,620,83,75,158,"21 de agosto de 1994"
12,9,11,621,255,253,508,"21 de agosto de 1994"
12,9,11,622,253,224,477,"21 de agosto de 1994"
12,9,11,623,254,254,508,"21 de agosto de 1994"
12,9,11,624,320,304,624,"21 de agosto de 1994"
12,9,11,625,38,29,67,"21 de agosto de 1994"
12,9,11,626,99,83,182,"21 de agosto de 1994"
12,9,11,627,301,298,599,"21 de agosto de 1994"
12,9,11,628,68,66,134,"21 de agosto de 1994"
12,9,11,629,42,35,77,"21 de agosto de 1994"
12,9,11,630,167,157,324,"21 de agosto de 1994"
12,9,11,631,165,145,310,"21 de agosto de 1994"
12,9,11,632,159,144,303,"21 de agosto de 1994"
12,9,11,633,144,141,285,"21 de agosto de 1994"
12,9,11,634,87,82,169,"21 de agosto de 1994"
12,9,11,635,33,27,60,"21 de agosto de 1994"
12,9,11,636,65,56,121,"21 de agosto de 1994"
12,9,11,637,172,169,341,"21 de agosto de 1994"
12,9,11,638,94,101,195,"21 de agosto de 1994"
12,9,11,639,196,212,408,"21 de agosto de 1994"
12,9,11,640,105,103,208,"21 de agosto de 1994"
12,9,11,641,134,146,280,"21 de agosto de 1994"
12,9,11,642,92,72,164,"21 de agosto de 1994"
12,9,11,643,56,45,101,"21 de agosto de 1994"
12,9,11,644,77,69,146,"21 de agosto de 1994"
12,9,11,645,100,103,203,"21 de agosto de 1994"
12,9,11,646,238,296,534,"21 de agosto de 1994"
12,9,11,647,311,297,608,"21 de agosto de 1994"
12,9,11,648,41,33,74,"21 de agosto de 1994"
12,9,11,649,48,50,98,"21 de agosto de 1994"
12,9,11,650,317,289,606,"21 de agosto de 1994"
12,9,11,651,39,28,67,"21 de agosto de 1994"
12,9,11,652,93,63,156,"21 de agosto de 1994"
12,9,11,653,140,128,268,"21 de agosto de 1994"
12,9,11,654,80,80,160,"21 de agosto de 1994"
12,9,11,655,60,74,134,"21 de agosto de 1994"
12,9,11,656,64,67,131,"21 de agosto de 1994"
12,9,11,657,467,442,909,"21 de agosto de 1994"
12,9,11,658,170,166,336,"21 de agosto de 1994"
12,9,11,659,372,414,786,"21 de agosto de 1994"
12,9,11,660,76,61,137,"21 de agosto de 1994"
12,9,11,661,216,235,451,"21 de agosto de 1994"
12,9,11,662,126,144,270,"21 de agosto de 1994"
12,9,11,663,291,352,643,"21 de agosto de 1994"
12,9,11,664,312,295,607,"21 de agosto de 1994"
12,9,11,665,346,383,729,"21 de agosto de 1994"
12,9,11,666,51,53,104,"21 de agosto de 1994"
12,9,11,667,132,148,280,"21 de agosto de 1994"
12,9,11,668,195,257,452,"21 de agosto de 1994"
12,9,11,669,336,379,715,"21 de agosto de 1994"
12,9,11,670,362,417,779,"21 de agosto de 1994"
12,9,14,763,375,386,761,"21 de agosto de 1994"
12,9,14,764,312,352,664,"21 de agosto de 1994"
12,9,14,765,364,347,711,"21 de agosto de 1994"
12,9,14,766,445,449,894,"21 de agosto de 1994"
12,9,14,767,242,269,511,"21 de agosto de 1994"
12,9,14,768,47,46,93,"21 de agosto de 1994"
12,9,14,769,70,58,128,"21 de agosto de 1994"
12,9,14,770,326,348,674,"21 de agosto de 1994"
12,9,14,771,67,58,125,"21 de agosto de 1994"
12,9,14,772,156,156,312,"21 de agosto de 1994"
12,9,14,773,425,448,873,"21 de agosto de 1994"
12,9,14,774,435,417,852,"21 de agosto de 1994"
12,9,14,775,303,326,629,"21 de agosto de 1994"
12,9,14,776,299,339,638,"21 de agosto de 1994"
12,9,14,777,106,97,203,"21 de agosto de 1994"
12,9,39,1589,289,299,588,"21 de agosto de 1994"
12,9,39,1590,617,660,1277,"21 de agosto de 1994"
12,9,39,1591,224,256,480,"21 de agosto de 1994"
12,9,39,1592,399,358,757,"21 de agosto de 1994"
12,9,39,1593,325,321,646,"21 de agosto de 1994"
12,9,39,1594,510,476,986,"21 de agosto de 1994"
12,9,39,1595,238,237,475,"21 de agosto de 1994"
12,9,39,1596,148,131,279,"21 de agosto de 1994"
12,9,39,1597,170,173,343,"21 de agosto de 1994"
12,9,39,1598,204,162,366,"21 de agosto de 1994"
12,9,39,1599,236,233,469,"21 de agosto de 1994"
12,9,39,1600,288,277,565,"21 de agosto de 1994"
12,9,39,1601,222,221,443,"21 de agosto de 1994"
12,9,39,1602,153,160,313,"21 de agosto de 1994"
12,9,39,1603,247,269,516,"21 de agosto de 1994"
12,9,39,1604,140,177,317,"21 de agosto de 1994"
12,9,39,1605,224,282,506,"21 de agosto de 1994"
12,9,39,1606,273,271,544,"21 de agosto de 1994"
12,9,39,1607,306,292,598,"21 de agosto de 1994"
12,9,39,1608,359,286,645,"21 de agosto de 1994"
12,9,39,1609,506,544,1050,"21 de agosto de 1994"
12,9,39,1610,348,331,679,"21 de agosto de 1994"
12,9,39,1611,422,408,830,"21 de agosto de 1994"
12,9,39,1612,326,333,659,"21 de agosto de 1994"
12,9,39,1613,334,379,713,"21 de agosto de 1994"
12,9,39,1614,263,300,563,"21 de agosto de 1994"
12,9,39,1615,263,273,536,"21 de agosto de 1994"
12,9,39,1616,259,288,547,"21 de agosto de 1994"
12,9,39,1617,405,450,855,"21 de agosto de 1994"
12,9,39,1618,121,126,247,"21 de agosto de 1994"
12,9,39,1619,397,446,843,"21 de agosto de 1994"
12,9,39,1620,273,261,534,"21 de agosto de 1994"
12,9,39,1621,158,148,306,"21 de agosto de 1994"
12,9,39,1622,119,106,225,"21 de agosto de 1994"
12,9,39,1623,107,40,147,"21 de agosto de 1994"
12,9,39,1624,174,190,364,"21 de agosto de 1994"
12,9,39,1625,247,224,471,"21 de agosto de 1994"
12,9,39,1626,91,83,174,"21 de agosto de 1994"
12,9,39,1627,126,82,208,"21 de agosto de 1994"
12,9,39,1628,519,445,964,"21 de agosto de 1994"
12,9,39,1629,223,183,406,"21 de agosto de 1994"
12,9,39,1630,51,42,93,"21 de agosto de 1994"
12,9,39,1631,90,85,175,"21 de agosto de 1994"
12,9,39,1632,127,113,240,"21 de agosto de 1994"
12,9,39,1633,96,95,191,"21 de agosto de 1994"
12,9,39,1634,28,25,53,"21 de agosto de 1994"
12,9,39,1635,335,377,712,"21 de agosto de 1994"
12,9,39,1636,379,349,728,"21 de agosto de 1994"
12,9,39,1637,77,66,143,"21 de agosto de 1994"
12,9,39,1638,278,274,552,"21 de agosto de 1994"
12,9,39,1639,145,146,291,"21 de agosto de 1994"
12,9,39,1640,249,249,498,"21 de agosto de 1994"
12,9,39,1641,424,451,875,"21 de agosto de 1994"
12,9,39,1642,113,101,214,"21 de agosto de 1994"
12,9,39,1643,102,103,205,"21 de agosto de 1994"
12,9,39,1644,228,214,442,"21 de agosto de 1994"
12,9,39,1645,100,107,207,"21 de agosto de 1994"
12,9,39,1646,351,334,685,"21 de agosto de 1994"
12,9,39,1647,424,403,827,"21 de agosto de 1994"
12,9,39,1648,416,424,840,"21 de agosto de 1994"
12,9,39,1649,236,199,435,"21 de agosto de 1994"
12,9,39,1650,162,159,321,"21 de agosto de 1994"
12,9,39,1651,144,175,319,"21 de agosto de 1994"
12,9,39,1652,169,165,334,"21 de agosto de 1994"
12,9,39,1653,210,210,420,"21 de agosto de 1994"
12,9,49,1875,306,277,583,"21 de agosto de 1994"
12,9,49,1876,620,76,696,"21 de agosto de 1994"
12,9,49,1877,295,295,590,"21 de agosto de 1994"
12,9,49,1878,217,252,469,"21 de agosto de 1994"
12,9,49,1879,278,317,595,"21 de agosto de 1994"
12,9,49,1880,173,188,361,"21 de agosto de 1994"
12,9,49,1881,213,249,462,"21 de agosto de 1994"
12,9,49,1882,230,243,473,"21 de agosto de 1994"
12,9,49,1883,270,254,524,"21 de agosto de 1994"
12,9,49,1884,229,210,439,"21 de agosto de 1994"
12,9,49,1885,193,188,381,"21 de agosto de 1994"
12,9,49,1886,296,253,549,"21 de agosto de 1994"
12,9,49,1887,537,596,1133,"21 de agosto de 1994"
12,9,49,1888,348,352,700,"21 de agosto de 1994"
12,9,49,1889,262,282,544,"21 de agosto de 1994"
12,9,49,1890,77,51,128,"21 de agosto de 1994"
12,9,49,1891,39,22,61,"21 de agosto de 1994"
12,9,49,1892,65,49,114,"21 de agosto de 1994"
12,9,49,1893,50,43,93,"21 de agosto de 1994"
12,9,49,1894,156,121,277,"21 de agosto de 1994"
12,9,49,1895,75,51,126,"21 de agosto de 1994"
12,9,49,1896,73,53,126,"21 de agosto de 1994"
12,9,49,1897,133,124,257,"21 de agosto de 1994"
12,9,49,1898,116,95,211,"21 de agosto de 1994"
12,9,49,1899,48,36,84,"21 de agosto de 1994"
12,9,49,1900,99,75,174,"21 de agosto de 1994"
12,9,49,1901,59,48,107,"21 de agosto de 1994"
12,9,49,1902,150,96,246,"21 de agosto de 1994"
12,9,49,1903,216,150,366,"21 de agosto de 1994"
12,9,49,1904,74,55,129,"21 de agosto de 1994"
12,9,49,1905,46,29,75,"21 de agosto de 1994"
12,9,49,1906,70,66,136,"21 de agosto de 1994"
12,9,49,1907,271,217,488,"21 de agosto de 1994"
12,9,49,1908,112,89,201,"21 de agosto de 1994"
12,9,49,1909,304,321,625,"21 de agosto de 1994"
12,9,49,1910,281,276,557,"21 de agosto de 1994"
12,9,49,1911,306,312,618,"21 de agosto de 1994"
12,9,49,1912,352,380,732,"21 de agosto de 1994"
12,9,49,1913,322,291,613,"21 de agosto de 1994"
12,9,49,1914,70,53,123,"21 de agosto de 1994"
12,9,49,1915,131,106,237,"21 de agosto de 1994"
12,9,49,1916,40,33,73,"21 de agosto de 1994"
12,9,49,1917,188,149,337,"21 de agosto de 1994"
12,9,49,1918,65,43,108,"21 de agosto de 1994"
12,9,49,1919,29,23,52,"21 de agosto de 1994"
12,9,49,1920,160,136,296,"21 de agosto de 1994"
12,9,49,1921,79,61,140,"21 de agosto de 1994"
12,9,49,1922,40,21,61,"21 de agosto de 1994"
12,9,49,1923,32,25,57,"21 de agosto de 1994"
12,9,49,1924,41,53,94,"21 de agosto de 1994"
12,9,49,1925,174,154,328,"21 de agosto de 1994"
12,9,49,1926,128,128,256,"21 de agosto de 1994"
12,9,49,1927,72,64,136,"21 de agosto de 1994"
12,9,49,1928,92,66,158,"21 de agosto de 1994"
12,9,49,1929,474,464,938,"21 de agosto de 1994"
12,9,49,1930,110,102,212,"21 de agosto de 1994"
12,9,49,1931,165,136,301,"21 de agosto de 1994"
12,9,49,1932,77,57,134,"21 de agosto de 1994"
12,9,58,2262,196,186,382,"21 de agosto de 1994"
12,9,58,2263,393,404,797,"21 de agosto de 1994"
12,9,58,2264,394,380,774,"21 de agosto de 1994"
12,9,58,2265,379,342,721,"21 de agosto de 1994"
12,9,58,2266,428,412,840,"21 de agosto de 1994"
12,9,58,2267,318,305,623,"21 de agosto de 1994"
12,9,58,2268,459,465,924,"21 de agosto de 1994"
12,9,58,2269,442,460,902,"21 de agosto de 1994"
12,9,58,2270,500,493,993,"21 de agosto de 1994"
12,9,58,2271,387,353,740,"21 de agosto de 1994"
12,9,58,2272,188,221,409,"21 de agosto de 1994"
12,9,58,2273,199,187,386,"21 de agosto de 1994"
12,9,58,2274,262,273,535,"21 de agosto de 1994"
12,9,58,2275,77,37,114,"21 de agosto de 1994"
12,9,58,2276,169,105,274,"21 de agosto de 1994"
12,9,58,2277,278,198,476,"21 de agosto de 1994"
12,9,58,2278,79,58,137,"21 de agosto de 1994"
12,9,58,2279,96,44,140,"21 de agosto de 1994"
12,9,58,2280,118,86,204,"21 de agosto de 1994"
12,9,58,2281,63,66,129,"21 de agosto de 1994"
12,9,58,2282,32,27,59,"21 de agosto de 1994"
12,9,58,2283,85,39,124,"21 de agosto de 1994"
12,9,58,2284,26,33,59,"21 de agosto de 1994"
12,9,58,2285,179,115,294,"21 de agosto de 1994"
12,9,58,2286,149,123,272,"21 de agosto de 1994"
12,9,58,2287,52,45,97,"21 de agosto de 1994"
12,9,58,2288,22,14,36,"21 de agosto de 1994"
12,9,58,2289,134,166,300,"21 de agosto de 1994"
12,9,58,2290,126,88,214,"21 de agosto de 1994"
12,9,58,2291,80,68,148,"21 de agosto de 1994"
12,9,58,2292,363,348,711,"21 de agosto de 1994"
12,9,58,2293,215,197,412,"21 de agosto de 1994"
12,9,58,2294,229,210,439,"21 de agosto de 1994"
12,9,58,2295,58,53,111,"21 de agosto de 1994"
12,9,58,2296,53,41,94,"21 de agosto de 1994"
12,9,58,2297,43,26,69,"21 de agosto de 1994"
12,9,58,2298,88,63,151,"21 de agosto de 1994"
12,9,58,2299,58,45,103,"21 de agosto de 1994"
12,9,58,2300,167,149,316,"21 de agosto de 1994"
12,9,58,2301,60,35,95,"21 de agosto de 1994"
12,9,58,2302,128,119,247,"21 de agosto de 1994"
12,9,58,2303,112,107,219,"21 de agosto de 1994"
12,9,58,2304,220,229,449,"21 de agosto de 1994"
12,9,58,2305,252,253,505,"21 de agosto de 1994"
12,9,58,2306,333,335,668,"21 de agosto de 1994"
12,9,58,2307,191,183,374,"21 de agosto de 1994"
12,9,58,2308,341,315,656,"21 de agosto de 1994"
12,9,58,2309,279,258,537,"21 de agosto de 1994"
12,9,58,2310,413,384,797,"21 de agosto de 1994"
12,9,58,2311,61,67,128,"21 de agosto de 1994"
12,9,58,2312,94,79,173,"21 de agosto de 1994"
12,9,58,2313,217,188,405,"21 de agosto de 1994"
12,9,58,2314,70,51,121,"21 de agosto de 1994"
12,9,58,2315,40,32,72,"21 de agosto de 1994"
12,9,58,2316,55,60,115,"21 de agosto de 1994"
12,9,58,2317,146,132,278,"21 de agosto de 1994"
12,9,58,2318,52,39,91,"21 de agosto de 1994"
12,9,58,2319,228,177,405,"21 de agosto de 1994"
12,9,58,2320,202,171,373,"21 de agosto de 1994"
12,9,58,2321,159,138,297,"21 de agosto de 1994"
12,9,58,2322,47,50,97,"21 de agosto de 1994"
12,9,58,2323,309,308,617,"21 de agosto de 1994"
12,9,58,2324,308,326,634,"21 de agosto de 1994"
12,9,58,2325,55,58,113,"21 de agosto de 1994"
12,9,58,2326,269,268,537,"21 de agosto de 1994"
12,9,58,2327,249,233,482,"21 de agosto de 1994"
12,9,58,2328,365,345,710,"21 de agosto de 1994"
12,9,58,2329,95,72,167,"21 de agosto de 1994"
12,9,58,2330,581,569,1150,"21 de agosto de 1994"
12,9,69,2622,399,381,780,"21 de agosto de 1994"
12,9,69,2623,258,244,502,"21 de agosto de 1994"
12,9,69,2624,242,219,461,"21 de agosto de 1994"
12,9,69,2625,79,64,143,"21 de agosto de 1994"
12,9,69,2626,118,119,237,"21 de agosto de 1994"
12,9,69,2627,98,78,176,"21 de agosto de 1994"
12,9,69,2628,97,65,162,"21 de agosto de 1994"
12,9,69,2629,152,129,281,"21 de agosto de 1994"
12,9,69,2630,170,148,318,"21 de agosto de 1994"
12,9,69,2631,73,51,124,"21 de agosto de 1994"
12,9,69,2632,207,197,404,"21 de agosto de 1994"
12,9,69,2633,68,53,121,"21 de agosto de 1994"
12,9,69,2634,157,156,313,"21 de agosto de 1994"
12,9,69,2635,160,144,304,"21 de agosto de 1994"
12,9,69,2636,415,396,811,"21 de agosto de 1994"
12,9,69,2637,127,100,227,"21 de agosto de 1994"
12,9,69,2638,159,129,288,"21 de agosto de 1994"
12,9,69,2639,367,298,665,"21 de agosto de 1994"
12,9,69,2640,309,265,574,"21 de agosto de 1994"
12,9,69,2641,463,393,856,"21 de agosto de 1994"
12,9,69,2642,370,323,693,"21 de agosto de 1994"
12,9,69,2643,237,200,437,"21 de agosto de 1994"
12,9,69,2644,83,76,159,"21 de agosto de 1994"
12,9,69,2645,80,64,144,"21 de agosto de 1994"
12,9,69,2646,97,72,169,"21 de agosto de 1994"
12,9,69,2647,163,126,289,"21 de agosto de 1994"
12,9,69,2648,187,166,353,"21 de agosto de 1994"
12,9,69,2649,63,63,126,"21 de agosto de 1994"
12,9,69,2650,62,54,116,"21 de agosto de 1994"
12,9,69,2651,200,181,381,"21 de agosto de 1994"
12,9,69,2652,57,49,106,"21 de agosto de 1994"
12,9,69,2653,115,85,200,"21 de agosto de 1994"
12,9,69,2654,396,371,767,"21 de agosto de 1994"
12,10,2,384,637,652,1289,"21 de agosto de 1994"
12,10,2,385,184,189,373,"21 de agosto de 1994"
12,10,2,386,159,188,347,"21 de agosto de 1994"
12,10,2,387,110,113,223,"21 de agosto de 1994"
12,10,2,388,82,78,160,"21 de agosto de 1994"
12,10,2,389,167,173,340,"21 de agosto de 1994"
12,10,2,390,91,83,174,"21 de agosto de 1994"
12,10,2,391,273,255,528,"21 de agosto de 1994"
12,10,2,392,51,52,103,"21 de agosto de 1994"
12,10,2,393,147,137,284,"21 de agosto de 1994"
12,10,2,394,65,81,146,"21 de agosto de 1994"
12,10,2,395,95,104,199,"21 de agosto de 1994"
12,10,2,396,47,57,104,"21 de agosto de 1994"
12,10,2,397,95,95,190,"21 de agosto de 1994"
12,10,2,398,86,127,213,"21 de agosto de 1994"
12,10,2,399,74,83,157,"21 de agosto de 1994"
12,10,2,400,145,144,289,"21 de agosto de 1994"
12,10,2,401,82,105,187,"21 de agosto de 1994"
12,10,2,402,87,113,200,"21 de agosto de 1994"
12,10,2,403,237,310,547,"21 de agosto de 1994"
12,10,2,404,101,130,231,"21 de agosto de 1994"
12,10,2,405,204,221,425,"21 de agosto de 1994"
12,10,2,406,126,172,298,"21 de agosto de 1994"
12,10,2,407,45,54,99,"21 de agosto de 1994"
12,10,2,408,222,306,528,"21 de agosto de 1994"
12,10,2,409,294,281,575,"21 de agosto de 1994"
12,10,2,410,44,38,82,"21 de agosto de 1994"
12,10,8,553,252,282,534,"21 de agosto de 1994"
12,10,8,554,273,334,607,"21 de agosto de 1994"
12,10,8,555,109,135,244,"21 de agosto de 1994"
12,10,8,556,128,142,270,"21 de agosto de 1994"
12,10,8,557,147,170,317,"21 de agosto de 1994"
12,10,8,558,23,31,54,"21 de agosto de 1994"
12,10,8,559,72,78,150,"21 de agosto de 1994"
12,10,8,560,182,205,387,"21 de agosto de 1994"
12,10,8,561,166,162,328,"21 de agosto de 1994"
12,10,8,562,204,221,425,"21 de agosto de 1994"
12,10,8,563,167,166,333,"21 de agosto de 1994"
12,10,19,858,674,662,1336,"21 de agosto de 1994"
12,10,19,859,503,581,1084,"21 de agosto de 1994"
12,10,19,860,69,72,141,"21 de agosto de 1994"
12,10,19,861,84,73,157,"21 de agosto de 1994"
12,10,19,862,345,356,701,"21 de agosto de 1994"
12,10,19,863,113,119,232,"21 de agosto de 1994"
12,10,19,864,105,117,222,"21 de agosto de 1994"
12,10,19,865,176,214,390,"21 de agosto de 1994"
12,10,19,866,90,85,175,"21 de agosto de 1994"
12,10,19,867,232,221,453,"21 de agosto de 1994"
12,10,24,1030,404,496,900,"21 de agosto de 1994"
12,10,24,1031,158,125,283,"21 de agosto de 1994"
12,10,24,1032,39,38,77,"21 de agosto de 1994"
12,10,24,1033,241,249,490,"21 de agosto de 1994"
12,10,24,1034,156,129,285,"21 de agosto de 1994"
12,10,24,1035,103,94,197,"21 de agosto de 1994"
12,10,24,1036,175,193,368,"21 de agosto de 1994"
12,10,28,1112,252,306,558,"21 de agosto de 1994"
12,10,28,1113,280,290,570,"21 de agosto de 1994"
12,10,28,1114,374,397,771,"21 de agosto de 1994"
12,10,28,1115,468,573,1041,"21 de agosto de 1994"
12,10,28,1116,276,331,607,"21 de agosto de 1994"
12,10,28,1117,332,387,719,"21 de agosto de 1994"
12,10,28,1118,299,356,655,"21 de agosto de 1994"
12,10,28,1119,274,326,600,"21 de agosto de 1994"
12,10,28,1120,344,414,758,"21 de agosto de 1994"
12,10,28,1121,486,539,1025,"21 de agosto de 1994"
12,10,28,1122,287,305,592,"21 de agosto de 1994"
12,10,28,1123,242,260,502,"21 de agosto de 1994"
12,10,28,1124,204,226,430,"21 de agosto de 1994"
12,10,28,1125,143,160,303,"21 de agosto de 1994"
12,10,28,1126,342,326,668,"21 de agosto de 1994"
12,10,28,1127,116,171,287,"21 de agosto de 1994"
12,10,28,1128,286,344,630,"21 de agosto de 1994"
12,10,28,1129,310,328,638,"21 de agosto de 1994"
12,10,28,1130,105,116,221,"21 de agosto de 1994"
12,10,28,1131,161,129,290,"21 de agosto de 1994"
12,10,28,1132,290,322,612,"21 de agosto de 1994"
12,10,28,1133,157,181,338,"21 de agosto de 1994"
12,10,28,1134,100,104,204,"21 de agosto de 1994"
12,10,28,1135,270,299,569,"21 de agosto de 1994"
12,10,28,1136,186,238,424,"21 de agosto de 1994"
12,10,28,1137,68,94,162,"21 de agosto de 1994"
12,10,28,1138,100,117,217,"21 de agosto de 1994"
12,10,28,1139,155,193,348,"21 de agosto de 1994"
12,10,28,1140,91,121,212,"21 de agosto de 1994"
12,10,28,1141,65,74,139,"21 de agosto de 1994"
12,10,28,1142,114,136,250,"21 de agosto de 1994"
12,10,28,1143,133,154,287,"21 de agosto de 1994"
12,10,28,1144,71,84,155,"21 de agosto de 1994"
12,10,28,1145,116,164,280,"21 de agosto de 1994"
12,10,28,1146,69,73,142,"21 de agosto de 1994"
12,10,28,1147,82,92,174,"21 de agosto de 1994"
12,10,28,1148,120,150,270,"21 de agosto de 1994"
12,10,28,1149,175,166,341,"21 de agosto de 1994"
12,10,28,1150,184,151,335,"21 de agosto de 1994"
12,10,28,1151,174,186,360,"21 de agosto de 1994"
12,10,28,1152,156,164,320,"21 de agosto de 1994"
12,10,28,1153,54,56,110,"21 de agosto de 1994"
12,10,28,1154,258,270,528,"21 de agosto de 1994"
12,10,28,1155,208,182,390,"21 de agosto de 1994"
12,10,28,1156,124,127,251,"21 de agosto de 1994"
12,10,28,1157,499,506,1005,"21 de agosto de 1994"
12,10,28,1158,132,105,237,"21 de agosto de 1994"
12,10,28,1159,119,132,251,"21 de agosto de 1994"
12,10,28,1160,179,174,353,"21 de agosto de 1994"
12,10,28,1161,202,246,448,"21 de agosto de 1994"
12,10,28,1162,169,216,385,"21 de agosto de 1994"
12,10,28,1163,121,137,258,"21 de agosto de 1994"
12,10,28,1164,270,308,578,"21 de agosto de 1994"
12,10,28,1165,108,115,223,"21 de agosto de 1994"
12,10,28,1166,191,195,386,"21 de agosto de 1994"
12,10,28,1167,174,313,487,"21 de agosto de 1994"
12,10,28,1168,135,135,270,"21 de agosto de 1994"
12,10,28,1169,64,69,133,"21 de agosto de 1994"
12,10,28,1170,215,251,466,"21 de agosto de 1994"
12,10,28,1171,127,147,274,"21 de agosto de 1994"
12,10,28,1172,133,146,279,"21 de agosto de 1994"
12,10,28,1173,244,261,505,"21 de agosto de 1994"
12,10,28,1174,77,70,147,"21 de agosto de 1994"
12,10,28,1175,317,433,750,"21 de agosto de 1994"
12,10,28,1176,76,80,156,"21 de agosto de 1994"
12,10,28,1177,376,381,757,"21 de agosto de 1994"
12,10,28,1178,328,339,667,"21 de agosto de 1994"
12,10,28,1179,238,258,496,"21 de agosto de 1994"
12,10,28,1180,112,127,239,"21 de agosto de 1994"
12,10,28,1181,289,320,609,"21 de agosto de 1994"
12,10,28,1182,72,85,157,"21 de agosto de 1994"
12,10,28,1183,192,184,376,"21 de agosto de 1994"
12,10,28,1184,88,25,113,"21 de agosto de 1994"
12,10,28,1185,227,237,464,"21 de agosto de 1994"
12,10,28,1186,98,109,207,"21 de agosto de 1994"
12,10,28,1187,185,169,354,"21 de agosto de 1994"
12,10,28,1188,71,70,141,"21 de agosto de 1994"
12,10,28,1189,150,132,282,"21 de agosto de 1994"
12,10,28,1190,181,154,335,"21 de agosto de 1994"
12,10,28,1191,148,127,275,"21 de agosto de 1994"
12,10,28,1192,133,113,246,"21 de agosto de 1994"
12,10,28,1193,62,64,126,"21 de agosto de 1994"
12,10,28,1194,237,229,466,"21 de agosto de 1994"
12,10,28,1195,372,399,771,"21 de agosto de 1994"
12,10,28,1196,180,177,357,"21 de agosto de 1994"
12,10,28,1197,75,69,144,"21 de agosto de 1994"
12,10,28,1198,227,225,452,"21 de agosto de 1994"
12,10,28,1199,120,77,197,"21 de agosto de 1994"
12,10,28,1200,170,111,281,"21 de agosto de 1994"
12,10,28,1201,146,121,267,"21 de agosto de 1994"
12,10,28,1202,117,88,205,"21 de agosto de 1994"
12,10,28,1203,211,165,376,"21 de agosto de 1994"
12,10,34,1432,213,296,509,"21 de agosto de 1994"
12,10,34,1433,265,352,617,"21 de agosto de 1994"
12,10,34,1434,411,520,931,"21 de agosto de 1994"
12,10,34,1435,96,156,252,"21 de agosto de 1994"
12,10,34,1436,102,129,231,"21 de agosto de 1994"
12,10,34,1437,263,305,568,"21 de agosto de 1994"
12,10,34,1438,69,77,146,"21 de agosto de 1994"
12,10,34,1439,213,244,457,"21 de agosto de 1994"
12,10,34,1440,214,229,443,"21 de agosto de 1994"
12,10,34,1441,189,261,450,"21 de agosto de 1994"
12,10,34,1442,157,195,352,"21 de agosto de 1994"
12,10,34,1443,87,88,175,"21 de agosto de 1994"
12,10,35,1444,213,257,470,"21 de agosto de 1994"
12,10,35,1445,309,328,637,"21 de agosto de 1994"
12,10,35,1446,291,302,593,"21 de agosto de 1994"
12,10,35,1447,228,283,511,"21 de agosto de 1994"
12,10,35,1448,261,313,574,"21 de agosto de 1994"
12,10,35,1449,275,315,590,"21 de agosto de 1994"
12,10,35,1450,312,365,677,"21 de agosto de 1994"
12,10,35,1451,306,349,655,"21 de agosto de 1994"
12,10,35,1452,270,314,584,"21 de agosto de 1994"
12,10,35,1453,177,235,412,"21 de agosto de 1994"
12,10,35,1454,321,389,710,"21 de agosto de 1994"
12,10,35,1455,385,469,854,"21 de agosto de 1994"
12,10,35,1456,204,237,441,"21 de agosto de 1994"
12,10,35,1457,47,52,99,"21 de agosto de 1994"
12,10,35,1458,225,317,542,"21 de agosto de 1994"
12,10,35,1459,165,200,365,"21 de agosto de 1994"
12,10,35,1460,152,186,338,"21 de agosto de 1994"
12,10,35,1461,33,23,56,"21 de agosto de 1994"
12,10,35,1462,174,258,432,"21 de agosto de 1994"
12,10,35,1463,269,413,682,"21 de agosto de 1994"
12,10,35,1464,266,350,616,"21 de agosto de 1994"
12,10,35,1465,248,289,537,"21 de agosto de 1994"
12,10,35,1466,29,46,75,"21 de agosto de 1994"
12,10,35,1467,76,89,165,"21 de agosto de 1994"
12,10,35,1468,150,168,318,"21 de agosto de 1994"
12,10,35,1469,231,230,461,"21 de agosto de 1994"
12,10,35,1470,60,85,145,"21 de agosto de 1994"
12,10,35,1471,69,90,159,"21 de agosto de 1994"
12,10,35,1472,153,189,342,"21 de agosto de 1994"
12,10,35,1473,174,209,383,"21 de agosto de 1994"
12,10,35,1474,182,205,387,"21 de agosto de 1994"
12,10,35,1475,56,50,106,"21 de agosto de 1994"
12,10,35,1476,67,63,130,"21 de agosto de 1994"
12,10,35,1477,204,256,460,"21 de agosto de 1994"
12,10,35,1478,268,323,591,"21 de agosto de 1994"
12,10,35,1479,154,140,294,"21 de agosto de 1994"
12,10,43,1719,339,372,711,"21 de agosto de 1994"
12,10,43,1720,267,266,533,"21 de agosto de 1994"
12,10,43,1721,283,307,590,"21 de agosto de 1994"
12,10,43,1722,124,110,234,"21 de agosto de 1994"
12,10,43,1723,106,138,244,"21 de agosto de 1994"
12,10,43,1724,90,112,202,"21 de agosto de 1994"
12,10,43,1725,153,130,283,"21 de agosto de 1994"
12,10,43,1726,104,60,164,"21 de agosto de 1994"
12,10,43,1727,255,218,473,"21 de agosto de 1994"
12,10,43,1728,31,25,56,"21 de agosto de 1994"
12,10,43,1729,92,85,177,"21 de agosto de 1994"
12,10,43,1730,60,59,119,"21 de agosto de 1994"
12,10,43,1731,64,68,132,"21 de agosto de 1994"
12,10,43,1732,260,316,576,"21 de agosto de 1994"
12,10,43,1733,312,338,650,"21 de agosto de 1994"
12,10,43,1734,225,290,515,"21 de agosto de 1994"
12,10,46,1784,362,384,746,"21 de agosto de 1994"
12,10,46,1785,275,284,559,"21 de agosto de 1994"
12,10,46,1786,475,553,1028,"21 de agosto de 1994"
12,10,46,1787,157,144,301,"21 de agosto de 1994"
12,10,46,1788,81,105,186,"21 de agosto de 1994"
12,10,46,1789,193,195,388,"21 de agosto de 1994"
12,10,46,1790,102,83,185,"21 de agosto de 1994"
12,10,46,1791,128,111,239,"21 de agosto de 1994"
12,10,46,1792,189,202,391,"21 de agosto de 1994"
12,10,46,1793,117,113,230,"21 de agosto de 1994"
12,10,46,1794,72,75,147,"21 de agosto de 1994"
12,10,46,1795,63,68,131,"21 de agosto de 1994"
12,10,46,1796,55,49,104,"21 de agosto de 1994"
12,10,46,1797,111,99,210,"21 de agosto de 1994"
12,10,46,1798,640,620,1260,"21 de agosto de 1994"
12,10,46,1799,133,99,232,"21 de agosto de 1994"
12,10,46,1800,359,295,654,"21 de agosto de 1994"
12,10,46,1801,108,115,223,"21 de agosto de 1994"
12,10,46,1802,48,55,103,"21 de agosto de 1994"
12,10,46,1803,82,98,180,"21 de agosto de 1994"
12,10,46,1804,130,111,241,"21 de agosto de 1994"
12,10,46,1805,56,50,106,"21 de agosto de 1994"
12,10,46,1806,41,41,82,"21 de agosto de 1994"
12,10,46,1807,91,97,188,"21 de agosto de 1994"
12,10,46,1808,110,118,228,"21 de agosto de 1994"
12,10,71,2669,169,240,409,"21 de agosto de 1994"
12,10,71,2670,325,505,830,"21 de agosto de 1994"
12,10,71,2671,258,384,642,"21 de agosto de 1994"
12,10,71,2672,172,242,414,"21 de agosto de 1994"
12,10,71,2673,89,111,200,"21 de agosto de 1994"
12,10,71,2674,144,183,327,"21 de agosto de 1994"
12,10,71,2675,51,66,117,"21 de agosto de 1994"
12,10,71,2676,55,70,125,"21 de agosto de 1994"
12,10,71,2677,31,27,58,"21 de agosto de 1994"
12,10,75,2752,396,449,845,"21 de agosto de 1994"
12,10,75,2753,379,443,822,"21 de agosto de 1994"
12,10,75,2754,385,443,828,"21 de agosto de 1994"
12,10,75,2755,50,57,107,"21 de agosto de 1994"
12,10,75,2756,38,34,72,"21 de agosto de 1994"
12,10,75,2757,63,65,128,"21 de agosto de 1994"
12,10,75,2758,95,79,174,"21 de agosto de 1994"
12,10,75,2759,243,289,532,"21 de agosto de 1994"
12,10,75,2760,48,44,92,"21 de agosto de 1994"
12,10,75,2761,237,239,476,"21 de agosto de 1994"
12,10,75,2762,55,53,108,"21 de agosto de 1994"
12,10,75,2763,154,167,321,"21 de agosto de 1994"
12,10,75,2764,114,149,263,"21 de agosto de 1994"
12,10,75,2765,48,57,105,"21 de agosto de 1994"
12,10,75,2766,142,153,295,"21 de agosto de 1994"
12,10,75,2767,70,63,133,"21 de agosto de 1994"
12,10,75,2768,121,148,269,"21 de agosto de 1994"
12,10,75,2769,564,624,1188,"21 de agosto de 1994"
12,10,75,2770,87,85,172,"21 de agosto de 1994"
12,10,75,2771,413,479,892,"21 de agosto de 1994"
13,1,21,350,403,454,857,"21 de agosto de 1994"
13,1,21,351,434,490,924,"21 de agosto de 1994"
13,1,21,352,415,476,891,"21 de agosto de 1994"
13,1,21,353,526,582,1108,"21 de agosto de 1994"
13,1,21,354,465,492,957,"21 de agosto de 1994"
13,1,21,355,448,475,923,"21 de agosto de 1994"
13,1,21,356,307,304,611,"21 de agosto de 1994"
13,1,21,357,325,372,697,"21 de agosto de 1994"
13,1,22,358,395,409,804,"21 de agosto de 1994"
13,1,22,359,333,324,657,"21 de agosto de 1994"
13,1,22,360,323,355,678,"21 de agosto de 1994"
13,1,22,361,222,194,416,"21 de agosto de 1994"
13,1,22,362,84,81,165,"21 de agosto de 1994"
13,1,22,363,463,509,972,"21 de agosto de 1994"
13,1,22,364,87,101,188,"21 de agosto de 1994"
13,1,22,365,144,146,290,"21 de agosto de 1994"
13,1,22,366,43,46,89,"21 de agosto de 1994"
13,1,22,367,167,194,361,"21 de agosto de 1994"
13,1,22,368,439,455,894,"21 de agosto de 1994"
13,1,40,725,300,352,652,"21 de agosto de 1994"
13,1,40,726,509,509,1018,"21 de agosto de 1994"
13,1,40,727,510,512,1022,"21 de agosto de 1994"
13,1,40,728,487,518,1005,"21 de agosto de 1994"
13,1,40,729,469,527,996,"21 de agosto de 1994"
13,1,40,730,188,199,387,"21 de agosto de 1994"
13,1,40,731,266,281,547,"21 de agosto de 1994"
13,1,40,732,421,570,991,"21 de agosto de 1994"
13,1,40,733,203,281,484,"21 de agosto de 1994"
13,1,40,734,278,337,615,"21 de agosto de 1994"
13,1,40,735,259,310,569,"21 de agosto de 1994"
13,1,40,736,360,477,837,"21 de agosto de 1994"
13,1,40,737,433,458,891,"21 de agosto de 1994"
13,1,40,738,276,328,604,"21 de agosto de 1994"
13,1,40,739,176,183,359,"21 de agosto de 1994"
13,1,40,740,277,291,568,"21 de agosto de 1994"
13,1,40,741,285,248,533,"21 de agosto de 1994"
13,1,40,742,480,517,997,"21 de agosto de 1994"
13,1,47,832,348,386,734,"21 de agosto de 1994"
13,1,47,833,431,465,896,"21 de agosto de 1994"
13,1,47,834,216,234,450,"21 de agosto de 1994"
13,1,47,835,266,306,572,"21 de agosto de 1994"
13,1,47,836,231,220,451,"21 de agosto de 1994"
13,1,47,837,270,294,564,"21 de agosto de 1994"
13,1,47,838,111,140,251,"21 de agosto de 1994"
13,1,47,839,256,329,585,"21 de agosto de 1994"
13,1,47,840,350,417,767,"21 de agosto de 1994"
13,1,47,841,264,340,604,"21 de agosto de 1994"
13,1,47,842,306,390,696,"21 de agosto de 1994"
13,1,47,843,423,479,902,"21 de agosto de 1994"
13,1,47,844,360,415,775,"21 de agosto de 1994"
13,1,47,845,217,240,457,"21 de agosto de 1994"
13,1,47,846,357,406,763,"21 de agosto de 1994"
13,1,47,847,399,421,820,"21 de agosto de 1994"
13,1,47,848,596,734,1330,"21 de agosto de 1994"
13,1,47,849,240,252,492,"21 de agosto de 1994"
13,1,47,850,455,518,973,"21 de agosto de 1994"
13,1,47,851,393,488,881,"21 de agosto de 1994"
13,1,47,852,399,436,835,"21 de agosto de 1994"
13,1,47,853,429,507,936,"21 de agosto de 1994"
13,1,47,854,586,720,1306,"21 de agosto de 1994"
13,1,47,855,581,738,1319,"21 de agosto de 1994"
13,1,47,856,641,759,1400,"21 de agosto de 1994"
13,1,47,857,472,552,1024,"21 de agosto de 1994"
13,1,47,858,315,368,683,"21 de agosto de 1994"
13,1,47,859,300,381,681,"21 de agosto de 1994"
13,1,47,860,383,508,891,"21 de agosto de 1994"
13,1,47,861,292,335,627,"21 de agosto de 1994"
13,1,47,862,306,362,668,"21 de agosto de 1994"
13,1,47,863,686,793,1479,"21 de agosto de 1994"
13,1,47,864,177,207,384,"21 de agosto de 1994"
13,1,47,865,310,367,677,"21 de agosto de 1994"
13,1,47,866,297,329,626,"21 de agosto de 1994"
13,1,47,867,588,634,1222,"21 de agosto de 1994"
13,1,47,868,457,464,921,"21 de agosto de 1994"
13,1,47,869,297,376,673,"21 de agosto de 1994"
13,1,47,870,288,374,662,"21 de agosto de 1994"
13,1,47,871,436,530,966,"21 de agosto de 1994"
13,1,47,872,274,376,650,"21 de agosto de 1994"
13,1,47,873,447,537,984,"21 de agosto de 1994"
13,1,47,874,388,453,841,"21 de agosto de 1994"
13,1,47,875,392,447,839,"21 de agosto de 1994"
13,1,47,876,532,613,1145,"21 de agosto de 1994"
13,1,47,877,333,419,752,"21 de agosto de 1994"
13,1,47,878,515,594,1109,"21 de agosto de 1994"
13,1,47,879,224,260,484,"21 de agosto de 1994"
13,1,47,880,362,452,814,"21 de agosto de 1994"
13,1,47,881,258,314,572,"21 de agosto de 1994"
13,1,47,882,322,389,711,"21 de agosto de 1994"
13,1,47,883,271,381,652,"21 de agosto de 1994"
13,1,47,884,279,358,637,"21 de agosto de 1994"
13,1,47,885,410,519,929,"21 de agosto de 1994"
13,1,47,886,232,287,519,"21 de agosto de 1994"
13,1,47,887,468,557,1025,"21 de agosto de 1994"
13,1,47,888,421,494,915,"21 de agosto de 1994"
13,1,47,889,335,398,733,"21 de agosto de 1994"
13,1,47,890,399,480,879,"21 de agosto de 1994"
13,1,47,891,375,484,859,"21 de agosto de 1994"
13,1,47,892,261,324,585,"21 de agosto de 1994"
13,1,47,893,170,203,373,"21 de agosto de 1994"
13,1,47,894,315,390,705,"21 de agosto de 1994"
13,1,47,895,369,439,808,"21 de agosto de 1994"
13,1,47,896,412,511,923,"21 de agosto de 1994"
13,1,47,897,466,548,1014,"21 de agosto de 1994"
13,1,47,898,462,536,998,"21 de agosto de 1994"
13,1,47,899,312,356,668,"21 de agosto de 1994"
13,1,47,900,354,405,759,"21 de agosto de 1994"
13,1,47,901,413,508,921,"21 de agosto de 1994"
13,1,47,902,614,763,1377,"21 de agosto de 1994"
13,1,47,903,394,481,875,"21 de agosto de 1994"
13,1,47,904,470,556,1026,"21 de agosto de 1994"
13,1,47,905,275,342,617,"21 de agosto de 1994"
13,1,47,906,264,304,568,"21 de agosto de 1994"
13,1,47,907,326,415,741,"21 de agosto de 1994"
13,1,47,908,319,334,653,"21 de agosto de 1994"
13,1,47,909,470,577,1047,"21 de agosto de 1994"
13,1,47,910,559,632,1191,"21 de agosto de 1994"
13,1,47,911,670,792,1462,"21 de agosto de 1994"
13,1,47,912,253,316,569,"21 de agosto de 1994"
13,1,47,913,396,413,809,"21 de agosto de 1994"
13,1,47,914,374,406,780,"21 de agosto de 1994"
13,1,47,915,513,601,1114,"21 de agosto de 1994"
13,1,47,916,428,509,937,"21 de agosto de 1994"
13,1,47,917,626,659,1285,"21 de agosto de 1994"
13,1,47,918,512,559,1071,"21 de agosto de 1994"
13,1,47,919,336,393,729,"21 de agosto de 1994"
13,1,47,920,598,646,1244,"21 de agosto de 1994"
13,1,47,921,313,382,695,"21 de agosto de 1994"
13,1,47,922,463,530,993,"21 de agosto de 1994"
13,1,47,923,489,588,1077,"21 de agosto de 1994"
13,1,47,924,422,472,894,"21 de agosto de 1994"
13,1,47,925,373,481,854,"21 de agosto de 1994"
13,1,47,926,308,341,649,"21 de agosto de 1994"
13,1,47,927,238,275,513,"21 de agosto de 1994"
13,1,47,928,597,705,1302,"21 de agosto de 1994"
13,1,47,929,419,432,851,"21 de agosto de 1994"
13,1,47,930,415,411,826,"21 de agosto de 1994"
13,1,47,931,320,331,651,"21 de agosto de 1994"
13,1,47,932,578,683,1261,"21 de agosto de 1994"
13,1,47,933,458,518,976,"21 de agosto de 1994"
13,1,47,934,563,594,1157,"21 de agosto de 1994"
13,1,47,935,689,730,1419,"21 de agosto de 1994"
13,1,47,936,377,448,825,"21 de agosto de 1994"
13,1,47,937,502,501,1003,"21 de agosto de 1994"
13,1,47,938,833,898,1731,"21 de agosto de 1994"
13,1,47,939,683,741,1424,"21 de agosto de 1994"
13,1,47,940,507,592,1099,"21 de agosto de 1994"
13,1,47,941,875,452,1327,"21 de agosto de 1994"
13,1,47,942,442,475,917,"21 de agosto de 1994"
13,1,47,943,482,573,1055,"21 de agosto de 1994"
13,1,47,944,130,145,275,"21 de agosto de 1994"
13,1,47,945,254,329,583,"21 de agosto de 1994"
13,1,47,946,338,392,730,"21 de agosto de 1994"
13,1,47,947,279,344,623,"21 de agosto de 1994"
13,1,47,948,413,548,961,"21 de agosto de 1994"
13,1,47,949,427,522,949,"21 de agosto de 1994"
13,1,47,950,338,368,706,"21 de agosto de 1994"
13,1,47,951,358,442,800,"21 de agosto de 1994"
13,1,47,952,446,523,969,"21 de agosto de 1994"
13,1,47,953,137,219,356,"21 de agosto de 1994"
13,1,47,954,267,277,544,"21 de agosto de 1994"
13,1,47,955,571,617,1188,"21 de agosto de 1994"
13,1,47,956,536,610,1146,"21 de agosto de 1994"
13,1,47,957,661,622,1283,"21 de agosto de 1994"
13,1,47,958,221,219,440,"21 de agosto de 1994"
13,1,47,959,337,398,735,"21 de agosto de 1994"
13,1,47,960,272,284,556,"21 de agosto de 1994"
13,1,47,961,347,424,771,"21 de agosto de 1994"
13,1,51,1008,530,537,1067,"21 de agosto de 1994"
13,1,51,1009,406,441,847,"21 de agosto de 1994"
13,1,51,1010,567,564,1131,"21 de agosto de 1994"
13,1,51,1011,483,475,958,"21 de agosto de 1994"
13,1,51,1012,200,160,360,"21 de agosto de 1994"
13,1,51,1013,506,510,1016,"21 de agosto de 1994"
13,1,51,1014,412,435,847,"21 de agosto de 1994"
13,1,51,1015,324,337,661,"21 de agosto de 1994"
13,1,51,1016,456,486,942,"21 de agosto de 1994"
13,1,51,1017,163,181,344,"21 de agosto de 1994"
13,1,51,1018,73,54,127,"21 de agosto de 1994"
13,1,51,1019,116,124,240,"21 de agosto de 1994"
13,1,51,1020,454,447,901,"21 de agosto de 1994"
13,1,51,1021,344,357,701,"21 de agosto de 1994"
13,1,51,1022,187,166,353,"21 de agosto de 1994"
13,1,51,1023,109,109,218,"21 de agosto de 1994"
13,1,51,1024,116,92,208,"21 de agosto de 1994"
13,1,51,1025,114,120,234,"21 de agosto de 1994"
13,1,61,1191,545,604,1149,"21 de agosto de 1994"
13,1,61,1192,476,529,1005,"21 de agosto de 1994"
13,1,61,1193,532,584,1116,"21 de agosto de 1994"
13,1,61,1194,165,197,362,"21 de agosto de 1994"
13,1,61,1195,361,422,783,"21 de agosto de 1994"
13,1,61,1196,465,509,974,"21 de agosto de 1994"
13,1,61,1197,658,703,1361,"21 de agosto de 1994"
13,1,61,1198,265,264,529,"21 de agosto de 1994"
13,1,61,1199,357,393,750,"21 de agosto de 1994"
13,1,61,1200,100,86,186,"21 de agosto de 1994"
13,1,61,1201,133,115,248,"21 de agosto de 1994"
13,1,61,1202,209,185,394,"21 de agosto de 1994"
13,1,61,1203,37,41,78,"21 de agosto de 1994"
13,1,61,1204,146,121,267,"21 de agosto de 1994"
13,1,61,1205,251,214,465,"21 de agosto de 1994"
13,1,61,1206,190,235,425,"21 de agosto de 1994"
13,1,61,1207,173,202,375,"21 de agosto de 1994"
13,1,61,1208,222,269,491,"21 de agosto de 1994"
13,1,61,1209,381,485,866,"21 de agosto de 1994"
13,1,61,1210,275,364,639,"21 de agosto de 1994"
13,1,61,1211,383,433,816,"21 de agosto de 1994"
13,1,61,1212,666,782,1448,"21 de agosto de 1994"
13,1,61,1213,341,411,752,"21 de agosto de 1994"
13,1,61,1214,272,343,615,"21 de agosto de 1994"
13,1,61,1215,632,747,1379,"21 de agosto de 1994"
13,1,61,1216,324,347,671,"21 de agosto de 1994"
13,1,61,1217,508,573,1081,"21 de agosto de 1994"
13,1,61,1218,515,565,1080,"21 de agosto de 1994"
13,1,61,1219,262,316,578,"21 de agosto de 1994"
13,1,61,1220,717,815,1532,"21 de agosto de 1994"
13,1,61,1221,486,519,1005,"21 de agosto de 1994"
13,1,61,1222,323,380,703,"21 de agosto de 1994"
13,1,61,1223,326,388,714,"21 de agosto de 1994"
13,1,61,1224,372,410,782,"21 de agosto de 1994"
13,1,61,1225,267,300,567,"21 de agosto de 1994"
13,1,61,1226,224,212,436,"21 de agosto de 1994"
13,1,61,1227,226,215,441,"21 de agosto de 1994"
13,1,61,1228,414,460,874,"21 de agosto de 1994"
13,1,68,1349,324,352,676,"21 de agosto de 1994"
13,1,68,1350,535,629,1164,"21 de agosto de 1994"
13,1,68,1351,621,698,1319,"21 de agosto de 1994"
13,1,68,1352,646,683,1329,"21 de agosto de 1994"
13,1,68,1353,616,599,1215,"21 de agosto de 1994"
13,1,68,1354,406,480,886,"21 de agosto de 1994"
13,1,68,1355,539,567,1106,"21 de agosto de 1994"
13,1,68,1356,547,591,1138,"21 de agosto de 1994"
13,1,68,1357,686,530,1216,"21 de agosto de 1994"
13,1,68,1358,301,339,640,"21 de agosto de 1994"
13,1,68,1359,313,343,656,"21 de agosto de 1994"
13,1,68,1360,367,393,760,"21 de agosto de 1994"
13,1,68,1361,282,354,636,"21 de agosto de 1994"
13,1,68,1362,316,387,703,"21 de agosto de 1994"
13,1,68,1363,479,490,969,"21 de agosto de 1994"
13,1,68,1364,105,130,235,"21 de agosto de 1994"
13,1,68,1365,384,380,764,"21 de agosto de 1994"
13,1,68,1366,420,438,858,"21 de agosto de 1994"
13,1,68,1367,760,757,1517,"21 de agosto de 1994"
13,1,68,1368,295,302,597,"21 de agosto de 1994"
13,1,71,1395,398,423,821,"21 de agosto de 1994"
13,1,71,1396,346,403,749,"21 de agosto de 1994"
13,1,71,1397,386,431,817,"21 de agosto de 1994"
13,1,71,1398,484,519,1003,"21 de agosto de 1994"
13,1,71,1399,418,433,851,"21 de agosto de 1994"
13,1,71,1400,112,95,207,"21 de agosto de 1994"
13,1,71,1401,196,185,381,"21 de agosto de 1994"
13,1,71,1402,296,364,660,"21 de agosto de 1994"
13,1,74,1441,268,292,560,"21 de agosto de 1994"
13,1,74,1442,516,519,1035,"21 de agosto de 1994"
13,1,74,1443,231,222,453,"21 de agosto de 1994"
13,1,74,1444,453,499,952,"21 de agosto de 1994"
13,1,74,1445,205,187,392,"21 de agosto de 1994"
13,1,74,1446,228,247,475,"21 de agosto de 1994"
13,1,74,1447,457,522,979,"21 de agosto de 1994"
13,1,74,1448,49,51,100,"21 de agosto de 1994"
13,1,77,1556,441,515,956,"21 de agosto de 1994"
13,1,77,1557,316,358,674,"21 de agosto de 1994"
13,1,77,1558,293,339,632,"21 de agosto de 1994"
13,1,77,1559,322,345,667,"21 de agosto de 1994"
13,1,77,1560,247,244,491,"21 de agosto de 1994"
13,1,77,1561,511,539,1050,"21 de agosto de 1994"
13,1,77,1562,64,80,144,"21 de agosto de 1994"
13,1,82,1619,555,596,1151,"21 de agosto de 1994"
13,1,82,1620,588,617,1205,"21 de agosto de 1994"
13,1,82,1621,558,578,1136,"21 de agosto de 1994"
13,1,82,1622,320,316,636,"21 de agosto de 1994"
13,1,82,1623,343,384,727,"21 de agosto de 1994"
13,1,82,1624,223,235,458,"21 de agosto de 1994"
13,1,82,1625,471,475,946,"21 de agosto de 1994"
13,1,82,1626,376,355,731,"21 de agosto de 1994"
13,1,83,1627,350,370,720,"21 de agosto de 1994"
13,1,83,1628,486,534,1020,"21 de agosto de 1994"
13,1,83,1629,614,586,1200,"21 de agosto de 1994"
13,1,83,1630,156,159,315,"21 de agosto de 1994"
13,1,83,1631,615,615,1230,"21 de agosto de 1994"
13,1,83,1632,384,369,753,"21 de agosto de 1994"
13,1,83,1633,431,418,849,"21 de agosto de 1994"
13,1,83,1634,204,192,396,"21 de agosto de 1994"
13,1,83,1635,395,380,775,"21 de agosto de 1994"
13,1,83,1636,211,193,404,"21 de agosto de 1994"
13,1,83,1637,676,678,1354,"21 de agosto de 1994"
13,1,83,1638,373,321,694,"21 de agosto de 1994"
13,1,83,1639,220,208,428,"21 de agosto de 1994"
13,1,83,1640,76,90,166,"21 de agosto de 1994"
13,1,83,1641,334,326,660,"21 de agosto de 1994"
13,1,83,1642,429,480,909,"21 de agosto de 1994"
13,1,83,1643,136,128,264,"21 de agosto de 1994"
13,2,1,1,369,421,790,"21 de agosto de 1994"
13,2,1,2,253,288,541,"21 de agosto de 1994"
13,2,1,3,93,84,177,"21 de agosto de 1994"
13,2,1,4,61,54,115,"21 de agosto de 1994"
13,2,1,5,300,244,544,"21 de agosto de 1994"
13,2,1,6,386,346,732,"21 de agosto de 1994"
13,2,1,7,348,357,705,"21 de agosto de 1994"
13,2,1,8,419,473,892,"21 de agosto de 1994"
13,2,1,9,531,525,1056,"21 de agosto de 1994"
13,2,1,10,440,451,891,"21 de agosto de 1994"
13,2,1,11,488,544,1032,"21 de agosto de 1994"
13,2,1,12,363,387,750,"21 de agosto de 1994"
13,2,2,13,529,604,1133,"21 de agosto de 1994"
13,2,2,14,454,491,945,"21 de agosto de 1994"
13,2,2,15,155,175,330,"21 de agosto de 1994"
13,2,2,16,219,235,454,"21 de agosto de 1994"
13,2,2,17,162,194,356,"21 de agosto de 1994"
13,2,2,18,127,118,245,"21 de agosto de 1994"
13,2,2,19,203,213,416,"21 de agosto de 1994"
13,2,2,20,311,447,758,"21 de agosto de 1994"
13,2,2,21,268,344,612,"21 de agosto de 1994"
13,2,2,22,474,485,959,"21 de agosto de 1994"
13,2,2,23,484,530,1014,"21 de agosto de 1994"
13,2,2,24,573,638,1211,"21 de agosto de 1994"
13,2,2,25,389,419,808,"21 de agosto de 1994"
13,2,2,26,245,278,523,"21 de agosto de 1994"
13,2,2,27,640,564,1204,"21 de agosto de 1994"
13,2,2,28,243,209,452,"21 de agosto de 1994"
13,2,2,29,426,428,854,"21 de agosto de 1994"
13,2,2,30,447,480,927,"21 de agosto de 1994"
13,2,2,31,385,395,780,"21 de agosto de 1994"
13,2,2,32,387,413,800,"21 de agosto de 1994"
13,2,2,33,294,265,559,"21 de agosto de 1994"
13,2,4,69,515,547,1062,"21 de agosto de 1994"
13,2,4,70,103,102,205,"21 de agosto de 1994"
13,2,4,71,61,64,125,"21 de agosto de 1994"
13,2,4,72,164,164,328,"21 de agosto de 1994"
13,2,4,73,131,115,246,"21 de agosto de 1994"
13,2,4,74,117,122,239,"21 de agosto de 1994"
13,2,4,75,59,52,111,"21 de agosto de 1994"
13,2,4,76,67,75,142,"21 de agosto de 1994"
13,2,4,77,300,273,573,"21 de agosto de 1994"
13,2,4,78,237,224,461,"21 de agosto de 1994"
13,2,4,79,194,190,384,"21 de agosto de 1994"
13,2,4,80,167,158,325,"21 de agosto de 1994"
13,2,7,114,616,642,1258,"21 de agosto de 1994"
13,2,7,115,337,369,706,"21 de agosto de 1994"
13,2,7,116,80,77,157,"21 de agosto de 1994"
13,2,7,117,101,116,217,"21 de agosto de 1994"
13,2,7,118,110,80,190,"21 de agosto de 1994"
13,2,7,119,120,118,238,"21 de agosto de 1994"
13,2,7,120,64,53,117,"21 de agosto de 1994"
13,2,7,121,207,193,400,"21 de agosto de 1994"
13,2,7,122,190,212,402,"21 de agosto de 1994"
13,2,7,123,112,108,220,"21 de agosto de 1994"
13,2,7,124,85,89,174,"21 de agosto de 1994"
13,2,7,125,97,105,202,"21 de agosto de 1994"
13,2,7,126,201,200,401,"21 de agosto de 1994"
13,2,8,127,602,654,1256,"21 de agosto de 1994"
13,2,8,128,728,838,1566,"21 de agosto de 1994"
13,2,8,129,552,638,1190,"21 de agosto de 1994"
13,2,8,130,684,797,1481,"21 de agosto de 1994"
13,2,8,131,532,604,1136,"21 de agosto de 1994"
13,2,8,132,381,461,842,"21 de agosto de 1994"
13,2,8,133,388,479,867,"21 de agosto de 1994"
13,2,8,134,739,840,1579,"21 de agosto de 1994"
13,2,8,135,483,494,977,"21 de agosto de 1994"
13,2,8,136,631,722,1353,"21 de agosto de 1994"
13,2,8,137,410,441,851,"21 de agosto de 1994"
13,2,8,138,297,346,643,"21 de agosto de 1994"
13,2,8,139,181,159,340,"21 de agosto de 1994"
13,2,8,140,145,104,249,"21 de agosto de 1994"
13,2,8,141,101,65,166,"21 de agosto de 1994"
13,2,8,142,167,137,304,"21 de agosto de 1994"
13,2,8,143,450,462,912,"21 de agosto de 1994"
13,2,8,144,195,193,388,"21 de agosto de 1994"
13,2,8,145,328,365,693,"21 de agosto de 1994"
13,2,8,146,309,312,621,"21 de agosto de 1994"
13,2,8,147,284,313,597,"21 de agosto de 1994"
13,2,8,148,379,360,739,"21 de agosto de 1994"
13,2,8,149,72,73,145,"21 de agosto de 1994"
13,2,8,150,198,212,410,"21 de agosto de 1994"
13,2,8,151,250,239,489,"21 de agosto de 1994"
13,2,15,257,541,625,1166,"21 de agosto de 1994"
13,2,15,258,719,826,1545,"21 de agosto de 1994"
13,2,15,259,471,630,1101,"21 de agosto de 1994"
13,2,15,260,217,274,491,"21 de agosto de 1994"
13,2,15,261,432,524,956,"21 de agosto de 1994"
13,2,15,262,451,509,960,"21 de agosto de 1994"
13,2,15,263,252,336,588,"21 de agosto de 1994"
13,2,15,264,606,659,1265,"21 de agosto de 1994"
13,2,15,265,625,727,1352,"21 de agosto de 1994"
13,2,15,266,271,309,580,"21 de agosto de 1994"
13,2,15,267,271,262,533,"21 de agosto de 1994"
13,2,15,268,157,159,316,"21 de agosto de 1994"
13,2,15,269,656,668,1324,"21 de agosto de 1994"
13,2,15,270,352,363,715,"21 de agosto de 1994"
13,2,15,271,421,482,903,"21 de agosto de 1994"
13,2,15,272,273,223,496,"21 de agosto de 1994"
13,2,15,273,867,807,1674,"21 de agosto de 1994"
13,2,15,274,775,864,1639,"21 de agosto de 1994"
13,2,15,275,209,204,413,"21 de agosto de 1994"
13,2,15,276,223,206,429,"21 de agosto de 1994"
13,2,15,277,239,220,459,"21 de agosto de 1994"
13,2,15,278,245,215,460,"21 de agosto de 1994"
13,2,15,279,194,188,382,"21 de agosto de 1994"
13,2,15,280,359,376,735,"21 de agosto de 1994"
13,2,27,441,655,657,1312,"21 de agosto de 1994"
13,2,27,442,104,77,181,"21 de agosto de 1994"
13,2,27,443,247,260,507,"21 de agosto de 1994"
13,2,27,444,257,293,550,"21 de agosto de 1994"
13,2,27,445,88,81,169,"21 de agosto de 1994"
13,2,27,446,200,200,400,"21 de agosto de 1994"
13,2,27,447,484,464,948,"21 de agosto de 1994"
13,2,27,448,209,205,414,"21 de agosto de 1994"
13,2,27,449,326,337,663,"21 de agosto de 1994"
13,2,27,450,235,206,441,"21 de agosto de 1994"
13,2,27,451,401,390,791,"21 de agosto de 1994"
13,2,27,452,311,285,596,"21 de agosto de 1994"
13,2,27,453,389,368,757,"21 de agosto de 1994"
13,2,27,454,316,319,635,"21 de agosto de 1994"
13,2,27,455,197,181,378,"21 de agosto de 1994"
13,2,27,456,175,155,330,"21 de agosto de 1994"
13,2,36,665,492,544,1036,"21 de agosto de 1994"
13,2,36,666,75,59,134,"21 de agosto de 1994"
13,2,36,667,342,372,714,"21 de agosto de 1994"
13,2,36,668,601,635,1236,"21 de agosto de 1994"
13,2,36,669,107,89,196,"21 de agosto de 1994"
13,2,36,670,219,175,394,"21 de agosto de 1994"
13,2,36,671,311,269,580,"21 de agosto de 1994"
13,2,36,672,92,87,179,"21 de agosto de 1994"
13,2,36,673,164,154,318,"21 de agosto de 1994"
13,2,52,1026,430,458,888,"21 de agosto de 1994"
13,2,52,1027,605,577,1182,"21 de agosto de 1994"
13,2,52,1028,158,148,306,"21 de agosto de 1994"
13,2,52,1029,60,67,127,"21 de agosto de 1994"
13,2,52,1030,246,213,459,"21 de agosto de 1994"
13,2,52,1031,309,264,573,"21 de agosto de 1994"
13,2,52,1032,276,236,512,"21 de agosto de 1994"
13,2,52,1033,68,69,137,"21 de agosto de 1994"
13,2,52,1034,309,269,578,"21 de agosto de 1994"
13,2,52,1035,141,123,264,"21 de agosto de 1994"
13,2,52,1036,418,407,825,"21 de agosto de 1994"
13,2,52,1037,298,250,548,"21 de agosto de 1994"
13,2,52,1038,132,108,240,"21 de agosto de 1994"
13,2,52,1039,380,353,733,"21 de agosto de 1994"
13,2,52,1040,84,81,165,"21 de agosto de 1994"
13,2,52,1041,86,91,177,"21 de agosto de 1994"
13,2,52,1042,81,68,149,"21 de agosto de 1994"
13,2,56,1110,559,643,1202,"21 de agosto de 1994"
13,2,56,1111,652,782,1434,"21 de agosto de 1994"
13,2,56,1112,549,628,1177,"21 de agosto de 1994"
13,2,56,1113,430,516,946,"21 de agosto de 1994"
13,2,56,1114,790,882,1672,"21 de agosto de 1994"
13,2,56,1115,97,89,186,"21 de agosto de 1994"
13,2,56,1116,423,493,916,"21 de agosto de 1994"
13,2,56,1117,244,288,532,"21 de agosto de 1994"
13,2,56,1118,535,461,996,"21 de agosto de 1994"
13,2,56,1119,114,100,214,"21 de agosto de 1994"
13,2,56,1120,249,280,529,"21 de agosto de 1994"
13,2,57,1121,677,678,1355,"21 de agosto de 1994"
13,2,57,1122,377,430,807,"21 de agosto de 1994"
13,2,57,1123,451,450,901,"21 de agosto de 1994"
13,2,57,1124,198,186,384,"21 de agosto de 1994"
13,2,57,1125,370,345,715,"21 de agosto de 1994"
13,2,57,1126,147,130,277,"21 de agosto de 1994"
13,2,57,1127,142,121,263,"21 de agosto de 1994"
13,2,57,1128,210,194,404,"21 de agosto de 1994"
13,2,57,1129,218,202,420,"21 de agosto de 1994"
13,2,57,1130,270,225,495,"21 de agosto de 1994"
13,2,57,1131,226,212,438,"21 de agosto de 1994"
13,2,60,1177,214,237,451,"21 de agosto de 1994"
13,2,60,1178,504,524,1028,"21 de agosto de 1994"
13,2,60,1179,142,104,246,"21 de agosto de 1994"
13,2,60,1180,477,396,873,"21 de agosto de 1994"
13,2,60,1181,254,217,471,"21 de agosto de 1994"
13,2,60,1182,134,130,264,"21 de agosto de 1994"
13,2,60,1183,242,275,517,"21 de agosto de 1994"
13,2,60,1184,146,140,286,"21 de agosto de 1994"
13,2,60,1185,176,183,359,"21 de agosto de 1994"
13,2,60,1186,145,127,272,"21 de agosto de 1994"
13,2,60,1187,133,160,293,"21 de agosto de 1994"
13,2,60,1188,280,367,647,"21 de agosto de 1994"
13,2,60,1189,179,246,425,"21 de agosto de 1994"
13,2,60,1190,257,271,528,"21 de agosto de 1994"
13,2,76,1502,698,743,1441,"21 de agosto de 1994"
13,2,76,1503,536,664,1200,"21 de agosto de 1994"
13,2,76,1504,582,714,1296,"21 de agosto de 1994"
13,2,76,1505,630,760,1390,"21 de agosto de 1994"
13,2,76,1506,546,661,1207,"21 de agosto de 1994"
13,2,76,1507,590,732,1322,"21 de agosto de 1994"
13,2,76,1508,510,674,1184,"21 de agosto de 1994"
13,2,76,1509,539,653,1192,"21 de agosto de 1994"
13,2,76,1510,605,722,1327,"21 de agosto de 1994"
13,2,76,1511,524,580,1104,"21 de agosto de 1994"
13,2,76,1512,391,476,867,"21 de agosto de 1994"
13,2,76,1513,640,813,1453,"21 de agosto de 1994"
13,2,76,1514,666,767,1433,"21 de agosto de 1994"
13,2,76,1515,638,773,1411,"21 de agosto de 1994"
13,2,76,1516,651,822,1473,"21 de agosto de 1994"
13,2,76,1517,612,763,1375,"21 de agosto de 1994"
13,2,76,1518,504,582,1086,"21 de agosto de 1994"
13,2,76,1519,364,473,837,"21 de agosto de 1994"
13,2,76,1520,578,752,1330,"21 de agosto de 1994"
13,2,76,1521,333,443,776,"21 de agosto de 1994"
13,2,76,1522,418,550,968,"21 de agosto de 1994"
13,2,76,1523,385,524,909,"21 de agosto de 1994"
13,2,76,1524,587,720,1307,"21 de agosto de 1994"
13,2,76,1525,655,720,1375,"21 de agosto de 1994"
13,2,76,1526,602,774,1376,"21 de agosto de 1994"
13,2,76,1527,265,300,565,"21 de agosto de 1994"
13,2,76,1528,520,626,1146,"21 de agosto de 1994"
13,2,76,1529,729,840,1569,"21 de agosto de 1994"
13,2,76,1530,775,887,1662,"21 de agosto de 1994"
13,2,76,1531,437,527,964,"21 de agosto de 1994"
13,2,76,1532,500,614,1114,"21 de agosto de 1994"
13,2,76,1533,472,621,1093,"21 de agosto de 1994"
13,2,76,1534,586,701,1287,"21 de agosto de 1994"
13,2,76,1535,577,701,1278,"21 de agosto de 1994"
13,2,76,1536,424,477,901,"21 de agosto de 1994"
13,2,76,1537,498,655,1153,"21 de agosto de 1994"
13,2,76,1538,456,590,1046,"21 de agosto de 1994"
13,2,76,1539,447,486,933,"21 de agosto de 1994"
13,2,76,1540,155,181,336,"21 de agosto de 1994"
13,2,76,1541,124,108,232,"21 de agosto de 1994"
13,2,76,1542,209,181,390,"21 de agosto de 1994"
13,2,76,1543,317,317,634,"21 de agosto de 1994"
13,2,76,1544,532,593,1125,"21 de agosto de 1994"
13,2,76,1545,523,546,1069,"21 de agosto de 1994"
13,2,76,1546,147,181,328,"21 de agosto de 1994"
13,2,76,1547,38,31,69,"21 de agosto de 1994"
13,2,76,1548,453,524,977,"21 de agosto de 1994"
13,2,76,1549,337,416,753,"21 de agosto de 1994"
13,2,76,1550,170,199,369,"21 de agosto de 1994"
13,2,76,1551,361,385,746,"21 de agosto de 1994"
13,2,76,1552,72,78,150,"21 de agosto de 1994"
13,2,76,1553,267,299,566,"21 de agosto de 1994"
13,2,76,1554,608,659,1267,"21 de agosto de 1994"
13,2,76,1555,348,401,749,"21 de agosto de 1994"
13,3,5,81,362,358,720,"21 de agosto de 1994"
13,3,5,82,470,441,911,"21 de agosto de 1994"
13,3,5,83,370,339,709,"21 de agosto de 1994"
13,3,5,84,346,380,726,"21 de agosto de 1994"
13,3,5,85,384,377,761,"21 de agosto de 1994"
13,3,5,86,568,533,1101,"21 de agosto de 1994"
13,3,5,87,89,86,175,"21 de agosto de 1994"
13,3,5,88,510,515,1025,"21 de agosto de 1994"
13,3,5,89,326,311,637,"21 de agosto de 1994"
13,3,5,90,110,116,226,"21 de agosto de 1994"
13,3,5,91,85,60,145,"21 de agosto de 1994"
13,3,9,152,642,692,1334,"21 de agosto de 1994"
13,3,9,153,629,605,1234,"21 de agosto de 1994"
13,3,9,154,480,453,933,"21 de agosto de 1994"
13,3,9,155,369,337,706,"21 de agosto de 1994"
13,3,9,156,530,517,1047,"21 de agosto de 1994"
13,3,9,157,505,488,993,"21 de agosto de 1994"
13,3,9,158,540,545,1085,"21 de agosto de 1994"
13,3,9,159,370,403,773,"21 de agosto de 1994"
13,3,9,160,289,309,598,"21 de agosto de 1994"
13,3,9,161,594,591,1185,"21 de agosto de 1994"
13,3,12,206,516,490,1006,"21 de agosto de 1994"
13,3,12,207,454,423,877,"21 de agosto de 1994"
13,3,12,208,473,480,953,"21 de agosto de 1994"
13,3,12,209,593,592,1185,"21 de agosto de 1994"
13,3,12,210,172,173,345,"21 de agosto de 1994"
13,3,12,211,333,349,682,"21 de agosto de 1994"
13,3,12,212,220,210,430,"21 de agosto de 1994"
13,3,12,213,192,187,379,"21 de agosto de 1994"
13,3,12,214,329,314,643,"21 de agosto de 1994"
13,3,12,215,536,564,1100,"21 de agosto de 1994"
13,3,12,216,771,768,1539,"21 de agosto de 1994"
13,3,12,217,101,104,205,"21 de agosto de 1994"
13,3,12,218,85,80,165,"21 de agosto de 1994"
13,3,12,219,70,64,134,"21 de agosto de 1994"
13,3,12,220,81,81,162,"21 de agosto de 1994"
13,3,12,221,73,81,154,"21 de agosto de 1994"
13,3,12,222,379,359,738,"21 de agosto de 1994"
13,3,12,223,302,312,614,"21 de agosto de 1994"
13,3,18,316,533,566,1099,"21 de agosto de 1994"
13,3,18,317,157,155,312,"21 de agosto de 1994"
13,3,18,318,162,143,305,"21 de agosto de 1994"
13,3,18,319,169,149,318,"21 de agosto de 1994"
13,3,18,320,254,245,499,"21 de agosto de 1994"
13,3,18,321,186,185,371,"21 de agosto de 1994"
13,3,18,322,142,153,295,"21 de agosto de 1994"
13,3,18,323,348,317,665,"21 de agosto de 1994"
13,3,18,324,185,170,355,"21 de agosto de 1994"
13,3,18,325,104,98,202,"21 de agosto de 1994"
13,3,18,326,40,24,64,"21 de agosto de 1994"
13,3,18,327,469,445,914,"21 de agosto de 1994"
13,3,18,328,300,248,548,"21 de agosto de 1994"
13,3,18,329,450,402,852,"21 de agosto de 1994"
13,3,18,330,30,24,54,"21 de agosto de 1994"
13,3,23,369,533,561,1094,"21 de agosto de 1994"
13,3,23,370,465,522,987,"21 de agosto de 1994"
13,3,23,371,525,562,1087,"21 de agosto de 1994"
13,3,23,372,310,333,643,"21 de agosto de 1994"
13,3,23,373,503,575,1078,"21 de agosto de 1994"
13,3,23,374,371,441,812,"21 de agosto de 1994"
13,3,23,375,243,206,449,"21 de agosto de 1994"
13,3,23,376,157,191,348,"21 de agosto de 1994"
13,3,23,377,129,136,265,"21 de agosto de 1994"
13,3,23,378,405,417,822,"21 de agosto de 1994"
13,3,23,379,398,423,821,"21 de agosto de 1994"
13,3,23,380,292,257,549,"21 de agosto de 1994"
13,3,23,381,384,388,772,"21 de agosto de 1994"
13,3,23,382,229,224,453,"21 de agosto de 1994"
13,3,23,383,612,547,1159,"21 de agosto de 1994"
13,3,23,384,568,581,1149,"21 de agosto de 1994"
13,3,23,385,656,655,1311,"21 de agosto de 1994"
13,3,41,743,657,708,1365,"21 de agosto de 1994"
13,3,41,744,537,588,1125,"21 de agosto de 1994"
13,3,41,745,477,501,978,"21 de agosto de 1994"
13,3,41,746,395,449,844,"21 de agosto de 1994"
13,3,41,747,323,344,667,"21 de agosto de 1994"
13,3,41,748,493,539,1032,"21 de agosto de 1994"
13,3,41,749,529,586,1115,"21 de agosto de 1994"
13,3,41,750,555,603,1158,"21 de agosto de 1994"
13,3,41,751,557,556,1113,"21 de agosto de 1994"
13,3,41,752,354,369,723,"21 de agosto de 1994"
13,3,41,753,425,511,936,"21 de agosto de 1994"
13,3,41,754,156,136,292,"21 de agosto de 1994"
13,3,41,755,200,165,365,"21 de agosto de 1994"
13,3,41,756,374,415,789,"21 de agosto de 1994"
13,3,41,757,309,268,577,"21 de agosto de 1994"
13,3,41,758,301,310,611,"21 de agosto de 1994"
13,3,41,759,486,474,960,"21 de agosto de 1994"
13,3,41,760,158,163,321,"21 de agosto de 1994"
13,3,41,761,524,524,1048,"21 de agosto de 1994"
13,3,41,762,222,240,462,"21 de agosto de 1994"
13,3,41,763,238,230,468,"21 de agosto de 1994"
13,3,41,764,101,105,206,"21 de agosto de 1994"
13,3,49,982,438,498,936,"21 de agosto de 1994"
13,3,49,983,661,759,1420,"21 de agosto de 1994"
13,3,49,984,395,452,847,"21 de agosto de 1994"
13,3,49,985,411,453,864,"21 de agosto de 1994"
13,3,49,986,428,486,914,"21 de agosto de 1994"
13,3,49,987,561,672,1233,"21 de agosto de 1994"
13,3,49,988,550,616,1166,"21 de agosto de 1994"
13,3,49,989,52,47,99,"21 de agosto de 1994"
13,3,49,990,91,81,172,"21 de agosto de 1994"
13,3,49,991,408,443,851,"21 de agosto de 1994"
13,3,49,992,392,419,811,"21 de agosto de 1994"
13,3,49,993,234,259,493,"21 de agosto de 1994"
13,3,63,1262,336,355,691,"21 de agosto de 1994"
13,3,63,1263,519,589,1108,"21 de agosto de 1994"
13,3,63,1264,353,377,730,"21 de agosto de 1994"
13,3,63,1265,248,261,509,"21 de agosto de 1994"
13,3,63,1266,397,414,811,"21 de agosto de 1994"
13,3,63,1267,575,606,1181,"21 de agosto de 1994"
13,3,63,1268,379,392,771,"21 de agosto de 1994"
13,3,63,1269,571,651,1222,"21 de agosto de 1994"
13,3,63,1270,457,484,941,"21 de agosto de 1994"
13,3,63,1271,607,664,1271,"21 de agosto de 1994"
13,3,63,1272,755,771,1526,"21 de agosto de 1994"
13,3,63,1273,524,590,1114,"21 de agosto de 1994"
13,3,63,1274,593,595,1188,"21 de agosto de 1994"
13,3,63,1275,455,466,921,"21 de agosto de 1994"
13,3,63,1276,642,745,1387,"21 de agosto de 1994"
13,3,63,1277,195,195,390,"21 de agosto de 1994"
13,3,63,1278,728,670,1398,"21 de agosto de 1994"
13,3,63,1279,436,360,796,"21 de agosto de 1994"
13,3,63,1280,434,414,848,"21 de agosto de 1994"
13,3,63,1281,382,368,750,"21 de agosto de 1994"
13,3,63,1282,398,412,810,"21 de agosto de 1994"
13,3,63,1283,268,277,545,"21 de agosto de 1994"
13,3,63,1284,592,553,1145,"21 de agosto de 1994"
13,3,63,1285,168,204,372,"21 de agosto de 1994"
13,3,63,1286,295,300,595,"21 de agosto de 1994"
13,3,63,1287,591,642,1233,"21 de agosto de 1994"
13,3,63,1288,116,119,235,"21 de agosto de 1994"
13,3,63,1289,369,353,722,"21 de agosto de 1994"
13,3,63,1290,271,242,513,"21 de agosto de 1994"
13,3,63,1291,365,351,716,"21 de agosto de 1994"
13,3,63,1292,409,381,790,"21 de agosto de 1994"
13,3,63,1293,537,484,1021,"21 de agosto de 1994"
13,3,63,1294,324,245,569,"21 de agosto de 1994"
13,3,64,1295,458,445,903,"21 de agosto de 1994"
13,3,64,1296,268,246,514,"21 de agosto de 1994"
13,3,64,1297,60,48,108,"21 de agosto de 1994"
13,3,64,1298,87,76,163,"21 de agosto de 1994"
13,3,64,1299,347,344,691,"21 de agosto de 1994"
13,3,64,1300,225,215,440,"21 de agosto de 1994"
13,3,64,1301,467,532,999,"21 de agosto de 1994"
13,3,64,1302,321,330,651,"21 de agosto de 1994"
13,3,65,1303,393,364,757,"21 de agosto de 1994"
13,3,65,1304,327,359,686,"21 de agosto de 1994"
13,3,65,1305,338,326,664,"21 de agosto de 1994"
13,3,65,1306,378,376,754,"21 de agosto de 1994"
13,3,65,1307,232,256,488,"21 de agosto de 1994"
13,3,65,1308,196,209,405,"21 de agosto de 1994"
13,3,65,1309,294,268,562,"21 de agosto de 1994"
13,3,66,1310,622,570,1192,"21 de agosto de 1994"
13,3,66,1311,515,531,1046,"21 de agosto de 1994"
13,3,66,1312,240,218,458,"21 de agosto de 1994"
13,3,66,1313,508,536,1044,"21 de agosto de 1994"
13,3,66,1314,523,497,1020,"21 de agosto de 1994"
13,3,66,1315,134,132,266,"21 de agosto de 1994"
13,3,66,1316,607,623,1230,"21 de agosto de 1994"
13,3,66,1317,565,543,1108,"21 de agosto de 1994"
13,3,66,1318,416,377,793,"21 de agosto de 1994"
13,3,66,1319,620,608,1228,"21 de agosto de 1994"
13,3,66,1320,306,315,621,"21 de agosto de 1994"
13,3,66,1321,240,210,450,"21 de agosto de 1994"
13,3,66,1322,348,306,654,"21 de agosto de 1994"
13,3,66,1323,158,141,299,"21 de agosto de 1994"
13,3,66,1324,260,203,463,"21 de agosto de 1994"
13,3,66,1325,335,340,675,"21 de agosto de 1994"
13,3,66,1326,304,295,599,"21 de agosto de 1994"
13,3,66,1327,334,330,664,"21 de agosto de 1994"
13,3,66,1328,490,474,964,"21 de agosto de 1994"
13,3,66,1329,328,315,643,"21 de agosto de 1994"
13,3,66,1330,103,92,195,"21 de agosto de 1994"
13,3,66,1331,135,151,286,"21 de agosto de 1994"
13,3,66,1332,332,308,640,"21 de agosto de 1994"
13,3,69,1369,324,345,669,"21 de agosto de 1994"
13,3,69,1370,374,443,817,"21 de agosto de 1994"
13,3,69,1371,145,142,287,"21 de agosto de 1994"
13,3,69,1372,175,177,352,"21 de agosto de 1994"
13,3,69,1373,380,423,803,"21 de agosto de 1994"
13,3,69,1374,524,601,1125,"21 de agosto de 1994"
13,3,69,1375,370,390,760,"21 de agosto de 1994"
13,3,69,1376,369,422,791,"21 de agosto de 1994"
13,3,69,1377,432,393,825,"21 de agosto de 1994"
13,3,73,1429,549,593,1142,"21 de agosto de 1994"
13,3,73,1430,592,637,1229,"21 de agosto de 1994"
13,3,73,1431,431,416,847,"21 de agosto de 1994"
13,3,73,1432,390,429,819,"21 de agosto de 1994"
13,3,73,1433,416,421,837,"21 de agosto de 1994"
13,3,73,1434,469,461,930,"21 de agosto de 1994"
13,3,73,1435,339,338,677,"21 de agosto de 1994"
13,3,73,1436,325,314,639,"21 de agosto de 1994"
13,3,73,1437,438,441,879,"21 de agosto de 1994"
13,3,73,1438,540,534,1074,"21 de agosto de 1994"
13,3,73,1439,289,281,570,"21 de agosto de 1994"
13,3,73,1440,226,221,447,"21 de agosto de 1994"
13,3,75,1449,420,439,859,"21 de agosto de 1994"
13,3,75,1450,360,353,713,"21 de agosto de 1994"
13,3,75,1451,477,508,985,"21 de agosto de 1994"
13,3,75,1452,631,616,1247,"21 de agosto de 1994"
13,3,75,1453,681,788,1469,"21 de agosto de 1994"
13,3,75,1454,456,495,951,"21 de agosto de 1994"
13,3,75,1455,332,363,695,"21 de agosto de 1994"
13,3,75,1456,554,603,1157,"21 de agosto de 1994"
13,3,75,1457,639,711,1350,"21 de agosto de 1994"
13,3,75,1458,572,631,1203,"21 de agosto de 1994"
13,3,75,1459,568,656,1224,"21 de agosto de 1994"
13,3,75,1460,595,611,1206,"21 de agosto de 1994"
13,3,75,1461,260,271,531,"21 de agosto de 1994"
13,3,75,1462,514,546,1060,"21 de agosto de 1994"
13,3,75,1463,113,99,212,"21 de agosto de 1994"
13,3,75,1464,502,481,983,"21 de agosto de 1994"
13,3,75,1465,55,59,114,"21 de agosto de 1994"
13,3,75,1466,534,639,1173,"21 de agosto de 1994"
13,3,75,1467,77,74,151,"21 de agosto de 1994"
13,3,75,1468,191,163,354,"21 de agosto de 1994"
13,3,75,1469,144,137,281,"21 de agosto de 1994"
13,3,75,1470,111,110,221,"21 de agosto de 1994"
13,3,75,1471,30,28,58,"21 de agosto de 1994"
13,3,75,1472,321,309,630,"21 de agosto de 1994"
13,3,75,1473,162,169,331,"21 de agosto de 1994"
13,3,75,1474,465,487,952,"21 de agosto de 1994"
13,3,75,1475,115,121,236,"21 de agosto de 1994"
13,3,75,1476,512,566,1078,"21 de agosto de 1994"
13,3,75,1477,440,459,899,"21 de agosto de 1994"
13,3,75,1478,425,463,888,"21 de agosto de 1994"
13,3,75,1479,270,317,587,"21 de agosto de 1994"
13,3,75,1480,610,674,1284,"21 de agosto de 1994"
13,3,75,1481,392,365,757,"21 de agosto de 1994"
13,3,75,1482,317,317,634,"21 de agosto de 1994"
13,3,75,1483,279,227,506,"21 de agosto de 1994"
13,3,75,1484,452,454,906,"21 de agosto de 1994"
13,3,75,1485,523,571,1094,"21 de agosto de 1994"
13,3,75,1486,430,486,916,"21 de agosto de 1994"
13,3,75,1487,516,608,1124,"21 de agosto de 1994"
13,3,75,1488,575,648,1223,"21 de agosto de 1994"
13,3,75,1489,260,254,514,"21 de agosto de 1994"
13,3,75,1490,111,102,213,"21 de agosto de 1994"
13,3,75,1491,340,358,698,"21 de agosto de 1994"
13,3,75,1492,615,625,1240,"21 de agosto de 1994"
13,3,75,1493,676,680,1356,"21 de agosto de 1994"
13,3,75,1494,636,706,1342,"21 de agosto de 1994"
13,3,75,1495,433,432,865,"21 de agosto de 1994"
13,3,75,1496,379,416,795,"21 de agosto de 1994"
13,3,75,1497,564,626,1190,"21 de agosto de 1994"
13,3,75,1498,671,744,1415,"21 de agosto de 1994"
13,3,75,1499,200,206,406,"21 de agosto de 1994"
13,3,75,1500,311,341,652,"21 de agosto de 1994"
13,3,75,1501,31,35,66,"21 de agosto de 1994"
13,4,10,162,386,466,852,"21 de agosto de 1994"
13,4,10,163,285,270,555,"21 de agosto de 1994"
13,4,10,164,113,112,225,"21 de agosto de 1994"
13,4,10,165,354,350,704,"21 de agosto de 1994"
13,4,10,166,243,238,481,"21 de agosto de 1994"
13,4,10,167,119,134,253,"21 de agosto de 1994"
13,4,10,168,138,158,296,"21 de agosto de 1994"
13,4,10,169,316,388,704,"21 de agosto de 1994"
13,4,10,170,254,248,502,"21 de agosto de 1994"
13,4,10,171,402,396,798,"21 de agosto de 1994"
13,4,10,172,155,158,313,"21 de agosto de 1994"
13,4,10,173,127,154,281,"21 de agosto de 1994"
13,4,10,174,129,129,258,"21 de agosto de 1994"
13,4,10,175,177,204,381,"21 de agosto de 1994"
13,4,10,176,246,256,502,"21 de agosto de 1994"
13,4,10,177,264,311,575,"21 de agosto de 1994"
13,4,13,224,549,622,1171,"21 de agosto de 1994"
13,4,13,225,309,365,674,"21 de agosto de 1994"
13,4,13,226,128,144,272,"21 de agosto de 1994"
13,4,13,227,145,127,272,"21 de agosto de 1994"
13,4,13,228,305,323,628,"21 de agosto de 1994"
13,4,13,229,152,129,281,"21 de agosto de 1994"
13,4,13,230,208,234,442,"21 de agosto de 1994"
13,4,13,231,173,166,339,"21 de agosto de 1994"
13,4,13,232,543,550,1093,"21 de agosto de 1994"
13,4,13,233,135,132,267,"21 de agosto de 1994"
13,4,13,234,144,151,295,"21 de agosto de 1994"
13,4,13,235,175,181,356,"21 de agosto de 1994"
13,4,13,236,268,309,577,"21 de agosto de 1994"
13,4,13,237,89,78,167,"21 de agosto de 1994"
13,4,13,238,222,250,472,"21 de agosto de 1994"
13,4,13,239,38,29,67,"21 de agosto de 1994"
13,4,25,405,442,447,889,"21 de agosto de 1994"
13,4,25,406,353,371,724,"21 de agosto de 1994"
13,4,25,407,121,129,250,"21 de agosto de 1994"
13,4,25,408,123,120,243,"21 de agosto de 1994"
13,4,25,409,205,201,406,"21 de agosto de 1994"
13,4,25,410,130,127,257,"21 de agosto de 1994"
13,4,25,411,191,179,370,"21 de agosto de 1994"
13,4,25,412,126,126,252,"21 de agosto de 1994"
13,4,25,413,196,205,401,"21 de agosto de 1994"
13,4,25,414,152,158,310,"21 de agosto de 1994"
13,4,25,415,189,205,394,"21 de agosto de 1994"
13,4,25,416,112,128,240,"21 de agosto de 1994"
13,4,25,417,426,453,879,"21 de agosto de 1994"
13,4,25,418,149,152,301,"21 de agosto de 1994"
13,4,25,419,378,422,800,"21 de agosto de 1994"
13,4,25,420,130,145,275,"21 de agosto de 1994"
13,4,25,421,93,81,174,"21 de agosto de 1994"
13,4,25,422,276,266,542,"21 de agosto de 1994"
13,4,25,423,50,39,89,"21 de agosto de 1994"
13,4,25,424,177,174,351,"21 de agosto de 1994"
13,4,25,425,181,194,375,"21 de agosto de 1994"
13,4,25,426,149,159,308,"21 de agosto de 1994"
13,4,25,427,127,152,279,"21 de agosto de 1994"
13,4,25,428,248,283,531,"21 de agosto de 1994"
13,4,25,429,359,411,770,"21 de agosto de 1994"
13,4,25,430,204,269,473,"21 de agosto de 1994"
13,4,26,431,359,385,744,"21 de agosto de 1994"
13,4,26,432,152,121,273,"21 de agosto de 1994"
13,4,26,433,181,169,350,"21 de agosto de 1994"
13,4,26,434,376,401,777,"21 de agosto de 1994"
13,4,26,435,316,322,638,"21 de agosto de 1994"
13,4,26,436,88,93,181,"21 de agosto de 1994"
13,4,26,437,136,135,271,"21 de agosto de 1994"
13,4,26,438,257,289,546,"21 de agosto de 1994"
13,4,26,439,178,169,347,"21 de agosto de 1994"
13,4,26,440,200,221,421,"21 de agosto de 1994"
13,4,28,457,848,890,1738,"21 de agosto de 1994"
13,4,28,458,431,442,873,"21 de agosto de 1994"
13,4,28,459,408,465,873,"21 de agosto de 1994"
13,4,28,460,841,484,1325,"21 de agosto de 1994"
13,4,28,461,564,606,1170,"21 de agosto de 1994"
13,4,28,462,473,537,1010,"21 de agosto de 1994"
13,4,28,463,470,520,990,"21 de agosto de 1994"
13,4,28,464,465,499,964,"21 de agosto de 1994"
13,4,28,465,290,327,617,"21 de agosto de 1994"
13,4,28,466,308,339,647,"21 de agosto de 1994"
13,4,28,467,464,523,987,"21 de agosto de 1994"
13,4,28,468,460,506,966,"21 de agosto de 1994"
13,4,28,469,487,531,1018,"21 de agosto de 1994"
13,4,28,470,534,540,1074,"21 de agosto de 1994"
13,4,28,471,534,483,1017,"21 de agosto de 1994"
13,4,28,472,202,205,407,"21 de agosto de 1994"
13,4,28,473,619,622,1241,"21 de agosto de 1994"
13,4,28,474,317,323,640,"21 de agosto de 1994"
13,4,28,475,180,141,321,"21 de agosto de 1994"
13,4,28,476,395,347,742,"21 de agosto de 1994"
13,4,28,477,197,205,402,"21 de agosto de 1994"
13,4,28,478,258,241,499,"21 de agosto de 1994"
13,4,28,479,292,276,568,"21 de agosto de 1994"
13,4,28,480,448,411,859,"21 de agosto de 1994"
13,4,28,481,281,261,542,"21 de agosto de 1994"
13,4,28,482,473,439,912,"21 de agosto de 1994"
13,4,28,483,377,338,715,"21 de agosto de 1994"
13,4,28,484,379,333,712,"21 de agosto de 1994"
13,4,28,485,288,285,573,"21 de agosto de 1994"
13,4,28,486,500,520,1020,"21 de agosto de 1994"
13,4,28,487,454,467,921,"21 de agosto de 1994"
13,4,28,488,316,299,615,"21 de agosto de 1994"
13,4,28,489,271,327,598,"21 de agosto de 1994"
13,4,28,490,379,440,819,"21 de agosto de 1994"
13,4,28,491,401,419,820,"21 de agosto de 1994"
13,4,28,492,217,195,412,"21 de agosto de 1994"
13,4,28,493,205,213,418,"21 de agosto de 1994"
13,4,28,494,237,254,491,"21 de agosto de 1994"
13,4,28,495,610,609,1219,"21 de agosto de 1994"
13,4,28,496,106,104,210,"21 de agosto de 1994"
13,4,28,497,209,212,421,"21 de agosto de 1994"
13,4,28,498,26,30,56,"21 de agosto de 1994"
13,4,28,499,485,461,946,"21 de agosto de 1994"
13,4,28,500,435,405,840,"21 de agosto de 1994"
13,4,28,501,329,257,586,"21 de agosto de 1994"
13,4,28,502,584,578,1162,"21 de agosto de 1994"
13,4,28,503,233,225,458,"21 de agosto de 1994"
13,4,28,504,515,400,915,"21 de agosto de 1994"
13,4,28,505,360,267,627,"21 de agosto de 1994"
13,4,28,506,189,176,365,"21 de agosto de 1994"
13,4,28,507,284,248,532,"21 de agosto de 1994"
13,4,28,508,563,553,1116,"21 de agosto de 1994"
13,4,28,509,204,198,402,"21 de agosto de 1994"
13,4,32,630,201,186,387,"21 de agosto de 1994"
13,4,32,631,517,572,1089,"21 de agosto de 1994"
13,4,32,632,517,523,1040,"21 de agosto de 1994"
13,4,32,633,140,124,264,"21 de agosto de 1994"
13,4,32,634,116,88,204,"21 de agosto de 1994"
13,4,32,635,56,54,110,"21 de agosto de 1994"
13,4,32,636,90,87,177,"21 de agosto de 1994"
13,4,32,637,70,80,150,"21 de agosto de 1994"
13,4,32,638,92,94,186,"21 de agosto de 1994"
13,4,32,639,113,101,214,"21 de agosto de 1994"
13,4,32,640,184,203,387,"21 de agosto de 1994"
13,4,32,641,161,148,309,"21 de agosto de 1994"
13,4,35,657,252,270,522,"21 de agosto de 1994"
13,4,35,658,113,109,222,"21 de agosto de 1994"
13,4,35,659,301,266,567,"21 de agosto de 1994"
13,4,35,660,335,299,634,"21 de agosto de 1994"
13,4,35,661,261,277,538,"21 de agosto de 1994"
13,4,35,662,242,294,536,"21 de agosto de 1994"
13,4,35,663,292,295,587,"21 de agosto de 1994"
13,4,35,664,259,301,560,"21 de agosto de 1994"
13,4,42,765,477,521,998,"21 de agosto de 1994"
13,4,42,766,437,483,920,"21 de agosto de 1994"
13,4,42,767,140,110,250,"21 de agosto de 1994"
13,4,42,768,154,164,318,"21 de agosto de 1994"
13,4,42,769,173,160,333,"21 de agosto de 1994"
13,4,42,770,65,49,114,"21 de agosto de 1994"
13,4,42,771,119,96,215,"21 de agosto de 1994"
13,4,42,772,159,128,287,"21 de agosto de 1994"
13,4,42,773,138,143,281,"21 de agosto de 1994"
13,4,42,774,73,67,140,"21 de agosto de 1994"
13,4,42,775,79,80,159,"21 de agosto de 1994"
13,4,42,776,91,69,160,"21 de agosto de 1994"
13,4,42,777,73,82,155,"21 de agosto de 1994"
13,4,42,778,93,96,189,"21 de agosto de 1994"
13,4,42,779,152,146,298,"21 de agosto de 1994"
13,4,53,1043,235,226,461,"21 de agosto de 1994"
13,4,53,1044,528,510,1038,"21 de agosto de 1994"
13,4,53,1045,583,552,1135,"21 de agosto de 1994"
13,4,53,1046,231,242,473,"21 de agosto de 1994"
13,4,53,1047,216,193,409,"21 de agosto de 1994"
13,4,53,1048,455,397,852,"21 de agosto de 1994"
13,4,53,1049,294,262,556,"21 de agosto de 1994"
13,4,53,1050,420,358,778,"21 de agosto de 1994"
13,4,53,1051,274,262,536,"21 de agosto de 1994"
13,4,53,1052,166,143,309,"21 de agosto de 1994"
13,4,53,1053,246,206,452,"21 de agosto de 1994"
13,4,53,1054,127,110,237,"21 de agosto de 1994"
13,4,53,1055,348,269,617,"21 de agosto de 1994"
13,4,53,1056,319,265,584,"21 de agosto de 1994"
13,4,53,1057,277,208,485,"21 de agosto de 1994"
13,4,53,1058,162,157,319,"21 de agosto de 1994"
13,4,53,1059,317,337,654,"21 de agosto de 1994"
13,4,53,1060,468,515,983,"21 de agosto de 1994"
13,4,53,1061,590,709,1299,"21 de agosto de 1994"
13,4,53,1062,571,491,1062,"21 de agosto de 1994"
13,4,53,1063,313,226,539,"21 de agosto de 1994"
13,4,53,1064,103,93,196,"21 de agosto de 1994"
13,4,53,1065,170,157,327,"21 de agosto de 1994"
13,4,53,1066,235,233,468,"21 de agosto de 1994"
13,4,62,1229,203,209,412,"21 de agosto de 1994"
13,4,62,1230,147,128,275,"21 de agosto de 1994"
13,4,62,1231,48,46,94,"21 de agosto de 1994"
13,4,62,1232,259,216,475,"21 de agosto de 1994"
13,4,62,1233,121,119,240,"21 de agosto de 1994"
13,4,62,1234,98,91,189,"21 de agosto de 1994"
13,4,62,1235,102,97,199,"21 de agosto de 1994"
13,4,62,1236,300,256,556,"21 de agosto de 1994"
13,4,62,1237,345,291,636,"21 de agosto de 1994"
13,4,62,1238,43,41,84,"21 de agosto de 1994"
13,4,62,1239,34,21,55,"21 de agosto de 1994"
13,4,62,1240,358,320,678,"21 de agosto de 1994"
13,4,62,1241,97,74,171,"21 de agosto de 1994"
13,4,62,1242,206,186,392,"21 de agosto de 1994"
13,4,62,1243,190,148,338,"21 de agosto de 1994"
13,4,62,1244,143,130,273,"21 de agosto de 1994"
13,4,62,1245,163,141,304,"21 de agosto de 1994"
13,4,62,1246,225,206,431,"21 de agosto de 1994"
13,4,62,1247,76,64,140,"21 de agosto de 1994"
13,4,62,1248,111,112,223,"21 de agosto de 1994"
13,4,62,1249,284,280,564,"21 de agosto de 1994"
13,4,62,1250,147,132,279,"21 de agosto de 1994"
13,4,62,1251,132,130,262,"21 de agosto de 1994"
13,4,62,1252,83,80,163,"21 de agosto de 1994"
13,4,62,1253,171,180,351,"21 de agosto de 1994"
13,4,62,1254,202,174,376,"21 de agosto de 1994"
13,4,62,1255,55,49,104,"21 de agosto de 1994"
13,4,62,1256,45,30,75,"21 de agosto de 1994"
13,4,62,1257,75,55,130,"21 de agosto de 1994"
13,4,62,1258,125,111,236,"21 de agosto de 1994"
13,4,62,1259,111,106,217,"21 de agosto de 1994"
13,4,62,1260,215,202,417,"21 de agosto de 1994"
13,4,62,1261,221,208,429,"21 de agosto de 1994"
13,4,72,1403,384,412,796,"21 de agosto de 1994"
13,4,72,1404,101,83,184,"21 de agosto de 1994"
13,4,72,1405,151,143,294,"21 de agosto de 1994"
13,4,72,1406,256,231,487,"21 de agosto de 1994"
13,4,72,1407,196,220,416,"21 de agosto de 1994"
13,4,72,1408,185,148,333,"21 de agosto de 1994"
13,4,72,1409,261,258,519,"21 de agosto de 1994"
13,4,72,1410,518,455,973,"21 de agosto de 1994"
13,4,72,1411,268,238,506,"21 de agosto de 1994"
13,4,72,1412,232,225,457,"21 de agosto de 1994"
13,4,72,1413,187,170,357,"21 de agosto de 1994"
13,4,72,1414,331,300,631,"21 de agosto de 1994"
13,4,72,1415,372,369,741,"21 de agosto de 1994"
13,4,72,1416,144,122,266,"21 de agosto de 1994"
13,4,72,1417,252,233,485,"21 de agosto de 1994"
13,4,72,1418,138,124,262,"21 de agosto de 1994"
13,4,72,1419,271,257,528,"21 de agosto de 1994"
13,4,72,1420,113,91,204,"21 de agosto de 1994"
13,4,72,1421,144,122,266,"21 de agosto de 1994"
13,4,72,1422,325,290,615,"21 de agosto de 1994"
13,4,72,1423,389,359,748,"21 de agosto de 1994"
13,4,72,1424,178,176,354,"21 de agosto de 1994"
13,4,72,1425,233,196,429,"21 de agosto de 1994"
13,4,72,1426,199,161,360,"21 de agosto de 1994"
13,4,72,1427,181,175,356,"21 de agosto de 1994"
13,4,72,1428,490,484,974,"21 de agosto de 1994"
13,4,78,1563,526,562,1088,"21 de agosto de 1994"
13,4,78,1564,211,222,433,"21 de agosto de 1994"
13,4,78,1565,200,223,423,"21 de agosto de 1994"
13,4,78,1566,127,140,267,"21 de agosto de 1994"
13,4,78,1567,373,399,772,"21 de agosto de 1994"
13,4,78,1568,342,377,719,"21 de agosto de 1994"
13,4,78,1569,206,209,415,"21 de agosto de 1994"
13,4,78,1570,324,334,658,"21 de agosto de 1994"
13,4,78,1571,251,240,491,"21 de agosto de 1994"
13,4,78,1572,318,322,640,"21 de agosto de 1994"
13,4,78,1573,111,140,251,"21 de agosto de 1994"
13,4,78,1574,126,125,251,"21 de agosto de 1994"
13,4,78,1575,208,159,367,"21 de agosto de 1994"
13,4,80,1585,633,623,1256,"21 de agosto de 1994"
13,4,80,1586,413,398,811,"21 de agosto de 1994"
13,4,80,1587,389,423,812,"21 de agosto de 1994"
13,4,80,1588,284,280,564,"21 de agosto de 1994"
13,4,80,1589,137,152,289,"21 de agosto de 1994"
13,4,80,1590,249,276,525,"21 de agosto de 1994"
13,4,80,1591,90,105,195,"21 de agosto de 1994"
13,4,80,1592,170,164,334,"21 de agosto de 1994"
13,4,80,1593,350,360,710,"21 de agosto de 1994"
13,4,80,1594,102,114,216,"21 de agosto de 1994"
13,4,80,1595,103,112,215,"21 de agosto de 1994"
13,4,80,1596,96,84,180,"21 de agosto de 1994"
13,4,80,1597,80,85,165,"21 de agosto de 1994"
13,4,80,1598,645,622,1267,"21 de agosto de 1994"
13,4,80,1599,316,316,632,"21 de agosto de 1994"
13,5,6,92,433,428,861,"21 de agosto de 1994"
13,5,6,93,157,172,329,"21 de agosto de 1994"
13,5,6,94,101,103,204,"21 de agosto de 1994"
13,5,6,95,312,300,612,"21 de agosto de 1994"
13,5,6,96,166,138,304,"21 de agosto de 1994"
13,5,6,97,236,202,438,"21 de agosto de 1994"
13,5,6,98,109,104,213,"21 de agosto de 1994"
13,5,6,99,331,329,660,"21 de agosto de 1994"
13,5,6,100,210,178,388,"21 de agosto de 1994"
13,5,6,101,266,284,550,"21 de agosto de 1994"
13,5,6,102,110,79,189,"21 de agosto de 1994"
13,5,6,103,365,359,724,"21 de agosto de 1994"
13,5,6,104,212,219,431,"21 de agosto de 1994"
13,5,6,105,180,148,328,"21 de agosto de 1994"
13,5,6,106,217,203,420,"21 de agosto de 1994"
13,5,6,107,163,144,307,"21 de agosto de 1994"
13,5,6,108,150,137,287,"21 de agosto de 1994"
13,5,6,109,163,132,295,"21 de agosto de 1994"
13,5,6,110,118,93,211,"21 de agosto de 1994"
13,5,6,111,258,225,483,"21 de agosto de 1994"
13,5,6,112,75,70,145,"21 de agosto de 1994"
13,5,6,113,102,79,181,"21 de agosto de 1994"
13,5,16,281,419,386,805,"21 de agosto de 1994"
13,5,16,282,361,360,721,"21 de agosto de 1994"
13,5,16,283,205,198,403,"21 de agosto de 1994"
13,5,16,284,167,146,313,"21 de agosto de 1994"
13,5,16,285,161,119,280,"21 de agosto de 1994"
13,5,16,286,376,323,699,"21 de agosto de 1994"
13,5,16,287,186,146,332,"21 de agosto de 1994"
13,5,16,288,385,339,724,"21 de agosto de 1994"
13,5,16,289,585,522,1107,"21 de agosto de 1994"
13,5,16,290,266,223,489,"21 de agosto de 1994"
13,5,17,291,419,435,854,"21 de agosto de 1994"
13,5,17,292,386,409,795,"21 de agosto de 1994"
13,5,17,293,118,93,211,"21 de agosto de 1994"
13,5,17,294,152,149,301,"21 de agosto de 1994"
13,5,17,295,67,53,120,"21 de agosto de 1994"
13,5,17,296,165,133,298,"21 de agosto de 1994"
13,5,17,297,163,144,307,"21 de agosto de 1994"
13,5,17,298,206,173,379,"21 de agosto de 1994"
13,5,17,299,77,60,137,"21 de agosto de 1994"
13,5,17,300,68,60,128,"21 de agosto de 1994"
13,5,17,301,100,83,183,"21 de agosto de 1994"
13,5,17,302,186,160,346,"21 de agosto de 1994"
13,5,17,303,123,99,222,"21 de agosto de 1994"
13,5,17,304,129,108,237,"21 de agosto de 1994"
13,5,17,305,178,143,321,"21 de agosto de 1994"
13,5,17,306,67,54,121,"21 de agosto de 1994"
13,5,17,307,244,184,428,"21 de agosto de 1994"
13,5,17,308,221,202,423,"21 de agosto de 1994"
13,5,17,309,419,409,828,"21 de agosto de 1994"
13,5,17,310,240,213,453,"21 de agosto de 1994"
13,5,17,311,249,193,442,"21 de agosto de 1994"
13,5,17,312,305,257,562,"21 de agosto de 1994"
13,5,17,313,117,82,199,"21 de agosto de 1994"
13,5,17,314,130,105,235,"21 de agosto de 1994"
13,5,17,315,261,235,496,"21 de agosto de 1994"
13,5,29,510,516,565,1081,"21 de agosto de 1994"
13,5,29,511,542,613,1155,"21 de agosto de 1994"
13,5,29,512,296,353,649,"21 de agosto de 1994"
13,5,29,513,433,497,930,"21 de agosto de 1994"
13,5,29,514,127,110,237,"21 de agosto de 1994"
13,5,29,515,86,73,159,"21 de agosto de 1994"
13,5,29,516,112,140,252,"21 de agosto de 1994"
13,5,29,517,338,311,649,"21 de agosto de 1994"
13,5,29,518,343,394,737,"21 de agosto de 1994"
13,5,29,519,232,202,434,"21 de agosto de 1994"
13,5,29,520,382,363,745,"21 de agosto de 1994"
13,5,29,521,156,148,304,"21 de agosto de 1994"
13,5,29,522,197,214,411,"21 de agosto de 1994"
13,5,29,523,425,404,829,"21 de agosto de 1994"
13,5,29,524,127,109,236,"21 de agosto de 1994"
13,5,29,525,151,142,293,"21 de agosto de 1994"
13,5,29,526,117,109,226,"21 de agosto de 1994"
13,5,29,527,134,140,274,"21 de agosto de 1994"
13,5,29,528,481,509,990,"21 de agosto de 1994"
13,5,29,529,67,63,130,"21 de agosto de 1994"
13,5,29,530,220,210,430,"21 de agosto de 1994"
13,5,29,531,178,181,359,"21 de agosto de 1994"
13,5,29,532,156,140,296,"21 de agosto de 1994"
13,5,29,533,211,205,416,"21 de agosto de 1994"
13,5,29,534,402,420,822,"21 de agosto de 1994"
13,5,29,535,421,451,872,"21 de agosto de 1994"
13,5,29,536,175,168,343,"21 de agosto de 1994"
13,5,29,537,292,267,559,"21 de agosto de 1994"
13,5,29,538,110,99,209,"21 de agosto de 1994"
13,5,29,539,274,293,567,"21 de agosto de 1994"
13,5,29,540,436,422,858,"21 de agosto de 1994"
13,5,29,541,92,85,177,"21 de agosto de 1994"
13,5,29,542,92,87,179,"21 de agosto de 1994"
13,5,29,543,256,306,562,"21 de agosto de 1994"
13,5,29,544,499,467,966,"21 de agosto de 1994"
13,5,29,545,267,260,527,"21 de agosto de 1994"
13,5,29,546,87,79,166,"21 de agosto de 1994"
13,5,30,547,460,578,1038,"21 de agosto de 1994"
13,5,30,548,279,347,626,"21 de agosto de 1994"
13,5,30,549,360,461,821,"21 de agosto de 1994"
13,5,30,550,460,570,1030,"21 de agosto de 1994"
13,5,30,551,524,639,1163,"21 de agosto de 1994"
13,5,30,552,531,660,1191,"21 de agosto de 1994"
13,5,30,553,526,722,1248,"21 de agosto de 1994"
13,5,30,554,182,236,418,"21 de agosto de 1994"
13,5,30,555,445,549,994,"21 de agosto de 1994"
13,5,30,556,308,421,729,"21 de agosto de 1994"
13,5,30,557,278,335,613,"21 de agosto de 1994"
13,5,30,558,139,172,311,"21 de agosto de 1994"
13,5,30,559,386,443,829,"21 de agosto de 1994"
13,5,30,560,554,742,1296,"21 de agosto de 1994"
13,5,30,561,380,437,817,"21 de agosto de 1994"
13,5,30,562,332,406,738,"21 de agosto de 1994"
13,5,30,563,335,432,767,"21 de agosto de 1994"
13,5,30,564,83,122,205,"21 de agosto de 1994"
13,5,30,565,84,86,170,"21 de agosto de 1994"
13,5,30,566,77,68,145,"21 de agosto de 1994"
13,5,30,567,50,49,99,"21 de agosto de 1994"
13,5,30,568,202,210,412,"21 de agosto de 1994"
13,5,30,569,175,160,335,"21 de agosto de 1994"
13,5,30,570,48,34,82,"21 de agosto de 1994"
13,5,30,571,46,47,93,"21 de agosto de 1994"
13,5,30,572,99,101,200,"21 de agosto de 1994"
13,5,30,573,36,24,60,"21 de agosto de 1994"
13,5,30,574,146,178,324,"21 de agosto de 1994"
13,5,30,575,415,459,874,"21 de agosto de 1994"
13,5,30,576,121,109,230,"21 de agosto de 1994"
13,5,30,577,144,154,298,"21 de agosto de 1994"
13,5,30,578,130,120,250,"21 de agosto de 1994"
13,5,30,579,217,222,439,"21 de agosto de 1994"
13,5,30,580,278,347,625,"21 de agosto de 1994"
13,5,30,581,452,547,999,"21 de agosto de 1994"
13,5,30,582,146,172,318,"21 de agosto de 1994"
13,5,30,583,176,215,391,"21 de agosto de 1994"
13,5,30,584,65,81,146,"21 de agosto de 1994"
13,5,30,585,146,158,304,"21 de agosto de 1994"
13,5,30,586,225,214,439,"21 de agosto de 1994"
13,5,30,587,125,127,252,"21 de agosto de 1994"
13,5,30,588,159,162,321,"21 de agosto de 1994"
13,5,30,589,129,136,265,"21 de agosto de 1994"
13,5,30,590,222,238,460,"21 de agosto de 1994"
13,5,30,591,112,149,261,"21 de agosto de 1994"
13,5,30,592,121,118,239,"21 de agosto de 1994"
13,5,30,593,472,476,948,"21 de agosto de 1994"
13,5,30,594,456,464,920,"21 de agosto de 1994"
13,5,30,595,723,673,1396,"21 de agosto de 1994"
13,5,30,596,301,369,670,"21 de agosto de 1994"
13,5,30,597,597,551,1148,"21 de agosto de 1994"
13,5,30,598,167,179,346,"21 de agosto de 1994"
13,5,30,599,58,64,122,"21 de agosto de 1994"
13,5,30,600,267,225,492,"21 de agosto de 1994"
13,5,30,601,384,404,788,"21 de agosto de 1994"
13,5,30,602,118,120,238,"21 de agosto de 1994"
13,5,30,603,251,234,485,"21 de agosto de 1994"
13,5,30,604,46,50,96,"21 de agosto de 1994"
13,5,30,605,258,288,546,"21 de agosto de 1994"
13,5,30,606,122,114,236,"21 de agosto de 1994"
13,5,30,607,508,532,1040,"21 de agosto de 1994"
13,5,31,608,483,586,1069,"21 de agosto de 1994"
13,5,31,609,347,427,774,"21 de agosto de 1994"
13,5,31,610,183,171,354,"21 de agosto de 1994"
13,5,31,611,126,162,288,"21 de agosto de 1994"
13,5,31,612,146,174,320,"21 de agosto de 1994"
13,5,31,613,180,192,372,"21 de agosto de 1994"
13,5,31,614,241,246,487,"21 de agosto de 1994"
13,5,31,615,56,50,106,"21 de agosto de 1994"
13,5,31,616,60,67,127,"21 de agosto de 1994"
13,5,31,617,37,55,92,"21 de agosto de 1994"
13,5,31,618,120,119,239,"21 de agosto de 1994"
13,5,31,619,37,25,62,"21 de agosto de 1994"
13,5,31,620,273,318,591,"21 de agosto de 1994"
13,5,31,621,45,42,87,"21 de agosto de 1994"
13,5,31,622,112,105,217,"21 de agosto de 1994"
13,5,31,623,35,35,70,"21 de agosto de 1994"
13,5,31,624,30,36,66,"21 de agosto de 1994"
13,5,31,625,42,51,93,"21 de agosto de 1994"
13,5,31,626,59,63,122,"21 de agosto de 1994"
13,5,31,627,132,147,279,"21 de agosto de 1994"
13,5,31,628,100,111,211,"21 de agosto de 1994"
13,5,31,629,137,164,301,"21 de agosto de 1994"
13,5,34,646,296,292,588,"21 de agosto de 1994"
13,5,34,647,333,269,602,"21 de agosto de 1994"
13,5,34,648,203,173,376,"21 de agosto de 1994"
13,5,34,649,312,273,585,"21 de agosto de 1994"
13,5,34,650,416,413,829,"21 de agosto de 1994"
13,5,34,651,114,116,230,"21 de agosto de 1994"
13,5,34,652,122,120,242,"21 de agosto de 1994"
13,5,34,653,196,168,364,"21 de agosto de 1994"
13,5,34,654,308,328,636,"21 de agosto de 1994"
13,5,34,655,321,299,620,"21 de agosto de 1994"
13,5,34,656,144,138,282,"21 de agosto de 1994"
13,5,43,780,183,211,394,"21 de agosto de 1994"
13,5,43,781,75,62,137,"21 de agosto de 1994"
13,5,43,782,84,81,165,"21 de agosto de 1994"
13,5,43,783,43,41,84,"21 de agosto de 1994"
13,5,43,784,86,101,187,"21 de agosto de 1994"
13,5,43,785,59,54,113,"21 de agosto de 1994"
13,5,43,786,42,55,97,"21 de agosto de 1994"
13,5,43,787,27,23,50,"21 de agosto de 1994"
13,5,43,788,99,100,199,"21 de agosto de 1994"
13,5,43,789,51,45,96,"21 de agosto de 1994"
13,5,43,790,77,86,163,"21 de agosto de 1994"
13,5,43,791,52,51,103,"21 de agosto de 1994"
13,5,43,792,33,32,65,"21 de agosto de 1994"
13,5,43,793,89,86,175,"21 de agosto de 1994"
13,5,43,794,26,27,53,"21 de agosto de 1994"
13,5,43,795,100,99,199,"21 de agosto de 1994"
13,5,43,796,69,85,154,"21 de agosto de 1994"
13,5,43,797,58,58,116,"21 de agosto de 1994"
13,5,43,798,33,39,72,"21 de agosto de 1994"
13,5,43,799,93,94,187,"21 de agosto de 1994"
13,5,43,800,84,88,172,"21 de agosto de 1994"
13,5,43,801,48,56,104,"21 de agosto de 1994"
13,5,44,802,791,746,1537,"21 de agosto de 1994"
13,5,44,803,552,602,1154,"21 de agosto de 1994"
13,5,44,804,291,251,542,"21 de agosto de 1994"
13,5,44,805,308,238,546,"21 de agosto de 1994"
13,5,44,806,405,363,768,"21 de agosto de 1994"
13,5,44,807,594,554,1148,"21 de agosto de 1994"
13,5,44,808,269,219,488,"21 de agosto de 1994"
13,5,44,809,239,180,419,"21 de agosto de 1994"
13,5,44,810,294,256,550,"21 de agosto de 1994"
13,5,44,811,231,191,422,"21 de agosto de 1994"
13,5,46,822,157,185,342,"21 de agosto de 1994"
13,5,46,823,170,197,367,"21 de agosto de 1994"
13,5,46,824,235,280,515,"21 de agosto de 1994"
13,5,46,825,123,137,260,"21 de agosto de 1994"
13,5,46,826,95,104,199,"21 de agosto de 1994"
13,5,46,827,73,106,179,"21 de agosto de 1994"
13,5,46,828,101,122,223,"21 de agosto de 1994"
13,5,46,829,137,145,282,"21 de agosto de 1994"
13,5,46,830,63,69,132,"21 de agosto de 1994"
13,5,46,831,113,130,243,"21 de agosto de 1994"
13,5,48,962,649,608,1257,"21 de agosto de 1994"
13,5,48,963,180,150,330,"21 de agosto de 1994"
13,5,48,964,124,88,212,"21 de agosto de 1994"
13,5,48,965,83,94,177,"21 de agosto de 1994"
13,5,48,966,117,100,217,"21 de agosto de 1994"
13,5,48,967,350,302,652,"21 de agosto de 1994"
13,5,48,968,59,53,112,"21 de agosto de 1994"
13,5,48,969,108,79,187,"21 de agosto de 1994"
13,5,48,970,269,252,521,"21 de agosto de 1994"
13,5,48,971,124,92,216,"21 de agosto de 1994"
13,5,48,972,452,399,851,"21 de agosto de 1994"
13,5,48,973,149,109,258,"21 de agosto de 1994"
13,5,48,974,151,132,283,"21 de agosto de 1994"
13,5,48,975,114,111,225,"21 de agosto de 1994"
13,5,48,976,127,107,234,"21 de agosto de 1994"
13,5,48,977,64,69,133,"21 de agosto de 1994"
13,5,48,978,177,162,339,"21 de agosto de 1994"
13,5,48,979,71,65,136,"21 de agosto de 1994"
13,5,48,980,61,53,114,"21 de agosto de 1994"
13,5,48,981,139,123,262,"21 de agosto de 1994"
13,5,58,1132,217,276,493,"21 de agosto de 1994"
13,5,58,1133,303,381,684,"21 de agosto de 1994"
13,5,58,1134,428,529,957,"21 de agosto de 1994"
13,5,58,1135,147,173,320,"21 de agosto de 1994"
13,5,58,1136,63,61,124,"21 de agosto de 1994"
13,5,58,1137,151,177,328,"21 de agosto de 1994"
13,5,58,1138,194,250,444,"21 de agosto de 1994"
13,5,58,1139,117,177,294,"21 de agosto de 1994"
13,5,58,1140,27,38,65,"21 de agosto de 1994"
13,5,58,1141,89,124,213,"21 de agosto de 1994"
13,5,58,1142,162,197,359,"21 de agosto de 1994"
13,5,58,1143,87,70,157,"21 de agosto de 1994"
13,5,58,1144,115,128,243,"21 de agosto de 1994"
13,5,58,1145,124,136,260,"21 de agosto de 1994"
13,5,58,1146,171,195,366,"21 de agosto de 1994"
13,5,58,1147,115,108,223,"21 de agosto de 1994"
13,5,58,1148,198,168,366,"21 de agosto de 1994"
13,5,58,1149,154,125,279,"21 de agosto de 1994"
13,5,58,1150,363,312,675,"21 de agosto de 1994"
13,5,58,1151,354,571,925,"21 de agosto de 1994"
13,5,59,1152,612,697,1309,"21 de agosto de 1994"
13,5,59,1153,632,717,1349,"21 de agosto de 1994"
13,5,59,1154,162,213,375,"21 de agosto de 1994"
13,5,59,1155,134,161,295,"21 de agosto de 1994"
13,5,59,1156,199,195,394,"21 de agosto de 1994"
13,5,59,1157,473,457,930,"21 de agosto de 1994"
13,5,59,1158,233,252,485,"21 de agosto de 1994"
13,5,59,1159,471,463,934,"21 de agosto de 1994"
13,5,59,1160,235,236,471,"21 de agosto de 1994"
13,5,59,1161,385,387,772,"21 de agosto de 1994"
13,5,59,1162,440,489,929,"21 de agosto de 1994"
13,5,59,1163,276,266,542,"21 de agosto de 1994"
13,5,59,1164,124,114,238,"21 de agosto de 1994"
13,5,59,1165,143,136,279,"21 de agosto de 1994"
13,5,59,1166,103,108,211,"21 de agosto de 1994"
13,5,59,1167,65,79,144,"21 de agosto de 1994"
13,5,59,1168,195,175,370,"21 de agosto de 1994"
13,5,59,1169,102,71,173,"21 de agosto de 1994"
13,5,59,1170,281,269,550,"21 de agosto de 1994"
13,5,59,1171,295,300,595,"21 de agosto de 1994"
13,5,59,1172,102,64,166,"21 de agosto de 1994"
13,5,59,1173,258,257,515,"21 de agosto de 1994"
13,5,59,1174,506,437,943,"21 de agosto de 1994"
13,5,59,1175,265,276,541,"21 de agosto de 1994"
13,5,59,1176,81,86,167,"21 de agosto de 1994"
13,5,84,1644,779,453,1232,"21 de agosto de 1994"
13,5,84,1645,350,394,744,"21 de agosto de 1994"
13,5,84,1646,210,298,508,"21 de agosto de 1994"
13,5,84,1647,240,277,517,"21 de agosto de 1994"
13,5,84,1648,213,270,483,"21 de agosto de 1994"
13,5,84,1649,392,478,870,"21 de agosto de 1994"
13,5,84,1650,386,432,818,"21 de agosto de 1994"
13,5,84,1651,51,35,86,"21 de agosto de 1994"
13,5,84,1652,51,65,116,"21 de agosto de 1994"
13,5,84,1653,173,192,365,"21 de agosto de 1994"
13,5,84,1654,69,63,132,"21 de agosto de 1994"
13,5,84,1655,59,55,114,"21 de agosto de 1994"
13,5,84,1656,67,63,130,"21 de agosto de 1994"
13,5,84,1657,54,46,100,"21 de agosto de 1994"
13,5,84,1658,18,28,46,"21 de agosto de 1994"
13,5,84,1659,55,55,110,"21 de agosto de 1994"
13,5,84,1660,100,106,206,"21 de agosto de 1994"
13,5,84,1661,50,51,101,"21 de agosto de 1994"
13,5,84,1662,170,158,328,"21 de agosto de 1994"
13,5,84,1663,73,74,147,"21 de agosto de 1994"
13,5,84,1664,73,97,170,"21 de agosto de 1994"
13,5,84,1665,72,67,139,"21 de agosto de 1994"
13,5,84,1666,24,26,50,"21 de agosto de 1994"
13,5,84,1667,45,50,95,"21 de agosto de 1994"
13,5,84,1668,235,315,550,"21 de agosto de 1994"
13,5,84,1669,50,68,118,"21 de agosto de 1994"
13,5,84,1670,80,79,159,"21 de agosto de 1994"
13,5,84,1671,50,50,100,"21 de agosto de 1994"
13,5,84,1672,70,70,140,"21 de agosto de 1994"
13,5,84,1673,61,63,124,"21 de agosto de 1994"
13,5,84,1674,31,40,71,"21 de agosto de 1994"
13,5,84,1675,200,233,433,"21 de agosto de 1994"
13,5,84,1676,173,203,376,"21 de agosto de 1994"
13,5,84,1677,33,32,65,"21 de agosto de 1994"
13,5,84,1678,264,315,579,"21 de agosto de 1994"
13,5,84,1679,291,360,651,"21 de agosto de 1994"
13,5,84,1680,348,432,780,"21 de agosto de 1994"
13,5,84,1681,107,151,258,"21 de agosto de 1994"
13,5,84,1682,184,229,413,"21 de agosto de 1994"
13,5,84,1683,274,312,586,"21 de agosto de 1994"
13,5,84,1684,238,255,493,"21 de agosto de 1994"
13,5,84,1685,52,78,130,"21 de agosto de 1994"
13,5,84,1686,84,80,164,"21 de agosto de 1994"
13,5,84,1687,135,131,266,"21 de agosto de 1994"
13,5,84,1688,129,112,241,"21 de agosto de 1994"
13,5,84,1689,41,38,79,"21 de agosto de 1994"
13,5,84,1690,20,31,51,"21 de agosto de 1994"
13,5,84,1691,28,35,63,"21 de agosto de 1994"
13,5,84,1692,78,100,178,"21 de agosto de 1994"
13,5,84,1693,66,86,152,"21 de agosto de 1994"
13,5,84,1694,497,561,1058,"21 de agosto de 1994"
13,5,84,1695,27,52,79,"21 de agosto de 1994"
13,5,84,1696,76,101,177,"21 de agosto de 1994"
13,5,84,1697,42,53,95,"21 de agosto de 1994"
13,5,84,1698,66,62,128,"21 de agosto de 1994"
13,5,84,1699,124,125,249,"21 de agosto de 1994"
13,5,84,1700,111,119,230,"21 de agosto de 1994"
13,5,84,1701,49,60,109,"21 de agosto de 1994"
13,5,84,1702,151,170,321,"21 de agosto de 1994"
13,5,84,1703,145,172,317,"21 de agosto de 1994"
13,5,84,1704,82,82,164,"21 de agosto de 1994"
13,5,84,1705,33,36,69,"21 de agosto de 1994"
13,5,84,1706,103,142,245,"21 de agosto de 1994"
13,5,84,1707,47,33,80,"21 de agosto de 1994"
13,6,3,34,315,392,707,"21 de agosto de 1994"
13,6,3,35,325,382,707,"21 de agosto de 1994"
13,6,3,36,239,267,506,"21 de agosto de 1994"
13,6,3,37,440,526,966,"21 de agosto de 1994"
13,6,3,38,409,493,902,"21 de agosto de 1994"
13,6,3,39,519,671,1190,"21 de agosto de 1994"
13,6,3,40,600,733,1333,"21 de agosto de 1994"
13,6,3,41,273,305,578,"21 de agosto de 1994"
13,6,3,42,231,294,525,"21 de agosto de 1994"
13,6,3,43,403,517,920,"21 de agosto de 1994"
13,6,3,44,624,762,1386,"21 de agosto de 1994"
13,6,3,45,373,445,818,"21 de agosto de 1994"
13,6,3,46,318,408,726,"21 de agosto de 1994"
13,6,3,47,334,404,738,"21 de agosto de 1994"
13,6,3,48,112,96,208,"21 de agosto de 1994"
13,6,3,49,91,76,167,"21 de agosto de 1994"
13,6,3,50,50,46,96,"21 de agosto de 1994"
13,6,3,51,84,84,168,"21 de agosto de 1994"
13,6,3,52,248,238,486,"21 de agosto de 1994"
13,6,3,53,112,114,226,"21 de agosto de 1994"
13,6,3,54,276,323,599,"21 de agosto de 1994"
13,6,3,55,274,303,577,"21 de agosto de 1994"
13,6,3,56,91,85,176,"21 de agosto de 1994"
13,6,3,57,201,204,405,"21 de agosto de 1994"
13,6,3,58,131,108,239,"21 de agosto de 1994"
13,6,3,59,121,118,239,"21 de agosto de 1994"
13,6,3,60,466,506,972,"21 de agosto de 1994"
13,6,3,61,152,154,306,"21 de agosto de 1994"
13,6,3,62,530,527,1057,"21 de agosto de 1994"
13,6,3,63,91,100,191,"21 de agosto de 1994"
13,6,3,64,150,186,336,"21 de agosto de 1994"
13,6,3,65,391,421,812,"21 de agosto de 1994"
13,6,3,66,330,348,678,"21 de agosto de 1994"
13,6,3,67,327,362,689,"21 de agosto de 1994"
13,6,3,68,314,343,657,"21 de agosto de 1994"
13,6,11,178,365,403,768,"21 de agosto de 1994"
13,6,11,179,472,586,1058,"21 de agosto de 1994"
13,6,11,180,356,416,772,"21 de agosto de 1994"
13,6,11,181,266,318,584,"21 de agosto de 1994"
13,6,11,182,73,85,158,"21 de agosto de 1994"
13,6,11,183,109,133,242,"21 de agosto de 1994"
13,6,11,184,188,170,358,"21 de agosto de 1994"
13,6,11,185,53,86,139,"21 de agosto de 1994"
13,6,11,186,164,184,348,"21 de agosto de 1994"
13,6,11,187,336,354,690,"21 de agosto de 1994"
13,6,11,188,205,181,386,"21 de agosto de 1994"
13,6,11,189,186,177,363,"21 de agosto de 1994"
13,6,11,190,151,173,324,"21 de agosto de 1994"
13,6,11,191,197,243,440,"21 de agosto de 1994"
13,6,11,192,140,243,383,"21 de agosto de 1994"
13,6,11,193,251,270,521,"21 de agosto de 1994"
13,6,11,194,293,388,681,"21 de agosto de 1994"
13,6,11,195,220,255,475,"21 de agosto de 1994"
13,6,11,196,129,159,288,"21 de agosto de 1994"
13,6,11,197,334,372,706,"21 de agosto de 1994"
13,6,11,198,70,71,141,"21 de agosto de 1994"
13,6,11,199,114,122,236,"21 de agosto de 1994"
13,6,11,200,200,192,392,"21 de agosto de 1994"
13,6,11,201,229,251,480,"21 de agosto de 1994"
13,6,11,202,138,112,250,"21 de agosto de 1994"
13,6,11,203,271,333,604,"21 de agosto de 1994"
13,6,11,204,352,289,641,"21 de agosto de 1994"
13,6,11,205,52,56,108,"21 de agosto de 1994"
13,6,14,240,308,312,620,"21 de agosto de 1994"
13,6,14,241,321,335,656,"21 de agosto de 1994"
13,6,14,242,103,104,207,"21 de agosto de 1994"
13,6,14,243,241,212,453,"21 de agosto de 1994"
13,6,14,244,85,79,164,"21 de agosto de 1994"
13,6,14,245,281,301,582,"21 de agosto de 1994"
13,6,14,246,360,341,701,"21 de agosto de 1994"
13,6,14,247,182,163,345,"21 de agosto de 1994"
13,6,14,248,176,129,305,"21 de agosto de 1994"
13,6,14,249,337,323,660,"21 de agosto de 1994"
13,6,14,250,462,430,892,"21 de agosto de 1994"
13,6,14,251,162,165,327,"21 de agosto de 1994"
13,6,14,252,135,110,245,"21 de agosto de 1994"
13,6,14,253,192,144,336,"21 de agosto de 1994"
13,6,14,254,111,89,200,"21 de agosto de 1994"
13,6,14,255,234,234,468,"21 de agosto de 1994"
13,6,14,256,253,217,470,"21 de agosto de 1994"
13,6,19,331,480,548,1028,"21 de agosto de 1994"
13,6,19,332,246,262,508,"21 de agosto de 1994"
13,6,19,333,274,254,528,"21 de agosto de 1994"
13,6,19,334,112,106,218,"21 de agosto de 1994"
13,6,19,335,199,224,423,"21 de agosto de 1994"
13,6,19,336,407,441,848,"21 de agosto de 1994"
13,6,19,337,172,180,352,"21 de agosto de 1994"
13,6,19,338,132,151,283,"21 de agosto de 1994"
13,6,19,339,171,167,338,"21 de agosto de 1994"
13,6,19,340,702,665,1367,"21 de agosto de 1994"
13,6,19,341,241,286,527,"21 de agosto de 1994"
13,6,20,342,254,263,517,"21 de agosto de 1994"
13,6,20,343,46,43,89,"21 de agosto de 1994"
13,6,20,344,41,36,77,"21 de agosto de 1994"
13,6,20,345,245,251,496,"21 de agosto de 1994"
13,6,20,346,77,90,167,"21 de agosto de 1994"
13,6,20,347,38,39,77,"21 de agosto de 1994"
13,6,20,348,78,68,146,"21 de agosto de 1994"
13,6,20,349,78,76,154,"21 de agosto de 1994"
13,6,24,386,270,312,582,"21 de agosto de 1994"
13,6,24,387,227,243,470,"21 de agosto de 1994"
13,6,24,388,90,88,178,"21 de agosto de 1994"
13,6,24,389,78,67,145,"21 de agosto de 1994"
13,6,24,390,65,71,136,"21 de agosto de 1994"
13,6,24,391,184,188,372,"21 de agosto de 1994"
13,6,24,392,347,328,675,"21 de agosto de 1994"
13,6,24,393,125,118,243,"21 de agosto de 1994"
13,6,24,394,87,74,161,"21 de agosto de 1994"
13,6,24,395,269,282,551,"21 de agosto de 1994"
13,6,24,396,203,173,376,"21 de agosto de 1994"
13,6,24,397,238,273,511,"21 de agosto de 1994"
13,6,24,398,210,256,466,"21 de agosto de 1994"
13,6,24,399,286,332,618,"21 de agosto de 1994"
13,6,24,400,338,319,657,"21 de agosto de 1994"
13,6,24,401,88,81,169,"21 de agosto de 1994"
13,6,24,402,92,125,217,"21 de agosto de 1994"
13,6,24,403,161,142,303,"21 de agosto de 1994"
13,6,24,404,58,67,125,"21 de agosto de 1994"
13,6,33,642,225,215,440,"21 de agosto de 1994"
13,6,33,643,138,116,254,"21 de agosto de 1994"
13,6,33,644,165,167,332,"21 de agosto de 1994"
13,6,33,645,284,294,578,"21 de agosto de 1994"
13,6,37,674,309,339,648,"21 de agosto de 1994"
13,6,37,675,432,480,912,"21 de agosto de 1994"
13,6,37,676,175,204,379,"21 de agosto de 1994"
13,6,37,677,103,91,194,"21 de agosto de 1994"
13,6,37,678,216,238,454,"21 de agosto de 1994"
13,6,37,679,230,214,444,"21 de agosto de 1994"
13,6,37,680,467,489,956,"21 de agosto de 1994"
13,6,37,681,391,417,808,"21 de agosto de 1994"
13,6,37,682,62,60,122,"21 de agosto de 1994"
13,6,37,683,107,85,192,"21 de agosto de 1994"
13,6,37,684,171,160,331,"21 de agosto de 1994"
13,6,37,685,103,113,216,"21 de agosto de 1994"
13,6,37,686,210,214,424,"21 de agosto de 1994"
13,6,37,687,124,106,230,"21 de agosto de 1994"
13,6,37,688,118,118,236,"21 de agosto de 1994"
13,6,37,689,239,253,492,"21 de agosto de 1994"
13,6,37,690,116,97,213,"21 de agosto de 1994"
13,6,37,691,206,171,377,"21 de agosto de 1994"
13,6,37,692,100,89,189,"21 de agosto de 1994"
13,6,37,693,198,203,401,"21 de agosto de 1994"
13,6,37,694,221,250,471,"21 de agosto de 1994"
13,6,37,695,251,189,440,"21 de agosto de 1994"
13,6,37,696,55,41,96,"21 de agosto de 1994"
13,6,37,697,305,315,620,"21 de agosto de 1994"
13,6,37,698,173,165,338,"21 de agosto de 1994"
13,6,37,699,55,38,93,"21 de agosto de 1994"
13,6,38,700,214,225,439,"21 de agosto de 1994"
13,6,38,701,31,32,63,"21 de agosto de 1994"
13,6,38,702,92,98,190,"21 de agosto de 1994"
13,6,38,703,36,30,66,"21 de agosto de 1994"
13,6,38,704,392,354,746,"21 de agosto de 1994"
13,6,38,705,39,34,73,"21 de agosto de 1994"
13,6,38,706,32,35,67,"21 de agosto de 1994"
13,6,38,707,73,69,142,"21 de agosto de 1994"
13,6,38,708,147,125,272,"21 de agosto de 1994"
13,6,38,709,28,30,58,"21 de agosto de 1994"
13,6,38,710,353,374,727,"21 de agosto de 1994"
13,6,38,711,82,57,139,"21 de agosto de 1994"
13,6,38,712,173,176,349,"21 de agosto de 1994"
13,6,39,713,257,289,546,"21 de agosto de 1994"
13,6,39,714,320,389,709,"21 de agosto de 1994"
13,6,39,715,397,427,824,"21 de agosto de 1994"
13,6,39,716,373,415,788,"21 de agosto de 1994"
13,6,39,717,310,360,670,"21 de agosto de 1994"
13,6,39,718,367,396,763,"21 de agosto de 1994"
13,6,39,719,285,309,594,"21 de agosto de 1994"
13,6,39,720,518,609,1127,"21 de agosto de 1994"
13,6,39,721,124,122,246,"21 de agosto de 1994"
13,6,39,722,60,67,127,"21 de agosto de 1994"
13,6,39,723,218,220,438,"21 de agosto de 1994"
13,6,39,724,60,53,113,"21 de agosto de 1994"
13,6,45,812,560,595,1155,"21 de agosto de 1994"
13,6,45,813,268,270,538,"21 de agosto de 1994"
13,6,45,814,109,116,225,"21 de agosto de 1994"
13,6,45,815,121,127,248,"21 de agosto de 1994"
13,6,45,816,208,210,418,"21 de agosto de 1994"
13,6,45,817,194,176,370,"21 de agosto de 1994"
13,6,45,818,287,267,554,"21 de agosto de 1994"
13,6,45,819,168,184,352,"21 de agosto de 1994"
13,6,45,820,105,125,230,"21 de agosto de 1994"
13,6,45,821,68,65,133,"21 de agosto de 1994"
13,6,50,994,583,606,1189,"21 de agosto de 1994"
13,6,50,995,67,96,163,"21 de agosto de 1994"
13,6,50,996,237,297,534,"21 de agosto de 1994"
13,6,50,997,196,210,406,"21 de agosto de 1994"
13,6,50,998,58,47,105,"21 de agosto de 1994"
13,6,50,999,110,132,242,"21 de agosto de 1994"
13,6,50,1000,177,191,368,"21 de agosto de 1994"
13,6,50,1001,157,189,346,"21 de agosto de 1994"
13,6,50,1002,179,190,369,"21 de agosto de 1994"
13,6,50,1003,46,55,101,"21 de agosto de 1994"
13,6,50,1004,47,58,105,"21 de agosto de 1994"
13,6,50,1005,131,154,285,"21 de agosto de 1994"
13,6,50,1006,82,69,151,"21 de agosto de 1994"
13,6,50,1007,50,54,104,"21 de agosto de 1994"
13,6,54,1067,406,447,853,"21 de agosto de 1994"
13,6,54,1068,354,266,620,"21 de agosto de 1994"
13,6,54,1069,127,103,230,"21 de agosto de 1994"
13,6,54,1070,380,384,764,"21 de agosto de 1994"
13,6,54,1071,128,112,240,"21 de agosto de 1994"
13,6,54,1072,319,280,599,"21 de agosto de 1994"
13,6,54,1073,303,286,589,"21 de agosto de 1994"
13,6,54,1074,256,269,525,"21 de agosto de 1994"
13,6,54,1075,156,150,306,"21 de agosto de 1994"
13,6,54,1076,214,220,434,"21 de agosto de 1994"
13,6,54,1077,130,124,254,"21 de agosto de 1994"
13,6,54,1078,334,366,700,"21 de agosto de 1994"
13,6,54,1079,541,574,1115,"21 de agosto de 1994"
13,6,54,1080,206,240,446,"21 de agosto de 1994"
13,6,54,1081,209,188,397,"21 de agosto de 1994"
13,6,54,1082,115,123,238,"21 de agosto de 1994"
13,6,54,1083,79,67,146,"21 de agosto de 1994"
13,6,54,1084,285,296,581,"21 de agosto de 1994"
13,6,54,1085,618,675,1293,"21 de agosto de 1994"
13,6,54,1086,201,247,448,"21 de agosto de 1994"
13,6,54,1087,542,544,1086,"21 de agosto de 1994"
13,6,54,1088,343,333,676,"21 de agosto de 1994"
13,6,54,1089,181,165,346,"21 de agosto de 1994"
13,6,54,1090,255,240,495,"21 de agosto de 1994"
13,6,55,1091,470,489,959,"21 de agosto de 1994"
13,6,55,1092,59,46,105,"21 de agosto de 1994"
13,6,55,1093,46,38,84,"21 de agosto de 1994"
13,6,55,1094,72,70,142,"21 de agosto de 1994"
13,6,55,1095,44,31,75,"21 de agosto de 1994"
13,6,55,1096,271,251,522,"21 de agosto de 1994"
13,6,55,1097,155,131,286,"21 de agosto de 1994"
13,6,55,1098,126,124,250,"21 de agosto de 1994"
13,6,55,1099,501,526,1027,"21 de agosto de 1994"
13,6,55,1100,337,351,688,"21 de agosto de 1994"
13,6,55,1101,149,155,304,"21 de agosto de 1994"
13,6,55,1102,135,122,257,"21 de agosto de 1994"
13,6,55,1103,96,105,201,"21 de agosto de 1994"
13,6,55,1104,78,81,159,"21 de agosto de 1994"
13,6,55,1105,217,202,419,"21 de agosto de 1994"
13,6,55,1106,125,118,243,"21 de agosto de 1994"
13,6,55,1107,174,136,310,"21 de agosto de 1994"
13,6,55,1108,160,124,284,"21 de agosto de 1994"
13,6,55,1109,271,257,528,"21 de agosto de 1994"
13,6,67,1333,314,324,638,"21 de agosto de 1994"
13,6,67,1334,298,307,605,"21 de agosto de 1994"
13,6,67,1335,115,99,214,"21 de agosto de 1994"
13,6,67,1336,169,186,355,"21 de agosto de 1994"
13,6,67,1337,158,136,294,"21 de agosto de 1994"
13,6,67,1338,244,178,422,"21 de agosto de 1994"
13,6,67,1339,77,64,141,"21 de agosto de 1994"
13,6,67,1340,154,119,273,"21 de agosto de 1994"
13,6,67,1341,182,180,362,"21 de agosto de 1994"
13,6,67,1342,229,229,458,"21 de agosto de 1994"
13,6,67,1343,127,108,235,"21 de agosto de 1994"
13,6,67,1344,283,240,523,"21 de agosto de 1994"
13,6,67,1345,153,161,314,"21 de agosto de 1994"
13,6,67,1346,272,273,545,"21 de agosto de 1994"
13,6,67,1347,202,221,423,"21 de agosto de 1994"
13,6,67,1348,136,202,338,"21 de agosto de 1994"
13,6,70,1378,221,183,404,"21 de agosto de 1994"
13,6,70,1379,194,141,335,"21 de agosto de 1994"
13,6,70,1380,238,179,417,"21 de agosto de 1994"
13,6,70,1381,180,151,331,"21 de agosto de 1994"
13,6,70,1382,107,75,182,"21 de agosto de 1994"
13,6,70,1383,92,69,161,"21 de agosto de 1994"
13,6,70,1384,85,70,155,"21 de agosto de 1994"
13,6,70,1385,125,120,245,"21 de agosto de 1994"
13,6,70,1386,197,132,329,"21 de agosto de 1994"
13,6,70,1387,56,32,88,"21 de agosto de 1994"
13,6,70,1388,257,252,509,"21 de agosto de 1994"
13,6,70,1389,81,66,147,"21 de agosto de 1994"
13,6,70,1390,103,99,202,"21 de agosto de 1994"
13,6,70,1391,196,185,381,"21 de agosto de 1994"
13,6,70,1392,145,169,314,"21 de agosto de 1994"
13,6,70,1393,106,112,218,"21 de agosto de 1994"
13,6,70,1394,51,67,118,"21 de agosto de 1994"
13,6,79,1576,265,266,531,"21 de agosto de 1994"
13,6,79,1577,295,287,582,"21 de agosto de 1994"
13,6,79,1578,265,243,508,"21 de agosto de 1994"
13,6,79,1579,213,194,407,"21 de agosto de 1994"
13,6,79,1580,74,73,147,"21 de agosto de 1994"
13,6,79,1581,206,207,413,"21 de agosto de 1994"
13,6,79,1582,171,183,354,"21 de agosto de 1994"
13,6,79,1583,328,322,650,"21 de agosto de 1994"
13,6,79,1584,203,218,421,"21 de agosto de 1994"
13,6,81,1600,321,340,661,"21 de agosto de 1994"
13,6,81,1601,289,297,586,"21 de agosto de 1994"
13,6,81,1602,396,372,768,"21 de agosto de 1994"
13,6,81,1603,360,432,792,"21 de agosto de 1994"
13,6,81,1604,307,366,673,"21 de agosto de 1994"
13,6,81,1605,322,366,688,"21 de agosto de 1994"
13,6,81,1606,351,456,807,"21 de agosto de 1994"
13,6,81,1607,311,359,670,"21 de agosto de 1994"
13,6,81,1608,307,341,648,"21 de agosto de 1994"
13,6,81,1609,111,85,196,"21 de agosto de 1994"
13,6,81,1610,214,165,379,"21 de agosto de 1994"
13,6,81,1611,149,257,406,"21 de agosto de 1994"
13,6,81,1612,60,58,118,"21 de agosto de 1994"
13,6,81,1613,166,136,302,"21 de agosto de 1994"
13,6,81,1614,266,246,512,"21 de agosto de 1994"
13,6,81,1615,180,164,344,"21 de agosto de 1994"
13,6,81,1616,160,157,317,"21 de agosto de 1994"
13,6,81,1617,171,166,337,"21 de agosto de 1994"
13,6,81,1618,185,175,360,"21 de agosto de 1994"
14,1,41,570,272,381,653,"21 de agosto de 1994"
14,1,41,571,245,322,567,"21 de agosto de 1994"
14,1,41,572,367,439,806,"21 de agosto de 1994"
14,1,41,573,277,376,653,"21 de agosto de 1994"
14,1,41,574,271,366,637,"21 de agosto de 1994"
14,1,41,575,262,345,607,"21 de agosto de 1994"
14,1,41,576,278,390,668,"21 de agosto de 1994"
14,1,41,577,257,326,583,"21 de agosto de 1994"
14,1,41,578,441,529,970,"21 de agosto de 1994"
14,1,41,579,339,414,753,"21 de agosto de 1994"
14,1,41,580,239,324,563,"21 de agosto de 1994"
14,1,41,581,348,412,760,"21 de agosto de 1994"
14,1,41,582,454,563,1017,"21 de agosto de 1994"
14,1,41,583,208,272,480,"21 de agosto de 1994"
14,1,41,584,318,418,736,"21 de agosto de 1994"
14,1,41,585,291,359,650,"21 de agosto de 1994"
14,1,41,586,515,656,1171,"21 de agosto de 1994"
14,1,41,587,597,706,1303,"21 de agosto de 1994"
14,1,41,588,340,441,781,"21 de agosto de 1994"
14,1,41,589,343,418,761,"21 de agosto de 1994"
14,1,41,590,374,527,901,"21 de agosto de 1994"
14,1,41,591,293,346,639,"21 de agosto de 1994"
14,1,41,592,336,392,728,"21 de agosto de 1994"
14,1,41,593,454,561,1015,"21 de agosto de 1994"
14,1,41,594,325,473,798,"21 de agosto de 1994"
14,1,41,595,262,335,597,"21 de agosto de 1994"
14,1,41,596,330,431,761,"21 de agosto de 1994"
14,1,41,597,256,339,595,"21 de agosto de 1994"
14,1,41,598,227,295,522,"21 de agosto de 1994"
14,1,41,599,375,495,870,"21 de agosto de 1994"
14,1,41,600,509,686,1195,"21 de agosto de 1994"
14,1,41,601,438,605,1043,"21 de agosto de 1994"
14,1,41,602,452,618,1070,"21 de agosto de 1994"
14,1,41,603,305,388,693,"21 de agosto de 1994"
14,1,41,604,270,381,651,"21 de agosto de 1994"
14,1,41,605,303,419,722,"21 de agosto de 1994"
14,1,41,606,239,333,572,"21 de agosto de 1994"
14,1,41,607,252,369,621,"21 de agosto de 1994"
14,1,41,608,318,443,761,"21 de agosto de 1994"
14,1,41,609,449,512,961,"21 de agosto de 1994"
14,1,41,610,253,320,573,"21 de agosto de 1994"
14,1,41,611,318,423,741,"21 de agosto de 1994"
14,1,41,612,369,446,815,"21 de agosto de 1994"
14,1,41,613,402,473,875,"21 de agosto de 1994"
14,1,41,614,397,522,919,"21 de agosto de 1994"
14,1,41,615,279,322,601,"21 de agosto de 1994"
14,1,41,616,454,541,995,"21 de agosto de 1994"
14,1,41,617,372,456,828,"21 de agosto de 1994"
14,1,41,618,327,378,705,"21 de agosto de 1994"
14,1,41,619,200,251,451,"21 de agosto de 1994"
14,1,41,620,222,283,505,"21 de agosto de 1994"
14,1,41,621,524,414,938,"21 de agosto de 1994"
14,1,41,622,434,458,892,"21 de agosto de 1994"
14,1,41,623,261,339,600,"21 de agosto de 1994"
14,1,41,624,352,429,781,"21 de agosto de 1994"
14,1,41,625,217,271,488,"21 de agosto de 1994"
14,1,41,626,335,494,829,"21 de agosto de 1994"
14,1,41,627,343,459,802,"21 de agosto de 1994"
14,1,41,628,343,399,742,"21 de agosto de 1994"
14,1,41,629,226,310,536,"21 de agosto de 1994"
14,1,41,630,451,534,985,"21 de agosto de 1994"
14,1,41,631,454,607,1061,"21 de agosto de 1994"
14,1,41,632,240,330,570,"21 de agosto de 1994"
14,2,41,633,443,502,945,"21 de agosto de 1994"
14,2,41,634,359,450,809,"21 de agosto de 1994"
14,2,41,635,454,489,943,"21 de agosto de 1994"
14,2,41,636,386,456,842,"21 de agosto de 1994"
14,2,41,637,623,747,1370,"21 de agosto de 1994"
14,2,41,638,709,881,1590,"21 de agosto de 1994"
14,2,41,639,437,480,917,"21 de agosto de 1994"
14,2,41,640,419,480,899,"21 de agosto de 1994"
14,2,41,641,492,559,1051,"21 de agosto de 1994"
14,2,41,642,457,486,943,"21 de agosto de 1994"
14,2,41,643,379,439,818,"21 de agosto de 1994"
14,2,41,644,387,448,835,"21 de agosto de 1994"
14,2,41,645,485,555,1040,"21 de agosto de 1994"
14,2,41,646,442,482,924,"21 de agosto de 1994"
14,2,41,647,420,520,940,"21 de agosto de 1994"
14,2,41,648,388,442,830,"21 de agosto de 1994"
14,2,41,649,319,405,724,"21 de agosto de 1994"
14,2,41,650,412,474,886,"21 de agosto de 1994"
14,2,41,651,396,487,883,"21 de agosto de 1994"
14,2,41,652,432,439,871,"21 de agosto de 1994"
14,2,41,653,371,422,793,"21 de agosto de 1994"
14,2,41,654,271,333,604,"21 de agosto de 1994"
14,2,41,655,196,246,442,"21 de agosto de 1994"
14,2,41,656,249,318,567,"21 de agosto de 1994"
14,2,41,657,101,127,228,"21 de agosto de 1994"
14,2,41,658,113,132,245,"21 de agosto de 1994"
14,2,41,659,122,157,279,"21 de agosto de 1994"
14,2,41,660,280,306,586,"21 de agosto de 1994"
14,2,41,661,489,548,1037,"21 de agosto de 1994"
14,2,41,662,474,471,945,"21 de agosto de 1994"
14,2,41,663,679,765,1444,"21 de agosto de 1994"
14,2,41,664,682,754,1436,"21 de agosto de 1994"
14,2,41,665,748,820,1568,"21 de agosto de 1994"
14,2,41,666,595,656,1251,"21 de agosto de 1994"
14,2,41,667,549,673,1222,"21 de agosto de 1994"
14,2,41,668,455,546,1001,"21 de agosto de 1994"
14,2,41,669,650,767,1417,"21 de agosto de 1994"
14,2,41,670,414,473,887,"21 de agosto de 1994"
14,2,41,671,330,383,713,"21 de agosto de 1994"
14,2,41,672,529,603,1132,"21 de agosto de 1994"
14,2,41,673,584,695,1279,"21 de agosto de 1994"
14,2,41,674,619,695,1314,"21 de agosto de 1994"
14,2,41,675,416,506,922,"21 de agosto de 1994"
14,2,41,676,413,496,909,"21 de agosto de 1994"
14,2,41,677,486,538,1024,"21 de agosto de 1994"
14,2,41,678,421,463,884,"21 de agosto de 1994"
14,2,41,679,528,604,1132,"21 de agosto de 1994"
14,2,41,680,501,614,1115,"21 de agosto de 1994"
14,2,41,681,423,499,922,"21 de agosto de 1994"
14,2,41,682,410,475,885,"21 de agosto de 1994"
14,2,41,683,536,643,1179,"21 de agosto de 1994"
14,2,41,684,584,717,1301,"21 de agosto de 1994"
14,2,41,685,535,630,1165,"21 de agosto de 1994"
14,2,41,686,439,531,970,"21 de agosto de 1994"
14,2,41,687,478,543,1021,"21 de agosto de 1994"
14,2,41,688,470,573,1043,"21 de agosto de 1994"
14,2,41,689,341,388,729,"21 de agosto de 1994"
14,2,41,690,503,529,1032,"21 de agosto de 1994"
14,2,41,691,526,594,1120,"21 de agosto de 1994"
14,2,41,692,558,659,1217,"21 de agosto de 1994"
14,2,41,693,490,567,1057,"21 de agosto de 1994"
14,2,41,694,460,505,965,"21 de agosto de 1994"
14,2,41,695,566,645,1211,"21 de agosto de 1994"
14,2,41,696,641,770,1411,"21 de agosto de 1994"
14,2,41,697,510,593,1103,"21 de agosto de 1994"
14,2,41,698,449,476,925,"21 de agosto de 1994"
14,2,41,699,542,607,1149,"21 de agosto de 1994"
14,2,41,700,545,572,1117,"21 de agosto de 1994"
14,2,41,701,583,744,1327,"21 de agosto de 1994"
14,2,41,702,442,533,975,"21 de agosto de 1994"
14,2,41,703,450,528,978,"21 de agosto de 1994"
14,2,41,704,428,488,916,"21 de agosto de 1994"
14,2,41,705,508,512,1020,"21 de agosto de 1994"
14,2,41,706,397,461,858,"21 de agosto de 1994"
14,2,41,707,286,353,639,"21 de agosto de 1994"
14,2,41,708,308,390,698,"21 de agosto de 1994"
14,2,41,709,312,376,688,"21 de agosto de 1994"
14,2,41,710,731,816,1547,"21 de agosto de 1994"
14,2,41,711,297,318,615,"21 de agosto de 1994"
14,2,41,712,731,800,1531,"21 de agosto de 1994"
14,2,41,713,395,475,870,"21 de agosto de 1994"
14,2,41,714,365,413,778,"21 de agosto de 1994"
14,2,41,715,298,313,611,"21 de agosto de 1994"
14,2,41,716,560,619,1179,"21 de agosto de 1994"
14,2,41,717,592,612,1204,"21 de agosto de 1994"
14,2,41,718,475,528,1003,"21 de agosto de 1994"
14,2,41,719,384,403,787,"21 de agosto de 1994"
14,2,41,720,525,573,1098,"21 de agosto de 1994"
14,2,41,721,421,472,893,"21 de agosto de 1994"
14,2,41,722,437,456,893,"21 de agosto de 1994"
14,2,41,723,434,466,900,"21 de agosto de 1994"
14,2,41,724,864,890,1754,"21 de agosto de 1994"
14,2,41,725,594,648,1242,"21 de agosto de 1994"
14,2,41,726,643,707,1350,"21 de agosto de 1994"
14,2,41,727,685,722,1407,"21 de agosto de 1994"
14,2,41,728,508,558,1066,"21 de agosto de 1994"
14,2,41,729,548,627,1175,"21 de agosto de 1994"
14,2,41,730,734,825,1559,"21 de agosto de 1994"
14,2,41,731,598,704,1302,"21 de agosto de 1994"
14,2,41,732,366,420,786,"21 de agosto de 1994"
14,2,41,733,291,329,620,"21 de agosto de 1994"
14,2,41,734,509,578,1087,"21 de agosto de 1994"
14,2,41,735,457,492,949,"21 de agosto de 1994"
14,2,41,736,722,840,1562,"21 de agosto de 1994"
14,2,41,737,294,369,663,"21 de agosto de 1994"
14,2,41,738,375,416,791,"21 de agosto de 1994"
14,2,41,739,530,610,1140,"21 de agosto de 1994"
14,2,41,740,401,490,891,"21 de agosto de 1994"
14,2,41,741,407,515,922,"21 de agosto de 1994"
14,2,41,742,358,441,799,"21 de agosto de 1994"
14,2,41,743,532,581,1113,"21 de agosto de 1994"
14,2,41,744,418,477,895,"21 de agosto de 1994"
14,2,41,745,337,450,787,"21 de agosto de 1994"
14,2,41,746,346,402,748,"21 de agosto de 1994"
14,2,41,747,331,392,723,"21 de agosto de 1994"
14,2,41,748,651,795,1446,"21 de agosto de 1994"
14,2,41,749,625,755,1380,"21 de agosto de 1994"
14,2,41,750,640,742,1382,"21 de agosto de 1994"
14,2,41,751,610,732,1342,"21 de agosto de 1994"
14,2,41,752,493,600,1093,"21 de agosto de 1994"
14,2,41,753,453,546,999,"21 de agosto de 1994"
14,2,41,754,310,376,686,"21 de agosto de 1994"
14,2,41,755,413,513,926,"21 de agosto de 1994"
14,2,41,756,559,651,1210,"21 de agosto de 1994"
14,3,41,757,283,354,637,"21 de agosto de 1994"
14,3,41,758,340,436,776,"21 de agosto de 1994"
14,3,41,759,508,651,1159,"21 de agosto de 1994"
14,3,41,760,471,596,1067,"21 de agosto de 1994"
14,3,41,761,362,457,819,"21 de agosto de 1994"
14,3,41,762,457,529,986,"21 de agosto de 1994"
14,3,41,763,355,492,847,"21 de agosto de 1994"
14,3,41,764,288,359,647,"21 de agosto de 1994"
14,3,41,765,241,305,546,"21 de agosto de 1994"
14,3,41,766,486,623,1109,"21 de agosto de 1994"
14,3,41,767,334,435,769,"21 de agosto de 1994"
14,3,41,768,306,373,679,"21 de agosto de 1994"
14,3,41,769,346,479,825,"21 de agosto de 1994"
14,3,41,770,401,412,813,"21 de agosto de 1994"
14,3,41,771,609,679,1288,"21 de agosto de 1994"
14,3,41,772,331,420,751,"21 de agosto de 1994"
14,3,41,773,406,468,874,"21 de agosto de 1994"
14,3,41,774,390,485,875,"21 de agosto de 1994"
14,3,41,775,323,380,703,"21 de agosto de 1994"
14,3,41,776,355,421,776,"21 de agosto de 1994"
14,3,41,777,574,689,1263,"21 de agosto de 1994"
14,3,41,778,529,617,1146,"21 de agosto de 1994"
14,3,41,779,474,595,1069,"21 de agosto de 1994"
14,3,41,780,468,526,994,"21 de agosto de 1994"
14,3,41,781,292,402,694,"21 de agosto de 1994"
14,3,41,782,399,484,883,"21 de agosto de 1994"
14,3,41,783,414,473,887,"21 de agosto de 1994"
14,3,41,784,610,760,1370,"21 de agosto de 1994"
14,3,41,785,301,385,686,"21 de agosto de 1994"
14,3,41,786,321,409,730,"21 de agosto de 1994"
14,3,41,787,519,581,1100,"21 de agosto de 1994"
14,3,41,788,664,753,1417,"21 de agosto de 1994"
14,3,41,789,509,701,1210,"21 de agosto de 1994"
14,3,41,790,585,700,1285,"21 de agosto de 1994"
14,3,41,791,810,924,1734,"21 de agosto de 1994"
14,3,41,792,472,524,996,"21 de agosto de 1994"
14,3,41,793,525,573,1098,"21 de agosto de 1994"
14,3,41,794,570,715,1285,"21 de agosto de 1994"
14,3,41,795,419,459,878,"21 de agosto de 1994"
14,3,41,796,492,524,1016,"21 de agosto de 1994"
14,3,41,797,632,678,1310,"21 de agosto de 1994"
14,3,41,798,607,671,1278,"21 de agosto de 1994"
14,3,41,799,733,835,1568,"21 de agosto de 1994"
14,3,41,800,320,353,673,"21 de agosto de 1994"
14,3,41,801,304,383,687,"21 de agosto de 1994"
14,3,41,802,390,482,872,"21 de agosto de 1994"
14,3,41,803,354,442,796,"21 de agosto de 1994"
14,3,41,804,402,479,881,"21 de agosto de 1994"
14,3,41,805,471,586,1057,"21 de agosto de 1994"
14,3,41,806,454,501,955,"21 de agosto de 1994"
14,3,41,807,699,820,1519,"21 de agosto de 1994"
14,3,41,808,643,740,1383,"21 de agosto de 1994"
14,3,41,809,624,767,1391,"21 de agosto de 1994"
14,3,41,810,698,851,1549,"21 de agosto de 1994"
14,3,41,811,425,556,981,"21 de agosto de 1994"
14,3,41,812,454,489,943,"21 de agosto de 1994"
14,3,41,813,726,842,1568,"21 de agosto de 1994"
14,3,41,814,512,600,1112,"21 de agosto de 1994"
14,3,41,815,390,432,822,"21 de agosto de 1994"
14,3,41,816,599,700,1299,"21 de agosto de 1994"
14,3,41,817,387,451,838,"21 de agosto de 1994"
14,3,41,818,355,411,766,"21 de agosto de 1994"
14,3,41,819,392,437,829,"21 de agosto de 1994"
14,3,41,820,366,425,791,"21 de agosto de 1994"
14,3,41,821,676,786,1462,"21 de agosto de 1994"
14,3,41,822,433,559,992,"21 de agosto de 1994"
14,3,41,823,309,377,686,"21 de agosto de 1994"
14,3,41,824,494,595,1089,"21 de agosto de 1994"
14,3,41,825,583,646,1229,"21 de agosto de 1994"
14,3,41,826,618,737,1355,"21 de agosto de 1994"
14,3,41,827,712,791,1503,"21 de agosto de 1994"
14,3,41,828,779,908,1687,"21 de agosto de 1994"
14,3,41,829,743,801,1544,"21 de agosto de 1994"
14,3,41,830,585,753,1338,"21 de agosto de 1994"
14,3,41,831,563,696,1259,"21 de agosto de 1994"
14,3,41,832,645,774,1419,"21 de agosto de 1994"
14,3,41,833,605,765,1370,"21 de agosto de 1994"
14,3,41,834,555,643,1198,"21 de agosto de 1994"
14,3,41,835,605,707,1312,"21 de agosto de 1994"
14,3,41,836,446,534,980,"21 de agosto de 1994"
14,3,41,837,496,565,1061,"21 de agosto de 1994"
14,3,41,838,549,642,1191,"21 de agosto de 1994"
14,3,41,839,655,725,1380,"21 de agosto de 1994"
14,3,41,840,585,656,1241,"21 de agosto de 1994"
14,3,41,841,541,614,1155,"21 de agosto de 1994"
14,3,41,842,727,795,1522,"21 de agosto de 1994"
14,3,41,843,513,565,1078,"21 de agosto de 1994"
14,3,41,844,747,784,1531,"21 de agosto de 1994"
14,3,41,845,460,546,1006,"21 de agosto de 1994"
14,3,41,846,367,439,806,"21 de agosto de 1994"
14,3,41,847,485,537,1022,"21 de agosto de 1994"
14,3,41,848,408,454,862,"21 de agosto de 1994"
14,3,41,849,591,640,1231,"21 de agosto de 1994"
14,3,41,850,355,396,751,"21 de agosto de 1994"
14,3,41,851,688,700,1388,"21 de agosto de 1994"
14,3,41,852,576,617,1193,"21 de agosto de 1994"
14,3,41,853,783,905,1688,"21 de agosto de 1994"
14,3,41,854,662,765,1427,"21 de agosto de 1994"
14,3,41,855,639,780,1419,"21 de agosto de 1994"
14,3,41,856,639,711,1350,"21 de agosto de 1994"
14,3,41,857,666,690,1356,"21 de agosto de 1994"
14,3,41,858,312,355,667,"21 de agosto de 1994"
14,3,41,859,520,655,1175,"21 de agosto de 1994"
14,3,41,860,440,435,875,"21 de agosto de 1994"
14,3,41,861,398,427,825,"21 de agosto de 1994"
14,3,41,862,701,771,1472,"21 de agosto de 1994"
14,3,41,863,798,816,1614,"21 de agosto de 1994"
14,3,41,864,482,535,1017,"21 de agosto de 1994"
14,3,41,865,486,467,953,"21 de agosto de 1994"
14,3,41,866,530,560,1090,"21 de agosto de 1994"
14,3,41,867,324,353,677,"21 de agosto de 1994"
14,3,41,868,854,943,1797,"21 de agosto de 1994"
14,3,41,869,746,842,1588,"21 de agosto de 1994"
14,3,41,870,456,528,984,"21 de agosto de 1994"
14,3,41,871,448,492,940,"21 de agosto de 1994"
14,3,41,872,318,359,677,"21 de agosto de 1994"
14,3,41,873,622,674,1296,"21 de agosto de 1994"
14,3,41,874,606,672,1278,"21 de agosto de 1994"
14,3,41,875,737,822,1559,"21 de agosto de 1994"
14,3,41,876,801,886,1687,"21 de agosto de 1994"
14,3,41,877,748,816,1564,"21 de agosto de 1994"
14,3,41,878,551,591,1142,"21 de agosto de 1994"
14,3,41,879,468,497,965,"21 de agosto de 1994"
14,3,41,880,730,782,1512,"21 de agosto de 1994"
14,3,41,881,789,809,1598,"21 de agosto de 1994"
14,3,41,882,705,784,1489,"21 de agosto de 1994"
14,3,41,883,743,848,1591,"21 de agosto de 1994"
14,3,41,884,602,621,1223,"21 de agosto de 1994"
14,3,41,885,753,902,1655,"21 de agosto de 1994"
14,3,41,886,679,791,1470,"21 de agosto de 1994"
14,3,41,887,704,847,1551,"21 de agosto de 1994"
14,3,41,888,624,732,1356,"21 de agosto de 1994"
14,3,41,889,369,450,819,"21 de agosto de 1994"
14,3,41,890,404,496,900,"21 de agosto de 1994"
14,3,41,891,650,720,1370,"21 de agosto de 1994"
14,3,41,892,404,550,954,"21 de agosto de 1994"
14,3,41,893,718,842,1560,"21 de agosto de 1994"
14,3,41,894,648,722,1370,"21 de agosto de 1994"
14,3,41,895,874,921,1795,"21 de agosto de 1994"
14,3,41,896,471,509,980,"21 de agosto de 1994"
14,3,41,897,400,406,806,"21 de agosto de 1994"
14,3,41,898,581,609,1190,"21 de agosto de 1994"
14,3,41,899,571,683,1254,"21 de agosto de 1994"
14,3,41,900,629,698,1327,"21 de agosto de 1994"
14,3,41,901,617,646,1263,"21 de agosto de 1994"
14,3,41,902,686,829,1515,"21 de agosto de 1994"
14,3,41,903,517,580,1097,"21 de agosto de 1994"
14,3,41,904,787,889,1676,"21 de agosto de 1994"
14,3,41,905,469,523,992,"21 de agosto de 1994"
14,3,41,906,347,425,772,"21 de agosto de 1994"
14,3,41,907,794,873,1667,"21 de agosto de 1994"
14,3,41,908,449,485,934,"21 de agosto de 1994"
14,3,41,909,348,361,709,"21 de agosto de 1994"
14,3,41,910,560,630,1190,"21 de agosto de 1994"
14,3,41,911,667,777,1444,"21 de agosto de 1994"
14,3,41,912,476,537,1013,"21 de agosto de 1994"
14,3,41,913,485,566,1051,"21 de agosto de 1994"
14,3,41,914,570,667,1237,"21 de agosto de 1994"
14,3,41,915,407,469,876,"21 de agosto de 1994"
14,3,41,916,430,526,956,"21 de agosto de 1994"
14,3,41,917,595,588,1183,"21 de agosto de 1994"
14,3,41,918,860,923,1783,"21 de agosto de 1994"
14,3,41,919,670,730,1400,"21 de agosto de 1994"
14,3,41,920,808,872,1680,"21 de agosto de 1994"
14,3,41,921,554,579,1133,"21 de agosto de 1994"
14,3,41,922,797,833,1630,"21 de agosto de 1994"
14,3,41,923,555,617,1172,"21 de agosto de 1994"
14,3,41,924,639,700,1339,"21 de agosto de 1994"
14,3,41,925,1130,1144,2274,"21 de agosto de 1994"
14,3,41,926,755,828,1583,"21 de agosto de 1994"
14,3,41,927,547,600,1147,"21 de agosto de 1994"
14,3,41,928,612,664,1276,"21 de agosto de 1994"
14,4,41,929,376,373,749,"21 de agosto de 1994"
14,4,41,930,191,205,396,"21 de agosto de 1994"
14,4,41,931,319,400,719,"21 de agosto de 1994"
14,4,41,932,409,475,884,"21 de agosto de 1994"
14,4,41,933,284,335,619,"21 de agosto de 1994"
14,4,41,934,371,98,469,"21 de agosto de 1994"
14,4,41,935,424,533,957,"21 de agosto de 1994"
14,4,41,936,337,435,772,"21 de agosto de 1994"
14,4,41,937,419,558,977,"21 de agosto de 1994"
14,4,41,938,368,389,757,"21 de agosto de 1994"
14,4,41,939,411,498,909,"21 de agosto de 1994"
14,4,41,940,450,543,993,"21 de agosto de 1994"
14,4,41,941,488,571,1059,"21 de agosto de 1994"
14,4,41,942,468,571,1039,"21 de agosto de 1994"
14,4,41,943,286,343,629,"21 de agosto de 1994"
14,4,41,944,287,335,622,"21 de agosto de 1994"
14,4,41,945,417,481,898,"21 de agosto de 1994"
14,4,41,946,361,410,771,"21 de agosto de 1994"
14,4,41,947,314,380,694,"21 de agosto de 1994"
14,4,41,948,240,286,526,"21 de agosto de 1994"
14,4,41,949,378,459,837,"21 de agosto de 1994"
14,4,41,950,464,496,960,"21 de agosto de 1994"
14,4,41,951,299,359,658,"21 de agosto de 1994"
14,4,41,952,299,363,662,"21 de agosto de 1994"
14,4,41,953,313,401,714,"21 de agosto de 1994"
14,4,41,954,339,424,763,"21 de agosto de 1994"
14,4,41,955,325,417,742,"21 de agosto de 1994"
14,4,41,956,332,415,747,"21 de agosto de 1994"
14,4,41,957,310,377,687,"21 de agosto de 1994"
14,4,41,958,472,551,1023,"21 de agosto de 1994"
14,4,41,959,371,536,907,"21 de agosto de 1994"
14,4,41,960,377,409,786,"21 de agosto de 1994"
14,4,41,961,285,321,606,"21 de agosto de 1994"
14,4,41,962,304,414,718,"21 de agosto de 1994"
14,4,41,963,302,367,669,"21 de agosto de 1994"
14,4,41,964,504,601,1105,"21 de agosto de 1994"
14,4,41,965,363,439,802,"21 de agosto de 1994"
14,4,41,966,342,412,754,"21 de agosto de 1994"
14,4,41,967,420,500,920,"21 de agosto de 1994"
14,4,41,968,388,500,888,"21 de agosto de 1994"
14,4,41,969,283,337,620,"21 de agosto de 1994"
14,4,41,970,179,206,385,"21 de agosto de 1994"
14,4,41,971,217,301,518,"21 de agosto de 1994"
14,4,41,972,263,290,553,"21 de agosto de 1994"
14,4,41,973,328,371,699,"21 de agosto de 1994"
14,4,41,974,271,353,624,"21 de agosto de 1994"
14,4,41,975,476,560,1036,"21 de agosto de 1994"
14,4,41,976,219,229,448,"21 de agosto de 1994"
14,4,41,977,217,230,447,"21 de agosto de 1994"
14,4,41,978,319,339,658,"21 de agosto de 1994"
14,4,41,979,201,188,389,"21 de agosto de 1994"
14,4,41,980,256,306,562,"21 de agosto de 1994"
14,4,41,981,328,349,677,"21 de agosto de 1994"
14,4,41,982,405,516,921,"21 de agosto de 1994"
14,4,41,983,182,197,379,"21 de agosto de 1994"
14,4,41,984,421,469,890,"21 de agosto de 1994"
14,4,41,985,151,177,328,"21 de agosto de 1994"
14,4,41,986,209,254,463,"21 de agosto de 1994"
14,4,41,987,257,324,581,"21 de agosto de 1994"
14,4,41,988,563,554,1117,"21 de agosto de 1994"
14,4,41,989,217,194,411,"21 de agosto de 1994"
14,4,41,990,589,665,1254,"21 de agosto de 1994"
14,4,41,991,321,363,684,"21 de agosto de 1994"
14,4,41,992,312,335,647,"21 de agosto de 1994"
14,4,41,993,401,427,828,"21 de agosto de 1994"
14,4,41,994,616,664,1280,"21 de agosto de 1994"
14,4,41,995,336,366,702,"21 de agosto de 1994"
14,4,41,996,666,715,1381,"21 de agosto de 1994"
14,4,41,997,298,313,611,"21 de agosto de 1994"
14,4,41,998,313,361,674,"21 de agosto de 1994"
14,4,41,999,693,816,1509,"21 de agosto de 1994"
14,4,41,1000,289,316,605,"21 de agosto de 1994"
14,4,41,1001,472,493,965,"21 de agosto de 1994"
14,4,41,1002,414,484,898,"21 de agosto de 1994"
14,4,41,1003,490,558,1048,"21 de agosto de 1994"
14,4,41,1004,584,616,1200,"21 de agosto de 1994"
14,4,41,1005,422,475,897,"21 de agosto de 1994"
14,4,41,1006,352,413,765,"21 de agosto de 1994"
14,4,41,1007,389,442,831,"21 de agosto de 1994"
14,4,41,1008,630,675,1305,"21 de agosto de 1994"
14,5,1,1,234,298,532,"21 de agosto de 1994"
14,5,1,2,305,370,675,"21 de agosto de 1994"
14,5,1,3,572,703,1275,"21 de agosto de 1994"
14,5,1,4,407,484,891,"21 de agosto de 1994"
14,5,1,5,552,598,1150,"21 de agosto de 1994"
14,5,1,6,348,416,764,"21 de agosto de 1994"
14,5,1,7,168,171,339,"21 de agosto de 1994"
14,5,1,8,83,87,170,"21 de agosto de 1994"
14,5,1,9,32,40,72,"21 de agosto de 1994"
14,5,1,10,563,651,1214,"21 de agosto de 1994"
14,5,1,11,267,273,540,"21 de agosto de 1994"
14,5,1,12,235,234,469,"21 de agosto de 1994"
14,5,19,292,349,353,702,"21 de agosto de 1994"
14,5,19,293,158,150,308,"21 de agosto de 1994"
14,5,19,294,464,359,823,"21 de agosto de 1994"
14,5,19,295,182,173,355,"21 de agosto de 1994"
14,5,26,411,297,308,605,"21 de agosto de 1994"
14,5,26,412,156,161,317,"21 de agosto de 1994"
14,5,26,413,299,357,656,"21 de agosto de 1994"
14,5,26,414,275,376,651,"21 de agosto de 1994"
14,5,26,415,381,414,795,"21 de agosto de 1994"
14,5,26,416,305,366,671,"21 de agosto de 1994"
14,5,26,417,296,309,605,"21 de agosto de 1994"
14,5,26,418,305,370,675,"21 de agosto de 1994"
14,5,26,419,397,455,852,"21 de agosto de 1994"
14,5,26,420,369,426,795,"21 de agosto de 1994"
14,5,26,421,127,139,266,"21 de agosto de 1994"
14,5,26,422,30,32,62,"21 de agosto de 1994"
14,5,26,423,73,97,170,"21 de agosto de 1994"
14,5,26,424,104,112,216,"21 de agosto de 1994"
14,5,26,425,325,417,742,"21 de agosto de 1994"
14,5,26,426,149,212,361,"21 de agosto de 1994"
14,5,30,445,458,531,989,"21 de agosto de 1994"
14,5,30,446,405,468,873,"21 de agosto de 1994"
14,5,30,447,276,339,615,"21 de agosto de 1994"
14,5,30,448,384,397,781,"21 de agosto de 1994"
14,5,30,449,335,302,637,"21 de agosto de 1994"
14,5,30,450,404,404,808,"21 de agosto de 1994"
14,5,30,451,382,424,806,"21 de agosto de 1994"
14,5,30,452,208,192,400,"21 de agosto de 1994"
14,5,30,453,362,380,742,"21 de agosto de 1994"
14,5,30,454,314,366,680,"21 de agosto de 1994"
14,5,30,455,331,365,696,"21 de agosto de 1994"
14,5,30,456,263,290,553,"21 de agosto de 1994"
14,5,32,476,324,304,628,"21 de agosto de 1994"
14,5,32,477,287,317,604,"21 de agosto de 1994"
14,5,32,478,119,130,249,"21 de agosto de 1994"
14,5,42,1549,289,273,562,"21 de agosto de 1994"
14,5,42,1550,119,112,231,"21 de agosto de 1994"
14,5,42,1551,123,143,266,"21 de agosto de 1994"
14,5,42,1552,276,281,557,"21 de agosto de 1994"
14,5,42,1553,471,415,886,"21 de agosto de 1994"
14,5,42,1554,146,167,313,"21 de agosto de 1994"
14,5,42,1555,37,31,68,"21 de agosto de 1994"
14,5,42,1556,68,50,118,"21 de agosto de 1994"
14,5,42,1557,80,83,163,"21 de agosto de 1994"
14,5,42,1558,217,186,403,"21 de agosto de 1994"
14,5,42,1559,92,66,158,"21 de agosto de 1994"
14,5,42,1560,259,227,486,"21 de agosto de 1994"
14,5,43,1561,265,332,597,"21 de agosto de 1994"
14,5,43,1562,417,516,933,"21 de agosto de 1994"
14,5,43,1563,294,362,656,"21 de agosto de 1994"
14,5,43,1564,305,393,698,"21 de agosto de 1994"
14,5,43,1565,308,425,733,"21 de agosto de 1994"
14,5,44,1566,349,455,804,"21 de agosto de 1994"
14,5,44,1567,439,554,993,"21 de agosto de 1994"
14,5,44,1568,366,442,808,"21 de agosto de 1994"
14,5,44,1569,253,338,591,"21 de agosto de 1994"
14,5,44,1570,96,125,221,"21 de agosto de 1994"
14,5,44,1571,73,99,172,"21 de agosto de 1994"
14,5,44,1572,269,284,553,"21 de agosto de 1994"
14,5,47,1602,472,556,1028,"21 de agosto de 1994"
14,5,47,1603,309,383,692,"21 de agosto de 1994"
14,5,47,1604,521,541,1062,"21 de agosto de 1994"
14,5,47,1605,494,535,1029,"21 de agosto de 1994"
14,5,47,1606,361,345,706,"21 de agosto de 1994"
14,5,47,1607,380,451,831,"21 de agosto de 1994"
14,5,47,1608,299,380,679,"21 de agosto de 1994"
14,5,47,1609,642,733,1375,"21 de agosto de 1994"
14,5,47,1610,285,277,562,"21 de agosto de 1994"
14,5,47,1611,279,332,611,"21 de agosto de 1994"
14,5,47,1612,259,319,578,"21 de agosto de 1994"
14,5,57,1782,457,496,953,"21 de agosto de 1994"
14,5,57,1783,610,604,1214,"21 de agosto de 1994"
14,5,57,1784,641,682,1323,"21 de agosto de 1994"
14,5,57,1785,365,416,781,"21 de agosto de 1994"
14,5,57,1786,392,470,862,"21 de agosto de 1994"
14,5,57,1787,414,443,857,"21 de agosto de 1994"
14,5,57,1788,262,267,529,"21 de agosto de 1994"
14,5,57,1789,317,317,634,"21 de agosto de 1994"
14,5,57,1790,266,260,526,"21 de agosto de 1994"
14,5,57,1791,413,445,858,"21 de agosto de 1994"
14,5,63,1831,433,503,936,"21 de agosto de 1994"
14,5,63,1832,213,270,483,"21 de agosto de 1994"
14,5,63,1833,106,120,226,"21 de agosto de 1994"
14,5,63,1834,195,176,371,"21 de agosto de 1994"
14,5,63,1835,132,160,292,"21 de agosto de 1994"
14,5,63,1836,21,20,41,"21 de agosto de 1994"
14,5,63,1837,430,216,646,"21 de agosto de 1994"
14,5,63,1838,447,250,697,"21 de agosto de 1994"
14,5,63,1839,577,385,962,"21 de agosto de 1994"
14,5,73,2050,370,374,744,"21 de agosto de 1994"
14,5,73,2051,122,138,260,"21 de agosto de 1994"
14,5,73,2052,242,216,458,"21 de agosto de 1994"
14,5,73,2053,104,120,224,"21 de agosto de 1994"
14,5,73,2054,129,110,239,"21 de agosto de 1994"
14,5,78,2110,226,243,469,"21 de agosto de 1994"
14,5,78,2111,289,293,582,"21 de agosto de 1994"
14,5,78,2112,122,129,251,"21 de agosto de 1994"
14,5,78,2113,70,81,151,"21 de agosto de 1994"
14,5,78,2114,36,30,66,"21 de agosto de 1994"
14,5,82,2157,144,173,317,"21 de agosto de 1994"
14,5,82,2158,288,333,621,"21 de agosto de 1994"
14,5,82,2159,130,156,286,"21 de agosto de 1994"
14,5,82,2160,378,439,817,"21 de agosto de 1994"
14,5,82,2161,187,207,394,"21 de agosto de 1994"
14,5,95,2396,400,391,791,"21 de agosto de 1994"
14,5,95,2397,304,333,637,"21 de agosto de 1994"
14,5,95,2398,358,407,765,"21 de agosto de 1994"
14,5,95,2399,295,333,628,"21 de agosto de 1994"
14,5,95,2400,514,536,1050,"21 de agosto de 1994"
14,5,95,2401,426,503,929,"21 de agosto de 1994"
14,5,95,2402,374,402,776,"21 de agosto de 1994"
14,5,95,2403,354,398,752,"21 de agosto de 1994"
14,5,95,2404,497,560,1057,"21 de agosto de 1994"
14,5,95,2405,580,588,1168,"21 de agosto de 1994"
14,5,95,2406,464,492,956,"21 de agosto de 1994"
14,5,95,2407,502,523,1025,"21 de agosto de 1994"
14,5,95,2408,312,322,634,"21 de agosto de 1994"
14,5,95,2409,140,108,248,"21 de agosto de 1994"
14,5,95,2410,65,61,126,"21 de agosto de 1994"
14,5,95,2411,44,47,91,"21 de agosto de 1994"
14,5,95,2412,276,261,537,"21 de agosto de 1994"
14,5,95,2413,348,293,641,"21 de agosto de 1994"
14,5,95,2414,164,117,281,"21 de agosto de 1994"
14,5,95,2415,251,228,479,"21 de agosto de 1994"
14,5,95,2416,155,168,323,"21 de agosto de 1994"
14,5,95,2417,241,212,453,"21 de agosto de 1994"
14,5,105,2742,325,443,768,"21 de agosto de 1994"
14,5,105,2743,297,380,677,"21 de agosto de 1994"
14,5,105,2744,144,188,332,"21 de agosto de 1994"
14,5,105,2745,76,102,178,"21 de agosto de 1994"
14,5,105,2746,136,157,293,"21 de agosto de 1994"
14,5,105,2747,428,488,916,"21 de agosto de 1994"
14,5,115,2839,291,317,608,"21 de agosto de 1994"
14,5,115,2840,309,369,678,"21 de agosto de 1994"
14,5,115,2841,238,303,541,"21 de agosto de 1994"
14,5,115,2842,265,284,549,"21 de agosto de 1994"
14,5,115,2843,132,142,274,"21 de agosto de 1994"
14,5,115,2844,110,91,201,"21 de agosto de 1994"
14,5,115,2845,70,34,104,"21 de agosto de 1994"
14,5,115,2846,67,47,114,"21 de agosto de 1994"
14,5,124,3278,567,650,1217,"21 de agosto de 1994"
14,5,124,3279,378,466,844,"21 de agosto de 1994"
14,5,124,3280,471,588,1059,"21 de agosto de 1994"
14,5,124,3281,543,625,1168,"21 de agosto de 1994"
14,5,124,3282,490,535,1025,"21 de agosto de 1994"
14,5,124,3283,499,550,1049,"21 de agosto de 1994"
14,5,124,3284,374,412,786,"21 de agosto de 1994"
14,5,124,3285,605,755,1360,"21 de agosto de 1994"
14,5,124,3286,521,597,1118,"21 de agosto de 1994"
14,5,124,3287,505,553,1058,"21 de agosto de 1994"
14,5,124,3288,261,276,537,"21 de agosto de 1994"
14,5,124,3289,325,362,687,"21 de agosto de 1994"
14,5,124,3290,201,185,386,"21 de agosto de 1994"
14,5,124,3291,377,453,830,"21 de agosto de 1994"
14,5,124,3292,80,92,172,"21 de agosto de 1994"
14,5,124,3293,169,194,363,"21 de agosto de 1994"
14,5,124,3294,234,201,435,"21 de agosto de 1994"
14,5,124,3295,258,275,533,"21 de agosto de 1994"
14,5,124,3296,216,201,417,"21 de agosto de 1994"
14,5,124,3297,300,307,607,"21 de agosto de 1994"
14,5,124,3298,73,78,151,"21 de agosto de 1994"
14,5,124,3299,53,61,114,"21 de agosto de 1994"
14,5,124,3300,104,98,202,"21 de agosto de 1994"
14,5,124,3301,765,845,1610,"21 de agosto de 1994"
14,5,124,3302,303,333,636,"21 de agosto de 1994"
14,5,124,3303,286,276,562,"21 de agosto de 1994"
14,5,124,3304,249,245,494,"21 de agosto de 1994"
14,5,124,3305,216,217,433,"21 de agosto de 1994"
14,5,124,3306,329,345,674,"21 de agosto de 1994"
14,5,124,3307,380,400,780,"21 de agosto de 1994"
14,5,124,3308,371,379,750,"21 de agosto de 1994"
14,5,124,3309,529,576,1105,"21 de agosto de 1994"
14,6,36,501,395,512,907,"21 de agosto de 1994"
14,6,36,502,394,485,879,"21 de agosto de 1994"
14,6,36,503,448,586,1034,"21 de agosto de 1994"
14,6,36,504,400,463,863,"21 de agosto de 1994"
14,6,36,505,550,646,1196,"21 de agosto de 1994"
14,6,36,506,465,679,1144,"21 de agosto de 1994"
14,6,36,507,330,446,776,"21 de agosto de 1994"
14,6,36,508,174,256,430,"21 de agosto de 1994"
14,6,36,509,522,649,1171,"21 de agosto de 1994"
14,6,36,510,337,400,737,"21 de agosto de 1994"
14,6,36,511,251,253,504,"21 de agosto de 1994"
14,6,36,512,506,491,997,"21 de agosto de 1994"
14,6,36,513,108,102,210,"21 de agosto de 1994"
14,6,36,514,70,69,139,"21 de agosto de 1994"
14,6,36,515,642,719,1361,"21 de agosto de 1994"
14,6,36,516,27,26,53,"21 de agosto de 1994"
14,6,36,517,39,31,70,"21 de agosto de 1994"
14,6,36,518,122,146,268,"21 de agosto de 1994"
14,6,36,519,106,122,228,"21 de agosto de 1994"
14,6,36,520,556,636,1192,"21 de agosto de 1994"
14,6,36,521,445,502,947,"21 de agosto de 1994"
14,6,36,522,92,65,157,"21 de agosto de 1994"
14,6,36,523,80,81,161,"21 de agosto de 1994"
14,6,36,524,48,51,99,"21 de agosto de 1994"
14,6,36,525,506,580,1086,"21 de agosto de 1994"
14,6,36,526,373,522,895,"21 de agosto de 1994"
14,6,36,527,424,522,946,"21 de agosto de 1994"
14,6,36,528,86,82,168,"21 de agosto de 1994"
14,6,36,529,60,72,132,"21 de agosto de 1994"
14,6,55,1702,704,769,1473,"21 de agosto de 1994"
14,6,55,1703,385,431,816,"21 de agosto de 1994"
14,6,55,1704,548,561,1109,"21 de agosto de 1994"
14,6,55,1705,342,378,720,"21 de agosto de 1994"
14,6,55,1706,650,664,1314,"21 de agosto de 1994"
14,6,55,1707,647,757,1404,"21 de agosto de 1994"
14,6,55,1708,760,820,1580,"21 de agosto de 1994"
14,6,55,1709,562,613,1175,"21 de agosto de 1994"
14,6,55,1710,435,528,963,"21 de agosto de 1994"
14,6,55,1711,707,821,1528,"21 de agosto de 1994"
14,6,55,1712,375,430,805,"21 de agosto de 1994"
14,6,55,1713,455,464,919,"21 de agosto de 1994"
14,6,55,1714,640,683,1323,"21 de agosto de 1994"
14,6,55,1715,634,658,1292,"21 de agosto de 1994"
14,6,55,1716,168,196,364,"21 de agosto de 1994"
14,6,55,1717,246,304,550,"21 de agosto de 1994"
14,6,55,1718,151,197,348,"21 de agosto de 1994"
14,6,55,1719,488,606,1094,"21 de agosto de 1994"
14,6,55,1720,220,271,491,"21 de agosto de 1994"
14,6,55,1721,311,367,678,"21 de agosto de 1994"
14,6,55,1722,359,455,814,"21 de agosto de 1994"
14,6,55,1723,321,417,738,"21 de agosto de 1994"
14,6,55,1724,267,363,630,"21 de agosto de 1994"
14,6,55,1725,110,129,239,"21 de agosto de 1994"
14,6,55,1726,292,363,655,"21 de agosto de 1994"
14,6,55,1727,54,51,105,"21 de agosto de 1994"
14,6,55,1728,189,256,445,"21 de agosto de 1994"
14,6,55,1729,608,778,1386,"21 de agosto de 1994"
14,6,55,1730,480,532,1012,"21 de agosto de 1994"
14,6,55,1731,489,593,1082,"21 de agosto de 1994"
14,6,55,1732,252,289,541,"21 de agosto de 1994"
14,6,55,1733,434,576,1010,"21 de agosto de 1994"
14,6,55,1734,415,460,875,"21 de agosto de 1994"
14,6,55,1735,657,667,1324,"21 de agosto de 1994"
14,6,55,1736,386,419,805,"21 de agosto de 1994"
14,6,55,1737,124,129,253,"21 de agosto de 1994"
14,6,55,1738,269,358,627,"21 de agosto de 1994"
14,6,55,1739,284,387,671,"21 de agosto de 1994"
14,6,55,1740,253,240,493,"21 de agosto de 1994"
14,6,55,1741,121,144,265,"21 de agosto de 1994"
14,6,55,1742,168,166,334,"21 de agosto de 1994"
14,6,55,1743,352,338,690,"21 de agosto de 1994"
14,6,55,1744,429,416,845,"21 de agosto de 1994"
14,6,55,1745,152,158,310,"21 de agosto de 1994"
14,6,55,1746,125,135,260,"21 de agosto de 1994"
14,6,55,1747,289,264,553,"21 de agosto de 1994"
14,6,55,1748,545,535,1080,"21 de agosto de 1994"
14,6,55,1749,635,671,1306,"21 de agosto de 1994"
14,6,55,1750,78,82,160,"21 de agosto de 1994"
14,6,55,1751,54,70,124,"21 de agosto de 1994"
14,6,55,1752,83,69,152,"21 de agosto de 1994"
14,6,55,1753,92,96,188,"21 de agosto de 1994"
14,6,55,1754,502,532,1034,"21 de agosto de 1994"
14,6,55,1755,110,106,216,"21 de agosto de 1994"
14,6,55,1756,35,38,73,"21 de agosto de 1994"
14,6,55,1757,331,308,639,"21 de agosto de 1994"
14,6,55,1758,45,49,94,"21 de agosto de 1994"
14,6,55,1759,202,142,344,"21 de agosto de 1994"
14,6,55,1760,340,306,646,"21 de agosto de 1994"
14,6,55,1761,213,162,375,"21 de agosto de 1994"
14,6,55,1762,156,183,339,"21 de agosto de 1994"
14,6,55,1763,808,801,1609,"21 de agosto de 1994"
14,6,55,1764,121,127,248,"21 de agosto de 1994"
14,6,55,1765,143,140,283,"21 de agosto de 1994"
14,6,55,1766,80,74,154,"21 de agosto de 1994"
14,6,55,1767,379,416,795,"21 de agosto de 1994"
14,6,55,1768,177,170,347,"21 de agosto de 1994"
14,6,55,1769,137,159,296,"21 de agosto de 1994"
14,6,55,1770,78,64,142,"21 de agosto de 1994"
14,6,55,1771,650,651,1301,"21 de agosto de 1994"
14,6,55,1772,403,376,779,"21 de agosto de 1994"
14,6,55,1773,180,172,352,"21 de agosto de 1994"
14,6,55,1774,138,96,234,"21 de agosto de 1994"
14,6,55,1775,36,43,79,"21 de agosto de 1994"
14,6,62,1824,326,458,784,"21 de agosto de 1994"
14,6,62,1825,186,232,418,"21 de agosto de 1994"
14,6,62,1826,103,125,228,"21 de agosto de 1994"
14,6,62,1827,154,192,346,"21 de agosto de 1994"
14,6,62,1828,226,300,526,"21 de agosto de 1994"
14,6,62,1829,181,263,444,"21 de agosto de 1994"
14,6,62,1830,60,63,123,"21 de agosto de 1994"
14,6,66,1886,446,516,962,"21 de agosto de 1994"
14,6,66,1887,261,299,560,"21 de agosto de 1994"
14,6,66,1888,414,452,866,"21 de agosto de 1994"
14,6,66,1889,482,526,1008,"21 de agosto de 1994"
14,6,66,1890,245,260,505,"21 de agosto de 1994"
14,6,66,1891,173,160,333,"21 de agosto de 1994"
14,6,66,1892,521,577,1098,"21 de agosto de 1994"
14,6,66,1893,121,146,267,"21 de agosto de 1994"
14,6,66,1894,219,222,441,"21 de agosto de 1994"
14,6,66,1895,305,327,632,"21 de agosto de 1994"
14,6,66,1896,517,512,1029,"21 de agosto de 1994"
14,6,66,1897,289,285,574,"21 de agosto de 1994"
14,6,66,1898,127,131,258,"21 de agosto de 1994"
14,6,66,1899,266,264,530,"21 de agosto de 1994"
14,6,66,1900,229,262,491,"21 de agosto de 1994"
14,6,75,2063,681,718,1399,"21 de agosto de 1994"
14,6,75,2064,540,598,1138,"21 de agosto de 1994"
14,6,75,2065,490,558,1048,"21 de agosto de 1994"
14,6,75,2066,509,603,1112,"21 de agosto de 1994"
14,6,75,2067,528,463,991,"21 de agosto de 1994"
14,6,75,2068,521,554,1075,"21 de agosto de 1994"
14,6,75,2069,436,533,969,"21 de agosto de 1994"
14,6,75,2070,256,301,557,"21 de agosto de 1994"
14,6,75,2071,196,211,407,"21 de agosto de 1994"
14,6,75,2072,243,269,512,"21 de agosto de 1994"
14,6,75,2073,334,384,718,"21 de agosto de 1994"
14,6,75,2074,453,528,981,"21 de agosto de 1994"
14,6,75,2075,270,312,582,"21 de agosto de 1994"
14,6,75,2076,388,401,789,"21 de agosto de 1994"
14,6,75,2077,396,516,912,"21 de agosto de 1994"
14,6,75,2078,488,575,1063,"21 de agosto de 1994"
14,6,75,2079,412,408,820,"21 de agosto de 1994"
14,6,75,2080,96,159,255,"21 de agosto de 1994"
14,6,75,2081,373,465,838,"21 de agosto de 1994"
14,6,75,2082,264,326,590,"21 de agosto de 1994"
14,6,75,2083,231,248,479,"21 de agosto de 1994"
14,6,75,2084,398,476,874,"21 de agosto de 1994"
14,6,75,2085,136,149,285,"21 de agosto de 1994"
14,6,75,2086,172,162,334,"21 de agosto de 1994"
14,6,75,2087,131,156,287,"21 de agosto de 1994"
14,6,75,2088,100,139,239,"21 de agosto de 1994"
14,6,75,2089,124,140,264,"21 de agosto de 1994"
14,6,75,2090,97,118,215,"21 de agosto de 1994"
14,6,75,2091,98,132,230,"21 de agosto de 1994"
14,6,75,2092,161,181,342,"21 de agosto de 1994"
14,6,75,2093,375,428,803,"21 de agosto de 1994"
14,6,75,2094,379,436,815,"21 de agosto de 1994"
14,6,75,2095,66,81,147,"21 de agosto de 1994"
14,6,75,2096,83,105,188,"21 de agosto de 1994"
14,6,92,2307,512,672,1184,"21 de agosto de 1994"
14,6,92,2308,597,735,1332,"21 de agosto de 1994"
14,6,92,2309,288,371,659,"21 de agosto de 1994"
14,6,92,2310,256,308,564,"21 de agosto de 1994"
14,6,92,2311,285,387,672,"21 de agosto de 1994"
14,6,92,2312,118,148,266,"21 de agosto de 1994"
14,6,92,2313,391,512,903,"21 de agosto de 1994"
14,6,92,2314,115,164,279,"21 de agosto de 1994"
14,6,92,2315,319,412,731,"21 de agosto de 1994"
14,6,92,2316,311,428,739,"21 de agosto de 1994"
14,6,92,2317,259,359,618,"21 de agosto de 1994"
14,6,92,2318,634,830,1464,"21 de agosto de 1994"
14,6,92,2319,527,614,1141,"21 de agosto de 1994"
14,6,92,2320,401,478,879,"21 de agosto de 1994"
14,6,92,2321,179,261,440,"21 de agosto de 1994"
14,6,92,2322,281,379,660,"21 de agosto de 1994"
14,6,92,2323,270,359,629,"21 de agosto de 1994"
14,6,92,2324,314,375,689,"21 de agosto de 1994"
14,6,92,2325,182,192,374,"21 de agosto de 1994"
14,6,92,2326,240,325,565,"21 de agosto de 1994"
14,6,92,2327,152,183,335,"21 de agosto de 1994"
14,6,92,2328,221,216,437,"21 de agosto de 1994"
14,6,92,2329,95,108,203,"21 de agosto de 1994"
14,6,110,2794,540,684,1224,"21 de agosto de 1994"
14,6,110,2795,248,304,552,"21 de agosto de 1994"
14,6,110,2796,463,600,1063,"21 de agosto de 1994"
14,6,110,2797,332,542,874,"21 de agosto de 1994"
14,6,110,2798,218,262,480,"21 de agosto de 1994"
14,6,110,2799,145,123,268,"21 de agosto de 1994"
14,6,110,2800,465,493,958,"21 de agosto de 1994"
14,6,110,2801,189,240,429,"21 de agosto de 1994"
14,6,110,2802,78,83,161,"21 de agosto de 1994"
14,6,110,2803,344,432,776,"21 de agosto de 1994"
14,6,116,2847,402,518,920,"21 de agosto de 1994"
14,6,116,2848,437,484,921,"21 de agosto de 1994"
14,6,116,2849,346,416,762,"21 de agosto de 1994"
14,6,116,2850,258,332,590,"21 de agosto de 1994"
14,6,116,2851,296,339,635,"21 de agosto de 1994"
14,6,116,2852,128,148,276,"21 de agosto de 1994"
14,6,116,2853,163,190,353,"21 de agosto de 1994"
14,6,116,2854,428,616,1044,"21 de agosto de 1994"
14,7,8,102,414,455,869,"21 de agosto de 1994"
14,7,8,103,614,657,1271,"21 de agosto de 1994"
14,7,8,104,330,413,743,"21 de agosto de 1994"
14,7,8,105,549,735,1284,"21 de agosto de 1994"
14,7,8,106,558,672,1230,"21 de agosto de 1994"
14,7,8,107,651,704,1355,"21 de agosto de 1994"
14,7,8,108,555,700,1255,"21 de agosto de 1994"
14,7,8,109,429,486,915,"21 de agosto de 1994"
14,7,8,110,495,562,1057,"21 de agosto de 1994"
14,7,8,111,470,578,1048,"21 de agosto de 1994"
14,7,8,112,595,738,1333,"21 de agosto de 1994"
14,7,8,113,560,700,1260,"21 de agosto de 1994"
14,7,8,114,550,601,1151,"21 de agosto de 1994"
14,7,8,115,475,607,1082,"21 de agosto de 1994"
14,7,8,116,577,652,1229,"21 de agosto de 1994"
14,7,8,117,533,595,1128,"21 de agosto de 1994"
14,7,8,118,302,374,676,"21 de agosto de 1994"
14,7,8,119,345,429,774,"21 de agosto de 1994"
14,7,8,120,353,443,796,"21 de agosto de 1994"
14,7,8,121,332,388,720,"21 de agosto de 1994"
14,7,8,122,696,840,1536,"21 de agosto de 1994"
14,7,8,123,608,799,1407,"21 de agosto de 1994"
14,7,8,124,243,295,538,"21 de agosto de 1994"
14,7,8,125,217,252,469,"21 de agosto de 1994"
14,7,8,126,130,146,276,"21 de agosto de 1994"
14,7,8,127,444,501,945,"21 de agosto de 1994"
14,7,8,128,119,130,249,"21 de agosto de 1994"
14,7,8,129,54,62,116,"21 de agosto de 1994"
14,7,8,130,76,57,133,"21 de agosto de 1994"
14,7,8,131,144,142,286,"21 de agosto de 1994"
14,7,8,132,332,304,636,"21 de agosto de 1994"
14,7,8,133,317,242,559,"21 de agosto de 1994"
14,7,8,134,293,347,640,"21 de agosto de 1994"
14,7,8,135,178,191,369,"21 de agosto de 1994"
14,7,8,136,471,485,956,"21 de agosto de 1994"
14,7,8,137,358,396,754,"21 de agosto de 1994"
14,7,8,138,281,310,591,"21 de agosto de 1994"
14,7,34,483,666,754,1420,"21 de agosto de 1994"
14,7,34,484,405,479,884,"21 de agosto de 1994"
14,7,34,485,419,536,955,"21 de agosto de 1994"
14,7,34,486,270,322,592,"21 de agosto de 1994"
14,7,34,487,430,500,930,"21 de agosto de 1994"
14,7,34,488,482,556,1038,"21 de agosto de 1994"
14,7,34,489,444,505,949,"21 de agosto de 1994"
14,7,34,490,237,239,476,"21 de agosto de 1994"
14,7,34,491,243,279,522,"21 de agosto de 1994"
14,7,34,492,78,89,167,"21 de agosto de 1994"
14,7,34,493,222,288,510,"21 de agosto de 1994"
14,7,34,494,78,87,165,"21 de agosto de 1994"
14,7,34,495,231,239,470,"21 de agosto de 1994"
14,7,34,496,301,346,647,"21 de agosto de 1994"
14,7,34,497,205,235,440,"21 de agosto de 1994"
14,7,34,498,213,231,444,"21 de agosto de 1994"
14,7,48,1613,315,376,691,"21 de agosto de 1994"
14,7,48,1614,467,542,1009,"21 de agosto de 1994"
14,7,48,1615,390,485,875,"21 de agosto de 1994"
14,7,48,1616,348,444,792,"21 de agosto de 1994"
14,7,48,1617,338,450,788,"21 de agosto de 1994"
14,7,48,1618,294,328,622,"21 de agosto de 1994"
14,7,48,1619,349,445,794,"21 de agosto de 1994"
14,7,48,1620,502,654,1156,"21 de agosto de 1994"
14,7,48,1621,319,407,726,"21 de agosto de 1994"
14,7,48,1622,366,465,831,"21 de agosto de 1994"
14,7,48,1623,250,289,539,"21 de agosto de 1994"
14,7,48,1624,391,479,870,"21 de agosto de 1994"
14,7,48,1625,66,97,163,"21 de agosto de 1994"
14,7,48,1626,259,354,613,"21 de agosto de 1994"
14,7,48,1627,30,24,54,"21 de agosto de 1994"
14,7,48,1628,123,117,240,"21 de agosto de 1994"
14,7,48,1629,98,108,206,"21 de agosto de 1994"
14,7,48,1630,64,95,159,"21 de agosto de 1994"
14,7,48,1631,150,147,297,"21 de agosto de 1994"
14,7,48,1632,66,74,140,"21 de agosto de 1994"
14,7,48,1633,199,252,451,"21 de agosto de 1994"
14,7,48,1634,92,86,178,"21 de agosto de 1994"
14,7,50,1647,364,411,775,"21 de agosto de 1994"
14,7,50,1648,326,371,697,"21 de agosto de 1994"
14,7,50,1649,369,449,818,"21 de agosto de 1994"
14,7,50,1650,413,545,958,"21 de agosto de 1994"
14,7,50,1651,540,658,1198,"21 de agosto de 1994"
14,7,50,1652,122,128,250,"21 de agosto de 1994"
14,7,50,1653,288,320,608,"21 de agosto de 1994"
14,7,50,1654,291,336,627,"21 de agosto de 1994"
14,7,50,1655,501,682,1183,"21 de agosto de 1994"
14,7,50,1656,177,187,364,"21 de agosto de 1994"
14,7,50,1657,224,278,502,"21 de agosto de 1994"
14,7,50,1658,367,466,833,"21 de agosto de 1994"
14,7,50,1659,117,198,315,"21 de agosto de 1994"
14,7,50,1660,185,268,453,"21 de agosto de 1994"
14,7,74,2055,436,485,921,"21 de agosto de 1994"
14,7,74,2056,403,478,881,"21 de agosto de 1994"
14,7,74,2057,115,150,265,"21 de agosto de 1994"
14,7,74,2058,124,108,232,"21 de agosto de 1994"
14,7,74,2059,49,44,93,"21 de agosto de 1994"
14,7,74,2060,50,58,108,"21 de agosto de 1994"
14,7,74,2061,81,92,173,"21 de agosto de 1994"
14,7,74,2062,84,85,169,"21 de agosto de 1994"
14,7,76,2097,111,159,270,"21 de agosto de 1994"
14,7,76,2098,550,719,1269,"21 de agosto de 1994"
14,7,76,2099,478,671,1149,"21 de agosto de 1994"
14,7,76,2100,331,435,766,"21 de agosto de 1994"
14,7,76,2101,389,520,909,"21 de agosto de 1994"
14,7,76,2102,391,512,903,"21 de agosto de 1994"
14,7,76,2103,273,357,630,"21 de agosto de 1994"
14,7,76,2104,113,125,238,"21 de agosto de 1994"
14,7,76,2105,120,168,288,"21 de agosto de 1994"
14,7,76,2106,56,101,157,"21 de agosto de 1994"
14,7,80,2132,303,365,668,"21 de agosto de 1994"
14,7,80,2133,587,748,1335,"21 de agosto de 1994"
14,7,80,2134,481,630,1111,"21 de agosto de 1994"
14,7,80,2135,412,552,964,"21 de agosto de 1994"
14,7,80,2136,624,842,1466,"21 de agosto de 1994"
14,7,80,2137,393,509,902,"21 de agosto de 1994"
14,7,80,2138,492,591,1083,"21 de agosto de 1994"
14,7,80,2139,386,558,944,"21 de agosto de 1994"
14,7,80,2140,526,695,1221,"21 de agosto de 1994"
14,7,80,2141,39,37,76,"21 de agosto de 1994"
14,7,80,2142,256,328,584,"21 de agosto de 1994"
14,7,80,2143,31,41,72,"21 de agosto de 1994"
14,7,80,2144,155,186,341,"21 de agosto de 1994"
14,7,80,2145,84,87,171,"21 de agosto de 1994"
14,7,80,2146,91,78,169,"21 de agosto de 1994"
14,7,80,2147,187,218,405,"21 de agosto de 1994"
14,7,80,2148,49,44,93,"21 de agosto de 1994"
14,7,80,2149,242,322,564,"21 de agosto de 1994"
14,7,94,2340,541,578,1119,"21 de agosto de 1994"
14,7,94,2341,488,563,1051,"21 de agosto de 1994"
14,7,94,2342,588,726,1314,"21 de agosto de 1994"
14,7,94,2343,500,598,1098,"21 de agosto de 1994"
14,7,94,2344,475,591,1066,"21 de agosto de 1994"
14,7,94,2345,565,701,1266,"21 de agosto de 1994"
14,7,94,2346,706,771,1477,"21 de agosto de 1994"
14,7,94,2347,639,713,1352,"21 de agosto de 1994"
14,7,94,2348,654,819,1473,"21 de agosto de 1994"
14,7,94,2349,387,472,859,"21 de agosto de 1994"
14,7,94,2350,490,593,1083,"21 de agosto de 1994"
14,7,94,2351,452,548,1000,"21 de agosto de 1994"
14,7,94,2352,631,775,1406,"21 de agosto de 1994"
14,7,94,2353,476,499,975,"21 de agosto de 1994"
14,7,94,2354,764,941,1705,"21 de agosto de 1994"
14,7,94,2355,552,647,1199,"21 de agosto de 1994"
14,7,94,2356,422,506,928,"21 de agosto de 1994"
14,7,94,2357,548,669,1217,"21 de agosto de 1994"
14,7,94,2358,541,681,1222,"21 de agosto de 1994"
14,7,94,2359,617,840,1457,"21 de agosto de 1994"
14,7,94,2360,753,808,1561,"21 de agosto de 1994"
14,7,94,2361,816,822,1638,"21 de agosto de 1994"
14,7,94,2362,532,661,1193,"21 de agosto de 1994"
14,7,94,2363,466,585,1051,"21 de agosto de 1994"
14,7,94,2364,597,719,1316,"21 de agosto de 1994"
14,7,94,2365,375,510,885,"21 de agosto de 1994"
14,7,94,2366,408,539,947,"21 de agosto de 1994"
14,7,94,2367,307,408,715,"21 de agosto de 1994"
14,7,94,2368,168,221,389,"21 de agosto de 1994"
14,7,94,2369,424,541,965,"21 de agosto de 1994"
14,7,94,2370,429,518,947,"21 de agosto de 1994"
14,7,94,2371,704,863,1567,"21 de agosto de 1994"
14,7,94,2372,555,666,1221,"21 de agosto de 1994"
14,7,94,2373,287,460,747,"21 de agosto de 1994"
14,7,94,2374,393,483,876,"21 de agosto de 1994"
14,7,94,2375,243,382,625,"21 de agosto de 1994"
14,7,94,2376,25,34,59,"21 de agosto de 1994"
14,7,94,2377,78,88,166,"21 de agosto de 1994"
14,7,94,2378,240,274,514,"21 de agosto de 1994"
14,7,94,2379,50,40,90,"21 de agosto de 1994"
14,7,94,2380,88,102,190,"21 de agosto de 1994"
14,7,94,2381,332,361,693,"21 de agosto de 1994"
14,7,94,2382,169,162,331,"21 de agosto de 1994"
14,7,94,2383,127,130,257,"21 de agosto de 1994"
14,7,94,2384,35,55,90,"21 de agosto de 1994"
14,7,94,2385,103,124,227,"21 de agosto de 1994"
14,7,94,2386,227,220,447,"21 de agosto de 1994"
14,7,94,2387,111,149,260,"21 de agosto de 1994"
14,7,94,2388,87,90,177,"21 de agosto de 1994"
14,7,94,2389,564,689,1253,"21 de agosto de 1994"
14,7,94,2390,119,133,252,"21 de agosto de 1994"
14,7,94,2391,42,52,94,"21 de agosto de 1994"
14,7,94,2392,348,471,819,"21 de agosto de 1994"
14,7,94,2393,156,158,314,"21 de agosto de 1994"
14,7,94,2394,222,235,457,"21 de agosto de 1994"
14,7,94,2395,251,263,514,"21 de agosto de 1994"
14,7,112,2816,490,630,1120,"21 de agosto de 1994"
14,7,112,2817,278,312,590,"21 de agosto de 1994"
14,7,112,2818,326,416,742,"21 de agosto de 1994"
14,7,112,2819,73,72,145,"21 de agosto de 1994"
14,7,112,2820,104,110,214,"21 de agosto de 1994"
14,7,112,2821,78,65,143,"21 de agosto de 1994"
14,7,112,2822,30,32,62,"21 de agosto de 1994"
14,7,112,2823,101,124,225,"21 de agosto de 1994"
14,7,117,2855,145,202,347,"21 de agosto de 1994"
14,7,117,2856,229,338,567,"21 de agosto de 1994"
14,7,117,2857,156,216,372,"21 de agosto de 1994"
14,7,117,2858,238,301,539,"21 de agosto de 1994"
14,7,117,2859,75,82,157,"21 de agosto de 1994"
14,7,117,2860,76,85,161,"21 de agosto de 1994"
14,7,117,2861,88,158,246,"21 de agosto de 1994"
14,7,118,2862,283,348,631,"21 de agosto de 1994"
14,7,118,2863,206,268,474,"21 de agosto de 1994"
14,7,118,2864,252,296,548,"21 de agosto de 1994"
14,7,118,2865,415,521,936,"21 de agosto de 1994"
14,7,118,2866,221,256,477,"21 de agosto de 1994"
14,7,118,2867,401,498,899,"21 de agosto de 1994"
14,7,118,2868,424,551,975,"21 de agosto de 1994"
14,7,118,2869,298,399,697,"21 de agosto de 1994"
14,7,118,2870,455,545,1000,"21 de agosto de 1994"
14,7,118,2871,509,618,1127,"21 de agosto de 1994"
14,7,118,2872,36,43,79,"21 de agosto de 1994"
14,7,118,2873,112,163,275,"21 de agosto de 1994"
14,7,118,2874,80,112,192,"21 de agosto de 1994"
14,7,118,2875,247,402,649,"21 de agosto de 1994"
14,7,118,2876,72,88,160,"21 de agosto de 1994"
14,7,118,2877,103,146,249,"21 de agosto de 1994"
14,7,118,2878,460,665,1125,"21 de agosto de 1994"
14,7,118,2879,212,252,464,"21 de agosto de 1994"
14,7,118,2880,64,80,144,"21 de agosto de 1994"
14,7,118,2881,230,335,565,"21 de agosto de 1994"
14,7,118,2882,84,115,199,"21 de agosto de 1994"
14,7,118,2883,124,157,281,"21 de agosto de 1994"
14,8,13,161,584,670,1254,"21 de agosto de 1994"
14,8,13,162,265,326,591,"21 de agosto de 1994"
14,8,13,163,550,649,1199,"21 de agosto de 1994"
14,8,13,164,230,283,513,"21 de agosto de 1994"
14,8,13,165,325,399,724,"21 de agosto de 1994"
14,8,13,166,476,537,1013,"21 de agosto de 1994"
14,8,13,167,514,540,1054,"21 de agosto de 1994"
14,8,13,168,503,584,1087,"21 de agosto de 1994"
14,8,13,169,415,533,948,"21 de agosto de 1994"
14,8,13,170,352,397,749,"21 de agosto de 1994"
14,8,13,171,605,649,1254,"21 de agosto de 1994"
14,8,13,172,639,757,1396,"21 de agosto de 1994"
14,8,13,173,552,648,1200,"21 de agosto de 1994"
14,8,13,174,252,292,544,"21 de agosto de 1994"
14,8,13,175,263,328,591,"21 de agosto de 1994"
14,8,13,176,425,579,1004,"21 de agosto de 1994"
14,8,13,177,530,636,1166,"21 de agosto de 1994"
14,8,13,178,78,75,153,"21 de agosto de 1994"
14,8,13,179,169,202,371,"21 de agosto de 1994"
14,8,13,180,268,299,567,"21 de agosto de 1994"
14,8,13,181,350,399,749,"21 de agosto de 1994"
14,8,13,182,483,541,1024,"21 de agosto de 1994"
14,8,13,183,239,323,562,"21 de agosto de 1994"
14,8,13,184,556,632,1188,"21 de agosto de 1994"
14,8,13,185,377,467,844,"21 de agosto de 1994"
14,8,13,186,313,307,620,"21 de agosto de 1994"
14,8,13,187,382,423,805,"21 de agosto de 1994"
14,8,16,224,557,640,1197,"21 de agosto de 1994"
14,8,16,225,642,764,1406,"21 de agosto de 1994"
14,8,16,226,495,554,1049,"21 de agosto de 1994"
14,8,16,227,612,683,1295,"21 de agosto de 1994"
14,8,16,228,451,580,1031,"21 de agosto de 1994"
14,8,16,229,337,416,753,"21 de agosto de 1994"
14,8,16,230,350,381,731,"21 de agosto de 1994"
14,8,16,231,353,426,779,"21 de agosto de 1994"
14,8,16,232,515,632,1147,"21 de agosto de 1994"
14,8,16,233,726,690,1416,"21 de agosto de 1994"
14,8,16,234,22,29,51,"21 de agosto de 1994"
14,8,16,235,59,76,135,"21 de agosto de 1994"
14,8,16,236,257,270,527,"21 de agosto de 1994"
14,8,16,237,66,84,150,"21 de agosto de 1994"
14,8,16,238,264,315,579,"21 de agosto de 1994"
14,8,16,239,131,158,289,"21 de agosto de 1994"
14,8,16,240,155,159,314,"21 de agosto de 1994"
14,8,16,241,174,197,371,"21 de agosto de 1994"
14,8,16,242,281,291,572,"21 de agosto de 1994"
14,8,16,243,559,595,1154,"21 de agosto de 1994"
14,8,18,256,560,626,1186,"21 de agosto de 1994"
14,8,18,257,524,574,1098,"21 de agosto de 1994"
14,8,18,258,491,564,1055,"21 de agosto de 1994"
14,8,18,259,574,664,1238,"21 de agosto de 1994"
14,8,18,260,278,328,606,"21 de agosto de 1994"
14,8,18,261,655,783,1438,"21 de agosto de 1994"
14,8,18,262,643,679,1322,"21 de agosto de 1994"
14,8,18,263,437,536,973,"21 de agosto de 1994"
14,8,18,264,340,419,759,"21 de agosto de 1994"
14,8,18,265,585,752,1337,"21 de agosto de 1994"
14,8,18,266,315,402,717,"21 de agosto de 1994"
14,8,18,267,547,660,1207,"21 de agosto de 1994"
14,8,18,268,311,439,750,"21 de agosto de 1994"
14,8,18,269,512,589,1101,"21 de agosto de 1994"
14,8,18,270,299,348,647,"21 de agosto de 1994"
14,8,18,271,318,388,706,"21 de agosto de 1994"
14,8,18,272,138,138,276,"21 de agosto de 1994"
14,8,18,273,347,403,750,"21 de agosto de 1994"
14,8,18,274,322,379,701,"21 de agosto de 1994"
14,8,18,275,305,386,691,"21 de agosto de 1994"
14,8,18,276,184,191,375,"21 de agosto de 1994"
14,8,18,277,178,195,373,"21 de agosto de 1994"
14,8,18,278,258,361,619,"21 de agosto de 1994"
14,8,18,279,224,282,506,"21 de agosto de 1994"
14,8,18,280,348,402,750,"21 de agosto de 1994"
14,8,18,281,322,367,689,"21 de agosto de 1994"
14,8,18,282,193,234,427,"21 de agosto de 1994"
14,8,18,283,391,552,943,"21 de agosto de 1994"
14,8,18,284,107,143,250,"21 de agosto de 1994"
14,8,18,285,349,465,814,"21 de agosto de 1994"
14,8,18,286,106,110,216,"21 de agosto de 1994"
14,8,18,287,469,533,1002,"21 de agosto de 1994"
14,8,18,288,356,388,744,"21 de agosto de 1994"
14,8,18,289,231,289,520,"21 de agosto de 1994"
14,8,18,290,492,606,1098,"21 de agosto de 1994"
14,8,18,291,252,298,550,"21 de agosto de 1994"
14,8,49,1635,442,454,896,"21 de agosto de 1994"
14,8,49,1636,666,770,1436,"21 de agosto de 1994"
14,8,49,1637,598,669,1267,"21 de agosto de 1994"
14,8,49,1638,199,224,423,"21 de agosto de 1994"
14,8,49,1639,314,394,708,"21 de agosto de 1994"
14,8,49,1640,267,270,537,"21 de agosto de 1994"
14,8,49,1641,574,548,1122,"21 de agosto de 1994"
14,8,49,1642,441,489,930,"21 de agosto de 1994"
14,8,49,1643,561,591,1152,"21 de agosto de 1994"
14,8,49,1644,436,571,1007,"21 de agosto de 1994"
14,8,49,1645,330,24,354,"21 de agosto de 1994"
14,8,49,1646,128,132,260,"21 de agosto de 1994"
14,8,65,1844,479,493,972,"21 de agosto de 1994"
14,8,65,1845,443,446,889,"21 de agosto de 1994"
14,8,65,1846,569,595,1164,"21 de agosto de 1994"
14,8,65,1847,630,685,1315,"21 de agosto de 1994"
14,8,65,1848,512,541,1053,"21 de agosto de 1994"
14,8,65,1849,414,514,928,"21 de agosto de 1994"
14,8,65,1850,537,596,1133,"21 de agosto de 1994"
14,8,65,1851,555,577,1132,"21 de agosto de 1994"
14,8,65,1852,734,771,1505,"21 de agosto de 1994"
14,8,65,1853,567,622,1189,"21 de agosto de 1994"
14,8,65,1854,537,602,1139,"21 de agosto de 1994"
14,8,65,1855,529,599,1128,"21 de agosto de 1994"
14,8,65,1856,491,549,1040,"21 de agosto de 1994"
14,8,65,1857,531,618,1149,"21 de agosto de 1994"
14,8,65,1858,256,302,558,"21 de agosto de 1994"
14,8,65,1859,465,530,995,"21 de agosto de 1994"
14,8,65,1860,314,364,678,"21 de agosto de 1994"
14,8,65,1861,444,513,957,"21 de agosto de 1994"
14,8,65,1862,421,454,875,"21 de agosto de 1994"
14,8,65,1863,285,328,613,"21 de agosto de 1994"
14,8,65,1864,534,599,1133,"21 de agosto de 1994"
14,8,65,1865,225,250,475,"21 de agosto de 1994"
14,8,65,1866,403,464,867,"21 de agosto de 1994"
14,8,65,1867,388,451,839,"21 de agosto de 1994"
14,8,65,1868,325,315,640,"21 de agosto de 1994"
14,8,65,1869,309,351,660,"21 de agosto de 1994"
14,8,65,1870,380,508,888,"21 de agosto de 1994"
14,8,65,1871,365,447,812,"21 de agosto de 1994"
14,8,65,1872,580,666,1246,"21 de agosto de 1994"
14,8,65,1873,382,423,805,"21 de agosto de 1994"
14,8,65,1874,665,709,1374,"21 de agosto de 1994"
14,8,65,1875,591,599,1190,"21 de agosto de 1994"
14,8,65,1876,534,517,1051,"21 de agosto de 1994"
14,8,65,1877,819,823,1642,"21 de agosto de 1994"
14,8,65,1878,527,580,1107,"21 de agosto de 1994"
14,8,65,1879,299,318,617,"21 de agosto de 1994"
14,8,65,1880,201,236,437,"21 de agosto de 1994"
14,8,65,1881,273,259,532,"21 de agosto de 1994"
14,8,65,1882,197,222,419,"21 de agosto de 1994"
14,8,65,1883,277,339,616,"21 de agosto de 1994"
14,8,65,1884,191,221,412,"21 de agosto de 1994"
14,8,65,1885,489,542,1031,"21 de agosto de 1994"
14,8,68,1914,298,352,650,"21 de agosto de 1994"
14,8,68,1915,592,675,1267,"21 de agosto de 1994"
14,8,68,1916,490,562,1052,"21 de agosto de 1994"
14,8,68,1917,306,340,646,"21 de agosto de 1994"
14,8,68,1918,444,512,956,"21 de agosto de 1994"
14,8,68,1919,548,650,1198,"21 de agosto de 1994"
14,8,68,1920,238,270,508,"21 de agosto de 1994"
14,8,68,1921,474,508,982,"21 de agosto de 1994"
14,8,68,1922,451,478,929,"21 de agosto de 1994"
14,8,68,1923,348,359,707,"21 de agosto de 1994"
14,8,68,1924,386,354,740,"21 de agosto de 1994"
14,8,68,1925,552,578,1130,"21 de agosto de 1994"
14,8,68,1926,473,529,1002,"21 de agosto de 1994"
14,8,68,1927,452,508,960,"21 de agosto de 1994"
14,8,68,1928,318,325,643,"21 de agosto de 1994"
14,8,68,1929,519,583,1102,"21 de agosto de 1994"
14,8,68,1930,265,225,490,"21 de agosto de 1994"
14,8,68,1931,824,892,1716,"21 de agosto de 1994"
14,8,68,1932,142,138,280,"21 de agosto de 1994"
14,8,68,1933,448,504,952,"21 de agosto de 1994"
14,8,106,2748,545,643,1188,"21 de agosto de 1994"
14,8,106,2749,700,753,1453,"21 de agosto de 1994"
14,8,106,2750,535,654,1189,"21 de agosto de 1994"
14,8,106,2751,538,634,1172,"21 de agosto de 1994"
14,8,106,2752,311,404,715,"21 de agosto de 1994"
14,8,106,2753,203,208,411,"21 de agosto de 1994"
14,8,106,2754,174,201,375,"21 de agosto de 1994"
14,8,106,2755,147,174,321,"21 de agosto de 1994"
14,8,106,2756,336,333,669,"21 de agosto de 1994"
14,8,106,2757,247,276,523,"21 de agosto de 1994"
14,8,106,2758,129,150,279,"21 de agosto de 1994"
14,8,106,2759,252,315,567,"21 de agosto de 1994"
14,8,106,2760,153,174,327,"21 de agosto de 1994"
14,8,106,2761,447,536,983,"21 de agosto de 1994"
14,8,123,3265,369,406,775,"21 de agosto de 1994"
14,8,123,3266,374,409,783,"21 de agosto de 1994"
14,8,123,3267,206,200,406,"21 de agosto de 1994"
14,8,123,3268,68,69,137,"21 de agosto de 1994"
14,8,123,3269,259,235,494,"21 de agosto de 1994"
14,8,123,3270,136,136,272,"21 de agosto de 1994"
14,8,123,3271,310,332,642,"21 de agosto de 1994"
14,8,123,3272,268,302,570,"21 de agosto de 1994"
14,8,123,3273,392,474,866,"21 de agosto de 1994"
14,8,123,3274,125,159,284,"21 de agosto de 1994"
14,8,123,3275,366,388,754,"21 de agosto de 1994"
14,8,123,3276,433,430,863,"21 de agosto de 1994"
14,8,123,3277,221,219,440,"21 de agosto de 1994"
14,9,2,13,437,453,890,"21 de agosto de 1994"
14,9,2,14,433,479,912,"21 de agosto de 1994"
14,9,2,15,358,382,740,"21 de agosto de 1994"
14,9,2,16,404,450,854,"21 de agosto de 1994"
14,9,2,17,282,297,579,"21 de agosto de 1994"
14,9,2,18,372,366,738,"21 de agosto de 1994"
14,9,2,19,465,456,921,"21 de agosto de 1994"
14,9,2,20,421,414,835,"21 de agosto de 1994"
14,9,2,21,307,304,611,"21 de agosto de 1994"
14,9,2,22,594,624,1218,"21 de agosto de 1994"
14,9,2,23,180,162,342,"21 de agosto de 1994"
14,9,4,36,218,242,460,"21 de agosto de 1994"
14,9,4,37,464,580,1044,"21 de agosto de 1994"
14,9,4,38,90,107,197,"21 de agosto de 1994"
14,9,4,39,440,535,975,"21 de agosto de 1994"
14,9,14,188,672,707,1379,"21 de agosto de 1994"
14,9,14,189,471,556,1027,"21 de agosto de 1994"
14,9,14,190,309,350,659,"21 de agosto de 1994"
14,9,14,191,170,176,346,"21 de agosto de 1994"
14,9,14,192,212,252,464,"21 de agosto de 1994"
14,9,14,193,332,373,705,"21 de agosto de 1994"
14,9,31,457,372,402,774,"21 de agosto de 1994"
14,9,31,458,686,757,1443,"21 de agosto de 1994"
14,9,31,459,660,706,1366,"21 de agosto de 1994"
14,9,31,460,371,489,860,"21 de agosto de 1994"
14,9,31,461,454,498,952,"21 de agosto de 1994"
14,9,31,462,388,415,803,"21 de agosto de 1994"
14,9,31,463,536,573,1109,"21 de agosto de 1994"
14,9,31,464,406,435,841,"21 de agosto de 1994"
14,9,31,465,188,214,402,"21 de agosto de 1994"
14,9,31,466,468,545,1013,"21 de agosto de 1994"
14,9,31,467,518,675,1193,"21 de agosto de 1994"
14,9,31,468,506,573,1079,"21 de agosto de 1994"
14,9,31,469,270,311,581,"21 de agosto de 1994"
14,9,31,470,673,723,1396,"21 de agosto de 1994"
14,9,31,471,376,402,778,"21 de agosto de 1994"
14,9,31,472,500,511,1011,"21 de agosto de 1994"
14,9,31,473,339,355,694,"21 de agosto de 1994"
14,9,31,474,420,474,894,"21 de agosto de 1994"
14,9,31,475,576,669,1245,"21 de agosto de 1994"
14,9,46,1591,524,538,1062,"21 de agosto de 1994"
14,9,46,1592,655,701,1356,"21 de agosto de 1994"
14,9,46,1593,358,407,765,"21 de agosto de 1994"
14,9,46,1594,632,678,1310,"21 de agosto de 1994"
14,9,46,1595,445,419,864,"21 de agosto de 1994"
14,9,46,1596,653,684,1337,"21 de agosto de 1994"
14,9,46,1597,479,508,987,"21 de agosto de 1994"
14,9,46,1598,263,239,502,"21 de agosto de 1994"
14,9,46,1599,374,366,740,"21 de agosto de 1994"
14,9,46,1600,50,41,91,"21 de agosto de 1994"
14,9,46,1601,512,507,1019,"21 de agosto de 1994"
14,9,52,1671,334,356,690,"21 de agosto de 1994"
14,9,52,1672,501,581,1082,"21 de agosto de 1994"
14,9,52,1673,295,305,600,"21 de agosto de 1994"
14,9,52,1674,604,650,1254,"21 de agosto de 1994"
14,9,52,1675,632,659,1291,"21 de agosto de 1994"
14,9,52,1676,582,638,1220,"21 de agosto de 1994"
14,9,52,1677,458,523,981,"21 de agosto de 1994"
14,9,52,1678,583,604,1187,"21 de agosto de 1994"
14,9,52,1679,147,151,298,"21 de agosto de 1994"
14,9,52,1680,228,233,461,"21 de agosto de 1994"
14,9,52,1681,581,628,1209,"21 de agosto de 1994"
14,9,52,1682,498,544,1042,"21 de agosto de 1994"
14,9,52,1683,307,326,633,"21 de agosto de 1994"
14,9,52,1684,439,459,898,"21 de agosto de 1994"
14,9,52,1685,277,317,594,"21 de agosto de 1994"
14,9,52,1686,470,555,1025,"21 de agosto de 1994"
14,9,52,1687,280,335,615,"21 de agosto de 1994"
14,9,52,1688,454,525,979,"21 de agosto de 1994"
14,9,53,1689,351,352,703,"21 de agosto de 1994"
14,9,53,1690,362,391,753,"21 de agosto de 1994"
14,9,53,1691,422,436,858,"21 de agosto de 1994"
14,9,53,1692,542,585,1127,"21 de agosto de 1994"
14,9,53,1693,300,314,614,"21 de agosto de 1994"
14,9,53,1694,321,365,686,"21 de agosto de 1994"
14,9,53,1695,442,431,873,"21 de agosto de 1994"
14,9,90,2298,209,247,456,"21 de agosto de 1994"
14,9,90,2299,260,331,591,"21 de agosto de 1994"
14,9,90,2300,253,253,506,"21 de agosto de 1994"
14,9,93,2330,350,388,738,"21 de agosto de 1994"
14,9,93,2331,384,450,834,"21 de agosto de 1994"
14,9,93,2332,301,317,618,"21 de agosto de 1994"
14,9,93,2333,228,259,487,"21 de agosto de 1994"
14,9,93,2334,388,492,880,"21 de agosto de 1994"
14,9,93,2335,283,308,591,"21 de agosto de 1994"
14,9,93,2336,152,134,286,"21 de agosto de 1994"
14,9,93,2337,282,288,570,"21 de agosto de 1994"
14,9,93,2338,363,408,771,"21 de agosto de 1994"
14,9,93,2339,462,476,938,"21 de agosto de 1994"
14,9,98,2438,450,481,931,"21 de agosto de 1994"
14,9,98,2439,392,396,788,"21 de agosto de 1994"
14,9,98,2440,444,468,912,"21 de agosto de 1994"
14,9,98,2441,378,403,781,"21 de agosto de 1994"
14,9,98,2442,495,506,1001,"21 de agosto de 1994"
14,9,98,2443,508,540,1048,"21 de agosto de 1994"
14,9,98,2444,623,589,1212,"21 de agosto de 1994"
14,9,98,2445,373,396,769,"21 de agosto de 1994"
14,9,98,2446,646,776,1422,"21 de agosto de 1994"
14,9,98,2447,399,268,667,"21 de agosto de 1994"
14,9,98,2448,682,729,1411,"21 de agosto de 1994"
14,9,98,2449,626,699,1325,"21 de agosto de 1994"
14,9,98,2450,781,841,1622,"21 de agosto de 1994"
14,9,98,2451,435,530,965,"21 de agosto de 1994"
14,9,98,2452,445,470,915,"21 de agosto de 1994"
14,9,98,2453,610,715,1325,"21 de agosto de 1994"
14,9,98,2454,743,777,1520,"21 de agosto de 1994"
14,9,98,2455,602,634,1236,"21 de agosto de 1994"
14,9,98,2456,680,726,1406,"21 de agosto de 1994"
14,9,98,2457,494,562,1056,"21 de agosto de 1994"
14,9,98,2458,431,430,861,"21 de agosto de 1994"
14,9,98,2459,588,629,1217,"21 de agosto de 1994"
14,9,98,2460,665,714,1379,"21 de agosto de 1994"
14,9,98,2461,414,448,862,"21 de agosto de 1994"
14,9,98,2462,265,254,519,"21 de agosto de 1994"
14,9,98,2463,476,468,944,"21 de agosto de 1994"
14,9,98,2464,520,536,1056,"21 de agosto de 1994"
14,9,98,2465,1187,1201,2388,"21 de agosto de 1994"
14,9,98,2466,513,605,1118,"21 de agosto de 1994"
14,9,98,2467,566,571,1137,"21 de agosto de 1994"
14,9,98,2468,762,745,1507,"21 de agosto de 1994"
14,9,98,2469,609,603,1212,"21 de agosto de 1994"
14,9,98,2470,428,439,867,"21 de agosto de 1994"
14,9,98,2471,372,354,726,"21 de agosto de 1994"
14,9,98,2472,649,640,1289,"21 de agosto de 1994"
14,9,108,2767,394,480,874,"21 de agosto de 1994"
14,9,108,2768,413,432,845,"21 de agosto de 1994"
14,9,108,2769,331,412,743,"21 de agosto de 1994"
14,9,108,2770,262,250,512,"21 de agosto de 1994"
14,9,114,2829,597,696,1293,"21 de agosto de 1994"
14,9,114,2830,567,614,1181,"21 de agosto de 1994"
14,9,114,2831,467,504,971,"21 de agosto de 1994"
14,9,114,2832,392,429,821,"21 de agosto de 1994"
14,9,114,2833,372,486,858,"21 de agosto de 1994"
14,9,114,2834,294,378,672,"21 de agosto de 1994"
14,9,114,2835,256,288,544,"21 de agosto de 1994"
14,9,114,2836,86,107,193,"21 de agosto de 1994"
14,9,114,2837,223,289,512,"21 de agosto de 1994"
14,9,114,2838,346,385,731,"21 de agosto de 1994"
14,9,119,2884,394,406,800,"21 de agosto de 1994"
14,9,119,2885,404,453,857,"21 de agosto de 1994"
14,9,119,2886,465,510,975,"21 de agosto de 1994"
14,9,119,2887,573,643,1216,"21 de agosto de 1994"
14,9,119,2888,417,463,880,"21 de agosto de 1994"
14,9,119,2889,583,659,1242,"21 de agosto de 1994"
14,9,119,2890,411,464,875,"21 de agosto de 1994"
14,9,119,2891,320,354,674,"21 de agosto de 1994"
14,9,119,2892,259,289,548,"21 de agosto de 1994"
14,9,119,2893,393,391,784,"21 de agosto de 1994"
14,9,119,2894,284,277,561,"21 de agosto de 1994"
14,9,119,2895,248,264,512,"21 de agosto de 1994"
14,9,119,2896,156,191,347,"21 de agosto de 1994"
14,9,119,2897,333,351,684,"21 de agosto de 1994"
14,9,119,2898,493,494,987,"21 de agosto de 1994"
14,9,119,2899,372,373,745,"21 de agosto de 1994"
14,10,10,144,356,395,751,"21 de agosto de 1994"
14,10,10,145,356,388,744,"21 de agosto de 1994"
14,10,10,146,257,272,529,"21 de agosto de 1994"
14,10,10,147,62,51,113,"21 de agosto de 1994"
14,10,10,148,178,189,367,"21 de agosto de 1994"
14,10,23,333,475,492,967,"21 de agosto de 1994"
14,10,23,334,563,650,1213,"21 de agosto de 1994"
14,10,23,335,379,419,798,"21 de agosto de 1994"
14,10,23,336,542,612,1154,"21 de agosto de 1994"
14,10,23,337,424,510,934,"21 de agosto de 1994"
14,10,23,338,527,608,1135,"21 de agosto de 1994"
14,10,23,339,289,324,613,"21 de agosto de 1994"
14,10,23,340,417,522,939,"21 de agosto de 1994"
14,10,23,341,401,471,872,"21 de agosto de 1994"
14,10,23,342,365,417,782,"21 de agosto de 1994"
14,10,23,343,257,288,545,"21 de agosto de 1994"
14,10,23,344,288,303,591,"21 de agosto de 1994"
14,10,23,345,373,439,812,"21 de agosto de 1994"
14,10,23,346,278,366,644,"21 de agosto de 1994"
14,10,23,347,408,482,890,"21 de agosto de 1994"
14,10,23,348,470,523,993,"21 de agosto de 1994"
14,10,23,349,519,611,1130,"21 de agosto de 1994"
14,10,23,350,126,152,278,"21 de agosto de 1994"
14,10,23,351,449,564,1013,"21 de agosto de 1994"
14,10,23,352,400,494,894,"21 de agosto de 1994"
14,10,23,353,309,378,687,"21 de agosto de 1994"
14,10,23,354,454,486,940,"21 de agosto de 1994"
14,10,23,355,408,457,865,"21 de agosto de 1994"
14,10,23,356,333,360,693,"21 de agosto de 1994"
14,10,23,357,489,584,1073,"21 de agosto de 1994"
14,10,23,358,489,610,1099,"21 de agosto de 1994"
14,10,23,359,378,498,876,"21 de agosto de 1994"
14,10,23,360,569,684,1253,"21 de agosto de 1994"
14,10,23,361,586,658,1244,"21 de agosto de 1994"
14,10,23,362,244,281,525,"21 de agosto de 1994"
14,10,23,363,387,428,815,"21 de agosto de 1994"
14,10,23,364,404,463,867,"21 de agosto de 1994"
14,10,23,365,482,555,1037,"21 de agosto de 1994"
14,10,23,366,172,200,372,"21 de agosto de 1994"
14,10,23,367,461,526,987,"21 de agosto de 1994"
14,10,23,368,359,415,774,"21 de agosto de 1994"
14,10,23,369,526,575,1101,"21 de agosto de 1994"
14,10,23,370,550,602,1152,"21 de agosto de 1994"
14,10,23,371,428,449,877,"21 de agosto de 1994"
14,10,23,372,493,548,1041,"21 de agosto de 1994"
14,10,23,373,458,523,981,"21 de agosto de 1994"
14,10,23,374,517,577,1094,"21 de agosto de 1994"
14,10,23,375,499,540,1039,"21 de agosto de 1994"
14,10,23,376,461,543,1004,"21 de agosto de 1994"
14,10,23,377,483,538,1021,"21 de agosto de 1994"
14,10,23,378,478,557,1035,"21 de agosto de 1994"
14,10,23,379,318,374,692,"21 de agosto de 1994"
14,10,23,380,365,442,807,"21 de agosto de 1994"
14,10,23,381,418,450,868,"21 de agosto de 1994"
14,10,23,382,90,96,186,"21 de agosto de 1994"
14,10,23,383,242,260,502,"21 de agosto de 1994"
14,10,24,384,393,453,846,"21 de agosto de 1994"
14,10,24,385,488,580,1068,"21 de agosto de 1994"
14,10,24,386,307,313,620,"21 de agosto de 1994"
14,10,24,387,462,510,972,"21 de agosto de 1994"
14,10,24,388,412,440,852,"21 de agosto de 1994"
14,10,24,389,277,311,588,"21 de agosto de 1994"
14,10,24,390,131,98,229,"21 de agosto de 1994"
14,10,24,391,397,386,783,"21 de agosto de 1994"
14,10,24,392,297,313,610,"21 de agosto de 1994"
14,10,24,393,411,390,801,"21 de agosto de 1994"
14,10,25,394,535,605,1140,"21 de agosto de 1994"
14,10,25,395,245,277,522,"21 de agosto de 1994"
14,10,25,396,353,404,757,"21 de agosto de 1994"
14,10,25,397,457,501,958,"21 de agosto de 1994"
14,10,25,398,432,524,956,"21 de agosto de 1994"
14,10,25,399,413,496,909,"21 de agosto de 1994"
14,10,25,400,160,181,341,"21 de agosto de 1994"
14,10,25,401,650,749,1399,"21 de agosto de 1994"
14,10,25,402,325,406,731,"21 de agosto de 1994"
14,10,25,403,368,462,830,"21 de agosto de 1994"
14,10,25,404,353,500,853,"21 de agosto de 1994"
14,10,25,405,287,352,639,"21 de agosto de 1994"
14,10,25,406,304,450,754,"21 de agosto de 1994"
14,10,25,407,179,187,366,"21 de agosto de 1994"
14,10,25,408,492,529,1021,"21 de agosto de 1994"
14,10,25,409,263,270,533,"21 de agosto de 1994"
14,10,25,410,272,274,546,"21 de agosto de 1994"
14,10,33,479,413,438,851,"21 de agosto de 1994"
14,10,33,480,455,510,965,"21 de agosto de 1994"
14,10,33,481,110,124,234,"21 de agosto de 1994"
14,10,33,482,178,203,381,"21 de agosto de 1994"
14,10,35,499,338,436,774,"21 de agosto de 1994"
14,10,35,500,126,143,269,"21 de agosto de 1994"
14,10,39,549,433,526,959,"21 de agosto de 1994"
14,10,39,550,693,752,1445,"21 de agosto de 1994"
14,10,39,551,373,447,820,"21 de agosto de 1994"
14,10,39,552,402,403,805,"21 de agosto de 1994"
14,10,39,553,546,639,1185,"21 de agosto de 1994"
14,10,39,554,444,462,906,"21 de agosto de 1994"
14,10,39,555,488,555,1043,"21 de agosto de 1994"
14,10,39,556,371,418,789,"21 de agosto de 1994"
14,10,39,557,332,347,679,"21 de agosto de 1994"
14,10,39,558,537,608,1145,"21 de agosto de 1994"
14,10,39,559,338,305,643,"21 de agosto de 1994"
14,10,39,560,126,126,252,"21 de agosto de 1994"
14,10,54,1696,349,411,760,"21 de agosto de 1994"
14,10,54,1697,286,325,611,"21 de agosto de 1994"
14,10,54,1698,272,347,619,"21 de agosto de 1994"
14,10,54,1699,181,179,360,"21 de agosto de 1994"
14,10,54,1700,255,300,555,"21 de agosto de 1994"
14,10,54,1701,120,111,231,"21 de agosto de 1994"
14,10,56,1776,175,220,395,"21 de agosto de 1994"
14,10,56,1777,337,350,687,"21 de agosto de 1994"
14,10,56,1778,389,427,816,"21 de agosto de 1994"
14,10,56,1779,334,341,675,"21 de agosto de 1994"
14,10,56,1780,266,296,562,"21 de agosto de 1994"
14,10,56,1781,272,273,545,"21 de agosto de 1994"
14,10,83,2162,542,593,1135,"21 de agosto de 1994"
14,10,83,2163,406,459,865,"21 de agosto de 1994"
14,10,83,2164,472,593,1065,"21 de agosto de 1994"
14,10,83,2165,461,548,1009,"21 de agosto de 1994"
14,10,83,2166,343,380,723,"21 de agosto de 1994"
14,10,83,2167,367,30,397,"21 de agosto de 1994"
14,10,83,2168,329,390,719,"21 de agosto de 1994"
14,10,83,2169,265,311,576,"21 de agosto de 1994"
14,10,83,2170,343,409,752,"21 de agosto de 1994"
14,10,83,2171,505,621,1126,"21 de agosto de 1994"
14,10,83,2172,313,346,659,"21 de agosto de 1994"
14,10,83,2173,437,514,951,"21 de agosto de 1994"
14,10,83,2174,394,465,859,"21 de agosto de 1994"
14,10,83,2175,514,573,1087,"21 de agosto de 1994"
14,10,83,2176,400,464,864,"21 de agosto de 1994"
14,10,83,2177,381,450,831,"21 de agosto de 1994"
14,10,83,2178,206,228,434,"21 de agosto de 1994"
14,10,83,2179,352,413,765,"21 de agosto de 1994"
14,10,83,2180,97,124,221,"21 de agosto de 1994"
14,10,87,2260,337,356,693,"21 de agosto de 1994"
14,10,87,2261,332,316,648,"21 de agosto de 1994"
14,10,87,2262,405,520,925,"21 de agosto de 1994"
14,10,87,2263,384,472,856,"21 de agosto de 1994"
14,10,87,2264,534,517,1051,"21 de agosto de 1994"
14,10,87,2265,375,380,755,"21 de agosto de 1994"
14,10,87,2266,70,75,145,"21 de agosto de 1994"
14,10,87,2267,453,446,899,"21 de agosto de 1994"
14,10,87,2268,182,153,335,"21 de agosto de 1994"
14,10,89,2285,592,594,1186,"21 de agosto de 1994"
14,10,89,2286,328,329,657,"21 de agosto de 1994"
14,10,89,2287,360,346,706,"21 de agosto de 1994"
14,10,89,2288,601,649,1250,"21 de agosto de 1994"
14,10,89,2289,252,252,504,"21 de agosto de 1994"
14,10,89,2290,205,207,412,"21 de agosto de 1994"
14,10,89,2291,81,106,187,"21 de agosto de 1994"
14,10,89,2292,249,255,504,"21 de agosto de 1994"
14,10,89,2293,316,300,616,"21 de agosto de 1994"
14,10,89,2294,315,307,622,"21 de agosto de 1994"
14,10,89,2295,69,87,156,"21 de agosto de 1994"
14,10,89,2296,379,430,809,"21 de agosto de 1994"
14,10,89,2297,123,119,242,"21 de agosto de 1994"
14,10,100,2625,333,360,693,"21 de agosto de 1994"
14,10,100,2626,278,311,589,"21 de agosto de 1994"
14,10,100,2627,198,164,362,"21 de agosto de 1994"
14,10,100,2628,244,236,480,"21 de agosto de 1994"
14,10,100,2629,422,475,897,"21 de agosto de 1994"
14,10,100,2630,323,367,690,"21 de agosto de 1994"
14,10,100,2631,270,304,574,"21 de agosto de 1994"
14,10,100,2632,39,29,68,"21 de agosto de 1994"
14,10,103,2730,443,571,1014,"21 de agosto de 1994"
14,10,103,2731,259,311,570,"21 de agosto de 1994"
14,10,103,2732,271,330,601,"21 de agosto de 1994"
14,10,103,2733,245,306,551,"21 de agosto de 1994"
14,10,103,2734,270,333,603,"21 de agosto de 1994"
14,10,107,2762,360,379,739,"21 de agosto de 1994"
14,10,107,2763,118,101,219,"21 de agosto de 1994"
14,10,107,2764,193,208,401,"21 de agosto de 1994"
14,10,107,2765,138,140,278,"21 de agosto de 1994"
14,10,107,2766,295,250,545,"21 de agosto de 1994"
14,10,111,2804,538,594,1132,"21 de agosto de 1994"
14,10,111,2805,342,396,738,"21 de agosto de 1994"
14,10,111,2806,216,250,466,"21 de agosto de 1994"
14,10,111,2807,268,328,596,"21 de agosto de 1994"
14,10,111,2808,353,459,812,"21 de agosto de 1994"
14,10,111,2809,296,337,633,"21 de agosto de 1994"
14,10,111,2810,219,225,444,"21 de agosto de 1994"
14,10,111,2811,304,336,640,"21 de agosto de 1994"
14,10,111,2812,305,290,595,"21 de agosto de 1994"
14,10,111,2813,291,295,586,"21 de agosto de 1994"
14,10,111,2814,207,219,426,"21 de agosto de 1994"
14,10,111,2815,159,152,311,"21 de agosto de 1994"
14,11,12,155,210,260,470,"21 de agosto de 1994"
14,11,12,156,221,271,492,"21 de agosto de 1994"
14,11,12,157,40,54,94,"21 de agosto de 1994"
14,11,12,158,61,77,138,"21 de agosto de 1994"
14,11,12,159,340,372,712,"21 de agosto de 1994"
14,11,12,160,58,89,147,"21 de agosto de 1994"
14,11,15,194,636,705,1341,"21 de agosto de 1994"
14,11,15,195,435,507,942,"21 de agosto de 1994"
14,11,15,196,320,423,743,"21 de agosto de 1994"
14,11,15,197,778,761,1539,"21 de agosto de 1994"
14,11,15,198,434,544,978,"21 de agosto de 1994"
14,11,15,199,568,633,1201,"21 de agosto de 1994"
14,11,15,200,498,570,1068,"21 de agosto de 1994"
14,11,15,201,383,439,822,"21 de agosto de 1994"
14,11,15,202,491,570,1061,"21 de agosto de 1994"
14,11,15,203,513,581,1094,"21 de agosto de 1994"
14,11,15,204,478,534,1012,"21 de agosto de 1994"
14,11,15,205,446,581,1027,"21 de agosto de 1994"
14,11,15,206,406,469,875,"21 de agosto de 1994"
14,11,15,207,640,724,1364,"21 de agosto de 1994"
14,11,15,208,251,268,519,"21 de agosto de 1994"
14,11,15,209,552,625,1177,"21 de agosto de 1994"
14,11,15,210,299,317,616,"21 de agosto de 1994"
14,11,15,211,190,224,414,"21 de agosto de 1994"
14,11,15,212,558,607,1165,"21 de agosto de 1994"
14,11,15,213,279,268,547,"21 de agosto de 1994"
14,11,15,214,421,377,798,"21 de agosto de 1994"
14,11,15,215,163,161,324,"21 de agosto de 1994"
14,11,15,216,290,287,577,"21 de agosto de 1994"
14,11,15,217,334,336,670,"21 de agosto de 1994"
14,11,15,218,204,212,416,"21 de agosto de 1994"
14,11,15,219,274,287,561,"21 de agosto de 1994"
14,11,15,220,55,49,104,"21 de agosto de 1994"
14,11,15,221,116,105,221,"21 de agosto de 1994"
14,11,15,222,268,261,529,"21 de agosto de 1994"
14,11,15,223,340,365,705,"21 de agosto de 1994"
14,11,17,244,517,554,1071,"21 de agosto de 1994"
14,11,17,245,362,350,712,"21 de agosto de 1994"
14,11,17,246,178,188,366,"21 de agosto de 1994"
14,11,17,247,310,317,627,"21 de agosto de 1994"
14,11,17,248,333,367,700,"21 de agosto de 1994"
14,11,17,249,120,144,264,"21 de agosto de 1994"
14,11,17,250,240,229,469,"21 de agosto de 1994"
14,11,17,251,215,213,428,"21 de agosto de 1994"
14,11,17,252,185,172,357,"21 de agosto de 1994"
14,11,17,253,227,187,414,"21 de agosto de 1994"
14,11,17,254,224,130,354,"21 de agosto de 1994"
14,11,17,255,221,163,384,"21 de agosto de 1994"
14,11,20,296,414,336,750,"21 de agosto de 1994"
14,11,20,297,441,347,788,"21 de agosto de 1994"
14,11,20,298,311,204,515,"21 de agosto de 1994"
14,11,20,299,203,178,381,"21 de agosto de 1994"
14,11,20,300,647,530,1177,"21 de agosto de 1994"
14,11,20,301,268,164,432,"21 de agosto de 1994"
14,11,21,302,323,327,650,"21 de agosto de 1994"
14,11,21,303,405,415,820,"21 de agosto de 1994"
14,11,21,304,401,442,843,"21 de agosto de 1994"
14,11,21,305,345,310,655,"21 de agosto de 1994"
14,11,21,306,241,260,501,"21 de agosto de 1994"
14,11,21,307,280,291,571,"21 de agosto de 1994"
14,11,21,308,490,493,983,"21 de agosto de 1994"
14,11,21,309,226,218,444,"21 de agosto de 1994"
14,11,21,310,390,399,789,"21 de agosto de 1994"
14,11,21,311,473,444,917,"21 de agosto de 1994"
14,11,21,312,311,311,622,"21 de agosto de 1994"
14,11,21,313,309,340,649,"21 de agosto de 1994"
14,11,21,314,333,361,694,"21 de agosto de 1994"
14,11,21,315,243,190,433,"21 de agosto de 1994"
14,11,22,316,297,314,611,"21 de agosto de 1994"
14,11,22,317,346,318,664,"21 de agosto de 1994"
14,11,22,318,273,233,506,"21 de agosto de 1994"
14,11,22,319,602,627,1229,"21 de agosto de 1994"
14,11,22,320,486,490,976,"21 de agosto de 1994"
14,11,22,321,510,557,1067,"21 de agosto de 1994"
14,11,22,322,291,281,572,"21 de agosto de 1994"
14,11,22,323,353,396,749,"21 de agosto de 1994"
14,11,22,324,239,261,500,"21 de agosto de 1994"
14,11,22,325,269,267,536,"21 de agosto de 1994"
14,11,22,326,399,399,798,"21 de agosto de 1994"
14,11,22,327,533,540,1073,"21 de agosto de 1994"
14,11,22,328,582,612,1194,"21 de agosto de 1994"
14,11,22,329,117,77,194,"21 de agosto de 1994"
14,11,22,330,382,331,713,"21 de agosto de 1994"
14,11,22,331,625,557,1182,"21 de agosto de 1994"
14,11,22,332,88,56,144,"21 de agosto de 1994"
14,11,28,432,354,334,688,"21 de agosto de 1994"
14,11,28,433,365,296,661,"21 de agosto de 1994"
14,11,28,434,430,367,797,"21 de agosto de 1994"
14,11,28,435,540,436,976,"21 de agosto de 1994"
14,11,28,436,522,359,881,"21 de agosto de 1994"
14,11,28,437,505,398,903,"21 de agosto de 1994"
14,11,28,438,111,99,210,"21 de agosto de 1994"
14,11,28,439,533,498,1031,"21 de agosto de 1994"
14,11,28,440,117,112,229,"21 de agosto de 1994"
14,11,29,441,265,366,631,"21 de agosto de 1994"
14,11,29,442,163,182,345,"21 de agosto de 1994"
14,11,29,443,54,59,113,"21 de agosto de 1994"
14,11,29,444,91,117,208,"21 de agosto de 1994"
14,11,45,1573,299,308,607,"21 de agosto de 1994"
14,11,45,1574,375,392,767,"21 de agosto de 1994"
14,11,45,1575,335,343,678,"21 de agosto de 1994"
14,11,45,1576,170,177,347,"21 de agosto de 1994"
14,11,45,1577,179,184,363,"21 de agosto de 1994"
14,11,45,1578,388,411,799,"21 de agosto de 1994"
14,11,45,1579,168,134,302,"21 de agosto de 1994"
14,11,45,1580,197,158,355,"21 de agosto de 1994"
14,11,45,1581,176,155,331,"21 de agosto de 1994"
14,11,45,1582,435,446,881,"21 de agosto de 1994"
14,11,45,1583,90,91,181,"21 de agosto de 1994"
14,11,45,1584,239,201,440,"21 de agosto de 1994"
14,11,45,1585,416,331,747,"21 de agosto de 1994"
14,11,45,1586,191,161,352,"21 de agosto de 1994"
14,11,45,1587,504,432,936,"21 de agosto de 1994"
14,11,45,1588,335,318,653,"21 de agosto de 1994"
14,11,45,1589,329,301,630,"21 de agosto de 1994"
14,11,45,1590,206,196,402,"21 de agosto de 1994"
14,11,64,1840,199,233,432,"21 de agosto de 1994"
14,11,64,1841,210,272,482,"21 de agosto de 1994"
14,11,64,1842,260,276,536,"21 de agosto de 1994"
14,11,64,1843,99,118,217,"21 de agosto de 1994"
14,11,70,2003,407,400,807,"21 de agosto de 1994"
14,11,70,2004,288,283,571,"21 de agosto de 1994"
14,11,70,2005,320,325,645,"21 de agosto de 1994"
14,11,70,2006,271,273,544,"21 de agosto de 1994"
14,11,70,2007,376,344,720,"21 de agosto de 1994"
14,11,70,2008,88,73,161,"21 de agosto de 1994"
14,11,70,2009,347,267,614,"21 de agosto de 1994"
14,11,70,2010,326,237,563,"21 de agosto de 1994"
14,11,70,2011,200,165,365,"21 de agosto de 1994"
14,11,85,2212,502,563,1065,"21 de agosto de 1994"
14,11,85,2213,701,708,1409,"21 de agosto de 1994"
14,11,85,2214,567,635,1202,"21 de agosto de 1994"
14,11,85,2215,268,229,497,"21 de agosto de 1994"
14,11,85,2216,196,145,341,"21 de agosto de 1994"
14,11,85,2217,166,130,296,"21 de agosto de 1994"
14,11,85,2218,53,47,100,"21 de agosto de 1994"
14,11,85,2219,98,84,182,"21 de agosto de 1994"
14,11,85,2220,329,276,605,"21 de agosto de 1994"
14,11,85,2221,135,83,218,"21 de agosto de 1994"
14,11,85,2222,240,160,400,"21 de agosto de 1994"
14,11,101,2633,465,523,988,"21 de agosto de 1994"
14,11,101,2634,584,534,1118,"21 de agosto de 1994"
14,11,101,2635,440,453,893,"21 de agosto de 1994"
14,11,101,2636,286,256,542,"21 de agosto de 1994"
14,11,101,2637,382,291,673,"21 de agosto de 1994"
14,11,101,2638,360,287,647,"21 de agosto de 1994"
14,11,101,2639,536,424,960,"21 de agosto de 1994"
14,11,101,2640,407,312,719,"21 de agosto de 1994"
14,11,101,2641,180,130,310,"21 de agosto de 1994"
14,11,101,2642,505,384,889,"21 de agosto de 1994"
14,11,101,2643,759,632,1391,"21 de agosto de 1994"
14,11,101,2644,187,173,360,"21 de agosto de 1994"
14,11,101,2645,194,151,345,"21 de agosto de 1994"
14,11,101,2646,246,238,484,"21 de agosto de 1994"
14,11,101,2647,238,222,460,"21 de agosto de 1994"
14,11,101,2648,489,442,931,"21 de agosto de 1994"
14,11,101,2649,566,528,1094,"21 de agosto de 1994"
14,12,6,48,496,524,1020,"21 de agosto de 1994"
14,12,6,49,39,2,41,"21 de agosto de 1994"
14,12,6,50,346,448,794,"21 de agosto de 1994"
14,12,6,51,382,471,853,"21 de agosto de 1994"
14,12,6,52,532,568,1100,"21 de agosto de 1994"
14,12,6,53,431,457,888,"21 de agosto de 1994"
14,12,6,54,334,386,720,"21 de agosto de 1994"
14,12,6,55,376,439,815,"21 de agosto de 1994"
14,12,6,56,557,618,1175,"21 de agosto de 1994"
14,12,6,57,456,525,981,"21 de agosto de 1994"
14,12,6,58,458,501,959,"21 de agosto de 1994"
14,12,6,59,372,427,799,"21 de agosto de 1994"
14,12,6,60,255,305,560,"21 de agosto de 1994"
14,12,6,61,403,483,886,"21 de agosto de 1994"
14,12,6,62,368,409,777,"21 de agosto de 1994"
14,12,6,63,414,398,812,"21 de agosto de 1994"
14,12,6,64,367,413,780,"21 de agosto de 1994"
14,12,6,65,452,470,922,"21 de agosto de 1994"
14,12,6,66,445,537,982,"21 de agosto de 1994"
14,12,6,67,548,592,1140,"21 de agosto de 1994"
14,12,6,68,444,13,457,"21 de agosto de 1994"
14,12,6,69,318,382,700,"21 de agosto de 1994"
14,12,6,70,351,419,770,"21 de agosto de 1994"
14,12,6,71,245,310,555,"21 de agosto de 1994"
14,12,6,72,743,771,1514,"21 de agosto de 1994"
14,12,6,73,181,172,353,"21 de agosto de 1994"
14,12,6,74,133,101,234,"21 de agosto de 1994"
14,12,6,75,247,250,497,"21 de agosto de 1994"
14,12,6,76,241,216,457,"21 de agosto de 1994"
14,12,6,77,334,336,670,"21 de agosto de 1994"
14,12,6,78,220,279,499,"21 de agosto de 1994"
14,12,6,79,265,247,512,"21 de agosto de 1994"
14,12,6,80,389,442,831,"21 de agosto de 1994"
14,12,6,81,324,347,671,"21 de agosto de 1994"
14,12,6,82,76,73,149,"21 de agosto de 1994"
14,12,6,83,45,41,86,"21 de agosto de 1994"
14,12,6,84,217,215,432,"21 de agosto de 1994"
14,12,6,85,141,159,300,"21 de agosto de 1994"
14,12,6,86,71,85,156,"21 de agosto de 1994"
14,12,6,87,243,292,535,"21 de agosto de 1994"
14,12,6,88,246,252,498,"21 de agosto de 1994"
14,12,6,89,194,176,370,"21 de agosto de 1994"
14,12,6,90,155,172,327,"21 de agosto de 1994"
14,12,6,91,386,381,767,"21 de agosto de 1994"
14,12,6,92,31,39,70,"21 de agosto de 1994"
14,12,6,93,160,171,331,"21 de agosto de 1994"
14,12,11,149,234,279,513,"21 de agosto de 1994"
14,12,11,150,207,209,416,"21 de agosto de 1994"
14,12,11,151,108,107,215,"21 de agosto de 1994"
14,12,11,152,157,130,287,"21 de agosto de 1994"
14,12,11,153,397,385,782,"21 de agosto de 1994"
14,12,11,154,115,118,233,"21 de agosto de 1994"
14,12,37,530,450,486,936,"21 de agosto de 1994"
14,12,37,531,532,596,1128,"21 de agosto de 1994"
14,12,37,532,568,667,1235,"21 de agosto de 1994"
14,12,37,533,458,463,921,"21 de agosto de 1994"
14,12,37,534,271,314,585,"21 de agosto de 1994"
14,12,37,535,379,489,868,"21 de agosto de 1994"
14,12,37,536,432,460,892,"21 de agosto de 1994"
14,12,37,537,231,239,470,"21 de agosto de 1994"
14,12,37,538,338,363,701,"21 de agosto de 1994"
14,12,37,539,418,388,806,"21 de agosto de 1994"
14,12,37,540,101,91,192,"21 de agosto de 1994"
14,12,40,561,242,263,505,"21 de agosto de 1994"
14,12,40,562,205,239,444,"21 de agosto de 1994"
14,12,40,563,246,198,444,"21 de agosto de 1994"
14,12,40,564,42,39,81,"21 de agosto de 1994"
14,12,40,565,114,95,209,"21 de agosto de 1994"
14,12,40,566,57,45,102,"21 de agosto de 1994"
14,12,40,567,75,82,157,"21 de agosto de 1994"
14,12,40,568,45,36,81,"21 de agosto de 1994"
14,12,40,569,137,133,270,"21 de agosto de 1994"
14,12,60,1802,470,469,939,"21 de agosto de 1994"
14,12,60,1803,389,465,854,"21 de agosto de 1994"
14,12,60,1804,407,427,834,"21 de agosto de 1994"
14,12,60,1805,514,572,1086,"21 de agosto de 1994"
14,12,60,1806,503,571,1074,"21 de agosto de 1994"
14,12,60,1807,99,74,173,"21 de agosto de 1994"
14,12,60,1808,241,299,540,"21 de agosto de 1994"
14,12,60,1809,328,351,679,"21 de agosto de 1994"
14,12,60,1810,141,159,300,"21 de agosto de 1994"
14,12,60,1811,63,53,116,"21 de agosto de 1994"
14,12,60,1812,66,47,113,"21 de agosto de 1994"
14,12,60,1813,97,81,178,"21 de agosto de 1994"
14,12,60,1814,216,198,414,"21 de agosto de 1994"
14,12,69,1934,100,96,196,"21 de agosto de 1994"
14,12,69,1935,726,736,1462,"21 de agosto de 1994"
14,12,69,1936,226,33,259,"21 de agosto de 1994"
14,12,69,1937,508,603,1111,"21 de agosto de 1994"
14,12,69,1938,601,804,1405,"21 de agosto de 1994"
14,12,69,1939,356,432,788,"21 de agosto de 1994"
14,12,69,1940,133,126,259,"21 de agosto de 1994"
14,12,69,1941,457,433,890,"21 de agosto de 1994"
14,12,69,1942,423,417,840,"21 de agosto de 1994"
14,12,69,1943,200,219,419,"21 de agosto de 1994"
14,12,69,1944,559,540,1099,"21 de agosto de 1994"
14,12,69,1945,651,628,1279,"21 de agosto de 1994"
14,12,69,1946,511,497,1008,"21 de agosto de 1994"
14,12,69,1947,478,486,964,"21 de agosto de 1994"
14,12,69,1948,655,642,1297,"21 de agosto de 1994"
14,12,69,1949,394,394,788,"21 de agosto de 1994"
14,12,69,1950,497,503,1000,"21 de agosto de 1994"
14,12,69,1951,411,416,827,"21 de agosto de 1994"
14,12,69,1952,483,507,990,"21 de agosto de 1994"
14,12,69,1953,485,501,986,"21 de agosto de 1994"
14,12,69,1954,470,488,958,"21 de agosto de 1994"
14,12,69,1955,532,536,1068,"21 de agosto de 1994"
14,12,69,1956,301,335,636,"21 de agosto de 1994"
14,12,69,1957,290,300,590,"21 de agosto de 1994"
14,12,69,1958,809,933,1742,"21 de agosto de 1994"
14,12,69,1959,320,332,652,"21 de agosto de 1994"
14,12,69,1960,538,536,1074,"21 de agosto de 1994"
14,12,69,1961,265,247,512,"21 de agosto de 1994"
14,12,69,1962,418,468,886,"21 de agosto de 1994"
14,12,69,1963,309,272,581,"21 de agosto de 1994"
14,12,69,1964,418,449,867,"21 de agosto de 1994"
14,12,69,1965,550,558,1108,"21 de agosto de 1994"
14,12,69,1966,186,216,402,"21 de agosto de 1994"
14,12,69,1967,776,777,1553,"21 de agosto de 1994"
14,12,69,1968,376,375,751,"21 de agosto de 1994"
14,12,69,1969,603,589,1192,"21 de agosto de 1994"
14,12,69,1970,346,352,698,"21 de agosto de 1994"
14,12,69,1971,595,572,1167,"21 de agosto de 1994"
14,12,69,1972,629,638,1267,"21 de agosto de 1994"
14,12,69,1973,702,685,1387,"21 de agosto de 1994"
14,12,69,1974,426,385,811,"21 de agosto de 1994"
14,12,69,1975,442,409,851,"21 de agosto de 1994"
14,12,69,1976,321,335,656,"21 de agosto de 1994"
14,12,69,1977,383,360,743,"21 de agosto de 1994"
14,12,69,1978,399,440,839,"21 de agosto de 1994"
14,12,69,1979,296,338,634,"21 de agosto de 1994"
14,12,69,1980,403,378,781,"21 de agosto de 1994"
14,12,69,1981,405,454,859,"21 de agosto de 1994"
14,12,69,1982,340,396,736,"21 de agosto de 1994"
14,12,69,1983,736,720,1456,"21 de agosto de 1994"
14,12,69,1984,383,369,752,"21 de agosto de 1994"
14,12,69,1985,590,591,1181,"21 de agosto de 1994"
14,12,69,1986,581,581,1162,"21 de agosto de 1994"
14,12,69,1987,331,314,645,"21 de agosto de 1994"
14,12,69,1988,590,624,1214,"21 de agosto de 1994"
14,12,69,1989,592,538,1130,"21 de agosto de 1994"
14,12,69,1990,270,239,509,"21 de agosto de 1994"
14,12,69,1991,399,369,768,"21 de agosto de 1994"
14,12,69,1992,226,219,445,"21 de agosto de 1994"
14,12,69,1993,478,423,901,"21 de agosto de 1994"
14,12,69,1994,144,174,318,"21 de agosto de 1994"
14,12,69,1995,404,416,820,"21 de agosto de 1994"
14,12,69,1996,747,777,1524,"21 de agosto de 1994"
14,12,69,1997,488,452,940,"21 de agosto de 1994"
14,12,69,1998,615,651,1266,"21 de agosto de 1994"
14,12,69,1999,590,604,1194,"21 de agosto de 1994"
14,12,69,2000,472,436,908,"21 de agosto de 1994"
14,12,69,2001,280,222,502,"21 de agosto de 1994"
14,12,69,2002,206,177,383,"21 de agosto de 1994"
14,12,77,2107,379,397,776,"21 de agosto de 1994"
14,12,77,2108,392,441,833,"21 de agosto de 1994"
14,12,77,2109,19,12,31,"21 de agosto de 1994"
14,12,79,2115,543,608,1151,"21 de agosto de 1994"
14,12,79,2116,369,431,800,"21 de agosto de 1994"
14,12,79,2117,495,586,1081,"21 de agosto de 1994"
14,12,79,2118,463,541,1004,"21 de agosto de 1994"
14,12,79,2119,337,492,829,"21 de agosto de 1994"
14,12,79,2120,250,309,559,"21 de agosto de 1994"
14,12,79,2121,345,364,709,"21 de agosto de 1994"
14,12,79,2122,334,348,682,"21 de agosto de 1994"
14,12,79,2123,480,591,1071,"21 de agosto de 1994"
14,12,79,2124,795,909,1704,"21 de agosto de 1994"
14,12,79,2125,600,670,1270,"21 de agosto de 1994"
14,12,79,2126,294,344,638,"21 de agosto de 1994"
14,12,79,2127,234,296,530,"21 de agosto de 1994"
14,12,79,2128,197,242,439,"21 de agosto de 1994"
14,12,79,2129,236,229,465,"21 de agosto de 1994"
14,12,79,2130,439,417,856,"21 de agosto de 1994"
14,12,79,2131,191,188,379,"21 de agosto de 1994"
14,12,81,2150,239,220,459,"21 de agosto de 1994"
14,12,81,2151,214,133,347,"21 de agosto de 1994"
14,12,81,2152,86,44,130,"21 de agosto de 1994"
14,12,81,2153,473,421,894,"21 de agosto de 1994"
14,12,81,2154,192,179,371,"21 de agosto de 1994"
14,12,81,2155,144,131,275,"21 de agosto de 1994"
14,12,81,2156,170,134,304,"21 de agosto de 1994"
14,12,91,2301,525,550,1075,"21 de agosto de 1994"
14,12,91,2302,429,455,884,"21 de agosto de 1994"
14,12,91,2303,290,324,614,"21 de agosto de 1994"
14,12,91,2304,243,251,494,"21 de agosto de 1994"
14,12,91,2305,65,72,137,"21 de agosto de 1994"
14,12,91,2306,292,310,602,"21 de agosto de 1994"
14,13,41,1009,283,396,679,"21 de agosto de 1994"
14,13,41,1010,311,395,706,"21 de agosto de 1994"
14,13,41,1011,465,635,1100,"21 de agosto de 1994"
14,13,41,1012,450,553,1003,"21 de agosto de 1994"
14,13,41,1013,402,507,909,"21 de agosto de 1994"
14,13,41,1014,487,589,1076,"21 de agosto de 1994"
14,13,41,1015,339,416,755,"21 de agosto de 1994"
14,13,41,1016,315,349,664,"21 de agosto de 1994"
14,13,41,1017,404,494,898,"21 de agosto de 1994"
14,13,41,1018,267,311,578,"21 de agosto de 1994"
14,13,41,1019,432,516,948,"21 de agosto de 1994"
14,13,41,1020,252,276,528,"21 de agosto de 1994"
14,13,41,1021,320,392,712,"21 de agosto de 1994"
14,13,41,1022,260,381,641,"21 de agosto de 1994"
14,13,41,1023,248,329,577,"21 de agosto de 1994"
14,13,41,1024,269,327,596,"21 de agosto de 1994"
14,13,41,1025,321,401,722,"21 de agosto de 1994"
14,13,41,1026,175,205,380,"21 de agosto de 1994"
14,13,41,1027,346,423,769,"21 de agosto de 1994"
14,13,41,1028,203,254,457,"21 de agosto de 1994"
14,13,41,1029,247,273,520,"21 de agosto de 1994"
14,13,41,1030,298,372,670,"21 de agosto de 1994"
14,13,41,1031,375,449,824,"21 de agosto de 1994"
14,13,41,1032,316,378,694,"21 de agosto de 1994"
14,13,41,1033,448,588,1036,"21 de agosto de 1994"
14,13,41,1034,242,262,504,"21 de agosto de 1994"
14,13,41,1035,366,433,799,"21 de agosto de 1994"
14,13,41,1036,272,347,619,"21 de agosto de 1994"
14,13,41,1037,302,338,640,"21 de agosto de 1994"
14,13,41,1038,322,412,734,"21 de agosto de 1994"
14,13,41,1039,234,374,608,"21 de agosto de 1994"
14,13,41,1040,395,499,894,"21 de agosto de 1994"
14,13,41,1041,326,370,696,"21 de agosto de 1994"
14,13,41,1042,333,448,781,"21 de agosto de 1994"
14,13,41,1043,315,401,716,"21 de agosto de 1994"
14,13,41,1044,260,334,594,"21 de agosto de 1994"
14,13,41,1045,213,227,440,"21 de agosto de 1994"
14,13,41,1046,296,365,661,"21 de agosto de 1994"
14,13,41,1047,312,385,697,"21 de agosto de 1994"
14,13,41,1048,239,216,455,"21 de agosto de 1994"
14,13,41,1049,224,188,412,"21 de agosto de 1994"
14,13,41,1050,301,344,645,"21 de agosto de 1994"
14,13,41,1051,220,240,460,"21 de agosto de 1994"
14,13,41,1052,263,363,626,"21 de agosto de 1994"
14,13,41,1053,332,351,683,"21 de agosto de 1994"
14,13,41,1054,233,274,507,"21 de agosto de 1994"
14,13,41,1055,158,189,347,"21 de agosto de 1994"
14,13,41,1056,323,380,703,"21 de agosto de 1994"
14,13,41,1057,155,216,371,"21 de agosto de 1994"
14,13,41,1058,394,501,895,"21 de agosto de 1994"
14,13,41,1059,196,279,475,"21 de agosto de 1994"
14,13,41,1060,184,246,430,"21 de agosto de 1994"
14,13,41,1061,408,504,912,"21 de agosto de 1994"
14,13,41,1062,328,452,780,"21 de agosto de 1994"
14,13,41,1063,168,201,369,"21 de agosto de 1994"
14,13,41,1064,330,464,794,"21 de agosto de 1994"
14,13,41,1065,509,605,1114,"21 de agosto de 1994"
14,13,41,1066,348,394,742,"21 de agosto de 1994"
14,13,41,1067,270,318,588,"21 de agosto de 1994"
14,13,41,1068,378,447,825,"21 de agosto de 1994"
14,13,41,1069,265,400,665,"21 de agosto de 1994"
14,13,41,1070,452,499,951,"21 de agosto de 1994"
14,13,41,1071,346,442,788,"21 de agosto de 1994"
14,13,41,1072,300,410,710,"21 de agosto de 1994"
14,13,41,1073,232,285,517,"21 de agosto de 1994"
14,13,41,1074,341,368,709,"21 de agosto de 1994"
14,13,41,1075,449,626,1075,"21 de agosto de 1994"
14,13,41,1076,212,258,470,"21 de agosto de 1994"
14,13,41,1077,355,427,782,"21 de agosto de 1994"
14,13,41,1078,419,502,921,"21 de agosto de 1994"
14,13,41,1079,291,341,632,"21 de agosto de 1994"
14,13,41,1080,301,348,649,"21 de agosto de 1994"
14,13,41,1081,311,342,653,"21 de agosto de 1994"
14,13,41,1082,465,550,1015,"21 de agosto de 1994"
14,13,41,1083,385,409,794,"21 de agosto de 1994"
14,13,41,1084,310,359,669,"21 de agosto de 1994"
14,13,41,1085,323,357,680,"21 de agosto de 1994"
14,13,41,1086,460,566,1026,"21 de agosto de 1994"
14,14,41,1087,653,788,1441,"21 de agosto de 1994"
14,14,41,1088,519,660,1179,"21 de agosto de 1994"
14,14,41,1089,303,396,699,"21 de agosto de 1994"
14,14,41,1090,352,430,782,"21 de agosto de 1994"
14,14,41,1091,572,695,1267,"21 de agosto de 1994"
14,14,41,1092,459,586,1045,"21 de agosto de 1994"
14,14,41,1093,395,543,938,"21 de agosto de 1994"
14,14,41,1094,306,381,687,"21 de agosto de 1994"
14,14,41,1095,357,450,807,"21 de agosto de 1994"
14,14,41,1096,366,415,781,"21 de agosto de 1994"
14,14,41,1097,258,369,627,"21 de agosto de 1994"
14,14,41,1098,411,524,935,"21 de agosto de 1994"
14,14,41,1099,240,286,526,"21 de agosto de 1994"
14,14,41,1100,460,511,971,"21 de agosto de 1994"
14,14,41,1101,539,644,1183,"21 de agosto de 1994"
14,14,41,1102,549,619,1168,"21 de agosto de 1994"
14,14,41,1103,695,788,1483,"21 de agosto de 1994"
14,14,41,1104,492,534,1026,"21 de agosto de 1994"
14,14,41,1105,368,440,808,"21 de agosto de 1994"
14,14,41,1106,530,697,1227,"21 de agosto de 1994"
14,14,41,1107,385,541,926,"21 de agosto de 1994"
14,14,41,1108,581,687,1268,"21 de agosto de 1994"
14,14,41,1109,345,439,784,"21 de agosto de 1994"
14,14,41,1110,317,379,696,"21 de agosto de 1994"
14,14,41,1111,373,461,834,"21 de agosto de 1994"
14,14,41,1112,359,455,814,"21 de agosto de 1994"
14,14,41,1113,606,776,1382,"21 de agosto de 1994"
14,14,41,1114,292,342,634,"21 de agosto de 1994"
14,14,41,1115,420,514,934,"21 de agosto de 1994"
14,14,41,1116,540,648,1188,"21 de agosto de 1994"
14,14,41,1117,336,374,710,"21 de agosto de 1994"
14,14,41,1118,285,372,657,"21 de agosto de 1994"
14,14,41,1119,288,358,646,"21 de agosto de 1994"
14,14,41,1120,465,579,1044,"21 de agosto de 1994"
14,14,41,1121,482,576,1058,"21 de agosto de 1994"
14,14,41,1122,444,536,980,"21 de agosto de 1994"
14,14,41,1123,592,662,1254,"21 de agosto de 1994"
14,14,41,1124,512,573,1085,"21 de agosto de 1994"
14,14,41,1125,555,634,1189,"21 de agosto de 1994"
14,14,41,1126,603,700,1303,"21 de agosto de 1994"
14,14,41,1127,367,503,870,"21 de agosto de 1994"
14,14,41,1128,611,790,1401,"21 de agosto de 1994"
14,14,41,1129,519,715,1234,"21 de agosto de 1994"
14,14,41,1130,372,457,829,"21 de agosto de 1994"
14,14,41,1131,330,387,717,"21 de agosto de 1994"
14,14,41,1132,293,384,677,"21 de agosto de 1994"
14,14,41,1133,380,455,835,"21 de agosto de 1994"
14,14,41,1134,192,240,432,"21 de agosto de 1994"
14,14,41,1135,345,419,764,"21 de agosto de 1994"
14,14,41,1136,399,483,882,"21 de agosto de 1994"
14,14,41,1137,465,577,1042,"21 de agosto de 1994"
14,14,41,1138,254,294,548,"21 de agosto de 1994"
14,14,41,1139,397,506,903,"21 de agosto de 1994"
14,14,41,1140,404,451,855,"21 de agosto de 1994"
14,14,41,1141,373,471,844,"21 de agosto de 1994"
14,14,41,1142,461,535,996,"21 de agosto de 1994"
14,14,41,1143,412,546,958,"21 de agosto de 1994"
14,14,41,1144,445,502,947,"21 de agosto de 1994"
14,14,41,1145,422,526,948,"21 de agosto de 1994"
14,14,41,1146,312,385,697,"21 de agosto de 1994"
14,14,41,1147,448,485,933,"21 de agosto de 1994"
14,14,41,1148,348,362,710,"21 de agosto de 1994"
14,14,41,1149,332,381,713,"21 de agosto de 1994"
14,14,41,1150,481,562,1043,"21 de agosto de 1994"
14,14,41,1151,515,664,1179,"21 de agosto de 1994"
14,14,41,1152,471,591,1062,"21 de agosto de 1994"
14,14,41,1153,496,568,1064,"21 de agosto de 1994"
14,14,41,1154,489,593,1082,"21 de agosto de 1994"
14,14,41,1155,267,369,636,"21 de agosto de 1994"
14,14,41,1156,419,507,926,"21 de agosto de 1994"
14,14,41,1157,284,341,625,"21 de agosto de 1994"
14,14,41,1158,269,364,633,"21 de agosto de 1994"
14,14,41,1159,342,431,773,"21 de agosto de 1994"
14,14,41,1160,221,306,527,"21 de agosto de 1994"
14,14,41,1161,361,532,893,"21 de agosto de 1994"
14,14,41,1162,423,515,938,"21 de agosto de 1994"
14,14,41,1163,454,541,995,"21 de agosto de 1994"
14,14,41,1164,528,591,1119,"21 de agosto de 1994"
14,14,41,1165,401,469,870,"21 de agosto de 1994"
14,14,41,1166,414,474,888,"21 de agosto de 1994"
14,14,41,1167,229,278,507,"21 de agosto de 1994"
14,14,41,1168,209,276,485,"21 de agosto de 1994"
14,14,41,1169,351,423,774,"21 de agosto de 1994"
14,14,41,1170,279,315,594,"21 de agosto de 1994"
14,14,41,1171,384,434,818,"21 de agosto de 1994"
14,14,41,1172,369,405,774,"21 de agosto de 1994"
14,14,41,1173,325,387,712,"21 de agosto de 1994"
14,14,41,1174,381,492,873,"21 de agosto de 1994"
14,14,41,1175,426,569,995,"21 de agosto de 1994"
14,14,41,1176,528,616,1144,"21 de agosto de 1994"
14,14,41,1177,467,554,1021,"21 de agosto de 1994"
14,14,41,1178,388,398,786,"21 de agosto de 1994"
14,14,41,1179,333,441,774,"21 de agosto de 1994"
14,14,41,1180,518,606,1124,"21 de agosto de 1994"
14,14,41,1181,184,237,421,"21 de agosto de 1994"
14,14,41,1182,216,308,524,"21 de agosto de 1994"
14,14,41,1183,213,300,513,"21 de agosto de 1994"
14,14,41,1184,195,288,483,"21 de agosto de 1994"
14,14,41,1185,279,330,609,"21 de agosto de 1994"
14,14,41,1186,266,238,504,"21 de agosto de 1994"
14,15,41,1187,715,804,1519,"21 de agosto de 1994"
14,15,41,1188,623,683,1306,"21 de agosto de 1994"
14,15,41,1189,526,605,1131,"21 de agosto de 1994"
14,15,41,1190,425,442,867,"21 de agosto de 1994"
14,15,41,1191,421,443,864,"21 de agosto de 1994"
14,15,41,1192,601,641,1242,"21 de agosto de 1994"
14,15,41,1193,586,666,1252,"21 de agosto de 1994"
14,15,41,1194,671,790,1461,"21 de agosto de 1994"
14,15,41,1195,385,458,843,"21 de agosto de 1994"
14,15,41,1196,436,523,959,"21 de agosto de 1994"
14,15,41,1197,410,458,868,"21 de agosto de 1994"
14,15,41,1198,395,449,844,"21 de agosto de 1994"
14,15,41,1199,408,426,834,"21 de agosto de 1994"
14,15,41,1200,653,724,1377,"21 de agosto de 1994"
14,15,41,1201,305,372,677,"21 de agosto de 1994"
14,15,41,1202,387,443,830,"21 de agosto de 1994"
14,15,41,1203,371,429,800,"21 de agosto de 1994"
14,15,41,1204,703,732,1435,"21 de agosto de 1994"
14,15,41,1205,560,604,1164,"21 de agosto de 1994"
14,15,41,1206,563,660,1223,"21 de agosto de 1994"
14,15,41,1207,854,922,1776,"21 de agosto de 1994"
14,15,41,1208,557,625,1182,"21 de agosto de 1994"
14,15,41,1209,736,818,1554,"21 de agosto de 1994"
14,15,41,1210,290,382,672,"21 de agosto de 1994"
14,15,41,1211,480,574,1054,"21 de agosto de 1994"
14,15,41,1212,427,466,893,"21 de agosto de 1994"
14,15,41,1213,755,829,1584,"21 de agosto de 1994"
14,15,41,1214,410,459,869,"21 de agosto de 1994"
14,15,41,1215,323,358,681,"21 de agosto de 1994"
14,15,41,1216,823,851,1674,"21 de agosto de 1994"
14,15,41,1217,810,915,1725,"21 de agosto de 1994"
14,15,41,1218,607,704,1311,"21 de agosto de 1994"
14,15,41,1219,539,678,1217,"21 de agosto de 1994"
14,15,41,1220,553,621,1174,"21 de agosto de 1994"
14,15,41,1221,554,596,1150,"21 de agosto de 1994"
14,15,41,1222,294,344,638,"21 de agosto de 1994"
14,15,41,1223,380,429,809,"21 de agosto de 1994"
14,15,41,1224,812,924,1736,"21 de agosto de 1994"
14,15,41,1225,453,535,988,"21 de agosto de 1994"
14,15,41,1226,356,431,787,"21 de agosto de 1994"
14,15,41,1227,439,479,918,"21 de agosto de 1994"
14,15,41,1228,475,485,960,"21 de agosto de 1994"
14,15,41,1229,461,453,914,"21 de agosto de 1994"
14,15,41,1230,423,470,893,"21 de agosto de 1994"
14,15,41,1231,381,463,844,"21 de agosto de 1994"
14,15,41,1232,342,363,705,"21 de agosto de 1994"
14,15,41,1233,483,543,1026,"21 de agosto de 1994"
14,15,41,1234,678,746,1424,"21 de agosto de 1994"
14,15,41,1235,626,729,1355,"21 de agosto de 1994"
14,15,41,1236,673,750,1423,"21 de agosto de 1994"
14,15,41,1237,632,687,1319,"21 de agosto de 1994"
14,15,41,1238,670,737,1407,"21 de agosto de 1994"
14,15,41,1239,513,523,1036,"21 de agosto de 1994"
14,15,41,1240,484,531,1015,"21 de agosto de 1994"
14,15,41,1241,397,452,849,"21 de agosto de 1994"
14,15,41,1242,743,839,1582,"21 de agosto de 1994"
14,15,41,1243,661,732,1393,"21 de agosto de 1994"
14,15,41,1244,531,675,1206,"21 de agosto de 1994"
14,15,41,1245,387,479,866,"21 de agosto de 1994"
14,15,41,1246,391,437,828,"21 de agosto de 1994"
14,15,41,1247,452,554,1006,"21 de agosto de 1994"
14,15,41,1248,403,484,887,"21 de agosto de 1994"
14,15,41,1249,547,621,1168,"21 de agosto de 1994"
14,15,41,1250,408,461,869,"21 de agosto de 1994"
14,15,41,1251,358,411,769,"21 de agosto de 1994"
14,15,41,1252,583,707,1290,"21 de agosto de 1994"
14,15,41,1253,351,450,801,"21 de agosto de 1994"
14,15,41,1254,398,442,840,"21 de agosto de 1994"
14,15,41,1255,736,822,1558,"21 de agosto de 1994"
14,15,41,1256,612,752,1364,"21 de agosto de 1994"
14,15,41,1257,538,657,1195,"21 de agosto de 1994"
14,15,41,1258,237,278,515,"21 de agosto de 1994"
14,15,41,1259,172,235,407,"21 de agosto de 1994"
14,15,41,1260,332,371,703,"21 de agosto de 1994"
14,15,41,1261,480,620,1100,"21 de agosto de 1994"
14,15,41,1262,713,810,1523,"21 de agosto de 1994"
14,15,41,1263,358,380,738,"21 de agosto de 1994"
14,15,41,1264,361,390,751,"21 de agosto de 1994"
14,15,41,1265,566,651,1217,"21 de agosto de 1994"
14,15,41,1266,494,540,1034,"21 de agosto de 1994"
14,15,41,1267,600,669,1269,"21 de agosto de 1994"
14,15,41,1268,466,510,976,"21 de agosto de 1994"
14,15,41,1269,530,579,1109,"21 de agosto de 1994"
14,15,41,1270,671,723,1394,"21 de agosto de 1994"
14,15,41,1271,622,704,1326,"21 de agosto de 1994"
14,15,41,1272,685,742,1427,"21 de agosto de 1994"
14,15,41,1273,663,766,1429,"21 de agosto de 1994"
14,15,41,1274,542,618,1160,"21 de agosto de 1994"
14,15,41,1275,425,510,935,"21 de agosto de 1994"
14,15,41,1276,382,450,832,"21 de agosto de 1994"
14,15,41,1277,478,602,1080,"21 de agosto de 1994"
14,15,41,1278,701,743,1444,"21 de agosto de 1994"
14,15,41,1279,503,588,1091,"21 de agosto de 1994"
14,15,41,1280,684,721,1405,"21 de agosto de 1994"
14,15,41,1281,388,453,841,"21 de agosto de 1994"
14,15,41,1282,306,356,662,"21 de agosto de 1994"
14,15,41,1283,708,750,1458,"21 de agosto de 1994"
14,15,41,1284,412,467,879,"21 de agosto de 1994"
14,15,41,1285,338,429,767,"21 de agosto de 1994"
14,15,41,1286,452,495,947,"21 de agosto de 1994"
14,15,41,1287,409,439,848,"21 de agosto de 1994"
14,15,41,1288,750,803,1553,"21 de agosto de 1994"
14,15,41,1289,522,595,1117,"21 de agosto de 1994"
14,15,41,1290,467,492,959,"21 de agosto de 1994"
14,15,41,1291,535,586,1121,"21 de agosto de 1994"
14,15,41,1292,657,717,1374,"21 de agosto de 1994"
14,15,41,1293,574,686,1260,"21 de agosto de 1994"
14,15,41,1294,308,430,738,"21 de agosto de 1994"
14,15,41,1295,385,454,839,"21 de agosto de 1994"
14,15,41,1296,515,637,1152,"21 de agosto de 1994"
14,15,41,1297,528,669,1197,"21 de agosto de 1994"
14,15,41,1298,423,537,960,"21 de agosto de 1994"
14,15,41,1299,305,437,742,"21 de agosto de 1994"
14,15,41,1300,383,457,840,"21 de agosto de 1994"
14,15,41,1301,354,442,796,"21 de agosto de 1994"
14,15,41,1302,384,485,869,"21 de agosto de 1994"
14,15,41,1303,570,680,1250,"21 de agosto de 1994"
14,15,41,1304,404,508,912,"21 de agosto de 1994"
14,15,41,1305,384,427,811,"21 de agosto de 1994"
14,15,41,1306,367,442,809,"21 de agosto de 1994"
14,15,41,1307,708,841,1549,"21 de agosto de 1994"
14,15,41,1308,405,522,927,"21 de agosto de 1994"
14,15,41,1309,639,814,1453,"21 de agosto de 1994"
14,15,41,1310,613,759,1372,"21 de agosto de 1994"
14,15,41,1311,408,461,869,"21 de agosto de 1994"
14,15,41,1312,345,417,762,"21 de agosto de 1994"
14,15,41,1313,419,426,845,"21 de agosto de 1994"
14,15,41,1314,326,349,675,"21 de agosto de 1994"
14,15,41,1315,514,606,1120,"21 de agosto de 1994"
14,15,41,1316,357,439,796,"21 de agosto de 1994"
14,15,41,1317,443,524,967,"21 de agosto de 1994"
14,15,41,1318,605,663,1268,"21 de agosto de 1994"
14,15,41,1319,636,736,1372,"21 de agosto de 1994"
14,15,41,1320,560,646,1206,"21 de agosto de 1994"
14,15,41,1321,488,527,1015,"21 de agosto de 1994"
14,15,41,1322,382,425,807,"21 de agosto de 1994"
14,15,41,1323,484,558,1042,"21 de agosto de 1994"
14,15,41,1324,491,501,992,"21 de agosto de 1994"
14,15,41,1325,370,425,795,"21 de agosto de 1994"
14,15,41,1326,363,424,787,"21 de agosto de 1994"
14,15,41,1327,700,800,1500,"21 de agosto de 1994"
14,15,41,1328,623,683,1306,"21 de agosto de 1994"
14,15,41,1329,336,376,712,"21 de agosto de 1994"
14,15,41,1330,673,757,1430,"21 de agosto de 1994"
14,15,41,1331,741,828,1569,"21 de agosto de 1994"
14,15,41,1332,724,787,1511,"21 de agosto de 1994"
14,15,41,1333,743,842,1585,"21 de agosto de 1994"
14,15,41,1334,455,438,893,"21 de agosto de 1994"
14,15,41,1335,423,484,907,"21 de agosto de 1994"
14,15,41,1336,750,793,1543,"21 de agosto de 1994"
14,15,41,1337,494,588,1082,"21 de agosto de 1994"
14,15,41,1338,463,543,1006,"21 de agosto de 1994"
14,15,41,1339,537,590,1127,"21 de agosto de 1994"
14,15,41,1340,673,790,1463,"21 de agosto de 1994"
14,15,41,1341,520,683,1203,"21 de agosto de 1994"
14,15,41,1342,613,702,1315,"21 de agosto de 1994"
14,15,41,1343,601,723,1324,"21 de agosto de 1994"
14,15,41,1344,564,624,1188,"21 de agosto de 1994"
14,15,41,1345,630,746,1376,"21 de agosto de 1994"
14,15,41,1346,621,692,1313,"21 de agosto de 1994"
14,15,41,1347,746,834,1580,"21 de agosto de 1994"
14,15,41,1348,516,616,1132,"21 de agosto de 1994"
14,15,41,1349,556,628,1184,"21 de agosto de 1994"
14,15,41,1350,390,465,855,"21 de agosto de 1994"
14,15,41,1351,491,601,1092,"21 de agosto de 1994"
14,15,41,1352,414,544,958,"21 de agosto de 1994"
14,15,41,1353,586,711,1297,"21 de agosto de 1994"
14,15,41,1354,348,414,762,"21 de agosto de 1994"
14,15,41,1355,516,587,1103,"21 de agosto de 1994"
14,15,41,1356,465,574,1039,"21 de agosto de 1994"
14,15,41,1357,584,720,1304,"21 de agosto de 1994"
14,15,41,1358,595,749,1344,"21 de agosto de 1994"
14,15,41,1359,441,576,1017,"21 de agosto de 1994"
14,15,41,1360,505,684,1189,"21 de agosto de 1994"
14,15,41,1361,507,718,1225,"21 de agosto de 1994"
14,15,41,1362,373,437,810,"21 de agosto de 1994"
14,15,41,1363,377,435,812,"21 de agosto de 1994"
14,15,41,1364,560,642,1202,"21 de agosto de 1994"
14,15,41,1365,601,667,1268,"21 de agosto de 1994"
14,15,41,1366,407,491,898,"21 de agosto de 1994"
14,15,41,1367,570,607,1177,"21 de agosto de 1994"
14,15,41,1368,316,395,711,"21 de agosto de 1994"
14,15,41,1369,338,366,704,"21 de agosto de 1994"
14,15,41,1370,373,444,817,"21 de agosto de 1994"
14,15,41,1371,684,728,1412,"21 de agosto de 1994"
14,15,41,1372,444,508,952,"21 de agosto de 1994"
14,15,41,1373,579,684,1263,"21 de agosto de 1994"
14,16,41,1374,376,413,789,"21 de agosto de 1994"
14,16,41,1375,343,399,742,"21 de agosto de 1994"
14,16,41,1376,476,576,1052,"21 de agosto de 1994"
14,16,41,1377,457,542,999,"21 de agosto de 1994"
14,16,41,1378,675,766,1441,"21 de agosto de 1994"
14,16,41,1379,660,727,1387,"21 de agosto de 1994"
14,16,41,1380,317,347,664,"21 de agosto de 1994"
14,16,41,1381,411,439,850,"21 de agosto de 1994"
14,16,41,1382,431,473,904,"21 de agosto de 1994"
14,16,41,1383,340,436,776,"21 de agosto de 1994"
14,16,41,1384,366,401,767,"21 de agosto de 1994"
14,16,41,1385,709,816,1525,"21 de agosto de 1994"
14,16,41,1386,423,473,896,"21 de agosto de 1994"
14,16,41,1387,701,831,1532,"21 de agosto de 1994"
14,16,41,1388,362,429,791,"21 de agosto de 1994"
14,16,41,1389,714,818,1532,"21 de agosto de 1994"
14,16,41,1390,395,477,872,"21 de agosto de 1994"
14,16,41,1391,401,490,891,"21 de agosto de 1994"
14,16,41,1392,373,400,773,"21 de agosto de 1994"
14,16,41,1393,470,476,946,"21 de agosto de 1994"
14,16,41,1394,448,499,947,"21 de agosto de 1994"
14,16,41,1395,583,634,1217,"21 de agosto de 1994"
14,16,41,1396,466,500,966,"21 de agosto de 1994"
14,16,41,1397,778,902,1680,"21 de agosto de 1994"
14,16,41,1398,320,368,688,"21 de agosto de 1994"
14,16,41,1399,571,613,1184,"21 de agosto de 1994"
14,16,41,1400,575,704,1279,"21 de agosto de 1994"
14,16,41,1401,638,689,1327,"21 de agosto de 1994"
14,16,41,1402,540,662,1202,"21 de agosto de 1994"
14,16,41,1403,686,805,1491,"21 de agosto de 1994"
14,16,41,1404,450,494,944,"21 de agosto de 1994"
14,16,41,1405,541,577,1118,"21 de agosto de 1994"
14,16,41,1406,405,459,864,"21 de agosto de 1994"
14,16,41,1407,483,577,1060,"21 de agosto de 1994"
14,16,41,1408,559,665,1224,"21 de agosto de 1994"
14,16,41,1409,490,592,1082,"21 de agosto de 1994"
14,16,41,1410,438,467,905,"21 de agosto de 1994"
14,16,41,1411,542,608,1150,"21 de agosto de 1994"
14,16,41,1412,477,545,1022,"21 de agosto de 1994"
14,16,41,1413,660,691,1351,"21 de agosto de 1994"
14,16,41,1414,452,492,944,"21 de agosto de 1994"
14,16,41,1415,550,591,1141,"21 de agosto de 1994"
14,16,41,1416,683,806,1489,"21 de agosto de 1994"
14,16,41,1417,674,742,1416,"21 de agosto de 1994"
14,16,41,1418,505,500,1005,"21 de agosto de 1994"
14,16,41,1419,432,442,874,"21 de agosto de 1994"
14,16,41,1420,456,471,927,"21 de agosto de 1994"
14,16,41,1421,447,479,926,"21 de agosto de 1994"
14,16,41,1422,397,434,831,"21 de agosto de 1994"
14,16,41,1423,419,500,919,"21 de agosto de 1994"
14,16,41,1424,527,556,1083,"21 de agosto de 1994"
14,16,41,1425,392,444,836,"21 de agosto de 1994"
14,16,41,1426,406,447,853,"21 de agosto de 1994"
14,16,41,1427,470,555,1025,"21 de agosto de 1994"
14,16,41,1428,510,552,1062,"21 de agosto de 1994"
14,16,41,1429,368,470,838,"21 de agosto de 1994"
14,16,41,1430,403,422,825,"21 de agosto de 1994"
14,16,41,1431,574,652,1226,"21 de agosto de 1994"
14,16,41,1432,308,378,686,"21 de agosto de 1994"
14,16,41,1433,393,418,811,"21 de agosto de 1994"
14,16,41,1434,437,524,961,"21 de agosto de 1994"
14,16,41,1435,576,629,1205,"21 de agosto de 1994"
14,16,41,1436,602,709,1311,"21 de agosto de 1994"
14,16,41,1437,365,434,799,"21 de agosto de 1994"
14,16,41,1438,314,394,708,"21 de agosto de 1994"
14,16,41,1439,350,414,764,"21 de agosto de 1994"
14,16,41,1440,430,506,936,"21 de agosto de 1994"
14,16,41,1441,411,492,903,"21 de agosto de 1994"
14,16,41,1442,375,430,805,"21 de agosto de 1994"
14,16,41,1443,254,331,585,"21 de agosto de 1994"
14,16,41,1444,337,394,731,"21 de agosto de 1994"
14,16,41,1445,319,346,665,"21 de agosto de 1994"
14,16,41,1446,411,459,870,"21 de agosto de 1994"
14,16,41,1447,498,545,1043,"21 de agosto de 1994"
14,16,41,1448,743,813,1556,"21 de agosto de 1994"
14,16,41,1449,519,674,1193,"21 de agosto de 1994"
14,16,41,1450,677,799,1476,"21 de agosto de 1994"
14,16,41,1451,578,656,1234,"21 de agosto de 1994"
14,16,41,1452,565,688,1253,"21 de agosto de 1994"
14,16,41,1453,662,770,1432,"21 de agosto de 1994"
14,16,41,1454,654,774,1428,"21 de agosto de 1994"
14,16,41,1455,638,733,1371,"21 de agosto de 1994"
14,16,41,1456,499,608,1107,"21 de agosto de 1994"
14,16,41,1457,454,567,1021,"21 de agosto de 1994"
14,16,41,1458,515,567,1082,"21 de agosto de 1994"
14,16,41,1459,695,790,1485,"21 de agosto de 1994"
14,16,41,1460,364,382,746,"21 de agosto de 1994"
14,16,41,1461,439,464,903,"21 de agosto de 1994"
14,16,41,1462,364,388,752,"21 de agosto de 1994"
14,16,41,1463,417,444,861,"21 de agosto de 1994"
14,16,41,1464,431,485,916,"21 de agosto de 1994"
14,16,41,1465,534,602,1136,"21 de agosto de 1994"
14,16,41,1466,511,553,1064,"21 de agosto de 1994"
14,16,41,1467,476,536,1012,"21 de agosto de 1994"
14,16,41,1468,422,476,898,"21 de agosto de 1994"
14,16,41,1469,434,480,914,"21 de agosto de 1994"
14,16,41,1470,454,496,950,"21 de agosto de 1994"
14,16,41,1471,467,509,976,"21 de agosto de 1994"
14,16,41,1472,456,495,951,"21 de agosto de 1994"
14,16,41,1473,373,455,828,"21 de agosto de 1994"
14,16,41,1474,323,344,667,"21 de agosto de 1994"
14,16,41,1475,515,589,1104,"21 de agosto de 1994"
14,16,41,1476,537,587,1124,"21 de agosto de 1994"
14,16,41,1477,432,482,914,"21 de agosto de 1994"
14,16,41,1478,379,426,805,"21 de agosto de 1994"
14,16,41,1479,391,406,797,"21 de agosto de 1994"
14,16,41,1480,368,413,781,"21 de agosto de 1994"
14,16,41,1481,483,481,964,"21 de agosto de 1994"
14,16,41,1482,489,543,1032,"21 de agosto de 1994"
14,16,41,1483,582,595,1177,"21 de agosto de 1994"
14,16,41,1484,371,440,811,"21 de agosto de 1994"
14,16,41,1485,277,348,625,"21 de agosto de 1994"
14,16,41,1486,271,304,575,"21 de agosto de 1994"
14,16,41,1487,367,426,793,"21 de agosto de 1994"
14,16,41,1488,319,364,683,"21 de agosto de 1994"
14,16,41,1489,280,339,619,"21 de agosto de 1994"
14,16,41,1490,346,407,753,"21 de agosto de 1994"
14,16,41,1491,332,435,767,"21 de agosto de 1994"
14,16,41,1492,464,556,1020,"21 de agosto de 1994"
14,16,41,1493,410,510,920,"21 de agosto de 1994"
14,16,41,1494,416,515,931,"21 de agosto de 1994"
14,16,41,1495,506,608,1114,"21 de agosto de 1994"
14,16,41,1496,342,357,699,"21 de agosto de 1994"
14,16,41,1497,472,581,1053,"21 de agosto de 1994"
14,16,41,1498,671,754,1425,"21 de agosto de 1994"
14,16,41,1499,565,722,1287,"21 de agosto de 1994"
14,16,41,1500,412,481,893,"21 de agosto de 1994"
14,16,41,1501,499,611,1110,"21 de agosto de 1994"
14,16,41,1502,447,591,1038,"21 de agosto de 1994"
14,16,41,1503,332,404,736,"21 de agosto de 1994"
14,16,41,1504,250,298,548,"21 de agosto de 1994"
14,16,41,1505,456,529,985,"21 de agosto de 1994"
14,16,41,1506,451,517,968,"21 de agosto de 1994"
14,16,41,1507,533,675,1208,"21 de agosto de 1994"
14,16,41,1508,365,444,809,"21 de agosto de 1994"
14,16,41,1509,495,556,1051,"21 de agosto de 1994"
14,16,41,1510,355,418,773,"21 de agosto de 1994"
14,16,41,1511,449,588,1037,"21 de agosto de 1994"
14,16,41,1512,364,461,825,"21 de agosto de 1994"
14,16,41,1513,454,524,978,"21 de agosto de 1994"
14,16,41,1514,654,746,1400,"21 de agosto de 1994"
14,16,41,1515,575,638,1213,"21 de agosto de 1994"
14,16,41,1516,472,554,1026,"21 de agosto de 1994"
14,16,41,1517,744,923,1667,"21 de agosto de 1994"
14,16,41,1518,548,637,1185,"21 de agosto de 1994"
14,16,41,1519,513,593,1106,"21 de agosto de 1994"
14,16,41,1520,487,614,1101,"21 de agosto de 1994"
14,16,41,1521,505,601,1106,"21 de agosto de 1994"
14,16,41,1522,371,450,821,"21 de agosto de 1994"
14,16,41,1523,471,666,1137,"21 de agosto de 1994"
14,16,41,1524,385,459,844,"21 de agosto de 1994"
14,16,41,1525,444,547,991,"21 de agosto de 1994"
14,16,41,1526,567,735,1302,"21 de agosto de 1994"
14,16,41,1527,289,337,626,"21 de agosto de 1994"
14,16,41,1528,342,366,708,"21 de agosto de 1994"
14,16,41,1529,317,383,700,"21 de agosto de 1994"
14,16,41,1530,331,361,692,"21 de agosto de 1994"
14,16,41,1531,367,459,826,"21 de agosto de 1994"
14,16,41,1532,271,330,601,"21 de agosto de 1994"
14,16,41,1533,267,320,587,"21 de agosto de 1994"
14,16,41,1534,662,871,1533,"21 de agosto de 1994"
14,16,41,1535,462,592,1054,"21 de agosto de 1994"
14,16,41,1536,385,435,820,"21 de agosto de 1994"
14,16,41,1537,396,468,864,"21 de agosto de 1994"
14,16,41,1538,520,608,1128,"21 de agosto de 1994"
14,16,41,1539,691,786,1477,"21 de agosto de 1994"
14,16,41,1540,327,401,728,"21 de agosto de 1994"
14,16,41,1541,397,465,862,"21 de agosto de 1994"
14,16,41,1542,495,572,1067,"21 de agosto de 1994"
14,16,41,1543,381,514,895,"21 de agosto de 1994"
14,16,41,1544,367,400,767,"21 de agosto de 1994"
14,16,41,1545,533,586,1119,"21 de agosto de 1994"
14,16,41,1546,354,422,776,"21 de agosto de 1994"
14,16,41,1547,381,483,864,"21 de agosto de 1994"
14,16,41,1548,330,420,750,"21 de agosto de 1994"
14,17,3,24,366,382,748,"21 de agosto de 1994"
14,17,3,25,419,453,872,"21 de agosto de 1994"
14,17,3,26,354,408,762,"21 de agosto de 1994"
14,17,3,27,365,352,717,"21 de agosto de 1994"
14,17,3,28,378,397,775,"21 de agosto de 1994"
14,17,3,29,538,632,1170,"21 de agosto de 1994"
14,17,3,30,320,345,665,"21 de agosto de 1994"
14,17,3,31,570,573,1143,"21 de agosto de 1994"
14,17,3,32,136,125,261,"21 de agosto de 1994"
14,17,3,33,387,416,803,"21 de agosto de 1994"
14,17,3,34,480,508,988,"21 de agosto de 1994"
14,17,3,35,439,386,825,"21 de agosto de 1994"
14,17,5,40,506,536,1042,"21 de agosto de 1994"
14,17,5,41,563,593,1156,"21 de agosto de 1994"
14,17,5,42,489,533,1022,"21 de agosto de 1994"
14,17,5,43,507,506,1013,"21 de agosto de 1994"
14,17,5,44,182,159,341,"21 de agosto de 1994"
14,17,5,45,187,173,360,"21 de agosto de 1994"
14,17,5,46,171,146,317,"21 de agosto de 1994"
14,17,5,47,252,238,490,"21 de agosto de 1994"
14,17,7,94,528,576,1104,"21 de agosto de 1994"
14,17,7,95,370,379,749,"21 de agosto de 1994"
14,17,7,96,338,343,681,"21 de agosto de 1994"
14,17,7,97,229,230,459,"21 de agosto de 1994"
14,17,7,98,172,178,350,"21 de agosto de 1994"
14,17,7,99,61,75,136,"21 de agosto de 1994"
14,17,7,100,180,166,346,"21 de agosto de 1994"
14,17,7,101,241,263,504,"21 de agosto de 1994"
14,17,9,139,724,825,1549,"21 de agosto de 1994"
14,17,9,140,680,694,1374,"21 de agosto de 1994"
14,17,9,141,686,712,1398,"21 de agosto de 1994"
14,17,9,142,505,477,982,"21 de agosto de 1994"
14,17,9,143,568,594,1162,"21 de agosto de 1994"
14,17,96,2418,524,617,1141,"21 de agosto de 1994"
14,17,96,2419,383,445,828,"21 de agosto de 1994"
14,17,96,2420,181,199,380,"21 de agosto de 1994"
14,17,96,2421,162,168,330,"21 de agosto de 1994"
14,17,96,2422,432,467,899,"21 de agosto de 1994"
14,17,96,2423,412,432,844,"21 de agosto de 1994"
14,17,120,2900,684,774,1458,"21 de agosto de 1994"
14,17,120,2901,411,458,869,"21 de agosto de 1994"
14,17,120,2902,832,944,1776,"21 de agosto de 1994"
14,17,120,2903,474,571,1045,"21 de agosto de 1994"
14,17,120,2904,466,505,971,"21 de agosto de 1994"
14,17,120,2905,553,609,1162,"21 de agosto de 1994"
14,17,120,2906,603,783,1386,"21 de agosto de 1994"
14,17,120,2907,552,624,1176,"21 de agosto de 1994"
14,17,120,2908,577,663,1240,"21 de agosto de 1994"
14,17,120,2909,446,497,943,"21 de agosto de 1994"
14,17,120,2910,445,465,910,"21 de agosto de 1994"
14,17,120,2911,662,782,1444,"21 de agosto de 1994"
14,17,120,2912,475,548,1023,"21 de agosto de 1994"
14,17,120,2913,601,717,1318,"21 de agosto de 1994"
14,17,120,2914,676,782,1458,"21 de agosto de 1994"
14,17,120,2915,455,507,962,"21 de agosto de 1994"
14,17,120,2916,384,483,867,"21 de agosto de 1994"
14,17,120,2917,635,679,1314,"21 de agosto de 1994"
14,17,120,2918,587,657,1244,"21 de agosto de 1994"
14,17,120,2919,440,518,958,"21 de agosto de 1994"
14,17,120,2920,439,508,947,"21 de agosto de 1994"
14,17,120,2921,610,617,1227,"21 de agosto de 1994"
14,17,120,2922,509,620,1129,"21 de agosto de 1994"
14,17,120,2923,591,675,1266,"21 de agosto de 1994"
14,17,120,2924,467,536,1003,"21 de agosto de 1994"
14,17,120,2925,373,476,849,"21 de agosto de 1994"
14,17,120,2926,486,619,1105,"21 de agosto de 1994"
14,17,120,2927,366,436,802,"21 de agosto de 1994"
14,17,120,2928,451,545,996,"21 de agosto de 1994"
14,17,120,2929,373,457,830,"21 de agosto de 1994"
14,17,120,2930,685,759,1444,"21 de agosto de 1994"
14,17,120,2931,685,800,1485,"21 de agosto de 1994"
14,17,120,2932,618,700,1318,"21 de agosto de 1994"
14,17,120,2933,644,748,1392,"21 de agosto de 1994"
14,17,120,2934,567,647,1214,"21 de agosto de 1994"
14,17,120,2935,515,646,1161,"21 de agosto de 1994"
14,17,120,2936,342,445,787,"21 de agosto de 1994"
14,17,120,2937,353,434,787,"21 de agosto de 1994"
14,17,120,2938,642,744,1386,"21 de agosto de 1994"
14,17,120,2939,603,682,1285,"21 de agosto de 1994"
14,17,120,2940,574,664,1238,"21 de agosto de 1994"
14,17,120,2941,515,591,1106,"21 de agosto de 1994"
14,17,120,2942,652,748,1400,"21 de agosto de 1994"
14,17,120,2943,599,634,1233,"21 de agosto de 1994"
14,17,120,2944,261,311,572,"21 de agosto de 1994"
14,17,120,2945,510,623,1133,"21 de agosto de 1994"
14,17,120,2946,680,735,1415,"21 de agosto de 1994"
14,17,120,2947,445,547,992,"21 de agosto de 1994"
14,17,120,2948,713,737,1450,"21 de agosto de 1994"
14,17,120,2949,597,695,1292,"21 de agosto de 1994"
14,17,120,2950,617,716,1333,"21 de agosto de 1994"
14,17,120,2951,546,584,1130,"21 de agosto de 1994"
14,17,120,2952,539,588,1127,"21 de agosto de 1994"
14,17,120,2953,720,846,1566,"21 de agosto de 1994"
14,17,120,2954,724,869,1593,"21 de agosto de 1994"
14,17,120,2955,690,769,1459,"21 de agosto de 1994"
14,17,120,2956,648,729,1377,"21 de agosto de 1994"
14,17,120,2957,433,477,910,"21 de agosto de 1994"
14,17,120,2958,456,521,977,"21 de agosto de 1994"
14,17,120,2959,472,553,1025,"21 de agosto de 1994"
14,17,120,2960,681,726,1407,"21 de agosto de 1994"
14,17,120,2961,643,744,1387,"21 de agosto de 1994"
14,17,120,2962,546,588,1134,"21 de agosto de 1994"
14,17,120,2963,307,373,680,"21 de agosto de 1994"
14,17,120,2964,442,493,935,"21 de agosto de 1994"
14,17,120,2965,666,684,1350,"21 de agosto de 1994"
14,17,120,2966,1042,1253,2295,"21 de agosto de 1994"
14,17,120,2967,512,628,1140,"21 de agosto de 1994"
14,17,120,2968,621,703,1324,"21 de agosto de 1994"
14,17,120,2969,662,774,1436,"21 de agosto de 1994"
14,17,120,2970,506,611,1117,"21 de agosto de 1994"
14,17,120,2971,400,482,882,"21 de agosto de 1994"
14,17,120,2972,565,710,1275,"21 de agosto de 1994"
14,17,120,2973,498,598,1096,"21 de agosto de 1994"
14,17,120,2974,483,544,1027,"21 de agosto de 1994"
14,17,120,2975,417,464,881,"21 de agosto de 1994"
14,17,120,2976,511,584,1095,"21 de agosto de 1994"
14,17,120,2977,453,536,989,"21 de agosto de 1994"
14,17,120,2978,442,538,980,"21 de agosto de 1994"
14,17,120,2979,610,695,1305,"21 de agosto de 1994"
14,17,120,2980,572,678,1250,"21 de agosto de 1994"
14,17,120,2981,648,716,1364,"21 de agosto de 1994"
14,17,120,2982,502,549,1051,"21 de agosto de 1994"
14,17,120,2983,619,677,1296,"21 de agosto de 1994"
14,17,120,2984,582,651,1233,"21 de agosto de 1994"
14,17,120,2985,813,888,1701,"21 de agosto de 1994"
14,17,120,2986,828,943,1771,"21 de agosto de 1994"
14,17,120,2987,740,833,1573,"21 de agosto de 1994"
14,17,120,2988,742,881,1623,"21 de agosto de 1994"
14,17,120,2989,520,576,1096,"21 de agosto de 1994"
14,17,120,2990,599,657,1256,"21 de agosto de 1994"
14,17,120,2991,510,554,1064,"21 de agosto de 1994"
14,17,120,2992,435,547,982,"21 de agosto de 1994"
14,17,120,2993,780,904,1684,"21 de agosto de 1994"
14,17,120,2994,726,807,1533,"21 de agosto de 1994"
14,17,120,2995,689,763,1452,"21 de agosto de 1994"
14,17,120,2996,641,743,1384,"21 de agosto de 1994"
14,17,120,2997,507,567,1074,"21 de agosto de 1994"
14,17,120,2998,561,635,1196,"21 de agosto de 1994"
14,17,120,2999,613,674,1287,"21 de agosto de 1994"
14,17,120,3000,735,807,1542,"21 de agosto de 1994"
14,17,120,3001,593,650,1243,"21 de agosto de 1994"
14,17,120,3002,855,949,1804,"21 de agosto de 1994"
14,17,120,3003,792,861,1653,"21 de agosto de 1994"
14,17,120,3004,840,967,1807,"21 de agosto de 1994"
14,17,120,3005,731,755,1486,"21 de agosto de 1994"
14,17,120,3006,935,1037,1972,"21 de agosto de 1994"
14,17,120,3007,807,863,1670,"21 de agosto de 1994"
14,17,120,3008,699,728,1427,"21 de agosto de 1994"
14,17,120,3009,398,436,834,"21 de agosto de 1994"
14,17,120,3010,394,439,833,"21 de agosto de 1994"
14,17,120,3011,683,696,1379,"21 de agosto de 1994"
14,17,120,3012,443,453,896,"21 de agosto de 1994"
14,17,120,3013,718,763,1481,"21 de agosto de 1994"
14,17,120,3014,384,427,811,"21 de agosto de 1994"
14,17,120,3015,440,479,919,"21 de agosto de 1994"
14,17,120,3016,499,511,1010,"21 de agosto de 1994"
14,17,120,3017,607,615,1222,"21 de agosto de 1994"
14,17,120,3018,874,914,1788,"21 de agosto de 1994"
14,17,120,3019,710,757,1467,"21 de agosto de 1994"
14,17,120,3020,699,722,1421,"21 de agosto de 1994"
14,17,120,3021,623,628,1251,"21 de agosto de 1994"
14,17,120,3022,491,587,1078,"21 de agosto de 1994"
14,17,120,3023,735,802,1537,"21 de agosto de 1994"
14,17,120,3024,1041,1095,2136,"21 de agosto de 1994"
14,17,120,3025,129,92,221,"21 de agosto de 1994"
14,17,120,3026,170,171,341,"21 de agosto de 1994"
14,17,120,3027,287,296,583,"21 de agosto de 1994"
14,17,120,3028,481,481,962,"21 de agosto de 1994"
14,17,120,3029,240,249,489,"21 de agosto de 1994"
14,17,120,3030,424,426,850,"21 de agosto de 1994"
14,18,72,2024,592,618,1210,"21 de agosto de 1994"
14,18,72,2025,841,847,1688,"21 de agosto de 1994"
14,18,72,2026,388,389,777,"21 de agosto de 1994"
14,18,72,2027,541,548,1089,"21 de agosto de 1994"
14,18,72,2028,517,534,1051,"21 de agosto de 1994"
14,18,72,2029,454,479,933,"21 de agosto de 1994"
14,18,72,2030,623,654,1277,"21 de agosto de 1994"
14,18,72,2031,508,543,1051,"21 de agosto de 1994"
14,18,72,2032,448,463,911,"21 de agosto de 1994"
14,18,72,2033,722,787,1509,"21 de agosto de 1994"
14,18,72,2034,500,513,1013,"21 de agosto de 1994"
14,18,72,2035,683,696,1379,"21 de agosto de 1994"
14,18,72,2036,491,541,1032,"21 de agosto de 1994"
14,18,72,2037,404,442,846,"21 de agosto de 1994"
14,18,72,2038,699,749,1448,"21 de agosto de 1994"
14,18,72,2039,530,557,1087,"21 de agosto de 1994"
14,18,72,2040,523,540,1063,"21 de agosto de 1994"
14,18,72,2041,262,267,529,"21 de agosto de 1994"
14,18,72,2042,172,207,379,"21 de agosto de 1994"
14,18,72,2043,829,891,1720,"21 de agosto de 1994"
14,18,72,2044,590,605,1195,"21 de agosto de 1994"
14,18,72,2045,621,606,1227,"21 de agosto de 1994"
14,18,72,2046,627,627,1254,"21 de agosto de 1994"
14,18,72,2047,73,88,161,"21 de agosto de 1994"
14,18,72,2048,204,179,383,"21 de agosto de 1994"
14,18,72,2049,667,661,1328,"21 de agosto de 1994"
14,18,99,2473,572,741,1313,"21 de agosto de 1994"
14,18,99,2474,448,549,997,"21 de agosto de 1994"
14,18,99,2475,423,471,894,"21 de agosto de 1994"
14,18,99,2476,398,466,864,"21 de agosto de 1994"
14,18,99,2477,579,670,1249,"21 de agosto de 1994"
14,18,99,2478,416,488,904,"21 de agosto de 1994"
14,18,99,2479,387,462,849,"21 de agosto de 1994"
14,18,99,2480,377,439,816,"21 de agosto de 1994"
14,18,99,2481,366,395,761,"21 de agosto de 1994"
14,18,99,2482,715,824,1539,"21 de agosto de 1994"
14,18,99,2483,568,624,1192,"21 de agosto de 1994"
14,18,99,2484,473,538,1011,"21 de agosto de 1994"
14,18,99,2485,379,454,833,"21 de agosto de 1994"
14,18,99,2486,542,607,1149,"21 de agosto de 1994"
14,18,99,2487,732,792,1524,"21 de agosto de 1994"
14,18,99,2488,616,708,1324,"21 de agosto de 1994"
14,18,99,2489,386,464,850,"21 de agosto de 1994"
14,18,99,2490,521,599,1120,"21 de agosto de 1994"
14,18,99,2491,779,855,1634,"21 de agosto de 1994"
14,18,99,2492,374,389,763,"21 de agosto de 1994"
14,18,99,2493,188,207,395,"21 de agosto de 1994"
14,18,99,2494,237,300,537,"21 de agosto de 1994"
14,18,99,2495,362,394,756,"21 de agosto de 1994"
14,18,99,2496,376,429,805,"21 de agosto de 1994"
14,18,99,2497,572,663,1235,"21 de agosto de 1994"
14,18,99,2498,402,456,858,"21 de agosto de 1994"
14,18,99,2499,340,404,744,"21 de agosto de 1994"
14,18,99,2500,513,611,1124,"21 de agosto de 1994"
14,18,99,2501,486,540,1026,"21 de agosto de 1994"
14,18,99,2502,431,451,882,"21 de agosto de 1994"
14,18,99,2503,482,577,1059,"21 de agosto de 1994"
14,18,99,2504,525,623,1148,"21 de agosto de 1994"
14,18,99,2505,460,487,947,"21 de agosto de 1994"
14,18,99,2506,470,545,1015,"21 de agosto de 1994"
14,18,99,2507,483,541,1024,"21 de agosto de 1994"
14,18,99,2508,374,437,811,"21 de agosto de 1994"
14,18,99,2509,441,474,915,"21 de agosto de 1994"
14,18,99,2510,587,659,1246,"21 de agosto de 1994"
14,18,99,2511,419,477,896,"21 de agosto de 1994"
14,18,99,2512,665,815,1480,"21 de agosto de 1994"
14,18,99,2513,635,659,1294,"21 de agosto de 1994"
14,18,99,2514,286,342,628,"21 de agosto de 1994"
14,18,99,2515,415,432,847,"21 de agosto de 1994"
14,18,99,2516,407,484,891,"21 de agosto de 1994"
14,18,99,2517,422,435,857,"21 de agosto de 1994"
14,18,99,2518,525,603,1128,"21 de agosto de 1994"
14,18,99,2519,513,563,1076,"21 de agosto de 1994"
14,18,99,2520,560,577,1137,"21 de agosto de 1994"
14,18,99,2521,363,447,810,"21 de agosto de 1994"
14,18,99,2522,416,479,895,"21 de agosto de 1994"
14,18,99,2523,641,669,1310,"21 de agosto de 1994"
14,18,99,2524,517,603,1120,"21 de agosto de 1994"
14,18,99,2525,196,240,436,"21 de agosto de 1994"
14,18,99,2526,725,808,1533,"21 de agosto de 1994"
14,18,99,2527,390,445,835,"21 de agosto de 1994"
14,18,99,2528,471,492,963,"21 de agosto de 1994"
14,18,99,2529,423,466,889,"21 de agosto de 1994"
14,18,99,2530,1058,1126,2184,"21 de agosto de 1994"
14,18,99,2531,592,675,1267,"21 de agosto de 1994"
14,18,99,2532,470,553,1023,"21 de agosto de 1994"
14,18,99,2533,406,462,868,"21 de agosto de 1994"
14,18,99,2534,582,688,1270,"21 de agosto de 1994"
14,18,99,2535,335,369,704,"21 de agosto de 1994"
14,18,99,2536,399,443,842,"21 de agosto de 1994"
14,18,99,2537,243,289,532,"21 de agosto de 1994"
14,18,99,2538,497,545,1042,"21 de agosto de 1994"
14,18,99,2539,443,494,937,"21 de agosto de 1994"
14,18,99,2540,738,835,1573,"21 de agosto de 1994"
14,18,99,2541,688,755,1443,"21 de agosto de 1994"
14,18,99,2542,629,689,1318,"21 de agosto de 1994"
14,18,99,2543,465,493,958,"21 de agosto de 1994"
14,18,99,2544,325,383,708,"21 de agosto de 1994"
14,18,99,2545,753,822,1575,"21 de agosto de 1994"
14,18,99,2546,526,550,1076,"21 de agosto de 1994"
14,18,99,2547,479,542,1021,"21 de agosto de 1994"
14,18,99,2548,609,703,1312,"21 de agosto de 1994"
14,18,99,2549,453,500,953,"21 de agosto de 1994"
14,18,99,2550,661,691,1352,"21 de agosto de 1994"
14,18,99,2551,697,719,1416,"21 de agosto de 1994"
14,18,99,2552,810,897,1707,"21 de agosto de 1994"
14,18,99,2553,819,843,1662,"21 de agosto de 1994"
14,18,99,2554,673,762,1435,"21 de agosto de 1994"
14,18,99,2555,425,471,896,"21 de agosto de 1994"
14,18,99,2556,736,773,1509,"21 de agosto de 1994"
14,18,99,2557,545,569,1114,"21 de agosto de 1994"
14,18,99,2558,592,638,1230,"21 de agosto de 1994"
14,18,99,2559,638,681,1319,"21 de agosto de 1994"
14,18,99,2560,448,456,904,"21 de agosto de 1994"
14,18,99,2561,497,489,986,"21 de agosto de 1994"
14,18,99,2562,847,946,1793,"21 de agosto de 1994"
14,18,99,2563,672,727,1399,"21 de agosto de 1994"
14,18,99,2564,683,687,1370,"21 de agosto de 1994"
14,18,99,2565,636,656,1292,"21 de agosto de 1994"
14,18,99,2566,718,703,1421,"21 de agosto de 1994"
14,18,99,2567,541,601,1142,"21 de agosto de 1994"
14,18,99,2568,695,792,1487,"21 de agosto de 1994"
14,18,99,2569,717,717,1434,"21 de agosto de 1994"
14,18,99,2570,591,600,1191,"21 de agosto de 1994"
14,18,99,2571,405,416,821,"21 de agosto de 1994"
14,18,99,2572,371,422,793,"21 de agosto de 1994"
14,18,99,2573,368,420,788,"21 de agosto de 1994"
14,18,99,2574,510,544,1054,"21 de agosto de 1994"
14,18,99,2575,418,474,892,"21 de agosto de 1994"
14,18,99,2576,957,1031,1988,"21 de agosto de 1994"
14,18,99,2577,829,881,1710,"21 de agosto de 1994"
14,18,99,2578,855,1021,1876,"21 de agosto de 1994"
14,18,99,2579,458,544,1002,"21 de agosto de 1994"
14,18,99,2580,349,423,772,"21 de agosto de 1994"
14,18,99,2581,351,433,784,"21 de agosto de 1994"
14,18,99,2582,667,727,1394,"21 de agosto de 1994"
14,18,99,2583,706,818,1524,"21 de agosto de 1994"
14,18,99,2584,730,762,1492,"21 de agosto de 1994"
14,18,99,2585,730,800,1530,"21 de agosto de 1994"
14,18,99,2586,660,692,1352,"21 de agosto de 1994"
14,18,99,2587,736,793,1529,"21 de agosto de 1994"
14,18,99,2588,873,954,1827,"21 de agosto de 1994"
14,18,99,2589,506,553,1059,"21 de agosto de 1994"
14,18,99,2590,632,641,1273,"21 de agosto de 1994"
14,18,99,2591,641,678,1319,"21 de agosto de 1994"
14,18,99,2592,702,775,1477,"21 de agosto de 1994"
14,18,99,2593,734,788,1522,"21 de agosto de 1994"
14,18,99,2594,562,629,1191,"21 de agosto de 1994"
14,18,99,2595,549,642,1191,"21 de agosto de 1994"
14,18,99,2596,743,776,1519,"21 de agosto de 1994"
14,18,99,2597,521,526,1047,"21 de agosto de 1994"
14,18,99,2598,489,522,1011,"21 de agosto de 1994"
14,18,99,2599,439,456,895,"21 de agosto de 1994"
14,18,99,2600,408,431,839,"21 de agosto de 1994"
14,18,99,2601,805,949,1754,"21 de agosto de 1994"
14,18,99,2602,759,895,1654,"21 de agosto de 1994"
14,18,99,2603,635,650,1285,"21 de agosto de 1994"
14,18,99,2604,944,1047,1991,"21 de agosto de 1994"
14,18,99,2605,512,581,1093,"21 de agosto de 1994"
14,18,99,2606,627,719,1346,"21 de agosto de 1994"
14,18,99,2607,686,724,1410,"21 de agosto de 1994"
14,18,99,2608,279,317,596,"21 de agosto de 1994"
14,18,99,2609,491,560,1051,"21 de agosto de 1994"
14,18,99,2610,362,408,770,"21 de agosto de 1994"
14,18,99,2611,532,609,1141,"21 de agosto de 1994"
14,18,99,2612,474,521,995,"21 de agosto de 1994"
14,18,99,2613,374,385,759,"21 de agosto de 1994"
14,18,99,2614,445,472,917,"21 de agosto de 1994"
14,18,99,2615,503,508,1011,"21 de agosto de 1994"
14,18,99,2616,452,489,941,"21 de agosto de 1994"
14,18,99,2617,202,209,411,"21 de agosto de 1994"
14,18,99,2618,377,438,815,"21 de agosto de 1994"
14,18,99,2619,580,613,1193,"21 de agosto de 1994"
14,18,99,2620,372,447,819,"21 de agosto de 1994"
14,18,99,2621,504,599,1103,"21 de agosto de 1994"
14,18,99,2622,469,571,1040,"21 de agosto de 1994"
14,18,99,2623,495,560,1055,"21 de agosto de 1994"
14,18,99,2624,890,956,1846,"21 de agosto de 1994"
14,18,102,2650,856,968,1824,"21 de agosto de 1994"
14,18,102,2651,913,1017,1930,"21 de agosto de 1994"
14,18,102,2652,719,857,1576,"21 de agosto de 1994"
14,18,102,2653,468,521,989,"21 de agosto de 1994"
14,18,102,2654,388,453,841,"21 de agosto de 1994"
14,18,102,2655,724,810,1534,"21 de agosto de 1994"
14,18,102,2656,799,901,1700,"21 de agosto de 1994"
14,18,102,2657,615,644,1259,"21 de agosto de 1994"
14,18,102,2658,409,452,861,"21 de agosto de 1994"
14,18,102,2659,484,548,1032,"21 de agosto de 1994"
14,18,102,2660,463,557,1020,"21 de agosto de 1994"
14,18,102,2661,553,605,1158,"21 de agosto de 1994"
14,18,102,2662,790,903,1693,"21 de agosto de 1994"
14,18,102,2663,526,582,1108,"21 de agosto de 1994"
14,18,102,2664,521,595,1116,"21 de agosto de 1994"
14,18,102,2665,662,743,1405,"21 de agosto de 1994"
14,18,102,2666,612,670,1282,"21 de agosto de 1994"
14,18,102,2667,514,571,1085,"21 de agosto de 1994"
14,18,102,2668,461,531,992,"21 de agosto de 1994"
14,18,102,2669,477,527,1004,"21 de agosto de 1994"
14,18,102,2670,791,877,1668,"21 de agosto de 1994"
14,18,102,2671,763,811,1574,"21 de agosto de 1994"
14,18,102,2672,514,554,1068,"21 de agosto de 1994"
14,18,102,2673,457,536,993,"21 de agosto de 1994"
14,18,102,2674,569,667,1236,"21 de agosto de 1994"
14,18,102,2675,259,262,521,"21 de agosto de 1994"
14,18,102,2676,929,977,1906,"21 de agosto de 1994"
14,18,102,2677,300,347,647,"21 de agosto de 1994"
14,18,102,2678,540,627,1167,"21 de agosto de 1994"
14,18,102,2679,278,304,582,"21 de agosto de 1994"
14,18,102,2680,311,348,659,"21 de agosto de 1994"
14,18,102,2681,730,832,1562,"21 de agosto de 1994"
14,18,102,2682,570,667,1237,"21 de agosto de 1994"
14,18,102,2683,510,533,1043,"21 de agosto de 1994"
14,18,102,2684,804,829,1633,"21 de agosto de 1994"
14,18,102,2685,647,669,1316,"21 de agosto de 1994"
14,18,102,2686,619,671,1290,"21 de agosto de 1994"
14,18,102,2687,748,868,1616,"21 de agosto de 1994"
14,18,102,2688,313,360,673,"21 de agosto de 1994"
14,18,102,2689,295,335,630,"21 de agosto de 1994"
14,18,102,2690,346,336,682,"21 de agosto de 1994"
14,18,102,2691,862,953,1815,"21 de agosto de 1994"
14,18,102,2692,586,643,1229,"21 de agosto de 1994"
14,18,102,2693,678,743,1421,"21 de agosto de 1994"
14,18,102,2694,537,612,1149,"21 de agosto de 1994"
14,18,102,2695,615,606,1221,"21 de agosto de 1994"
14,18,102,2696,391,470,861,"21 de agosto de 1994"
14,18,102,2697,805,939,1744,"21 de agosto de 1994"
14,18,102,2698,486,582,1068,"21 de agosto de 1994"
14,18,102,2699,380,455,835,"21 de agosto de 1994"
14,18,102,2700,438,597,1035,"21 de agosto de 1994"
14,18,102,2701,564,635,1199,"21 de agosto de 1994"
14,18,102,2702,887,989,1876,"21 de agosto de 1994"
14,18,102,2703,769,783,1552,"21 de agosto de 1994"
14,18,102,2704,524,575,1099,"21 de agosto de 1994"
14,18,102,2705,486,523,1009,"21 de agosto de 1994"
14,18,102,2706,397,446,843,"21 de agosto de 1994"
14,18,102,2707,1207,1424,2631,"21 de agosto de 1994"
14,18,102,2708,601,709,1310,"21 de agosto de 1994"
14,18,102,2709,724,921,1645,"21 de agosto de 1994"
14,18,102,2710,894,1063,1957,"21 de agosto de 1994"
14,18,102,2711,653,680,1333,"21 de agosto de 1994"
14,18,102,2712,704,749,1453,"21 de agosto de 1994"
14,18,102,2713,432,556,988,"21 de agosto de 1994"
14,18,102,2714,513,583,1096,"21 de agosto de 1994"
14,18,102,2715,444,582,1026,"21 de agosto de 1994"
14,18,102,2716,672,807,1479,"21 de agosto de 1994"
14,18,102,2717,730,780,1510,"21 de agosto de 1994"
14,18,102,2718,733,780,1513,"21 de agosto de 1994"
14,18,102,2719,410,494,904,"21 de agosto de 1994"
14,18,102,2720,375,433,808,"21 de agosto de 1994"
14,18,102,2721,777,803,1580,"21 de agosto de 1994"
14,18,102,2722,608,644,1252,"21 de agosto de 1994"
14,18,102,2723,539,550,1089,"21 de agosto de 1994"
14,18,102,2724,347,398,745,"21 de agosto de 1994"
14,18,102,2725,606,712,1318,"21 de agosto de 1994"
14,18,102,2726,365,392,757,"21 de agosto de 1994"
14,18,102,2727,550,561,1111,"21 de agosto de 1994"
14,18,102,2728,161,152,313,"21 de agosto de 1994"
14,18,102,2729,354,324,678,"21 de agosto de 1994"
14,19,27,427,352,385,737,"21 de agosto de 1994"
14,19,27,428,402,459,861,"21 de agosto de 1994"
14,19,27,429,377,421,798,"21 de agosto de 1994"
14,19,27,430,37,33,70,"21 de agosto de 1994"
14,19,27,431,180,175,355,"21 de agosto de 1994"
14,19,38,541,428,505,933,"21 de agosto de 1994"
14,19,38,542,413,411,824,"21 de agosto de 1994"
14,19,38,543,440,523,963,"21 de agosto de 1994"
14,19,38,544,316,400,716,"21 de agosto de 1994"
14,19,38,545,613,696,1309,"21 de agosto de 1994"
14,19,38,546,169,167,336,"21 de agosto de 1994"
14,19,38,547,82,77,159,"21 de agosto de 1994"
14,19,38,548,53,62,115,"21 de agosto de 1994"
14,19,51,1661,414,390,804,"21 de agosto de 1994"
14,19,51,1662,110,87,197,"21 de agosto de 1994"
14,19,51,1663,28,20,48,"21 de agosto de 1994"
14,19,51,1664,82,55,137,"21 de agosto de 1994"
14,19,51,1665,242,257,499,"21 de agosto de 1994"
14,19,51,1666,458,386,844,"21 de agosto de 1994"
14,19,51,1667,113,78,191,"21 de agosto de 1994"
14,19,51,1668,219,141,360,"21 de agosto de 1994"
14,19,51,1669,183,160,343,"21 de agosto de 1994"
14,19,51,1670,84,67,151,"21 de agosto de 1994"
14,19,58,1792,256,289,545,"21 de agosto de 1994"
14,19,58,1793,95,83,178,"21 de agosto de 1994"
14,19,58,1794,64,48,112,"21 de agosto de 1994"
14,19,58,1795,88,95,183,"21 de agosto de 1994"
14,19,58,1796,83,89,172,"21 de agosto de 1994"
14,19,59,1797,237,304,541,"21 de agosto de 1994"
14,19,59,1798,181,184,365,"21 de agosto de 1994"
14,19,59,1799,180,215,395,"21 de agosto de 1994"
14,19,59,1800,138,151,289,"21 de agosto de 1994"
14,19,59,1801,105,141,246,"21 de agosto de 1994"
14,19,61,1815,451,523,974,"21 de agosto de 1994"
14,19,61,1816,428,539,967,"21 de agosto de 1994"
14,19,61,1817,345,420,765,"21 de agosto de 1994"
14,19,61,1818,211,261,472,"21 de agosto de 1994"
14,19,61,1819,190,224,414,"21 de agosto de 1994"
14,19,61,1820,142,161,303,"21 de agosto de 1994"
14,19,61,1821,217,267,484,"21 de agosto de 1994"
14,19,61,1822,74,61,135,"21 de agosto de 1994"
14,19,61,1823,264,258,522,"21 de agosto de 1994"
14,19,67,1901,423,420,843,"21 de agosto de 1994"
14,19,67,1902,392,415,807,"21 de agosto de 1994"
14,19,67,1903,389,455,844,"21 de agosto de 1994"
14,19,67,1904,369,412,781,"21 de agosto de 1994"
14,19,67,1905,463,516,979,"21 de agosto de 1994"
14,19,67,1906,292,329,621,"21 de agosto de 1994"
14,19,67,1907,266,283,549,"21 de agosto de 1994"
14,19,67,1908,408,405,813,"21 de agosto de 1994"
14,19,67,1909,302,247,549,"21 de agosto de 1994"
14,19,67,1910,101,92,193,"21 de agosto de 1994"
14,19,67,1911,78,68,146,"21 de agosto de 1994"
14,19,67,1912,223,189,412,"21 de agosto de 1994"
14,19,67,1913,172,161,333,"21 de agosto de 1994"
14,19,71,2012,216,332,548,"21 de agosto de 1994"
14,19,71,2013,374,504,878,"21 de agosto de 1994"
14,19,71,2014,118,191,309,"21 de agosto de 1994"
14,19,71,2015,224,361,585,"21 de agosto de 1994"
14,19,71,2016,157,232,389,"21 de agosto de 1994"
14,19,71,2017,173,268,441,"21 de agosto de 1994"
14,19,71,2018,457,663,1120,"21 de agosto de 1994"
14,19,71,2019,124,188,312,"21 de agosto de 1994"
14,19,71,2020,51,63,114,"21 de agosto de 1994"
14,19,71,2021,117,164,281,"21 de agosto de 1994"
14,19,71,2022,112,116,228,"21 de agosto de 1994"
14,19,71,2023,188,200,388,"21 de agosto de 1994"
14,19,86,2223,377,398,775,"21 de agosto de 1994"
14,19,86,2224,310,362,672,"21 de agosto de 1994"
14,19,86,2225,274,321,595,"21 de agosto de 1994"
14,19,86,2226,432,478,910,"21 de agosto de 1994"
14,19,86,2227,389,468,857,"21 de agosto de 1994"
14,19,86,2228,410,472,882,"21 de agosto de 1994"
14,19,86,2229,242,274,516,"21 de agosto de 1994"
14,19,86,2230,172,227,399,"21 de agosto de 1994"
14,19,86,2231,275,349,624,"21 de agosto de 1994"
14,19,86,2232,343,432,775,"21 de agosto de 1994"
14,19,86,2233,203,247,450,"21 de agosto de 1994"
14,19,86,2234,487,602,1089,"21 de agosto de 1994"
14,19,86,2235,282,368,650,"21 de agosto de 1994"
14,19,86,2236,286,363,649,"21 de agosto de 1994"
14,19,86,2237,428,477,905,"21 de agosto de 1994"
14,19,86,2238,634,711,1345,"21 de agosto de 1994"
14,19,86,2239,340,367,707,"21 de agosto de 1994"
14,19,86,2240,51,43,94,"21 de agosto de 1994"
14,19,86,2241,91,95,186,"21 de agosto de 1994"
14,19,86,2242,36,28,64,"21 de agosto de 1994"
14,19,86,2243,174,206,380,"21 de agosto de 1994"
14,19,86,2244,550,720,1270,"21 de agosto de 1994"
14,19,86,2245,26,42,68,"21 de agosto de 1994"
14,19,86,2246,201,236,437,"21 de agosto de 1994"
14,19,86,2247,414,536,950,"21 de agosto de 1994"
14,19,86,2248,251,244,495,"21 de agosto de 1994"
14,19,86,2249,100,104,204,"21 de agosto de 1994"
14,19,86,2250,33,26,59,"21 de agosto de 1994"
14,19,86,2251,142,140,282,"21 de agosto de 1994"
14,19,86,2252,255,242,497,"21 de agosto de 1994"
14,19,86,2253,183,246,429,"21 de agosto de 1994"
14,19,86,2254,251,250,501,"21 de agosto de 1994"
14,19,86,2255,307,339,646,"21 de agosto de 1994"
14,19,86,2256,324,325,649,"21 de agosto de 1994"
14,19,86,2257,302,359,661,"21 de agosto de 1994"
14,19,86,2258,60,50,110,"21 de agosto de 1994"
14,19,86,2259,143,153,296,"21 de agosto de 1994"
14,19,88,2269,299,378,677,"21 de agosto de 1994"
14,19,88,2270,350,382,732,"21 de agosto de 1994"
14,19,88,2271,333,403,736,"21 de agosto de 1994"
14,19,88,2272,306,336,642,"21 de agosto de 1994"
14,19,88,2273,365,469,834,"21 de agosto de 1994"
14,19,88,2274,539,608,1147,"21 de agosto de 1994"
14,19,88,2275,588,639,1227,"21 de agosto de 1994"
14,19,88,2276,452,550,1002,"21 de agosto de 1994"
14,19,88,2277,291,324,615,"21 de agosto de 1994"
14,19,88,2278,51,44,95,"21 de agosto de 1994"
14,19,88,2279,235,250,485,"21 de agosto de 1994"
14,19,88,2280,117,108,225,"21 de agosto de 1994"
14,19,88,2281,127,93,220,"21 de agosto de 1994"
14,19,88,2282,69,48,117,"21 de agosto de 1994"
14,19,88,2283,120,97,217,"21 de agosto de 1994"
14,19,88,2284,183,125,308,"21 de agosto de 1994"
14,19,97,2424,486,501,987,"21 de agosto de 1994"
14,19,97,2425,305,375,680,"21 de agosto de 1994"
14,19,97,2426,377,472,849,"21 de agosto de 1994"
14,19,97,2427,273,344,617,"21 de agosto de 1994"
14,19,97,2428,189,230,419,"21 de agosto de 1994"
14,19,97,2429,270,299,569,"21 de agosto de 1994"
14,19,97,2430,382,429,811,"21 de agosto de 1994"
14,19,97,2431,403,490,893,"21 de agosto de 1994"
14,19,97,2432,236,242,478,"21 de agosto de 1994"
14,19,97,2433,172,177,349,"21 de agosto de 1994"
14,19,97,2434,291,330,621,"21 de agosto de 1994"
14,19,97,2435,573,683,1256,"21 de agosto de 1994"
14,19,97,2436,167,200,367,"21 de agosto de 1994"
14,19,97,2437,132,131,263,"21 de agosto de 1994"
14,19,104,2735,179,189,368,"21 de agosto de 1994"
14,19,104,2736,228,243,471,"21 de agosto de 1994"
14,19,104,2737,249,238,487,"21 de agosto de 1994"
14,19,104,2738,300,317,617,"21 de agosto de 1994"
14,19,104,2739,388,403,791,"21 de agosto de 1994"
14,19,104,2740,451,500,951,"21 de agosto de 1994"
14,19,104,2741,82,113,195,"21 de agosto de 1994"
14,19,109,2771,571,662,1233,"21 de agosto de 1994"
14,19,109,2772,245,256,501,"21 de agosto de 1994"
14,19,109,2773,497,529,1026,"21 de agosto de 1994"
14,19,109,2774,361,428,789,"21 de agosto de 1994"
14,19,109,2775,511,583,1094,"21 de agosto de 1994"
14,19,109,2776,196,238,434,"21 de agosto de 1994"
14,19,109,2777,376,448,824,"21 de agosto de 1994"
14,19,109,2778,389,405,794,"21 de agosto de 1994"
14,19,109,2779,433,519,952,"21 de agosto de 1994"
14,19,109,2780,444,489,933,"21 de agosto de 1994"
14,19,109,2781,426,481,907,"21 de agosto de 1994"
14,19,109,2782,767,779,1546,"21 de agosto de 1994"
14,19,109,2783,319,382,701,"21 de agosto de 1994"
14,19,109,2784,407,470,877,"21 de agosto de 1994"
14,19,109,2785,253,270,523,"21 de agosto de 1994"
14,19,109,2786,348,439,787,"21 de agosto de 1994"
14,19,109,2787,334,348,682,"21 de agosto de 1994"
14,19,109,2788,99,123,222,"21 de agosto de 1994"
14,19,109,2789,257,247,504,"21 de agosto de 1994"
14,19,109,2790,268,320,588,"21 de agosto de 1994"
14,19,109,2791,401,421,822,"21 de agosto de 1994"
14,19,109,2792,326,340,666,"21 de agosto de 1994"
14,19,109,2793,206,175,381,"21 de agosto de 1994"
14,19,113,2824,170,259,429,"21 de agosto de 1994"
14,19,113,2825,274,354,628,"21 de agosto de 1994"
14,19,113,2826,476,639,1115,"21 de agosto de 1994"
14,19,113,2827,6,8,14,"21 de agosto de 1994"
14,19,113,2828,195,275,470,"21 de agosto de 1994"
14,19,121,3238,492,567,1059,"21 de agosto de 1994"
14,19,121,3239,676,857,1533,"21 de agosto de 1994"
14,19,121,3240,361,425,786,"21 de agosto de 1994"
14,19,121,3241,368,392,760,"21 de agosto de 1994"
14,19,121,3242,334,410,744,"21 de agosto de 1994"
14,19,121,3243,303,328,631,"21 de agosto de 1994"
14,19,121,3244,567,614,1181,"21 de agosto de 1994"
14,19,121,3245,426,487,913,"21 de agosto de 1994"
14,19,121,3246,262,327,589,"21 de agosto de 1994"
14,19,121,3247,317,358,675,"21 de agosto de 1994"
14,19,121,3248,387,429,816,"21 de agosto de 1994"
14,19,121,3249,221,259,480,"21 de agosto de 1994"
14,19,121,3250,197,248,445,"21 de agosto de 1994"
14,19,121,3251,242,273,515,"21 de agosto de 1994"
14,19,121,3252,499,583,1082,"21 de agosto de 1994"
14,19,121,3253,74,75,149,"21 de agosto de 1994"
14,19,121,3254,127,128,255,"21 de agosto de 1994"
14,19,121,3255,115,131,246,"21 de agosto de 1994"
14,19,121,3256,541,651,1192,"21 de agosto de 1994"
14,19,121,3257,134,148,282,"21 de agosto de 1994"
14,19,121,3258,193,196,389,"21 de agosto de 1994"
14,19,122,3259,358,430,788,"21 de agosto de 1994"
14,19,122,3260,306,337,643,"21 de agosto de 1994"
14,19,122,3261,146,165,311,"21 de agosto de 1994"
14,19,122,3262,253,256,509,"21 de agosto de 1994"
14,19,122,3263,228,218,446,"21 de agosto de 1994"
14,19,122,3264,57,66,123,"21 de agosto de 1994"
14,20,84,2181,357,384,741,"21 de agosto de 1994"
14,20,84,2182,600,686,1286,"21 de agosto de 1994"
14,20,84,2183,281,309,590,"21 de agosto de 1994"
14,20,84,2184,423,487,910,"21 de agosto de 1994"
14,20,84,2185,327,369,696,"21 de agosto de 1994"
14,20,84,2186,422,436,858,"21 de agosto de 1994"
14,20,84,2187,261,334,595,"21 de agosto de 1994"
14,20,84,2188,420,385,805,"21 de agosto de 1994"
14,20,84,2189,360,353,713,"21 de agosto de 1994"
14,20,84,2190,380,420,800,"21 de agosto de 1994"
14,20,84,2191,483,493,976,"21 de agosto de 1994"
14,20,84,2192,298,341,639,"21 de agosto de 1994"
14,20,84,2193,509,625,1134,"21 de agosto de 1994"
14,20,84,2194,357,355,712,"21 de agosto de 1994"
14,20,84,2195,322,389,711,"21 de agosto de 1994"
14,20,84,2196,322,353,675,"21 de agosto de 1994"
14,20,84,2197,305,333,638,"21 de agosto de 1994"
14,20,84,2198,538,524,1062,"21 de agosto de 1994"
14,20,84,2199,336,304,640,"21 de agosto de 1994"
14,20,84,2200,298,298,596,"21 de agosto de 1994"
14,20,84,2201,342,378,720,"21 de agosto de 1994"
14,20,84,2202,190,208,398,"21 de agosto de 1994"
14,20,84,2203,118,124,242,"21 de agosto de 1994"
14,20,84,2204,387,405,792,"21 de agosto de 1994"
14,20,84,2205,422,448,870,"21 de agosto de 1994"
14,20,84,2206,541,553,1094,"21 de agosto de 1994"
14,20,84,2207,430,422,852,"21 de agosto de 1994"
14,20,84,2208,406,405,811,"21 de agosto de 1994"
14,20,84,2209,265,305,570,"21 de agosto de 1994"
14,20,84,2210,879,960,1839,"21 de agosto de 1994"
14,20,84,2211,121,134,255,"21 de agosto de 1994"
14,20,120,3031,576,673,1249,"21 de agosto de 1994"
14,20,120,3032,448,497,945,"21 de agosto de 1994"
14,20,120,3033,552,632,1184,"21 de agosto de 1994"
14,20,120,3034,496,540,1036,"21 de agosto de 1994"
14,20,120,3035,386,422,808,"21 de agosto de 1994"
14,20,120,3036,512,594,1106,"21 de agosto de 1994"
14,20,120,3037,484,599,1083,"21 de agosto de 1994"
14,20,120,3038,559,642,1201,"21 de agosto de 1994"
14,20,120,3039,444,533,977,"21 de agosto de 1994"
14,20,120,3040,687,823,1510,"21 de agosto de 1994"
14,20,120,3041,453,507,960,"21 de agosto de 1994"
14,20,120,3042,554,667,1221,"21 de agosto de 1994"
14,20,120,3043,420,502,922,"21 de agosto de 1994"
14,20,120,3044,322,369,691,"21 de agosto de 1994"
14,20,120,3045,494,616,1110,"21 de agosto de 1994"
14,20,120,3046,576,654,1230,"21 de agosto de 1994"
14,20,120,3047,403,460,863,"21 de agosto de 1994"
14,20,120,3048,526,603,1129,"21 de agosto de 1994"
14,20,120,3049,577,647,1224,"21 de agosto de 1994"
14,20,120,3050,687,799,1486,"21 de agosto de 1994"
14,20,120,3051,573,583,1156,"21 de agosto de 1994"
14,20,120,3052,668,788,1456,"21 de agosto de 1994"
14,20,120,3053,654,805,1459,"21 de agosto de 1994"
14,20,120,3054,466,510,976,"21 de agosto de 1994"
14,20,120,3055,424,512,936,"21 de agosto de 1994"
14,20,120,3056,488,536,1024,"21 de agosto de 1994"
14,20,120,3057,358,427,785,"21 de agosto de 1994"
14,20,120,3058,587,623,1210,"21 de agosto de 1994"
14,20,120,3059,476,524,1000,"21 de agosto de 1994"
14,20,120,3060,321,347,668,"21 de agosto de 1994"
14,20,120,3061,742,876,1618,"21 de agosto de 1994"
14,20,120,3062,526,561,1087,"21 de agosto de 1994"
14,20,120,3063,442,461,903,"21 de agosto de 1994"
14,20,120,3064,658,720,1378,"21 de agosto de 1994"
14,20,120,3065,573,643,1216,"21 de agosto de 1994"
14,20,120,3066,505,547,1052,"21 de agosto de 1994"
14,20,120,3067,833,917,1750,"21 de agosto de 1994"
14,20,120,3068,677,777,1454,"21 de agosto de 1994"
14,20,120,3069,474,573,1047,"21 de agosto de 1994"
14,20,120,3070,374,368,742,"21 de agosto de 1994"
14,20,120,3071,756,951,1707,"21 de agosto de 1994"
14,20,120,3072,545,655,1200,"21 de agosto de 1994"
14,20,120,3073,690,726,1416,"21 de agosto de 1994"
14,20,120,3074,555,614,1169,"21 de agosto de 1994"
14,20,120,3075,480,566,1046,"21 de agosto de 1994"
14,20,120,3076,633,750,1383,"21 de agosto de 1994"
14,20,120,3077,812,937,1749,"21 de agosto de 1994"
14,20,120,3078,521,668,1189,"21 de agosto de 1994"
14,20,120,3079,827,959,1786,"21 de agosto de 1994"
14,20,120,3080,536,617,1153,"21 de agosto de 1994"
14,20,120,3081,311,354,665,"21 de agosto de 1994"
14,20,120,3082,679,802,1481,"21 de agosto de 1994"
14,20,120,3083,549,686,1235,"21 de agosto de 1994"
14,20,120,3084,431,532,963,"21 de agosto de 1994"
14,20,120,3085,396,465,861,"21 de agosto de 1994"
14,20,120,3086,928,1062,1990,"21 de agosto de 1994"
14,20,120,3087,716,861,1577,"21 de agosto de 1994"
14,20,120,3088,482,594,1076,"21 de agosto de 1994"
14,20,120,3089,375,502,877,"21 de agosto de 1994"
14,20,120,3090,490,668,1158,"21 de agosto de 1994"
14,20,120,3091,569,683,1252,"21 de agosto de 1994"
14,20,120,3092,689,819,1508,"21 de agosto de 1994"
14,20,120,3093,469,572,1041,"21 de agosto de 1994"
14,20,120,3094,691,801,1492,"21 de agosto de 1994"
14,20,120,3095,552,654,1206,"21 de agosto de 1994"
14,20,120,3096,455,503,958,"21 de agosto de 1994"
14,20,120,3097,571,618,1189,"21 de agosto de 1994"
14,20,120,3098,518,618,1136,"21 de agosto de 1994"
14,20,120,3099,431,469,900,"21 de agosto de 1994"
14,20,120,3100,666,696,1362,"21 de agosto de 1994"
14,20,120,3101,486,572,1058,"21 de agosto de 1994"
14,20,120,3102,460,585,1045,"21 de agosto de 1994"
14,20,120,3103,779,946,1725,"21 de agosto de 1994"
14,20,120,3104,690,850,1540,"21 de agosto de 1994"
14,20,120,3105,470,599,1069,"21 de agosto de 1994"
14,20,120,3106,791,904,1695,"21 de agosto de 1994"
14,20,120,3107,520,633,1153,"21 de agosto de 1994"
14,20,120,3108,574,821,1395,"21 de agosto de 1994"
14,20,120,3109,303,348,651,"21 de agosto de 1994"
14,20,120,3110,541,645,1186,"21 de agosto de 1994"
14,20,120,3111,699,871,1570,"21 de agosto de 1994"
14,20,120,3112,706,848,1554,"21 de agosto de 1994"
14,20,120,3113,665,735,1400,"21 de agosto de 1994"
14,20,120,3114,749,869,1618,"21 de agosto de 1994"
14,20,120,3115,598,741,1339,"21 de agosto de 1994"
14,20,120,3116,766,785,1551,"21 de agosto de 1994"
14,20,120,3117,588,631,1219,"21 de agosto de 1994"
14,20,120,3118,708,676,1384,"21 de agosto de 1994"
14,20,120,3119,529,552,1081,"21 de agosto de 1994"
14,20,120,3120,298,338,636,"21 de agosto de 1994"
14,20,120,3121,585,625,1210,"21 de agosto de 1994"
14,20,120,3122,778,876,1654,"21 de agosto de 1994"
14,20,120,3123,342,440,782,"21 de agosto de 1994"
14,20,120,3124,476,577,1053,"21 de agosto de 1994"
14,20,120,3125,449,596,1045,"21 de agosto de 1994"
14,20,120,3126,975,1124,2099,"21 de agosto de 1994"
14,20,120,3127,460,561,1021,"21 de agosto de 1994"
14,20,120,3128,389,487,876,"21 de agosto de 1994"
14,20,120,3129,1017,1251,2268,"21 de agosto de 1994"
14,20,120,3130,703,842,1545,"21 de agosto de 1994"
14,20,120,3131,586,652,1238,"21 de agosto de 1994"
14,20,120,3132,930,1043,1973,"21 de agosto de 1994"
14,20,120,3133,603,821,1424,"21 de agosto de 1994"
14,20,120,3134,415,457,872,"21 de agosto de 1994"
14,20,120,3135,423,541,964,"21 de agosto de 1994"
14,20,120,3136,389,451,840,"21 de agosto de 1994"
14,20,120,3137,373,495,868,"21 de agosto de 1994"
14,20,120,3138,428,522,950,"21 de agosto de 1994"
14,20,120,3139,410,535,945,"21 de agosto de 1994"
14,20,120,3140,468,551,1019,"21 de agosto de 1994"
14,20,120,3141,549,663,1212,"21 de agosto de 1994"
14,20,120,3142,464,543,1007,"21 de agosto de 1994"
14,20,120,3143,610,718,1328,"21 de agosto de 1994"
14,20,120,3144,762,973,1735,"21 de agosto de 1994"
14,20,120,3145,612,750,1362,"21 de agosto de 1994"
14,20,120,3146,525,663,1188,"21 de agosto de 1994"
14,20,120,3147,841,1008,1849,"21 de agosto de 1994"
14,20,120,3148,699,734,1433,"21 de agosto de 1994"
14,20,120,3149,503,561,1064,"21 de agosto de 1994"
14,20,120,3150,243,263,506,"21 de agosto de 1994"
14,20,120,3151,682,739,1421,"21 de agosto de 1994"
14,20,120,3152,570,590,1160,"21 de agosto de 1994"
14,20,120,3153,709,753,1462,"21 de agosto de 1994"
14,20,120,3154,664,710,1374,"21 de agosto de 1994"
14,20,120,3155,748,832,1580,"21 de agosto de 1994"
14,20,120,3156,556,684,1240,"21 de agosto de 1994"
14,20,120,3157,651,699,1350,"21 de agosto de 1994"
14,20,120,3158,796,855,1651,"21 de agosto de 1994"
14,20,120,3159,529,570,1099,"21 de agosto de 1994"
14,20,120,3160,503,556,1059,"21 de agosto de 1994"
14,20,120,3161,324,406,730,"21 de agosto de 1994"
14,20,120,3162,377,467,844,"21 de agosto de 1994"
14,20,120,3163,495,620,1115,"21 de agosto de 1994"
14,20,120,3164,321,420,741,"21 de agosto de 1994"
14,20,120,3165,343,417,760,"21 de agosto de 1994"
14,20,120,3166,516,606,1122,"21 de agosto de 1994"
14,20,120,3167,769,895,1664,"21 de agosto de 1994"
14,20,120,3168,762,863,1625,"21 de agosto de 1994"
14,20,120,3169,426,459,885,"21 de agosto de 1994"
14,20,120,3170,754,873,1627,"21 de agosto de 1994"
14,20,120,3171,600,655,1255,"21 de agosto de 1994"
14,20,120,3172,678,792,1470,"21 de agosto de 1994"
14,20,120,3173,752,864,1616,"21 de agosto de 1994"
14,20,120,3174,573,643,1216,"21 de agosto de 1994"
14,20,120,3175,661,729,1390,"21 de agosto de 1994"
14,20,120,3176,623,702,1325,"21 de agosto de 1994"
14,20,120,3177,557,703,1260,"21 de agosto de 1994"
14,20,120,3178,537,605,1142,"21 de agosto de 1994"
14,20,120,3179,606,681,1287,"21 de agosto de 1994"
14,20,120,3180,536,696,1232,"21 de agosto de 1994"
14,20,120,3181,537,663,1200,"21 de agosto de 1994"
14,20,120,3182,474,596,1070,"21 de agosto de 1994"
14,20,120,3183,396,506,902,"21 de agosto de 1994"
14,20,120,3184,383,481,864,"21 de agosto de 1994"
14,20,120,3185,458,534,992,"21 de agosto de 1994"
14,20,120,3186,462,558,1020,"21 de agosto de 1994"
14,20,120,3187,675,822,1497,"21 de agosto de 1994"
14,20,120,3188,641,769,1410,"21 de agosto de 1994"
14,20,120,3189,585,714,1299,"21 de agosto de 1994"
14,20,120,3190,394,483,877,"21 de agosto de 1994"
14,20,120,3191,403,467,870,"21 de agosto de 1994"
14,20,120,3192,525,649,1174,"21 de agosto de 1994"
14,20,120,3193,373,459,832,"21 de agosto de 1994"
14,20,120,3194,603,657,1260,"21 de agosto de 1994"
14,20,120,3195,535,637,1172,"21 de agosto de 1994"
14,20,120,3196,510,649,1159,"21 de agosto de 1994"
14,20,120,3197,486,581,1067,"21 de agosto de 1994"
14,20,120,3198,666,724,1390,"21 de agosto de 1994"
14,20,120,3199,712,773,1485,"21 de agosto de 1994"
14,20,120,3200,1231,1411,2642,"21 de agosto de 1994"
14,20,120,3201,1138,1391,2529,"21 de agosto de 1994"
14,20,120,3202,514,632,1146,"21 de agosto de 1994"
14,20,120,3203,290,365,655,"21 de agosto de 1994"
14,20,120,3204,439,527,966,"21 de agosto de 1994"
14,20,120,3205,431,481,912,"21 de agosto de 1994"
14,20,120,3206,788,836,1624,"21 de agosto de 1994"
14,20,120,3207,416,443,859,"21 de agosto de 1994"
14,20,120,3208,570,682,1252,"21 de agosto de 1994"
14,20,120,3209,296,318,614,"21 de agosto de 1994"
14,20,120,3210,651,770,1421,"21 de agosto de 1994"
14,20,120,3211,952,1011,1963,"21 de agosto de 1994"
14,20,120,3212,476,521,997,"21 de agosto de 1994"
14,20,120,3213,462,494,956,"21 de agosto de 1994"
14,20,120,3214,343,368,711,"21 de agosto de 1994"
14,20,120,3215,1002,1055,2057,"21 de agosto de 1994"
14,20,120,3216,629,627,1256,"21 de agosto de 1994"
14,20,120,3217,430,457,887,"21 de agosto de 1994"
14,20,120,3218,168,206,374,"21 de agosto de 1994"
14,20,120,3219,497,569,1066,"21 de agosto de 1994"
14,20,120,3220,230,297,527,"21 de agosto de 1994"
14,20,120,3221,283,337,620,"21 de agosto de 1994"
14,20,120,3222,497,510,1007,"21 de agosto de 1994"
14,20,120,3223,409,428,837,"21 de agosto de 1994"
14,20,120,3224,317,369,686,"21 de agosto de 1994"
14,20,120,3225,559,616,1175,"21 de agosto de 1994"
14,20,120,3226,418,492,910,"21 de agosto de 1994"
14,20,120,3227,283,334,617,"21 de agosto de 1994"
14,20,120,3228,358,431,789,"21 de agosto de 1994"
14,20,120,3229,380,445,825,"21 de agosto de 1994"
14,20,120,3230,514,509,1023,"21 de agosto de 1994"
14,20,120,3231,493,505,998,"21 de agosto de 1994"
14,20,120,3232,1194,143,1337,"21 de agosto de 1994"
14,20,120,3233,925,63,988,"21 de agosto de 1994"
14,20,120,3234,493,508,1001,"21 de agosto de 1994"
14,20,120,3235,936,977,1913,"21 de agosto de 1994"
14,20,120,3236,335,358,693,"21 de agosto de 1994"
14,20,120,3237,324,330,654,"21 de agosto de 1994"
15,1,4,82,304,366,670,"21 de agosto de 1994"
15,1,4,83,312,352,664,"21 de agosto de 1994"
15,1,4,84,332,357,689,"21 de agosto de 1994"
15,1,4,85,220,243,463,"21 de agosto de 1994"
15,1,4,86,484,583,1067,"21 de agosto de 1994"
15,1,4,87,241,369,610,"21 de agosto de 1994"
15,1,4,88,217,240,457,"21 de agosto de 1994"
15,1,4,89,202,233,435,"21 de agosto de 1994"
15,1,4,90,88,87,175,"21 de agosto de 1994"
15,1,4,91,48,60,108,"21 de agosto de 1994"
15,1,4,92,316,300,616,"21 de agosto de 1994"
15,1,4,93,185,183,368,"21 de agosto de 1994"
15,1,8,166,507,514,1021,"21 de agosto de 1994"
15,1,8,167,451,525,976,"21 de agosto de 1994"
15,1,8,168,124,130,254,"21 de agosto de 1994"
15,1,8,169,159,175,334,"21 de agosto de 1994"
15,1,8,170,292,311,603,"21 de agosto de 1994"
15,1,8,171,616,644,1260,"21 de agosto de 1994"
15,1,8,172,154,159,313,"21 de agosto de 1994"
15,1,8,173,235,277,512,"21 de agosto de 1994"
15,1,8,174,159,143,302,"21 de agosto de 1994"
15,1,8,175,411,488,899,"21 de agosto de 1994"
15,1,8,176,361,454,815,"21 de agosto de 1994"
15,1,8,177,48,43,91,"21 de agosto de 1994"
15,1,8,178,133,150,283,"21 de agosto de 1994"
15,1,8,179,122,139,261,"21 de agosto de 1994"
15,1,8,180,314,343,657,"21 de agosto de 1994"
15,1,8,181,201,227,428,"21 de agosto de 1994"
15,1,8,182,96,111,207,"21 de agosto de 1994"
15,1,8,183,200,183,383,"21 de agosto de 1994"
15,1,8,184,375,430,805,"21 de agosto de 1994"
15,1,8,185,63,111,174,"21 de agosto de 1994"
15,1,8,186,224,232,456,"21 de agosto de 1994"
15,1,8,187,188,178,366,"21 de agosto de 1994"
15,1,8,188,67,80,147,"21 de agosto de 1994"
15,1,8,189,116,133,249,"21 de agosto de 1994"
15,1,8,190,195,254,449,"21 de agosto de 1994"
15,1,8,191,168,209,377,"21 de agosto de 1994"
15,1,8,192,132,155,287,"21 de agosto de 1994"
15,1,21,629,483,560,1043,"21 de agosto de 1994"
15,1,21,630,518,651,1169,"21 de agosto de 1994"
15,1,21,631,373,471,844,"21 de agosto de 1994"
15,1,21,632,518,634,1152,"21 de agosto de 1994"
15,1,21,633,223,190,413,"21 de agosto de 1994"
15,1,21,634,233,227,460,"21 de agosto de 1994"
15,1,21,635,204,212,416,"21 de agosto de 1994"
15,1,21,636,500,527,1027,"21 de agosto de 1994"
15,1,21,637,344,340,684,"21 de agosto de 1994"
15,1,21,638,156,189,345,"21 de agosto de 1994"
15,1,21,639,360,447,807,"21 de agosto de 1994"
15,1,21,640,244,272,516,"21 de agosto de 1994"
15,1,21,641,351,361,712,"21 de agosto de 1994"
15,1,21,642,312,349,661,"21 de agosto de 1994"
15,1,21,643,260,330,590,"21 de agosto de 1994"
15,1,21,644,368,386,754,"21 de agosto de 1994"
15,1,21,645,260,287,547,"21 de agosto de 1994"
15,1,21,646,329,375,704,"21 de agosto de 1994"
15,1,21,647,174,129,303,"21 de agosto de 1994"
15,1,41,2164,568,651,1219,"21 de agosto de 1994"
15,1,41,2165,182,242,424,"21 de agosto de 1994"
15,1,41,2166,441,524,965,"21 de agosto de 1994"
15,1,41,2167,362,379,741,"21 de agosto de 1994"
15,1,41,2168,340,415,755,"21 de agosto de 1994"
15,1,41,2169,299,421,720,"21 de agosto de 1994"
15,1,41,2170,464,621,1085,"21 de agosto de 1994"
15,1,41,2171,50,62,112,"21 de agosto de 1994"
15,1,41,2172,435,495,930,"21 de agosto de 1994"
15,1,41,2173,226,316,542,"21 de agosto de 1994"
15,1,41,2174,461,494,955,"21 de agosto de 1994"
15,1,41,2175,192,207,399,"21 de agosto de 1994"
15,1,41,2176,246,277,523,"21 de agosto de 1994"
15,1,41,2177,75,72,147,"21 de agosto de 1994"
15,1,41,2178,271,354,625,"21 de agosto de 1994"
15,1,41,2179,263,285,548,"21 de agosto de 1994"
15,1,41,2180,176,198,374,"21 de agosto de 1994"
15,1,41,2181,146,166,312,"21 de agosto de 1994"
15,1,41,2182,147,158,305,"21 de agosto de 1994"
15,1,53,2432,315,344,659,"21 de agosto de 1994"
15,1,53,2433,421,416,837,"21 de agosto de 1994"
15,1,53,2434,403,458,861,"21 de agosto de 1994"
15,1,53,2435,303,359,662,"21 de agosto de 1994"
15,1,53,2436,418,421,839,"21 de agosto de 1994"
15,1,53,2437,385,364,749,"21 de agosto de 1994"
15,1,53,2438,433,436,869,"21 de agosto de 1994"
15,1,53,2439,460,459,919,"21 de agosto de 1994"
15,1,53,2440,140,127,267,"21 de agosto de 1994"
15,1,53,2441,87,72,159,"21 de agosto de 1994"
15,1,53,2442,130,149,279,"21 de agosto de 1994"
15,1,53,2443,301,290,591,"21 de agosto de 1994"
15,1,53,2444,194,179,373,"21 de agosto de 1994"
15,1,53,2445,108,104,212,"21 de agosto de 1994"
15,1,53,2446,316,346,662,"21 de agosto de 1994"
15,1,53,2447,94,78,172,"21 de agosto de 1994"
15,1,64,3850,600,614,1214,"21 de agosto de 1994"
15,1,64,3851,57,57,114,"21 de agosto de 1994"
15,1,64,3852,551,569,1120,"21 de agosto de 1994"
15,1,64,3853,466,417,883,"21 de agosto de 1994"
15,1,64,3854,782,817,1599,"21 de agosto de 1994"
15,1,64,3855,307,308,615,"21 de agosto de 1994"
15,1,64,3856,520,529,1049,"21 de agosto de 1994"
15,1,64,3857,196,161,357,"21 de agosto de 1994"
15,1,64,3858,222,177,399,"21 de agosto de 1994"
15,1,64,3859,368,381,749,"21 de agosto de 1994"
15,1,64,3860,173,177,350,"21 de agosto de 1994"
15,1,64,3861,242,276,518,"21 de agosto de 1994"
15,1,64,3862,329,346,675,"21 de agosto de 1994"
15,1,67,3899,402,391,793,"21 de agosto de 1994"
15,1,67,3900,162,159,321,"21 de agosto de 1994"
15,1,67,3901,224,199,423,"21 de agosto de 1994"
15,1,67,3902,286,275,561,"21 de agosto de 1994"
15,1,78,4144,460,504,964,"21 de agosto de 1994"
15,1,78,4145,171,180,351,"21 de agosto de 1994"
15,1,78,4146,198,186,384,"21 de agosto de 1994"
15,1,78,4147,276,265,541,"21 de agosto de 1994"
15,1,81,4165,219,272,491,"21 de agosto de 1994"
15,1,81,4166,391,429,820,"21 de agosto de 1994"
15,1,81,4167,413,444,857,"21 de agosto de 1994"
15,1,81,4168,152,168,320,"21 de agosto de 1994"
15,1,81,4169,355,403,758,"21 de agosto de 1994"
15,1,81,4170,476,489,965,"21 de agosto de 1994"
15,1,81,4171,90,99,189,"21 de agosto de 1994"
15,1,81,4172,96,101,197,"21 de agosto de 1994"
15,1,81,4173,107,132,239,"21 de agosto de 1994"
15,1,81,4174,323,386,709,"21 de agosto de 1994"
15,1,81,4175,176,176,352,"21 de agosto de 1994"
15,1,81,4176,170,229,399,"21 de agosto de 1994"
15,1,81,4177,161,197,358,"21 de agosto de 1994"
15,1,81,4178,337,392,729,"21 de agosto de 1994"
15,1,81,4179,196,191,387,"21 de agosto de 1994"
15,1,81,4180,181,215,396,"21 de agosto de 1994"
15,1,81,4181,246,273,519,"21 de agosto de 1994"
15,1,81,4182,133,151,284,"21 de agosto de 1994"
15,1,81,4183,208,192,400,"21 de agosto de 1994"
15,1,81,4184,144,136,280,"21 de agosto de 1994"
15,1,81,4185,149,143,292,"21 de agosto de 1994"
15,1,81,4186,134,112,246,"21 de agosto de 1994"
15,1,81,4187,118,109,227,"21 de agosto de 1994"
15,1,83,4256,345,401,746,"21 de agosto de 1994"
15,1,83,4257,380,455,835,"21 de agosto de 1994"
15,1,83,4258,343,411,754,"21 de agosto de 1994"
15,1,83,4259,574,709,1283,"21 de agosto de 1994"
15,1,83,4260,486,543,1029,"21 de agosto de 1994"
15,1,83,4261,343,439,782,"21 de agosto de 1994"
15,1,83,4262,490,573,1063,"21 de agosto de 1994"
15,1,83,4263,469,578,1047,"21 de agosto de 1994"
15,1,83,4264,300,357,657,"21 de agosto de 1994"
15,1,83,4265,373,453,826,"21 de agosto de 1994"
15,1,83,4266,117,95,212,"21 de agosto de 1994"
15,1,83,4267,182,162,344,"21 de agosto de 1994"
15,1,83,4268,200,169,369,"21 de agosto de 1994"
15,1,83,4269,109,93,202,"21 de agosto de 1994"
15,1,83,4270,348,343,691,"21 de agosto de 1994"
15,1,83,4271,388,385,773,"21 de agosto de 1994"
15,1,83,4272,265,267,532,"21 de agosto de 1994"
15,1,83,4273,121,117,238,"21 de agosto de 1994"
15,1,83,4274,232,231,463,"21 de agosto de 1994"
15,1,83,4275,247,268,515,"21 de agosto de 1994"
15,1,83,4276,187,176,363,"21 de agosto de 1994"
15,1,83,4277,301,303,604,"21 de agosto de 1994"
15,1,83,4278,367,348,715,"21 de agosto de 1994"
15,1,83,4279,140,162,302,"21 de agosto de 1994"
15,1,83,4280,213,210,423,"21 de agosto de 1994"
15,1,83,4281,298,321,619,"21 de agosto de 1994"
15,1,83,4282,142,143,285,"21 de agosto de 1994"
15,1,83,4283,252,302,554,"21 de agosto de 1994"
15,1,83,4284,352,397,749,"21 de agosto de 1994"
15,1,83,4285,436,502,938,"21 de agosto de 1994"
15,1,83,4286,436,531,967,"21 de agosto de 1994"
15,1,83,4287,497,544,1041,"21 de agosto de 1994"
15,1,83,4288,108,98,206,"21 de agosto de 1994"
15,1,83,4289,232,266,498,"21 de agosto de 1994"
15,1,83,4290,305,330,635,"21 de agosto de 1994"
15,1,83,4291,279,314,593,"21 de agosto de 1994"
15,1,83,4292,258,256,514,"21 de agosto de 1994"
15,1,83,4293,267,250,517,"21 de agosto de 1994"
15,1,83,4294,502,614,1116,"21 de agosto de 1994"
15,1,83,4295,256,321,577,"21 de agosto de 1994"
15,1,83,4296,64,73,137,"21 de agosto de 1994"
15,1,83,4297,144,159,303,"21 de agosto de 1994"
15,1,83,4298,409,421,830,"21 de agosto de 1994"
15,1,83,4299,118,152,270,"21 de agosto de 1994"
15,1,83,4300,339,377,716,"21 de agosto de 1994"
15,1,83,4301,217,242,459,"21 de agosto de 1994"
15,1,83,4302,134,145,279,"21 de agosto de 1994"
15,1,83,4303,106,101,207,"21 de agosto de 1994"
15,1,83,4304,157,168,325,"21 de agosto de 1994"
15,1,83,4305,127,133,260,"21 de agosto de 1994"
15,1,83,4306,106,108,214,"21 de agosto de 1994"
15,1,83,4307,86,109,195,"21 de agosto de 1994"
15,1,83,4308,178,236,414,"21 de agosto de 1994"
15,1,83,4309,407,476,883,"21 de agosto de 1994"
15,1,83,4310,79,86,165,"21 de agosto de 1994"
15,1,83,4311,28,25,53,"21 de agosto de 1994"
15,1,83,4312,136,167,303,"21 de agosto de 1994"
15,1,83,4313,105,98,203,"21 de agosto de 1994"
15,1,83,4314,421,475,896,"21 de agosto de 1994"
15,1,83,4315,388,435,823,"21 de agosto de 1994"
15,1,83,4316,314,274,588,"21 de agosto de 1994"
15,1,83,4317,110,90,200,"21 de agosto de 1994"
15,1,83,4318,231,190,421,"21 de agosto de 1994"
15,1,83,4319,160,192,352,"21 de agosto de 1994"
15,1,83,4320,40,53,93,"21 de agosto de 1994"
15,1,83,4321,122,134,256,"21 de agosto de 1994"
15,1,83,4322,82,73,155,"21 de agosto de 1994"
15,1,83,4323,220,263,483,"21 de agosto de 1994"
15,1,83,4324,162,191,353,"21 de agosto de 1994"
15,1,83,4325,202,250,452,"21 de agosto de 1994"
15,1,89,4429,488,648,1136,"21 de agosto de 1994"
15,1,89,4430,679,816,1495,"21 de agosto de 1994"
15,1,89,4431,469,568,1037,"21 de agosto de 1994"
15,1,89,4432,592,753,1345,"21 de agosto de 1994"
15,1,89,4433,366,16,382,"21 de agosto de 1994"
15,1,89,4434,313,445,758,"21 de agosto de 1994"
15,1,89,4435,403,473,876,"21 de agosto de 1994"
15,1,89,4436,495,576,1071,"21 de agosto de 1994"
15,1,89,4437,716,902,1618,"21 de agosto de 1994"
15,1,89,4438,573,671,1244,"21 de agosto de 1994"
15,1,89,4439,598,723,1321,"21 de agosto de 1994"
15,1,89,4440,530,616,1146,"21 de agosto de 1994"
15,1,89,4441,496,597,1093,"21 de agosto de 1994"
15,1,89,4442,498,516,1014,"21 de agosto de 1994"
15,1,89,4443,658,664,1322,"21 de agosto de 1994"
15,1,89,4444,123,119,242,"21 de agosto de 1994"
15,1,89,4445,385,416,801,"21 de agosto de 1994"
15,1,89,4446,476,470,946,"21 de agosto de 1994"
15,1,89,4447,371,370,741,"21 de agosto de 1994"
15,1,89,4448,697,715,1412,"21 de agosto de 1994"
15,1,89,4449,193,179,372,"21 de agosto de 1994"
15,1,89,4450,398,415,813,"21 de agosto de 1994"
15,1,89,4451,644,735,1379,"21 de agosto de 1994"
15,1,89,4452,268,322,590,"21 de agosto de 1994"
15,1,89,4453,155,161,316,"21 de agosto de 1994"
15,1,89,4454,407,475,882,"21 de agosto de 1994"
15,1,89,4455,365,367,732,"21 de agosto de 1994"
15,1,89,4456,574,510,1084,"21 de agosto de 1994"
15,1,89,4457,71,78,149,"21 de agosto de 1994"
15,1,89,4458,511,581,1092,"21 de agosto de 1994"
15,1,89,4459,395,487,882,"21 de agosto de 1994"
15,1,89,4460,439,516,955,"21 de agosto de 1994"
15,1,89,4461,444,502,946,"21 de agosto de 1994"
15,1,89,4462,183,192,375,"21 de agosto de 1994"
15,1,89,4463,243,218,461,"21 de agosto de 1994"
15,1,89,4464,107,89,196,"21 de agosto de 1994"
15,1,89,4465,176,153,329,"21 de agosto de 1994"
15,1,98,4601,663,674,1337,"21 de agosto de 1994"
15,1,98,4602,317,306,623,"21 de agosto de 1994"
15,1,98,4603,433,443,876,"21 de agosto de 1994"
15,1,98,4604,498,458,956,"21 de agosto de 1994"
15,1,98,4605,280,291,571,"21 de agosto de 1994"
15,1,98,4606,231,218,449,"21 de agosto de 1994"
15,1,98,4607,269,255,524,"21 de agosto de 1994"
15,1,98,4608,323,313,636,"21 de agosto de 1994"
15,1,106,5137,418,379,797,"21 de agosto de 1994"
15,1,106,5138,384,420,804,"21 de agosto de 1994"
15,1,106,5139,264,281,545,"21 de agosto de 1994"
15,1,106,5140,172,162,334,"21 de agosto de 1994"
15,1,106,5141,200,226,426,"21 de agosto de 1994"
15,1,106,5142,169,213,382,"21 de agosto de 1994"
15,1,106,5143,387,458,845,"21 de agosto de 1994"
15,1,106,5144,106,134,240,"21 de agosto de 1994"
15,1,106,5145,257,254,511,"21 de agosto de 1994"
15,1,106,5146,155,182,337,"21 de agosto de 1994"
15,1,106,5147,291,322,613,"21 de agosto de 1994"
15,1,106,5148,542,584,1126,"21 de agosto de 1994"
15,1,106,5149,49,41,90,"21 de agosto de 1994"
15,1,106,5150,131,150,281,"21 de agosto de 1994"
15,1,106,5151,264,288,552,"21 de agosto de 1994"
15,1,106,5152,211,232,443,"21 de agosto de 1994"
15,1,106,5153,316,392,708,"21 de agosto de 1994"
15,1,106,5154,146,167,313,"21 de agosto de 1994"
15,1,106,5155,183,177,360,"21 de agosto de 1994"
15,1,106,5156,169,191,360,"21 de agosto de 1994"
15,1,106,5157,291,347,638,"21 de agosto de 1994"
15,1,106,5158,260,276,536,"21 de agosto de 1994"
15,1,106,5159,202,244,446,"21 de agosto de 1994"
15,1,106,5160,124,138,262,"21 de agosto de 1994"
15,1,106,5161,315,330,645,"21 de agosto de 1994"
15,1,106,5162,87,104,191,"21 de agosto de 1994"
15,1,106,5163,273,375,648,"21 de agosto de 1994"
15,1,106,5164,174,160,334,"21 de agosto de 1994"
15,1,106,5165,176,195,371,"21 de agosto de 1994"
15,1,106,5166,133,135,268,"21 de agosto de 1994"
15,1,106,5167,142,168,310,"21 de agosto de 1994"
15,1,106,5168,172,180,352,"21 de agosto de 1994"
15,1,108,5443,386,490,876,"21 de agosto de 1994"
15,1,108,5444,344,431,775,"21 de agosto de 1994"
15,1,108,5445,392,479,871,"21 de agosto de 1994"
15,1,108,5446,318,373,691,"21 de agosto de 1994"
15,1,108,5447,276,356,632,"21 de agosto de 1994"
15,1,108,5448,169,165,334,"21 de agosto de 1994"
15,1,108,5449,250,280,530,"21 de agosto de 1994"
15,1,108,5450,295,329,624,"21 de agosto de 1994"
15,1,108,5451,127,140,267,"21 de agosto de 1994"
15,1,114,5723,758,880,1638,"21 de agosto de 1994"
15,1,114,5724,483,583,1066,"21 de agosto de 1994"
15,1,114,5725,277,307,584,"21 de agosto de 1994"
15,1,114,5726,575,660,1235,"21 de agosto de 1994"
15,1,114,5727,591,535,1126,"21 de agosto de 1994"
15,1,114,5728,386,394,780,"21 de agosto de 1994"
15,1,114,5729,206,190,396,"21 de agosto de 1994"
15,1,114,5730,516,501,1017,"21 de agosto de 1994"
15,1,114,5731,261,278,539,"21 de agosto de 1994"
15,1,114,5732,468,511,979,"21 de agosto de 1994"
15,1,114,5733,460,477,937,"21 de agosto de 1994"
15,1,114,5734,288,314,602,"21 de agosto de 1994"
15,1,114,5735,637,724,1361,"21 de agosto de 1994"
15,1,114,5736,411,410,821,"21 de agosto de 1994"
15,1,114,5737,275,296,571,"21 de agosto de 1994"
15,1,114,5738,483,541,1024,"21 de agosto de 1994"
15,1,114,5739,283,312,595,"21 de agosto de 1994"
15,1,114,5740,502,557,1059,"21 de agosto de 1994"
15,1,114,5741,321,363,684,"21 de agosto de 1994"
15,1,114,5742,383,454,837,"21 de agosto de 1994"
15,1,114,5743,213,243,456,"21 de agosto de 1994"
15,1,114,5744,298,300,598,"21 de agosto de 1994"
15,1,114,5745,212,213,425,"21 de agosto de 1994"
15,1,114,5746,177,171,348,"21 de agosto de 1994"
15,1,114,5747,112,96,208,"21 de agosto de 1994"
15,1,117,5805,479,445,924,"21 de agosto de 1994"
15,1,117,5806,184,181,365,"21 de agosto de 1994"
15,1,118,5807,299,350,649,"21 de agosto de 1994"
15,1,118,5808,500,624,1124,"21 de agosto de 1994"
15,1,118,5809,321,319,640,"21 de agosto de 1994"
15,1,118,5810,300,306,606,"21 de agosto de 1994"
15,1,118,5811,174,167,341,"21 de agosto de 1994"
15,1,118,5812,193,217,410,"21 de agosto de 1994"
15,1,118,5813,81,102,183,"21 de agosto de 1994"
15,1,118,5814,71,66,137,"21 de agosto de 1994"
15,1,118,5815,64,68,132,"21 de agosto de 1994"
15,1,118,5816,276,316,592,"21 de agosto de 1994"
15,1,118,5817,190,202,392,"21 de agosto de 1994"
15,1,118,5818,261,305,566,"21 de agosto de 1994"
15,1,118,5819,152,202,354,"21 de agosto de 1994"
15,1,118,5820,174,186,360,"21 de agosto de 1994"
15,1,118,5821,80,85,165,"21 de agosto de 1994"
15,1,120,5869,450,514,964,"21 de agosto de 1994"
15,1,120,5870,325,429,754,"21 de agosto de 1994"
15,1,120,5871,251,242,493,"21 de agosto de 1994"
15,1,120,5872,494,503,997,"21 de agosto de 1994"
15,1,120,5873,278,303,581,"21 de agosto de 1994"
15,1,120,5874,171,193,364,"21 de agosto de 1994"
15,1,120,5875,131,122,253,"21 de agosto de 1994"
15,1,120,5876,73,82,155,"21 de agosto de 1994"
15,1,120,5877,271,311,582,"21 de agosto de 1994"
15,1,120,5878,184,193,377,"21 de agosto de 1994"
15,1,120,5879,200,231,431,"21 de agosto de 1994"
15,2,5,94,731,759,1490,"21 de agosto de 1994"
15,2,5,95,273,252,525,"21 de agosto de 1994"
15,2,5,96,326,314,640,"21 de agosto de 1994"
15,2,5,97,683,599,1282,"21 de agosto de 1994"
15,2,5,98,133,118,251,"21 de agosto de 1994"
15,2,5,99,221,226,447,"21 de agosto de 1994"
15,2,5,100,632,614,1246,"21 de agosto de 1994"
15,2,5,101,518,508,1026,"21 de agosto de 1994"
15,2,5,102,652,647,1299,"21 de agosto de 1994"
15,2,5,103,156,173,329,"21 de agosto de 1994"
15,2,5,104,92,84,176,"21 de agosto de 1994"
15,2,5,105,263,252,515,"21 de agosto de 1994"
15,2,5,106,424,403,827,"21 de agosto de 1994"
15,2,5,107,511,510,1021,"21 de agosto de 1994"
15,2,5,108,124,121,245,"21 de agosto de 1994"
15,2,5,109,258,267,525,"21 de agosto de 1994"
15,2,5,110,444,413,857,"21 de agosto de 1994"
15,2,5,111,263,253,516,"21 de agosto de 1994"
15,2,5,112,527,506,1033,"21 de agosto de 1994"
15,2,5,113,569,547,1116,"21 de agosto de 1994"
15,2,5,114,400,377,777,"21 de agosto de 1994"
15,2,5,115,407,391,798,"21 de agosto de 1994"
15,2,5,116,224,223,447,"21 de agosto de 1994"
15,2,5,117,394,385,779,"21 de agosto de 1994"
15,2,5,118,371,384,755,"21 de agosto de 1994"
15,2,5,119,296,296,592,"21 de agosto de 1994"
15,2,5,120,322,326,648,"21 de agosto de 1994"
15,2,5,121,303,307,610,"21 de agosto de 1994"
15,2,5,122,366,381,747,"21 de agosto de 1994"
15,2,5,123,627,614,1241,"21 de agosto de 1994"
15,2,5,124,392,402,794,"21 de agosto de 1994"
15,2,5,125,544,546,1090,"21 de agosto de 1994"
15,2,5,126,447,406,853,"21 de agosto de 1994"
15,2,5,127,258,254,512,"21 de agosto de 1994"
15,2,5,128,589,569,1158,"21 de agosto de 1994"
15,2,5,129,317,309,626,"21 de agosto de 1994"
15,2,5,130,325,326,651,"21 de agosto de 1994"
15,2,5,131,328,328,656,"21 de agosto de 1994"
15,2,5,132,430,473,903,"21 de agosto de 1994"
15,2,5,133,483,510,993,"21 de agosto de 1994"
15,2,5,134,427,423,850,"21 de agosto de 1994"
15,2,5,135,402,339,741,"21 de agosto de 1994"
15,2,5,136,353,310,663,"21 de agosto de 1994"
15,2,5,137,394,318,712,"21 de agosto de 1994"
15,2,5,138,482,420,902,"21 de agosto de 1994"
15,2,5,139,297,310,607,"21 de agosto de 1994"
15,2,5,140,643,682,1325,"21 de agosto de 1994"
15,2,5,141,547,580,1127,"21 de agosto de 1994"
15,2,5,142,474,504,978,"21 de agosto de 1994"
15,2,5,143,413,449,862,"21 de agosto de 1994"
15,2,5,144,454,494,948,"21 de agosto de 1994"
15,2,5,145,426,376,802,"21 de agosto de 1994"
15,2,5,146,293,248,541,"21 de agosto de 1994"
15,2,5,147,312,277,589,"21 de agosto de 1994"
15,2,5,148,187,161,348,"21 de agosto de 1994"
15,2,5,149,217,206,423,"21 de agosto de 1994"
15,2,5,150,165,154,319,"21 de agosto de 1994"
15,2,7,156,267,292,559,"21 de agosto de 1994"
15,2,7,157,280,249,529,"21 de agosto de 1994"
15,2,7,158,336,291,627,"21 de agosto de 1994"
15,2,7,159,212,198,410,"21 de agosto de 1994"
15,2,7,160,595,579,1174,"21 de agosto de 1994"
15,2,7,161,514,492,1006,"21 de agosto de 1994"
15,2,7,162,440,421,861,"21 de agosto de 1994"
15,2,7,163,535,542,1077,"21 de agosto de 1994"
15,2,7,164,405,396,801,"21 de agosto de 1994"
15,2,7,165,503,445,948,"21 de agosto de 1994"
15,2,33,1286,266,241,507,"21 de agosto de 1994"
15,2,33,1287,275,257,532,"21 de agosto de 1994"
15,2,33,1288,268,277,545,"21 de agosto de 1994"
15,2,33,1289,258,220,478,"21 de agosto de 1994"
15,2,33,1290,579,578,1157,"21 de agosto de 1994"
15,2,33,1291,138,124,262,"21 de agosto de 1994"
15,2,33,1292,382,400,782,"21 de agosto de 1994"
15,2,33,1293,371,393,764,"21 de agosto de 1994"
15,2,33,1294,352,332,684,"21 de agosto de 1994"
15,2,33,1295,297,287,584,"21 de agosto de 1994"
15,2,33,1296,345,326,671,"21 de agosto de 1994"
15,2,33,1297,292,300,592,"21 de agosto de 1994"
15,2,33,1298,341,392,733,"21 de agosto de 1994"
15,2,33,1299,263,355,618,"21 de agosto de 1994"
15,2,33,1300,666,647,1313,"21 de agosto de 1994"
15,2,33,1301,169,167,336,"21 de agosto de 1994"
15,2,42,2183,376,360,736,"21 de agosto de 1994"
15,2,42,2184,357,318,675,"21 de agosto de 1994"
15,2,42,2185,202,199,401,"21 de agosto de 1994"
15,2,42,2186,181,155,336,"21 de agosto de 1994"
15,2,42,2187,280,263,543,"21 de agosto de 1994"
15,2,75,4026,656,748,1404,"21 de agosto de 1994"
15,2,75,4027,244,213,457,"21 de agosto de 1994"
15,2,75,4028,355,369,724,"21 de agosto de 1994"
15,2,75,4029,426,401,827,"21 de agosto de 1994"
15,2,75,4030,199,213,412,"21 de agosto de 1994"
15,2,75,4031,461,484,945,"21 de agosto de 1994"
15,2,75,4032,312,368,680,"21 de agosto de 1994"
15,2,75,4033,224,226,450,"21 de agosto de 1994"
15,2,75,4034,354,411,765,"21 de agosto de 1994"
15,2,75,4035,420,482,902,"21 de agosto de 1994"
15,2,75,4036,512,631,1143,"21 de agosto de 1994"
15,2,75,4037,833,902,1735,"21 de agosto de 1994"
15,2,75,4038,392,361,753,"21 de agosto de 1994"
15,2,75,4039,359,370,729,"21 de agosto de 1994"
15,2,75,4040,302,339,641,"21 de agosto de 1994"
15,2,75,4041,366,389,755,"21 de agosto de 1994"
15,2,75,4042,454,529,983,"21 de agosto de 1994"
15,2,75,4043,426,479,905,"21 de agosto de 1994"
15,2,75,4044,350,399,749,"21 de agosto de 1994"
15,2,75,4045,477,460,937,"21 de agosto de 1994"
15,2,75,4046,526,494,1020,"21 de agosto de 1994"
15,2,75,4047,359,347,706,"21 de agosto de 1994"
15,2,75,4048,459,478,937,"21 de agosto de 1994"
15,2,75,4049,497,501,998,"21 de agosto de 1994"
15,2,75,4050,274,261,535,"21 de agosto de 1994"
15,2,75,4051,366,379,745,"21 de agosto de 1994"
15,2,75,4052,253,297,550,"21 de agosto de 1994"
15,2,75,4053,417,480,897,"21 de agosto de 1994"
15,2,75,4054,271,349,620,"21 de agosto de 1994"
15,2,75,4055,319,356,675,"21 de agosto de 1994"
15,2,75,4056,205,222,427,"21 de agosto de 1994"
15,2,75,4057,467,548,1015,"21 de agosto de 1994"
15,2,75,4058,99,117,216,"21 de agosto de 1994"
15,2,75,4059,708,722,1430,"21 de agosto de 1994"
15,2,75,4060,428,467,895,"21 de agosto de 1994"
15,2,75,4061,559,634,1193,"21 de agosto de 1994"
15,2,75,4062,335,342,677,"21 de agosto de 1994"
15,2,75,4063,353,345,698,"21 de agosto de 1994"
15,2,75,4064,325,319,644,"21 de agosto de 1994"
15,2,75,4065,472,506,978,"21 de agosto de 1994"
15,2,75,4066,407,438,845,"21 de agosto de 1994"
15,2,75,4067,433,432,865,"21 de agosto de 1994"
15,2,75,4068,240,256,496,"21 de agosto de 1994"
15,2,75,4069,716,798,1514,"21 de agosto de 1994"
15,2,75,4070,426,472,898,"21 de agosto de 1994"
15,2,75,4071,286,326,612,"21 de agosto de 1994"
15,2,75,4072,685,848,1533,"21 de agosto de 1994"
15,2,75,4073,106,120,226,"21 de agosto de 1994"
15,2,75,4074,417,472,889,"21 de agosto de 1994"
15,2,75,4075,651,696,1347,"21 de agosto de 1994"
15,2,75,4076,448,445,893,"21 de agosto de 1994"
15,2,75,4077,444,485,929,"21 de agosto de 1994"
15,2,75,4078,559,672,1231,"21 de agosto de 1994"
15,2,75,4079,457,499,956,"21 de agosto de 1994"
15,2,75,4080,669,681,1350,"21 de agosto de 1994"
15,2,75,4081,265,257,522,"21 de agosto de 1994"
15,2,75,4082,404,377,781,"21 de agosto de 1994"
15,2,75,4083,217,196,413,"21 de agosto de 1994"
15,2,75,4084,371,398,769,"21 de agosto de 1994"
15,2,75,4085,432,461,893,"21 de agosto de 1994"
15,2,75,4086,100,124,224,"21 de agosto de 1994"
15,2,75,4087,411,434,845,"21 de agosto de 1994"
15,2,75,4088,240,255,495,"21 de agosto de 1994"
15,2,75,4089,527,543,1070,"21 de agosto de 1994"
15,2,75,4090,529,564,1093,"21 de agosto de 1994"
15,2,75,4091,618,575,1193,"21 de agosto de 1994"
15,2,75,4092,271,251,522,"21 de agosto de 1994"
15,2,75,4093,240,227,467,"21 de agosto de 1994"
15,2,75,4094,321,293,614,"21 de agosto de 1994"
15,2,75,4095,328,324,652,"21 de agosto de 1994"
15,2,75,4096,451,404,855,"21 de agosto de 1994"
15,2,75,4097,162,190,352,"21 de agosto de 1994"
15,2,75,4098,220,225,445,"21 de agosto de 1994"
15,2,75,4099,83,84,167,"21 de agosto de 1994"
15,2,75,4100,175,202,377,"21 de agosto de 1994"
15,2,75,4101,121,133,254,"21 de agosto de 1994"
15,2,75,4102,296,299,595,"21 de agosto de 1994"
15,2,75,4103,236,277,513,"21 de agosto de 1994"
15,2,75,4104,277,257,534,"21 de agosto de 1994"
15,2,75,4105,104,91,195,"21 de agosto de 1994"
15,2,79,4148,314,364,678,"21 de agosto de 1994"
15,2,79,4149,216,251,467,"21 de agosto de 1994"
15,2,79,4150,47,56,103,"21 de agosto de 1994"
15,2,79,4151,363,349,712,"21 de agosto de 1994"
15,2,79,4152,104,88,192,"21 de agosto de 1994"
15,2,79,4153,84,77,161,"21 de agosto de 1994"
15,2,79,4154,101,71,172,"21 de agosto de 1994"
15,2,79,4155,205,182,387,"21 de agosto de 1994"
15,2,79,4156,63,63,126,"21 de agosto de 1994"
15,2,79,4157,347,389,736,"21 de agosto de 1994"
15,2,87,4380,423,498,921,"21 de agosto de 1994"
15,2,87,4381,223,281,504,"21 de agosto de 1994"
15,2,87,4382,308,329,637,"21 de agosto de 1994"
15,2,87,4383,349,312,661,"21 de agosto de 1994"
15,2,87,4384,396,377,773,"21 de agosto de 1994"
15,2,87,4385,345,327,672,"21 de agosto de 1994"
15,2,87,4386,283,276,559,"21 de agosto de 1994"
15,2,87,4387,336,320,656,"21 de agosto de 1994"
15,2,87,4388,244,225,469,"21 de agosto de 1994"
15,2,87,4389,337,334,671,"21 de agosto de 1994"
15,2,87,4390,522,543,1065,"21 de agosto de 1994"
15,2,87,4391,220,216,436,"21 de agosto de 1994"
15,2,87,4392,186,165,351,"21 de agosto de 1994"
15,2,87,4393,299,305,604,"21 de agosto de 1994"
15,2,87,4394,441,427,868,"21 de agosto de 1994"
15,2,87,4395,392,346,738,"21 de agosto de 1994"
15,2,87,4396,122,120,242,"21 de agosto de 1994"
15,2,87,4397,158,192,350,"21 de agosto de 1994"
15,2,87,4398,68,58,126,"21 de agosto de 1994"
15,2,87,4399,113,102,215,"21 de agosto de 1994"
15,2,87,4400,101,93,194,"21 de agosto de 1994"
15,2,87,4401,163,138,301,"21 de agosto de 1994"
15,2,87,4402,137,120,257,"21 de agosto de 1994"
15,2,111,5654,285,311,596,"21 de agosto de 1994"
15,2,111,5655,761,822,1583,"21 de agosto de 1994"
15,2,111,5656,351,415,766,"21 de agosto de 1994"
15,2,111,5657,733,770,1503,"21 de agosto de 1994"
15,2,111,5658,709,737,1446,"21 de agosto de 1994"
15,2,111,5659,384,449,833,"21 de agosto de 1994"
15,2,111,5660,327,366,693,"21 de agosto de 1994"
15,2,111,5661,561,595,1156,"21 de agosto de 1994"
15,2,111,5662,429,426,855,"21 de agosto de 1994"
15,2,111,5663,167,154,321,"21 de agosto de 1994"
15,2,111,5664,233,245,478,"21 de agosto de 1994"
15,2,111,5665,201,217,418,"21 de agosto de 1994"
15,2,111,5666,300,275,575,"21 de agosto de 1994"
15,2,111,5667,502,508,1010,"21 de agosto de 1994"
15,2,111,5668,143,144,287,"21 de agosto de 1994"
15,2,111,5669,513,555,1068,"21 de agosto de 1994"
15,2,111,5670,117,112,229,"21 de agosto de 1994"
15,2,111,5671,178,179,357,"21 de agosto de 1994"
15,2,111,5672,383,381,764,"21 de agosto de 1994"
15,2,111,5673,476,461,937,"21 de agosto de 1994"
15,2,111,5674,280,250,530,"21 de agosto de 1994"
15,2,111,5675,320,294,614,"21 de agosto de 1994"
15,2,111,5676,209,233,442,"21 de agosto de 1994"
15,2,111,5677,363,454,817,"21 de agosto de 1994"
15,2,111,5678,315,313,628,"21 de agosto de 1994"
15,2,111,5679,507,615,1122,"21 de agosto de 1994"
15,2,111,5680,606,698,1304,"21 de agosto de 1994"
15,2,111,5681,554,584,1138,"21 de agosto de 1994"
15,2,112,5682,442,477,919,"21 de agosto de 1994"
15,2,112,5683,364,361,725,"21 de agosto de 1994"
15,2,112,5684,466,448,914,"21 de agosto de 1994"
15,2,112,5685,350,374,724,"21 de agosto de 1994"
15,2,112,5686,109,112,221,"21 de agosto de 1994"
15,2,112,5687,323,308,631,"21 de agosto de 1994"
15,2,112,5688,660,683,1343,"21 de agosto de 1994"
15,2,112,5689,304,335,639,"21 de agosto de 1994"
15,2,112,5690,175,190,365,"21 de agosto de 1994"
15,2,112,5691,445,465,910,"21 de agosto de 1994"
15,2,112,5692,529,498,1027,"21 de agosto de 1994"
15,2,112,5693,226,202,428,"21 de agosto de 1994"
15,2,112,5694,227,218,445,"21 de agosto de 1994"
15,2,112,5695,392,385,777,"21 de agosto de 1994"
15,2,112,5696,456,374,830,"21 de agosto de 1994"
15,2,112,5697,530,569,1099,"21 de agosto de 1994"
15,2,112,5698,165,143,308,"21 de agosto de 1994"
15,2,112,5699,237,207,444,"21 de agosto de 1994"
15,2,112,5700,239,242,481,"21 de agosto de 1994"
15,2,112,5701,330,331,661,"21 de agosto de 1994"
15,2,112,5702,128,124,252,"21 de agosto de 1994"
15,2,112,5703,443,426,869,"21 de agosto de 1994"
15,2,115,5748,334,358,692,"21 de agosto de 1994"
15,2,115,5749,295,321,616,"21 de agosto de 1994"
15,2,115,5750,364,374,738,"21 de agosto de 1994"
15,2,115,5751,447,438,885,"21 de agosto de 1994"
15,2,115,5752,240,234,474,"21 de agosto de 1994"
15,2,115,5753,258,263,521,"21 de agosto de 1994"
15,2,115,5754,583,592,1175,"21 de agosto de 1994"
15,2,115,5755,331,372,703,"21 de agosto de 1994"
15,2,115,5756,464,444,908,"21 de agosto de 1994"
15,2,115,5757,124,142,266,"21 de agosto de 1994"
15,2,115,5758,152,126,278,"21 de agosto de 1994"
15,2,115,5759,338,352,690,"21 de agosto de 1994"
15,2,115,5760,153,140,293,"21 de agosto de 1994"
15,2,115,5761,669,711,1380,"21 de agosto de 1994"
15,2,115,5762,228,239,467,"21 de agosto de 1994"
15,2,115,5763,501,484,985,"21 de agosto de 1994"
15,2,115,5764,218,214,432,"21 de agosto de 1994"
15,2,115,5765,146,143,289,"21 de agosto de 1994"
15,2,115,5766,601,585,1186,"21 de agosto de 1994"
15,2,115,5767,324,308,632,"21 de agosto de 1994"
15,2,115,5768,286,303,589,"21 de agosto de 1994"
15,2,115,5769,206,195,401,"21 de agosto de 1994"
15,2,115,5770,328,327,655,"21 de agosto de 1994"
15,2,115,5771,343,332,675,"21 de agosto de 1994"
15,2,115,5772,492,481,973,"21 de agosto de 1994"
15,2,115,5773,378,380,758,"21 de agosto de 1994"
15,2,115,5774,307,262,569,"21 de agosto de 1994"
15,2,115,5775,360,325,685,"21 de agosto de 1994"
15,2,115,5776,206,212,418,"21 de agosto de 1994"
15,2,115,5777,133,95,228,"21 de agosto de 1994"
15,2,115,5778,204,185,389,"21 de agosto de 1994"
15,2,115,5779,315,311,626,"21 de agosto de 1994"
15,2,115,5780,450,421,871,"21 de agosto de 1994"
15,2,115,5781,519,450,969,"21 de agosto de 1994"
15,2,115,5782,203,204,407,"21 de agosto de 1994"
15,2,115,5783,325,337,662,"21 de agosto de 1994"
15,2,115,5784,304,315,619,"21 de agosto de 1994"
15,2,115,5785,166,144,310,"21 de agosto de 1994"
15,2,115,5786,166,146,312,"21 de agosto de 1994"
15,2,115,5787,309,246,555,"21 de agosto de 1994"
15,2,115,5788,172,165,337,"21 de agosto de 1994"
15,2,115,5789,224,234,458,"21 de agosto de 1994"
15,2,115,5790,239,195,434,"21 de agosto de 1994"
15,3,6,151,447,529,976,"21 de agosto de 1994"
15,3,6,152,392,476,868,"21 de agosto de 1994"
15,3,6,153,317,346,663,"21 de agosto de 1994"
15,3,6,154,376,397,773,"21 de agosto de 1994"
15,3,6,155,353,434,787,"21 de agosto de 1994"
15,3,12,247,419,455,874,"21 de agosto de 1994"
15,3,12,248,651,697,1348,"21 de agosto de 1994"
15,3,12,249,527,559,1086,"21 de agosto de 1994"
15,3,18,495,344,364,708,"21 de agosto de 1994"
15,3,18,496,358,371,729,"21 de agosto de 1994"
15,3,18,497,374,432,806,"21 de agosto de 1994"
15,3,18,498,345,367,712,"21 de agosto de 1994"
15,3,18,499,444,468,912,"21 de agosto de 1994"
15,3,18,500,719,764,1483,"21 de agosto de 1994"
15,3,18,501,511,544,1055,"21 de agosto de 1994"
15,3,18,502,633,632,1265,"21 de agosto de 1994"
15,3,18,503,289,286,575,"21 de agosto de 1994"
15,3,18,504,361,401,762,"21 de agosto de 1994"
15,3,18,505,596,676,1272,"21 de agosto de 1994"
15,3,18,506,552,568,1120,"21 de agosto de 1994"
15,3,18,507,348,344,692,"21 de agosto de 1994"
15,3,18,508,604,616,1220,"21 de agosto de 1994"
15,3,18,509,511,533,1044,"21 de agosto de 1994"
15,3,18,510,174,187,361,"21 de agosto de 1994"
15,3,19,511,695,752,1447,"21 de agosto de 1994"
15,3,19,512,754,802,1556,"21 de agosto de 1994"
15,3,19,513,709,802,1511,"21 de agosto de 1994"
15,3,19,514,570,619,1189,"21 de agosto de 1994"
15,3,19,515,592,652,1244,"21 de agosto de 1994"
15,3,19,516,441,505,946,"21 de agosto de 1994"
15,3,19,517,367,436,803,"21 de agosto de 1994"
15,3,19,518,685,662,1347,"21 de agosto de 1994"
15,3,19,519,151,164,315,"21 de agosto de 1994"
15,3,19,520,396,447,843,"21 de agosto de 1994"
15,3,19,521,260,244,504,"21 de agosto de 1994"
15,3,19,522,449,481,930,"21 de agosto de 1994"
15,3,28,1095,728,781,1509,"21 de agosto de 1994"
15,3,28,1096,409,495,904,"21 de agosto de 1994"
15,3,44,2236,733,775,1508,"21 de agosto de 1994"
15,3,44,2237,736,819,1555,"21 de agosto de 1994"
15,3,44,2238,559,620,1179,"21 de agosto de 1994"
15,3,44,2239,712,765,1477,"21 de agosto de 1994"
15,3,44,2240,463,457,920,"21 de agosto de 1994"
15,3,44,2241,264,270,534,"21 de agosto de 1994"
15,3,44,2242,74,65,139,"21 de agosto de 1994"
15,3,50,2373,411,493,904,"21 de agosto de 1994"
15,3,50,2374,538,570,1108,"21 de agosto de 1994"
15,3,50,2375,526,576,1102,"21 de agosto de 1994"
15,3,50,2376,508,517,1025,"21 de agosto de 1994"
15,3,50,2377,228,206,434,"21 de agosto de 1994"
15,3,52,2386,285,310,595,"21 de agosto de 1994"
15,3,52,2387,638,737,1375,"21 de agosto de 1994"
15,3,52,2388,934,948,1882,"21 de agosto de 1994"
15,3,52,2389,588,622,1210,"21 de agosto de 1994"
15,3,52,2390,578,600,1178,"21 de agosto de 1994"
15,3,52,2391,300,338,638,"21 de agosto de 1994"
15,3,52,2392,105,112,217,"21 de agosto de 1994"
15,3,52,2393,183,210,393,"21 de agosto de 1994"
15,3,52,2394,226,239,465,"21 de agosto de 1994"
15,3,52,2395,431,422,853,"21 de agosto de 1994"
15,3,52,2396,179,193,372,"21 de agosto de 1994"
15,3,52,2397,354,338,692,"21 de agosto de 1994"
15,3,52,2398,362,385,747,"21 de agosto de 1994"
15,3,52,2399,338,351,689,"21 de agosto de 1994"
15,3,52,2400,284,290,574,"21 de agosto de 1994"
15,3,52,2401,228,231,459,"21 de agosto de 1994"
15,3,52,2402,337,334,671,"21 de agosto de 1994"
15,3,52,2403,149,163,312,"21 de agosto de 1994"
15,3,52,2404,575,640,1215,"21 de agosto de 1994"
15,3,52,2405,519,485,1004,"21 de agosto de 1994"
15,3,52,2406,271,261,532,"21 de agosto de 1994"
15,3,52,2407,318,293,611,"21 de agosto de 1994"
15,3,52,2408,388,412,800,"21 de agosto de 1994"
15,3,52,2409,441,408,849,"21 de agosto de 1994"
15,3,52,2410,74,81,155,"21 de agosto de 1994"
15,3,52,2411,416,404,820,"21 de agosto de 1994"
15,3,52,2412,436,381,817,"21 de agosto de 1994"
15,3,52,2413,693,683,1376,"21 de agosto de 1994"
15,3,52,2414,249,255,504,"21 de agosto de 1994"
15,3,52,2415,505,481,986,"21 de agosto de 1994"
15,3,52,2416,621,626,1247,"21 de agosto de 1994"
15,3,52,2417,698,712,1410,"21 de agosto de 1994"
15,3,52,2418,714,729,1443,"21 de agosto de 1994"
15,3,52,2419,907,930,1837,"21 de agosto de 1994"
15,3,52,2420,602,612,1214,"21 de agosto de 1994"
15,3,52,2421,530,515,1045,"21 de agosto de 1994"
15,3,52,2422,261,285,546,"21 de agosto de 1994"
15,3,52,2423,77,66,143,"21 de agosto de 1994"
15,3,52,2424,680,707,1387,"21 de agosto de 1994"
15,3,52,2425,562,601,1163,"21 de agosto de 1994"
15,3,52,2426,371,303,674,"21 de agosto de 1994"
15,3,52,2427,563,548,1111,"21 de agosto de 1994"
15,3,52,2428,560,539,1099,"21 de agosto de 1994"
15,3,52,2429,568,521,1089,"21 de agosto de 1994"
15,3,52,2430,202,194,396,"21 de agosto de 1994"
15,3,52,2431,193,221,414,"21 de agosto de 1994"
15,3,56,2550,406,457,863,"21 de agosto de 1994"
15,3,56,2551,658,711,1369,"21 de agosto de 1994"
15,3,56,2552,416,434,850,"21 de agosto de 1994"
15,3,56,2553,495,547,1042,"21 de agosto de 1994"
15,3,63,3828,552,572,1124,"21 de agosto de 1994"
15,3,63,3829,389,417,806,"21 de agosto de 1994"
15,3,63,3830,606,651,1257,"21 de agosto de 1994"
15,3,63,3831,574,580,1154,"21 de agosto de 1994"
15,3,63,3832,497,508,1005,"21 de agosto de 1994"
15,3,63,3833,654,644,1298,"21 de agosto de 1994"
15,3,63,3834,484,514,998,"21 de agosto de 1994"
15,3,63,3835,560,592,1152,"21 de agosto de 1994"
15,3,63,3836,183,215,398,"21 de agosto de 1994"
15,3,63,3837,532,535,1067,"21 de agosto de 1994"
15,3,63,3838,512,607,1119,"21 de agosto de 1994"
15,3,63,3839,410,380,790,"21 de agosto de 1994"
15,3,63,3840,327,327,654,"21 de agosto de 1994"
15,3,63,3841,228,224,452,"21 de agosto de 1994"
15,3,63,3842,814,837,1651,"21 de agosto de 1994"
15,3,63,3843,486,485,971,"21 de agosto de 1994"
15,3,63,3844,492,477,969,"21 de agosto de 1994"
15,3,63,3845,772,857,1629,"21 de agosto de 1994"
15,3,63,3846,495,526,1021,"21 de agosto de 1994"
15,3,63,3847,463,453,916,"21 de agosto de 1994"
15,3,63,3848,383,406,789,"21 de agosto de 1994"
15,3,63,3849,446,462,908,"21 de agosto de 1994"
15,3,73,4018,658,702,1360,"21 de agosto de 1994"
15,3,73,4019,487,496,983,"21 de agosto de 1994"
15,3,73,4020,499,493,992,"21 de agosto de 1994"
15,3,73,4021,457,469,926,"21 de agosto de 1994"
15,3,74,4022,535,574,1109,"21 de agosto de 1994"
15,3,74,4023,652,651,1303,"21 de agosto de 1994"
15,3,74,4024,570,587,1157,"21 de agosto de 1994"
15,3,74,4025,417,401,818,"21 de agosto de 1994"
15,3,77,4121,356,357,713,"21 de agosto de 1994"
15,3,77,4122,527,579,1106,"21 de agosto de 1994"
15,3,77,4123,459,476,935,"21 de agosto de 1994"
15,3,77,4124,556,592,1148,"21 de agosto de 1994"
15,3,77,4125,522,609,1131,"21 de agosto de 1994"
15,3,77,4126,740,776,1516,"21 de agosto de 1994"
15,3,77,4127,623,652,1275,"21 de agosto de 1994"
15,3,77,4128,476,461,937,"21 de agosto de 1994"
15,3,77,4129,797,803,1600,"21 de agosto de 1994"
15,3,77,4130,638,726,1364,"21 de agosto de 1994"
15,3,77,4131,502,541,1043,"21 de agosto de 1994"
15,3,77,4132,503,524,1027,"21 de agosto de 1994"
15,3,77,4133,393,440,833,"21 de agosto de 1994"
15,3,77,4134,700,722,1422,"21 de agosto de 1994"
15,3,77,4135,1018,1079,2097,"21 de agosto de 1994"
15,3,77,4136,436,463,899,"21 de agosto de 1994"
15,3,77,4137,530,525,1055,"21 de agosto de 1994"
15,3,77,4138,571,575,1146,"21 de agosto de 1994"
15,3,77,4139,444,427,871,"21 de agosto de 1994"
15,3,77,4140,484,482,966,"21 de agosto de 1994"
15,3,77,4141,438,462,900,"21 de agosto de 1994"
15,3,77,4142,457,471,928,"21 de agosto de 1994"
15,3,77,4143,95,103,198,"21 de agosto de 1994"
15,3,91,4471,530,590,1120,"21 de agosto de 1994"
15,3,91,4472,608,668,1276,"21 de agosto de 1994"
15,3,91,4473,636,774,1410,"21 de agosto de 1994"
15,3,91,4474,642,700,1342,"21 de agosto de 1994"
15,3,91,4475,494,541,1035,"21 de agosto de 1994"
15,3,91,4476,336,409,745,"21 de agosto de 1994"
15,3,91,4477,442,540,982,"21 de agosto de 1994"
15,3,91,4478,396,478,874,"21 de agosto de 1994"
15,3,91,4479,321,371,692,"21 de agosto de 1994"
15,3,91,4480,61,82,143,"21 de agosto de 1994"
15,3,91,4481,443,433,876,"21 de agosto de 1994"
15,3,91,4482,520,564,1084,"21 de agosto de 1994"
15,3,91,4483,543,532,1075,"21 de agosto de 1994"
15,3,91,4484,439,467,906,"21 de agosto de 1994"
15,3,91,4485,367,373,740,"21 de agosto de 1994"
15,3,91,4486,326,342,668,"21 de agosto de 1994"
15,3,91,4487,261,259,520,"21 de agosto de 1994"
15,3,91,4488,676,738,1414,"21 de agosto de 1994"
15,3,91,4489,181,179,360,"21 de agosto de 1994"
15,3,91,4490,326,304,630,"21 de agosto de 1994"
15,3,91,4491,454,462,916,"21 de agosto de 1994"
15,3,91,4492,277,289,566,"21 de agosto de 1994"
15,3,91,4493,358,352,710,"21 de agosto de 1994"
15,3,91,4494,528,568,1096,"21 de agosto de 1994"
15,3,91,4495,599,672,1271,"21 de agosto de 1994"
15,3,91,4496,325,381,706,"21 de agosto de 1994"
15,3,91,4497,464,485,949,"21 de agosto de 1994"
15,3,99,4609,432,482,914,"21 de agosto de 1994"
15,3,99,4610,477,526,1003,"21 de agosto de 1994"
15,3,102,4701,739,851,1590,"21 de agosto de 1994"
15,3,102,4702,569,643,1212,"21 de agosto de 1994"
15,3,102,4703,806,928,1734,"21 de agosto de 1994"
15,3,102,4704,792,797,1589,"21 de agosto de 1994"
15,3,102,4705,710,735,1445,"21 de agosto de 1994"
15,3,102,4706,467,552,1019,"21 de agosto de 1994"
15,3,102,4707,316,335,651,"21 de agosto de 1994"
15,3,102,4708,324,368,692,"21 de agosto de 1994"
15,3,102,4709,740,785,1525,"21 de agosto de 1994"
15,3,102,4710,470,527,997,"21 de agosto de 1994"
15,3,102,4711,433,488,921,"21 de agosto de 1994"
15,3,102,4712,52,63,115,"21 de agosto de 1994"
15,3,102,4713,231,215,446,"21 de agosto de 1994"
15,3,102,4714,255,235,490,"21 de agosto de 1994"
15,3,102,4715,434,468,902,"21 de agosto de 1994"
15,3,102,4716,361,351,712,"21 de agosto de 1994"
15,3,102,4717,307,368,675,"21 de agosto de 1994"
15,3,102,4718,450,522,972,"21 de agosto de 1994"
15,3,102,4719,384,436,820,"21 de agosto de 1994"
15,3,102,4720,678,691,1369,"21 de agosto de 1994"
15,3,102,4721,280,297,577,"21 de agosto de 1994"
15,3,102,4722,431,420,851,"21 de agosto de 1994"
15,3,102,4723,286,297,583,"21 de agosto de 1994"
15,3,102,4724,290,281,571,"21 de agosto de 1994"
15,3,119,5822,443,500,943,"21 de agosto de 1994"
15,3,119,5823,365,418,783,"21 de agosto de 1994"
15,3,119,5824,401,449,850,"21 de agosto de 1994"
15,3,119,5825,401,466,867,"21 de agosto de 1994"
15,3,119,5826,600,620,1220,"21 de agosto de 1994"
15,3,119,5827,426,463,889,"21 de agosto de 1994"
15,3,119,5828,692,731,1423,"21 de agosto de 1994"
15,3,119,5829,592,653,1245,"21 de agosto de 1994"
15,3,119,5830,365,361,726,"21 de agosto de 1994"
15,3,119,5831,454,519,973,"21 de agosto de 1994"
15,3,119,5832,308,308,616,"21 de agosto de 1994"
15,3,119,5833,327,329,656,"21 de agosto de 1994"
15,3,119,5834,827,913,1740,"21 de agosto de 1994"
15,3,119,5835,742,778,1520,"21 de agosto de 1994"
15,3,119,5836,840,778,1618,"21 de agosto de 1994"
15,3,119,5837,719,794,1513,"21 de agosto de 1994"
15,3,119,5838,595,545,1140,"21 de agosto de 1994"
15,3,119,5839,688,718,1406,"21 de agosto de 1994"
15,3,119,5840,60,54,114,"21 de agosto de 1994"
15,3,119,5841,641,641,1282,"21 de agosto de 1994"
15,3,119,5842,418,470,888,"21 de agosto de 1994"
15,3,119,5843,166,159,325,"21 de agosto de 1994"
15,3,119,5844,227,235,462,"21 de agosto de 1994"
15,3,119,5845,253,276,529,"21 de agosto de 1994"
15,3,119,5846,205,214,419,"21 de agosto de 1994"
15,3,119,5847,801,860,1661,"21 de agosto de 1994"
15,3,119,5848,591,607,1198,"21 de agosto de 1994"
15,3,119,5849,890,960,1850,"21 de agosto de 1994"
15,3,119,5850,176,182,358,"21 de agosto de 1994"
15,3,119,5851,670,697,1367,"21 de agosto de 1994"
15,3,119,5852,476,481,957,"21 de agosto de 1994"
15,3,119,5853,730,806,1536,"21 de agosto de 1994"
15,3,119,5854,368,426,794,"21 de agosto de 1994"
15,3,119,5855,611,672,1283,"21 de agosto de 1994"
15,3,119,5856,545,567,1112,"21 de agosto de 1994"
15,3,119,5857,696,722,1418,"21 de agosto de 1994"
15,3,119,5858,499,539,1038,"21 de agosto de 1994"
15,3,119,5859,694,713,1407,"21 de agosto de 1994"
15,3,119,5860,814,852,1666,"21 de agosto de 1994"
15,3,119,5861,615,634,1249,"21 de agosto de 1994"
15,3,119,5862,518,538,1056,"21 de agosto de 1994"
15,3,119,5863,299,306,605,"21 de agosto de 1994"
15,3,119,5864,338,368,706,"21 de agosto de 1994"
15,3,119,5865,111,89,200,"21 de agosto de 1994"
15,3,119,5866,110,90,200,"21 de agosto de 1994"
15,3,119,5867,87,88,175,"21 de agosto de 1994"
15,3,119,5868,123,99,222,"21 de agosto de 1994"
15,4,107,5169,565,687,1252,"21 de agosto de 1994"
15,4,107,5170,740,906,1646,"21 de agosto de 1994"
15,4,107,5171,585,700,1285,"21 de agosto de 1994"
15,4,107,5172,363,398,761,"21 de agosto de 1994"
15,4,107,5173,575,722,1297,"21 de agosto de 1994"
15,4,107,5174,693,841,1534,"21 de agosto de 1994"
15,4,107,5175,518,646,1164,"21 de agosto de 1994"
15,4,107,5176,715,836,1551,"21 de agosto de 1994"
15,4,107,5177,535,665,1200,"21 de agosto de 1994"
15,4,107,5178,501,605,1106,"21 de agosto de 1994"
15,4,107,5179,503,617,1120,"21 de agosto de 1994"
15,4,107,5180,604,717,1321,"21 de agosto de 1994"
15,4,107,5181,469,583,1052,"21 de agosto de 1994"
15,4,107,5182,220,284,504,"21 de agosto de 1994"
15,4,107,5183,433,491,924,"21 de agosto de 1994"
15,4,107,5184,602,644,1246,"21 de agosto de 1994"
15,4,107,5185,740,939,1679,"21 de agosto de 1994"
15,4,107,5186,692,825,1517,"21 de agosto de 1994"
15,4,107,5187,492,561,1053,"21 de agosto de 1994"
15,4,107,5188,853,959,1812,"21 de agosto de 1994"
15,4,107,5189,434,535,969,"21 de agosto de 1994"
15,4,107,5190,533,609,1142,"21 de agosto de 1994"
15,4,107,5191,642,812,1454,"21 de agosto de 1994"
15,4,107,5192,543,678,1221,"21 de agosto de 1994"
15,4,107,5193,562,644,1206,"21 de agosto de 1994"
15,4,107,5194,229,294,523,"21 de agosto de 1994"
15,4,107,5195,87,100,187,"21 de agosto de 1994"
15,4,107,5196,168,219,387,"21 de agosto de 1994"
15,4,107,5197,182,246,428,"21 de agosto de 1994"
15,4,107,5198,621,772,1393,"21 de agosto de 1994"
15,4,107,5199,364,461,825,"21 de agosto de 1994"
15,4,107,5200,422,530,952,"21 de agosto de 1994"
15,4,107,5201,484,604,1088,"21 de agosto de 1994"
15,4,107,5202,484,581,1065,"21 de agosto de 1994"
15,4,107,5203,776,929,1705,"21 de agosto de 1994"
15,4,107,5204,68,103,171,"21 de agosto de 1994"
15,4,107,5205,352,471,823,"21 de agosto de 1994"
15,4,107,5206,409,528,937,"21 de agosto de 1994"
15,4,107,5207,330,377,707,"21 de agosto de 1994"
15,4,107,5208,139,173,312,"21 de agosto de 1994"
15,4,107,5209,119,173,292,"21 de agosto de 1994"
15,4,107,5210,222,304,526,"21 de agosto de 1994"
15,4,107,5211,216,283,499,"21 de agosto de 1994"
15,4,107,5212,198,223,421,"21 de agosto de 1994"
15,4,107,5213,379,504,883,"21 de agosto de 1994"
15,4,107,5214,519,678,1197,"21 de agosto de 1994"
15,4,107,5215,323,415,738,"21 de agosto de 1994"
15,4,107,5216,391,505,896,"21 de agosto de 1994"
15,4,107,5217,412,441,853,"21 de agosto de 1994"
15,4,107,5218,571,715,1286,"21 de agosto de 1994"
15,4,107,5219,596,753,1349,"21 de agosto de 1994"
15,4,107,5220,455,596,1051,"21 de agosto de 1994"
15,4,107,5221,355,407,762,"21 de agosto de 1994"
15,4,107,5222,432,590,1022,"21 de agosto de 1994"
15,4,107,5223,459,584,1043,"21 de agosto de 1994"
15,4,107,5224,368,489,857,"21 de agosto de 1994"
15,4,107,5225,354,503,857,"21 de agosto de 1994"
15,4,107,5226,466,652,1118,"21 de agosto de 1994"
15,4,107,5227,522,659,1181,"21 de agosto de 1994"
15,4,107,5228,472,581,1053,"21 de agosto de 1994"
15,4,107,5229,402,526,928,"21 de agosto de 1994"
15,4,107,5230,323,389,712,"21 de agosto de 1994"
15,4,107,5231,643,811,1454,"21 de agosto de 1994"
15,4,107,5232,667,854,1521,"21 de agosto de 1994"
15,4,107,5233,437,511,948,"21 de agosto de 1994"
15,4,107,5234,383,479,862,"21 de agosto de 1994"
15,4,107,5235,388,512,900,"21 de agosto de 1994"
15,4,107,5236,640,881,1521,"21 de agosto de 1994"
15,4,107,5237,505,601,1106,"21 de agosto de 1994"
15,4,107,5238,380,513,893,"21 de agosto de 1994"
15,4,107,5239,395,454,849,"21 de agosto de 1994"
15,4,107,5240,598,793,1391,"21 de agosto de 1994"
15,4,107,5241,549,699,1248,"21 de agosto de 1994"
15,4,107,5242,552,664,1216,"21 de agosto de 1994"
15,4,107,5243,499,610,1109,"21 de agosto de 1994"
15,4,107,5244,509,631,1140,"21 de agosto de 1994"
15,4,107,5245,613,806,1419,"21 de agosto de 1994"
15,4,107,5246,374,467,841,"21 de agosto de 1994"
15,4,107,5247,382,481,863,"21 de agosto de 1994"
15,4,107,5248,655,776,1431,"21 de agosto de 1994"
15,4,107,5249,410,505,915,"21 de agosto de 1994"
15,4,107,5250,446,561,1007,"21 de agosto de 1994"
15,4,107,5251,599,728,1327,"21 de agosto de 1994"
15,4,107,5252,526,673,1199,"21 de agosto de 1994"
15,4,107,5253,1062,540,1602,"21 de agosto de 1994"
15,4,107,5254,501,593,1094,"21 de agosto de 1994"
15,4,107,5255,719,786,1505,"21 de agosto de 1994"
15,4,107,5256,718,735,1453,"21 de agosto de 1994"
15,4,107,5257,474,594,1068,"21 de agosto de 1994"
15,4,107,5258,445,530,975,"21 de agosto de 1994"
15,4,107,5259,479,569,1048,"21 de agosto de 1994"
15,4,107,5260,478,545,1023,"21 de agosto de 1994"
15,4,107,5261,689,820,1509,"21 de agosto de 1994"
15,4,107,5262,571,687,1258,"21 de agosto de 1994"
15,4,107,5263,522,705,1227,"21 de agosto de 1994"
15,4,107,5264,615,710,1325,"21 de agosto de 1994"
15,4,107,5265,579,629,1208,"21 de agosto de 1994"
15,5,1,1,422,495,917,"21 de agosto de 1994"
15,5,1,2,400,468,868,"21 de agosto de 1994"
15,5,1,3,510,539,1049,"21 de agosto de 1994"
15,5,1,4,503,489,992,"21 de agosto de 1994"
15,5,1,5,384,369,753,"21 de agosto de 1994"
15,5,1,6,308,341,649,"21 de agosto de 1994"
15,5,1,7,203,238,441,"21 de agosto de 1994"
15,5,1,8,238,277,515,"21 de agosto de 1994"
15,5,1,9,227,268,495,"21 de agosto de 1994"
15,5,1,10,311,258,569,"21 de agosto de 1994"
15,5,1,11,271,258,529,"21 de agosto de 1994"
15,5,1,12,296,258,554,"21 de agosto de 1994"
15,5,1,13,455,415,870,"21 de agosto de 1994"
15,5,1,14,542,453,995,"21 de agosto de 1994"
15,5,1,15,428,339,767,"21 de agosto de 1994"
15,5,1,16,316,349,665,"21 de agosto de 1994"
15,5,1,17,363,390,753,"21 de agosto de 1994"
15,5,1,18,171,196,367,"21 de agosto de 1994"
15,5,1,19,511,520,1031,"21 de agosto de 1994"
15,5,1,20,563,517,1080,"21 de agosto de 1994"
15,5,1,21,333,357,690,"21 de agosto de 1994"
15,5,1,22,369,390,759,"21 de agosto de 1994"
15,5,1,23,206,211,417,"21 de agosto de 1994"
15,5,1,24,438,376,814,"21 de agosto de 1994"
15,5,1,25,210,239,449,"21 de agosto de 1994"
15,5,1,26,417,407,824,"21 de agosto de 1994"
15,5,1,27,400,355,755,"21 de agosto de 1994"
15,5,1,28,363,298,661,"21 de agosto de 1994"
15,5,1,29,276,292,568,"21 de agosto de 1994"
15,5,1,30,300,322,622,"21 de agosto de 1994"
15,5,1,31,411,442,853,"21 de agosto de 1994"
15,5,1,32,341,332,673,"21 de agosto de 1994"
15,5,3,59,439,539,978,"21 de agosto de 1994"
15,5,3,60,367,336,703,"21 de agosto de 1994"
15,5,3,61,293,270,563,"21 de agosto de 1994"
15,5,3,62,361,273,634,"21 de agosto de 1994"
15,5,3,63,305,310,615,"21 de agosto de 1994"
15,5,3,64,202,218,420,"21 de agosto de 1994"
15,5,3,65,272,263,535,"21 de agosto de 1994"
15,5,3,66,373,376,749,"21 de agosto de 1994"
15,5,3,67,458,441,899,"21 de agosto de 1994"
15,5,3,68,337,304,641,"21 de agosto de 1994"
15,5,3,69,553,551,1104,"21 de agosto de 1994"
15,5,3,70,647,646,1293,"21 de agosto de 1994"
15,5,3,71,167,149,316,"21 de agosto de 1994"
15,5,3,72,607,649,1256,"21 de agosto de 1994"
15,5,3,73,305,302,607,"21 de agosto de 1994"
15,5,3,74,314,284,598,"21 de agosto de 1994"
15,5,3,75,505,418,923,"21 de agosto de 1994"
15,5,3,76,368,272,640,"21 de agosto de 1994"
15,5,3,77,422,342,764,"21 de agosto de 1994"
15,5,3,78,136,127,263,"21 de agosto de 1994"
15,5,3,79,53,41,94,"21 de agosto de 1994"
15,5,3,80,235,185,420,"21 de agosto de 1994"
15,5,3,81,263,278,541,"21 de agosto de 1994"
15,5,14,417,726,909,1635,"21 de agosto de 1994"
15,5,14,418,456,506,962,"21 de agosto de 1994"
15,5,14,419,361,477,838,"21 de agosto de 1994"
15,5,14,420,452,533,985,"21 de agosto de 1994"
15,5,14,421,317,359,676,"21 de agosto de 1994"
15,5,14,422,725,854,1579,"21 de agosto de 1994"
15,5,14,423,578,721,1299,"21 de agosto de 1994"
15,5,14,424,375,411,786,"21 de agosto de 1994"
15,5,14,425,265,275,540,"21 de agosto de 1994"
15,5,14,426,302,346,648,"21 de agosto de 1994"
15,5,14,427,213,247,460,"21 de agosto de 1994"
15,5,14,428,264,255,519,"21 de agosto de 1994"
15,5,14,429,221,246,467,"21 de agosto de 1994"
15,5,14,430,409,433,842,"21 de agosto de 1994"
15,5,14,431,751,750,1501,"21 de agosto de 1994"
15,5,14,432,157,164,321,"21 de agosto de 1994"
15,5,14,433,335,329,664,"21 de agosto de 1994"
15,5,14,434,293,320,613,"21 de agosto de 1994"
15,5,14,435,378,372,750,"21 de agosto de 1994"
15,5,14,436,376,370,746,"21 de agosto de 1994"
15,5,14,437,371,430,801,"21 de agosto de 1994"
15,5,14,438,153,181,334,"21 de agosto de 1994"
15,5,14,439,109,119,228,"21 de agosto de 1994"
15,5,14,440,464,525,989,"21 de agosto de 1994"
15,5,14,441,214,228,442,"21 de agosto de 1994"
15,5,14,442,466,553,1019,"21 de agosto de 1994"
15,5,14,443,516,587,1103,"21 de agosto de 1994"
15,5,14,444,294,305,599,"21 de agosto de 1994"
15,5,14,445,598,642,1240,"21 de agosto de 1994"
15,5,14,446,331,411,742,"21 de agosto de 1994"
15,5,14,447,208,205,413,"21 de agosto de 1994"
15,5,14,448,234,202,436,"21 de agosto de 1994"
15,5,14,449,72,76,148,"21 de agosto de 1994"
15,5,14,450,289,275,564,"21 de agosto de 1994"
15,5,14,451,105,98,203,"21 de agosto de 1994"
15,5,14,452,92,101,193,"21 de agosto de 1994"
15,5,14,453,192,180,372,"21 de agosto de 1994"
15,5,14,454,109,105,214,"21 de agosto de 1994"
15,5,14,455,73,92,165,"21 de agosto de 1994"
15,5,27,1081,520,523,1043,"21 de agosto de 1994"
15,5,27,1082,285,303,588,"21 de agosto de 1994"
15,5,27,1083,474,492,966,"21 de agosto de 1994"
15,5,27,1084,256,223,479,"21 de agosto de 1994"
15,5,27,1085,743,688,1431,"21 de agosto de 1994"
15,5,27,1086,455,400,855,"21 de agosto de 1994"
15,5,27,1087,284,318,602,"21 de agosto de 1994"
15,5,27,1088,202,198,400,"21 de agosto de 1994"
15,5,27,1089,249,220,469,"21 de agosto de 1994"
15,5,27,1090,338,322,660,"21 de agosto de 1994"
15,5,27,1091,274,226,500,"21 de agosto de 1994"
15,5,27,1092,218,188,406,"21 de agosto de 1994"
15,5,27,1093,175,162,337,"21 de agosto de 1994"
15,5,27,1094,96,73,169,"21 de agosto de 1994"
15,5,46,2260,503,595,1098,"21 de agosto de 1994"
15,5,46,2261,363,445,808,"21 de agosto de 1994"
15,5,46,2262,278,295,573,"21 de agosto de 1994"
15,5,46,2263,442,478,920,"21 de agosto de 1994"
15,5,46,2264,396,451,847,"21 de agosto de 1994"
15,5,46,2265,348,395,743,"21 de agosto de 1994"
15,5,46,2266,75,60,135,"21 de agosto de 1994"
15,5,46,2267,506,437,943,"21 de agosto de 1994"
15,5,46,2268,122,154,276,"21 de agosto de 1994"
15,5,46,2269,524,481,1005,"21 de agosto de 1994"
15,5,46,2270,36,34,70,"21 de agosto de 1994"
15,5,46,2271,313,294,607,"21 de agosto de 1994"
15,5,46,2272,254,231,485,"21 de agosto de 1994"
15,5,46,2273,349,365,714,"21 de agosto de 1994"
15,5,46,2274,288,240,528,"21 de agosto de 1994"
15,5,46,2275,446,443,889,"21 de agosto de 1994"
15,5,46,2276,186,169,355,"21 de agosto de 1994"
15,5,46,2277,570,521,1091,"21 de agosto de 1994"
15,5,46,2278,90,82,172,"21 de agosto de 1994"
15,5,46,2279,127,117,244,"21 de agosto de 1994"
15,5,46,2280,366,323,689,"21 de agosto de 1994"
15,5,46,2281,441,359,800,"21 de agosto de 1994"
15,5,46,2282,368,377,745,"21 de agosto de 1994"
15,5,46,2283,363,368,731,"21 de agosto de 1994"
15,5,46,2284,166,167,333,"21 de agosto de 1994"
15,5,46,2285,284,225,509,"21 de agosto de 1994"
15,5,46,2286,323,302,625,"21 de agosto de 1994"
15,5,46,2287,947,920,1867,"21 de agosto de 1994"
15,5,46,2288,391,370,761,"21 de agosto de 1994"
15,5,46,2289,470,424,894,"21 de agosto de 1994"
15,5,46,2290,235,229,464,"21 de agosto de 1994"
15,5,46,2291,593,593,1186,"21 de agosto de 1994"
15,5,46,2292,355,369,724,"21 de agosto de 1994"
15,5,46,2293,308,282,590,"21 de agosto de 1994"
15,5,46,2294,194,146,340,"21 de agosto de 1994"
15,5,46,2295,390,426,816,"21 de agosto de 1994"
15,5,46,2296,491,479,970,"21 de agosto de 1994"
15,5,46,2297,286,264,550,"21 de agosto de 1994"
15,5,46,2298,449,433,882,"21 de agosto de 1994"
15,5,46,2299,183,175,358,"21 de agosto de 1994"
15,5,46,2300,132,118,250,"21 de agosto de 1994"
15,5,46,2301,241,261,502,"21 de agosto de 1994"
15,5,46,2302,104,104,208,"21 de agosto de 1994"
15,5,46,2303,115,108,223,"21 de agosto de 1994"
15,5,49,2344,415,457,872,"21 de agosto de 1994"
15,5,49,2345,201,203,404,"21 de agosto de 1994"
15,5,49,2346,329,352,681,"21 de agosto de 1994"
15,5,49,2347,317,361,678,"21 de agosto de 1994"
15,5,49,2348,528,568,1096,"21 de agosto de 1994"
15,5,49,2349,278,324,602,"21 de agosto de 1994"
15,5,49,2350,561,605,1166,"21 de agosto de 1994"
15,5,49,2351,246,260,506,"21 de agosto de 1994"
15,5,49,2352,480,546,1026,"21 de agosto de 1994"
15,5,49,2353,428,491,919,"21 de agosto de 1994"
15,5,49,2354,320,353,673,"21 de agosto de 1994"
15,5,49,2355,391,399,790,"21 de agosto de 1994"
15,5,49,2356,466,501,967,"21 de agosto de 1994"
15,5,49,2357,385,435,820,"21 de agosto de 1994"
15,5,49,2358,337,305,642,"21 de agosto de 1994"
15,5,49,2359,423,441,864,"21 de agosto de 1994"
15,5,49,2360,295,282,577,"21 de agosto de 1994"
15,5,49,2361,402,389,791,"21 de agosto de 1994"
15,5,49,2362,370,385,755,"21 de agosto de 1994"
15,5,49,2363,124,118,242,"21 de agosto de 1994"
15,5,49,2364,396,408,804,"21 de agosto de 1994"
15,5,49,2365,216,215,431,"21 de agosto de 1994"
15,5,49,2366,447,442,889,"21 de agosto de 1994"
15,5,49,2367,511,495,1006,"21 de agosto de 1994"
15,5,49,2368,352,351,703,"21 de agosto de 1994"
15,5,49,2369,457,491,948,"21 de agosto de 1994"
15,5,49,2370,337,372,709,"21 de agosto de 1994"
15,5,49,2371,391,434,825,"21 de agosto de 1994"
15,5,49,2372,302,299,601,"21 de agosto de 1994"
15,5,57,2554,282,341,623,"21 de agosto de 1994"
15,5,57,2555,289,348,637,"21 de agosto de 1994"
15,5,57,2556,218,282,500,"21 de agosto de 1994"
15,5,57,2557,313,335,648,"21 de agosto de 1994"
15,5,57,2558,291,330,621,"21 de agosto de 1994"
15,5,57,2559,166,191,357,"21 de agosto de 1994"
15,5,57,2560,397,420,817,"21 de agosto de 1994"
15,5,57,2561,383,458,841,"21 de agosto de 1994"
15,5,57,2562,156,195,351,"21 de agosto de 1994"
15,5,57,2563,160,209,369,"21 de agosto de 1994"
15,5,57,2564,507,475,982,"21 de agosto de 1994"
15,5,57,2565,335,334,669,"21 de agosto de 1994"
15,5,57,2566,214,219,433,"21 de agosto de 1994"
15,5,57,2567,165,155,320,"21 de agosto de 1994"
15,5,57,2568,453,374,827,"21 de agosto de 1994"
15,5,57,2569,136,138,274,"21 de agosto de 1994"
15,5,57,2570,302,297,599,"21 de agosto de 1994"
15,5,57,2571,488,516,1004,"21 de agosto de 1994"
15,5,65,3863,185,213,398,"21 de agosto de 1994"
15,5,65,3864,484,555,1039,"21 de agosto de 1994"
15,5,65,3865,322,405,727,"21 de agosto de 1994"
15,5,65,3866,468,452,920,"21 de agosto de 1994"
15,5,65,3867,540,609,1149,"21 de agosto de 1994"
15,5,65,3868,431,385,816,"21 de agosto de 1994"
15,5,65,3869,630,613,1243,"21 de agosto de 1994"
15,5,65,3870,519,544,1063,"21 de agosto de 1994"
15,5,65,3871,236,297,533,"21 de agosto de 1994"
15,5,65,3872,176,210,386,"21 de agosto de 1994"
15,5,65,3873,383,430,813,"21 de agosto de 1994"
15,5,65,3874,532,595,1127,"21 de agosto de 1994"
15,5,65,3875,396,378,774,"21 de agosto de 1994"
15,5,65,3876,232,253,485,"21 de agosto de 1994"
15,5,65,3877,336,378,714,"21 de agosto de 1994"
15,5,65,3878,70,76,146,"21 de agosto de 1994"
15,5,65,3879,55,61,116,"21 de agosto de 1994"
15,5,72,4008,589,579,1168,"21 de agosto de 1994"
15,5,72,4009,626,642,1268,"21 de agosto de 1994"
15,5,72,4010,283,266,549,"21 de agosto de 1994"
15,5,72,4011,399,375,774,"21 de agosto de 1994"
15,5,72,4012,198,202,400,"21 de agosto de 1994"
15,5,72,4013,283,263,546,"21 de agosto de 1994"
15,5,72,4014,238,251,489,"21 de agosto de 1994"
15,5,72,4015,244,232,476,"21 de agosto de 1994"
15,5,72,4016,207,189,396,"21 de agosto de 1994"
15,5,72,4017,126,94,220,"21 de agosto de 1994"
15,5,80,4158,768,759,1527,"21 de agosto de 1994"
15,5,80,4159,256,257,513,"21 de agosto de 1994"
15,5,80,4160,241,198,439,"21 de agosto de 1994"
15,5,80,4161,383,367,750,"21 de agosto de 1994"
15,5,80,4162,385,345,730,"21 de agosto de 1994"
15,5,80,4163,144,127,271,"21 de agosto de 1994"
15,5,80,4164,86,85,171,"21 de agosto de 1994"
15,5,86,4346,404,460,864,"21 de agosto de 1994"
15,5,86,4347,336,391,727,"21 de agosto de 1994"
15,5,86,4348,373,421,794,"21 de agosto de 1994"
15,5,86,4349,412,466,878,"21 de agosto de 1994"
15,5,86,4350,329,358,687,"21 de agosto de 1994"
15,5,86,4351,490,533,1023,"21 de agosto de 1994"
15,5,86,4352,325,298,623,"21 de agosto de 1994"
15,5,86,4353,362,330,692,"21 de agosto de 1994"
15,5,86,4354,466,475,941,"21 de agosto de 1994"
15,5,86,4355,253,269,522,"21 de agosto de 1994"
15,5,86,4356,604,625,1229,"21 de agosto de 1994"
15,5,86,4357,332,310,642,"21 de agosto de 1994"
15,5,86,4358,491,499,990,"21 de agosto de 1994"
15,5,86,4359,545,525,1070,"21 de agosto de 1994"
15,5,86,4360,410,428,838,"21 de agosto de 1994"
15,5,86,4361,335,309,644,"21 de agosto de 1994"
15,5,86,4362,358,340,698,"21 de agosto de 1994"
15,5,86,4363,413,394,807,"21 de agosto de 1994"
15,5,86,4364,392,338,730,"21 de agosto de 1994"
15,5,86,4365,339,331,670,"21 de agosto de 1994"
15,5,86,4366,215,202,417,"21 de agosto de 1994"
15,5,86,4367,424,433,857,"21 de agosto de 1994"
15,5,86,4368,113,113,226,"21 de agosto de 1994"
15,5,86,4369,638,573,1211,"21 de agosto de 1994"
15,5,86,4370,158,147,305,"21 de agosto de 1994"
15,5,86,4371,279,292,571,"21 de agosto de 1994"
15,5,86,4372,362,382,744,"21 de agosto de 1994"
15,5,86,4373,442,403,845,"21 de agosto de 1994"
15,5,86,4374,313,375,688,"21 de agosto de 1994"
15,5,86,4375,374,405,779,"21 de agosto de 1994"
15,5,86,4376,701,750,1451,"21 de agosto de 1994"
15,5,86,4377,199,236,435,"21 de agosto de 1994"
15,5,86,4378,435,472,907,"21 de agosto de 1994"
15,5,86,4379,153,150,303,"21 de agosto de 1994"
15,5,103,4725,336,361,697,"21 de agosto de 1994"
15,5,103,4726,320,300,620,"21 de agosto de 1994"
15,5,103,4727,375,339,714,"21 de agosto de 1994"
15,5,103,4728,305,278,583,"21 de agosto de 1994"
15,5,103,4729,395,363,758,"21 de agosto de 1994"
15,5,103,4730,315,299,614,"21 de agosto de 1994"
15,5,103,4731,562,558,1120,"21 de agosto de 1994"
15,5,103,4732,212,211,423,"21 de agosto de 1994"
15,5,103,4733,441,410,851,"21 de agosto de 1994"
15,5,103,4734,95,75,170,"21 de agosto de 1994"
15,5,103,4735,48,55,103,"21 de agosto de 1994"
15,6,23,654,798,832,1630,"21 de agosto de 1994"
15,6,23,655,729,735,1464,"21 de agosto de 1994"
15,6,23,656,763,761,1524,"21 de agosto de 1994"
15,6,23,657,623,597,1220,"21 de agosto de 1994"
15,6,23,658,845,891,1736,"21 de agosto de 1994"
15,6,23,659,350,381,731,"21 de agosto de 1994"
15,6,23,660,550,567,1117,"21 de agosto de 1994"
15,6,23,661,582,590,1172,"21 de agosto de 1994"
15,6,23,662,524,494,1018,"21 de agosto de 1994"
15,6,23,663,488,496,984,"21 de agosto de 1994"
15,6,23,664,884,904,1788,"21 de agosto de 1994"
15,6,24,665,378,414,792,"21 de agosto de 1994"
15,6,24,666,605,692,1297,"21 de agosto de 1994"
15,6,24,667,689,760,1449,"21 de agosto de 1994"
15,6,24,668,576,702,1278,"21 de agosto de 1994"
15,6,24,669,661,763,1424,"21 de agosto de 1994"
15,6,24,670,680,730,1410,"21 de agosto de 1994"
15,6,24,671,557,604,1161,"21 de agosto de 1994"
15,6,24,672,531,583,1114,"21 de agosto de 1994"
15,6,24,673,429,466,895,"21 de agosto de 1994"
15,6,24,674,413,549,962,"21 de agosto de 1994"
15,6,24,675,681,780,1461,"21 de agosto de 1994"
15,6,24,676,404,425,829,"21 de agosto de 1994"
15,6,24,677,432,485,917,"21 de agosto de 1994"
15,6,24,678,489,535,1024,"21 de agosto de 1994"
15,6,24,679,425,474,899,"21 de agosto de 1994"
15,6,24,680,643,675,1318,"21 de agosto de 1994"
15,6,24,681,324,380,704,"21 de agosto de 1994"
15,6,24,682,256,270,526,"21 de agosto de 1994"
15,6,24,683,211,222,433,"21 de agosto de 1994"
15,6,24,684,298,340,638,"21 de agosto de 1994"
15,6,24,685,428,451,879,"21 de agosto de 1994"
15,6,24,686,224,215,439,"21 de agosto de 1994"
15,6,24,687,437,485,922,"21 de agosto de 1994"
15,6,24,688,465,499,964,"21 de agosto de 1994"
15,6,24,689,646,662,1308,"21 de agosto de 1994"
15,6,24,690,602,629,1231,"21 de agosto de 1994"
15,6,24,691,495,508,1003,"21 de agosto de 1994"
15,6,25,692,410,498,908,"21 de agosto de 1994"
15,6,25,693,966,959,1925,"21 de agosto de 1994"
15,6,25,694,590,684,1274,"21 de agosto de 1994"
15,6,25,695,483,532,1015,"21 de agosto de 1994"
15,6,25,696,446,519,965,"21 de agosto de 1994"
15,6,25,697,538,555,1093,"21 de agosto de 1994"
15,6,25,698,599,624,1223,"21 de agosto de 1994"
15,6,25,699,467,520,987,"21 de agosto de 1994"
15,6,25,700,537,562,1099,"21 de agosto de 1994"
15,6,25,701,421,461,882,"21 de agosto de 1994"
15,6,25,702,393,474,867,"21 de agosto de 1994"
15,6,25,703,327,343,670,"21 de agosto de 1994"
15,6,25,704,626,685,1311,"21 de agosto de 1994"
15,6,25,705,514,519,1033,"21 de agosto de 1994"
15,6,25,706,558,580,1138,"21 de agosto de 1994"
15,6,25,707,229,251,480,"21 de agosto de 1994"
15,6,25,708,325,337,662,"21 de agosto de 1994"
15,6,25,709,388,471,859,"21 de agosto de 1994"
15,6,25,710,390,446,836,"21 de agosto de 1994"
15,6,25,711,495,567,1062,"21 de agosto de 1994"
15,6,25,712,111,142,253,"21 de agosto de 1994"
15,6,25,713,322,375,697,"21 de agosto de 1994"
15,6,25,714,558,634,1192,"21 de agosto de 1994"
15,6,25,715,332,397,729,"21 de agosto de 1994"
15,6,25,716,398,454,852,"21 de agosto de 1994"
15,6,25,717,263,297,560,"21 de agosto de 1994"
15,6,25,718,575,648,1223,"21 de agosto de 1994"
15,6,25,719,528,557,1085,"21 de agosto de 1994"
15,6,25,720,409,496,905,"21 de agosto de 1994"
15,6,25,721,80,107,187,"21 de agosto de 1994"
15,6,25,722,469,534,1003,"21 de agosto de 1994"
15,6,25,723,382,481,863,"21 de agosto de 1994"
15,6,25,724,490,498,988,"21 de agosto de 1994"
15,6,25,725,633,686,1319,"21 de agosto de 1994"
15,6,25,726,366,381,747,"21 de agosto de 1994"
15,6,25,727,531,571,1102,"21 de agosto de 1994"
15,6,25,728,346,411,757,"21 de agosto de 1994"
15,6,25,729,377,413,790,"21 de agosto de 1994"
15,6,25,730,791,851,1642,"21 de agosto de 1994"
15,6,25,731,735,801,1536,"21 de agosto de 1994"
15,6,25,732,402,446,848,"21 de agosto de 1994"
15,6,25,733,294,349,643,"21 de agosto de 1994"
15,6,25,734,605,654,1259,"21 de agosto de 1994"
15,6,25,735,494,563,1057,"21 de agosto de 1994"
15,6,25,736,429,470,899,"21 de agosto de 1994"
15,6,25,737,491,542,1033,"21 de agosto de 1994"
15,6,25,738,518,549,1067,"21 de agosto de 1994"
15,6,25,739,427,471,898,"21 de agosto de 1994"
15,6,25,740,282,318,600,"21 de agosto de 1994"
15,6,25,741,480,544,1024,"21 de agosto de 1994"
15,6,25,742,266,315,581,"21 de agosto de 1994"
15,6,25,743,306,324,630,"21 de agosto de 1994"
15,6,25,744,389,456,845,"21 de agosto de 1994"
15,6,25,745,422,441,863,"21 de agosto de 1994"
15,6,25,746,714,789,1503,"21 de agosto de 1994"
15,6,25,747,589,688,1277,"21 de agosto de 1994"
15,6,25,748,275,291,566,"21 de agosto de 1994"
15,6,25,749,280,321,601,"21 de agosto de 1994"
15,6,25,750,321,392,713,"21 de agosto de 1994"
15,6,25,751,346,376,722,"21 de agosto de 1994"
15,6,25,752,346,400,746,"21 de agosto de 1994"
15,6,25,753,310,363,673,"21 de agosto de 1994"
15,6,25,754,533,572,1105,"21 de agosto de 1994"
15,6,25,755,592,672,1264,"21 de agosto de 1994"
15,6,25,756,507,570,1077,"21 de agosto de 1994"
15,6,25,757,231,287,518,"21 de agosto de 1994"
15,6,25,758,614,663,1277,"21 de agosto de 1994"
15,6,25,759,343,393,736,"21 de agosto de 1994"
15,6,25,760,589,656,1245,"21 de agosto de 1994"
15,6,25,761,463,481,944,"21 de agosto de 1994"
15,6,25,762,482,581,1063,"21 de agosto de 1994"
15,6,25,763,243,296,539,"21 de agosto de 1994"
15,6,25,764,296,334,630,"21 de agosto de 1994"
15,6,25,765,538,582,1120,"21 de agosto de 1994"
15,6,25,766,456,496,952,"21 de agosto de 1994"
15,6,25,767,508,558,1066,"21 de agosto de 1994"
15,6,25,768,437,522,959,"21 de agosto de 1994"
15,6,25,769,439,514,953,"21 de agosto de 1994"
15,6,25,770,499,580,1079,"21 de agosto de 1994"
15,6,25,771,326,354,680,"21 de agosto de 1994"
15,6,25,772,199,231,430,"21 de agosto de 1994"
15,6,25,773,264,304,568,"21 de agosto de 1994"
15,6,25,774,284,317,601,"21 de agosto de 1994"
15,6,25,775,233,293,526,"21 de agosto de 1994"
15,6,25,776,230,266,496,"21 de agosto de 1994"
15,6,25,777,222,263,485,"21 de agosto de 1994"
15,6,25,778,229,248,477,"21 de agosto de 1994"
15,6,25,779,593,659,1252,"21 de agosto de 1994"
15,6,25,780,413,502,915,"21 de agosto de 1994"
15,6,25,781,422,460,882,"21 de agosto de 1994"
15,6,25,782,438,500,938,"21 de agosto de 1994"
15,6,25,783,623,705,1328,"21 de agosto de 1994"
15,6,25,784,563,625,1188,"21 de agosto de 1994"
15,6,25,785,474,558,1032,"21 de agosto de 1994"
15,6,25,786,285,331,616,"21 de agosto de 1994"
15,6,25,787,525,573,1098,"21 de agosto de 1994"
15,6,25,788,364,443,807,"21 de agosto de 1994"
15,6,25,789,444,504,948,"21 de agosto de 1994"
15,6,25,790,448,475,923,"21 de agosto de 1994"
15,6,25,791,602,677,1279,"21 de agosto de 1994"
15,6,25,792,739,865,1604,"21 de agosto de 1994"
15,6,25,793,485,507,992,"21 de agosto de 1994"
15,6,25,794,588,634,1222,"21 de agosto de 1994"
15,6,25,795,393,503,896,"21 de agosto de 1994"
15,6,25,796,374,508,882,"21 de agosto de 1994"
15,6,25,797,437,524,961,"21 de agosto de 1994"
15,6,25,798,779,880,1659,"21 de agosto de 1994"
15,6,25,799,488,580,1068,"21 de agosto de 1994"
15,6,25,800,551,638,1189,"21 de agosto de 1994"
15,6,25,801,426,461,887,"21 de agosto de 1994"
15,6,25,802,875,953,1828,"21 de agosto de 1994"
15,6,25,803,222,282,504,"21 de agosto de 1994"
15,6,25,804,509,568,1077,"21 de agosto de 1994"
15,6,25,805,304,366,670,"21 de agosto de 1994"
15,6,25,806,374,419,793,"21 de agosto de 1994"
15,6,25,807,339,405,744,"21 de agosto de 1994"
15,6,25,808,544,630,1174,"21 de agosto de 1994"
15,6,25,809,646,736,1382,"21 de agosto de 1994"
15,6,25,810,190,240,430,"21 de agosto de 1994"
15,6,25,811,303,350,653,"21 de agosto de 1994"
15,6,25,812,326,430,756,"21 de agosto de 1994"
15,6,25,813,502,583,1085,"21 de agosto de 1994"
15,6,25,814,167,194,361,"21 de agosto de 1994"
15,6,25,815,663,736,1399,"21 de agosto de 1994"
15,6,25,816,506,596,1102,"21 de agosto de 1994"
15,6,25,817,442,498,940,"21 de agosto de 1994"
15,6,25,818,531,582,1113,"21 de agosto de 1994"
15,6,25,819,527,565,1092,"21 de agosto de 1994"
15,6,25,820,296,352,648,"21 de agosto de 1994"
15,6,25,821,357,401,758,"21 de agosto de 1994"
15,6,25,822,296,328,624,"21 de agosto de 1994"
15,6,25,823,288,338,626,"21 de agosto de 1994"
15,6,25,824,324,351,675,"21 de agosto de 1994"
15,6,25,825,477,565,1042,"21 de agosto de 1994"
15,6,25,826,212,219,431,"21 de agosto de 1994"
15,6,25,827,398,469,867,"21 de agosto de 1994"
15,6,25,828,513,597,1110,"21 de agosto de 1994"
15,6,25,829,392,418,810,"21 de agosto de 1994"
15,6,25,830,304,341,645,"21 de agosto de 1994"
15,6,25,831,304,338,642,"21 de agosto de 1994"
15,6,25,832,254,321,575,"21 de agosto de 1994"
15,6,25,833,283,340,623,"21 de agosto de 1994"
15,6,25,834,372,410,782,"21 de agosto de 1994"
15,6,25,835,325,362,687,"21 de agosto de 1994"
15,6,25,836,291,334,625,"21 de agosto de 1994"
15,6,25,837,612,674,1286,"21 de agosto de 1994"
15,6,25,838,240,312,552,"21 de agosto de 1994"
15,6,25,839,226,306,532,"21 de agosto de 1994"
15,6,25,840,527,662,1189,"21 de agosto de 1994"
15,6,25,841,339,381,720,"21 de agosto de 1994"
15,6,25,842,253,301,554,"21 de agosto de 1994"
15,6,25,843,318,358,676,"21 de agosto de 1994"
15,6,25,844,224,244,468,"21 de agosto de 1994"
15,6,25,845,330,349,679,"21 de agosto de 1994"
15,6,25,846,281,280,561,"21 de agosto de 1994"
15,6,25,847,295,357,652,"21 de agosto de 1994"
15,6,25,848,451,491,942,"21 de agosto de 1994"
15,6,25,849,444,557,1001,"21 de agosto de 1994"
15,6,25,850,1144,1367,2511,"21 de agosto de 1994"
15,6,25,851,583,721,1304,"21 de agosto de 1994"
15,6,25,852,276,315,591,"21 de agosto de 1994"
15,6,25,853,500,522,1022,"21 de agosto de 1994"
15,6,25,854,460,520,980,"21 de agosto de 1994"
15,6,25,855,379,398,777,"21 de agosto de 1994"
15,6,25,856,412,427,839,"21 de agosto de 1994"
15,6,25,857,690,728,1418,"21 de agosto de 1994"
15,6,25,858,230,271,501,"21 de agosto de 1994"
15,6,25,859,420,439,859,"21 de agosto de 1994"
15,6,25,860,335,355,690,"21 de agosto de 1994"
15,6,25,861,321,350,671,"21 de agosto de 1994"
15,6,25,862,318,340,658,"21 de agosto de 1994"
15,6,25,863,389,433,822,"21 de agosto de 1994"
15,6,25,864,485,489,974,"21 de agosto de 1994"
15,6,25,865,428,458,886,"21 de agosto de 1994"
15,6,25,866,471,480,951,"21 de agosto de 1994"
15,6,25,867,823,839,1662,"21 de agosto de 1994"
15,6,25,868,526,597,1123,"21 de agosto de 1994"
15,6,25,869,595,636,1231,"21 de agosto de 1994"
15,6,25,870,585,600,1185,"21 de agosto de 1994"
15,6,25,871,473,490,963,"21 de agosto de 1994"
15,6,25,872,333,374,707,"21 de agosto de 1994"
15,6,25,873,483,546,1029,"21 de agosto de 1994"
15,6,25,874,445,498,943,"21 de agosto de 1994"
15,6,25,875,563,619,1182,"21 de agosto de 1994"
15,6,25,876,311,373,684,"21 de agosto de 1994"
15,6,25,877,203,248,451,"21 de agosto de 1994"
15,6,25,878,362,383,745,"21 de agosto de 1994"
15,6,25,879,436,482,918,"21 de agosto de 1994"
15,6,25,880,335,369,704,"21 de agosto de 1994"
15,6,25,881,608,705,1313,"21 de agosto de 1994"
15,6,25,882,695,838,1533,"21 de agosto de 1994"
15,6,25,883,372,439,811,"21 de agosto de 1994"
15,6,25,884,638,705,1343,"21 de agosto de 1994"
15,6,25,885,829,878,1707,"21 de agosto de 1994"
15,6,25,886,554,582,1136,"21 de agosto de 1994"
15,6,25,887,839,850,1689,"21 de agosto de 1994"
15,6,25,888,420,476,896,"21 de agosto de 1994"
15,6,25,889,515,640,1155,"21 de agosto de 1994"
15,6,25,890,242,297,539,"21 de agosto de 1994"
15,6,25,891,141,164,305,"21 de agosto de 1994"
15,6,25,892,147,167,314,"21 de agosto de 1994"
15,6,25,893,454,526,980,"21 de agosto de 1994"
15,6,25,894,586,708,1294,"21 de agosto de 1994"
15,6,25,895,474,523,997,"21 de agosto de 1994"
15,6,25,896,424,473,897,"21 de agosto de 1994"
15,6,25,897,493,574,1067,"21 de agosto de 1994"
15,6,25,898,328,433,761,"21 de agosto de 1994"
15,6,25,899,436,547,983,"21 de agosto de 1994"
15,6,25,900,609,674,1283,"21 de agosto de 1994"
15,6,25,901,197,243,440,"21 de agosto de 1994"
15,6,25,902,858,900,1758,"21 de agosto de 1994"
15,6,25,903,615,675,1290,"21 de agosto de 1994"
15,6,25,904,552,596,1148,"21 de agosto de 1994"
15,6,25,905,679,728,1407,"21 de agosto de 1994"
15,6,25,906,486,522,1008,"21 de agosto de 1994"
15,6,25,907,619,637,1256,"21 de agosto de 1994"
15,6,25,908,415,425,840,"21 de agosto de 1994"
15,6,25,909,663,675,1338,"21 de agosto de 1994"
15,6,25,910,755,841,1596,"21 de agosto de 1994"
15,6,25,911,526,540,1066,"21 de agosto de 1994"
15,6,36,1956,473,487,960,"21 de agosto de 1994"
15,6,36,1957,427,453,880,"21 de agosto de 1994"
15,6,36,1958,326,353,679,"21 de agosto de 1994"
15,6,36,1959,813,746,1559,"21 de agosto de 1994"
15,6,36,1960,537,514,1051,"21 de agosto de 1994"
15,6,36,1961,307,337,644,"21 de agosto de 1994"
15,6,36,1962,587,606,1193,"21 de agosto de 1994"
15,6,36,1963,281,294,575,"21 de agosto de 1994"
15,6,36,1964,205,220,425,"21 de agosto de 1994"
15,6,36,1965,114,103,217,"21 de agosto de 1994"
15,6,36,1966,158,141,299,"21 de agosto de 1994"
15,6,36,1967,596,637,1233,"21 de agosto de 1994"
15,6,36,1968,555,567,1122,"21 de agosto de 1994"
15,6,36,1969,426,470,896,"21 de agosto de 1994"
15,6,36,1970,479,504,983,"21 de agosto de 1994"
15,6,36,1971,446,480,926,"21 de agosto de 1994"
15,6,36,1972,304,380,684,"21 de agosto de 1994"
15,6,36,1973,394,431,825,"21 de agosto de 1994"
15,6,36,1974,311,351,662,"21 de agosto de 1994"
15,6,36,1975,363,417,780,"21 de agosto de 1994"
15,6,96,4564,558,580,1138,"21 de agosto de 1994"
15,6,96,4565,475,540,1015,"21 de agosto de 1994"
15,6,96,4566,617,673,1290,"21 de agosto de 1994"
15,6,96,4567,642,667,1309,"21 de agosto de 1994"
15,6,96,4568,801,942,1743,"21 de agosto de 1994"
15,6,96,4569,310,360,670,"21 de agosto de 1994"
15,6,96,4570,617,639,1256,"21 de agosto de 1994"
15,6,96,4571,841,905,1746,"21 de agosto de 1994"
15,6,96,4572,801,863,1664,"21 de agosto de 1994"
15,6,96,4573,553,582,1135,"21 de agosto de 1994"
15,6,96,4574,395,453,848,"21 de agosto de 1994"
15,6,96,4575,654,686,1340,"21 de agosto de 1994"
15,6,96,4576,483,514,997,"21 de agosto de 1994"
15,6,96,4577,461,495,956,"21 de agosto de 1994"
15,6,96,4578,145,106,251,"21 de agosto de 1994"
15,6,96,4579,241,206,447,"21 de agosto de 1994"
15,6,96,4580,648,658,1306,"21 de agosto de 1994"
15,6,96,4581,245,252,497,"21 de agosto de 1994"
15,6,96,4582,857,906,1763,"21 de agosto de 1994"
15,6,96,4583,395,404,799,"21 de agosto de 1994"
15,6,96,4584,543,542,1085,"21 de agosto de 1994"
15,6,96,4585,420,425,845,"21 de agosto de 1994"
15,6,96,4586,636,656,1292,"21 de agosto de 1994"
15,6,96,4587,495,522,1017,"21 de agosto de 1994"
15,7,58,2572,445,467,912,"21 de agosto de 1994"
15,7,58,2573,405,487,892,"21 de agosto de 1994"
15,7,58,2574,472,581,1053,"21 de agosto de 1994"
15,7,58,2575,459,618,1077,"21 de agosto de 1994"
15,7,58,2576,574,708,1282,"21 de agosto de 1994"
15,7,58,2577,460,538,998,"21 de agosto de 1994"
15,7,58,2578,405,478,883,"21 de agosto de 1994"
15,7,58,2579,443,534,977,"21 de agosto de 1994"
15,7,58,2580,424,534,958,"21 de agosto de 1994"
15,7,58,2581,394,491,885,"21 de agosto de 1994"
15,7,58,2582,530,619,1149,"21 de agosto de 1994"
15,7,58,2583,526,581,1107,"21 de agosto de 1994"
15,7,58,2584,438,500,938,"21 de agosto de 1994"
15,7,58,2585,304,350,654,"21 de agosto de 1994"
15,7,58,2586,240,291,531,"21 de agosto de 1994"
15,7,58,2587,523,526,1049,"21 de agosto de 1994"
15,7,58,2588,561,575,1136,"21 de agosto de 1994"
15,7,58,2589,475,541,1016,"21 de agosto de 1994"
15,7,58,2590,421,510,931,"21 de agosto de 1994"
15,7,58,2591,383,456,839,"21 de agosto de 1994"
15,7,58,2592,439,486,925,"21 de agosto de 1994"
15,7,58,2593,491,522,1013,"21 de agosto de 1994"
15,7,58,2594,398,411,809,"21 de agosto de 1994"
15,7,58,2595,716,804,1520,"21 de agosto de 1994"
15,7,58,2596,477,580,1057,"21 de agosto de 1994"
15,7,58,2597,303,288,591,"21 de agosto de 1994"
15,7,58,2598,206,233,439,"21 de agosto de 1994"
15,7,58,2599,369,425,794,"21 de agosto de 1994"
15,7,58,2600,314,382,696,"21 de agosto de 1994"
15,7,58,2601,456,529,985,"21 de agosto de 1994"
15,7,58,2602,449,477,926,"21 de agosto de 1994"
15,7,58,2603,637,707,1344,"21 de agosto de 1994"
15,7,58,2604,479,511,990,"21 de agosto de 1994"
15,7,58,2605,424,431,855,"21 de agosto de 1994"
15,7,58,2606,669,668,1337,"21 de agosto de 1994"
15,7,58,2607,490,579,1069,"21 de agosto de 1994"
15,7,58,2608,622,657,1279,"21 de agosto de 1994"
15,7,58,2609,531,553,1084,"21 de agosto de 1994"
15,7,58,2610,554,617,1171,"21 de agosto de 1994"
15,7,58,2611,472,536,1008,"21 de agosto de 1994"
15,7,58,2612,321,360,681,"21 de agosto de 1994"
15,7,58,2613,492,566,1058,"21 de agosto de 1994"
15,7,58,2614,290,378,668,"21 de agosto de 1994"
15,7,58,2615,599,659,1258,"21 de agosto de 1994"
15,7,58,2616,439,474,913,"21 de agosto de 1994"
15,7,58,2617,420,443,863,"21 de agosto de 1994"
15,7,58,2618,489,595,1084,"21 de agosto de 1994"
15,7,58,2619,575,622,1197,"21 de agosto de 1994"
15,7,58,2620,530,595,1125,"21 de agosto de 1994"
15,7,58,2621,634,697,1331,"21 de agosto de 1994"
15,7,58,2622,465,476,941,"21 de agosto de 1994"
15,7,58,2623,427,492,919,"21 de agosto de 1994"
15,7,58,2624,393,384,777,"21 de agosto de 1994"
15,7,58,2625,557,659,1216,"21 de agosto de 1994"
15,7,58,2626,477,498,975,"21 de agosto de 1994"
15,7,58,2627,460,511,971,"21 de agosto de 1994"
15,8,11,233,791,828,1619,"21 de agosto de 1994"
15,8,11,234,703,732,1435,"21 de agosto de 1994"
15,8,11,235,545,587,1132,"21 de agosto de 1994"
15,8,11,236,586,596,1182,"21 de agosto de 1994"
15,8,11,237,771,801,1572,"21 de agosto de 1994"
15,8,11,238,122,133,255,"21 de agosto de 1994"
15,8,11,239,120,126,246,"21 de agosto de 1994"
15,8,11,240,657,695,1352,"21 de agosto de 1994"
15,8,11,241,365,378,743,"21 de agosto de 1994"
15,8,11,242,628,694,1322,"21 de agosto de 1994"
15,8,11,243,658,656,1314,"21 de agosto de 1994"
15,8,11,244,270,261,531,"21 de agosto de 1994"
15,8,11,245,334,333,667,"21 de agosto de 1994"
15,8,11,246,101,87,188,"21 de agosto de 1994"
15,8,29,1097,704,745,1449,"21 de agosto de 1994"
15,8,29,1098,622,708,1330,"21 de agosto de 1994"
15,8,29,1099,366,416,782,"21 de agosto de 1994"
15,8,29,1100,160,156,316,"21 de agosto de 1994"
15,8,29,1101,320,336,656,"21 de agosto de 1994"
15,8,29,1102,216,232,448,"21 de agosto de 1994"
15,8,29,1103,227,229,456,"21 de agosto de 1994"
15,8,29,1104,107,109,216,"21 de agosto de 1994"
15,8,29,1105,171,187,358,"21 de agosto de 1994"
15,8,29,1106,205,221,426,"21 de agosto de 1994"
15,8,29,1107,658,704,1362,"21 de agosto de 1994"
15,8,29,1108,646,668,1314,"21 de agosto de 1994"
15,8,31,1142,580,614,1194,"21 de agosto de 1994"
15,8,31,1143,663,718,1381,"21 de agosto de 1994"
15,8,31,1144,570,587,1157,"21 de agosto de 1994"
15,8,31,1145,683,711,1394,"21 de agosto de 1994"
15,8,31,1146,475,500,975,"21 de agosto de 1994"
15,8,31,1147,712,816,1528,"21 de agosto de 1994"
15,8,31,1148,600,638,1238,"21 de agosto de 1994"
15,8,32,1149,559,656,1215,"21 de agosto de 1994"
15,8,32,1150,606,719,1325,"21 de agosto de 1994"
15,8,32,1151,529,566,1095,"21 de agosto de 1994"
15,8,32,1152,532,583,1115,"21 de agosto de 1994"
15,8,32,1153,238,293,531,"21 de agosto de 1994"
15,8,32,1154,341,361,702,"21 de agosto de 1994"
15,8,32,1155,609,726,1335,"21 de agosto de 1994"
15,8,32,1156,313,360,673,"21 de agosto de 1994"
15,8,32,1157,310,344,654,"21 de agosto de 1994"
15,8,32,1158,370,402,772,"21 de agosto de 1994"
15,8,32,1159,374,420,794,"21 de agosto de 1994"
15,8,32,1160,605,631,1236,"21 de agosto de 1994"
15,8,32,1161,566,672,1238,"21 de agosto de 1994"
15,8,32,1162,555,621,1176,"21 de agosto de 1994"
15,8,32,1163,490,614,1104,"21 de agosto de 1994"
15,8,32,1164,424,476,900,"21 de agosto de 1994"
15,8,32,1165,503,551,1054,"21 de agosto de 1994"
15,8,32,1166,552,637,1189,"21 de agosto de 1994"
15,8,32,1167,543,623,1166,"21 de agosto de 1994"
15,8,32,1168,497,567,1064,"21 de agosto de 1994"
15,8,32,1169,531,617,1148,"21 de agosto de 1994"
15,8,32,1170,689,799,1488,"21 de agosto de 1994"
15,8,32,1171,470,538,1008,"21 de agosto de 1994"
15,8,32,1172,413,444,857,"21 de agosto de 1994"
15,8,32,1173,861,956,1817,"21 de agosto de 1994"
15,8,32,1174,532,582,1114,"21 de agosto de 1994"
15,8,32,1175,567,650,1217,"21 de agosto de 1994"
15,8,32,1176,533,606,1139,"21 de agosto de 1994"
15,8,32,1177,621,672,1293,"21 de agosto de 1994"
15,8,32,1178,618,679,1297,"21 de agosto de 1994"
15,8,32,1179,549,595,1144,"21 de agosto de 1994"
15,8,32,1180,547,632,1179,"21 de agosto de 1994"
15,8,32,1181,473,526,999,"21 de agosto de 1994"
15,8,32,1182,484,515,999,"21 de agosto de 1994"
15,8,32,1183,467,558,1025,"21 de agosto de 1994"
15,8,32,1184,466,531,997,"21 de agosto de 1994"
15,8,32,1185,489,554,1043,"21 de agosto de 1994"
15,8,32,1186,465,530,995,"21 de agosto de 1994"
15,8,32,1187,499,535,1034,"21 de agosto de 1994"
15,8,32,1188,436,540,976,"21 de agosto de 1994"
15,8,32,1189,563,612,1175,"21 de agosto de 1994"
15,8,32,1190,486,552,1038,"21 de agosto de 1994"
15,8,32,1191,535,587,1122,"21 de agosto de 1994"
15,8,32,1192,788,863,1651,"21 de agosto de 1994"
15,8,32,1193,476,558,1034,"21 de agosto de 1994"
15,8,32,1194,802,919,1721,"21 de agosto de 1994"
15,8,32,1195,594,701,1295,"21 de agosto de 1994"
15,8,32,1196,475,543,1018,"21 de agosto de 1994"
15,8,32,1197,458,550,1008,"21 de agosto de 1994"
15,8,32,1198,488,532,1020,"21 de agosto de 1994"
15,8,32,1199,480,553,1033,"21 de agosto de 1994"
15,8,32,1200,519,618,1137,"21 de agosto de 1994"
15,8,32,1201,405,502,907,"21 de agosto de 1994"
15,8,32,1202,418,471,889,"21 de agosto de 1994"
15,8,32,1203,349,415,764,"21 de agosto de 1994"
15,8,32,1204,621,705,1326,"21 de agosto de 1994"
15,8,32,1205,478,572,1050,"21 de agosto de 1994"
15,8,32,1206,409,481,890,"21 de agosto de 1994"
15,8,32,1207,466,537,1003,"21 de agosto de 1994"
15,8,32,1208,422,455,877,"21 de agosto de 1994"
15,8,32,1209,843,920,1763,"21 de agosto de 1994"
15,8,32,1210,722,820,1542,"21 de agosto de 1994"
15,8,32,1211,519,609,1128,"21 de agosto de 1994"
15,8,32,1212,721,813,1534,"21 de agosto de 1994"
15,8,32,1213,646,786,1432,"21 de agosto de 1994"
15,8,32,1214,329,346,675,"21 de agosto de 1994"
15,8,32,1215,584,594,1178,"21 de agosto de 1994"
15,8,32,1216,123,150,273,"21 de agosto de 1994"
15,8,32,1217,488,561,1049,"21 de agosto de 1994"
15,8,32,1218,842,978,1820,"21 de agosto de 1994"
15,8,32,1219,743,813,1556,"21 de agosto de 1994"
15,8,32,1220,318,360,678,"21 de agosto de 1994"
15,8,32,1221,433,516,949,"21 de agosto de 1994"
15,8,32,1222,485,573,1058,"21 de agosto de 1994"
15,8,32,1223,555,613,1168,"21 de agosto de 1994"
15,8,32,1224,577,672,1249,"21 de agosto de 1994"
15,8,32,1225,486,541,1027,"21 de agosto de 1994"
15,8,32,1226,304,286,590,"21 de agosto de 1994"
15,8,32,1227,531,601,1132,"21 de agosto de 1994"
15,8,32,1228,564,596,1160,"21 de agosto de 1994"
15,8,32,1229,482,528,1010,"21 de agosto de 1994"
15,8,32,1230,617,692,1309,"21 de agosto de 1994"
15,8,32,1231,595,652,1247,"21 de agosto de 1994"
15,8,32,1232,664,694,1358,"21 de agosto de 1994"
15,8,32,1233,614,699,1313,"21 de agosto de 1994"
15,8,32,1234,660,695,1355,"21 de agosto de 1994"
15,8,32,1235,626,691,1317,"21 de agosto de 1994"
15,8,32,1236,729,781,1510,"21 de agosto de 1994"
15,8,32,1237,695,804,1499,"21 de agosto de 1994"
15,8,32,1238,438,529,967,"21 de agosto de 1994"
15,8,32,1239,325,375,700,"21 de agosto de 1994"
15,8,32,1240,612,696,1308,"21 de agosto de 1994"
15,8,32,1241,703,853,1556,"21 de agosto de 1994"
15,8,32,1242,446,519,965,"21 de agosto de 1994"
15,8,32,1243,605,679,1284,"21 de agosto de 1994"
15,8,32,1244,565,598,1163,"21 de agosto de 1994"
15,8,32,1245,606,648,1254,"21 de agosto de 1994"
15,8,32,1246,700,780,1480,"21 de agosto de 1994"
15,8,32,1247,274,299,573,"21 de agosto de 1994"
15,8,32,1248,687,740,1427,"21 de agosto de 1994"
15,8,32,1249,616,703,1319,"21 de agosto de 1994"
15,8,32,1250,554,656,1210,"21 de agosto de 1994"
15,8,32,1251,755,877,1632,"21 de agosto de 1994"
15,8,32,1252,450,500,950,"21 de agosto de 1994"
15,8,32,1253,384,424,808,"21 de agosto de 1994"
15,8,32,1254,483,537,1020,"21 de agosto de 1994"
15,8,32,1255,702,786,1488,"21 de agosto de 1994"
15,8,32,1256,836,932,1768,"21 de agosto de 1994"
15,8,32,1257,560,669,1229,"21 de agosto de 1994"
15,8,32,1258,477,547,1024,"21 de agosto de 1994"
15,8,32,1259,555,623,1178,"21 de agosto de 1994"
15,8,32,1260,470,501,971,"21 de agosto de 1994"
15,8,32,1261,397,435,832,"21 de agosto de 1994"
15,8,32,1262,483,553,1036,"21 de agosto de 1994"
15,8,32,1263,491,544,1035,"21 de agosto de 1994"
15,8,32,1264,491,575,1066,"21 de agosto de 1994"
15,8,32,1265,756,903,1659,"21 de agosto de 1994"
15,8,32,1266,532,607,1139,"21 de agosto de 1994"
15,8,32,1267,736,814,1550,"21 de agosto de 1994"
15,8,32,1268,772,870,1642,"21 de agosto de 1994"
15,8,32,1269,907,994,1901,"21 de agosto de 1994"
15,8,32,1270,236,311,547,"21 de agosto de 1994"
15,8,32,1271,232,276,508,"21 de agosto de 1994"
15,8,32,1272,300,386,686,"21 de agosto de 1994"
15,8,32,1273,332,348,680,"21 de agosto de 1994"
15,8,32,1274,384,418,802,"21 de agosto de 1994"
15,8,32,1275,240,276,516,"21 de agosto de 1994"
15,8,32,1276,363,437,800,"21 de agosto de 1994"
15,8,32,1277,886,1112,1998,"21 de agosto de 1994"
15,8,32,1278,310,358,668,"21 de agosto de 1994"
15,8,32,1279,236,240,476,"21 de agosto de 1994"
15,8,32,1280,468,519,987,"21 de agosto de 1994"
15,8,32,1281,341,386,727,"21 de agosto de 1994"
15,8,32,1282,358,366,724,"21 de agosto de 1994"
15,8,32,1283,167,182,349,"21 de agosto de 1994"
15,8,32,1284,277,323,600,"21 de agosto de 1994"
15,8,32,1285,268,293,561,"21 de agosto de 1994"
15,8,66,3880,441,511,952,"21 de agosto de 1994"
15,8,66,3881,440,499,939,"21 de agosto de 1994"
15,8,66,3882,225,266,491,"21 de agosto de 1994"
15,8,66,3883,628,689,1317,"21 de agosto de 1994"
15,8,66,3884,428,421,849,"21 de agosto de 1994"
15,8,66,3885,470,518,988,"21 de agosto de 1994"
15,8,66,3886,28,23,51,"21 de agosto de 1994"
15,8,66,3887,329,305,634,"21 de agosto de 1994"
15,8,66,3888,154,132,286,"21 de agosto de 1994"
15,8,66,3889,177,209,386,"21 de agosto de 1994"
15,8,66,3890,338,323,661,"21 de agosto de 1994"
15,8,66,3891,243,203,446,"21 de agosto de 1994"
15,8,66,3892,313,284,597,"21 de agosto de 1994"
15,8,66,3893,60,42,102,"21 de agosto de 1994"
15,8,66,3894,180,126,306,"21 de agosto de 1994"
15,8,66,3895,385,387,772,"21 de agosto de 1994"
15,8,66,3896,494,465,959,"21 de agosto de 1994"
15,8,66,3897,376,367,743,"21 de agosto de 1994"
15,8,66,3898,293,308,601,"21 de agosto de 1994"
15,8,70,3940,470,553,1023,"21 de agosto de 1994"
15,8,70,3941,411,442,853,"21 de agosto de 1994"
15,8,71,3942,329,367,696,"21 de agosto de 1994"
15,8,71,3943,735,855,1590,"21 de agosto de 1994"
15,8,71,3944,406,436,842,"21 de agosto de 1994"
15,8,71,3945,582,592,1174,"21 de agosto de 1994"
15,8,71,3946,764,816,1580,"21 de agosto de 1994"
15,8,71,3947,143,141,284,"21 de agosto de 1994"
15,8,71,3948,340,367,707,"21 de agosto de 1994"
15,8,71,3949,365,393,758,"21 de agosto de 1994"
15,8,71,3950,762,879,1641,"21 de agosto de 1994"
15,8,71,3951,655,742,1397,"21 de agosto de 1994"
15,8,71,3952,683,713,1396,"21 de agosto de 1994"
15,8,71,3953,697,745,1442,"21 de agosto de 1994"
15,8,71,3954,628,654,1282,"21 de agosto de 1994"
15,8,71,3955,808,840,1648,"21 de agosto de 1994"
15,8,71,3956,619,600,1219,"21 de agosto de 1994"
15,8,71,3957,697,736,1433,"21 de agosto de 1994"
15,8,71,3958,770,789,1559,"21 de agosto de 1994"
15,8,71,3959,763,822,1585,"21 de agosto de 1994"
15,8,71,3960,598,622,1220,"21 de agosto de 1994"
15,8,71,3961,589,617,1206,"21 de agosto de 1994"
15,8,71,3962,610,679,1289,"21 de agosto de 1994"
15,8,71,3963,727,791,1518,"21 de agosto de 1994"
15,8,71,3964,586,639,1225,"21 de agosto de 1994"
15,8,71,3965,699,739,1438,"21 de agosto de 1994"
15,8,71,3966,552,580,1132,"21 de agosto de 1994"
15,8,71,3967,751,869,1620,"21 de agosto de 1994"
15,8,71,3968,735,830,1565,"21 de agosto de 1994"
15,8,71,3969,572,669,1241,"21 de agosto de 1994"
15,8,71,3970,599,679,1278,"21 de agosto de 1994"
15,8,71,3971,579,631,1210,"21 de agosto de 1994"
15,8,71,3972,651,688,1339,"21 de agosto de 1994"
15,8,71,3973,727,759,1486,"21 de agosto de 1994"
15,8,71,3974,672,704,1376,"21 de agosto de 1994"
15,8,71,3975,525,569,1094,"21 de agosto de 1994"
15,8,71,3976,450,517,967,"21 de agosto de 1994"
15,8,71,3977,764,828,1592,"21 de agosto de 1994"
15,8,71,3978,523,587,1110,"21 de agosto de 1994"
15,8,71,3979,417,445,862,"21 de agosto de 1994"
15,8,71,3980,744,836,1580,"21 de agosto de 1994"
15,8,71,3981,409,484,893,"21 de agosto de 1994"
15,8,71,3982,503,521,1024,"21 de agosto de 1994"
15,8,71,3983,512,627,1139,"21 de agosto de 1994"
15,8,71,3984,557,572,1129,"21 de agosto de 1994"
15,8,71,3985,342,390,732,"21 de agosto de 1994"
15,8,71,3986,641,711,1352,"21 de agosto de 1994"
15,8,71,3987,677,748,1425,"21 de agosto de 1994"
15,8,71,3988,729,812,1541,"21 de agosto de 1994"
15,8,71,3989,425,462,887,"21 de agosto de 1994"
15,8,71,3990,573,616,1189,"21 de agosto de 1994"
15,8,71,3991,405,449,854,"21 de agosto de 1994"
15,8,71,3992,433,501,934,"21 de agosto de 1994"
15,8,71,3993,385,439,824,"21 de agosto de 1994"
15,8,71,3994,501,531,1032,"21 de agosto de 1994"
15,8,71,3995,450,478,928,"21 de agosto de 1994"
15,8,71,3996,301,343,644,"21 de agosto de 1994"
15,8,71,3997,525,549,1074,"21 de agosto de 1994"
15,8,71,3998,554,626,1180,"21 de agosto de 1994"
15,8,71,3999,242,280,522,"21 de agosto de 1994"
15,8,71,4000,458,512,970,"21 de agosto de 1994"
15,8,71,4001,502,618,1120,"21 de agosto de 1994"
15,8,71,4002,342,381,723,"21 de agosto de 1994"
15,8,71,4003,343,398,741,"21 de agosto de 1994"
15,8,71,4004,815,879,1694,"21 de agosto de 1994"
15,8,71,4005,446,506,952,"21 de agosto de 1994"
15,8,71,4006,171,202,373,"21 de agosto de 1994"
15,8,71,4007,153,157,310,"21 de agosto de 1994"
15,8,94,4546,463,522,985,"21 de agosto de 1994"
15,8,94,4547,493,509,1002,"21 de agosto de 1994"
15,8,94,4548,457,490,947,"21 de agosto de 1994"
15,8,94,4549,465,477,942,"21 de agosto de 1994"
15,8,94,4550,432,433,865,"21 de agosto de 1994"
15,8,94,4551,559,560,1119,"21 de agosto de 1994"
15,8,94,4552,263,288,551,"21 de agosto de 1994"
15,8,94,4553,629,614,1243,"21 de agosto de 1994"
15,8,94,4554,674,699,1373,"21 de agosto de 1994"
15,8,94,4555,257,245,502,"21 de agosto de 1994"
15,8,100,4611,600,623,1223,"21 de agosto de 1994"
15,8,100,4612,436,485,921,"21 de agosto de 1994"
15,8,100,4613,300,361,661,"21 de agosto de 1994"
15,8,100,4614,431,465,896,"21 de agosto de 1994"
15,8,100,4615,474,558,1032,"21 de agosto de 1994"
15,8,100,4616,357,400,757,"21 de agosto de 1994"
15,8,100,4617,731,852,1583,"21 de agosto de 1994"
15,8,100,4618,618,686,1304,"21 de agosto de 1994"
15,8,100,4619,427,491,918,"21 de agosto de 1994"
15,8,100,4620,536,689,1225,"21 de agosto de 1994"
15,8,100,4621,486,501,987,"21 de agosto de 1994"
15,8,100,4622,345,347,692,"21 de agosto de 1994"
15,8,100,4623,530,586,1116,"21 de agosto de 1994"
15,8,100,4624,382,439,821,"21 de agosto de 1994"
15,8,100,4625,651,792,1443,"21 de agosto de 1994"
15,8,100,4626,521,615,1136,"21 de agosto de 1994"
15,8,100,4627,553,615,1168,"21 de agosto de 1994"
15,8,100,4628,593,648,1241,"21 de agosto de 1994"
15,8,100,4629,452,529,981,"21 de agosto de 1994"
15,8,100,4630,554,632,1186,"21 de agosto de 1994"
15,8,100,4631,619,750,1369,"21 de agosto de 1994"
15,8,100,4632,510,646,1156,"21 de agosto de 1994"
15,8,100,4633,449,528,977,"21 de agosto de 1994"
15,8,100,4634,362,452,814,"21 de agosto de 1994"
15,8,100,4635,550,621,1171,"21 de agosto de 1994"
15,8,100,4636,669,676,1345,"21 de agosto de 1994"
15,8,100,4637,461,541,1002,"21 de agosto de 1994"
15,8,100,4638,313,362,675,"21 de agosto de 1994"
15,8,100,4639,269,322,591,"21 de agosto de 1994"
15,8,100,4640,648,707,1355,"21 de agosto de 1994"
15,8,100,4641,286,300,586,"21 de agosto de 1994"
15,8,100,4642,906,132,1038,"21 de agosto de 1994"
15,8,100,4643,334,338,672,"21 de agosto de 1994"
15,8,100,4644,415,496,911,"21 de agosto de 1994"
15,8,100,4645,359,381,740,"21 de agosto de 1994"
15,8,100,4646,632,666,1298,"21 de agosto de 1994"
15,8,100,4647,723,411,1134,"21 de agosto de 1994"
15,8,100,4648,430,423,853,"21 de agosto de 1994"
15,8,100,4649,795,894,1689,"21 de agosto de 1994"
15,8,100,4650,716,739,1455,"21 de agosto de 1994"
15,8,100,4651,626,672,1298,"21 de agosto de 1994"
15,8,100,4652,662,716,1378,"21 de agosto de 1994"
15,8,100,4653,701,773,1474,"21 de agosto de 1994"
15,8,100,4654,702,788,1490,"21 de agosto de 1994"
15,8,100,4655,751,752,1503,"21 de agosto de 1994"
15,8,100,4656,337,355,692,"21 de agosto de 1994"
15,8,100,4657,309,324,633,"21 de agosto de 1994"
15,8,100,4658,597,656,1253,"21 de agosto de 1994"
15,8,100,4659,595,548,1143,"21 de agosto de 1994"
15,8,100,4660,369,425,794,"21 de agosto de 1994"
15,8,100,4661,370,416,786,"21 de agosto de 1994"
15,8,100,4662,654,721,1375,"21 de agosto de 1994"
15,8,100,4663,582,601,1183,"21 de agosto de 1994"
15,8,100,4664,436,433,869,"21 de agosto de 1994"
15,8,100,4665,417,387,804,"21 de agosto de 1994"
15,8,100,4666,408,420,828,"21 de agosto de 1994"
15,8,100,4667,429,447,876,"21 de agosto de 1994"
15,8,100,4668,445,497,942,"21 de agosto de 1994"
15,8,100,4669,425,440,865,"21 de agosto de 1994"
15,8,100,4670,442,482,924,"21 de agosto de 1994"
15,8,100,4671,521,569,1090,"21 de agosto de 1994"
15,8,100,4672,324,324,648,"21 de agosto de 1994"
15,8,100,4673,560,511,1071,"21 de agosto de 1994"
15,8,100,4674,622,676,1298,"21 de agosto de 1994"
15,8,100,4675,777,801,1578,"21 de agosto de 1994"
15,8,100,4676,485,470,955,"21 de agosto de 1994"
15,8,100,4677,499,531,1030,"21 de agosto de 1994"
15,8,100,4678,220,254,474,"21 de agosto de 1994"
15,8,100,4679,803,892,1695,"21 de agosto de 1994"
15,8,100,4680,517,566,1083,"21 de agosto de 1994"
15,8,100,4681,493,488,981,"21 de agosto de 1994"
15,8,100,4682,412,362,774,"21 de agosto de 1994"
15,8,100,4683,232,273,505,"21 de agosto de 1994"
15,8,100,4684,1185,1558,2743,"21 de agosto de 1994"
15,8,100,4685,376,391,767,"21 de agosto de 1994"
15,8,100,4686,409,417,826,"21 de agosto de 1994"
15,8,100,4687,452,507,959,"21 de agosto de 1994"
15,8,100,4688,433,428,861,"21 de agosto de 1994"
15,8,100,4689,393,402,795,"21 de agosto de 1994"
15,8,100,4690,369,380,749,"21 de agosto de 1994"
15,9,60,3046,606,642,1248,"21 de agosto de 1994"
15,9,60,3047,493,598,1091,"21 de agosto de 1994"
15,9,60,3048,631,691,1322,"21 de agosto de 1994"
15,9,60,3049,474,500,974,"21 de agosto de 1994"
15,9,60,3050,697,811,1508,"21 de agosto de 1994"
15,9,60,3051,460,476,936,"21 de agosto de 1994"
15,9,60,3052,423,464,887,"21 de agosto de 1994"
15,9,60,3053,774,829,1603,"21 de agosto de 1994"
15,9,60,3054,683,721,1404,"21 de agosto de 1994"
15,9,60,3055,444,441,885,"21 de agosto de 1994"
15,9,60,3056,732,816,1548,"21 de agosto de 1994"
15,9,60,3057,459,513,972,"21 de agosto de 1994"
15,9,60,3058,355,389,744,"21 de agosto de 1994"
15,9,60,3059,701,769,1470,"21 de agosto de 1994"
15,9,60,3060,553,634,1187,"21 de agosto de 1994"
15,9,60,3061,777,870,1647,"21 de agosto de 1994"
15,9,60,3062,732,806,1538,"21 de agosto de 1994"
15,9,60,3063,635,718,1353,"21 de agosto de 1994"
15,9,60,3064,684,782,1466,"21 de agosto de 1994"
15,9,60,3065,665,734,1399,"21 de agosto de 1994"
15,9,60,3066,620,677,1297,"21 de agosto de 1994"
15,9,60,3067,491,551,1042,"21 de agosto de 1994"
15,9,60,3068,674,707,1381,"21 de agosto de 1994"
15,9,60,3069,542,608,1150,"21 de agosto de 1994"
15,9,60,3070,449,515,964,"21 de agosto de 1994"
15,9,60,3071,593,655,1248,"21 de agosto de 1994"
15,9,60,3072,697,740,1437,"21 de agosto de 1994"
15,9,60,3073,675,753,1428,"21 de agosto de 1994"
15,9,60,3074,581,653,1234,"21 de agosto de 1994"
15,9,60,3075,554,615,1169,"21 de agosto de 1994"
15,9,60,3076,539,593,1132,"21 de agosto de 1994"
15,9,60,3077,527,617,1144,"21 de agosto de 1994"
15,9,60,3078,447,498,945,"21 de agosto de 1994"
15,9,60,3079,469,533,1002,"21 de agosto de 1994"
15,9,60,3080,468,463,931,"21 de agosto de 1994"
15,9,60,3081,390,409,799,"21 de agosto de 1994"
15,9,60,3082,740,796,1536,"21 de agosto de 1994"
15,9,60,3083,483,527,1010,"21 de agosto de 1994"
15,9,60,3084,368,402,770,"21 de agosto de 1994"
15,9,60,3085,672,759,1431,"21 de agosto de 1994"
15,9,60,3086,491,569,1060,"21 de agosto de 1994"
15,9,60,3087,639,705,1344,"21 de agosto de 1994"
15,9,60,3088,569,640,1209,"21 de agosto de 1994"
15,9,60,3089,504,617,1121,"21 de agosto de 1994"
15,9,60,3090,609,643,1252,"21 de agosto de 1994"
15,9,60,3091,402,423,825,"21 de agosto de 1994"
15,9,60,3092,715,771,1486,"21 de agosto de 1994"
15,9,60,3093,460,484,944,"21 de agosto de 1994"
15,9,60,3094,393,464,857,"21 de agosto de 1994"
15,9,60,3095,704,791,1495,"21 de agosto de 1994"
15,9,60,3096,309,379,688,"21 de agosto de 1994"
15,9,60,3097,317,373,690,"21 de agosto de 1994"
15,9,60,3098,806,892,1698,"21 de agosto de 1994"
15,9,60,3099,421,455,876,"21 de agosto de 1994"
15,9,60,3100,455,502,957,"21 de agosto de 1994"
15,9,60,3101,425,493,918,"21 de agosto de 1994"
15,9,60,3102,447,517,964,"21 de agosto de 1994"
15,9,60,3103,408,465,873,"21 de agosto de 1994"
15,9,60,3104,466,469,935,"21 de agosto de 1994"
15,9,60,3105,430,485,915,"21 de agosto de 1994"
15,9,60,3106,440,490,930,"21 de agosto de 1994"
15,10,60,3107,530,592,1122,"21 de agosto de 1994"
15,10,60,3108,639,760,1399,"21 de agosto de 1994"
15,10,60,3109,565,666,1231,"21 de agosto de 1994"
15,10,60,3110,606,689,1295,"21 de agosto de 1994"
15,10,60,3111,558,720,1278,"21 de agosto de 1994"
15,10,60,3112,491,572,1063,"21 de agosto de 1994"
15,10,60,3113,409,544,953,"21 de agosto de 1994"
15,10,60,3114,544,685,1229,"21 de agosto de 1994"
15,10,60,3115,586,655,1241,"21 de agosto de 1994"
15,10,60,3116,636,767,1403,"21 de agosto de 1994"
15,10,60,3117,581,677,1258,"21 de agosto de 1994"
15,10,60,3118,410,500,910,"21 de agosto de 1994"
15,10,60,3119,387,421,808,"21 de agosto de 1994"
15,10,60,3120,465,527,992,"21 de agosto de 1994"
15,10,60,3121,587,662,1249,"21 de agosto de 1994"
15,10,60,3122,493,576,1069,"21 de agosto de 1994"
15,10,60,3123,476,601,1077,"21 de agosto de 1994"
15,10,60,3124,542,631,1173,"21 de agosto de 1994"
15,10,60,3125,486,556,1042,"21 de agosto de 1994"
15,10,60,3126,381,435,816,"21 de agosto de 1994"
15,10,60,3127,441,484,925,"21 de agosto de 1994"
15,10,60,3128,378,470,848,"21 de agosto de 1994"
15,10,60,3129,578,711,1289,"21 de agosto de 1994"
15,10,60,3130,505,556,1061,"21 de agosto de 1994"
15,10,60,3131,409,451,860,"21 de agosto de 1994"
15,10,60,3132,376,414,790,"21 de agosto de 1994"
15,10,60,3133,259,326,585,"21 de agosto de 1994"
15,10,60,3134,438,471,909,"21 de agosto de 1994"
15,10,60,3135,326,429,755,"21 de agosto de 1994"
15,10,60,3136,410,438,848,"21 de agosto de 1994"
15,10,60,3137,332,391,723,"21 de agosto de 1994"
15,10,60,3138,322,399,721,"21 de agosto de 1994"
15,10,60,3139,709,831,1540,"21 de agosto de 1994"
15,10,60,3140,501,575,1076,"21 de agosto de 1994"
15,10,60,3141,569,589,1158,"21 de agosto de 1994"
15,10,60,3142,378,425,803,"21 de agosto de 1994"
15,10,60,3143,421,469,890,"21 de agosto de 1994"
15,10,60,3144,567,624,1191,"21 de agosto de 1994"
15,10,60,3145,322,388,710,"21 de agosto de 1994"
15,10,60,3146,275,318,593,"21 de agosto de 1994"
15,10,60,3147,222,274,496,"21 de agosto de 1994"
15,10,60,3148,227,274,501,"21 de agosto de 1994"
15,10,60,3149,368,438,806,"21 de agosto de 1994"
15,10,60,3150,180,236,416,"21 de agosto de 1994"
15,10,60,3151,520,590,1110,"21 de agosto de 1994"
15,10,60,3152,366,462,828,"21 de agosto de 1994"
15,10,60,3153,523,557,1080,"21 de agosto de 1994"
15,10,60,3154,547,575,1122,"21 de agosto de 1994"
15,10,60,3155,459,503,962,"21 de agosto de 1994"
15,10,60,3156,407,442,849,"21 de agosto de 1994"
15,10,60,3157,651,717,1368,"21 de agosto de 1994"
15,10,60,3158,443,510,953,"21 de agosto de 1994"
15,10,60,3159,715,735,1450,"21 de agosto de 1994"
15,10,60,3160,502,529,1031,"21 de agosto de 1994"
15,10,60,3161,399,456,855,"21 de agosto de 1994"
15,10,60,3162,798,875,1673,"21 de agosto de 1994"
15,10,60,3163,615,667,1282,"21 de agosto de 1994"
15,10,60,3164,551,594,1145,"21 de agosto de 1994"
15,10,60,3165,442,450,892,"21 de agosto de 1994"
15,10,60,3166,596,665,1261,"21 de agosto de 1994"
15,10,60,3167,827,884,1711,"21 de agosto de 1994"
15,10,60,3168,413,445,858,"21 de agosto de 1994"
15,10,60,3169,696,787,1483,"21 de agosto de 1994"
15,10,60,3170,409,455,864,"21 de agosto de 1994"
15,10,60,3171,595,656,1251,"21 de agosto de 1994"
15,10,60,3172,513,614,1127,"21 de agosto de 1994"
15,10,60,3173,420,470,890,"21 de agosto de 1994"
15,10,60,3174,586,615,1201,"21 de agosto de 1994"
15,10,60,3175,655,712,1367,"21 de agosto de 1994"
15,10,60,3176,423,476,899,"21 de agosto de 1994"
15,10,60,3177,693,732,1425,"21 de agosto de 1994"
15,10,60,3178,594,611,1205,"21 de agosto de 1994"
15,10,60,3179,362,403,765,"21 de agosto de 1994"
15,10,60,3180,565,630,1195,"21 de agosto de 1994"
15,10,60,3181,401,489,890,"21 de agosto de 1994"
15,10,60,3182,588,672,1260,"21 de agosto de 1994"
15,10,60,3183,542,610,1152,"21 de agosto de 1994"
15,10,60,3184,551,582,1133,"21 de agosto de 1994"
15,10,60,3185,551,571,1122,"21 de agosto de 1994"
15,10,60,3186,434,485,919,"21 de agosto de 1994"
15,11,34,1302,918,963,1881,"21 de agosto de 1994"
15,11,34,1303,713,773,1486,"21 de agosto de 1994"
15,11,34,1304,573,636,1209,"21 de agosto de 1994"
15,11,34,1305,634,700,1334,"21 de agosto de 1994"
15,11,34,1306,655,729,1384,"21 de agosto de 1994"
15,11,34,1307,310,325,635,"21 de agosto de 1994"
15,11,34,1308,657,741,1398,"21 de agosto de 1994"
15,11,34,1309,472,526,998,"21 de agosto de 1994"
15,11,34,1310,445,511,956,"21 de agosto de 1994"
15,11,34,1311,482,532,1014,"21 de agosto de 1994"
15,11,34,1312,341,405,746,"21 de agosto de 1994"
15,11,34,1313,337,420,757,"21 de agosto de 1994"
15,11,34,1314,379,453,832,"21 de agosto de 1994"
15,11,34,1315,364,444,808,"21 de agosto de 1994"
15,11,34,1316,478,490,968,"21 de agosto de 1994"
15,11,34,1317,555,617,1172,"21 de agosto de 1994"
15,11,34,1318,548,602,1150,"21 de agosto de 1994"
15,11,34,1319,530,583,1113,"21 de agosto de 1994"
15,11,34,1320,571,536,1107,"21 de agosto de 1994"
15,11,34,1321,796,883,1679,"21 de agosto de 1994"
15,11,34,1322,617,649,1266,"21 de agosto de 1994"
15,11,34,1323,695,746,1441,"21 de agosto de 1994"
15,11,34,1324,738,810,1548,"21 de agosto de 1994"
15,11,34,1325,441,456,897,"21 de agosto de 1994"
15,11,34,1326,456,449,905,"21 de agosto de 1994"
15,11,34,1327,462,503,965,"21 de agosto de 1994"
15,11,34,1328,581,599,1180,"21 de agosto de 1994"
15,11,34,1329,640,706,1346,"21 de agosto de 1994"
15,11,34,1330,738,797,1535,"21 de agosto de 1994"
15,11,34,1331,778,869,1647,"21 de agosto de 1994"
15,11,34,1332,447,497,944,"21 de agosto de 1994"
15,11,34,1333,407,464,871,"21 de agosto de 1994"
15,11,34,1334,652,756,1408,"21 de agosto de 1994"
15,11,34,1335,858,974,1832,"21 de agosto de 1994"
15,11,34,1336,634,678,1312,"21 de agosto de 1994"
15,11,34,1337,490,534,1024,"21 de agosto de 1994"
15,11,34,1338,475,498,973,"21 de agosto de 1994"
15,11,34,1339,632,627,1259,"21 de agosto de 1994"
15,11,34,1340,590,636,1226,"21 de agosto de 1994"
15,11,34,1341,569,663,1232,"21 de agosto de 1994"
15,11,34,1342,452,534,986,"21 de agosto de 1994"
15,11,34,1343,410,461,871,"21 de agosto de 1994"
15,11,34,1344,459,524,983,"21 de agosto de 1994"
15,11,34,1345,696,781,1477,"21 de agosto de 1994"
15,11,34,1346,530,594,1124,"21 de agosto de 1994"
15,11,34,1347,550,670,1220,"21 de agosto de 1994"
15,11,34,1348,610,699,1309,"21 de agosto de 1994"
15,11,34,1349,374,419,793,"21 de agosto de 1994"
15,11,34,1350,643,796,1439,"21 de agosto de 1994"
15,11,34,1351,757,829,1586,"21 de agosto de 1994"
15,11,34,1352,458,494,952,"21 de agosto de 1994"
15,11,34,1353,396,382,778,"21 de agosto de 1994"
15,11,34,1354,629,726,1355,"21 de agosto de 1994"
15,11,34,1355,610,688,1298,"21 de agosto de 1994"
15,11,34,1356,698,733,1431,"21 de agosto de 1994"
15,11,34,1357,766,791,1557,"21 de agosto de 1994"
15,11,34,1358,513,557,1070,"21 de agosto de 1994"
15,11,34,1359,306,286,592,"21 de agosto de 1994"
15,11,34,1360,585,550,1135,"21 de agosto de 1994"
15,11,34,1361,778,780,1558,"21 de agosto de 1994"
15,11,34,1362,813,836,1649,"21 de agosto de 1994"
15,11,34,1363,837,926,1763,"21 de agosto de 1994"
15,11,34,1364,523,576,1099,"21 de agosto de 1994"
15,11,34,1365,720,870,1590,"21 de agosto de 1994"
15,11,34,1366,705,806,1511,"21 de agosto de 1994"
15,11,34,1367,638,709,1347,"21 de agosto de 1994"
15,11,34,1368,603,670,1273,"21 de agosto de 1994"
15,11,34,1369,470,489,959,"21 de agosto de 1994"
15,11,34,1370,919,954,1873,"21 de agosto de 1994"
15,11,34,1371,668,747,1415,"21 de agosto de 1994"
15,11,34,1372,563,600,1163,"21 de agosto de 1994"
15,11,34,1373,568,638,1206,"21 de agosto de 1994"
15,11,34,1374,786,797,1583,"21 de agosto de 1994"
15,11,34,1375,726,873,1599,"21 de agosto de 1994"
15,11,34,1376,627,657,1284,"21 de agosto de 1994"
15,11,34,1377,460,533,993,"21 de agosto de 1994"
15,11,34,1378,838,918,1756,"21 de agosto de 1994"
15,11,34,1379,743,817,1560,"21 de agosto de 1994"
15,11,34,1380,687,742,1429,"21 de agosto de 1994"
15,11,34,1381,659,741,1400,"21 de agosto de 1994"
15,11,34,1382,736,812,1548,"21 de agosto de 1994"
15,11,34,1383,695,692,1387,"21 de agosto de 1994"
15,11,34,1384,614,648,1262,"21 de agosto de 1994"
15,11,34,1385,558,621,1179,"21 de agosto de 1994"
15,11,34,1386,756,797,1553,"21 de agosto de 1994"
15,11,34,1387,656,653,1309,"21 de agosto de 1994"
15,11,34,1388,653,690,1343,"21 de agosto de 1994"
15,11,34,1389,782,902,1684,"21 de agosto de 1994"
15,11,34,1390,796,922,1718,"21 de agosto de 1994"
15,11,34,1391,672,720,1392,"21 de agosto de 1994"
15,11,34,1392,641,735,1376,"21 de agosto de 1994"
15,11,34,1393,426,499,925,"21 de agosto de 1994"
15,11,105,4757,396,419,815,"21 de agosto de 1994"
15,11,105,4758,479,524,1003,"21 de agosto de 1994"
15,11,105,4759,357,395,752,"21 de agosto de 1994"
15,11,105,4760,344,373,717,"21 de agosto de 1994"
15,11,105,4761,376,386,762,"21 de agosto de 1994"
15,11,105,4762,524,538,1062,"21 de agosto de 1994"
15,11,105,4763,361,391,752,"21 de agosto de 1994"
15,11,105,4764,816,908,1724,"21 de agosto de 1994"
15,11,105,4765,961,1068,2029,"21 de agosto de 1994"
15,11,105,4766,730,784,1514,"21 de agosto de 1994"
15,11,105,4767,615,622,1237,"21 de agosto de 1994"
15,11,105,4768,803,847,1650,"21 de agosto de 1994"
15,11,105,4769,564,577,1141,"21 de agosto de 1994"
15,11,105,4770,505,540,1045,"21 de agosto de 1994"
15,11,105,4771,443,491,934,"21 de agosto de 1994"
15,11,105,4772,443,471,914,"21 de agosto de 1994"
15,11,105,4773,405,429,834,"21 de agosto de 1994"
15,11,105,4774,402,408,810,"21 de agosto de 1994"
15,11,105,4775,576,608,1184,"21 de agosto de 1994"
15,11,105,4776,517,523,1040,"21 de agosto de 1994"
15,11,105,4777,493,517,1010,"21 de agosto de 1994"
15,11,105,4778,437,453,890,"21 de agosto de 1994"
15,11,105,4779,761,813,1574,"21 de agosto de 1994"
15,11,105,4780,660,696,1356,"21 de agosto de 1994"
15,11,105,4781,553,586,1139,"21 de agosto de 1994"
15,11,105,4782,502,585,1087,"21 de agosto de 1994"
15,11,105,4783,528,576,1104,"21 de agosto de 1994"
15,11,105,4784,526,561,1087,"21 de agosto de 1994"
15,11,105,4785,357,369,726,"21 de agosto de 1994"
15,11,105,4786,650,671,1321,"21 de agosto de 1994"
15,11,105,4787,723,774,1497,"21 de agosto de 1994"
15,11,105,4788,718,762,1480,"21 de agosto de 1994"
15,11,105,4789,440,499,939,"21 de agosto de 1994"
15,11,105,4790,447,489,936,"21 de agosto de 1994"
15,11,105,4791,761,813,1574,"21 de agosto de 1994"
15,11,105,4792,428,464,892,"21 de agosto de 1994"
15,11,105,4793,503,564,1067,"21 de agosto de 1994"
15,11,105,4794,492,498,990,"21 de agosto de 1994"
15,11,105,4795,538,533,1071,"21 de agosto de 1994"
15,11,105,4796,351,411,762,"21 de agosto de 1994"
15,11,105,4797,484,494,978,"21 de agosto de 1994"
15,11,105,4798,721,769,1490,"21 de agosto de 1994"
15,11,105,4799,818,943,1761,"21 de agosto de 1994"
15,11,105,4800,540,575,1115,"21 de agosto de 1994"
15,11,105,4801,402,410,812,"21 de agosto de 1994"
15,11,105,4802,618,677,1295,"21 de agosto de 1994"
15,11,105,4803,683,718,1401,"21 de agosto de 1994"
15,11,105,4804,900,947,1847,"21 de agosto de 1994"
15,11,105,4805,856,872,1728,"21 de agosto de 1994"
15,11,105,4806,492,567,1059,"21 de agosto de 1994"
15,11,105,4807,482,504,986,"21 de agosto de 1994"
15,11,105,4808,835,837,1672,"21 de agosto de 1994"
15,11,105,4809,492,499,991,"21 de agosto de 1994"
15,11,105,4810,452,500,952,"21 de agosto de 1994"
15,11,105,4811,296,330,626,"21 de agosto de 1994"
15,11,105,4812,637,637,1274,"21 de agosto de 1994"
15,11,105,4813,431,484,915,"21 de agosto de 1994"
15,11,105,4814,542,610,1152,"21 de agosto de 1994"
15,11,105,4815,699,725,1424,"21 de agosto de 1994"
15,11,105,4816,737,756,1493,"21 de agosto de 1994"
15,11,105,4817,559,543,1102,"21 de agosto de 1994"
15,11,105,4818,455,494,949,"21 de agosto de 1994"
15,11,105,4819,424,461,885,"21 de agosto de 1994"
15,11,105,4820,377,424,801,"21 de agosto de 1994"
15,11,105,4821,490,525,1015,"21 de agosto de 1994"
15,11,105,4822,518,530,1048,"21 de agosto de 1994"
15,11,105,4823,681,754,1435,"21 de agosto de 1994"
15,11,105,4824,647,693,1340,"21 de agosto de 1994"
15,11,105,4825,526,579,1105,"21 de agosto de 1994"
15,11,105,4826,632,668,1300,"21 de agosto de 1994"
15,11,105,4827,704,766,1470,"21 de agosto de 1994"
15,11,105,4828,481,518,999,"21 de agosto de 1994"
15,11,105,4829,309,321,630,"21 de agosto de 1994"
15,11,105,4830,801,856,1657,"21 de agosto de 1994"
15,11,105,4831,761,738,1499,"21 de agosto de 1994"
15,11,105,4832,750,799,1549,"21 de agosto de 1994"
15,11,105,4833,440,480,920,"21 de agosto de 1994"
15,11,105,4834,548,534,1082,"21 de agosto de 1994"
15,11,105,4835,472,476,948,"21 de agosto de 1994"
15,12,13,250,494,550,1044,"21 de agosto de 1994"
15,12,13,251,388,413,801,"21 de agosto de 1994"
15,12,13,252,642,645,1287,"21 de agosto de 1994"
15,12,13,253,481,518,999,"21 de agosto de 1994"
15,12,13,254,532,590,1122,"21 de agosto de 1994"
15,12,13,255,520,576,1096,"21 de agosto de 1994"
15,12,13,256,739,834,1573,"21 de agosto de 1994"
15,12,13,257,532,595,1127,"21 de agosto de 1994"
15,12,13,258,643,741,1384,"21 de agosto de 1994"
15,12,13,259,391,461,852,"21 de agosto de 1994"
15,12,13,260,329,363,692,"21 de agosto de 1994"
15,12,13,261,703,809,1512,"21 de agosto de 1994"
15,12,13,262,840,942,1782,"21 de agosto de 1994"
15,12,13,263,607,660,1267,"21 de agosto de 1994"
15,12,13,264,374,432,806,"21 de agosto de 1994"
15,12,13,265,418,484,902,"21 de agosto de 1994"
15,12,13,266,181,230,411,"21 de agosto de 1994"
15,12,13,267,373,481,854,"21 de agosto de 1994"
15,12,13,268,326,420,746,"21 de agosto de 1994"
15,12,13,269,141,173,314,"21 de agosto de 1994"
15,12,13,270,606,662,1268,"21 de agosto de 1994"
15,12,13,271,503,594,1097,"21 de agosto de 1994"
15,12,13,272,841,936,1777,"21 de agosto de 1994"
15,12,13,273,379,428,807,"21 de agosto de 1994"
15,12,13,274,503,581,1084,"21 de agosto de 1994"
15,12,13,275,515,523,1038,"21 de agosto de 1994"
15,12,13,276,569,630,1199,"21 de agosto de 1994"
15,12,13,277,419,487,906,"21 de agosto de 1994"
15,12,13,278,565,613,1178,"21 de agosto de 1994"
15,12,13,279,434,494,928,"21 de agosto de 1994"
15,12,13,280,326,339,665,"21 de agosto de 1994"
15,12,13,281,494,595,1089,"21 de agosto de 1994"
15,12,13,282,654,773,1427,"21 de agosto de 1994"
15,12,13,283,721,824,1545,"21 de agosto de 1994"
15,12,13,284,285,377,662,"21 de agosto de 1994"
15,12,13,285,357,411,768,"21 de agosto de 1994"
15,12,13,286,212,262,474,"21 de agosto de 1994"
15,12,13,287,616,659,1275,"21 de agosto de 1994"
15,12,13,288,456,506,962,"21 de agosto de 1994"
15,12,13,289,629,705,1334,"21 de agosto de 1994"
15,12,13,290,703,765,1468,"21 de agosto de 1994"
15,12,13,291,337,417,754,"21 de agosto de 1994"
15,12,13,292,365,455,820,"21 de agosto de 1994"
15,12,13,293,201,220,421,"21 de agosto de 1994"
15,12,13,294,539,622,1161,"21 de agosto de 1994"
15,12,13,295,758,787,1545,"21 de agosto de 1994"
15,12,13,296,579,649,1228,"21 de agosto de 1994"
15,12,13,297,897,954,1851,"21 de agosto de 1994"
15,12,13,298,547,633,1180,"21 de agosto de 1994"
15,12,13,299,516,583,1099,"21 de agosto de 1994"
15,12,13,300,557,609,1166,"21 de agosto de 1994"
15,12,13,301,578,612,1190,"21 de agosto de 1994"
15,12,13,302,553,643,1196,"21 de agosto de 1994"
15,12,13,303,286,325,611,"21 de agosto de 1994"
15,12,13,304,316,352,668,"21 de agosto de 1994"
15,12,13,305,338,365,703,"21 de agosto de 1994"
15,12,13,306,618,631,1249,"21 de agosto de 1994"
15,12,13,307,792,854,1646,"21 de agosto de 1994"
15,12,13,308,464,528,992,"21 de agosto de 1994"
15,12,13,309,424,483,907,"21 de agosto de 1994"
15,12,13,310,677,792,1469,"21 de agosto de 1994"
15,12,13,311,354,455,809,"21 de agosto de 1994"
15,12,13,312,892,973,1865,"21 de agosto de 1994"
15,12,13,313,532,635,1167,"21 de agosto de 1994"
15,12,13,314,719,799,1518,"21 de agosto de 1994"
15,12,13,315,394,461,855,"21 de agosto de 1994"
15,12,13,316,587,646,1233,"21 de agosto de 1994"
15,12,13,317,579,588,1167,"21 de agosto de 1994"
15,12,13,318,736,810,1546,"21 de agosto de 1994"
15,12,13,319,631,671,1302,"21 de agosto de 1994"
15,12,13,320,899,957,1856,"21 de agosto de 1994"
15,12,13,321,582,775,1357,"21 de agosto de 1994"
15,12,13,322,692,778,1470,"21 de agosto de 1994"
15,12,13,323,574,601,1175,"21 de agosto de 1994"
15,12,13,324,822,880,1702,"21 de agosto de 1994"
15,12,13,325,439,512,951,"21 de agosto de 1994"
15,12,13,326,690,783,1473,"21 de agosto de 1994"
15,12,13,327,308,388,696,"21 de agosto de 1994"
15,12,13,328,248,315,563,"21 de agosto de 1994"
15,12,13,329,641,720,1361,"21 de agosto de 1994"
15,12,13,330,876,937,1813,"21 de agosto de 1994"
15,12,13,331,591,668,1259,"21 de agosto de 1994"
15,12,13,332,794,813,1607,"21 de agosto de 1994"
15,12,13,333,689,770,1459,"21 de agosto de 1994"
15,12,13,334,331,322,653,"21 de agosto de 1994"
15,12,13,335,566,630,1196,"21 de agosto de 1994"
15,12,13,336,664,715,1379,"21 de agosto de 1994"
15,12,13,337,598,693,1291,"21 de agosto de 1994"
15,12,13,338,560,579,1139,"21 de agosto de 1994"
15,12,13,339,435,512,947,"21 de agosto de 1994"
15,12,13,340,773,822,1595,"21 de agosto de 1994"
15,12,13,341,646,681,1327,"21 de agosto de 1994"
15,12,13,342,623,725,1348,"21 de agosto de 1994"
15,12,13,343,674,725,1399,"21 de agosto de 1994"
15,12,13,344,224,251,475,"21 de agosto de 1994"
15,12,13,345,748,877,1625,"21 de agosto de 1994"
15,12,13,346,583,652,1235,"21 de agosto de 1994"
15,12,13,347,500,563,1063,"21 de agosto de 1994"
15,12,13,348,592,659,1251,"21 de agosto de 1994"
15,12,13,349,635,742,1377,"21 de agosto de 1994"
15,12,13,350,492,504,996,"21 de agosto de 1994"
15,12,13,351,735,830,1565,"21 de agosto de 1994"
15,12,13,352,895,960,1855,"21 de agosto de 1994"
15,12,13,353,762,833,1595,"21 de agosto de 1994"
15,12,13,354,783,846,1629,"21 de agosto de 1994"
15,12,13,355,500,538,1038,"21 de agosto de 1994"
15,12,13,356,692,745,1437,"21 de agosto de 1994"
15,12,13,357,788,800,1588,"21 de agosto de 1994"
15,12,13,358,377,483,860,"21 de agosto de 1994"
15,12,13,359,655,749,1404,"21 de agosto de 1994"
15,12,13,360,818,881,1699,"21 de agosto de 1994"
15,12,13,361,738,855,1593,"21 de agosto de 1994"
15,12,13,362,490,587,1077,"21 de agosto de 1994"
15,12,13,363,596,702,1298,"21 de agosto de 1994"
15,12,13,364,632,726,1358,"21 de agosto de 1994"
15,12,13,365,550,569,1119,"21 de agosto de 1994"
15,12,13,366,476,507,983,"21 de agosto de 1994"
15,12,13,367,379,448,827,"21 de agosto de 1994"
15,12,13,368,537,674,1211,"21 de agosto de 1994"
15,12,13,369,665,785,1450,"21 de agosto de 1994"
15,12,13,370,421,499,920,"21 de agosto de 1994"
15,12,13,371,326,340,666,"21 de agosto de 1994"
15,12,13,372,519,610,1129,"21 de agosto de 1994"
15,12,13,373,358,417,775,"21 de agosto de 1994"
15,12,13,374,637,675,1312,"21 de agosto de 1994"
15,12,13,375,605,664,1269,"21 de agosto de 1994"
15,12,13,376,236,260,496,"21 de agosto de 1994"
15,12,13,377,689,737,1426,"21 de agosto de 1994"
15,12,13,378,264,286,550,"21 de agosto de 1994"
15,12,13,379,549,657,1206,"21 de agosto de 1994"
15,12,13,380,366,443,809,"21 de agosto de 1994"
15,12,13,381,962,1132,2094,"21 de agosto de 1994"
15,12,13,382,624,780,1404,"21 de agosto de 1994"
15,12,13,383,772,892,1664,"21 de agosto de 1994"
15,12,13,384,161,195,356,"21 de agosto de 1994"
15,12,13,385,368,418,786,"21 de agosto de 1994"
15,12,13,386,468,532,1000,"21 de agosto de 1994"
15,12,13,387,418,502,920,"21 de agosto de 1994"
15,12,13,388,438,502,940,"21 de agosto de 1994"
15,12,13,389,378,445,823,"21 de agosto de 1994"
15,12,13,390,515,560,1075,"21 de agosto de 1994"
15,12,13,391,205,256,461,"21 de agosto de 1994"
15,12,13,392,614,741,1355,"21 de agosto de 1994"
15,12,13,393,879,978,1857,"21 de agosto de 1994"
15,12,13,394,599,653,1252,"21 de agosto de 1994"
15,12,13,395,816,898,1714,"21 de agosto de 1994"
15,12,13,396,803,901,1704,"21 de agosto de 1994"
15,12,13,397,549,635,1184,"21 de agosto de 1994"
15,12,13,398,659,771,1430,"21 de agosto de 1994"
15,12,13,399,694,745,1439,"21 de agosto de 1994"
15,12,13,400,626,712,1338,"21 de agosto de 1994"
15,12,13,401,486,545,1031,"21 de agosto de 1994"
15,12,13,402,707,779,1486,"21 de agosto de 1994"
15,12,13,403,537,669,1206,"21 de agosto de 1994"
15,12,13,404,690,817,1507,"21 de agosto de 1994"
15,12,13,405,647,700,1347,"21 de agosto de 1994"
15,12,13,406,495,593,1088,"21 de agosto de 1994"
15,12,13,407,362,402,764,"21 de agosto de 1994"
15,12,13,408,789,890,1679,"21 de agosto de 1994"
15,12,13,409,605,685,1290,"21 de agosto de 1994"
15,12,13,410,835,888,1723,"21 de agosto de 1994"
15,12,13,411,752,815,1567,"21 de agosto de 1994"
15,12,13,412,479,625,1104,"21 de agosto de 1994"
15,12,13,413,562,654,1216,"21 de agosto de 1994"
15,12,13,414,376,446,822,"21 de agosto de 1994"
15,12,13,415,295,331,626,"21 de agosto de 1994"
15,12,13,416,479,526,1005,"21 de agosto de 1994"
15,12,105,4836,639,822,1461,"21 de agosto de 1994"
15,12,105,4837,614,789,1403,"21 de agosto de 1994"
15,12,105,4838,777,883,1660,"21 de agosto de 1994"
15,12,105,4839,621,792,1413,"21 de agosto de 1994"
15,12,105,4840,395,548,943,"21 de agosto de 1994"
15,12,105,4841,623,742,1365,"21 de agosto de 1994"
15,12,105,4842,625,688,1313,"21 de agosto de 1994"
15,12,105,4843,638,777,1415,"21 de agosto de 1994"
15,12,105,4844,134,149,283,"21 de agosto de 1994"
15,12,105,4845,627,707,1334,"21 de agosto de 1994"
15,12,105,4846,795,905,1700,"21 de agosto de 1994"
15,12,105,4847,606,742,1348,"21 de agosto de 1994"
15,12,105,4848,498,617,1115,"21 de agosto de 1994"
15,12,105,4849,665,828,1493,"21 de agosto de 1994"
15,12,105,4850,504,576,1080,"21 de agosto de 1994"
15,12,105,4851,654,780,1434,"21 de agosto de 1994"
15,12,105,4852,616,758,1374,"21 de agosto de 1994"
15,12,105,4853,587,677,1264,"21 de agosto de 1994"
15,12,105,4854,620,805,1425,"21 de agosto de 1994"
15,12,105,4855,619,642,1261,"21 de agosto de 1994"
15,12,105,4856,665,742,1407,"21 de agosto de 1994"
15,12,105,4857,537,614,1151,"21 de agosto de 1994"
15,12,105,4858,811,892,1703,"21 de agosto de 1994"
15,12,105,4859,414,464,878,"21 de agosto de 1994"
15,12,105,4860,417,453,870,"21 de agosto de 1994"
15,12,105,4861,701,689,1390,"21 de agosto de 1994"
15,12,105,4862,641,709,1350,"21 de agosto de 1994"
15,12,105,4863,429,484,913,"21 de agosto de 1994"
15,12,105,4864,338,361,699,"21 de agosto de 1994"
15,12,105,4865,632,774,1406,"21 de agosto de 1994"
15,12,105,4866,718,837,1555,"21 de agosto de 1994"
15,12,105,4867,360,393,753,"21 de agosto de 1994"
15,12,105,4868,797,809,1606,"21 de agosto de 1994"
15,13,38,1992,448,458,906,"21 de agosto de 1994"
15,13,38,1993,329,383,712,"21 de agosto de 1994"
15,13,38,1994,404,419,823,"21 de agosto de 1994"
15,13,38,1995,598,658,1256,"21 de agosto de 1994"
15,13,38,1996,725,822,1547,"21 de agosto de 1994"
15,13,38,1997,586,614,1200,"21 de agosto de 1994"
15,13,38,1998,436,433,869,"21 de agosto de 1994"
15,13,38,1999,285,341,626,"21 de agosto de 1994"
15,13,38,2000,749,823,1572,"21 de agosto de 1994"
15,13,38,2001,353,381,734,"21 de agosto de 1994"
15,13,38,2002,385,499,884,"21 de agosto de 1994"
15,13,38,2003,488,652,1140,"21 de agosto de 1994"
15,13,38,2004,458,593,1051,"21 de agosto de 1994"
15,13,38,2005,489,642,1131,"21 de agosto de 1994"
15,13,38,2006,680,812,1492,"21 de agosto de 1994"
15,13,38,2007,857,974,1831,"21 de agosto de 1994"
15,13,38,2008,827,914,1741,"21 de agosto de 1994"
15,13,38,2009,406,512,918,"21 de agosto de 1994"
15,13,38,2010,655,839,1494,"21 de agosto de 1994"
15,13,38,2011,526,784,1310,"21 de agosto de 1994"
15,13,38,2012,473,619,1092,"21 de agosto de 1994"
15,13,38,2013,418,580,998,"21 de agosto de 1994"
15,13,38,2014,511,667,1178,"21 de agosto de 1994"
15,13,38,2015,461,660,1121,"21 de agosto de 1994"
15,13,38,2016,539,647,1186,"21 de agosto de 1994"
15,13,38,2017,425,581,1006,"21 de agosto de 1994"
15,13,38,2018,613,645,1258,"21 de agosto de 1994"
15,13,38,2019,722,744,1466,"21 de agosto de 1994"
15,13,38,2020,649,699,1348,"21 de agosto de 1994"
15,13,38,2021,403,442,845,"21 de agosto de 1994"
15,13,38,2022,397,420,817,"21 de agosto de 1994"
15,13,38,2023,440,461,901,"21 de agosto de 1994"
15,13,38,2024,595,623,1218,"21 de agosto de 1994"
15,13,38,2025,742,793,1535,"21 de agosto de 1994"
15,13,38,2026,442,498,940,"21 de agosto de 1994"
15,13,38,2027,817,838,1655,"21 de agosto de 1994"
15,13,38,2028,604,687,1291,"21 de agosto de 1994"
15,13,38,2029,384,378,762,"21 de agosto de 1994"
15,13,38,2030,491,495,986,"21 de agosto de 1994"
15,13,38,2031,438,432,870,"21 de agosto de 1994"
15,13,38,2032,117,130,247,"21 de agosto de 1994"
15,13,38,2033,384,401,785,"21 de agosto de 1994"
15,13,38,2034,810,859,1669,"21 de agosto de 1994"
15,13,38,2035,112,141,253,"21 de agosto de 1994"
15,13,38,2036,402,570,972,"21 de agosto de 1994"
15,13,38,2037,443,595,1038,"21 de agosto de 1994"
15,13,38,2038,330,476,806,"21 de agosto de 1994"
15,13,38,2039,732,803,1535,"21 de agosto de 1994"
15,13,38,2040,505,530,1035,"21 de agosto de 1994"
15,13,38,2041,437,448,885,"21 de agosto de 1994"
15,13,38,2042,614,683,1297,"21 de agosto de 1994"
15,13,38,2043,459,472,931,"21 de agosto de 1994"
15,13,38,2044,493,502,995,"21 de agosto de 1994"
15,13,38,2045,364,380,744,"21 de agosto de 1994"
15,13,38,2046,818,870,1688,"21 de agosto de 1994"
15,13,38,2047,837,939,1776,"21 de agosto de 1994"
15,13,38,2048,422,465,887,"21 de agosto de 1994"
15,13,38,2049,449,557,1006,"21 de agosto de 1994"
15,13,38,2050,603,722,1325,"21 de agosto de 1994"
15,13,38,2051,463,514,977,"21 de agosto de 1994"
15,13,38,2052,413,484,897,"21 de agosto de 1994"
15,13,38,2053,538,571,1109,"21 de agosto de 1994"
15,13,38,2054,473,534,1007,"21 de agosto de 1994"
15,13,38,2055,445,461,906,"21 de agosto de 1994"
15,13,38,2056,139,169,308,"21 de agosto de 1994"
15,13,38,2057,525,572,1097,"21 de agosto de 1994"
15,13,38,2058,396,404,800,"21 de agosto de 1994"
15,13,38,2059,272,277,549,"21 de agosto de 1994"
15,13,38,2060,773,827,1600,"21 de agosto de 1994"
15,13,38,2061,538,517,1055,"21 de agosto de 1994"
15,13,38,2062,260,276,536,"21 de agosto de 1994"
15,13,38,2063,467,504,971,"21 de agosto de 1994"
15,13,38,2064,393,387,780,"21 de agosto de 1994"
15,13,38,2065,583,598,1181,"21 de agosto de 1994"
15,13,38,2066,523,570,1093,"21 de agosto de 1994"
15,13,38,2067,701,719,1420,"21 de agosto de 1994"
15,13,58,2628,373,423,796,"21 de agosto de 1994"
15,13,58,2629,654,706,1360,"21 de agosto de 1994"
15,13,58,2630,413,427,840,"21 de agosto de 1994"
15,13,58,2631,440,463,903,"21 de agosto de 1994"
15,13,58,2632,465,499,964,"21 de agosto de 1994"
15,13,58,2633,354,393,747,"21 de agosto de 1994"
15,13,58,2634,669,747,1416,"21 de agosto de 1994"
15,13,58,2635,672,718,1390,"21 de agosto de 1994"
15,13,58,2636,825,855,1680,"21 de agosto de 1994"
15,13,58,2637,630,683,1313,"21 de agosto de 1994"
15,13,58,2638,708,799,1507,"21 de agosto de 1994"
15,13,58,2639,612,682,1294,"21 de agosto de 1994"
15,13,58,2640,786,876,1662,"21 de agosto de 1994"
15,13,58,2641,684,714,1398,"21 de agosto de 1994"
15,13,58,2642,705,723,1428,"21 de agosto de 1994"
15,13,58,2643,657,715,1372,"21 de agosto de 1994"
15,13,58,2644,612,664,1276,"21 de agosto de 1994"
15,13,58,2645,786,816,1602,"21 de agosto de 1994"
15,13,58,2646,517,513,1030,"21 de agosto de 1994"
15,13,58,2647,796,812,1608,"21 de agosto de 1994"
15,13,58,2648,629,657,1286,"21 de agosto de 1994"
15,13,58,2649,883,895,1778,"21 de agosto de 1994"
15,13,58,2650,867,972,1839,"21 de agosto de 1994"
15,13,58,2651,457,494,951,"21 de agosto de 1994"
15,13,58,2652,479,525,1004,"21 de agosto de 1994"
15,13,58,2653,610,666,1276,"21 de agosto de 1994"
15,13,58,2654,623,605,1228,"21 de agosto de 1994"
15,13,58,2655,492,586,1078,"21 de agosto de 1994"
15,13,58,2656,800,893,1693,"21 de agosto de 1994"
15,13,58,2657,633,677,1310,"21 de agosto de 1994"
15,13,58,2658,806,835,1641,"21 de agosto de 1994"
15,13,58,2659,480,501,981,"21 de agosto de 1994"
15,13,58,2660,385,404,789,"21 de agosto de 1994"
15,13,58,2661,772,806,1578,"21 de agosto de 1994"
15,13,58,2662,778,866,1644,"21 de agosto de 1994"
15,13,58,2663,505,575,1080,"21 de agosto de 1994"
15,13,58,2664,691,775,1466,"21 de agosto de 1994"
15,13,58,2665,589,611,1200,"21 de agosto de 1994"
15,13,58,2666,600,727,1327,"21 de agosto de 1994"
15,13,58,2667,697,732,1429,"21 de agosto de 1994"
15,13,58,2668,612,680,1292,"21 de agosto de 1994"
15,13,58,2669,731,760,1491,"21 de agosto de 1994"
15,13,58,2670,535,591,1126,"21 de agosto de 1994"
15,13,58,2671,418,436,854,"21 de agosto de 1994"
15,13,58,2672,557,637,1194,"21 de agosto de 1994"
15,13,58,2673,477,533,1010,"21 de agosto de 1994"
15,13,58,2674,546,569,1115,"21 de agosto de 1994"
15,13,58,2675,762,792,1554,"21 de agosto de 1994"
15,13,58,2676,775,823,1598,"21 de agosto de 1994"
15,13,58,2677,664,661,1325,"21 de agosto de 1994"
15,13,58,2678,933,1001,1934,"21 de agosto de 1994"
15,13,58,2679,685,694,1379,"21 de agosto de 1994"
15,13,58,2680,732,789,1521,"21 de agosto de 1994"
15,13,58,2681,735,762,1497,"21 de agosto de 1994"
15,13,58,2682,748,782,1530,"21 de agosto de 1994"
15,13,58,2683,736,795,1531,"21 de agosto de 1994"
15,13,58,2684,237,234,471,"21 de agosto de 1994"
15,13,58,2685,323,346,669,"21 de agosto de 1994"
15,13,58,2686,680,770,1450,"21 de agosto de 1994"
15,13,58,2687,692,823,1515,"21 de agosto de 1994"
15,13,58,2688,413,526,939,"21 de agosto de 1994"
15,13,58,2689,455,480,935,"21 de agosto de 1994"
15,13,58,2690,717,966,1683,"21 de agosto de 1994"
15,13,58,2691,468,644,1112,"21 de agosto de 1994"
15,13,58,2692,422,472,894,"21 de agosto de 1994"
15,13,58,2693,228,273,501,"21 de agosto de 1994"
15,13,58,2694,396,506,902,"21 de agosto de 1994"
15,13,58,2695,425,537,962,"21 de agosto de 1994"
15,13,58,2696,459,596,1055,"21 de agosto de 1994"
15,13,58,2697,387,464,851,"21 de agosto de 1994"
15,13,58,2698,423,588,1011,"21 de agosto de 1994"
15,13,58,2699,285,381,666,"21 de agosto de 1994"
15,13,58,2700,454,629,1083,"21 de agosto de 1994"
15,13,58,2701,623,660,1283,"21 de agosto de 1994"
15,13,58,2702,448,607,1055,"21 de agosto de 1994"
15,13,58,2703,333,467,800,"21 de agosto de 1994"
15,13,58,2704,294,407,701,"21 de agosto de 1994"
15,13,58,2705,521,560,1081,"21 de agosto de 1994"
15,13,58,2706,345,439,784,"21 de agosto de 1994"
15,13,58,2707,61,201,262,"21 de agosto de 1994"
15,13,58,2708,202,487,689,"21 de agosto de 1994"
15,13,58,2709,1647,6,1653,"21 de agosto de 1994"
15,13,58,2710,732,6,738,"21 de agosto de 1994"
15,13,58,2711,117,226,343,"21 de agosto de 1994"
15,13,58,2712,637,2,639,"21 de agosto de 1994"
15,13,58,2713,438,0,438,"21 de agosto de 1994"
15,13,58,2714,479,1,480,"21 de agosto de 1994"
15,13,58,2715,854,5,859,"21 de agosto de 1994"
15,13,58,2716,98,9,107,"21 de agosto de 1994"
15,13,58,2717,457,0,457,"21 de agosto de 1994"
15,13,58,2718,162,0,162,"21 de agosto de 1994"
15,13,58,2719,662,56,718,"21 de agosto de 1994"
15,13,58,2720,873,0,873,"21 de agosto de 1994"
15,13,58,2721,725,2,727,"21 de agosto de 1994"
15,13,58,2722,937,4,941,"21 de agosto de 1994"
15,14,105,4869,493,520,1013,"21 de agosto de 1994"
15,14,105,4870,736,694,1430,"21 de agosto de 1994"
15,14,105,4871,398,426,824,"21 de agosto de 1994"
15,14,105,4872,764,872,1636,"21 de agosto de 1994"
15,14,105,4873,585,643,1228,"21 de agosto de 1994"
15,14,105,4874,502,559,1061,"21 de agosto de 1994"
15,14,105,4875,605,693,1298,"21 de agosto de 1994"
15,14,105,4876,754,810,1564,"21 de agosto de 1994"
15,14,105,4877,622,680,1302,"21 de agosto de 1994"
15,14,105,4878,635,689,1324,"21 de agosto de 1994"
15,14,105,4879,63,89,152,"21 de agosto de 1994"
15,14,105,4880,114,126,240,"21 de agosto de 1994"
15,14,105,4881,291,334,625,"21 de agosto de 1994"
15,14,105,4882,441,437,878,"21 de agosto de 1994"
15,14,105,4883,427,476,903,"21 de agosto de 1994"
15,14,105,4884,428,464,892,"21 de agosto de 1994"
15,14,105,4885,540,558,1098,"21 de agosto de 1994"
15,14,105,4886,607,695,1302,"21 de agosto de 1994"
15,14,105,4887,449,490,939,"21 de agosto de 1994"
15,14,105,4888,527,592,1119,"21 de agosto de 1994"
15,14,105,4889,381,421,802,"21 de agosto de 1994"
15,14,105,4890,744,819,1563,"21 de agosto de 1994"
15,14,105,4891,394,460,854,"21 de agosto de 1994"
15,14,105,4892,359,394,753,"21 de agosto de 1994"
15,14,105,4893,462,503,965,"21 de agosto de 1994"
15,14,105,4894,701,787,1488,"21 de agosto de 1994"
15,14,105,4895,532,587,1119,"21 de agosto de 1994"
15,14,105,4896,393,403,796,"21 de agosto de 1994"
15,14,105,4897,386,404,790,"21 de agosto de 1994"
15,14,105,4898,578,604,1182,"21 de agosto de 1994"
15,14,105,4899,468,471,939,"21 de agosto de 1994"
15,14,105,4900,331,376,707,"21 de agosto de 1994"
15,14,105,4901,384,436,820,"21 de agosto de 1994"
15,14,105,4902,212,255,467,"21 de agosto de 1994"
15,14,105,4903,267,338,605,"21 de agosto de 1994"
15,14,105,4904,333,399,732,"21 de agosto de 1994"
15,14,105,4905,533,599,1132,"21 de agosto de 1994"
15,14,105,4906,330,384,714,"21 de agosto de 1994"
15,14,105,4907,480,522,1002,"21 de agosto de 1994"
15,14,105,4908,340,360,700,"21 de agosto de 1994"
15,14,105,4909,565,683,1248,"21 de agosto de 1994"
15,14,105,4910,547,628,1175,"21 de agosto de 1994"
15,14,105,4911,439,492,931,"21 de agosto de 1994"
15,14,105,4912,609,702,1311,"21 de agosto de 1994"
15,14,105,4913,315,335,650,"21 de agosto de 1994"
15,14,105,4914,633,705,1338,"21 de agosto de 1994"
15,14,105,4915,663,724,1387,"21 de agosto de 1994"
15,14,105,4916,352,417,769,"21 de agosto de 1994"
15,14,105,4917,719,843,1562,"21 de agosto de 1994"
15,14,105,4918,575,599,1174,"21 de agosto de 1994"
15,14,105,4919,493,550,1043,"21 de agosto de 1994"
15,14,105,4920,653,711,1364,"21 de agosto de 1994"
15,14,105,4921,527,646,1173,"21 de agosto de 1994"
15,14,105,4922,407,438,845,"21 de agosto de 1994"
15,14,105,4923,524,590,1114,"21 de agosto de 1994"
15,14,105,4924,266,287,553,"21 de agosto de 1994"
15,14,105,4925,652,733,1385,"21 de agosto de 1994"
15,14,105,4926,786,882,1668,"21 de agosto de 1994"
15,14,105,4927,476,591,1067,"21 de agosto de 1994"
15,14,105,4928,433,552,985,"21 de agosto de 1994"
15,14,105,4929,499,645,1144,"21 de agosto de 1994"
15,14,105,4930,466,456,922,"21 de agosto de 1994"
15,14,105,4931,373,430,803,"21 de agosto de 1994"
15,14,105,4932,181,213,394,"21 de agosto de 1994"
15,14,105,4933,283,314,597,"21 de agosto de 1994"
15,14,105,4934,303,346,649,"21 de agosto de 1994"
15,14,105,4935,632,711,1343,"21 de agosto de 1994"
15,14,105,4936,358,389,747,"21 de agosto de 1994"
15,14,105,4937,639,678,1317,"21 de agosto de 1994"
15,14,105,4938,744,764,1508,"21 de agosto de 1994"
15,14,105,4939,409,465,874,"21 de agosto de 1994"
15,14,105,4940,403,415,818,"21 de agosto de 1994"
15,14,105,4941,524,617,1141,"21 de agosto de 1994"
15,14,105,4942,641,685,1326,"21 de agosto de 1994"
15,14,105,4943,699,718,1417,"21 de agosto de 1994"
15,14,105,4944,651,682,1333,"21 de agosto de 1994"
15,14,105,4945,535,572,1107,"21 de agosto de 1994"
15,14,105,4946,781,827,1608,"21 de agosto de 1994"
15,14,105,4947,409,472,881,"21 de agosto de 1994"
15,14,105,4948,629,744,1373,"21 de agosto de 1994"
15,14,105,4949,684,779,1463,"21 de agosto de 1994"
15,14,105,4950,433,476,909,"21 de agosto de 1994"
15,14,105,4951,435,467,902,"21 de agosto de 1994"
15,14,105,4952,425,460,885,"21 de agosto de 1994"
15,14,105,4953,567,624,1191,"21 de agosto de 1994"
15,14,105,4954,584,605,1189,"21 de agosto de 1994"
15,14,105,4955,496,558,1054,"21 de agosto de 1994"
15,14,105,4956,524,621,1145,"21 de agosto de 1994"
15,14,105,4957,493,586,1079,"21 de agosto de 1994"
15,14,105,4958,615,664,1279,"21 de agosto de 1994"
15,14,105,4959,498,580,1078,"21 de agosto de 1994"
15,14,105,4960,532,561,1093,"21 de agosto de 1994"
15,14,105,4961,609,693,1302,"21 de agosto de 1994"
15,14,105,4962,570,611,1181,"21 de agosto de 1994"
15,15,9,193,341,379,720,"21 de agosto de 1994"
15,15,9,194,369,396,765,"21 de agosto de 1994"
15,15,9,195,444,482,926,"21 de agosto de 1994"
15,15,9,196,446,495,941,"21 de agosto de 1994"
15,15,9,197,362,437,799,"21 de agosto de 1994"
15,15,9,198,308,361,669,"21 de agosto de 1994"
15,15,9,199,268,309,577,"21 de agosto de 1994"
15,15,9,200,317,393,710,"21 de agosto de 1994"
15,15,9,201,474,541,1015,"21 de agosto de 1994"
15,15,9,202,451,449,900,"21 de agosto de 1994"
15,15,9,203,267,295,562,"21 de agosto de 1994"
15,15,9,204,352,392,744,"21 de agosto de 1994"
15,15,9,205,347,425,772,"21 de agosto de 1994"
15,15,9,206,385,403,788,"21 de agosto de 1994"
15,15,9,207,511,542,1053,"21 de agosto de 1994"
15,15,9,208,525,621,1146,"21 de agosto de 1994"
15,15,9,209,439,471,910,"21 de agosto de 1994"
15,15,9,210,462,475,937,"21 de agosto de 1994"
15,15,9,211,460,485,945,"21 de agosto de 1994"
15,15,9,212,640,646,1286,"21 de agosto de 1994"
15,15,9,213,433,404,837,"21 de agosto de 1994"
15,15,9,214,326,350,676,"21 de agosto de 1994"
15,15,9,215,579,605,1184,"21 de agosto de 1994"
15,15,9,216,363,411,774,"21 de agosto de 1994"
15,15,9,217,433,447,880,"21 de agosto de 1994"
15,15,9,218,338,357,695,"21 de agosto de 1994"
15,15,15,456,543,571,1114,"21 de agosto de 1994"
15,15,15,457,362,380,742,"21 de agosto de 1994"
15,15,15,458,342,358,700,"21 de agosto de 1994"
15,15,15,459,384,385,769,"21 de agosto de 1994"
15,15,15,460,455,466,921,"21 de agosto de 1994"
15,15,15,461,118,115,233,"21 de agosto de 1994"
15,15,15,462,202,219,421,"21 de agosto de 1994"
15,15,15,463,599,612,1211,"21 de agosto de 1994"
15,15,15,464,736,750,1486,"21 de agosto de 1994"
15,15,15,465,327,322,649,"21 de agosto de 1994"
15,15,15,466,356,381,737,"21 de agosto de 1994"
15,15,15,467,617,580,1197,"21 de agosto de 1994"
15,15,15,468,372,337,709,"21 de agosto de 1994"
15,15,17,490,446,473,919,"21 de agosto de 1994"
15,15,17,491,333,351,684,"21 de agosto de 1994"
15,15,17,492,100,99,199,"21 de agosto de 1994"
15,15,17,493,159,153,312,"21 de agosto de 1994"
15,15,17,494,283,280,563,"21 de agosto de 1994"
15,15,22,648,444,453,897,"21 de agosto de 1994"
15,15,22,649,479,513,992,"21 de agosto de 1994"
15,15,22,650,463,503,966,"21 de agosto de 1994"
15,15,22,651,405,422,827,"21 de agosto de 1994"
15,15,22,652,503,543,1046,"21 de agosto de 1994"
15,15,22,653,339,375,714,"21 de agosto de 1994"
15,15,26,912,572,639,1211,"21 de agosto de 1994"
15,15,26,913,590,588,1178,"21 de agosto de 1994"
15,15,26,914,449,469,918,"21 de agosto de 1994"
15,15,26,915,496,590,1086,"21 de agosto de 1994"
15,15,26,916,500,546,1046,"21 de agosto de 1994"
15,15,26,917,356,384,740,"21 de agosto de 1994"
15,15,26,918,284,299,583,"21 de agosto de 1994"
15,15,26,919,530,555,1085,"21 de agosto de 1994"
15,15,26,920,452,458,910,"21 de agosto de 1994"
15,15,26,921,352,398,750,"21 de agosto de 1994"
15,15,26,922,375,371,746,"21 de agosto de 1994"
15,15,26,923,499,541,1040,"21 de agosto de 1994"
15,15,26,924,626,630,1256,"21 de agosto de 1994"
15,15,26,925,552,612,1164,"21 de agosto de 1994"
15,15,26,926,546,603,1149,"21 de agosto de 1994"
15,15,26,927,333,365,698,"21 de agosto de 1994"
15,15,26,928,297,307,604,"21 de agosto de 1994"
15,15,26,929,428,459,887,"21 de agosto de 1994"
15,15,26,930,381,417,798,"21 de agosto de 1994"
15,15,26,931,559,584,1143,"21 de agosto de 1994"
15,15,26,932,489,533,1022,"21 de agosto de 1994"
15,15,26,933,475,513,988,"21 de agosto de 1994"
15,15,26,934,589,633,1222,"21 de agosto de 1994"
15,15,26,935,382,441,823,"21 de agosto de 1994"
15,15,26,936,453,501,954,"21 de agosto de 1994"
15,15,26,937,575,618,1193,"21 de agosto de 1994"
15,15,26,938,481,521,1002,"21 de agosto de 1994"
15,15,26,939,508,568,1076,"21 de agosto de 1994"
15,15,26,940,528,550,1078,"21 de agosto de 1994"
15,15,26,941,521,585,1106,"21 de agosto de 1994"
15,15,26,942,564,555,1119,"21 de agosto de 1994"
15,15,26,943,519,503,1022,"21 de agosto de 1994"
15,15,26,944,357,425,782,"21 de agosto de 1994"
15,15,26,945,322,339,661,"21 de agosto de 1994"
15,15,26,946,455,511,966,"21 de agosto de 1994"
15,15,26,947,742,759,1501,"21 de agosto de 1994"
15,15,26,948,606,622,1228,"21 de agosto de 1994"
15,15,26,949,520,550,1070,"21 de agosto de 1994"
15,15,26,950,386,446,832,"21 de agosto de 1994"
15,15,26,951,580,629,1209,"21 de agosto de 1994"
15,15,26,952,428,481,909,"21 de agosto de 1994"
15,15,26,953,331,345,676,"21 de agosto de 1994"
15,15,26,954,304,329,633,"21 de agosto de 1994"
15,15,26,955,392,416,808,"21 de agosto de 1994"
15,15,26,956,324,329,653,"21 de agosto de 1994"
15,15,26,957,427,435,862,"21 de agosto de 1994"
15,15,26,958,523,574,1097,"21 de agosto de 1994"
15,15,26,959,441,491,932,"21 de agosto de 1994"
15,15,26,960,526,581,1107,"21 de agosto de 1994"
15,15,26,961,577,665,1242,"21 de agosto de 1994"
15,15,26,962,535,586,1121,"21 de agosto de 1994"
15,15,26,963,572,613,1185,"21 de agosto de 1994"
15,15,26,964,503,560,1063,"21 de agosto de 1994"
15,15,26,965,367,441,808,"21 de agosto de 1994"
15,15,26,966,480,530,1010,"21 de agosto de 1994"
15,15,26,967,495,546,1041,"21 de agosto de 1994"
15,15,26,968,481,501,982,"21 de agosto de 1994"
15,15,26,969,521,548,1069,"21 de agosto de 1994"
15,15,26,970,448,502,950,"21 de agosto de 1994"
15,15,26,971,690,765,1455,"21 de agosto de 1994"
15,15,26,972,645,736,1381,"21 de agosto de 1994"
15,15,26,973,431,497,928,"21 de agosto de 1994"
15,15,26,974,590,628,1218,"21 de agosto de 1994"
15,15,26,975,490,490,980,"21 de agosto de 1994"
15,15,26,976,469,507,976,"21 de agosto de 1994"
15,15,26,977,598,657,1255,"21 de agosto de 1994"
15,15,26,978,465,453,918,"21 de agosto de 1994"
15,15,26,979,432,527,959,"21 de agosto de 1994"
15,15,26,980,524,596,1120,"21 de agosto de 1994"
15,15,26,981,603,607,1210,"21 de agosto de 1994"
15,15,26,982,574,583,1157,"21 de agosto de 1994"
15,15,26,983,560,591,1151,"21 de agosto de 1994"
15,15,26,984,684,762,1446,"21 de agosto de 1994"
15,15,26,985,433,475,908,"21 de agosto de 1994"
15,15,26,986,371,408,779,"21 de agosto de 1994"
15,15,26,987,411,439,850,"21 de agosto de 1994"
15,15,26,988,373,430,803,"21 de agosto de 1994"
15,15,26,989,221,240,461,"21 de agosto de 1994"
15,15,26,990,286,317,603,"21 de agosto de 1994"
15,15,26,991,468,547,1015,"21 de agosto de 1994"
15,15,26,992,352,434,786,"21 de agosto de 1994"
15,15,26,993,534,617,1151,"21 de agosto de 1994"
15,15,26,994,562,677,1239,"21 de agosto de 1994"
15,15,26,995,928,1065,1993,"21 de agosto de 1994"
15,15,26,996,679,698,1377,"21 de agosto de 1994"
15,15,26,997,379,421,800,"21 de agosto de 1994"
15,15,26,998,318,328,646,"21 de agosto de 1994"
15,15,26,999,595,613,1208,"21 de agosto de 1994"
15,15,26,1000,599,613,1212,"21 de agosto de 1994"
15,15,26,1001,495,564,1059,"21 de agosto de 1994"
15,15,26,1002,576,582,1158,"21 de agosto de 1994"
15,15,26,1003,648,674,1322,"21 de agosto de 1994"
15,15,26,1004,446,472,918,"21 de agosto de 1994"
15,15,26,1005,424,427,851,"21 de agosto de 1994"
15,15,26,1006,455,509,964,"21 de agosto de 1994"
15,15,26,1007,773,819,1592,"21 de agosto de 1994"
15,15,26,1008,444,469,913,"21 de agosto de 1994"
15,15,26,1009,624,682,1306,"21 de agosto de 1994"
15,15,26,1010,579,601,1180,"21 de agosto de 1994"
15,15,26,1011,636,660,1296,"21 de agosto de 1994"
15,15,26,1012,630,642,1272,"21 de agosto de 1994"
15,15,26,1013,488,540,1028,"21 de agosto de 1994"
15,15,26,1014,489,536,1025,"21 de agosto de 1994"
15,15,26,1015,503,562,1065,"21 de agosto de 1994"
15,15,26,1016,404,472,876,"21 de agosto de 1994"
15,15,26,1017,373,409,782,"21 de agosto de 1994"
15,15,26,1018,447,508,955,"21 de agosto de 1994"
15,15,26,1019,647,667,1314,"21 de agosto de 1994"
15,15,26,1020,333,378,711,"21 de agosto de 1994"
15,15,26,1021,367,437,804,"21 de agosto de 1994"
15,15,26,1022,579,641,1220,"21 de agosto de 1994"
15,15,26,1023,547,618,1165,"21 de agosto de 1994"
15,15,26,1024,282,323,605,"21 de agosto de 1994"
15,15,26,1025,588,655,1243,"21 de agosto de 1994"
15,15,26,1026,490,570,1060,"21 de agosto de 1994"
15,15,26,1027,505,588,1093,"21 de agosto de 1994"
15,15,26,1028,453,493,946,"21 de agosto de 1994"
15,15,26,1029,672,734,1406,"21 de agosto de 1994"
15,15,26,1030,634,686,1320,"21 de agosto de 1994"
15,15,26,1031,530,588,1118,"21 de agosto de 1994"
15,15,26,1032,567,624,1191,"21 de agosto de 1994"
15,15,26,1033,501,531,1032,"21 de agosto de 1994"
15,15,26,1034,697,715,1412,"21 de agosto de 1994"
15,15,26,1035,464,467,931,"21 de agosto de 1994"
15,15,26,1036,711,811,1522,"21 de agosto de 1994"
15,15,26,1037,774,851,1625,"21 de agosto de 1994"
15,15,26,1038,450,473,923,"21 de agosto de 1994"
15,15,26,1039,569,636,1205,"21 de agosto de 1994"
15,15,26,1040,605,681,1286,"21 de agosto de 1994"
15,15,26,1041,511,580,1091,"21 de agosto de 1994"
15,15,26,1042,642,771,1413,"21 de agosto de 1994"
15,15,26,1043,380,418,798,"21 de agosto de 1994"
15,15,26,1044,435,431,866,"21 de agosto de 1994"
15,15,26,1045,345,379,724,"21 de agosto de 1994"
15,15,26,1046,352,341,693,"21 de agosto de 1994"
15,15,26,1047,599,603,1202,"21 de agosto de 1994"
15,15,26,1048,205,233,438,"21 de agosto de 1994"
15,15,26,1049,626,686,1312,"21 de agosto de 1994"
15,15,26,1050,399,474,873,"21 de agosto de 1994"
15,15,26,1051,410,449,859,"21 de agosto de 1994"
15,15,26,1052,399,443,842,"21 de agosto de 1994"
15,15,26,1053,610,664,1274,"21 de agosto de 1994"
15,15,26,1054,403,497,900,"21 de agosto de 1994"
15,15,26,1055,526,545,1071,"21 de agosto de 1994"
15,15,26,1056,274,289,563,"21 de agosto de 1994"
15,15,26,1057,313,350,663,"21 de agosto de 1994"
15,15,26,1058,367,369,736,"21 de agosto de 1994"
15,15,26,1059,432,467,899,"21 de agosto de 1994"
15,15,26,1060,475,496,971,"21 de agosto de 1994"
15,15,26,1061,382,401,783,"21 de agosto de 1994"
15,15,26,1062,420,468,888,"21 de agosto de 1994"
15,15,26,1063,605,654,1259,"21 de agosto de 1994"
15,15,26,1064,434,498,932,"21 de agosto de 1994"
15,15,26,1065,668,712,1380,"21 de agosto de 1994"
15,15,26,1066,310,358,668,"21 de agosto de 1994"
15,15,26,1067,539,605,1144,"21 de agosto de 1994"
15,15,26,1068,658,658,1316,"21 de agosto de 1994"
15,15,26,1069,401,415,816,"21 de agosto de 1994"
15,15,26,1070,501,543,1044,"21 de agosto de 1994"
15,15,26,1071,420,470,890,"21 de agosto de 1994"
15,15,26,1072,406,431,837,"21 de agosto de 1994"
15,15,26,1073,562,583,1145,"21 de agosto de 1994"
15,15,26,1074,407,457,864,"21 de agosto de 1994"
15,15,26,1075,573,633,1206,"21 de agosto de 1994"
15,15,26,1076,787,789,1576,"21 de agosto de 1994"
15,15,26,1077,465,492,957,"21 de agosto de 1994"
15,15,26,1078,445,446,891,"21 de agosto de 1994"
15,15,26,1079,627,681,1308,"21 de agosto de 1994"
15,15,26,1080,526,525,1051,"21 de agosto de 1994"
15,15,30,1109,828,837,1665,"21 de agosto de 1994"
15,15,30,1110,589,623,1212,"21 de agosto de 1994"
15,15,30,1111,545,616,1161,"21 de agosto de 1994"
15,15,30,1112,933,959,1892,"21 de agosto de 1994"
15,15,30,1113,619,632,1251,"21 de agosto de 1994"
15,15,30,1114,564,643,1207,"21 de agosto de 1994"
15,15,30,1115,398,422,820,"21 de agosto de 1994"
15,15,30,1116,643,702,1345,"21 de agosto de 1994"
15,15,30,1117,441,532,973,"21 de agosto de 1994"
15,15,30,1118,509,612,1121,"21 de agosto de 1994"
15,15,30,1119,361,430,791,"21 de agosto de 1994"
15,15,30,1120,382,420,802,"21 de agosto de 1994"
15,15,30,1121,828,920,1748,"21 de agosto de 1994"
15,15,30,1122,549,607,1156,"21 de agosto de 1994"
15,15,30,1123,483,548,1031,"21 de agosto de 1994"
15,15,30,1124,583,663,1246,"21 de agosto de 1994"
15,15,30,1125,495,512,1007,"21 de agosto de 1994"
15,15,30,1126,521,578,1099,"21 de agosto de 1994"
15,15,30,1127,462,518,980,"21 de agosto de 1994"
15,15,30,1128,409,486,895,"21 de agosto de 1994"
15,15,30,1129,392,427,819,"21 de agosto de 1994"
15,15,30,1130,525,629,1154,"21 de agosto de 1994"
15,15,30,1131,348,424,772,"21 de agosto de 1994"
15,15,30,1132,357,411,768,"21 de agosto de 1994"
15,15,30,1133,447,510,957,"21 de agosto de 1994"
15,15,30,1134,434,475,909,"21 de agosto de 1994"
15,15,30,1135,369,412,781,"21 de agosto de 1994"
15,15,30,1136,481,570,1051,"21 de agosto de 1994"
15,15,30,1137,452,531,983,"21 de agosto de 1994"
15,15,30,1138,342,382,724,"21 de agosto de 1994"
15,15,30,1139,269,305,574,"21 de agosto de 1994"
15,15,30,1140,431,439,870,"21 de agosto de 1994"
15,15,30,1141,419,508,927,"21 de agosto de 1994"
15,15,35,1952,669,717,1386,"21 de agosto de 1994"
15,15,35,1953,569,551,1120,"21 de agosto de 1994"
15,15,35,1954,215,226,441,"21 de agosto de 1994"
15,15,35,1955,202,173,375,"21 de agosto de 1994"
15,15,40,2073,1017,1108,2125,"21 de agosto de 1994"
15,15,40,2074,334,391,725,"21 de agosto de 1994"
15,15,40,2075,370,457,827,"21 de agosto de 1994"
15,15,40,2076,147,185,332,"21 de agosto de 1994"
15,15,40,2077,528,657,1185,"21 de agosto de 1994"
15,15,40,2078,372,386,758,"21 de agosto de 1994"
15,15,40,2079,292,330,622,"21 de agosto de 1994"
15,15,40,2080,334,368,702,"21 de agosto de 1994"
15,15,40,2081,499,602,1101,"21 de agosto de 1994"
15,15,40,2082,848,916,1764,"21 de agosto de 1994"
15,15,40,2083,657,730,1387,"21 de agosto de 1994"
15,15,40,2084,358,355,713,"21 de agosto de 1994"
15,15,40,2085,262,315,577,"21 de agosto de 1994"
15,15,40,2086,544,604,1148,"21 de agosto de 1994"
15,15,40,2087,274,343,617,"21 de agosto de 1994"
15,15,40,2088,128,169,297,"21 de agosto de 1994"
15,15,40,2089,602,684,1286,"21 de agosto de 1994"
15,15,40,2090,303,319,622,"21 de agosto de 1994"
15,15,40,2091,282,347,629,"21 de agosto de 1994"
15,15,40,2092,291,312,603,"21 de agosto de 1994"
15,15,40,2093,450,481,931,"21 de agosto de 1994"
15,15,40,2094,794,812,1606,"21 de agosto de 1994"
15,15,40,2095,760,851,1611,"21 de agosto de 1994"
15,15,40,2096,311,319,630,"21 de agosto de 1994"
15,15,40,2097,1011,1223,2234,"21 de agosto de 1994"
15,15,40,2098,416,433,849,"21 de agosto de 1994"
15,15,40,2099,328,351,679,"21 de agosto de 1994"
15,15,40,2100,630,687,1317,"21 de agosto de 1994"
15,15,40,2101,400,431,831,"21 de agosto de 1994"
15,15,40,2102,289,329,618,"21 de agosto de 1994"
15,15,40,2103,567,618,1185,"21 de agosto de 1994"
15,15,40,2104,364,416,780,"21 de agosto de 1994"
15,15,40,2105,249,280,529,"21 de agosto de 1994"
15,15,40,2106,570,702,1272,"21 de agosto de 1994"
15,15,40,2107,681,721,1402,"21 de agosto de 1994"
15,15,40,2108,569,677,1246,"21 de agosto de 1994"
15,15,40,2109,439,503,942,"21 de agosto de 1994"
15,15,40,2110,533,593,1126,"21 de agosto de 1994"
15,15,40,2111,552,570,1122,"21 de agosto de 1994"
15,15,40,2112,187,239,426,"21 de agosto de 1994"
15,15,40,2113,215,266,481,"21 de agosto de 1994"
15,15,40,2114,530,551,1081,"21 de agosto de 1994"
15,15,40,2115,377,422,799,"21 de agosto de 1994"
15,15,40,2116,355,389,744,"21 de agosto de 1994"
15,15,40,2117,514,574,1088,"21 de agosto de 1994"
15,15,40,2118,493,597,1090,"21 de agosto de 1994"
15,15,40,2119,412,449,861,"21 de agosto de 1994"
15,15,40,2120,502,514,1016,"21 de agosto de 1994"
15,15,40,2121,400,450,850,"21 de agosto de 1994"
15,15,40,2122,368,418,786,"21 de agosto de 1994"
15,15,40,2123,760,818,1578,"21 de agosto de 1994"
15,15,40,2124,419,484,903,"21 de agosto de 1994"
15,15,40,2125,582,627,1209,"21 de agosto de 1994"
15,15,40,2126,359,386,745,"21 de agosto de 1994"
15,15,40,2127,523,604,1127,"21 de agosto de 1994"
15,15,40,2128,672,734,1406,"21 de agosto de 1994"
15,15,40,2129,724,785,1509,"21 de agosto de 1994"
15,15,40,2130,387,474,861,"21 de agosto de 1994"
15,15,40,2131,466,518,984,"21 de agosto de 1994"
15,15,40,2132,511,551,1062,"21 de agosto de 1994"
15,15,40,2133,593,679,1272,"21 de agosto de 1994"
15,15,40,2134,448,516,964,"21 de agosto de 1994"
15,15,40,2135,481,569,1050,"21 de agosto de 1994"
15,15,40,2136,519,540,1059,"21 de agosto de 1994"
15,15,40,2137,379,454,833,"21 de agosto de 1994"
15,15,40,2138,297,328,625,"21 de agosto de 1994"
15,15,40,2139,473,513,986,"21 de agosto de 1994"
15,15,40,2140,464,467,931,"21 de agosto de 1994"
15,15,40,2141,377,403,780,"21 de agosto de 1994"
15,15,40,2142,249,294,543,"21 de agosto de 1994"
15,15,40,2143,566,583,1149,"21 de agosto de 1994"
15,15,40,2144,460,502,962,"21 de agosto de 1994"
15,15,40,2145,327,316,643,"21 de agosto de 1994"
15,15,40,2146,292,337,629,"21 de agosto de 1994"
15,15,40,2147,349,371,720,"21 de agosto de 1994"
15,15,40,2148,311,341,652,"21 de agosto de 1994"
15,15,40,2149,511,564,1075,"21 de agosto de 1994"
15,15,40,2150,565,675,1240,"21 de agosto de 1994"
15,15,40,2151,586,602,1188,"21 de agosto de 1994"
15,15,40,2152,457,494,951,"21 de agosto de 1994"
15,15,40,2153,460,477,937,"21 de agosto de 1994"
15,15,40,2154,387,435,822,"21 de agosto de 1994"
15,15,40,2155,432,489,921,"21 de agosto de 1994"
15,15,40,2156,425,475,900,"21 de agosto de 1994"
15,15,40,2157,421,429,850,"21 de agosto de 1994"
15,15,40,2158,463,473,936,"21 de agosto de 1994"
15,15,40,2159,295,350,645,"21 de agosto de 1994"
15,15,40,2160,184,179,363,"21 de agosto de 1994"
15,15,40,2161,284,333,617,"21 de agosto de 1994"
15,15,40,2162,519,542,1061,"21 de agosto de 1994"
15,15,40,2163,1083,1331,2414,"21 de agosto de 1994"
15,15,51,2378,410,458,868,"21 de agosto de 1994"
15,15,51,2379,417,490,907,"21 de agosto de 1994"
15,15,51,2380,709,800,1509,"21 de agosto de 1994"
15,15,51,2381,632,655,1287,"21 de agosto de 1994"
15,15,51,2382,426,472,898,"21 de agosto de 1994"
15,15,51,2383,493,520,1013,"21 de agosto de 1994"
15,15,51,2384,583,579,1162,"21 de agosto de 1994"
15,15,51,2385,490,458,948,"21 de agosto de 1994"
15,15,69,3927,392,415,807,"21 de agosto de 1994"
15,15,69,3928,157,167,324,"21 de agosto de 1994"
15,15,69,3929,508,608,1116,"21 de agosto de 1994"
15,15,69,3930,645,757,1402,"21 de agosto de 1994"
15,15,69,3931,517,571,1088,"21 de agosto de 1994"
15,15,69,3932,517,619,1136,"21 de agosto de 1994"
15,15,69,3933,550,646,1196,"21 de agosto de 1994"
15,15,69,3934,341,397,738,"21 de agosto de 1994"
15,15,69,3935,323,351,674,"21 de agosto de 1994"
15,15,69,3936,420,472,892,"21 de agosto de 1994"
15,15,69,3937,314,298,612,"21 de agosto de 1994"
15,15,69,3938,359,376,735,"21 de agosto de 1994"
15,15,69,3939,107,111,218,"21 de agosto de 1994"
15,15,84,4326,469,515,984,"21 de agosto de 1994"
15,15,84,4327,508,592,1100,"21 de agosto de 1994"
15,15,84,4328,346,368,714,"21 de agosto de 1994"
15,15,84,4329,180,207,387,"21 de agosto de 1994"
15,15,84,4330,732,135,867,"21 de agosto de 1994"
15,15,90,4466,384,392,776,"21 de agosto de 1994"
15,15,90,4467,357,391,748,"21 de agosto de 1994"
15,15,90,4468,435,458,893,"21 de agosto de 1994"
15,15,90,4469,468,458,926,"21 de agosto de 1994"
15,15,90,4470,367,391,758,"21 de agosto de 1994"
15,15,95,4556,547,551,1098,"21 de agosto de 1994"
15,15,95,4557,342,402,744,"21 de agosto de 1994"
15,15,95,4558,559,569,1128,"21 de agosto de 1994"
15,15,95,4559,678,675,1353,"21 de agosto de 1994"
15,15,95,4560,369,377,746,"21 de agosto de 1994"
15,15,95,4561,397,399,796,"21 de agosto de 1994"
15,15,95,4562,301,278,579,"21 de agosto de 1994"
15,15,95,4563,542,564,1106,"21 de agosto de 1994"
15,15,104,4736,507,518,1025,"21 de agosto de 1994"
15,15,104,4737,723,839,1562,"21 de agosto de 1994"
15,15,104,4738,504,532,1036,"21 de agosto de 1994"
15,15,104,4739,483,541,1024,"21 de agosto de 1994"
15,15,104,4740,424,463,887,"21 de agosto de 1994"
15,15,104,4741,656,705,1361,"21 de agosto de 1994"
15,15,104,4742,458,466,924,"21 de agosto de 1994"
15,15,104,4743,531,614,1145,"21 de agosto de 1994"
15,15,104,4744,524,543,1067,"21 de agosto de 1994"
15,15,104,4745,687,713,1400,"21 de agosto de 1994"
15,15,104,4746,308,321,629,"21 de agosto de 1994"
15,15,104,4747,355,383,738,"21 de agosto de 1994"
15,15,104,4748,328,386,714,"21 de agosto de 1994"
15,15,104,4749,507,543,1050,"21 de agosto de 1994"
15,15,104,4750,710,738,1448,"21 de agosto de 1994"
15,15,104,4751,475,504,979,"21 de agosto de 1994"
15,15,104,4752,395,411,806,"21 de agosto de 1994"
15,15,104,4753,556,583,1139,"21 de agosto de 1994"
15,15,104,4754,347,381,728,"21 de agosto de 1994"
15,15,104,4755,399,433,832,"21 de agosto de 1994"
15,15,104,4756,336,360,696,"21 de agosto de 1994"
15,16,55,2464,580,724,1304,"21 de agosto de 1994"
15,16,55,2465,495,526,1021,"21 de agosto de 1994"
15,16,55,2466,517,622,1139,"21 de agosto de 1994"
15,16,55,2467,363,434,797,"21 de agosto de 1994"
15,16,55,2468,246,271,517,"21 de agosto de 1994"
15,16,55,2469,228,266,494,"21 de agosto de 1994"
15,16,55,2470,482,555,1037,"21 de agosto de 1994"
15,16,55,2471,449,479,928,"21 de agosto de 1994"
15,16,55,2472,392,437,829,"21 de agosto de 1994"
15,16,55,2473,395,444,839,"21 de agosto de 1994"
15,16,55,2474,345,390,735,"21 de agosto de 1994"
15,16,55,2475,469,547,1016,"21 de agosto de 1994"
15,16,55,2476,513,584,1097,"21 de agosto de 1994"
15,16,55,2477,508,549,1057,"21 de agosto de 1994"
15,16,55,2478,549,586,1135,"21 de agosto de 1994"
15,16,55,2479,669,703,1372,"21 de agosto de 1994"
15,16,55,2480,740,831,1571,"21 de agosto de 1994"
15,16,55,2481,617,705,1322,"21 de agosto de 1994"
15,16,55,2482,378,428,806,"21 de agosto de 1994"
15,16,55,2483,292,321,613,"21 de agosto de 1994"
15,16,55,2484,454,566,1020,"21 de agosto de 1994"
15,16,55,2485,444,522,966,"21 de agosto de 1994"
15,16,55,2486,438,509,947,"21 de agosto de 1994"
15,16,55,2487,459,542,1001,"21 de agosto de 1994"
15,16,55,2488,717,818,1535,"21 de agosto de 1994"
15,16,55,2489,822,891,1713,"21 de agosto de 1994"
15,16,55,2490,893,973,1866,"21 de agosto de 1994"
15,16,55,2491,272,359,631,"21 de agosto de 1994"
15,16,55,2492,864,920,1784,"21 de agosto de 1994"
15,16,55,2493,516,539,1055,"21 de agosto de 1994"
15,16,55,2494,346,381,727,"21 de agosto de 1994"
15,16,55,2495,489,534,1023,"21 de agosto de 1994"
15,16,55,2496,441,448,889,"21 de agosto de 1994"
15,16,55,2497,673,767,1440,"21 de agosto de 1994"
15,16,55,2498,678,801,1479,"21 de agosto de 1994"
15,16,55,2499,654,783,1437,"21 de agosto de 1994"
15,16,55,2500,133,168,301,"21 de agosto de 1994"
15,16,55,2501,381,428,809,"21 de agosto de 1994"
15,16,55,2502,544,609,1153,"21 de agosto de 1994"
15,16,55,2503,303,354,657,"21 de agosto de 1994"
15,16,55,2504,343,419,762,"21 de agosto de 1994"
15,16,55,2505,204,223,427,"21 de agosto de 1994"
15,16,55,2506,579,646,1225,"21 de agosto de 1994"
15,16,55,2507,792,902,1694,"21 de agosto de 1994"
15,16,55,2508,654,680,1334,"21 de agosto de 1994"
15,16,55,2509,369,405,774,"21 de agosto de 1994"
15,16,55,2510,339,410,749,"21 de agosto de 1994"
15,16,55,2511,388,512,900,"21 de agosto de 1994"
15,16,55,2512,200,198,398,"21 de agosto de 1994"
15,16,55,2513,321,320,641,"21 de agosto de 1994"
15,16,55,2514,376,430,806,"21 de agosto de 1994"
15,16,55,2515,466,528,994,"21 de agosto de 1994"
15,16,55,2516,380,447,827,"21 de agosto de 1994"
15,16,55,2517,343,435,778,"21 de agosto de 1994"
15,16,55,2518,481,544,1025,"21 de agosto de 1994"
15,16,55,2519,176,191,367,"21 de agosto de 1994"
15,16,55,2520,634,669,1303,"21 de agosto de 1994"
15,16,55,2521,628,661,1289,"21 de agosto de 1994"
15,16,55,2522,200,237,437,"21 de agosto de 1994"
15,16,55,2523,174,212,386,"21 de agosto de 1994"
15,16,55,2524,634,726,1360,"21 de agosto de 1994"
15,16,55,2525,643,710,1353,"21 de agosto de 1994"
15,16,55,2526,272,352,624,"21 de agosto de 1994"
15,16,55,2527,540,686,1226,"21 de agosto de 1994"
15,16,55,2528,508,643,1151,"21 de agosto de 1994"
15,16,55,2529,538,611,1149,"21 de agosto de 1994"
15,16,55,2530,444,501,945,"21 de agosto de 1994"
15,16,55,2531,636,646,1282,"21 de agosto de 1994"
15,16,55,2532,487,546,1033,"21 de agosto de 1994"
15,16,55,2533,618,720,1338,"21 de agosto de 1994"
15,16,55,2534,763,892,1655,"21 de agosto de 1994"
15,16,55,2535,234,252,486,"21 de agosto de 1994"
15,16,55,2536,350,445,795,"21 de agosto de 1994"
15,16,55,2537,399,516,915,"21 de agosto de 1994"
15,16,55,2538,774,849,1623,"21 de agosto de 1994"
15,16,55,2539,815,888,1703,"21 de agosto de 1994"
15,16,55,2540,38,40,78,"21 de agosto de 1994"
15,16,55,2541,640,650,1290,"21 de agosto de 1994"
15,16,55,2542,559,556,1115,"21 de agosto de 1994"
15,16,55,2543,170,182,352,"21 de agosto de 1994"
15,16,55,2544,687,755,1442,"21 de agosto de 1994"
15,16,55,2545,463,465,928,"21 de agosto de 1994"
15,16,55,2546,370,394,764,"21 de agosto de 1994"
15,16,55,2547,676,710,1386,"21 de agosto de 1994"
15,16,55,2548,704,736,1440,"21 de agosto de 1994"
15,16,55,2549,468,515,983,"21 de agosto de 1994"
15,16,107,5174,0,1,1,"21 de agosto de 1994"
15,16,107,5266,597,693,1290,"21 de agosto de 1994"
15,16,107,5267,607,653,1260,"21 de agosto de 1994"
15,16,107,5268,480,545,1025,"21 de agosto de 1994"
15,16,107,5269,862,1000,1862,"21 de agosto de 1994"
15,16,107,5270,515,588,1103,"21 de agosto de 1994"
15,16,107,5271,590,719,1309,"21 de agosto de 1994"
15,16,107,5272,501,583,1084,"21 de agosto de 1994"
15,16,107,5273,221,235,456,"21 de agosto de 1994"
15,16,107,5274,745,808,1553,"21 de agosto de 1994"
15,16,107,5275,455,500,955,"21 de agosto de 1994"
15,16,107,5276,438,536,974,"21 de agosto de 1994"
15,16,107,5277,539,603,1142,"21 de agosto de 1994"
15,16,107,5278,787,881,1668,"21 de agosto de 1994"
15,16,107,5279,342,397,739,"21 de agosto de 1994"
15,16,107,5280,242,279,521,"21 de agosto de 1994"
15,16,107,5281,193,213,406,"21 de agosto de 1994"
15,16,107,5282,258,304,562,"21 de agosto de 1994"
15,16,107,5283,551,572,1123,"21 de agosto de 1994"
15,16,107,5284,401,498,899,"21 de agosto de 1994"
15,16,107,5285,923,1108,2031,"21 de agosto de 1994"
15,16,107,5286,574,618,1192,"21 de agosto de 1994"
15,16,107,5287,730,867,1597,"21 de agosto de 1994"
15,16,107,5288,441,527,968,"21 de agosto de 1994"
15,16,107,5289,416,453,869,"21 de agosto de 1994"
15,16,107,5290,413,467,880,"21 de agosto de 1994"
15,16,107,5291,767,852,1619,"21 de agosto de 1994"
15,16,107,5292,470,629,1099,"21 de agosto de 1994"
15,16,107,5293,561,663,1224,"21 de agosto de 1994"
15,16,107,5294,558,615,1173,"21 de agosto de 1994"
15,16,107,5295,482,525,1007,"21 de agosto de 1994"
15,16,107,5296,521,575,1096,"21 de agosto de 1994"
15,16,107,5297,442,491,933,"21 de agosto de 1994"
15,16,107,5298,723,814,1537,"21 de agosto de 1994"
15,16,107,5299,267,294,561,"21 de agosto de 1994"
15,16,107,5300,392,437,829,"21 de agosto de 1994"
15,16,107,5301,335,392,727,"21 de agosto de 1994"
15,16,107,5302,532,637,1169,"21 de agosto de 1994"
15,16,107,5303,814,893,1707,"21 de agosto de 1994"
15,16,107,5304,664,734,1398,"21 de agosto de 1994"
15,16,107,5305,616,681,1297,"21 de agosto de 1994"
15,16,107,5306,678,814,1492,"21 de agosto de 1994"
15,16,107,5307,483,601,1084,"21 de agosto de 1994"
15,16,107,5308,470,661,1131,"21 de agosto de 1994"
15,16,107,5309,789,899,1688,"21 de agosto de 1994"
15,16,107,5310,622,718,1340,"21 de agosto de 1994"
15,16,107,5311,643,726,1369,"21 de agosto de 1994"
15,16,107,5312,444,544,988,"21 de agosto de 1994"
15,16,107,5313,556,719,1275,"21 de agosto de 1994"
15,16,107,5314,654,859,1513,"21 de agosto de 1994"
15,16,107,5315,275,397,672,"21 de agosto de 1994"
15,16,107,5316,549,675,1224,"21 de agosto de 1994"
15,16,107,5317,571,648,1219,"21 de agosto de 1994"
15,16,107,5318,535,628,1163,"21 de agosto de 1994"
15,16,107,5319,583,670,1253,"21 de agosto de 1994"
15,16,107,5320,626,751,1377,"21 de agosto de 1994"
15,16,107,5321,576,672,1248,"21 de agosto de 1994"
15,16,107,5322,522,617,1139,"21 de agosto de 1994"
15,16,107,5323,874,896,1770,"21 de agosto de 1994"
15,16,107,5324,582,684,1266,"21 de agosto de 1994"
15,16,107,5325,438,460,898,"21 de agosto de 1994"
15,16,107,5326,522,559,1081,"21 de agosto de 1994"
15,16,107,5327,426,491,917,"21 de agosto de 1994"
15,16,107,5328,313,385,698,"21 de agosto de 1994"
15,16,107,5329,515,652,1167,"21 de agosto de 1994"
15,16,107,5330,843,922,1765,"21 de agosto de 1994"
15,16,107,5331,464,513,977,"21 de agosto de 1994"
15,16,107,5332,420,444,864,"21 de agosto de 1994"
15,16,107,5333,478,536,1014,"21 de agosto de 1994"
15,16,107,5334,439,462,901,"21 de agosto de 1994"
15,16,107,5335,650,760,1410,"21 de agosto de 1994"
15,16,107,5336,687,819,1506,"21 de agosto de 1994"
15,16,107,5337,513,599,1112,"21 de agosto de 1994"
15,16,107,5338,387,470,857,"21 de agosto de 1994"
15,16,107,5339,654,808,1462,"21 de agosto de 1994"
15,16,107,5340,252,319,571,"21 de agosto de 1994"
15,16,107,5341,533,685,1218,"21 de agosto de 1994"
15,16,107,5342,598,718,1316,"21 de agosto de 1994"
15,16,107,5343,479,573,1052,"21 de agosto de 1994"
15,16,107,5344,423,501,924,"21 de agosto de 1994"
15,16,107,5345,380,440,820,"21 de agosto de 1994"
15,16,107,5346,320,385,705,"21 de agosto de 1994"
15,16,107,5347,677,715,1392,"21 de agosto de 1994"
15,16,107,5348,739,839,1578,"21 de agosto de 1994"
15,16,107,5349,704,832,1536,"21 de agosto de 1994"
15,16,107,5350,802,916,1718,"21 de agosto de 1994"
15,16,107,5351,795,911,1706,"21 de agosto de 1994"
15,16,107,5352,191,247,438,"21 de agosto de 1994"
15,16,107,5353,243,312,555,"21 de agosto de 1994"
15,16,107,5354,623,805,1428,"21 de agosto de 1994"
15,16,107,5355,725,800,1525,"21 de agosto de 1994"
15,16,107,5356,609,628,1237,"21 de agosto de 1994"
15,16,107,5357,216,215,431,"21 de agosto de 1994"
15,16,107,5358,329,385,714,"21 de agosto de 1994"
15,16,107,5359,454,506,960,"21 de agosto de 1994"
15,16,107,5360,367,406,773,"21 de agosto de 1994"
15,16,107,5361,325,354,679,"21 de agosto de 1994"
15,16,107,5362,475,477,952,"21 de agosto de 1994"
15,16,107,5363,365,434,799,"21 de agosto de 1994"
15,16,107,5364,556,606,1162,"21 de agosto de 1994"
15,16,107,5365,251,258,509,"21 de agosto de 1994"
15,16,107,5366,542,598,1140,"21 de agosto de 1994"
15,16,107,5367,393,446,839,"21 de agosto de 1994"
15,16,107,5368,492,504,996,"21 de agosto de 1994"
15,16,107,5369,366,389,755,"21 de agosto de 1994"
15,16,107,5370,389,399,788,"21 de agosto de 1994"
15,16,107,5371,177,205,382,"21 de agosto de 1994"
15,16,107,5372,537,568,1105,"21 de agosto de 1994"
15,16,107,5373,401,430,831,"21 de agosto de 1994"
15,16,107,5374,385,435,820,"21 de agosto de 1994"
15,16,107,5375,586,663,1249,"21 de agosto de 1994"
15,16,107,5376,586,650,1236,"21 de agosto de 1994"
15,16,107,5377,306,331,637,"21 de agosto de 1994"
15,16,107,5378,625,653,1278,"21 de agosto de 1994"
15,16,107,5379,504,534,1038,"21 de agosto de 1994"
15,16,107,5380,450,446,896,"21 de agosto de 1994"
15,16,107,5381,673,745,1418,"21 de agosto de 1994"
15,16,107,5382,471,525,996,"21 de agosto de 1994"
15,16,107,5383,452,530,982,"21 de agosto de 1994"
15,16,107,5384,552,569,1121,"21 de agosto de 1994"
15,16,107,5385,270,311,581,"21 de agosto de 1994"
15,16,107,5386,444,470,914,"21 de agosto de 1994"
15,16,107,5387,334,359,693,"21 de agosto de 1994"
15,16,107,5388,489,533,1022,"21 de agosto de 1994"
15,16,107,5389,745,827,1572,"21 de agosto de 1994"
15,16,107,5390,626,687,1313,"21 de agosto de 1994"
15,16,107,5391,402,433,835,"21 de agosto de 1994"
15,16,107,5392,348,358,706,"21 de agosto de 1994"
15,16,107,5393,329,348,677,"21 de agosto de 1994"
15,16,107,5394,509,539,1048,"21 de agosto de 1994"
15,16,107,5395,238,294,532,"21 de agosto de 1994"
15,16,107,5396,354,356,710,"21 de agosto de 1994"
15,16,107,5397,609,676,1285,"21 de agosto de 1994"
15,16,107,5398,647,673,1320,"21 de agosto de 1994"
15,16,107,5399,786,866,1652,"21 de agosto de 1994"
15,16,107,5400,604,625,1229,"21 de agosto de 1994"
15,16,107,5401,731,747,1478,"21 de agosto de 1994"
15,16,107,5402,499,530,1029,"21 de agosto de 1994"
15,16,107,5403,454,480,934,"21 de agosto de 1994"
15,16,107,5404,501,600,1101,"21 de agosto de 1994"
15,16,107,5405,564,621,1185,"21 de agosto de 1994"
15,16,107,5406,523,551,1074,"21 de agosto de 1994"
15,16,107,5407,499,550,1049,"21 de agosto de 1994"
15,16,107,5408,432,479,911,"21 de agosto de 1994"
15,16,107,5409,311,322,633,"21 de agosto de 1994"
15,16,107,5410,391,418,809,"21 de agosto de 1994"
15,16,107,5411,591,625,1216,"21 de agosto de 1994"
15,16,107,5412,560,578,1138,"21 de agosto de 1994"
15,16,107,5413,358,372,730,"21 de agosto de 1994"
15,16,107,5414,827,866,1693,"21 de agosto de 1994"
15,16,107,5415,674,761,1435,"21 de agosto de 1994"
15,16,107,5416,522,576,1098,"21 de agosto de 1994"
15,16,107,5417,456,516,972,"21 de agosto de 1994"
15,16,107,5418,423,463,886,"21 de agosto de 1994"
15,16,107,5419,418,442,860,"21 de agosto de 1994"
15,16,107,5420,357,380,737,"21 de agosto de 1994"
15,16,107,5421,459,487,946,"21 de agosto de 1994"
15,16,107,5422,704,698,1402,"21 de agosto de 1994"
15,16,107,5423,432,435,867,"21 de agosto de 1994"
15,16,107,5424,406,418,824,"21 de agosto de 1994"
15,16,107,5425,700,732,1432,"21 de agosto de 1994"
15,16,107,5426,134,141,275,"21 de agosto de 1994"
15,16,107,5427,40,49,89,"21 de agosto de 1994"
15,16,107,5428,507,516,1023,"21 de agosto de 1994"
15,16,107,5429,371,398,769,"21 de agosto de 1994"
15,16,107,5430,513,572,1085,"21 de agosto de 1994"
15,16,107,5431,417,421,838,"21 de agosto de 1994"
15,16,107,5432,389,413,802,"21 de agosto de 1994"
15,16,107,5433,729,720,1449,"21 de agosto de 1994"
15,16,107,5434,616,648,1264,"21 de agosto de 1994"
15,16,107,5435,585,627,1212,"21 de agosto de 1994"
15,16,107,5436,536,575,1111,"21 de agosto de 1994"
15,16,107,5437,709,712,1421,"21 de agosto de 1994"
15,16,107,5438,654,659,1313,"21 de agosto de 1994"
15,16,107,5439,273,280,553,"21 de agosto de 1994"
15,16,107,5440,632,737,1369,"21 de agosto de 1994"
15,16,107,5441,346,352,698,"21 de agosto de 1994"
15,16,107,5442,357,403,760,"21 de agosto de 1994"
15,17,39,2068,661,682,1343,"21 de agosto de 1994"
15,17,39,2069,603,612,1215,"21 de agosto de 1994"
15,17,39,2070,376,380,756,"21 de agosto de 1994"
15,17,39,2071,91,84,175,"21 de agosto de 1994"
15,17,39,2072,35,34,69,"21 de agosto de 1994"
15,17,43,2188,427,475,902,"21 de agosto de 1994"
15,17,43,2189,381,478,859,"21 de agosto de 1994"
15,17,43,2190,610,635,1245,"21 de agosto de 1994"
15,17,43,2191,518,625,1143,"21 de agosto de 1994"
15,17,43,2192,89,90,179,"21 de agosto de 1994"
15,17,43,2193,110,96,206,"21 de agosto de 1994"
15,17,43,2194,506,484,990,"21 de agosto de 1994"
15,17,43,2195,656,724,1380,"21 de agosto de 1994"
15,17,43,2196,1031,1101,2132,"21 de agosto de 1994"
15,17,43,2197,339,384,723,"21 de agosto de 1994"
15,17,43,2198,479,538,1017,"21 de agosto de 1994"
15,17,43,2199,602,626,1228,"21 de agosto de 1994"
15,17,43,2200,575,636,1211,"21 de agosto de 1994"
15,17,43,2201,449,442,891,"21 de agosto de 1994"
15,17,43,2202,197,206,403,"21 de agosto de 1994"
15,17,43,2203,526,542,1068,"21 de agosto de 1994"
15,17,43,2204,376,367,743,"21 de agosto de 1994"
15,17,43,2205,347,382,729,"21 de agosto de 1994"
15,17,43,2206,437,540,977,"21 de agosto de 1994"
15,17,43,2207,524,687,1211,"21 de agosto de 1994"
15,17,43,2208,512,609,1121,"21 de agosto de 1994"
15,17,43,2209,668,809,1477,"21 de agosto de 1994"
15,17,43,2210,583,742,1325,"21 de agosto de 1994"
15,17,43,2211,618,708,1326,"21 de agosto de 1994"
15,17,43,2212,430,482,912,"21 de agosto de 1994"
15,17,43,2213,442,519,961,"21 de agosto de 1994"
15,17,43,2214,536,601,1137,"21 de agosto de 1994"
15,17,43,2215,841,984,1825,"21 de agosto de 1994"
15,17,43,2216,299,302,601,"21 de agosto de 1994"
15,17,43,2217,343,370,713,"21 de agosto de 1994"
15,17,43,2218,718,893,1611,"21 de agosto de 1994"
15,17,43,2219,453,481,934,"21 de agosto de 1994"
15,17,43,2220,358,462,820,"21 de agosto de 1994"
15,17,43,2221,636,761,1397,"21 de agosto de 1994"
15,17,43,2222,179,193,372,"21 de agosto de 1994"
15,17,43,2223,295,288,583,"21 de agosto de 1994"
15,17,43,2224,360,434,794,"21 de agosto de 1994"
15,17,43,2225,162,198,360,"21 de agosto de 1994"
15,17,43,2226,163,146,309,"21 de agosto de 1994"
15,17,43,2227,652,671,1323,"21 de agosto de 1994"
15,17,43,2228,544,514,1058,"21 de agosto de 1994"
15,17,43,2229,730,734,1464,"21 de agosto de 1994"
15,17,43,2230,393,427,820,"21 de agosto de 1994"
15,17,43,2231,87,75,162,"21 de agosto de 1994"
15,17,43,2232,665,704,1369,"21 de agosto de 1994"
15,17,43,2233,545,583,1128,"21 de agosto de 1994"
15,17,43,2234,547,601,1148,"21 de agosto de 1994"
15,17,43,2235,98,108,206,"21 de agosto de 1994"
15,17,47,2304,315,311,626,"21 de agosto de 1994"
15,17,47,2305,116,91,207,"21 de agosto de 1994"
15,17,47,2306,296,253,549,"21 de agosto de 1994"
15,17,47,2307,201,192,393,"21 de agosto de 1994"
15,17,47,2308,642,680,1322,"21 de agosto de 1994"
15,17,47,2309,159,141,300,"21 de agosto de 1994"
15,17,47,2310,480,507,987,"21 de agosto de 1994"
15,17,47,2311,381,348,729,"21 de agosto de 1994"
15,17,47,2312,214,202,416,"21 de agosto de 1994"
15,17,47,2313,323,330,653,"21 de agosto de 1994"
15,17,48,2314,568,636,1204,"21 de agosto de 1994"
15,17,48,2315,301,326,627,"21 de agosto de 1994"
15,17,48,2316,405,425,830,"21 de agosto de 1994"
15,17,48,2317,198,234,432,"21 de agosto de 1994"
15,17,48,2318,641,679,1320,"21 de agosto de 1994"
15,17,48,2319,700,878,1578,"21 de agosto de 1994"
15,17,48,2320,276,285,561,"21 de agosto de 1994"
15,17,48,2321,387,403,790,"21 de agosto de 1994"
15,17,48,2322,397,390,787,"21 de agosto de 1994"
15,17,48,2323,407,391,798,"21 de agosto de 1994"
15,17,48,2324,191,175,366,"21 de agosto de 1994"
15,17,48,2325,398,469,867,"21 de agosto de 1994"
15,17,48,2326,262,296,558,"21 de agosto de 1994"
15,17,48,2327,367,394,761,"21 de agosto de 1994"
15,17,48,2328,519,664,1183,"21 de agosto de 1994"
15,17,48,2329,645,663,1308,"21 de agosto de 1994"
15,17,48,2330,514,569,1083,"21 de agosto de 1994"
15,17,48,2331,384,427,811,"21 de agosto de 1994"
15,17,48,2332,591,550,1141,"21 de agosto de 1994"
15,17,48,2333,418,463,881,"21 de agosto de 1994"
15,17,48,2334,404,411,815,"21 de agosto de 1994"
15,17,48,2335,154,138,292,"21 de agosto de 1994"
15,17,48,2336,275,278,553,"21 de agosto de 1994"
15,17,48,2337,562,512,1074,"21 de agosto de 1994"
15,17,48,2338,448,446,894,"21 de agosto de 1994"
15,17,48,2339,383,382,765,"21 de agosto de 1994"
15,17,48,2340,218,228,446,"21 de agosto de 1994"
15,17,48,2341,369,365,734,"21 de agosto de 1994"
15,17,48,2342,91,92,183,"21 de agosto de 1994"
15,17,48,2343,296,339,635,"21 de agosto de 1994"
15,17,61,3723,429,460,889,"21 de agosto de 1994"
15,17,61,3724,407,443,850,"21 de agosto de 1994"
15,17,61,3725,493,582,1075,"21 de agosto de 1994"
15,17,61,3726,924,987,1911,"21 de agosto de 1994"
15,17,61,3727,751,858,1609,"21 de agosto de 1994"
15,17,61,3728,626,700,1326,"21 de agosto de 1994"
15,17,61,3729,181,185,366,"21 de agosto de 1994"
15,17,61,3730,721,772,1493,"21 de agosto de 1994"
15,17,61,3731,890,945,1835,"21 de agosto de 1994"
15,17,61,3732,400,448,848,"21 de agosto de 1994"
15,17,61,3733,487,498,985,"21 de agosto de 1994"
15,17,61,3734,795,868,1663,"21 de agosto de 1994"
15,17,61,3735,549,587,1136,"21 de agosto de 1994"
15,17,61,3736,554,578,1132,"21 de agosto de 1994"
15,17,61,3737,386,447,833,"21 de agosto de 1994"
15,17,61,3738,718,806,1524,"21 de agosto de 1994"
15,17,61,3739,767,851,1618,"21 de agosto de 1994"
15,17,61,3740,686,711,1397,"21 de agosto de 1994"
15,17,61,3741,271,277,548,"21 de agosto de 1994"
15,17,61,3742,440,517,957,"21 de agosto de 1994"
15,17,61,3743,508,583,1091,"21 de agosto de 1994"
15,17,61,3744,765,817,1582,"21 de agosto de 1994"
15,17,61,3745,769,841,1610,"21 de agosto de 1994"
15,17,61,3746,501,563,1064,"21 de agosto de 1994"
15,17,61,3747,466,533,999,"21 de agosto de 1994"
15,17,61,3748,812,914,1726,"21 de agosto de 1994"
15,17,61,3749,636,662,1298,"21 de agosto de 1994"
15,17,61,3750,647,679,1326,"21 de agosto de 1994"
15,17,61,3751,637,618,1255,"21 de agosto de 1994"
15,17,61,3752,587,652,1239,"21 de agosto de 1994"
15,17,61,3753,714,787,1501,"21 de agosto de 1994"
15,17,61,3754,619,692,1311,"21 de agosto de 1994"
15,17,61,3755,557,577,1134,"21 de agosto de 1994"
15,17,61,3756,581,615,1196,"21 de agosto de 1994"
15,17,61,3757,653,756,1409,"21 de agosto de 1994"
15,17,61,3758,653,713,1366,"21 de agosto de 1994"
15,17,61,3759,687,730,1417,"21 de agosto de 1994"
15,17,61,3760,758,807,1565,"21 de agosto de 1994"
15,17,61,3761,376,389,765,"21 de agosto de 1994"
15,17,61,3762,443,497,940,"21 de agosto de 1994"
15,17,61,3763,475,447,922,"21 de agosto de 1994"
15,17,61,3764,642,714,1356,"21 de agosto de 1994"
15,17,61,3765,409,479,888,"21 de agosto de 1994"
15,17,61,3766,471,498,969,"21 de agosto de 1994"
15,17,61,3767,508,531,1039,"21 de agosto de 1994"
15,17,61,3768,485,529,1014,"21 de agosto de 1994"
15,17,61,3769,425,485,910,"21 de agosto de 1994"
15,17,61,3770,736,833,1569,"21 de agosto de 1994"
15,17,61,3771,542,541,1083,"21 de agosto de 1994"
15,17,61,3772,543,566,1109,"21 de agosto de 1994"
15,17,61,3773,476,523,999,"21 de agosto de 1994"
15,17,61,3774,795,802,1597,"21 de agosto de 1994"
15,17,61,3775,671,726,1397,"21 de agosto de 1994"
15,17,61,3776,1036,1102,2138,"21 de agosto de 1994"
15,17,61,3777,445,469,914,"21 de agosto de 1994"
15,17,61,3778,431,450,881,"21 de agosto de 1994"
15,17,61,3779,495,553,1048,"21 de agosto de 1994"
15,17,61,3780,470,505,975,"21 de agosto de 1994"
15,17,61,3781,603,648,1251,"21 de agosto de 1994"
15,17,61,3782,534,618,1152,"21 de agosto de 1994"
15,17,61,3783,552,552,1104,"21 de agosto de 1994"
15,17,61,3784,508,612,1120,"21 de agosto de 1994"
15,17,61,3785,719,772,1491,"21 de agosto de 1994"
15,17,61,3786,483,554,1037,"21 de agosto de 1994"
15,17,61,3787,713,783,1496,"21 de agosto de 1994"
15,17,61,3788,759,899,1658,"21 de agosto de 1994"
15,17,61,3789,388,422,810,"21 de agosto de 1994"
15,17,61,3790,715,787,1502,"21 de agosto de 1994"
15,17,61,3791,923,980,1903,"21 de agosto de 1994"
15,17,61,3792,892,991,1883,"21 de agosto de 1994"
15,17,61,3793,631,665,1296,"21 de agosto de 1994"
15,17,61,3794,737,750,1487,"21 de agosto de 1994"
15,17,61,3795,371,416,787,"21 de agosto de 1994"
15,17,61,3796,148,131,279,"21 de agosto de 1994"
15,17,61,3797,279,287,566,"21 de agosto de 1994"
15,17,61,3798,470,464,934,"21 de agosto de 1994"
15,17,61,3799,470,502,972,"21 de agosto de 1994"
15,17,61,3800,459,430,889,"21 de agosto de 1994"
15,17,61,3801,671,741,1412,"21 de agosto de 1994"
15,17,61,3802,366,377,743,"21 de agosto de 1994"
15,17,61,3803,305,335,640,"21 de agosto de 1994"
15,17,61,3804,707,700,1407,"21 de agosto de 1994"
15,17,61,3805,212,223,435,"21 de agosto de 1994"
15,17,61,3806,332,359,691,"21 de agosto de 1994"
15,17,61,3807,566,622,1188,"21 de agosto de 1994"
15,17,61,3808,688,784,1472,"21 de agosto de 1994"
15,17,61,3809,517,516,1033,"21 de agosto de 1994"
15,17,61,3810,348,369,717,"21 de agosto de 1994"
15,17,61,3811,350,337,687,"21 de agosto de 1994"
15,17,61,3812,152,152,304,"21 de agosto de 1994"
15,17,61,3813,374,404,778,"21 de agosto de 1994"
15,17,61,3814,349,413,762,"21 de agosto de 1994"
15,17,61,3815,390,406,796,"21 de agosto de 1994"
15,17,61,3816,289,327,616,"21 de agosto de 1994"
15,17,61,3817,370,382,752,"21 de agosto de 1994"
15,17,61,3818,353,339,692,"21 de agosto de 1994"
15,17,61,3819,403,430,833,"21 de agosto de 1994"
15,17,61,3820,330,366,696,"21 de agosto de 1994"
15,17,61,3821,747,849,1596,"21 de agosto de 1994"
15,17,61,3822,359,407,766,"21 de agosto de 1994"
15,17,68,3903,716,780,1496,"21 de agosto de 1994"
15,17,68,3904,762,820,1582,"21 de agosto de 1994"
15,17,68,3905,828,866,1694,"21 de agosto de 1994"
15,17,68,3906,488,517,1005,"21 de agosto de 1994"
15,17,68,3907,466,506,972,"21 de agosto de 1994"
15,17,68,3908,366,368,734,"21 de agosto de 1994"
15,17,68,3909,642,648,1290,"21 de agosto de 1994"
15,17,68,3910,626,550,1176,"21 de agosto de 1994"
15,17,68,3911,234,242,476,"21 de agosto de 1994"
15,17,68,3912,733,808,1541,"21 de agosto de 1994"
15,17,68,3913,503,531,1034,"21 de agosto de 1994"
15,17,68,3914,310,292,602,"21 de agosto de 1994"
15,17,68,3915,431,453,884,"21 de agosto de 1994"
15,17,68,3916,202,195,397,"21 de agosto de 1994"
15,17,68,3917,279,297,576,"21 de agosto de 1994"
15,17,68,3918,421,421,842,"21 de agosto de 1994"
15,17,68,3919,618,668,1286,"21 de agosto de 1994"
15,17,68,3920,176,174,350,"21 de agosto de 1994"
15,17,68,3921,566,562,1128,"21 de agosto de 1994"
15,17,68,3922,225,239,464,"21 de agosto de 1994"
15,17,68,3923,182,184,366,"21 de agosto de 1994"
15,17,68,3924,478,503,981,"21 de agosto de 1994"
15,17,68,3925,267,282,549,"21 de agosto de 1994"
15,17,68,3926,262,264,526,"21 de agosto de 1994"
15,17,88,4403,606,691,1297,"21 de agosto de 1994"
15,17,88,4404,198,190,388,"21 de agosto de 1994"
15,17,88,4405,399,394,793,"21 de agosto de 1994"
15,17,88,4406,675,642,1317,"21 de agosto de 1994"
15,17,88,4407,285,288,573,"21 de agosto de 1994"
15,17,88,4408,737,790,1527,"21 de agosto de 1994"
15,17,88,4409,367,371,738,"21 de agosto de 1994"
15,17,88,4410,254,185,439,"21 de agosto de 1994"
15,17,88,4411,312,343,655,"21 de agosto de 1994"
15,17,88,4412,299,304,603,"21 de agosto de 1994"
15,17,88,4413,490,587,1077,"21 de agosto de 1994"
15,17,88,4414,360,397,757,"21 de agosto de 1994"
15,17,88,4415,547,583,1130,"21 de agosto de 1994"
15,17,88,4416,567,668,1235,"21 de agosto de 1994"
15,17,88,4417,561,598,1159,"21 de agosto de 1994"
15,17,88,4418,506,618,1124,"21 de agosto de 1994"
15,17,88,4419,800,881,1681,"21 de agosto de 1994"
15,17,88,4420,365,375,740,"21 de agosto de 1994"
15,17,88,4421,505,480,985,"21 de agosto de 1994"
15,17,88,4422,584,640,1224,"21 de agosto de 1994"
15,17,88,4423,879,909,1788,"21 de agosto de 1994"
15,17,88,4424,519,521,1040,"21 de agosto de 1994"
15,17,88,4425,309,320,629,"21 de agosto de 1994"
15,17,88,4426,510,552,1062,"21 de agosto de 1994"
15,17,88,4427,274,281,555,"21 de agosto de 1994"
15,17,88,4428,291,269,560,"21 de agosto de 1994"
15,17,113,5704,552,597,1149,"21 de agosto de 1994"
15,17,113,5705,545,578,1123,"21 de agosto de 1994"
15,17,113,5706,512,535,1047,"21 de agosto de 1994"
15,17,113,5707,726,643,1369,"21 de agosto de 1994"
15,17,113,5708,267,241,508,"21 de agosto de 1994"
15,17,113,5709,175,162,337,"21 de agosto de 1994"
15,17,113,5710,318,272,590,"21 de agosto de 1994"
15,17,113,5711,169,155,324,"21 de agosto de 1994"
15,17,113,5712,415,330,745,"21 de agosto de 1994"
15,17,113,5713,506,443,949,"21 de agosto de 1994"
15,17,113,5714,316,283,599,"21 de agosto de 1994"
15,17,113,5715,103,97,200,"21 de agosto de 1994"
15,17,113,5716,492,465,957,"21 de agosto de 1994"
15,17,113,5717,321,251,572,"21 de agosto de 1994"
15,17,113,5718,422,421,843,"21 de agosto de 1994"
15,17,113,5719,429,357,786,"21 de agosto de 1994"
15,17,113,5720,456,393,849,"21 de agosto de 1994"
15,17,113,5721,591,583,1174,"21 de agosto de 1994"
15,17,113,5722,124,94,218,"21 de agosto de 1994"
15,17,116,5791,502,491,993,"21 de agosto de 1994"
15,17,116,5792,627,651,1278,"21 de agosto de 1994"
15,17,116,5793,749,765,1514,"21 de agosto de 1994"
15,17,116,5794,589,656,1245,"21 de agosto de 1994"
15,17,116,5795,458,526,984,"21 de agosto de 1994"
15,17,116,5796,662,736,1398,"21 de agosto de 1994"
15,17,116,5797,657,694,1351,"21 de agosto de 1994"
15,17,116,5798,443,397,840,"21 de agosto de 1994"
15,17,116,5799,696,640,1336,"21 de agosto de 1994"
15,17,116,5800,508,481,989,"21 de agosto de 1994"
15,17,116,5801,408,418,826,"21 de agosto de 1994"
15,17,116,5802,831,861,1692,"21 de agosto de 1994"
15,17,116,5803,766,792,1558,"21 de agosto de 1994"
15,17,116,5804,587,541,1128,"21 de agosto de 1994"
15,18,58,2723,411,502,913,"21 de agosto de 1994"
15,18,58,2724,444,551,995,"21 de agosto de 1994"
15,18,58,2725,324,387,711,"21 de agosto de 1994"
15,18,58,2726,230,276,506,"21 de agosto de 1994"
15,18,58,2727,302,361,663,"21 de agosto de 1994"
15,18,58,2728,353,394,747,"21 de agosto de 1994"
15,18,58,2729,427,502,929,"21 de agosto de 1994"
15,18,58,2730,494,620,1114,"21 de agosto de 1994"
15,18,58,2731,376,486,862,"21 de agosto de 1994"
15,18,58,2732,360,472,832,"21 de agosto de 1994"
15,18,58,2733,348,434,782,"21 de agosto de 1994"
15,18,58,2734,590,756,1346,"21 de agosto de 1994"
15,18,58,2735,354,430,784,"21 de agosto de 1994"
15,18,58,2736,573,742,1315,"21 de agosto de 1994"
15,18,58,2737,753,978,1731,"21 de agosto de 1994"
15,18,58,2738,495,589,1084,"21 de agosto de 1994"
15,18,58,2739,533,586,1119,"21 de agosto de 1994"
15,18,58,2740,528,662,1190,"21 de agosto de 1994"
15,18,58,2741,607,726,1333,"21 de agosto de 1994"
15,18,58,2742,718,882,1600,"21 de agosto de 1994"
15,18,58,2743,435,545,980,"21 de agosto de 1994"
15,18,58,2744,477,614,1091,"21 de agosto de 1994"
15,18,58,2745,314,407,721,"21 de agosto de 1994"
15,18,58,2746,382,489,871,"21 de agosto de 1994"
15,18,58,2747,433,498,931,"21 de agosto de 1994"
15,18,58,2748,271,336,607,"21 de agosto de 1994"
15,18,58,2749,437,504,941,"21 de agosto de 1994"
15,18,58,2750,106,132,238,"21 de agosto de 1994"
15,18,58,2751,330,351,681,"21 de agosto de 1994"
15,18,58,2752,172,175,347,"21 de agosto de 1994"
15,18,58,2753,538,631,1169,"21 de agosto de 1994"
15,18,58,2754,334,399,733,"21 de agosto de 1994"
15,18,58,2755,395,479,874,"21 de agosto de 1994"
15,18,58,2756,385,447,832,"21 de agosto de 1994"
15,18,58,2757,279,334,613,"21 de agosto de 1994"
15,18,58,2758,565,688,1253,"21 de agosto de 1994"
15,18,58,2759,567,721,1288,"21 de agosto de 1994"
15,18,58,2760,624,729,1353,"21 de agosto de 1994"
15,18,58,2761,930,1014,1944,"21 de agosto de 1994"
15,18,58,2762,632,729,1361,"21 de agosto de 1994"
15,18,58,2763,570,623,1193,"21 de agosto de 1994"
15,18,58,2764,497,567,1064,"21 de agosto de 1994"
15,18,58,2765,423,449,872,"21 de agosto de 1994"
15,18,58,2766,368,408,776,"21 de agosto de 1994"
15,18,58,2767,385,429,814,"21 de agosto de 1994"
15,18,58,2768,681,783,1464,"21 de agosto de 1994"
15,18,58,2769,693,845,1538,"21 de agosto de 1994"
15,18,58,2770,620,620,1240,"21 de agosto de 1994"
15,18,58,2771,376,416,792,"21 de agosto de 1994"
15,18,58,2772,523,536,1059,"21 de agosto de 1994"
15,18,58,2773,780,781,1561,"21 de agosto de 1994"
15,18,58,2774,509,593,1102,"21 de agosto de 1994"
15,18,58,2775,561,666,1227,"21 de agosto de 1994"
15,18,58,2776,504,601,1105,"21 de agosto de 1994"
15,18,58,2777,494,558,1052,"21 de agosto de 1994"
15,18,58,2778,544,617,1161,"21 de agosto de 1994"
15,18,58,2779,338,371,709,"21 de agosto de 1994"
15,18,58,2780,481,537,1018,"21 de agosto de 1994"
15,18,58,2781,455,506,961,"21 de agosto de 1994"
15,18,58,2782,625,783,1408,"21 de agosto de 1994"
15,18,58,2783,541,726,1267,"21 de agosto de 1994"
15,18,58,2784,414,521,935,"21 de agosto de 1994"
15,18,58,2785,451,560,1011,"21 de agosto de 1994"
15,18,58,2786,373,463,836,"21 de agosto de 1994"
15,18,58,2787,344,397,741,"21 de agosto de 1994"
15,18,58,2788,410,520,930,"21 de agosto de 1994"
15,18,58,2789,300,311,611,"21 de agosto de 1994"
15,18,58,2790,463,602,1065,"21 de agosto de 1994"
15,18,58,2791,269,372,641,"21 de agosto de 1994"
15,18,58,2792,362,457,819,"21 de agosto de 1994"
15,18,58,2793,631,743,1374,"21 de agosto de 1994"
15,18,58,2794,131,158,289,"21 de agosto de 1994"
15,18,58,2795,409,449,858,"21 de agosto de 1994"
15,18,58,2796,582,692,1274,"21 de agosto de 1994"
15,18,58,2797,545,696,1241,"21 de agosto de 1994"
15,18,58,2798,259,326,585,"21 de agosto de 1994"
15,18,58,2799,352,455,807,"21 de agosto de 1994"
15,18,58,2800,267,322,589,"21 de agosto de 1994"
15,18,58,2801,479,562,1041,"21 de agosto de 1994"
15,18,58,2802,455,461,916,"21 de agosto de 1994"
15,18,58,2803,525,595,1120,"21 de agosto de 1994"
15,18,58,2804,492,539,1031,"21 de agosto de 1994"
15,18,58,2805,946,1114,2060,"21 de agosto de 1994"
15,18,58,2806,374,433,807,"21 de agosto de 1994"
15,18,58,2807,488,585,1073,"21 de agosto de 1994"
15,18,58,2808,458,568,1026,"21 de agosto de 1994"
15,18,58,2809,580,677,1257,"21 de agosto de 1994"
15,18,58,2810,619,784,1403,"21 de agosto de 1994"
15,18,58,2811,697,800,1497,"21 de agosto de 1994"
15,18,58,2812,361,479,840,"21 de agosto de 1994"
15,18,58,2813,550,650,1200,"21 de agosto de 1994"
15,18,58,2814,556,758,1314,"21 de agosto de 1994"
15,18,58,2815,656,819,1475,"21 de agosto de 1994"
15,18,58,2816,641,793,1434,"21 de agosto de 1994"
15,18,58,2817,506,639,1145,"21 de agosto de 1994"
15,18,58,2818,254,317,571,"21 de agosto de 1994"
15,18,58,2819,417,504,921,"21 de agosto de 1994"
15,18,58,2820,551,593,1144,"21 de agosto de 1994"
15,18,58,2821,433,453,886,"21 de agosto de 1994"
15,18,58,2822,378,400,778,"21 de agosto de 1994"
15,18,58,2823,463,509,972,"21 de agosto de 1994"
15,18,58,2824,410,464,874,"21 de agosto de 1994"
15,18,58,2825,447,542,989,"21 de agosto de 1994"
15,18,58,2826,567,718,1285,"21 de agosto de 1994"
15,18,58,2827,548,708,1256,"21 de agosto de 1994"
15,18,58,2828,361,457,818,"21 de agosto de 1994"
15,18,58,2829,349,464,813,"21 de agosto de 1994"
15,18,58,2830,548,631,1179,"21 de agosto de 1994"
15,18,58,2831,708,860,1568,"21 de agosto de 1994"
15,18,58,2832,109,174,283,"21 de agosto de 1994"
15,18,58,2833,86,96,182,"21 de agosto de 1994"
15,18,58,2834,566,615,1181,"21 de agosto de 1994"
15,18,58,2835,506,593,1099,"21 de agosto de 1994"
15,18,58,2836,215,271,486,"21 de agosto de 1994"
15,18,58,2837,804,876,1680,"21 de agosto de 1994"
15,18,58,2838,470,569,1039,"21 de agosto de 1994"
15,18,58,2839,667,694,1361,"21 de agosto de 1994"
15,18,58,2840,494,585,1079,"21 de agosto de 1994"
15,18,58,2841,353,435,788,"21 de agosto de 1994"
15,19,58,2842,242,335,577,"21 de agosto de 1994"
15,19,58,2843,150,215,365,"21 de agosto de 1994"
15,19,58,2844,287,348,635,"21 de agosto de 1994"
15,19,58,2845,327,342,669,"21 de agosto de 1994"
15,19,58,2846,586,637,1223,"21 de agosto de 1994"
15,19,58,2847,336,382,718,"21 de agosto de 1994"
15,19,58,2848,231,271,502,"21 de agosto de 1994"
15,19,58,2849,262,316,578,"21 de agosto de 1994"
15,19,58,2850,300,341,641,"21 de agosto de 1994"
15,19,58,2851,387,473,860,"21 de agosto de 1994"
15,19,58,2852,304,390,694,"21 de agosto de 1994"
15,19,58,2853,340,343,683,"21 de agosto de 1994"
15,19,58,2854,614,73,687,"21 de agosto de 1994"
15,19,58,2855,263,291,554,"21 de agosto de 1994"
15,19,58,2856,588,624,1212,"21 de agosto de 1994"
15,19,58,2857,236,288,524,"21 de agosto de 1994"
15,19,58,2858,221,219,440,"21 de agosto de 1994"
15,19,58,2859,353,386,739,"21 de agosto de 1994"
15,19,58,2860,276,288,564,"21 de agosto de 1994"
15,19,58,2861,240,251,491,"21 de agosto de 1994"
15,19,58,2862,247,244,491,"21 de agosto de 1994"
15,19,58,2863,558,604,1162,"21 de agosto de 1994"
15,19,58,2864,360,413,773,"21 de agosto de 1994"
15,19,58,2865,385,403,788,"21 de agosto de 1994"
15,19,58,2866,632,632,1264,"21 de agosto de 1994"
15,19,58,2867,559,588,1147,"21 de agosto de 1994"
15,19,58,2868,245,268,513,"21 de agosto de 1994"
15,19,58,2869,406,441,847,"21 de agosto de 1994"
15,19,58,2870,291,328,619,"21 de agosto de 1994"
15,19,58,2871,197,255,452,"21 de agosto de 1994"
15,19,58,2872,467,504,971,"21 de agosto de 1994"
15,19,58,2873,365,428,793,"21 de agosto de 1994"
15,19,58,2874,554,587,1141,"21 de agosto de 1994"
15,19,58,2875,425,438,863,"21 de agosto de 1994"
15,19,58,2876,207,219,426,"21 de agosto de 1994"
15,19,58,2877,403,427,830,"21 de agosto de 1994"
15,19,58,2878,429,492,921,"21 de agosto de 1994"
15,19,58,2879,297,358,655,"21 de agosto de 1994"
15,19,58,2880,703,793,1496,"21 de agosto de 1994"
15,19,58,2881,299,325,624,"21 de agosto de 1994"
15,19,58,2882,285,371,656,"21 de agosto de 1994"
15,19,58,2883,239,242,481,"21 de agosto de 1994"
15,19,58,2884,222,232,454,"21 de agosto de 1994"
15,19,58,2885,290,290,580,"21 de agosto de 1994"
15,19,58,2886,155,212,367,"21 de agosto de 1994"
15,19,58,2887,167,234,401,"21 de agosto de 1994"
15,20,58,2888,604,645,1249,"21 de agosto de 1994"
15,20,58,2889,818,932,1750,"21 de agosto de 1994"
15,20,58,2890,595,650,1245,"21 de agosto de 1994"
15,20,58,2891,405,462,867,"21 de agosto de 1994"
15,20,58,2892,397,414,811,"21 de agosto de 1994"
15,20,58,2893,413,460,873,"21 de agosto de 1994"
15,20,58,2894,429,512,941,"21 de agosto de 1994"
15,20,58,2895,527,658,1185,"21 de agosto de 1994"
15,20,58,2896,586,679,1265,"21 de agosto de 1994"
15,20,58,2897,345,387,732,"21 de agosto de 1994"
15,20,58,2898,634,684,1318,"21 de agosto de 1994"
15,20,58,2899,614,647,1261,"21 de agosto de 1994"
15,20,58,2900,487,506,993,"21 de agosto de 1994"
15,20,58,2901,442,480,922,"21 de agosto de 1994"
15,20,58,2902,743,809,1552,"21 de agosto de 1994"
15,20,58,2903,181,234,415,"21 de agosto de 1994"
15,20,58,2904,322,357,679,"21 de agosto de 1994"
15,20,58,2905,445,450,895,"21 de agosto de 1994"
15,20,58,2906,555,620,1175,"21 de agosto de 1994"
15,20,58,2907,631,682,1313,"21 de agosto de 1994"
15,20,58,2908,826,929,1755,"21 de agosto de 1994"
15,20,58,2909,716,784,1500,"21 de agosto de 1994"
15,20,58,2910,705,743,1448,"21 de agosto de 1994"
15,20,58,2911,790,886,1676,"21 de agosto de 1994"
15,20,58,2912,804,836,1640,"21 de agosto de 1994"
15,20,58,2913,696,831,1527,"21 de agosto de 1994"
15,20,58,2914,438,501,939,"21 de agosto de 1994"
15,20,58,2915,685,796,1481,"21 de agosto de 1994"
15,20,58,2916,609,708,1317,"21 de agosto de 1994"
15,20,58,2917,477,489,966,"21 de agosto de 1994"
15,20,58,2918,363,452,815,"21 de agosto de 1994"
15,20,58,2919,597,689,1286,"21 de agosto de 1994"
15,20,58,2920,192,224,416,"21 de agosto de 1994"
15,20,58,2921,731,770,1501,"21 de agosto de 1994"
15,20,58,2922,745,813,1558,"21 de agosto de 1994"
15,20,58,2923,719,748,1467,"21 de agosto de 1994"
15,20,58,2924,688,754,1442,"21 de agosto de 1994"
15,20,58,2925,667,727,1394,"21 de agosto de 1994"
15,20,58,2926,725,803,1528,"21 de agosto de 1994"
15,20,58,2927,743,747,1490,"21 de agosto de 1994"
15,20,58,2928,495,507,1002,"21 de agosto de 1994"
15,20,58,2929,603,668,1271,"21 de agosto de 1994"
15,20,58,2930,390,383,773,"21 de agosto de 1994"
15,20,58,2931,294,348,642,"21 de agosto de 1994"
15,20,58,2932,628,692,1320,"21 de agosto de 1994"
15,20,58,2933,280,334,614,"21 de agosto de 1994"
15,20,58,2934,759,785,1544,"21 de agosto de 1994"
15,20,58,2935,422,456,878,"21 de agosto de 1994"
15,20,58,2936,562,610,1172,"21 de agosto de 1994"
15,20,58,2937,519,565,1084,"21 de agosto de 1994"
15,20,58,2938,428,436,864,"21 de agosto de 1994"
15,20,58,2939,499,554,1053,"21 de agosto de 1994"
15,20,58,2940,748,750,1498,"21 de agosto de 1994"
15,20,58,2941,744,764,1508,"21 de agosto de 1994"
15,20,58,2942,608,678,1286,"21 de agosto de 1994"
15,20,58,2943,371,385,756,"21 de agosto de 1994"
15,20,58,2944,540,583,1123,"21 de agosto de 1994"
15,20,58,2945,447,474,921,"21 de agosto de 1994"
15,20,58,2946,320,386,706,"21 de agosto de 1994"
15,20,58,2947,401,405,806,"21 de agosto de 1994"
15,20,58,2948,431,490,921,"21 de agosto de 1994"
15,20,58,2949,587,633,1220,"21 de agosto de 1994"
15,20,58,2950,488,486,974,"21 de agosto de 1994"
15,20,58,2951,593,603,1196,"21 de agosto de 1994"
15,20,58,2952,367,397,764,"21 de agosto de 1994"
15,20,58,2953,619,635,1254,"21 de agosto de 1994"
15,20,58,2954,449,491,940,"21 de agosto de 1994"
15,20,58,2955,455,478,933,"21 de agosto de 1994"
15,20,58,2956,547,626,1173,"21 de agosto de 1994"
15,20,58,2957,516,549,1065,"21 de agosto de 1994"
15,20,58,2958,816,953,1769,"21 de agosto de 1994"
15,20,58,2959,755,791,1546,"21 de agosto de 1994"
15,20,58,2960,730,786,1516,"21 de agosto de 1994"
15,20,58,2961,689,788,1477,"21 de agosto de 1994"
15,20,58,2962,636,732,1368,"21 de agosto de 1994"
15,20,58,2963,551,600,1151,"21 de agosto de 1994"
15,20,58,2964,545,565,1110,"21 de agosto de 1994"
15,20,58,2965,479,526,1005,"21 de agosto de 1994"
15,20,58,2966,730,800,1530,"21 de agosto de 1994"
15,20,58,2967,706,784,1490,"21 de agosto de 1994"
15,20,58,2968,727,817,1544,"21 de agosto de 1994"
15,20,58,2969,711,831,1542,"21 de agosto de 1994"
15,20,58,2970,464,521,985,"21 de agosto de 1994"
15,20,58,2971,639,673,1312,"21 de agosto de 1994"
15,20,58,2972,491,497,988,"21 de agosto de 1994"
15,20,58,2973,470,511,981,"21 de agosto de 1994"
15,20,58,2974,421,425,846,"21 de agosto de 1994"
15,20,58,2975,576,656,1232,"21 de agosto de 1994"
15,20,58,2976,559,597,1156,"21 de agosto de 1994"
15,20,58,2977,525,535,1060,"21 de agosto de 1994"
15,20,58,2978,595,652,1247,"21 de agosto de 1994"
15,20,58,2979,684,696,1380,"21 de agosto de 1994"
15,20,58,2980,700,700,1400,"21 de agosto de 1994"
15,20,58,2981,555,564,1119,"21 de agosto de 1994"
15,20,58,2982,424,442,866,"21 de agosto de 1994"
15,20,58,2983,491,551,1042,"21 de agosto de 1994"
15,20,58,2984,435,467,902,"21 de agosto de 1994"
15,20,58,2985,390,452,842,"21 de agosto de 1994"
15,20,58,2986,458,489,947,"21 de agosto de 1994"
15,20,58,2987,530,567,1097,"21 de agosto de 1994"
15,20,58,2988,464,509,973,"21 de agosto de 1994"
15,20,58,2989,572,605,1177,"21 de agosto de 1994"
15,20,58,2990,505,557,1062,"21 de agosto de 1994"
15,20,58,2991,413,468,881,"21 de agosto de 1994"
15,20,58,2992,659,680,1339,"21 de agosto de 1994"
15,20,58,2993,419,447,866,"21 de agosto de 1994"
15,20,58,2994,684,775,1459,"21 de agosto de 1994"
15,20,58,2995,671,769,1440,"21 de agosto de 1994"
15,20,58,2996,522,554,1076,"21 de agosto de 1994"
15,20,58,2997,523,552,1075,"21 de agosto de 1994"
15,20,58,2998,509,545,1054,"21 de agosto de 1994"
15,20,58,2999,950,958,1908,"21 de agosto de 1994"
15,20,58,3000,593,656,1249,"21 de agosto de 1994"
15,20,58,3001,368,362,730,"21 de agosto de 1994"
15,20,58,3002,363,341,704,"21 de agosto de 1994"
15,20,58,3003,476,498,974,"21 de agosto de 1994"
15,20,58,3004,544,616,1160,"21 de agosto de 1994"
15,20,58,3005,570,628,1198,"21 de agosto de 1994"
15,20,58,3006,630,713,1343,"21 de agosto de 1994"
15,20,58,3007,603,675,1278,"21 de agosto de 1994"
15,20,58,3008,305,345,650,"21 de agosto de 1994"
15,20,58,3009,631,748,1379,"21 de agosto de 1994"
15,20,58,3010,402,474,876,"21 de agosto de 1994"
15,20,58,3011,489,546,1035,"21 de agosto de 1994"
15,20,58,3012,281,307,588,"21 de agosto de 1994"
15,20,58,3013,260,252,512,"21 de agosto de 1994"
15,20,58,3014,692,733,1425,"21 de agosto de 1994"
15,20,58,3015,436,457,893,"21 de agosto de 1994"
15,20,58,3016,624,646,1270,"21 de agosto de 1994"
15,20,58,3017,618,651,1269,"21 de agosto de 1994"
15,20,58,3018,614,689,1303,"21 de agosto de 1994"
15,20,58,3019,477,538,1015,"21 de agosto de 1994"
15,20,58,3020,482,497,979,"21 de agosto de 1994"
15,20,58,3021,332,365,697,"21 de agosto de 1994"
15,20,58,3022,515,631,1146,"21 de agosto de 1994"
15,20,58,3023,380,431,811,"21 de agosto de 1994"
15,20,58,3024,252,307,559,"21 de agosto de 1994"
15,20,58,3025,472,493,965,"21 de agosto de 1994"
15,20,58,3026,438,479,917,"21 de agosto de 1994"
15,20,58,3027,411,455,866,"21 de agosto de 1994"
15,20,58,3028,453,519,972,"21 de agosto de 1994"
15,20,58,3029,656,709,1365,"21 de agosto de 1994"
15,20,58,3030,495,514,1009,"21 de agosto de 1994"
15,20,58,3031,542,590,1132,"21 de agosto de 1994"
15,20,58,3032,554,561,1115,"21 de agosto de 1994"
15,20,58,3033,259,285,544,"21 de agosto de 1994"
15,20,58,3034,157,155,312,"21 de agosto de 1994"
15,20,58,3035,872,915,1787,"21 de agosto de 1994"
15,21,2,33,473,492,965,"21 de agosto de 1994"
15,21,2,34,523,567,1090,"21 de agosto de 1994"
15,21,2,35,559,579,1138,"21 de agosto de 1994"
15,21,2,36,43,40,83,"21 de agosto de 1994"
15,21,2,37,501,518,1019,"21 de agosto de 1994"
15,21,2,38,506,540,1046,"21 de agosto de 1994"
15,21,2,39,28,34,62,"21 de agosto de 1994"
15,21,2,40,190,212,402,"21 de agosto de 1994"
15,21,2,41,452,475,927,"21 de agosto de 1994"
15,21,2,42,472,490,962,"21 de agosto de 1994"
15,21,2,43,443,503,946,"21 de agosto de 1994"
15,21,2,44,407,432,839,"21 de agosto de 1994"
15,21,2,45,436,464,900,"21 de agosto de 1994"
15,21,2,46,563,615,1178,"21 de agosto de 1994"
15,21,2,47,541,598,1139,"21 de agosto de 1994"
15,21,2,48,610,599,1209,"21 de agosto de 1994"
15,21,2,49,752,779,1531,"21 de agosto de 1994"
15,21,2,50,747,797,1544,"21 de agosto de 1994"
15,21,2,51,728,792,1520,"21 de agosto de 1994"
15,21,2,52,381,392,773,"21 de agosto de 1994"
15,21,2,53,659,794,1453,"21 de agosto de 1994"
15,21,2,54,641,729,1370,"21 de agosto de 1994"
15,21,2,55,691,759,1450,"21 de agosto de 1994"
15,21,2,56,507,552,1059,"21 de agosto de 1994"
15,21,2,57,541,545,1086,"21 de agosto de 1994"
15,21,2,58,428,476,904,"21 de agosto de 1994"
15,21,10,219,625,639,1264,"21 de agosto de 1994"
15,21,10,220,757,733,1490,"21 de agosto de 1994"
15,21,10,221,677,675,1352,"21 de agosto de 1994"
15,21,10,222,809,806,1615,"21 de agosto de 1994"
15,21,10,223,372,391,763,"21 de agosto de 1994"
15,21,10,224,587,592,1179,"21 de agosto de 1994"
15,21,10,225,195,192,387,"21 de agosto de 1994"
15,21,10,226,242,214,456,"21 de agosto de 1994"
15,21,10,227,113,117,230,"21 de agosto de 1994"
15,21,10,228,56,60,116,"21 de agosto de 1994"
15,21,10,229,43,36,79,"21 de agosto de 1994"
15,21,10,230,183,203,386,"21 de agosto de 1994"
15,21,10,231,405,376,781,"21 de agosto de 1994"
15,21,10,232,377,378,755,"21 de agosto de 1994"
15,21,16,469,412,411,823,"21 de agosto de 1994"
15,21,16,470,373,375,748,"21 de agosto de 1994"
15,21,16,471,191,213,404,"21 de agosto de 1994"
15,21,16,472,384,366,750,"21 de agosto de 1994"
15,21,16,473,351,327,678,"21 de agosto de 1994"
15,21,16,474,138,153,291,"21 de agosto de 1994"
15,21,16,475,180,157,337,"21 de agosto de 1994"
15,21,16,476,76,67,143,"21 de agosto de 1994"
15,21,16,477,101,90,191,"21 de agosto de 1994"
15,21,16,478,557,528,1085,"21 de agosto de 1994"
15,21,16,479,42,45,87,"21 de agosto de 1994"
15,21,16,480,74,57,131,"21 de agosto de 1994"
15,21,16,481,112,114,226,"21 de agosto de 1994"
15,21,16,482,237,224,461,"21 de agosto de 1994"
15,21,16,483,137,124,261,"21 de agosto de 1994"
15,21,16,484,108,102,210,"21 de agosto de 1994"
15,21,16,485,383,374,757,"21 de agosto de 1994"
15,21,16,486,325,324,649,"21 de agosto de 1994"
15,21,16,487,502,504,1006,"21 de agosto de 1994"
15,21,16,488,26,25,51,"21 de agosto de 1994"
15,21,16,489,35,36,71,"21 de agosto de 1994"
15,21,37,1976,752,762,1514,"21 de agosto de 1994"
15,21,37,1977,343,289,632,"21 de agosto de 1994"
15,21,37,1978,602,498,1100,"21 de agosto de 1994"
15,21,37,1979,499,507,1006,"21 de agosto de 1994"
15,21,37,1980,598,570,1168,"21 de agosto de 1994"
15,21,37,1981,652,627,1279,"21 de agosto de 1994"
15,21,37,1982,183,149,332,"21 de agosto de 1994"
15,21,37,1983,762,722,1484,"21 de agosto de 1994"
15,21,37,1984,648,648,1296,"21 de agosto de 1994"
15,21,37,1985,533,490,1023,"21 de agosto de 1994"
15,21,37,1986,79,67,146,"21 de agosto de 1994"
15,21,37,1987,427,390,817,"21 de agosto de 1994"
15,21,37,1988,207,206,413,"21 de agosto de 1994"
15,21,37,1989,424,427,851,"21 de agosto de 1994"
15,21,37,1990,558,541,1099,"21 de agosto de 1994"
15,21,37,1991,475,420,895,"21 de agosto de 1994"
15,21,45,2243,510,587,1097,"21 de agosto de 1994"
15,21,45,2244,636,610,1246,"21 de agosto de 1994"
15,21,45,2245,594,668,1262,"21 de agosto de 1994"
15,21,45,2246,26,20,46,"21 de agosto de 1994"
15,21,45,2247,77,94,171,"21 de agosto de 1994"
15,21,45,2248,525,541,1066,"21 de agosto de 1994"
15,21,45,2249,610,648,1258,"21 de agosto de 1994"
15,21,45,2250,380,450,830,"21 de agosto de 1994"
15,21,45,2251,421,466,887,"21 de agosto de 1994"
15,21,45,2252,330,388,718,"21 de agosto de 1994"
15,21,45,2253,295,328,623,"21 de agosto de 1994"
15,21,45,2254,404,434,838,"21 de agosto de 1994"
15,21,45,2255,430,453,883,"21 de agosto de 1994"
15,21,45,2256,382,448,830,"21 de agosto de 1994"
15,21,45,2257,263,319,582,"21 de agosto de 1994"
15,21,45,2258,238,267,505,"21 de agosto de 1994"
15,21,45,2259,274,299,573,"21 de agosto de 1994"
15,21,54,2448,436,446,882,"21 de agosto de 1994"
15,21,54,2449,414,433,847,"21 de agosto de 1994"
15,21,54,2450,856,925,1781,"21 de agosto de 1994"
15,21,54,2451,662,733,1395,"21 de agosto de 1994"
15,21,54,2452,541,507,1048,"21 de agosto de 1994"
15,21,54,2453,651,686,1337,"21 de agosto de 1994"
15,21,54,2454,736,774,1510,"21 de agosto de 1994"
15,21,54,2455,577,658,1235,"21 de agosto de 1994"
15,21,54,2456,570,605,1175,"21 de agosto de 1994"
15,21,54,2457,385,398,783,"21 de agosto de 1994"
15,21,54,2458,525,564,1089,"21 de agosto de 1994"
15,21,54,2459,584,658,1242,"21 de agosto de 1994"
15,21,54,2460,80,77,157,"21 de agosto de 1994"
15,21,54,2461,70,73,143,"21 de agosto de 1994"
15,21,54,2462,642,650,1292,"21 de agosto de 1994"
15,21,54,2463,185,205,390,"21 de agosto de 1994"
15,21,59,3036,648,714,1362,"21 de agosto de 1994"
15,21,59,3037,509,554,1063,"21 de agosto de 1994"
15,21,59,3038,370,398,768,"21 de agosto de 1994"
15,21,59,3039,216,259,475,"21 de agosto de 1994"
15,21,59,3040,570,606,1176,"21 de agosto de 1994"
15,21,59,3041,162,176,338,"21 de agosto de 1994"
15,21,59,3042,316,317,633,"21 de agosto de 1994"
15,21,59,3043,259,242,501,"21 de agosto de 1994"
15,21,59,3044,47,40,87,"21 de agosto de 1994"
15,21,59,3045,181,189,370,"21 de agosto de 1994"
15,21,62,3823,347,354,701,"21 de agosto de 1994"
15,21,62,3824,318,325,643,"21 de agosto de 1994"
15,21,62,3825,40,33,73,"21 de agosto de 1994"
15,21,62,3826,696,688,1384,"21 de agosto de 1994"
15,21,62,3827,323,316,639,"21 de agosto de 1994"
15,21,76,4106,460,483,943,"21 de agosto de 1994"
15,21,76,4107,515,560,1075,"21 de agosto de 1994"
15,21,76,4108,502,498,1000,"21 de agosto de 1994"
15,21,76,4109,620,671,1291,"21 de agosto de 1994"
15,21,76,4110,664,688,1352,"21 de agosto de 1994"
15,21,76,4111,41,39,80,"21 de agosto de 1994"
15,21,76,4112,83,71,154,"21 de agosto de 1994"
15,21,76,4113,246,228,474,"21 de agosto de 1994"
15,21,76,4114,199,176,375,"21 de agosto de 1994"
15,21,76,4115,126,115,241,"21 de agosto de 1994"
15,21,76,4116,157,168,325,"21 de agosto de 1994"
15,21,76,4117,42,46,88,"21 de agosto de 1994"
15,21,76,4118,347,385,732,"21 de agosto de 1994"
15,21,76,4119,370,312,682,"21 de agosto de 1994"
15,21,76,4120,8,6,14,"21 de agosto de 1994"
15,21,82,4188,449,485,934,"21 de agosto de 1994"
15,21,82,4189,531,590,1121,"21 de agosto de 1994"
15,21,82,4190,636,687,1323,"21 de agosto de 1994"
15,21,82,4191,604,624,1228,"21 de agosto de 1994"
15,21,82,4192,409,479,888,"21 de agosto de 1994"
15,21,82,4193,460,490,950,"21 de agosto de 1994"
15,21,82,4194,351,351,702,"21 de agosto de 1994"
15,21,82,4195,491,502,993,"21 de agosto de 1994"
15,21,82,4196,266,287,553,"21 de agosto de 1994"
15,21,82,4197,680,750,1430,"21 de agosto de 1994"
15,21,82,4198,480,533,1013,"21 de agosto de 1994"
15,21,82,4199,614,636,1250,"21 de agosto de 1994"
15,21,82,4200,261,282,543,"21 de agosto de 1994"
15,21,82,4201,675,614,1289,"21 de agosto de 1994"
15,21,82,4202,399,425,824,"21 de agosto de 1994"
15,21,82,4203,571,592,1163,"21 de agosto de 1994"
15,21,82,4204,666,749,1415,"21 de agosto de 1994"
15,21,82,4205,492,484,976,"21 de agosto de 1994"
15,21,82,4206,507,525,1032,"21 de agosto de 1994"
15,21,82,4207,651,661,1312,"21 de agosto de 1994"
15,21,82,4208,388,415,803,"21 de agosto de 1994"
15,21,82,4209,618,652,1270,"21 de agosto de 1994"
15,21,82,4210,46,52,98,"21 de agosto de 1994"
15,21,82,4211,399,476,875,"21 de agosto de 1994"
15,21,82,4212,752,838,1590,"21 de agosto de 1994"
15,21,82,4213,604,659,1263,"21 de agosto de 1994"
15,21,82,4214,478,513,991,"21 de agosto de 1994"
15,21,82,4215,520,588,1108,"21 de agosto de 1994"
15,21,82,4216,666,700,1366,"21 de agosto de 1994"
15,21,82,4217,464,517,981,"21 de agosto de 1994"
15,21,82,4218,722,786,1508,"21 de agosto de 1994"
15,21,82,4219,477,525,1002,"21 de agosto de 1994"
15,21,82,4220,671,732,1403,"21 de agosto de 1994"
15,21,82,4221,437,442,879,"21 de agosto de 1994"
15,21,82,4222,362,438,800,"21 de agosto de 1994"
15,21,82,4223,489,545,1034,"21 de agosto de 1994"
15,21,82,4224,592,669,1261,"21 de agosto de 1994"
15,21,82,4225,379,379,758,"21 de agosto de 1994"
15,21,82,4226,779,835,1614,"21 de agosto de 1994"
15,21,82,4227,510,561,1071,"21 de agosto de 1994"
15,21,82,4228,608,654,1262,"21 de agosto de 1994"
15,21,82,4229,529,633,1162,"21 de agosto de 1994"
15,21,82,4230,442,477,919,"21 de agosto de 1994"
15,21,82,4231,650,686,1336,"21 de agosto de 1994"
15,21,82,4232,510,539,1049,"21 de agosto de 1994"
15,21,82,4233,570,657,1227,"21 de agosto de 1994"
15,21,82,4234,597,657,1254,"21 de agosto de 1994"
15,21,82,4235,422,461,883,"21 de agosto de 1994"
15,21,82,4236,490,566,1056,"21 de agosto de 1994"
15,21,82,4237,655,762,1417,"21 de agosto de 1994"
15,21,82,4238,598,653,1251,"21 de agosto de 1994"
15,21,82,4239,443,512,955,"21 de agosto de 1994"
15,21,82,4240,379,450,829,"21 de agosto de 1994"
15,21,82,4241,465,533,998,"21 de agosto de 1994"
15,21,82,4242,556,578,1134,"21 de agosto de 1994"
15,21,82,4243,576,651,1227,"21 de agosto de 1994"
15,21,82,4244,541,602,1143,"21 de agosto de 1994"
15,21,82,4245,528,605,1133,"21 de agosto de 1994"
15,21,82,4246,461,495,956,"21 de agosto de 1994"
15,21,82,4247,639,744,1383,"21 de agosto de 1994"
15,21,82,4248,587,663,1250,"21 de agosto de 1994"
15,21,82,4249,492,576,1068,"21 de agosto de 1994"
15,21,82,4250,591,663,1254,"21 de agosto de 1994"
15,21,82,4251,405,426,831,"21 de agosto de 1994"
15,21,82,4252,161,185,346,"21 de agosto de 1994"
15,21,82,4253,396,484,880,"21 de agosto de 1994"
15,21,82,4254,143,168,311,"21 de agosto de 1994"
15,21,82,4255,378,456,834,"21 de agosto de 1994"
15,21,85,4331,587,628,1215,"21 de agosto de 1994"
15,21,85,4332,564,599,1163,"21 de agosto de 1994"
15,21,85,4333,54,60,114,"21 de agosto de 1994"
15,21,85,4334,422,441,863,"21 de agosto de 1994"
15,21,85,4335,342,360,702,"21 de agosto de 1994"
15,21,85,4336,155,143,298,"21 de agosto de 1994"
15,21,85,4337,767,781,1548,"21 de agosto de 1994"
15,21,85,4338,230,249,479,"21 de agosto de 1994"
15,21,85,4339,204,221,425,"21 de agosto de 1994"
15,21,85,4340,436,472,908,"21 de agosto de 1994"
15,21,85,4341,191,174,365,"21 de agosto de 1994"
15,21,85,4342,681,667,1348,"21 de agosto de 1994"
15,21,85,4343,432,469,901,"21 de agosto de 1994"
15,21,85,4344,394,390,784,"21 de agosto de 1994"
15,21,85,4345,127,115,242,"21 de agosto de 1994"
15,21,92,4498,737,796,1533,"21 de agosto de 1994"
15,21,92,4499,855,863,1718,"21 de agosto de 1994"
15,21,92,4500,407,456,863,"21 de agosto de 1994"
15,21,92,4501,678,755,1433,"21 de agosto de 1994"
15,21,92,4502,364,373,737,"21 de agosto de 1994"
15,21,92,4503,285,295,580,"21 de agosto de 1994"
15,21,92,4504,424,476,900,"21 de agosto de 1994"
15,21,92,4505,588,617,1205,"21 de agosto de 1994"
15,21,92,4506,746,807,1553,"21 de agosto de 1994"
15,21,92,4507,447,460,907,"21 de agosto de 1994"
15,21,92,4508,516,605,1121,"21 de agosto de 1994"
15,21,92,4509,632,703,1335,"21 de agosto de 1994"
15,21,92,4510,929,1035,1964,"21 de agosto de 1994"
15,21,92,4511,560,565,1125,"21 de agosto de 1994"
15,21,92,4512,724,742,1466,"21 de agosto de 1994"
15,21,92,4513,517,575,1092,"21 de agosto de 1994"
15,21,92,4514,224,262,486,"21 de agosto de 1994"
15,21,92,4515,343,362,705,"21 de agosto de 1994"
15,21,92,4516,358,400,758,"21 de agosto de 1994"
15,21,92,4517,225,241,466,"21 de agosto de 1994"
15,21,92,4518,72,102,174,"21 de agosto de 1994"
15,21,92,4519,417,450,867,"21 de agosto de 1994"
15,21,92,4520,23,31,54,"21 de agosto de 1994"
15,21,92,4521,372,399,771,"21 de agosto de 1994"
15,21,92,4522,570,555,1125,"21 de agosto de 1994"
15,21,93,4523,682,769,1451,"21 de agosto de 1994"
15,21,93,4524,699,755,1454,"21 de agosto de 1994"
15,21,93,4525,1646,881,2527,"21 de agosto de 1994"
15,21,93,4526,716,770,1486,"21 de agosto de 1994"
15,21,93,4527,741,853,1594,"21 de agosto de 1994"
15,21,93,4528,861,915,1776,"21 de agosto de 1994"
15,21,93,4529,143,164,307,"21 de agosto de 1994"
15,21,93,4530,179,191,370,"21 de agosto de 1994"
15,21,93,4531,91,86,177,"21 de agosto de 1994"
15,21,93,4532,217,199,416,"21 de agosto de 1994"
15,21,93,4533,52,41,93,"21 de agosto de 1994"
15,21,93,4534,426,424,850,"21 de agosto de 1994"
15,21,93,4535,420,456,876,"21 de agosto de 1994"
15,21,93,4536,63,71,134,"21 de agosto de 1994"
15,21,93,4537,460,475,935,"21 de agosto de 1994"
15,21,93,4538,733,737,1470,"21 de agosto de 1994"
15,21,93,4539,562,562,1124,"21 de agosto de 1994"
15,21,93,4540,71,82,153,"21 de agosto de 1994"
15,21,93,4541,88,71,159,"21 de agosto de 1994"
15,21,93,4542,553,584,1137,"21 de agosto de 1994"
15,21,93,4543,431,453,884,"21 de agosto de 1994"
15,21,93,4544,35,33,68,"21 de agosto de 1994"
15,21,93,4545,496,518,1014,"21 de agosto de 1994"
15,21,97,4588,699,769,1468,"21 de agosto de 1994"
15,21,97,4589,800,840,1640,"21 de agosto de 1994"
15,21,97,4590,541,561,1102,"21 de agosto de 1994"
15,21,97,4591,528,541,1069,"21 de agosto de 1994"
15,21,97,4592,727,724,1451,"21 de agosto de 1994"
15,21,97,4593,769,747,1516,"21 de agosto de 1994"
15,21,97,4594,434,421,855,"21 de agosto de 1994"
15,21,97,4595,435,417,852,"21 de agosto de 1994"
15,21,97,4596,402,404,806,"21 de agosto de 1994"
15,21,97,4597,82,58,140,"21 de agosto de 1994"
15,21,97,4598,33,29,62,"21 de agosto de 1994"
15,21,97,4599,380,388,768,"21 de agosto de 1994"
15,21,97,4600,103,101,204,"21 de agosto de 1994"
15,21,101,4691,668,681,1349,"21 de agosto de 1994"
15,21,101,4692,600,674,1274,"21 de agosto de 1994"
15,21,101,4693,356,417,773,"21 de agosto de 1994"
15,21,101,4694,399,416,815,"21 de agosto de 1994"
15,21,101,4695,627,698,1325,"21 de agosto de 1994"
15,21,101,4696,404,448,852,"21 de agosto de 1994"
15,21,101,4697,670,722,1392,"21 de agosto de 1994"
15,21,101,4698,92,93,185,"21 de agosto de 1994"
15,21,101,4699,27,34,61,"21 de agosto de 1994"
15,21,101,4700,199,207,406,"21 de agosto de 1994"
15,21,109,5452,680,746,1426,"21 de agosto de 1994"
15,21,109,5453,515,523,1038,"21 de agosto de 1994"
15,21,109,5454,557,630,1187,"21 de agosto de 1994"
15,21,109,5455,682,717,1399,"21 de agosto de 1994"
15,21,109,5456,740,795,1535,"21 de agosto de 1994"
15,21,109,5457,424,493,917,"21 de agosto de 1994"
15,21,109,5458,282,304,586,"21 de agosto de 1994"
15,21,109,5459,706,776,1482,"21 de agosto de 1994"
15,21,109,5460,384,452,836,"21 de agosto de 1994"
15,21,109,5461,607,678,1285,"21 de agosto de 1994"
15,21,109,5462,638,613,1251,"21 de agosto de 1994"
15,21,109,5463,567,609,1176,"21 de agosto de 1994"
15,21,109,5464,447,499,946,"21 de agosto de 1994"
15,21,109,5465,526,558,1084,"21 de agosto de 1994"
15,21,109,5466,596,630,1226,"21 de agosto de 1994"
15,21,109,5467,585,629,1214,"21 de agosto de 1994"
15,21,109,5468,282,317,599,"21 de agosto de 1994"
15,21,109,5469,109,119,228,"21 de agosto de 1994"
15,21,109,5470,35,48,83,"21 de agosto de 1994"
15,21,109,5471,167,195,362,"21 de agosto de 1994"
15,21,109,5472,112,127,239,"21 de agosto de 1994"
15,21,109,5473,687,659,1346,"21 de agosto de 1994"
15,21,109,5474,404,503,907,"21 de agosto de 1994"
15,21,109,5475,529,647,1176,"21 de agosto de 1994"
15,21,109,5476,471,503,974,"21 de agosto de 1994"
15,21,109,5477,743,731,1474,"21 de agosto de 1994"
15,21,109,5478,531,636,1167,"21 de agosto de 1994"
15,21,109,5479,433,442,875,"21 de agosto de 1994"
15,21,109,5480,507,529,1036,"21 de agosto de 1994"
15,21,109,5481,428,499,927,"21 de agosto de 1994"
15,21,121,5880,818,906,1724,"21 de agosto de 1994"
15,21,121,5881,631,699,1330,"21 de agosto de 1994"
15,21,121,5882,721,776,1497,"21 de agosto de 1994"
15,21,121,5883,602,632,1234,"21 de agosto de 1994"
15,21,121,5884,722,829,1551,"21 de agosto de 1994"
15,21,121,5885,725,745,1470,"21 de agosto de 1994"
15,21,121,5886,588,684,1272,"21 de agosto de 1994"
15,21,121,5887,770,818,1588,"21 de agosto de 1994"
15,21,121,5888,779,842,1621,"21 de agosto de 1994"
15,21,121,5889,568,594,1162,"21 de agosto de 1994"
15,21,121,5890,539,549,1088,"21 de agosto de 1994"
15,21,121,5891,695,720,1415,"21 de agosto de 1994"
15,21,121,5892,559,626,1185,"21 de agosto de 1994"
15,21,121,5893,75,78,153,"21 de agosto de 1994"
15,21,121,5894,214,215,429,"21 de agosto de 1994"
15,21,121,5895,310,321,631,"21 de agosto de 1994"
15,21,121,5896,396,420,816,"21 de agosto de 1994"
15,21,121,5897,243,254,497,"21 de agosto de 1994"
15,21,121,5898,309,303,612,"21 de agosto de 1994"
15,21,121,5899,298,286,584,"21 de agosto de 1994"
15,21,121,5900,601,642,1243,"21 de agosto de 1994"
15,21,121,5901,644,657,1301,"21 de agosto de 1994"
15,21,121,5902,779,760,1539,"21 de agosto de 1994"
15,21,121,5903,71,63,134,"21 de agosto de 1994"
15,21,121,5904,150,140,290,"21 de agosto de 1994"
15,21,121,5905,217,237,454,"21 de agosto de 1994"
15,21,121,5906,914,955,1869,"21 de agosto de 1994"
15,21,121,5907,643,696,1339,"21 de agosto de 1994"
15,21,121,5908,733,774,1507,"21 de agosto de 1994"
15,21,121,5909,775,751,1526,"21 de agosto de 1994"
15,21,121,5910,730,771,1501,"21 de agosto de 1994"
15,21,121,5911,512,510,1022,"21 de agosto de 1994"
15,21,121,5912,157,159,316,"21 de agosto de 1994"
15,21,121,5913,35,40,75,"21 de agosto de 1994"
15,21,121,5914,143,156,299,"21 de agosto de 1994"
15,21,121,5915,533,593,1126,"21 de agosto de 1994"
15,21,121,5916,497,519,1016,"21 de agosto de 1994"
15,21,121,5917,289,299,588,"21 de agosto de 1994"
15,21,121,5918,64,68,132,"21 de agosto de 1994"
15,21,121,5919,170,206,376,"21 de agosto de 1994"
15,21,121,5920,47,63,110,"21 de agosto de 1994"
15,21,121,5921,888,758,1646,"21 de agosto de 1994"
15,21,121,5922,334,151,485,"21 de agosto de 1994"
15,21,121,5923,854,410,1264,"21 de agosto de 1994"
15,22,60,3194,451,530,981,"21 de agosto de 1994"
15,22,60,3195,404,457,861,"21 de agosto de 1994"
15,22,60,3196,759,930,1689,"21 de agosto de 1994"
15,22,60,3197,250,269,519,"21 de agosto de 1994"
15,22,60,3198,447,611,1058,"21 de agosto de 1994"
15,22,60,3199,480,605,1085,"21 de agosto de 1994"
15,22,60,3200,259,293,552,"21 de agosto de 1994"
15,22,60,3201,288,354,642,"21 de agosto de 1994"
15,22,60,3202,450,575,1025,"21 de agosto de 1994"
15,22,60,3203,488,615,1103,"21 de agosto de 1994"
15,22,60,3204,495,611,1106,"21 de agosto de 1994"
15,22,60,3205,443,545,988,"21 de agosto de 1994"
15,22,60,3206,513,613,1126,"21 de agosto de 1994"
15,22,60,3207,381,483,864,"21 de agosto de 1994"
15,22,60,3208,263,315,578,"21 de agosto de 1994"
15,22,60,3209,388,423,811,"21 de agosto de 1994"
15,22,60,3210,541,621,1162,"21 de agosto de 1994"
15,22,60,3211,200,219,419,"21 de agosto de 1994"
15,22,60,3212,532,637,1169,"21 de agosto de 1994"
15,22,60,3213,601,755,1356,"21 de agosto de 1994"
15,22,60,3214,501,633,1134,"21 de agosto de 1994"
15,22,60,3215,358,464,822,"21 de agosto de 1994"
15,22,60,3216,350,460,810,"21 de agosto de 1994"
15,22,60,3217,619,787,1406,"21 de agosto de 1994"
15,22,60,3218,605,690,1295,"21 de agosto de 1994"
15,22,60,3219,418,458,876,"21 de agosto de 1994"
15,22,60,3220,624,770,1394,"21 de agosto de 1994"
15,22,60,3221,679,720,1399,"21 de agosto de 1994"
15,22,60,3222,678,782,1460,"21 de agosto de 1994"
15,22,60,3223,656,701,1357,"21 de agosto de 1994"
15,22,60,3224,591,705,1296,"21 de agosto de 1994"
15,22,60,3225,518,589,1107,"21 de agosto de 1994"
15,22,60,3226,790,885,1675,"21 de agosto de 1994"
15,22,60,3227,653,681,1334,"21 de agosto de 1994"
15,22,60,3228,501,546,1047,"21 de agosto de 1994"
15,22,60,3229,735,827,1562,"21 de agosto de 1994"
15,22,60,3230,262,331,593,"21 de agosto de 1994"
15,22,60,3231,575,648,1223,"21 de agosto de 1994"
15,22,60,3232,840,928,1768,"21 de agosto de 1994"
15,22,60,3233,785,794,1579,"21 de agosto de 1994"
15,22,60,3234,815,868,1683,"21 de agosto de 1994"
15,22,60,3235,646,683,1329,"21 de agosto de 1994"
15,22,60,3236,601,613,1214,"21 de agosto de 1994"
15,22,60,3237,618,592,1210,"21 de agosto de 1994"
15,22,60,3238,495,559,1054,"21 de agosto de 1994"
15,22,60,3239,680,698,1378,"21 de agosto de 1994"
15,22,60,3240,691,794,1485,"21 de agosto de 1994"
15,22,60,3241,687,743,1430,"21 de agosto de 1994"
15,22,60,3242,614,692,1306,"21 de agosto de 1994"
15,22,60,3243,559,622,1181,"21 de agosto de 1994"
15,22,60,3244,700,785,1485,"21 de agosto de 1994"
15,22,60,3245,653,736,1389,"21 de agosto de 1994"
15,22,60,3246,700,755,1455,"21 de agosto de 1994"
15,22,60,3247,619,674,1293,"21 de agosto de 1994"
15,22,60,3248,544,544,1088,"21 de agosto de 1994"
15,22,60,3249,622,634,1256,"21 de agosto de 1994"
15,22,60,3250,583,613,1196,"21 de agosto de 1994"
15,22,60,3251,615,717,1332,"21 de agosto de 1994"
15,22,60,3252,560,625,1185,"21 de agosto de 1994"
15,22,60,3253,610,625,1235,"21 de agosto de 1994"
15,22,60,3254,369,430,799,"21 de agosto de 1994"
15,22,60,3255,608,643,1251,"21 de agosto de 1994"
15,22,60,3256,566,572,1138,"21 de agosto de 1994"
15,22,60,3257,425,447,872,"21 de agosto de 1994"
15,22,60,3258,497,533,1030,"21 de agosto de 1994"
15,22,60,3259,713,786,1499,"21 de agosto de 1994"
15,22,60,3260,685,749,1434,"21 de agosto de 1994"
15,22,60,3261,587,620,1207,"21 de agosto de 1994"
15,22,60,3262,391,464,855,"21 de agosto de 1994"
15,22,60,3263,564,616,1180,"21 de agosto de 1994"
15,22,60,3264,513,591,1104,"21 de agosto de 1994"
15,22,60,3265,570,620,1190,"21 de agosto de 1994"
15,22,60,3266,466,489,955,"21 de agosto de 1994"
15,22,60,3267,634,698,1332,"21 de agosto de 1994"
15,22,60,3268,727,807,1534,"21 de agosto de 1994"
15,22,60,3269,688,779,1467,"21 de agosto de 1994"
15,22,60,3270,547,632,1179,"21 de agosto de 1994"
15,22,60,3271,703,727,1430,"21 de agosto de 1994"
15,22,60,3272,618,654,1272,"21 de agosto de 1994"
15,22,60,3273,372,490,862,"21 de agosto de 1994"
15,22,60,3274,419,404,823,"21 de agosto de 1994"
15,22,60,3275,345,416,761,"21 de agosto de 1994"
15,22,60,3276,698,775,1473,"21 de agosto de 1994"
15,22,60,3277,550,596,1146,"21 de agosto de 1994"
15,22,60,3278,437,476,913,"21 de agosto de 1994"
15,22,60,3279,447,450,897,"21 de agosto de 1994"
15,22,60,3280,301,340,641,"21 de agosto de 1994"
15,22,60,3281,476,529,1005,"21 de agosto de 1994"
15,23,60,3282,427,455,882,"21 de agosto de 1994"
15,23,60,3283,326,361,687,"21 de agosto de 1994"
15,23,60,3284,690,730,1420,"21 de agosto de 1994"
15,23,60,3285,746,805,1551,"21 de agosto de 1994"
15,23,60,3286,657,706,1363,"21 de agosto de 1994"
15,23,60,3287,719,745,1464,"21 de agosto de 1994"
15,23,60,3288,679,683,1362,"21 de agosto de 1994"
15,23,60,3289,503,519,1022,"21 de agosto de 1994"
15,23,60,3290,419,451,870,"21 de agosto de 1994"
15,23,60,3291,582,615,1197,"21 de agosto de 1994"
15,23,60,3292,640,680,1320,"21 de agosto de 1994"
15,23,60,3293,412,409,821,"21 de agosto de 1994"
15,23,60,3294,544,589,1133,"21 de agosto de 1994"
15,23,60,3295,551,582,1133,"21 de agosto de 1994"
15,23,60,3296,392,420,812,"21 de agosto de 1994"
15,23,60,3297,455,465,920,"21 de agosto de 1994"
15,23,60,3298,586,594,1180,"21 de agosto de 1994"
15,23,60,3299,451,462,913,"21 de agosto de 1994"
15,23,60,3300,346,345,691,"21 de agosto de 1994"
15,23,60,3301,495,509,1004,"21 de agosto de 1994"
15,23,60,3302,502,552,1054,"21 de agosto de 1994"
15,23,60,3303,553,642,1195,"21 de agosto de 1994"
15,23,60,3304,660,697,1357,"21 de agosto de 1994"
15,23,60,3305,530,556,1086,"21 de agosto de 1994"
15,23,60,3306,547,542,1089,"21 de agosto de 1994"
15,23,60,3307,463,444,907,"21 de agosto de 1994"
15,23,60,3308,366,398,764,"21 de agosto de 1994"
15,23,60,3309,696,787,1483,"21 de agosto de 1994"
15,23,60,3310,440,465,905,"21 de agosto de 1994"
15,23,60,3311,404,417,821,"21 de agosto de 1994"
15,23,60,3312,703,741,1444,"21 de agosto de 1994"
15,23,60,3313,728,801,1529,"21 de agosto de 1994"
15,23,60,3314,618,651,1269,"21 de agosto de 1994"
15,23,60,3315,672,693,1365,"21 de agosto de 1994"
15,23,60,3316,584,633,1217,"21 de agosto de 1994"
15,23,60,3317,566,624,1190,"21 de agosto de 1994"
15,23,60,3318,686,734,1420,"21 de agosto de 1994"
15,23,60,3319,499,539,1038,"21 de agosto de 1994"
15,23,60,3320,468,515,983,"21 de agosto de 1994"
15,23,60,3321,406,462,868,"21 de agosto de 1994"
15,23,60,3322,413,456,869,"21 de agosto de 1994"
15,23,60,3323,624,654,1278,"21 de agosto de 1994"
15,23,60,3324,494,568,1062,"21 de agosto de 1994"
15,23,60,3325,554,611,1165,"21 de agosto de 1994"
15,23,60,3326,471,484,955,"21 de agosto de 1994"
15,23,60,3327,428,457,885,"21 de agosto de 1994"
15,23,60,3328,374,422,796,"21 de agosto de 1994"
15,23,60,3329,476,557,1033,"21 de agosto de 1994"
15,23,60,3330,499,565,1064,"21 de agosto de 1994"
15,23,60,3331,423,466,889,"21 de agosto de 1994"
15,23,60,3332,787,810,1597,"21 de agosto de 1994"
15,23,60,3333,695,720,1415,"21 de agosto de 1994"
15,23,60,3334,366,378,744,"21 de agosto de 1994"
15,23,60,3335,659,715,1374,"21 de agosto de 1994"
15,23,60,3336,561,616,1177,"21 de agosto de 1994"
15,23,60,3337,584,626,1210,"21 de agosto de 1994"
15,23,60,3338,666,721,1387,"21 de agosto de 1994"
15,23,60,3339,658,696,1354,"21 de agosto de 1994"
15,23,60,3340,486,540,1026,"21 de agosto de 1994"
15,23,60,3341,471,505,976,"21 de agosto de 1994"
15,23,60,3342,474,516,990,"21 de agosto de 1994"
15,23,60,3343,475,500,975,"21 de agosto de 1994"
15,23,60,3344,327,372,699,"21 de agosto de 1994"
15,23,60,3345,383,396,779,"21 de agosto de 1994"
15,23,60,3346,391,408,799,"21 de agosto de 1994"
15,23,60,3347,357,416,773,"21 de agosto de 1994"
15,23,60,3348,349,418,767,"21 de agosto de 1994"
15,23,60,3349,484,523,1007,"21 de agosto de 1994"
15,24,60,3350,435,485,920,"21 de agosto de 1994"
15,24,60,3351,535,619,1154,"21 de agosto de 1994"
15,24,60,3352,554,657,1211,"21 de agosto de 1994"
15,24,60,3353,477,524,1001,"21 de agosto de 1994"
15,24,60,3354,496,550,1046,"21 de agosto de 1994"
15,24,60,3355,553,603,1156,"21 de agosto de 1994"
15,24,60,3356,642,741,1383,"21 de agosto de 1994"
15,24,60,3357,711,797,1508,"21 de agosto de 1994"
15,24,60,3358,302,363,665,"21 de agosto de 1994"
15,24,60,3359,531,580,1111,"21 de agosto de 1994"
15,24,60,3360,439,538,977,"21 de agosto de 1994"
15,24,60,3361,434,500,934,"21 de agosto de 1994"
15,24,60,3362,396,427,823,"21 de agosto de 1994"
15,24,60,3363,355,380,735,"21 de agosto de 1994"
15,24,60,3364,352,401,753,"21 de agosto de 1994"
15,24,60,3365,755,874,1629,"21 de agosto de 1994"
15,24,60,3366,541,598,1139,"21 de agosto de 1994"
15,24,60,3367,356,418,774,"21 de agosto de 1994"
15,24,60,3368,778,838,1616,"21 de agosto de 1994"
15,24,60,3369,498,543,1041,"21 de agosto de 1994"
15,24,60,3370,297,361,658,"21 de agosto de 1994"
15,24,60,3371,512,544,1056,"21 de agosto de 1994"
15,24,60,3372,443,543,986,"21 de agosto de 1994"
15,24,60,3373,391,414,805,"21 de agosto de 1994"
15,24,60,3374,510,584,1094,"21 de agosto de 1994"
15,24,60,3375,515,592,1107,"21 de agosto de 1994"
15,24,60,3376,646,730,1376,"21 de agosto de 1994"
15,24,60,3377,458,493,951,"21 de agosto de 1994"
15,24,60,3378,418,427,845,"21 de agosto de 1994"
15,24,60,3379,347,392,739,"21 de agosto de 1994"
15,24,60,3380,469,514,983,"21 de agosto de 1994"
15,24,60,3381,452,548,1000,"21 de agosto de 1994"
15,24,60,3382,453,503,956,"21 de agosto de 1994"
15,24,60,3383,560,632,1192,"21 de agosto de 1994"
15,24,60,3384,559,608,1167,"21 de agosto de 1994"
15,24,60,3385,608,682,1290,"21 de agosto de 1994"
15,24,60,3386,325,386,711,"21 de agosto de 1994"
15,24,60,3387,689,764,1453,"21 de agosto de 1994"
15,24,60,3388,416,454,870,"21 de agosto de 1994"
15,24,60,3389,559,663,1222,"21 de agosto de 1994"
15,24,60,3390,589,696,1285,"21 de agosto de 1994"
15,24,60,3391,299,335,634,"21 de agosto de 1994"
15,24,60,3392,549,634,1183,"21 de agosto de 1994"
15,24,60,3393,325,359,684,"21 de agosto de 1994"
15,24,60,3394,586,644,1230,"21 de agosto de 1994"
15,24,60,3395,545,609,1154,"21 de agosto de 1994"
15,24,60,3396,330,381,711,"21 de agosto de 1994"
15,24,60,3397,464,537,1001,"21 de agosto de 1994"
15,24,60,3398,629,741,1370,"21 de agosto de 1994"
15,24,60,3399,507,517,1024,"21 de agosto de 1994"
15,24,60,3400,532,604,1136,"21 de agosto de 1994"
15,24,60,3401,558,612,1170,"21 de agosto de 1994"
15,24,60,3402,639,695,1334,"21 de agosto de 1994"
15,24,60,3403,706,798,1504,"21 de agosto de 1994"
15,24,60,3404,381,502,883,"21 de agosto de 1994"
15,24,60,3405,574,651,1225,"21 de agosto de 1994"
15,24,60,3406,434,485,919,"21 de agosto de 1994"
15,25,60,3407,395,447,842,"21 de agosto de 1994"
15,25,60,3408,667,712,1379,"21 de agosto de 1994"
15,25,60,3409,461,542,1003,"21 de agosto de 1994"
15,25,60,3410,694,723,1417,"21 de agosto de 1994"
15,25,60,3411,444,496,940,"21 de agosto de 1994"
15,25,60,3412,583,640,1223,"21 de agosto de 1994"
15,25,60,3413,789,866,1655,"21 de agosto de 1994"
15,25,60,3414,459,513,972,"21 de agosto de 1994"
15,25,60,3415,631,716,1347,"21 de agosto de 1994"
15,25,60,3416,527,595,1122,"21 de agosto de 1994"
15,25,60,3417,472,538,1010,"21 de agosto de 1994"
15,25,60,3418,709,844,1553,"21 de agosto de 1994"
15,25,60,3419,783,867,1650,"21 de agosto de 1994"
15,25,60,3420,672,733,1405,"21 de agosto de 1994"
15,25,60,3421,464,552,1016,"21 de agosto de 1994"
15,25,60,3422,634,663,1297,"21 de agosto de 1994"
15,25,60,3423,533,622,1155,"21 de agosto de 1994"
15,25,60,3424,437,497,934,"21 de agosto de 1994"
15,25,60,3425,634,756,1390,"21 de agosto de 1994"
15,25,60,3426,459,502,961,"21 de agosto de 1994"
15,25,60,3427,595,690,1285,"21 de agosto de 1994"
15,25,60,3428,303,344,647,"21 de agosto de 1994"
15,25,60,3429,559,612,1171,"21 de agosto de 1994"
15,25,60,3430,524,594,1118,"21 de agosto de 1994"
15,25,60,3431,351,368,719,"21 de agosto de 1994"
15,25,60,3432,659,682,1341,"21 de agosto de 1994"
15,25,60,3433,651,681,1332,"21 de agosto de 1994"
15,25,60,3434,530,578,1108,"21 de agosto de 1994"
15,25,60,3435,669,767,1436,"21 de agosto de 1994"
15,25,60,3436,352,383,735,"21 de agosto de 1994"
15,25,60,3437,403,463,866,"21 de agosto de 1994"
15,25,60,3438,401,491,892,"21 de agosto de 1994"
15,25,60,3439,714,790,1504,"21 de agosto de 1994"
15,25,60,3440,538,637,1175,"21 de agosto de 1994"
15,25,60,3441,367,410,777,"21 de agosto de 1994"
15,25,60,3442,414,464,878,"21 de agosto de 1994"
15,25,60,3443,665,716,1381,"21 de agosto de 1994"
15,25,60,3444,409,478,887,"21 de agosto de 1994"
15,25,60,3445,383,397,780,"21 de agosto de 1994"
15,25,60,3446,570,601,1171,"21 de agosto de 1994"
15,25,60,3447,771,866,1637,"21 de agosto de 1994"
15,25,60,3448,380,414,794,"21 de agosto de 1994"
15,25,60,3449,734,773,1507,"21 de agosto de 1994"
15,25,60,3450,578,653,1231,"21 de agosto de 1994"
15,25,60,3451,661,739,1400,"21 de agosto de 1994"
15,26,60,3452,673,715,1388,"21 de agosto de 1994"
15,26,60,3453,597,628,1225,"21 de agosto de 1994"
15,26,60,3454,718,790,1508,"21 de agosto de 1994"
15,26,60,3455,709,784,1493,"21 de agosto de 1994"
15,26,60,3456,770,805,1575,"21 de agosto de 1994"
15,26,60,3457,659,710,1369,"21 de agosto de 1994"
15,26,60,3458,504,528,1032,"21 de agosto de 1994"
15,26,60,3459,427,467,894,"21 de agosto de 1994"
15,26,60,3460,392,405,797,"21 de agosto de 1994"
15,26,60,3461,479,512,991,"21 de agosto de 1994"
15,26,60,3462,452,494,946,"21 de agosto de 1994"
15,26,60,3463,582,599,1181,"21 de agosto de 1994"
15,26,60,3464,769,788,1557,"21 de agosto de 1994"
15,26,60,3465,535,601,1136,"21 de agosto de 1994"
15,26,60,3466,610,665,1275,"21 de agosto de 1994"
15,26,60,3467,560,625,1185,"21 de agosto de 1994"
15,26,60,3468,461,467,928,"21 de agosto de 1994"
15,26,60,3469,447,502,949,"21 de agosto de 1994"
15,26,60,3470,431,469,900,"21 de agosto de 1994"
15,26,60,3471,437,502,939,"21 de agosto de 1994"
15,26,60,3472,472,548,1020,"21 de agosto de 1994"
15,26,60,3473,514,548,1062,"21 de agosto de 1994"
15,26,60,3474,544,608,1152,"21 de agosto de 1994"
15,26,60,3475,482,489,971,"21 de agosto de 1994"
15,26,60,3476,497,517,1014,"21 de agosto de 1994"
15,26,60,3477,472,491,963,"21 de agosto de 1994"
15,26,60,3478,542,571,1113,"21 de agosto de 1994"
15,26,60,3479,600,652,1252,"21 de agosto de 1994"
15,26,60,3480,671,688,1359,"21 de agosto de 1994"
15,26,60,3481,530,621,1151,"21 de agosto de 1994"
15,26,60,3482,603,597,1200,"21 de agosto de 1994"
15,26,60,3483,553,629,1182,"21 de agosto de 1994"
15,26,60,3484,543,610,1153,"21 de agosto de 1994"
15,26,60,3485,591,663,1254,"21 de agosto de 1994"
15,26,60,3486,547,614,1161,"21 de agosto de 1994"
15,26,60,3487,423,485,908,"21 de agosto de 1994"
15,26,60,3488,687,781,1468,"21 de agosto de 1994"
15,26,60,3489,678,755,1433,"21 de agosto de 1994"
15,26,60,3490,539,608,1147,"21 de agosto de 1994"
15,26,60,3491,604,655,1259,"21 de agosto de 1994"
15,26,60,3492,569,645,1214,"21 de agosto de 1994"
15,26,60,3493,605,664,1269,"21 de agosto de 1994"
15,26,60,3494,594,635,1229,"21 de agosto de 1994"
15,26,60,3495,540,587,1127,"21 de agosto de 1994"
15,26,60,3496,491,522,1013,"21 de agosto de 1994"
15,26,60,3497,676,742,1418,"21 de agosto de 1994"
15,26,60,3498,619,694,1313,"21 de agosto de 1994"
15,26,60,3499,795,856,1651,"21 de agosto de 1994"
15,26,60,3500,512,582,1094,"21 de agosto de 1994"
15,26,60,3501,521,608,1129,"21 de agosto de 1994"
15,26,60,3502,541,606,1147,"21 de agosto de 1994"
15,26,60,3503,702,737,1439,"21 de agosto de 1994"
15,26,60,3504,570,628,1198,"21 de agosto de 1994"
15,26,60,3505,556,653,1209,"21 de agosto de 1994"
15,26,60,3506,516,612,1128,"21 de agosto de 1994"
15,26,60,3507,506,543,1049,"21 de agosto de 1994"
15,26,60,3508,370,441,811,"21 de agosto de 1994"
15,26,60,3509,374,364,738,"21 de agosto de 1994"
15,26,60,3510,622,665,1287,"21 de agosto de 1994"
15,26,60,3511,718,786,1504,"21 de agosto de 1994"
15,27,60,3512,483,538,1021,"21 de agosto de 1994"
15,27,60,3513,505,541,1046,"21 de agosto de 1994"
15,27,60,3514,648,682,1330,"21 de agosto de 1994"
15,27,60,3515,487,561,1048,"21 de agosto de 1994"
15,27,60,3516,572,635,1207,"21 de agosto de 1994"
15,27,60,3517,659,736,1395,"21 de agosto de 1994"
15,27,60,3518,598,670,1268,"21 de agosto de 1994"
15,27,60,3519,491,541,1032,"21 de agosto de 1994"
15,27,60,3520,473,504,977,"21 de agosto de 1994"
15,27,60,3521,447,483,930,"21 de agosto de 1994"
15,27,60,3522,761,777,1538,"21 de agosto de 1994"
15,27,60,3523,584,596,1180,"21 de agosto de 1994"
15,27,60,3524,302,336,638,"21 de agosto de 1994"
15,27,60,3525,584,617,1201,"21 de agosto de 1994"
15,27,60,3526,558,623,1181,"21 de agosto de 1994"
15,27,60,3527,547,611,1158,"21 de agosto de 1994"
15,27,60,3528,421,479,900,"21 de agosto de 1994"
15,27,60,3529,489,566,1055,"21 de agosto de 1994"
15,27,60,3530,445,442,887,"21 de agosto de 1994"
15,27,60,3531,325,437,762,"21 de agosto de 1994"
15,27,60,3532,519,598,1117,"21 de agosto de 1994"
15,27,60,3533,537,616,1153,"21 de agosto de 1994"
15,27,60,3534,557,584,1141,"21 de agosto de 1994"
15,27,60,3535,710,817,1527,"21 de agosto de 1994"
15,27,60,3536,605,687,1292,"21 de agosto de 1994"
15,27,60,3537,464,499,963,"21 de agosto de 1994"
15,27,60,3538,400,444,844,"21 de agosto de 1994"
15,27,60,3539,450,514,964,"21 de agosto de 1994"
15,27,60,3540,316,391,707,"21 de agosto de 1994"
15,27,60,3541,444,494,938,"21 de agosto de 1994"
15,27,60,3542,612,662,1274,"21 de agosto de 1994"
15,27,60,3543,522,546,1068,"21 de agosto de 1994"
15,27,60,3544,354,396,750,"21 de agosto de 1994"
15,27,60,3545,483,541,1024,"21 de agosto de 1994"
15,27,60,3546,503,595,1098,"21 de agosto de 1994"
15,27,60,3547,456,470,926,"21 de agosto de 1994"
15,27,60,3548,804,833,1637,"21 de agosto de 1994"
15,27,60,3549,571,635,1206,"21 de agosto de 1994"
15,27,60,3550,605,671,1276,"21 de agosto de 1994"
15,27,60,3551,464,477,941,"21 de agosto de 1994"
15,27,60,3552,595,591,1186,"21 de agosto de 1994"
15,27,60,3553,423,464,887,"21 de agosto de 1994"
15,27,60,3554,376,448,824,"21 de agosto de 1994"
15,27,60,3555,406,436,842,"21 de agosto de 1994"
15,27,60,3556,522,556,1078,"21 de agosto de 1994"
15,27,60,3557,620,663,1283,"21 de agosto de 1994"
15,27,60,3558,564,592,1156,"21 de agosto de 1994"
15,27,60,3559,717,782,1499,"21 de agosto de 1994"
15,27,60,3560,515,541,1056,"21 de agosto de 1994"
15,27,60,3561,518,607,1125,"21 de agosto de 1994"
15,27,60,3562,482,517,999,"21 de agosto de 1994"
15,27,60,3563,614,662,1276,"21 de agosto de 1994"
15,27,60,3564,427,463,890,"21 de agosto de 1994"
15,27,60,3565,614,647,1261,"21 de agosto de 1994"
15,27,60,3566,533,565,1098,"21 de agosto de 1994"
15,27,60,3567,433,441,874,"21 de agosto de 1994"
15,27,60,3568,753,846,1599,"21 de agosto de 1994"
15,27,60,3569,368,386,754,"21 de agosto de 1994"
15,27,60,3570,535,538,1073,"21 de agosto de 1994"
15,27,60,3571,534,552,1086,"21 de agosto de 1994"
15,27,60,3572,430,463,893,"21 de agosto de 1994"
15,27,60,3573,466,518,984,"21 de agosto de 1994"
15,27,60,3574,613,672,1285,"21 de agosto de 1994"
15,27,60,3575,623,703,1326,"21 de agosto de 1994"
15,27,60,3576,575,625,1200,"21 de agosto de 1994"
15,27,60,3577,610,622,1232,"21 de agosto de 1994"
15,27,60,3578,373,417,790,"21 de agosto de 1994"
15,28,60,3579,756,845,1601,"21 de agosto de 1994"
15,28,60,3580,406,431,837,"21 de agosto de 1994"
15,28,60,3581,422,493,915,"21 de agosto de 1994"
15,28,60,3582,329,364,693,"21 de agosto de 1994"
15,28,60,3583,442,499,941,"21 de agosto de 1994"
15,28,60,3584,727,879,1606,"21 de agosto de 1994"
15,28,60,3585,418,488,906,"21 de agosto de 1994"
15,28,60,3586,464,539,1003,"21 de agosto de 1994"
15,28,60,3587,690,817,1507,"21 de agosto de 1994"
15,28,60,3588,780,855,1635,"21 de agosto de 1994"
15,28,60,3589,582,633,1215,"21 de agosto de 1994"
15,28,60,3590,689,803,1492,"21 de agosto de 1994"
15,28,60,3591,701,799,1500,"21 de agosto de 1994"
15,28,60,3592,724,815,1539,"21 de agosto de 1994"
15,28,60,3593,473,500,973,"21 de agosto de 1994"
15,28,60,3594,482,548,1030,"21 de agosto de 1994"
15,28,60,3595,521,528,1049,"21 de agosto de 1994"
15,28,60,3596,469,518,987,"21 de agosto de 1994"
15,28,60,3597,752,842,1594,"21 de agosto de 1994"
15,28,60,3598,316,338,654,"21 de agosto de 1994"
15,28,60,3599,559,593,1152,"21 de agosto de 1994"
15,28,60,3600,457,483,940,"21 de agosto de 1994"
15,28,60,3601,400,436,836,"21 de agosto de 1994"
15,28,60,3602,777,790,1567,"21 de agosto de 1994"
15,28,60,3603,576,636,1212,"21 de agosto de 1994"
15,28,60,3604,413,463,876,"21 de agosto de 1994"
15,28,60,3605,418,475,893,"21 de agosto de 1994"
15,28,60,3606,750,884,1634,"21 de agosto de 1994"
15,28,60,3607,536,577,1113,"21 de agosto de 1994"
15,28,60,3608,371,406,777,"21 de agosto de 1994"
15,28,60,3609,356,418,774,"21 de agosto de 1994"
15,28,60,3610,693,734,1427,"21 de agosto de 1994"
15,28,60,3611,668,678,1346,"21 de agosto de 1994"
15,28,60,3612,600,642,1242,"21 de agosto de 1994"
15,28,60,3613,718,818,1536,"21 de agosto de 1994"
15,28,60,3614,739,892,1631,"21 de agosto de 1994"
15,28,60,3615,507,562,1069,"21 de agosto de 1994"
15,28,60,3616,437,516,953,"21 de agosto de 1994"
15,28,60,3617,477,530,1007,"21 de agosto de 1994"
15,28,60,3618,544,596,1140,"21 de agosto de 1994"
15,28,60,3619,637,685,1322,"21 de agosto de 1994"
15,28,60,3620,575,648,1223,"21 de agosto de 1994"
15,28,60,3621,604,678,1282,"21 de agosto de 1994"
15,28,60,3622,634,706,1340,"21 de agosto de 1994"
15,28,60,3623,646,754,1400,"21 de agosto de 1994"
15,28,60,3624,459,490,949,"21 de agosto de 1994"
15,28,60,3625,714,780,1494,"21 de agosto de 1994"
15,28,60,3626,466,478,944,"21 de agosto de 1994"
15,28,60,3627,531,615,1146,"21 de agosto de 1994"
15,28,60,3628,509,540,1049,"21 de agosto de 1994"
15,28,60,3629,412,500,912,"21 de agosto de 1994"
15,28,60,3630,481,471,952,"21 de agosto de 1994"
15,28,60,3631,406,415,821,"21 de agosto de 1994"
15,28,60,3632,774,821,1595,"21 de agosto de 1994"
15,28,60,3633,542,618,1160,"21 de agosto de 1994"
15,28,60,3634,554,616,1170,"21 de agosto de 1994"
15,28,60,3635,699,796,1495,"21 de agosto de 1994"
15,28,60,3636,436,460,896,"21 de agosto de 1994"
15,28,60,3637,396,456,852,"21 de agosto de 1994"
15,28,60,3638,417,445,862,"21 de agosto de 1994"
15,28,60,3639,418,433,851,"21 de agosto de 1994"
15,28,60,3640,622,675,1297,"21 de agosto de 1994"
15,28,60,3641,656,735,1391,"21 de agosto de 1994"
15,28,60,3642,627,739,1366,"21 de agosto de 1994"
15,28,60,3643,742,787,1529,"21 de agosto de 1994"
15,28,60,3644,695,812,1507,"21 de agosto de 1994"
15,28,60,3645,520,589,1109,"21 de agosto de 1994"
15,28,60,3646,608,668,1276,"21 de agosto de 1994"
15,28,60,3647,543,659,1202,"21 de agosto de 1994"
15,28,60,3648,425,523,948,"21 de agosto de 1994"
15,28,60,3649,273,296,569,"21 de agosto de 1994"
15,29,60,3650,517,560,1077,"21 de agosto de 1994"
15,29,60,3651,726,846,1572,"21 de agosto de 1994"
15,29,60,3652,635,657,1292,"21 de agosto de 1994"
15,29,60,3653,565,604,1169,"21 de agosto de 1994"
15,29,60,3654,373,387,760,"21 de agosto de 1994"
15,29,60,3655,434,479,913,"21 de agosto de 1994"
15,29,60,3656,405,451,856,"21 de agosto de 1994"
15,29,60,3657,403,458,861,"21 de agosto de 1994"
15,29,60,3658,455,535,990,"21 de agosto de 1994"
15,29,60,3659,491,568,1059,"21 de agosto de 1994"
15,29,60,3660,484,517,1001,"21 de agosto de 1994"
15,29,60,3661,505,556,1061,"21 de agosto de 1994"
15,29,60,3662,468,520,988,"21 de agosto de 1994"
15,29,60,3663,458,470,928,"21 de agosto de 1994"
15,29,60,3664,464,525,989,"21 de agosto de 1994"
15,29,60,3665,448,506,954,"21 de agosto de 1994"
15,29,60,3666,615,687,1302,"21 de agosto de 1994"
15,29,60,3667,476,541,1017,"21 de agosto de 1994"
15,29,60,3668,812,873,1685,"21 de agosto de 1994"
15,29,60,3669,726,844,1570,"21 de agosto de 1994"
15,29,60,3670,854,882,1736,"21 de agosto de 1994"
15,29,60,3671,686,692,1378,"21 de agosto de 1994"
15,29,60,3672,630,668,1298,"21 de agosto de 1994"
15,29,60,3673,557,631,1188,"21 de agosto de 1994"
15,29,60,3674,559,643,1202,"21 de agosto de 1994"
15,29,60,3675,420,457,877,"21 de agosto de 1994"
15,29,60,3676,348,399,747,"21 de agosto de 1994"
15,29,60,3677,694,770,1464,"21 de agosto de 1994"
15,29,60,3678,419,477,896,"21 de agosto de 1994"
15,29,60,3679,733,819,1552,"21 de agosto de 1994"
15,29,60,3680,716,779,1495,"21 de agosto de 1994"
15,29,60,3681,568,599,1167,"21 de agosto de 1994"
15,29,60,3682,669,723,1392,"21 de agosto de 1994"
15,29,60,3683,546,612,1158,"21 de agosto de 1994"
15,29,60,3684,634,711,1345,"21 de agosto de 1994"
15,29,60,3685,429,476,905,"21 de agosto de 1994"
15,29,60,3686,473,535,1008,"21 de agosto de 1994"
15,29,60,3687,596,664,1260,"21 de agosto de 1994"
15,29,60,3688,709,772,1481,"21 de agosto de 1994"
15,29,60,3689,551,624,1175,"21 de agosto de 1994"
15,29,60,3690,379,413,792,"21 de agosto de 1994"
15,29,60,3691,389,452,841,"21 de agosto de 1994"
15,29,60,3692,459,519,978,"21 de agosto de 1994"
15,29,60,3693,477,560,1037,"21 de agosto de 1994"
15,29,60,3694,476,546,1022,"21 de agosto de 1994"
15,29,60,3695,432,469,901,"21 de agosto de 1994"
15,29,60,3696,508,581,1089,"21 de agosto de 1994"
15,29,60,3697,506,551,1057,"21 de agosto de 1994"
15,29,60,3698,749,846,1595,"21 de agosto de 1994"
15,29,60,3699,789,834,1623,"21 de agosto de 1994"
15,29,60,3700,451,508,959,"21 de agosto de 1994"
15,29,60,3701,387,424,811,"21 de agosto de 1994"
15,29,60,3702,474,508,982,"21 de agosto de 1994"
15,29,60,3703,568,634,1202,"21 de agosto de 1994"
15,29,60,3704,566,645,1211,"21 de agosto de 1994"
15,29,60,3705,689,715,1404,"21 de agosto de 1994"
15,29,60,3706,483,470,953,"21 de agosto de 1994"
15,29,60,3707,468,470,938,"21 de agosto de 1994"
15,29,60,3708,671,762,1433,"21 de agosto de 1994"
15,29,60,3709,470,543,1013,"21 de agosto de 1994"
15,29,60,3710,811,844,1655,"21 de agosto de 1994"
15,29,60,3711,589,634,1223,"21 de agosto de 1994"
15,29,60,3712,598,649,1247,"21 de agosto de 1994"
15,29,60,3713,652,720,1372,"21 de agosto de 1994"
15,29,60,3714,704,757,1461,"21 de agosto de 1994"
15,29,60,3715,659,741,1400,"21 de agosto de 1994"
15,29,60,3716,535,566,1101,"21 de agosto de 1994"
15,29,60,3717,756,791,1547,"21 de agosto de 1994"
15,29,60,3718,436,477,913,"21 de agosto de 1994"
15,29,60,3719,466,516,982,"21 de agosto de 1994"
15,29,60,3720,654,736,1390,"21 de agosto de 1994"
15,29,60,3721,437,474,911,"21 de agosto de 1994"
15,29,60,3722,420,501,921,"21 de agosto de 1994"
15,30,34,1394,508,603,1111,"21 de agosto de 1994"
15,30,34,1395,443,459,902,"21 de agosto de 1994"
15,30,34,1396,834,864,1698,"21 de agosto de 1994"
15,30,34,1397,717,821,1538,"21 de agosto de 1994"
15,30,34,1398,889,935,1824,"21 de agosto de 1994"
15,30,34,1399,529,552,1081,"21 de agosto de 1994"
15,30,34,1400,453,509,962,"21 de agosto de 1994"
15,30,34,1401,741,817,1558,"21 de agosto de 1994"
15,30,34,1402,767,830,1597,"21 de agosto de 1994"
15,30,34,1403,387,481,868,"21 de agosto de 1994"
15,30,34,1404,365,452,817,"21 de agosto de 1994"
15,30,34,1405,698,817,1515,"21 de agosto de 1994"
15,30,34,1406,520,581,1101,"21 de agosto de 1994"
15,30,34,1407,841,872,1713,"21 de agosto de 1994"
15,30,34,1408,807,856,1663,"21 de agosto de 1994"
15,30,34,1409,512,600,1112,"21 de agosto de 1994"
15,30,34,1410,665,752,1417,"21 de agosto de 1994"
15,30,34,1411,857,862,1719,"21 de agosto de 1994"
15,30,34,1412,768,800,1568,"21 de agosto de 1994"
15,30,34,1413,748,822,1570,"21 de agosto de 1994"
15,30,34,1414,407,436,843,"21 de agosto de 1994"
15,30,34,1415,357,357,714,"21 de agosto de 1994"
15,30,34,1416,708,753,1461,"21 de agosto de 1994"
15,30,34,1417,707,755,1462,"21 de agosto de 1994"
15,30,34,1418,550,605,1155,"21 de agosto de 1994"
15,30,34,1419,603,641,1244,"21 de agosto de 1994"
15,30,34,1420,412,440,852,"21 de agosto de 1994"
15,30,34,1421,560,647,1207,"21 de agosto de 1994"
15,30,34,1422,821,818,1639,"21 de agosto de 1994"
15,30,34,1423,486,561,1047,"21 de agosto de 1994"
15,30,34,1424,569,588,1157,"21 de agosto de 1994"
15,30,34,1425,522,518,1040,"21 de agosto de 1994"
15,30,34,1426,539,649,1188,"21 de agosto de 1994"
15,30,34,1427,488,522,1010,"21 de agosto de 1994"
15,30,34,1428,306,336,642,"21 de agosto de 1994"
15,30,34,1429,564,618,1182,"21 de agosto de 1994"
15,30,34,1430,320,368,688,"21 de agosto de 1994"
15,30,34,1431,601,694,1295,"21 de agosto de 1994"
15,30,34,1432,682,721,1403,"21 de agosto de 1994"
15,30,34,1433,685,744,1429,"21 de agosto de 1994"
15,30,34,1434,557,570,1127,"21 de agosto de 1994"
15,30,34,1435,538,545,1083,"21 de agosto de 1994"
15,30,34,1436,444,507,951,"21 de agosto de 1994"
15,30,34,1437,487,512,999,"21 de agosto de 1994"
15,30,34,1438,445,446,891,"21 de agosto de 1994"
15,30,34,1439,671,794,1465,"21 de agosto de 1994"
15,30,34,1440,653,679,1332,"21 de agosto de 1994"
15,30,34,1441,631,693,1324,"21 de agosto de 1994"
15,30,34,1442,529,521,1050,"21 de agosto de 1994"
15,30,34,1443,564,655,1219,"21 de agosto de 1994"
15,30,34,1444,564,667,1231,"21 de agosto de 1994"
15,30,34,1445,801,851,1652,"21 de agosto de 1994"
15,30,34,1446,545,576,1121,"21 de agosto de 1994"
15,30,34,1447,761,798,1559,"21 de agosto de 1994"
15,30,34,1448,613,727,1340,"21 de agosto de 1994"
15,30,34,1449,566,584,1150,"21 de agosto de 1994"
15,30,34,1450,811,876,1687,"21 de agosto de 1994"
15,30,34,1451,435,474,909,"21 de agosto de 1994"
15,30,34,1452,451,514,965,"21 de agosto de 1994"
15,30,34,1453,491,509,1000,"21 de agosto de 1994"
15,30,34,1454,728,817,1545,"21 de agosto de 1994"
15,30,34,1455,672,739,1411,"21 de agosto de 1994"
15,30,34,1456,669,705,1374,"21 de agosto de 1994"
15,30,34,1457,370,389,759,"21 de agosto de 1994"
15,30,34,1458,424,544,968,"21 de agosto de 1994"
15,30,34,1459,262,323,585,"21 de agosto de 1994"
15,30,34,1460,257,303,560,"21 de agosto de 1994"
15,30,34,1461,541,634,1175,"21 de agosto de 1994"
15,30,34,1462,655,731,1386,"21 de agosto de 1994"
15,30,34,1463,534,617,1151,"21 de agosto de 1994"
15,30,34,1464,420,466,886,"21 de agosto de 1994"
15,30,34,1465,679,721,1400,"21 de agosto de 1994"
15,30,34,1466,646,707,1353,"21 de agosto de 1994"
15,30,34,1467,549,599,1148,"21 de agosto de 1994"
15,30,34,1468,805,919,1724,"21 de agosto de 1994"
15,30,34,1469,535,577,1112,"21 de agosto de 1994"
15,30,34,1470,786,876,1662,"21 de agosto de 1994"
15,30,34,1471,591,607,1198,"21 de agosto de 1994"
15,30,34,1472,658,702,1360,"21 de agosto de 1994"
15,30,34,1473,651,730,1381,"21 de agosto de 1994"
15,30,34,1474,721,777,1498,"21 de agosto de 1994"
15,30,34,1475,762,832,1594,"21 de agosto de 1994"
15,30,34,1476,602,643,1245,"21 de agosto de 1994"
15,30,34,1477,708,690,1398,"21 de agosto de 1994"
15,30,34,1478,684,737,1421,"21 de agosto de 1994"
15,30,34,1479,547,608,1155,"21 de agosto de 1994"
15,30,34,1480,519,602,1121,"21 de agosto de 1994"
15,30,34,1481,585,689,1274,"21 de agosto de 1994"
15,30,34,1482,474,543,1017,"21 de agosto de 1994"
15,30,34,1483,278,369,647,"21 de agosto de 1994"
15,30,34,1484,448,474,922,"21 de agosto de 1994"
15,30,34,1485,339,381,720,"21 de agosto de 1994"
15,30,34,1486,525,609,1134,"21 de agosto de 1994"
15,30,34,1487,542,595,1137,"21 de agosto de 1994"
15,30,34,1488,534,627,1161,"21 de agosto de 1994"
15,30,34,1489,422,468,890,"21 de agosto de 1994"
15,30,34,1490,466,517,983,"21 de agosto de 1994"
15,30,34,1491,584,618,1202,"21 de agosto de 1994"
15,30,34,1492,695,755,1450,"21 de agosto de 1994"
15,30,34,1493,392,440,832,"21 de agosto de 1994"
15,30,34,1494,486,620,1106,"21 de agosto de 1994"
15,30,34,1495,555,610,1165,"21 de agosto de 1994"
15,30,34,1496,665,765,1430,"21 de agosto de 1994"
15,30,34,1497,499,583,1082,"21 de agosto de 1994"
15,30,34,1498,773,829,1602,"21 de agosto de 1994"
15,30,34,1499,274,314,588,"21 de agosto de 1994"
15,30,34,1500,490,576,1066,"21 de agosto de 1994"
15,31,34,1501,593,610,1203,"21 de agosto de 1994"
15,31,34,1502,657,713,1370,"21 de agosto de 1994"
15,31,34,1503,639,670,1309,"21 de agosto de 1994"
15,31,34,1504,467,510,977,"21 de agosto de 1994"
15,31,34,1505,411,471,882,"21 de agosto de 1994"
15,31,34,1506,525,567,1092,"21 de agosto de 1994"
15,31,34,1507,717,761,1478,"21 de agosto de 1994"
15,31,34,1508,564,607,1171,"21 de agosto de 1994"
15,31,34,1509,445,455,900,"21 de agosto de 1994"
15,31,34,1510,499,668,1167,"21 de agosto de 1994"
15,31,34,1511,487,507,994,"21 de agosto de 1994"
15,31,34,1512,637,675,1312,"21 de agosto de 1994"
15,31,34,1513,476,493,969,"21 de agosto de 1994"
15,31,34,1514,406,422,828,"21 de agosto de 1994"
15,31,34,1515,999,1044,2043,"21 de agosto de 1994"
15,31,34,1516,456,490,946,"21 de agosto de 1994"
15,31,34,1517,835,914,1749,"21 de agosto de 1994"
15,31,34,1518,669,777,1446,"21 de agosto de 1994"
15,31,34,1519,428,455,883,"21 de agosto de 1994"
15,31,34,1520,530,578,1108,"21 de agosto de 1994"
15,31,34,1521,329,379,708,"21 de agosto de 1994"
15,31,34,1522,743,802,1545,"21 de agosto de 1994"
15,31,34,1523,777,857,1634,"21 de agosto de 1994"
15,31,34,1524,267,257,524,"21 de agosto de 1994"
15,31,34,1525,470,512,982,"21 de agosto de 1994"
15,31,34,1526,763,799,1562,"21 de agosto de 1994"
15,31,34,1527,554,605,1159,"21 de agosto de 1994"
15,31,34,1528,792,818,1610,"21 de agosto de 1994"
15,31,34,1529,435,492,927,"21 de agosto de 1994"
15,31,34,1530,398,478,876,"21 de agosto de 1994"
15,31,34,1531,592,663,1255,"21 de agosto de 1994"
15,31,34,1532,591,683,1274,"21 de agosto de 1994"
15,31,34,1533,500,596,1096,"21 de agosto de 1994"
15,31,34,1534,609,685,1294,"21 de agosto de 1994"
15,31,34,1535,472,494,966,"21 de agosto de 1994"
15,31,34,1536,657,700,1357,"21 de agosto de 1994"
15,31,34,1537,697,721,1418,"21 de agosto de 1994"
15,31,34,1538,485,545,1030,"21 de agosto de 1994"
15,31,34,1539,391,445,836,"21 de agosto de 1994"
15,31,34,1540,499,540,1039,"21 de agosto de 1994"
15,31,34,1541,571,660,1231,"21 de agosto de 1994"
15,31,34,1542,279,322,601,"21 de agosto de 1994"
15,31,34,1543,465,579,1044,"21 de agosto de 1994"
15,31,34,1544,122,125,247,"21 de agosto de 1994"
15,31,34,1545,491,550,1041,"21 de agosto de 1994"
15,31,34,1546,378,468,846,"21 de agosto de 1994"
15,31,34,1547,555,631,1186,"21 de agosto de 1994"
15,31,34,1548,427,491,918,"21 de agosto de 1994"
15,31,34,1549,265,311,576,"21 de agosto de 1994"
15,31,34,1550,222,264,486,"21 de agosto de 1994"
15,31,34,1551,486,564,1050,"21 de agosto de 1994"
15,31,34,1552,375,439,814,"21 de agosto de 1994"
15,31,34,1553,281,325,606,"21 de agosto de 1994"
15,31,34,1554,505,596,1101,"21 de agosto de 1994"
15,31,34,1555,604,684,1288,"21 de agosto de 1994"
15,31,34,1556,735,765,1500,"21 de agosto de 1994"
15,31,34,1557,728,757,1485,"21 de agosto de 1994"
15,31,34,1558,826,894,1720,"21 de agosto de 1994"
15,31,34,1559,650,670,1320,"21 de agosto de 1994"
15,31,34,1560,470,507,977,"21 de agosto de 1994"
15,31,34,1561,806,926,1732,"21 de agosto de 1994"
15,31,34,1562,234,264,498,"21 de agosto de 1994"
15,31,34,1563,460,493,953,"21 de agosto de 1994"
15,31,34,1564,496,576,1072,"21 de agosto de 1994"
15,31,34,1565,645,700,1345,"21 de agosto de 1994"
15,31,34,1566,562,654,1216,"21 de agosto de 1994"
15,31,34,1567,724,839,1563,"21 de agosto de 1994"
15,31,34,1568,462,552,1014,"21 de agosto de 1994"
15,31,34,1569,391,475,866,"21 de agosto de 1994"
15,31,34,1570,747,796,1543,"21 de agosto de 1994"
15,31,34,1571,718,747,1465,"21 de agosto de 1994"
15,31,34,1572,586,640,1226,"21 de agosto de 1994"
15,31,34,1573,598,688,1286,"21 de agosto de 1994"
15,31,34,1574,720,819,1539,"21 de agosto de 1994"
15,31,34,1575,678,762,1440,"21 de agosto de 1994"
15,31,34,1576,522,587,1109,"21 de agosto de 1994"
15,31,34,1577,389,431,820,"21 de agosto de 1994"
15,31,34,1578,629,740,1369,"21 de agosto de 1994"
15,31,34,1579,662,759,1421,"21 de agosto de 1994"
15,31,34,1580,606,702,1308,"21 de agosto de 1994"
15,31,34,1581,427,507,934,"21 de agosto de 1994"
15,31,34,1582,487,550,1037,"21 de agosto de 1994"
15,31,34,1583,467,535,1002,"21 de agosto de 1994"
15,31,34,1584,666,725,1391,"21 de agosto de 1994"
15,31,34,1585,682,735,1417,"21 de agosto de 1994"
15,31,34,1586,230,256,486,"21 de agosto de 1994"
15,31,34,1587,368,441,809,"21 de agosto de 1994"
15,31,34,1588,739,806,1545,"21 de agosto de 1994"
15,31,34,1589,234,261,495,"21 de agosto de 1994"
15,31,34,1590,163,185,348,"21 de agosto de 1994"
15,31,34,1591,688,745,1433,"21 de agosto de 1994"
15,31,34,1592,651,734,1385,"21 de agosto de 1994"
15,31,34,1593,351,376,727,"21 de agosto de 1994"
15,31,34,1594,407,493,900,"21 de agosto de 1994"
15,31,34,1595,481,517,998,"21 de agosto de 1994"
15,31,34,1596,452,467,919,"21 de agosto de 1994"
15,31,34,1597,623,684,1307,"21 de agosto de 1994"
15,31,34,1598,541,558,1099,"21 de agosto de 1994"
15,31,34,1599,381,455,836,"21 de agosto de 1994"
15,31,34,1600,298,345,643,"21 de agosto de 1994"
15,31,34,1601,245,262,507,"21 de agosto de 1994"
15,31,34,1602,494,509,1003,"21 de agosto de 1994"
15,31,34,1603,454,494,948,"21 de agosto de 1994"
15,31,34,1604,641,663,1304,"21 de agosto de 1994"
15,31,34,1605,676,746,1422,"21 de agosto de 1994"
15,31,34,1606,700,725,1425,"21 de agosto de 1994"
15,31,34,1607,764,802,1566,"21 de agosto de 1994"
15,31,34,1608,263,320,583,"21 de agosto de 1994"
15,31,34,1609,562,618,1180,"21 de agosto de 1994"
15,31,34,1610,396,430,826,"21 de agosto de 1994"
15,31,34,1611,326,383,709,"21 de agosto de 1994"
15,31,34,1612,667,689,1356,"21 de agosto de 1994"
15,31,34,1613,761,786,1547,"21 de agosto de 1994"
15,31,34,1614,488,536,1024,"21 de agosto de 1994"
15,31,34,1615,474,479,953,"21 de agosto de 1994"
15,31,34,1616,467,523,990,"21 de agosto de 1994"
15,31,34,1617,392,458,850,"21 de agosto de 1994"
15,31,34,1618,594,649,1243,"21 de agosto de 1994"
15,31,34,1619,155,214,369,"21 de agosto de 1994"
15,31,34,1620,219,269,488,"21 de agosto de 1994"
15,31,34,1621,287,366,653,"21 de agosto de 1994"
15,31,34,1622,265,315,580,"21 de agosto de 1994"
15,31,34,1623,207,250,457,"21 de agosto de 1994"
15,31,34,1624,318,410,728,"21 de agosto de 1994"
15,31,34,1625,501,576,1077,"21 de agosto de 1994"
15,31,34,1626,513,571,1084,"21 de agosto de 1994"
15,31,34,1627,605,663,1268,"21 de agosto de 1994"
15,31,34,1628,270,301,571,"21 de agosto de 1994"
15,31,34,1629,595,666,1261,"21 de agosto de 1994"
15,31,34,1630,289,336,625,"21 de agosto de 1994"
15,31,34,1631,457,522,979,"21 de agosto de 1994"
15,31,34,1632,439,486,925,"21 de agosto de 1994"
15,31,34,1633,538,583,1121,"21 de agosto de 1994"
15,31,34,1634,323,392,715,"21 de agosto de 1994"
15,31,34,1635,258,333,591,"21 de agosto de 1994"
15,31,34,1636,227,299,526,"21 de agosto de 1994"
15,31,34,1637,307,391,698,"21 de agosto de 1994"
15,31,34,1638,307,368,675,"21 de agosto de 1994"
15,31,34,1639,247,297,544,"21 de agosto de 1994"
15,31,34,1640,247,325,572,"21 de agosto de 1994"
15,31,34,1641,157,200,357,"21 de agosto de 1994"
15,31,34,1642,336,372,708,"21 de agosto de 1994"
15,31,34,1643,476,503,979,"21 de agosto de 1994"
15,31,34,1644,648,710,1358,"21 de agosto de 1994"
15,31,34,1645,652,702,1354,"21 de agosto de 1994"
15,31,34,1646,590,569,1159,"21 de agosto de 1994"
15,31,34,1647,791,853,1644,"21 de agosto de 1994"
15,31,34,1648,609,675,1284,"21 de agosto de 1994"
15,31,34,1649,786,838,1624,"21 de agosto de 1994"
15,31,34,1650,782,844,1626,"21 de agosto de 1994"
15,31,34,1651,478,512,990,"21 de agosto de 1994"
15,31,34,1652,466,467,933,"21 de agosto de 1994"
15,31,34,1653,442,462,904,"21 de agosto de 1994"
15,31,34,1654,488,529,1017,"21 de agosto de 1994"
15,31,34,1655,755,826,1581,"21 de agosto de 1994"
15,31,34,1656,467,490,957,"21 de agosto de 1994"
15,31,34,1657,410,444,854,"21 de agosto de 1994"
15,31,34,1658,811,903,1714,"21 de agosto de 1994"
15,31,34,1659,799,854,1653,"21 de agosto de 1994"
15,31,34,1660,406,498,904,"21 de agosto de 1994"
15,31,34,1661,464,569,1033,"21 de agosto de 1994"
15,31,34,1662,467,518,985,"21 de agosto de 1994"
15,31,34,1663,420,507,927,"21 de agosto de 1994"
15,31,34,1664,257,310,567,"21 de agosto de 1994"
15,31,34,1665,290,330,620,"21 de agosto de 1994"
15,31,34,1666,499,557,1056,"21 de agosto de 1994"
15,31,34,1667,376,453,829,"21 de agosto de 1994"
15,31,34,1668,365,409,774,"21 de agosto de 1994"
15,31,34,1669,381,440,821,"21 de agosto de 1994"
15,31,34,1670,400,450,850,"21 de agosto de 1994"
15,31,34,1671,680,700,1380,"21 de agosto de 1994"
15,31,34,1672,391,438,829,"21 de agosto de 1994"
15,31,34,1673,531,596,1127,"21 de agosto de 1994"
15,31,34,1674,424,480,904,"21 de agosto de 1994"
15,31,34,1675,458,477,935,"21 de agosto de 1994"
15,31,34,1676,512,483,995,"21 de agosto de 1994"
15,31,34,1677,461,511,972,"21 de agosto de 1994"
15,31,34,1678,492,541,1033,"21 de agosto de 1994"
15,31,34,1679,526,558,1084,"21 de agosto de 1994"
15,31,34,1680,689,723,1412,"21 de agosto de 1994"
15,31,34,1681,573,617,1190,"21 de agosto de 1994"
15,31,34,1682,587,653,1240,"21 de agosto de 1994"
15,31,34,1683,727,787,1514,"21 de agosto de 1994"
15,31,34,1684,332,330,662,"21 de agosto de 1994"
15,31,34,1685,380,427,807,"21 de agosto de 1994"
15,31,34,1686,409,470,879,"21 de agosto de 1994"
15,31,34,1687,530,558,1088,"21 de agosto de 1994"
15,31,34,1688,601,621,1222,"21 de agosto de 1994"
15,31,34,1689,482,554,1036,"21 de agosto de 1994"
15,31,34,1690,464,480,944,"21 de agosto de 1994"
15,31,34,1691,841,912,1753,"21 de agosto de 1994"
15,31,34,1692,705,723,1428,"21 de agosto de 1994"
15,31,34,1693,594,658,1252,"21 de agosto de 1994"
15,31,34,1694,733,798,1531,"21 de agosto de 1994"
15,31,34,1695,547,586,1133,"21 de agosto de 1994"
15,31,34,1696,509,576,1085,"21 de agosto de 1994"
15,31,34,1697,629,646,1275,"21 de agosto de 1994"
15,31,34,1698,591,668,1259,"21 de agosto de 1994"
15,31,34,1699,660,703,1363,"21 de agosto de 1994"
15,31,34,1700,664,717,1381,"21 de agosto de 1994"
15,31,34,1701,506,557,1063,"21 de agosto de 1994"
15,31,34,1702,554,597,1151,"21 de agosto de 1994"
15,31,34,1703,799,948,1747,"21 de agosto de 1994"
15,31,34,1704,576,641,1217,"21 de agosto de 1994"
15,31,34,1705,522,582,1104,"21 de agosto de 1994"
15,31,34,1706,688,713,1401,"21 de agosto de 1994"
15,31,34,1707,445,491,936,"21 de agosto de 1994"
15,31,34,1708,667,773,1440,"21 de agosto de 1994"
15,31,34,1709,562,570,1132,"21 de agosto de 1994"
15,31,34,1710,568,598,1166,"21 de agosto de 1994"
15,31,34,1711,622,674,1296,"21 de agosto de 1994"
15,31,34,1712,457,493,950,"21 de agosto de 1994"
15,31,34,1713,196,236,432,"21 de agosto de 1994"
15,31,34,1714,497,554,1051,"21 de agosto de 1994"
15,31,34,1715,488,525,1013,"21 de agosto de 1994"
15,31,34,1716,507,576,1083,"21 de agosto de 1994"
15,31,34,1717,602,734,1336,"21 de agosto de 1994"
15,31,34,1718,663,729,1392,"21 de agosto de 1994"
15,31,34,1719,364,423,787,"21 de agosto de 1994"
15,31,34,1720,732,838,1570,"21 de agosto de 1994"
15,31,34,1721,567,692,1259,"21 de agosto de 1994"
15,31,34,1722,633,678,1311,"21 de agosto de 1994"
15,31,34,1723,476,561,1037,"21 de agosto de 1994"
15,31,34,1724,563,637,1200,"21 de agosto de 1994"
15,31,34,1725,296,411,707,"21 de agosto de 1994"
15,31,34,1726,228,273,501,"21 de agosto de 1994"
15,31,34,1727,306,379,685,"21 de agosto de 1994"
15,31,34,1728,562,663,1225,"21 de agosto de 1994"
15,31,34,1729,474,489,963,"21 de agosto de 1994"
15,31,34,1730,399,479,878,"21 de agosto de 1994"
15,31,34,1731,228,268,496,"21 de agosto de 1994"
15,31,34,1732,645,740,1385,"21 de agosto de 1994"
15,31,34,1733,679,746,1425,"21 de agosto de 1994"
15,31,34,1734,642,691,1333,"21 de agosto de 1994"
15,32,34,1735,434,489,923,"21 de agosto de 1994"
15,32,34,1736,390,442,832,"21 de agosto de 1994"
15,32,34,1737,401,483,884,"21 de agosto de 1994"
15,32,34,1738,467,508,975,"21 de agosto de 1994"
15,32,34,1739,443,516,959,"21 de agosto de 1994"
15,32,34,1740,384,413,797,"21 de agosto de 1994"
15,32,34,1741,412,454,866,"21 de agosto de 1994"
15,32,34,1742,373,427,800,"21 de agosto de 1994"
15,32,34,1743,339,380,719,"21 de agosto de 1994"
15,32,34,1744,343,385,728,"21 de agosto de 1994"
15,32,34,1745,268,298,566,"21 de agosto de 1994"
15,32,34,1746,507,566,1073,"21 de agosto de 1994"
15,32,34,1747,461,513,974,"21 de agosto de 1994"
15,32,34,1748,485,531,1016,"21 de agosto de 1994"
15,32,34,1749,474,488,962,"21 de agosto de 1994"
15,32,34,1750,480,521,1001,"21 de agosto de 1994"
15,32,34,1751,448,466,914,"21 de agosto de 1994"
15,32,34,1752,456,478,934,"21 de agosto de 1994"
15,32,34,1753,448,464,912,"21 de agosto de 1994"
15,32,34,1754,486,558,1044,"21 de agosto de 1994"
15,32,34,1755,365,400,765,"21 de agosto de 1994"
15,32,34,1756,393,440,833,"21 de agosto de 1994"
15,32,34,1757,500,612,1112,"21 de agosto de 1994"
15,32,34,1758,269,309,578,"21 de agosto de 1994"
15,32,34,1759,684,784,1468,"21 de agosto de 1994"
15,32,34,1760,615,661,1276,"21 de agosto de 1994"
15,32,34,1761,704,790,1494,"21 de agosto de 1994"
15,32,34,1762,719,754,1473,"21 de agosto de 1994"
15,32,34,1763,664,711,1375,"21 de agosto de 1994"
15,32,34,1764,578,645,1223,"21 de agosto de 1994"
15,32,34,1765,225,228,453,"21 de agosto de 1994"
15,32,34,1766,583,604,1187,"21 de agosto de 1994"
15,32,34,1767,672,787,1459,"21 de agosto de 1994"
15,32,34,1768,397,441,838,"21 de agosto de 1994"
15,32,34,1769,509,526,1035,"21 de agosto de 1994"
15,32,34,1770,762,857,1619,"21 de agosto de 1994"
15,32,34,1771,344,411,755,"21 de agosto de 1994"
15,32,34,1772,297,323,620,"21 de agosto de 1994"
15,32,34,1773,680,688,1368,"21 de agosto de 1994"
15,32,34,1774,426,486,912,"21 de agosto de 1994"
15,32,34,1775,428,479,907,"21 de agosto de 1994"
15,32,34,1776,613,619,1232,"21 de agosto de 1994"
15,32,34,1777,311,384,695,"21 de agosto de 1994"
15,32,34,1778,203,212,415,"21 de agosto de 1994"
15,32,34,1779,517,551,1068,"21 de agosto de 1994"
15,32,34,1780,500,562,1062,"21 de agosto de 1994"
15,32,34,1781,1699,1924,3623,"21 de agosto de 1994"
15,32,34,1782,53,54,107,"21 de agosto de 1994"
15,32,34,1783,642,744,1386,"21 de agosto de 1994"
15,32,34,1784,342,349,691,"21 de agosto de 1994"
15,32,34,1785,697,729,1426,"21 de agosto de 1994"
15,32,34,1786,771,863,1634,"21 de agosto de 1994"
15,32,34,1787,593,668,1261,"21 de agosto de 1994"
15,32,34,1788,692,748,1440,"21 de agosto de 1994"
15,32,34,1789,659,736,1395,"21 de agosto de 1994"
15,32,34,1790,698,776,1474,"21 de agosto de 1994"
15,32,34,1791,760,851,1611,"21 de agosto de 1994"
15,32,34,1792,785,836,1621,"21 de agosto de 1994"
15,32,34,1793,317,357,674,"21 de agosto de 1994"
15,32,34,1794,784,895,1679,"21 de agosto de 1994"
15,32,34,1795,463,546,1009,"21 de agosto de 1994"
15,32,34,1796,663,778,1441,"21 de agosto de 1994"
15,32,34,1797,500,555,1055,"21 de agosto de 1994"
15,32,34,1798,534,607,1141,"21 de agosto de 1994"
15,32,34,1799,356,434,790,"21 de agosto de 1994"
15,32,34,1800,678,828,1506,"21 de agosto de 1994"
15,32,34,1801,306,391,697,"21 de agosto de 1994"
15,32,34,1802,566,642,1208,"21 de agosto de 1994"
15,32,34,1803,731,841,1572,"21 de agosto de 1994"
15,32,34,1804,747,830,1577,"21 de agosto de 1994"
15,32,34,1805,770,908,1678,"21 de agosto de 1994"
15,32,34,1806,535,607,1142,"21 de agosto de 1994"
15,32,34,1807,121,161,282,"21 de agosto de 1994"
15,32,34,1808,247,261,508,"21 de agosto de 1994"
15,32,34,1809,142,189,331,"21 de agosto de 1994"
15,32,34,1810,610,737,1347,"21 de agosto de 1994"
15,32,34,1811,550,630,1180,"21 de agosto de 1994"
15,32,34,1812,675,794,1469,"21 de agosto de 1994"
15,32,34,1813,298,301,599,"21 de agosto de 1994"
15,32,34,1814,405,485,890,"21 de agosto de 1994"
15,32,34,1815,429,471,900,"21 de agosto de 1994"
15,32,34,1816,483,519,1002,"21 de agosto de 1994"
15,32,34,1817,434,450,884,"21 de agosto de 1994"
15,32,34,1818,508,558,1066,"21 de agosto de 1994"
15,32,34,1819,513,567,1080,"21 de agosto de 1994"
15,32,34,1820,479,490,969,"21 de agosto de 1994"
15,32,34,1821,536,594,1130,"21 de agosto de 1994"
15,32,34,1822,431,434,865,"21 de agosto de 1994"
15,32,34,1823,527,683,1210,"21 de agosto de 1994"
15,32,34,1824,557,639,1196,"21 de agosto de 1994"
15,32,34,1825,726,801,1527,"21 de agosto de 1994"
15,32,34,1826,699,771,1470,"21 de agosto de 1994"
15,32,34,1827,567,582,1149,"21 de agosto de 1994"
15,32,34,1828,648,776,1424,"21 de agosto de 1994"
15,32,34,1829,739,814,1553,"21 de agosto de 1994"
15,32,34,1830,775,840,1615,"21 de agosto de 1994"
15,32,34,1831,532,571,1103,"21 de agosto de 1994"
15,32,34,1832,730,838,1568,"21 de agosto de 1994"
15,32,34,1833,705,799,1504,"21 de agosto de 1994"
15,32,34,1834,487,554,1041,"21 de agosto de 1994"
15,32,34,1835,469,512,981,"21 de agosto de 1994"
15,32,34,1836,448,530,978,"21 de agosto de 1994"
15,32,34,1837,495,566,1061,"21 de agosto de 1994"
15,32,34,1838,611,750,1361,"21 de agosto de 1994"
15,32,34,1839,281,322,603,"21 de agosto de 1994"
15,32,34,1840,517,645,1162,"21 de agosto de 1994"
15,32,34,1841,434,539,973,"21 de agosto de 1994"
15,32,34,1842,724,809,1533,"21 de agosto de 1994"
15,32,34,1843,457,531,988,"21 de agosto de 1994"
15,32,34,1844,544,620,1164,"21 de agosto de 1994"
15,32,34,1845,377,443,820,"21 de agosto de 1994"
15,32,34,1846,448,521,969,"21 de agosto de 1994"
15,32,34,1847,570,643,1213,"21 de agosto de 1994"
15,32,34,1848,716,766,1482,"21 de agosto de 1994"
15,32,34,1849,706,769,1475,"21 de agosto de 1994"
15,32,34,1850,771,836,1607,"21 de agosto de 1994"
15,32,34,1851,499,552,1051,"21 de agosto de 1994"
15,32,34,1852,513,614,1127,"21 de agosto de 1994"
15,32,34,1853,427,511,938,"21 de agosto de 1994"
15,32,34,1854,557,633,1190,"21 de agosto de 1994"
15,32,34,1855,518,533,1051,"21 de agosto de 1994"
15,32,34,1856,466,544,1010,"21 de agosto de 1994"
15,32,34,1857,318,382,700,"21 de agosto de 1994"
15,32,34,1858,645,741,1386,"21 de agosto de 1994"
15,32,34,1859,641,765,1406,"21 de agosto de 1994"
15,32,34,1860,524,584,1108,"21 de agosto de 1994"
15,32,34,1861,707,797,1504,"21 de agosto de 1994"
15,32,34,1862,675,728,1403,"21 de agosto de 1994"
15,32,34,1863,248,306,554,"21 de agosto de 1994"
15,32,34,1864,889,973,1862,"21 de agosto de 1994"
15,32,34,1865,639,671,1310,"21 de agosto de 1994"
15,32,34,1866,545,639,1184,"21 de agosto de 1994"
15,32,34,1867,511,565,1076,"21 de agosto de 1994"
15,32,34,1868,336,399,735,"21 de agosto de 1994"
15,32,34,1869,487,572,1059,"21 de agosto de 1994"
15,32,34,1870,756,856,1612,"21 de agosto de 1994"
15,32,34,1871,679,779,1458,"21 de agosto de 1994"
15,32,34,1872,515,564,1079,"21 de agosto de 1994"
15,32,34,1873,607,659,1266,"21 de agosto de 1994"
15,32,34,1874,464,539,1003,"21 de agosto de 1994"
15,32,34,1875,514,588,1102,"21 de agosto de 1994"
15,32,34,1876,674,784,1458,"21 de agosto de 1994"
15,32,34,1877,686,805,1491,"21 de agosto de 1994"
15,32,34,1878,561,671,1232,"21 de agosto de 1994"
15,32,34,1879,595,641,1236,"21 de agosto de 1994"
15,32,34,1880,820,889,1709,"21 de agosto de 1994"
15,32,34,1881,597,586,1183,"21 de agosto de 1994"
15,32,34,1882,615,750,1365,"21 de agosto de 1994"
15,32,34,1883,663,720,1383,"21 de agosto de 1994"
15,32,34,1884,467,501,968,"21 de agosto de 1994"
15,32,34,1885,446,494,940,"21 de agosto de 1994"
15,32,34,1886,517,609,1126,"21 de agosto de 1994"
15,32,34,1887,551,652,1203,"21 de agosto de 1994"
15,32,34,1888,364,472,836,"21 de agosto de 1994"
15,32,34,1889,555,611,1166,"21 de agosto de 1994"
15,32,34,1890,457,542,999,"21 de agosto de 1994"
15,32,34,1891,372,423,795,"21 de agosto de 1994"
15,32,34,1892,537,600,1137,"21 de agosto de 1994"
15,32,34,1893,727,788,1515,"21 de agosto de 1994"
15,32,34,1894,823,959,1782,"21 de agosto de 1994"
15,32,34,1895,730,815,1545,"21 de agosto de 1994"
15,32,34,1896,424,462,886,"21 de agosto de 1994"
15,32,34,1897,470,503,973,"21 de agosto de 1994"
15,32,34,1898,440,569,1009,"21 de agosto de 1994"
15,32,34,1899,445,495,940,"21 de agosto de 1994"
15,32,34,1900,542,643,1185,"21 de agosto de 1994"
15,32,34,1901,447,479,926,"21 de agosto de 1994"
15,32,34,1902,458,511,969,"21 de agosto de 1994"
15,32,34,1903,543,617,1160,"21 de agosto de 1994"
15,32,34,1904,763,908,1671,"21 de agosto de 1994"
15,32,34,1905,747,858,1605,"21 de agosto de 1994"
15,32,34,1906,495,550,1045,"21 de agosto de 1994"
15,32,34,1907,480,496,976,"21 de agosto de 1994"
15,32,34,1908,568,676,1244,"21 de agosto de 1994"
15,32,34,1909,479,527,1006,"21 de agosto de 1994"
15,32,34,1910,517,545,1062,"21 de agosto de 1994"
15,32,34,1911,565,611,1176,"21 de agosto de 1994"
15,32,34,1912,570,625,1195,"21 de agosto de 1994"
15,32,34,1913,588,638,1226,"21 de agosto de 1994"
15,32,34,1914,357,432,789,"21 de agosto de 1994"
15,32,34,1915,322,377,699,"21 de agosto de 1994"
15,32,34,1916,474,522,996,"21 de agosto de 1994"
15,32,34,1917,721,906,1627,"21 de agosto de 1994"
15,32,34,1918,488,608,1096,"21 de agosto de 1994"
15,32,34,1919,380,457,837,"21 de agosto de 1994"
15,32,34,1920,682,836,1518,"21 de agosto de 1994"
15,32,34,1921,530,606,1136,"21 de agosto de 1994"
15,32,34,1922,758,899,1657,"21 de agosto de 1994"
15,32,34,1923,453,526,979,"21 de agosto de 1994"
15,32,34,1924,706,781,1487,"21 de agosto de 1994"
15,32,34,1925,595,715,1310,"21 de agosto de 1994"
15,32,34,1926,477,522,999,"21 de agosto de 1994"
15,32,34,1927,550,594,1144,"21 de agosto de 1994"
15,32,34,1928,679,776,1455,"21 de agosto de 1994"
15,32,34,1929,550,625,1175,"21 de agosto de 1994"
15,32,34,1930,634,710,1344,"21 de agosto de 1994"
15,32,34,1931,711,802,1513,"21 de agosto de 1994"
15,32,34,1932,564,595,1159,"21 de agosto de 1994"
15,32,34,1933,390,475,865,"21 de agosto de 1994"
15,32,34,1934,679,774,1453,"21 de agosto de 1994"
15,32,34,1935,687,849,1536,"21 de agosto de 1994"
15,32,34,1936,450,548,998,"21 de agosto de 1994"
15,32,34,1937,333,372,705,"21 de agosto de 1994"
15,32,34,1938,601,648,1249,"21 de agosto de 1994"
15,32,34,1939,603,684,1287,"21 de agosto de 1994"
15,32,34,1940,803,897,1700,"21 de agosto de 1994"
15,32,34,1941,675,746,1421,"21 de agosto de 1994"
15,32,34,1942,656,770,1426,"21 de agosto de 1994"
15,32,34,1943,394,457,851,"21 de agosto de 1994"
15,32,34,1944,521,603,1124,"21 de agosto de 1994"
15,32,34,1945,602,649,1251,"21 de agosto de 1994"
15,32,34,1946,653,736,1389,"21 de agosto de 1994"
15,32,34,1947,608,699,1307,"21 de agosto de 1994"
15,32,34,1948,656,751,1407,"21 de agosto de 1994"
15,32,34,1949,601,699,1300,"21 de agosto de 1994"
15,32,34,1950,305,361,666,"21 de agosto de 1994"
15,32,34,1951,449,513,962,"21 de agosto de 1994"
15,33,105,4963,466,514,980,"21 de agosto de 1994"
15,33,105,4964,694,836,1530,"21 de agosto de 1994"
15,33,105,4965,582,683,1265,"21 de agosto de 1994"
15,33,105,4966,466,570,1036,"21 de agosto de 1994"
15,33,105,4967,295,332,627,"21 de agosto de 1994"
15,33,105,4968,360,428,788,"21 de agosto de 1994"
15,33,105,4969,378,401,779,"21 de agosto de 1994"
15,33,105,4970,449,541,990,"21 de agosto de 1994"
15,33,105,4971,452,481,933,"21 de agosto de 1994"
15,33,105,4972,428,504,932,"21 de agosto de 1994"
15,33,105,4973,607,715,1322,"21 de agosto de 1994"
15,33,105,4974,593,705,1298,"21 de agosto de 1994"
15,33,105,4975,693,834,1527,"21 de agosto de 1994"
15,33,105,4976,497,570,1067,"21 de agosto de 1994"
15,33,105,4977,532,648,1180,"21 de agosto de 1994"
15,33,105,4978,806,929,1735,"21 de agosto de 1994"
15,33,105,4979,552,683,1235,"21 de agosto de 1994"
15,33,105,4980,621,735,1356,"21 de agosto de 1994"
15,33,105,4981,387,449,836,"21 de agosto de 1994"
15,33,105,4982,600,701,1301,"21 de agosto de 1994"
15,33,105,4983,564,614,1178,"21 de agosto de 1994"
15,33,105,4984,366,373,739,"21 de agosto de 1994"
15,33,105,4985,815,867,1682,"21 de agosto de 1994"
15,33,105,4986,703,784,1487,"21 de agosto de 1994"
15,33,105,4987,683,742,1425,"21 de agosto de 1994"
15,33,105,4988,748,835,1583,"21 de agosto de 1994"
15,33,105,4989,809,848,1657,"21 de agosto de 1994"
15,33,105,4990,769,837,1606,"21 de agosto de 1994"
15,33,105,4991,568,621,1189,"21 de agosto de 1994"
15,33,105,4992,445,490,935,"21 de agosto de 1994"
15,33,105,4993,390,450,840,"21 de agosto de 1994"
15,33,105,4994,266,343,609,"21 de agosto de 1994"
15,33,105,4995,371,346,717,"21 de agosto de 1994"
15,33,105,4996,522,654,1176,"21 de agosto de 1994"
15,33,105,4997,698,840,1538,"21 de agosto de 1994"
15,33,105,4998,651,776,1427,"21 de agosto de 1994"
15,33,105,4999,591,710,1301,"21 de agosto de 1994"
15,33,105,5000,625,800,1425,"21 de agosto de 1994"
15,33,105,5001,597,726,1323,"21 de agosto de 1994"
15,33,105,5002,604,613,1217,"21 de agosto de 1994"
15,33,105,5003,572,654,1226,"21 de agosto de 1994"
15,33,105,5004,525,591,1116,"21 de agosto de 1994"
15,33,105,5005,644,723,1367,"21 de agosto de 1994"
15,33,105,5006,476,560,1036,"21 de agosto de 1994"
15,33,105,5007,282,302,584,"21 de agosto de 1994"
15,33,105,5008,504,561,1065,"21 de agosto de 1994"
15,33,105,5009,528,597,1125,"21 de agosto de 1994"
15,33,105,5010,333,351,684,"21 de agosto de 1994"
15,33,105,5011,712,800,1512,"21 de agosto de 1994"
15,33,105,5012,686,843,1529,"21 de agosto de 1994"
15,33,105,5013,535,621,1156,"21 de agosto de 1994"
15,33,105,5014,544,667,1211,"21 de agosto de 1994"
15,33,105,5015,605,700,1305,"21 de agosto de 1994"
15,33,105,5016,390,453,843,"21 de agosto de 1994"
15,33,105,5017,345,394,739,"21 de agosto de 1994"
15,33,105,5018,347,388,735,"21 de agosto de 1994"
15,33,105,5019,462,474,936,"21 de agosto de 1994"
15,33,105,5020,433,496,929,"21 de agosto de 1994"
15,33,105,5021,384,444,828,"21 de agosto de 1994"
15,33,105,5022,709,765,1474,"21 de agosto de 1994"
15,33,105,5023,450,484,934,"21 de agosto de 1994"
15,33,105,5024,413,478,891,"21 de agosto de 1994"
15,33,105,5025,660,730,1390,"21 de agosto de 1994"
15,33,105,5026,409,461,870,"21 de agosto de 1994"
15,33,105,5027,400,420,820,"21 de agosto de 1994"
15,33,105,5028,713,773,1486,"21 de agosto de 1994"
15,33,105,5029,238,270,508,"21 de agosto de 1994"
15,33,105,5030,333,414,747,"21 de agosto de 1994"
15,33,105,5031,310,413,723,"21 de agosto de 1994"
15,33,105,5032,359,449,808,"21 de agosto de 1994"
15,33,105,5033,287,280,567,"21 de agosto de 1994"
15,33,105,5034,646,725,1371,"21 de agosto de 1994"
15,33,105,5035,682,795,1477,"21 de agosto de 1994"
15,33,105,5036,697,823,1520,"21 de agosto de 1994"
15,33,105,5037,429,460,889,"21 de agosto de 1994"
15,33,105,5038,711,741,1452,"21 de agosto de 1994"
15,33,105,5039,608,686,1294,"21 de agosto de 1994"
15,33,105,5040,510,497,1007,"21 de agosto de 1994"
15,33,105,5041,340,348,688,"21 de agosto de 1994"
15,33,105,5042,637,678,1315,"21 de agosto de 1994"
15,33,105,5043,463,562,1025,"21 de agosto de 1994"
15,33,105,5044,664,751,1415,"21 de agosto de 1994"
15,33,105,5045,583,650,1233,"21 de agosto de 1994"
15,33,105,5046,521,586,1107,"21 de agosto de 1994"
15,33,105,5047,438,479,917,"21 de agosto de 1994"
15,33,105,5048,618,620,1238,"21 de agosto de 1994"
15,33,105,5049,464,497,961,"21 de agosto de 1994"
15,33,105,5050,424,451,875,"21 de agosto de 1994"
15,33,105,5051,467,522,989,"21 de agosto de 1994"
15,33,105,5052,690,748,1438,"21 de agosto de 1994"
15,33,105,5053,627,708,1335,"21 de agosto de 1994"
15,33,105,5054,650,670,1320,"21 de agosto de 1994"
15,33,105,5055,735,826,1561,"21 de agosto de 1994"
15,33,105,5056,786,849,1635,"21 de agosto de 1994"
15,33,105,5057,611,678,1289,"21 de agosto de 1994"
15,33,105,5058,325,345,670,"21 de agosto de 1994"
15,33,105,5059,697,836,1533,"21 de agosto de 1994"
15,33,105,5060,515,605,1120,"21 de agosto de 1994"
15,33,105,5061,692,759,1451,"21 de agosto de 1994"
15,33,105,5062,517,524,1041,"21 de agosto de 1994"
15,33,105,5063,663,672,1335,"21 de agosto de 1994"
15,33,105,5064,699,773,1472,"21 de agosto de 1994"
15,33,105,5065,631,699,1330,"21 de agosto de 1994"
15,33,105,5066,765,816,1581,"21 de agosto de 1994"
15,33,105,5067,682,739,1421,"21 de agosto de 1994"
15,33,105,5068,738,795,1533,"21 de agosto de 1994"
15,33,105,5069,622,697,1319,"21 de agosto de 1994"
15,33,105,5070,642,679,1321,"21 de agosto de 1994"
15,33,105,5071,432,519,951,"21 de agosto de 1994"
15,33,105,5072,659,799,1458,"21 de agosto de 1994"
15,33,105,5073,571,769,1340,"21 de agosto de 1994"
15,33,105,5074,450,498,948,"21 de agosto de 1994"
15,33,105,5075,407,502,909,"21 de agosto de 1994"
15,33,105,5076,755,783,1538,"21 de agosto de 1994"
15,33,105,5077,649,746,1395,"21 de agosto de 1994"
15,33,105,5078,659,675,1334,"21 de agosto de 1994"
15,33,105,5079,823,854,1677,"21 de agosto de 1994"
15,33,105,5080,435,540,975,"21 de agosto de 1994"
15,33,105,5081,453,466,919,"21 de agosto de 1994"
15,33,105,5082,409,434,843,"21 de agosto de 1994"
15,33,105,5083,516,543,1059,"21 de agosto de 1994"
15,33,105,5084,470,464,934,"21 de agosto de 1994"
15,33,105,5085,470,504,974,"21 de agosto de 1994"
15,33,105,5086,405,415,820,"21 de agosto de 1994"
15,33,105,5087,426,534,960,"21 de agosto de 1994"
15,33,105,5088,609,692,1301,"21 de agosto de 1994"
15,33,105,5089,562,573,1135,"21 de agosto de 1994"
15,33,105,5090,690,753,1443,"21 de agosto de 1994"
15,33,105,5091,559,631,1190,"21 de agosto de 1994"
15,34,20,523,712,730,1442,"21 de agosto de 1994"
15,34,20,524,628,738,1366,"21 de agosto de 1994"
15,34,20,525,632,723,1355,"21 de agosto de 1994"
15,34,20,526,630,737,1367,"21 de agosto de 1994"
15,34,20,527,672,795,1467,"21 de agosto de 1994"
15,34,20,528,753,800,1553,"21 de agosto de 1994"
15,34,20,529,454,498,952,"21 de agosto de 1994"
15,34,20,530,438,477,915,"21 de agosto de 1994"
15,34,20,531,560,632,1192,"21 de agosto de 1994"
15,34,20,532,498,503,1001,"21 de agosto de 1994"
15,34,20,533,488,548,1036,"21 de agosto de 1994"
15,34,20,534,762,867,1629,"21 de agosto de 1994"
15,34,20,535,779,903,1682,"21 de agosto de 1994"
15,34,20,536,464,568,1032,"21 de agosto de 1994"
15,34,20,537,669,744,1413,"21 de agosto de 1994"
15,34,20,538,627,726,1353,"21 de agosto de 1994"
15,34,20,539,666,741,1407,"21 de agosto de 1994"
15,34,20,540,776,870,1646,"21 de agosto de 1994"
15,34,20,541,405,485,890,"21 de agosto de 1994"
15,34,20,542,323,364,687,"21 de agosto de 1994"
15,34,20,543,358,410,768,"21 de agosto de 1994"
15,34,20,544,227,274,501,"21 de agosto de 1994"
15,34,20,545,270,303,573,"21 de agosto de 1994"
15,34,20,546,448,509,957,"21 de agosto de 1994"
15,34,20,547,283,310,593,"21 de agosto de 1994"
15,34,20,548,450,516,966,"21 de agosto de 1994"
15,34,20,549,844,955,1799,"21 de agosto de 1994"
15,34,20,550,624,744,1368,"21 de agosto de 1994"
15,34,20,551,747,881,1628,"21 de agosto de 1994"
15,34,20,552,725,835,1560,"21 de agosto de 1994"
15,34,20,553,268,300,568,"21 de agosto de 1994"
15,34,20,554,603,759,1362,"21 de agosto de 1994"
15,34,20,555,228,267,495,"21 de agosto de 1994"
15,34,20,556,334,400,734,"21 de agosto de 1994"
15,34,20,557,279,367,646,"21 de agosto de 1994"
15,34,20,558,653,779,1432,"21 de agosto de 1994"
15,34,20,559,681,774,1455,"21 de agosto de 1994"
15,34,20,560,535,577,1112,"21 de agosto de 1994"
15,34,20,561,492,538,1030,"21 de agosto de 1994"
15,34,20,562,634,765,1399,"21 de agosto de 1994"
15,34,20,563,488,535,1023,"21 de agosto de 1994"
15,34,20,564,302,348,650,"21 de agosto de 1994"
15,34,20,565,450,518,968,"21 de agosto de 1994"
15,34,20,566,372,419,791,"21 de agosto de 1994"
15,34,20,567,312,325,637,"21 de agosto de 1994"
15,34,20,568,231,252,483,"21 de agosto de 1994"
15,34,20,569,630,711,1341,"21 de agosto de 1994"
15,34,20,570,473,499,972,"21 de agosto de 1994"
15,34,20,571,313,378,691,"21 de agosto de 1994"
15,34,20,572,295,341,636,"21 de agosto de 1994"
15,34,20,573,217,275,492,"21 de agosto de 1994"
15,34,20,574,51,69,120,"21 de agosto de 1994"
15,34,20,575,594,641,1235,"21 de agosto de 1994"
15,34,20,576,610,711,1321,"21 de agosto de 1994"
15,34,20,577,508,582,1090,"21 de agosto de 1994"
15,34,20,578,750,830,1580,"21 de agosto de 1994"
15,34,20,579,176,185,361,"21 de agosto de 1994"
15,34,20,580,134,169,303,"21 de agosto de 1994"
15,34,20,581,229,262,491,"21 de agosto de 1994"
15,34,20,582,216,249,465,"21 de agosto de 1994"
15,34,20,583,269,333,602,"21 de agosto de 1994"
15,34,20,584,239,285,524,"21 de agosto de 1994"
15,34,20,585,340,381,721,"21 de agosto de 1994"
15,34,20,586,264,307,571,"21 de agosto de 1994"
15,34,20,587,61,67,128,"21 de agosto de 1994"
15,34,20,588,319,354,673,"21 de agosto de 1994"
15,34,20,589,464,513,977,"21 de agosto de 1994"
15,34,20,590,528,578,1106,"21 de agosto de 1994"
15,34,20,591,550,655,1205,"21 de agosto de 1994"
15,34,20,592,690,719,1409,"21 de agosto de 1994"
15,34,20,593,398,477,875,"21 de agosto de 1994"
15,34,20,594,531,629,1160,"21 de agosto de 1994"
15,34,20,595,457,533,990,"21 de agosto de 1994"
15,34,20,596,261,339,600,"21 de agosto de 1994"
15,34,20,597,357,436,793,"21 de agosto de 1994"
15,34,20,598,202,265,467,"21 de agosto de 1994"
15,34,20,599,313,342,655,"21 de agosto de 1994"
15,34,20,600,339,400,739,"21 de agosto de 1994"
15,34,20,601,670,680,1350,"21 de agosto de 1994"
15,34,20,602,642,724,1366,"21 de agosto de 1994"
15,34,20,603,405,405,810,"21 de agosto de 1994"
15,34,20,604,383,455,838,"21 de agosto de 1994"
15,34,20,605,538,605,1143,"21 de agosto de 1994"
15,34,20,606,611,653,1264,"21 de agosto de 1994"
15,34,20,607,517,578,1095,"21 de agosto de 1994"
15,34,20,608,445,506,951,"21 de agosto de 1994"
15,34,20,609,612,754,1366,"21 de agosto de 1994"
15,34,20,610,982,1044,2026,"21 de agosto de 1994"
15,34,20,611,636,709,1345,"21 de agosto de 1994"
15,34,20,612,418,440,858,"21 de agosto de 1994"
15,34,20,613,653,678,1331,"21 de agosto de 1994"
15,34,20,614,834,908,1742,"21 de agosto de 1994"
15,34,20,615,663,685,1348,"21 de agosto de 1994"
15,34,20,616,617,682,1299,"21 de agosto de 1994"
15,34,20,617,444,544,988,"21 de agosto de 1994"
15,34,20,618,826,964,1790,"21 de agosto de 1994"
15,34,20,619,539,629,1168,"21 de agosto de 1994"
15,34,20,620,577,676,1253,"21 de agosto de 1994"
15,34,20,621,579,600,1179,"21 de agosto de 1994"
15,34,20,622,283,335,618,"21 de agosto de 1994"
15,34,20,623,245,271,516,"21 de agosto de 1994"
15,34,20,624,408,476,884,"21 de agosto de 1994"
15,34,20,625,196,248,444,"21 de agosto de 1994"
15,34,20,626,361,454,815,"21 de agosto de 1994"
15,34,20,627,271,361,632,"21 de agosto de 1994"
15,34,20,628,308,352,660,"21 de agosto de 1994"
15,34,105,5092,482,496,978,"21 de agosto de 1994"
15,34,105,5093,380,411,791,"21 de agosto de 1994"
15,34,105,5094,521,566,1087,"21 de agosto de 1994"
15,34,105,5095,455,495,950,"21 de agosto de 1994"
15,34,105,5096,575,619,1194,"21 de agosto de 1994"
15,34,105,5097,445,476,921,"21 de agosto de 1994"
15,34,105,5098,335,386,721,"21 de agosto de 1994"
15,34,105,5099,452,482,934,"21 de agosto de 1994"
15,34,105,5100,389,459,848,"21 de agosto de 1994"
15,34,105,5101,314,393,707,"21 de agosto de 1994"
15,34,105,5102,287,317,604,"21 de agosto de 1994"
15,34,105,5103,313,359,672,"21 de agosto de 1994"
15,34,105,5104,607,617,1224,"21 de agosto de 1994"
15,34,105,5105,121,150,271,"21 de agosto de 1994"
15,34,105,5106,737,829,1566,"21 de agosto de 1994"
15,34,105,5107,743,793,1536,"21 de agosto de 1994"
15,34,105,5108,435,488,923,"21 de agosto de 1994"
15,34,105,5109,373,454,827,"21 de agosto de 1994"
15,34,105,5110,427,490,917,"21 de agosto de 1994"
15,34,105,5111,478,521,999,"21 de agosto de 1994"
15,34,105,5112,583,602,1185,"21 de agosto de 1994"
15,34,105,5113,755,813,1568,"21 de agosto de 1994"
15,34,105,5114,619,648,1267,"21 de agosto de 1994"
15,34,105,5115,380,447,827,"21 de agosto de 1994"
15,34,105,5116,326,392,718,"21 de agosto de 1994"
15,34,105,5117,652,713,1365,"21 de agosto de 1994"
15,34,105,5118,572,632,1204,"21 de agosto de 1994"
15,34,105,5119,545,549,1094,"21 de agosto de 1994"
15,34,105,5120,542,598,1140,"21 de agosto de 1994"
15,34,105,5121,285,320,605,"21 de agosto de 1994"
15,34,105,5122,715,651,1366,"21 de agosto de 1994"
15,34,105,5123,483,459,942,"21 de agosto de 1994"
15,34,105,5124,741,778,1519,"21 de agosto de 1994"
15,34,105,5125,584,624,1208,"21 de agosto de 1994"
15,34,105,5126,414,455,869,"21 de agosto de 1994"
15,34,105,5127,425,467,892,"21 de agosto de 1994"
15,34,105,5128,430,452,882,"21 de agosto de 1994"
15,34,105,5129,790,835,1625,"21 de agosto de 1994"
15,34,105,5130,606,656,1262,"21 de agosto de 1994"
15,34,105,5131,674,704,1378,"21 de agosto de 1994"
15,34,105,5132,676,681,1357,"21 de agosto de 1994"
15,34,105,5133,730,799,1529,"21 de agosto de 1994"
15,34,105,5134,759,826,1585,"21 de agosto de 1994"
15,34,105,5135,487,516,1003,"21 de agosto de 1994"
15,34,105,5136,378,454,832,"21 de agosto de 1994"
15,34,110,5482,468,501,969,"21 de agosto de 1994"
15,34,110,5483,593,624,1217,"21 de agosto de 1994"
15,34,110,5484,559,659,1218,"21 de agosto de 1994"
15,34,110,5485,626,638,1264,"21 de agosto de 1994"
15,34,110,5486,397,422,819,"21 de agosto de 1994"
15,34,110,5487,381,388,769,"21 de agosto de 1994"
15,34,110,5488,729,763,1492,"21 de agosto de 1994"
15,34,110,5489,280,289,569,"21 de agosto de 1994"
15,34,110,5490,754,751,1505,"21 de agosto de 1994"
15,34,110,5491,338,357,695,"21 de agosto de 1994"
15,34,110,5492,518,561,1079,"21 de agosto de 1994"
15,34,110,5493,594,684,1278,"21 de agosto de 1994"
15,34,110,5494,414,472,886,"21 de agosto de 1994"
15,34,110,5495,401,428,829,"21 de agosto de 1994"
15,34,110,5496,273,271,544,"21 de agosto de 1994"
15,34,110,5497,152,164,316,"21 de agosto de 1994"
15,34,110,5498,229,253,482,"21 de agosto de 1994"
15,34,110,5499,784,858,1642,"21 de agosto de 1994"
15,34,110,5500,574,586,1160,"21 de agosto de 1994"
15,34,110,5501,370,389,759,"21 de agosto de 1994"
15,34,110,5502,515,553,1068,"21 de agosto de 1994"
15,34,110,5503,197,218,415,"21 de agosto de 1994"
15,34,110,5504,292,317,609,"21 de agosto de 1994"
15,34,110,5505,467,508,975,"21 de agosto de 1994"
15,34,110,5506,496,530,1026,"21 de agosto de 1994"
15,34,110,5507,611,616,1227,"21 de agosto de 1994"
15,34,110,5508,694,716,1410,"21 de agosto de 1994"
15,34,110,5509,277,278,555,"21 de agosto de 1994"
15,34,110,5510,537,563,1100,"21 de agosto de 1994"
15,34,110,5511,465,495,960,"21 de agosto de 1994"
15,34,110,5512,593,652,1245,"21 de agosto de 1994"
15,34,110,5513,444,439,883,"21 de agosto de 1994"
15,34,110,5514,490,475,965,"21 de agosto de 1994"
15,34,110,5515,790,845,1635,"21 de agosto de 1994"
15,34,110,5516,633,693,1326,"21 de agosto de 1994"
15,34,110,5517,705,759,1464,"21 de agosto de 1994"
15,34,110,5518,687,745,1432,"21 de agosto de 1994"
15,34,110,5519,582,586,1168,"21 de agosto de 1994"
15,34,110,5520,119,143,262,"21 de agosto de 1994"
15,34,110,5521,49,57,106,"21 de agosto de 1994"
15,34,110,5522,512,591,1103,"21 de agosto de 1994"
15,34,110,5523,432,455,887,"21 de agosto de 1994"
15,34,110,5524,367,407,774,"21 de agosto de 1994"
15,34,110,5525,555,595,1150,"21 de agosto de 1994"
15,34,110,5526,689,746,1435,"21 de agosto de 1994"
15,34,110,5527,685,717,1402,"21 de agosto de 1994"
15,34,110,5528,608,591,1199,"21 de agosto de 1994"
15,34,110,5529,421,447,868,"21 de agosto de 1994"
15,34,110,5530,550,564,1114,"21 de agosto de 1994"
15,34,110,5531,527,591,1118,"21 de agosto de 1994"
15,34,110,5532,520,610,1130,"21 de agosto de 1994"
15,34,110,5533,777,929,1706,"21 de agosto de 1994"
15,34,110,5534,368,411,779,"21 de agosto de 1994"
15,34,110,5535,330,420,750,"21 de agosto de 1994"
15,34,110,5536,466,538,1004,"21 de agosto de 1994"
15,34,110,5537,249,339,588,"21 de agosto de 1994"
15,34,110,5538,455,514,969,"21 de agosto de 1994"
15,34,110,5539,719,753,1472,"21 de agosto de 1994"
15,34,110,5540,680,688,1368,"21 de agosto de 1994"
15,34,110,5541,722,737,1459,"21 de agosto de 1994"
15,34,110,5542,295,378,673,"21 de agosto de 1994"
15,34,110,5543,243,273,516,"21 de agosto de 1994"
15,34,110,5544,567,609,1176,"21 de agosto de 1994"
15,34,110,5545,652,710,1362,"21 de agosto de 1994"
15,34,110,5546,632,619,1251,"21 de agosto de 1994"
15,34,110,5547,513,529,1042,"21 de agosto de 1994"
15,34,110,5548,854,910,1764,"21 de agosto de 1994"
15,34,110,5549,198,246,444,"21 de agosto de 1994"
15,34,110,5550,389,398,787,"21 de agosto de 1994"
15,34,110,5551,298,342,640,"21 de agosto de 1994"
15,34,110,5552,651,743,1394,"21 de agosto de 1994"
15,34,110,5553,617,709,1326,"21 de agosto de 1994"
15,34,110,5554,600,690,1290,"21 de agosto de 1994"
15,34,110,5555,76,88,164,"21 de agosto de 1994"
15,34,110,5556,409,442,851,"21 de agosto de 1994"
15,34,110,5557,929,1018,1947,"21 de agosto de 1994"
15,34,110,5558,592,632,1224,"21 de agosto de 1994"
15,34,110,5559,538,545,1083,"21 de agosto de 1994"
15,34,110,5560,505,543,1048,"21 de agosto de 1994"
15,34,110,5561,580,659,1239,"21 de agosto de 1994"
15,34,110,5562,605,677,1282,"21 de agosto de 1994"
15,34,110,5563,518,525,1043,"21 de agosto de 1994"
15,34,110,5564,549,595,1144,"21 de agosto de 1994"
15,34,110,5565,186,201,387,"21 de agosto de 1994"
15,34,110,5566,741,786,1527,"21 de agosto de 1994"
15,34,110,5567,297,328,625,"21 de agosto de 1994"
15,34,110,5568,230,269,499,"21 de agosto de 1994"
15,34,110,5569,757,792,1549,"21 de agosto de 1994"
15,34,110,5570,513,565,1078,"21 de agosto de 1994"
15,34,110,5571,346,401,747,"21 de agosto de 1994"
15,34,110,5572,334,400,734,"21 de agosto de 1994"
15,34,110,5573,621,709,1330,"21 de agosto de 1994"
15,34,110,5574,433,519,952,"21 de agosto de 1994"
15,34,110,5575,702,758,1460,"21 de agosto de 1994"
15,34,110,5576,767,844,1611,"21 de agosto de 1994"
15,34,110,5577,703,800,1503,"21 de agosto de 1994"
15,34,110,5578,703,793,1496,"21 de agosto de 1994"
15,34,110,5579,652,669,1321,"21 de agosto de 1994"
15,34,110,5580,182,230,412,"21 de agosto de 1994"
15,34,110,5581,422,473,895,"21 de agosto de 1994"
15,34,110,5582,598,631,1229,"21 de agosto de 1994"
15,34,110,5583,844,880,1724,"21 de agosto de 1994"
15,34,110,5584,461,519,980,"21 de agosto de 1994"
15,34,110,5585,139,170,309,"21 de agosto de 1994"
15,34,110,5586,314,358,672,"21 de agosto de 1994"
15,34,110,5587,545,613,1158,"21 de agosto de 1994"
15,34,110,5588,322,409,731,"21 de agosto de 1994"
15,34,110,5589,526,584,1110,"21 de agosto de 1994"
15,34,110,5590,457,553,1010,"21 de agosto de 1994"
15,34,110,5591,232,245,477,"21 de agosto de 1994"
15,34,110,5592,327,359,686,"21 de agosto de 1994"
15,34,110,5593,337,382,719,"21 de agosto de 1994"
15,34,110,5594,378,433,811,"21 de agosto de 1994"
15,34,110,5595,274,326,600,"21 de agosto de 1994"
15,34,110,5596,227,281,508,"21 de agosto de 1994"
15,34,110,5597,651,653,1304,"21 de agosto de 1994"
15,34,110,5598,697,763,1460,"21 de agosto de 1994"
15,34,110,5599,65,63,128,"21 de agosto de 1994"
15,34,110,5600,461,494,955,"21 de agosto de 1994"
15,34,110,5601,449,518,967,"21 de agosto de 1994"
15,34,110,5602,284,320,604,"21 de agosto de 1994"
15,34,110,5603,351,416,767,"21 de agosto de 1994"
15,34,110,5604,447,507,954,"21 de agosto de 1994"
15,34,110,5605,508,613,1121,"21 de agosto de 1994"
15,34,110,5606,285,356,641,"21 de agosto de 1994"
15,34,110,5607,496,613,1109,"21 de agosto de 1994"
15,34,110,5608,343,387,730,"21 de agosto de 1994"
15,34,110,5609,527,549,1076,"21 de agosto de 1994"
15,34,110,5610,711,734,1445,"21 de agosto de 1994"
15,34,110,5611,336,315,651,"21 de agosto de 1994"
15,34,110,5612,480,561,1041,"21 de agosto de 1994"
15,34,110,5613,764,885,1649,"21 de agosto de 1994"
15,34,110,5614,172,212,384,"21 de agosto de 1994"
15,34,110,5615,254,331,585,"21 de agosto de 1994"
15,34,110,5616,430,531,961,"21 de agosto de 1994"
15,34,110,5617,514,599,1113,"21 de agosto de 1994"
15,34,110,5618,466,487,953,"21 de agosto de 1994"
15,34,110,5619,530,628,1158,"21 de agosto de 1994"
15,34,110,5620,287,330,617,"21 de agosto de 1994"
15,34,110,5621,264,344,608,"21 de agosto de 1994"
15,34,110,5622,104,145,249,"21 de agosto de 1994"
15,34,110,5623,465,528,993,"21 de agosto de 1994"
15,34,110,5624,436,450,886,"21 de agosto de 1994"
15,34,110,5625,391,409,800,"21 de agosto de 1994"
15,34,110,5626,268,337,605,"21 de agosto de 1994"
15,34,110,5627,313,384,697,"21 de agosto de 1994"
15,34,110,5628,376,475,851,"21 de agosto de 1994"
15,34,110,5629,272,319,591,"21 de agosto de 1994"
15,34,110,5630,275,310,585,"21 de agosto de 1994"
15,34,110,5631,426,508,934,"21 de agosto de 1994"
15,34,110,5632,267,359,626,"21 de agosto de 1994"
15,34,110,5633,319,351,670,"21 de agosto de 1994"
15,34,110,5634,157,214,371,"21 de agosto de 1994"
15,34,110,5635,141,178,319,"21 de agosto de 1994"
15,34,110,5636,436,487,923,"21 de agosto de 1994"
15,34,110,5637,213,267,480,"21 de agosto de 1994"
15,34,110,5638,383,478,861,"21 de agosto de 1994"
15,34,110,5639,340,406,746,"21 de agosto de 1994"
15,34,110,5640,267,292,559,"21 de agosto de 1994"
15,34,110,5641,261,308,569,"21 de agosto de 1994"
15,34,110,5642,326,390,716,"21 de agosto de 1994"
15,34,110,5643,297,386,683,"21 de agosto de 1994"
15,34,110,5644,229,274,503,"21 de agosto de 1994"
15,34,110,5645,193,215,408,"21 de agosto de 1994"
15,34,110,5646,106,142,248,"21 de agosto de 1994"
15,34,110,5647,133,197,330,"21 de agosto de 1994"
15,34,110,5648,268,291,559,"21 de agosto de 1994"
15,34,110,5649,428,494,922,"21 de agosto de 1994"
15,34,110,5650,427,453,880,"21 de agosto de 1994"
15,34,110,5651,467,514,981,"21 de agosto de 1994"
15,34,110,5652,476,531,1007,"21 de agosto de 1994"
15,34,110,5653,222,259,481,"21 de agosto de 1994"
16,1,54,941,380,437,817,"21 de agosto de 1994"
16,1,54,942,304,355,659,"21 de agosto de 1994"
16,1,54,943,343,384,727,"21 de agosto de 1994"
16,1,54,944,404,421,825,"21 de agosto de 1994"
16,1,54,945,462,578,1040,"21 de agosto de 1994"
16,1,54,946,308,355,663,"21 de agosto de 1994"
16,1,54,947,354,431,785,"21 de agosto de 1994"
16,1,54,948,419,496,915,"21 de agosto de 1994"
16,1,54,949,569,683,1252,"21 de agosto de 1994"
16,1,54,950,376,438,814,"21 de agosto de 1994"
16,1,54,951,438,533,971,"21 de agosto de 1994"
16,1,54,952,454,495,949,"21 de agosto de 1994"
16,1,54,953,260,311,571,"21 de agosto de 1994"
16,1,54,954,221,300,521,"21 de agosto de 1994"
16,1,54,955,408,464,872,"21 de agosto de 1994"
16,1,54,956,404,476,880,"21 de agosto de 1994"
16,1,54,957,273,326,599,"21 de agosto de 1994"
16,1,54,958,548,701,1249,"21 de agosto de 1994"
16,1,54,959,341,416,757,"21 de agosto de 1994"
16,1,54,960,502,594,1096,"21 de agosto de 1994"
16,1,54,961,233,260,493,"21 de agosto de 1994"
16,1,54,962,429,476,905,"21 de agosto de 1994"
16,1,54,963,471,561,1032,"21 de agosto de 1994"
16,1,54,964,378,428,806,"21 de agosto de 1994"
16,1,54,965,414,510,924,"21 de agosto de 1994"
16,1,54,966,441,498,939,"21 de agosto de 1994"
16,1,54,967,419,456,875,"21 de agosto de 1994"
16,1,54,968,398,481,879,"21 de agosto de 1994"
16,1,54,969,484,596,1080,"21 de agosto de 1994"
16,1,54,970,479,518,997,"21 de agosto de 1994"
16,1,54,971,213,244,457,"21 de agosto de 1994"
16,1,54,972,460,520,980,"21 de agosto de 1994"
16,1,54,973,282,322,604,"21 de agosto de 1994"
16,1,54,974,171,208,379,"21 de agosto de 1994"
16,1,54,975,115,164,279,"21 de agosto de 1994"
16,1,54,976,186,230,416,"21 de agosto de 1994"
16,1,54,977,223,262,485,"21 de agosto de 1994"
16,1,54,978,383,455,838,"21 de agosto de 1994"
16,1,54,979,205,238,443,"21 de agosto de 1994"
16,1,54,980,164,199,363,"21 de agosto de 1994"
16,1,54,981,236,278,514,"21 de agosto de 1994"
16,1,54,982,204,228,432,"21 de agosto de 1994"
16,1,54,983,317,401,718,"21 de agosto de 1994"
16,1,54,984,308,338,646,"21 de agosto de 1994"
16,1,54,985,284,331,615,"21 de agosto de 1994"
16,1,54,986,185,200,385,"21 de agosto de 1994"
16,1,54,987,207,254,461,"21 de agosto de 1994"
16,1,54,988,385,464,849,"21 de agosto de 1994"
16,1,54,989,357,413,770,"21 de agosto de 1994"
16,1,54,990,243,273,516,"21 de agosto de 1994"
16,1,54,991,281,324,605,"21 de agosto de 1994"
16,1,54,992,366,447,813,"21 de agosto de 1994"
16,1,54,993,216,260,476,"21 de agosto de 1994"
16,1,54,994,390,458,848,"21 de agosto de 1994"
16,1,54,995,388,440,828,"21 de agosto de 1994"
16,1,54,996,273,386,659,"21 de agosto de 1994"
16,1,54,997,444,514,958,"21 de agosto de 1994"
16,1,54,998,518,590,1108,"21 de agosto de 1994"
16,1,54,999,454,532,986,"21 de agosto de 1994"
16,1,54,1000,404,454,858,"21 de agosto de 1994"
16,1,54,1001,366,444,810,"21 de agosto de 1994"
16,1,54,1002,397,462,859,"21 de agosto de 1994"
16,1,54,1003,337,415,752,"21 de agosto de 1994"
16,1,54,1004,533,619,1152,"21 de agosto de 1994"
16,1,54,1005,431,557,988,"21 de agosto de 1994"
16,1,54,1006,355,409,764,"21 de agosto de 1994"
16,1,54,1007,512,584,1096,"21 de agosto de 1994"
16,1,54,1008,582,684,1266,"21 de agosto de 1994"
16,1,54,1009,351,423,774,"21 de agosto de 1994"
16,1,54,1010,426,482,908,"21 de agosto de 1994"
16,1,54,1011,438,540,978,"21 de agosto de 1994"
16,1,54,1012,429,535,964,"21 de agosto de 1994"
16,1,54,1013,393,486,879,"21 de agosto de 1994"
16,1,54,1014,362,449,811,"21 de agosto de 1994"
16,1,54,1015,499,588,1087,"21 de agosto de 1994"
16,1,54,1016,360,427,787,"21 de agosto de 1994"
16,1,54,1017,258,342,600,"21 de agosto de 1994"
16,1,54,1018,326,409,735,"21 de agosto de 1994"
16,1,54,1019,363,493,856,"21 de agosto de 1994"
16,1,54,1020,586,677,1263,"21 de agosto de 1994"
16,1,54,1021,295,402,697,"21 de agosto de 1994"
16,1,54,1022,204,253,457,"21 de agosto de 1994"
16,1,54,1023,237,299,536,"21 de agosto de 1994"
16,1,54,1024,162,235,397,"21 de agosto de 1994"
16,1,54,1025,214,297,511,"21 de agosto de 1994"
16,1,54,1026,266,362,628,"21 de agosto de 1994"
16,1,54,1027,154,242,396,"21 de agosto de 1994"
16,1,54,1028,198,232,430,"21 de agosto de 1994"
16,1,54,1029,262,409,671,"21 de agosto de 1994"
16,1,54,1030,376,473,849,"21 de agosto de 1994"
16,1,54,1031,411,489,900,"21 de agosto de 1994"
16,1,54,1032,513,587,1100,"21 de agosto de 1994"
16,1,54,1033,525,644,1169,"21 de agosto de 1994"
16,1,54,1034,525,607,1132,"21 de agosto de 1994"
16,1,54,1035,243,299,542,"21 de agosto de 1994"
16,1,54,1036,192,236,428,"21 de agosto de 1994"
16,1,54,1037,464,504,968,"21 de agosto de 1994"
16,1,54,1038,441,533,974,"21 de agosto de 1994"
16,1,54,1039,459,540,999,"21 de agosto de 1994"
16,1,54,1040,500,561,1061,"21 de agosto de 1994"
16,1,54,1041,360,458,818,"21 de agosto de 1994"
16,1,54,1042,228,316,544,"21 de agosto de 1994"
16,1,54,1043,212,303,515,"21 de agosto de 1994"
16,1,54,1044,327,423,750,"21 de agosto de 1994"
16,1,54,1045,482,561,1043,"21 de agosto de 1994"
16,1,54,1046,317,347,664,"21 de agosto de 1994"
16,1,54,1047,396,443,839,"21 de agosto de 1994"
16,1,54,1048,291,369,660,"21 de agosto de 1994"
16,1,54,1049,284,333,617,"21 de agosto de 1994"
16,1,54,1050,414,462,876,"21 de agosto de 1994"
16,1,54,1051,445,523,968,"21 de agosto de 1994"
16,1,54,1052,424,491,915,"21 de agosto de 1994"
16,1,54,1053,271,314,585,"21 de agosto de 1994"
16,1,54,1054,226,276,502,"21 de agosto de 1994"
16,1,54,1055,293,339,632,"21 de agosto de 1994"
16,1,54,1056,273,306,579,"21 de agosto de 1994"
16,1,54,1057,358,436,794,"21 de agosto de 1994"
16,1,54,1058,343,398,741,"21 de agosto de 1994"
16,1,54,1059,507,568,1075,"21 de agosto de 1994"
16,1,54,1060,325,374,699,"21 de agosto de 1994"
16,1,54,1061,131,177,308,"21 de agosto de 1994"
16,1,54,1062,466,480,946,"21 de agosto de 1994"
16,1,54,1063,420,512,932,"21 de agosto de 1994"
16,1,54,1064,401,494,895,"21 de agosto de 1994"
16,1,54,1065,179,239,418,"21 de agosto de 1994"
16,1,54,1066,370,461,831,"21 de agosto de 1994"
16,1,54,1067,298,391,689,"21 de agosto de 1994"
16,1,54,1068,242,321,563,"21 de agosto de 1994"
16,1,54,1069,253,327,580,"21 de agosto de 1994"
16,1,54,1070,381,436,817,"21 de agosto de 1994"
16,1,54,1071,258,365,623,"21 de agosto de 1994"
16,1,54,1072,323,408,731,"21 de agosto de 1994"
16,1,54,1073,282,357,639,"21 de agosto de 1994"
16,1,54,1074,438,480,918,"21 de agosto de 1994"
16,1,54,1075,254,376,630,"21 de agosto de 1994"
16,1,54,1076,531,651,1182,"21 de agosto de 1994"
16,1,54,1077,642,829,1471,"21 de agosto de 1994"
16,1,54,1078,581,698,1279,"21 de agosto de 1994"
16,1,54,1079,271,390,661,"21 de agosto de 1994"
16,1,54,1080,298,361,659,"21 de agosto de 1994"
16,1,54,1081,422,589,1011,"21 de agosto de 1994"
16,1,54,1082,452,537,989,"21 de agosto de 1994"
16,1,54,1083,766,265,1031,"21 de agosto de 1994"
16,1,54,1084,381,470,851,"21 de agosto de 1994"
16,1,54,1085,475,581,1056,"21 de agosto de 1994"
16,1,54,1086,415,509,924,"21 de agosto de 1994"
16,1,54,1087,445,559,1004,"21 de agosto de 1994"
16,1,54,1088,248,358,606,"21 de agosto de 1994"
16,1,54,1089,336,430,766,"21 de agosto de 1994"
16,1,54,1090,254,325,579,"21 de agosto de 1994"
16,1,54,1091,236,295,531,"21 de agosto de 1994"
16,1,54,1092,389,487,876,"21 de agosto de 1994"
16,1,54,1093,418,497,915,"21 de agosto de 1994"
16,1,54,1094,411,452,863,"21 de agosto de 1994"
16,1,54,1095,321,336,657,"21 de agosto de 1994"
16,1,54,1096,453,509,962,"21 de agosto de 1994"
16,1,54,1097,413,461,874,"21 de agosto de 1994"
16,1,54,1098,307,379,686,"21 de agosto de 1994"
16,1,54,1099,353,420,773,"21 de agosto de 1994"
16,1,54,1100,279,364,643,"21 de agosto de 1994"
16,1,54,1101,453,536,989,"21 de agosto de 1994"
16,1,54,1102,398,520,918,"21 de agosto de 1994"
16,1,54,1103,382,431,813,"21 de agosto de 1994"
16,1,54,1104,358,429,787,"21 de agosto de 1994"
16,1,54,1105,253,341,594,"21 de agosto de 1994"
16,1,54,1106,346,461,807,"21 de agosto de 1994"
16,1,54,1107,310,309,619,"21 de agosto de 1994"
16,1,54,1108,560,656,1216,"21 de agosto de 1994"
16,1,54,1109,406,475,881,"21 de agosto de 1994"
16,1,54,1110,398,458,856,"21 de agosto de 1994"
16,1,54,1111,362,442,804,"21 de agosto de 1994"
16,1,54,1112,332,387,719,"21 de agosto de 1994"
16,1,54,1113,330,414,744,"21 de agosto de 1994"
16,1,54,1114,306,385,691,"21 de agosto de 1994"
16,1,54,1115,358,411,769,"21 de agosto de 1994"
16,1,54,1116,387,462,849,"21 de agosto de 1994"
16,1,54,1117,346,418,764,"21 de agosto de 1994"
16,1,54,1118,398,453,851,"21 de agosto de 1994"
16,1,54,1119,334,423,757,"21 de agosto de 1994"
16,1,54,1120,409,460,869,"21 de agosto de 1994"
16,1,54,1121,514,591,1105,"21 de agosto de 1994"
16,1,54,1122,419,491,910,"21 de agosto de 1994"
16,1,54,1123,321,393,714,"21 de agosto de 1994"
16,1,54,1124,306,377,683,"21 de agosto de 1994"
16,1,54,1125,557,669,1226,"21 de agosto de 1994"
16,1,54,1126,488,589,1077,"21 de agosto de 1994"
16,1,54,1127,345,444,789,"21 de agosto de 1994"
16,1,54,1128,559,664,1223,"21 de agosto de 1994"
16,1,54,1129,472,525,997,"21 de agosto de 1994"
16,1,54,1130,290,348,638,"21 de agosto de 1994"
16,1,54,1131,493,566,1059,"21 de agosto de 1994"
16,1,54,1132,267,364,631,"21 de agosto de 1994"
16,1,54,1133,409,494,903,"21 de agosto de 1994"
16,1,54,1134,330,418,748,"21 de agosto de 1994"
16,1,54,1135,451,559,1010,"21 de agosto de 1994"
16,1,54,1136,457,535,992,"21 de agosto de 1994"
16,1,54,1137,404,503,907,"21 de agosto de 1994"
16,1,54,1138,387,454,841,"21 de agosto de 1994"
16,1,54,1139,368,417,785,"21 de agosto de 1994"
16,1,54,1140,227,293,520,"21 de agosto de 1994"
16,1,54,1141,491,591,1082,"21 de agosto de 1994"
16,1,54,1142,170,179,349,"21 de agosto de 1994"
16,1,54,1143,364,429,793,"21 de agosto de 1994"
16,1,54,1144,371,467,838,"21 de agosto de 1994"
16,1,54,1145,308,338,646,"21 de agosto de 1994"
16,1,54,1146,213,268,481,"21 de agosto de 1994"
16,1,54,1147,393,486,879,"21 de agosto de 1994"
16,1,54,1148,361,428,789,"21 de agosto de 1994"
16,1,54,1149,238,299,537,"21 de agosto de 1994"
16,1,54,1150,387,487,874,"21 de agosto de 1994"
16,1,54,1151,194,237,431,"21 de agosto de 1994"
16,1,54,1152,199,215,414,"21 de agosto de 1994"
16,1,54,1153,149,173,322,"21 de agosto de 1994"
16,1,54,1154,176,235,411,"21 de agosto de 1994"
16,1,54,1155,347,422,769,"21 de agosto de 1994"
16,1,54,1156,152,195,347,"21 de agosto de 1994"
16,1,54,1157,204,239,443,"21 de agosto de 1994"
16,1,54,1158,336,353,689,"21 de agosto de 1994"
16,1,54,1159,323,353,676,"21 de agosto de 1994"
16,1,54,1160,381,432,813,"21 de agosto de 1994"
16,1,54,1161,307,374,681,"21 de agosto de 1994"
16,1,54,1162,216,262,478,"21 de agosto de 1994"
16,1,54,1163,202,237,439,"21 de agosto de 1994"
16,1,54,1164,224,277,501,"21 de agosto de 1994"
16,1,54,1165,437,517,954,"21 de agosto de 1994"
16,1,54,1166,393,462,855,"21 de agosto de 1994"
16,1,54,1167,296,342,638,"21 de agosto de 1994"
16,1,54,1168,440,512,952,"21 de agosto de 1994"
16,1,54,1169,476,552,1028,"21 de agosto de 1994"
16,1,54,1170,439,510,949,"21 de agosto de 1994"
16,1,54,1171,295,399,694,"21 de agosto de 1994"
16,1,54,1172,406,480,886,"21 de agosto de 1994"
16,1,54,1173,240,315,555,"21 de agosto de 1994"
16,1,54,1174,280,315,595,"21 de agosto de 1994"
16,1,54,1175,408,456,864,"21 de agosto de 1994"
16,1,54,1176,247,302,549,"21 de agosto de 1994"
16,1,54,1177,362,404,766,"21 de agosto de 1994"
16,1,54,1178,345,380,725,"21 de agosto de 1994"
16,1,54,1179,541,642,1183,"21 de agosto de 1994"
16,1,54,1180,156,206,362,"21 de agosto de 1994"
16,1,54,1181,346,418,764,"21 de agosto de 1994"
16,1,54,1182,436,546,982,"21 de agosto de 1994"
16,1,54,1183,311,375,686,"21 de agosto de 1994"
16,1,54,1184,662,787,1449,"21 de agosto de 1994"
16,1,54,1185,411,496,907,"21 de agosto de 1994"
16,1,54,1186,488,549,1037,"21 de agosto de 1994"
16,1,54,1187,397,430,827,"21 de agosto de 1994"
16,1,54,1188,435,465,900,"21 de agosto de 1994"
16,1,54,1189,296,323,619,"21 de agosto de 1994"
16,1,54,1190,251,280,531,"21 de agosto de 1994"
16,2,22,346,643,753,1396,"21 de agosto de 1994"
16,2,22,347,674,863,1537,"21 de agosto de 1994"
16,2,22,348,370,418,788,"21 de agosto de 1994"
16,2,22,349,385,475,860,"21 de agosto de 1994"
16,2,22,350,163,195,358,"21 de agosto de 1994"
16,2,22,351,386,432,818,"21 de agosto de 1994"
16,2,22,352,270,324,594,"21 de agosto de 1994"
16,2,22,353,172,218,390,"21 de agosto de 1994"
16,2,22,354,98,89,187,"21 de agosto de 1994"
16,2,22,355,91,89,180,"21 de agosto de 1994"
16,2,22,356,102,103,205,"21 de agosto de 1994"
16,2,22,357,93,84,177,"21 de agosto de 1994"
16,2,22,358,102,97,199,"21 de agosto de 1994"
16,2,22,359,322,282,604,"21 de agosto de 1994"
16,2,22,360,131,133,264,"21 de agosto de 1994"
16,2,34,480,467,537,1004,"21 de agosto de 1994"
16,2,34,481,495,543,1038,"21 de agosto de 1994"
16,2,34,482,616,770,1386,"21 de agosto de 1994"
16,2,34,483,566,754,1320,"21 de agosto de 1994"
16,2,34,484,644,848,1492,"21 de agosto de 1994"
16,2,34,485,480,595,1075,"21 de agosto de 1994"
16,2,34,486,694,857,1551,"21 de agosto de 1994"
16,2,34,487,524,636,1160,"21 de agosto de 1994"
16,2,34,488,592,694,1286,"21 de agosto de 1994"
16,2,34,489,473,550,1023,"21 de agosto de 1994"
16,2,34,490,404,458,862,"21 de agosto de 1994"
16,2,34,491,623,826,1449,"21 de agosto de 1994"
16,2,34,492,463,585,1048,"21 de agosto de 1994"
16,2,34,493,579,719,1298,"21 de agosto de 1994"
16,2,34,494,719,919,1638,"21 de agosto de 1994"
16,2,34,495,661,741,1402,"21 de agosto de 1994"
16,2,34,496,429,571,1000,"21 de agosto de 1994"
16,2,34,497,414,529,943,"21 de agosto de 1994"
16,2,34,498,586,772,1358,"21 de agosto de 1994"
16,2,34,499,551,699,1250,"21 de agosto de 1994"
16,2,34,500,363,423,786,"21 de agosto de 1994"
16,2,34,501,388,500,888,"21 de agosto de 1994"
16,2,34,502,402,494,896,"21 de agosto de 1994"
16,2,34,503,514,573,1087,"21 de agosto de 1994"
16,2,34,504,74,67,141,"21 de agosto de 1994"
16,2,34,505,57,48,105,"21 de agosto de 1994"
16,2,34,506,67,64,131,"21 de agosto de 1994"
16,2,34,507,58,55,113,"21 de agosto de 1994"
16,2,34,508,377,428,805,"21 de agosto de 1994"
16,2,34,509,70,75,145,"21 de agosto de 1994"
16,2,34,510,424,429,853,"21 de agosto de 1994"
16,2,34,511,396,388,784,"21 de agosto de 1994"
16,2,34,512,187,181,368,"21 de agosto de 1994"
16,2,34,513,338,420,758,"21 de agosto de 1994"
16,2,34,514,200,206,406,"21 de agosto de 1994"
16,2,34,515,100,122,222,"21 de agosto de 1994"
16,2,34,516,142,156,298,"21 de agosto de 1994"
16,2,34,517,609,780,1389,"21 de agosto de 1994"
16,2,34,518,91,111,202,"21 de agosto de 1994"
16,2,34,519,34,38,72,"21 de agosto de 1994"
16,2,34,520,132,147,279,"21 de agosto de 1994"
16,2,34,521,510,525,1035,"21 de agosto de 1994"
16,2,34,522,142,185,327,"21 de agosto de 1994"
16,2,34,523,139,168,307,"21 de agosto de 1994"
16,2,34,524,103,102,205,"21 de agosto de 1994"
16,2,34,525,129,121,250,"21 de agosto de 1994"
16,2,34,526,418,403,821,"21 de agosto de 1994"
16,2,34,527,472,432,904,"21 de agosto de 1994"
16,2,34,528,192,199,391,"21 de agosto de 1994"
16,2,34,529,165,150,315,"21 de agosto de 1994"
16,2,34,530,80,94,174,"21 de agosto de 1994"
16,2,34,531,151,144,295,"21 de agosto de 1994"
16,2,34,532,256,272,528,"21 de agosto de 1994"
16,2,34,533,46,54,100,"21 de agosto de 1994"
16,2,34,534,168,178,346,"21 de agosto de 1994"
16,2,34,535,52,48,100,"21 de agosto de 1994"
16,2,34,536,61,57,118,"21 de agosto de 1994"
16,2,34,537,158,160,318,"21 de agosto de 1994"
16,2,34,538,97,146,243,"21 de agosto de 1994"
16,2,34,539,199,237,436,"21 de agosto de 1994"
16,2,34,540,72,73,145,"21 de agosto de 1994"
16,2,34,541,84,86,170,"21 de agosto de 1994"
16,2,34,542,211,191,402,"21 de agosto de 1994"
16,2,34,543,82,72,154,"21 de agosto de 1994"
16,2,34,544,198,207,405,"21 de agosto de 1994"
16,2,34,545,333,332,665,"21 de agosto de 1994"
16,2,34,546,608,595,1203,"21 de agosto de 1994"
16,2,34,547,71,72,143,"21 de agosto de 1994"
16,2,34,548,230,230,460,"21 de agosto de 1994"
16,2,34,549,380,443,823,"21 de agosto de 1994"
16,2,34,550,239,225,464,"21 de agosto de 1994"
16,2,34,551,89,65,154,"21 de agosto de 1994"
16,2,34,552,86,61,147,"21 de agosto de 1994"
16,2,34,553,70,55,125,"21 de agosto de 1994"
16,2,34,554,35,26,61,"21 de agosto de 1994"
16,2,34,555,84,64,148,"21 de agosto de 1994"
16,2,34,556,55,40,95,"21 de agosto de 1994"
16,2,40,651,580,679,1259,"21 de agosto de 1994"
16,2,40,652,404,476,880,"21 de agosto de 1994"
16,2,40,653,385,513,898,"21 de agosto de 1994"
16,2,40,654,322,467,789,"21 de agosto de 1994"
16,2,40,655,273,310,583,"21 de agosto de 1994"
16,2,40,656,178,204,382,"21 de agosto de 1994"
16,2,40,657,177,283,460,"21 de agosto de 1994"
16,2,40,658,112,142,254,"21 de agosto de 1994"
16,2,40,659,495,486,981,"21 de agosto de 1994"
16,2,40,660,140,163,303,"21 de agosto de 1994"
16,2,40,661,81,75,156,"21 de agosto de 1994"
16,2,40,662,95,104,199,"21 de agosto de 1994"
16,2,40,663,30,27,57,"21 de agosto de 1994"
16,2,40,664,60,54,114,"21 de agosto de 1994"
16,2,41,665,388,456,844,"21 de agosto de 1994"
16,2,41,666,465,534,999,"21 de agosto de 1994"
16,2,41,667,77,84,161,"21 de agosto de 1994"
16,2,41,668,322,360,682,"21 de agosto de 1994"
16,2,41,669,464,508,972,"21 de agosto de 1994"
16,2,41,670,228,247,475,"21 de agosto de 1994"
16,2,41,671,169,209,378,"21 de agosto de 1994"
16,2,41,672,482,551,1033,"21 de agosto de 1994"
16,2,47,774,412,430,842,"21 de agosto de 1994"
16,2,47,775,394,429,823,"21 de agosto de 1994"
16,2,47,776,122,146,268,"21 de agosto de 1994"
16,2,47,777,222,213,435,"21 de agosto de 1994"
16,2,47,778,129,125,254,"21 de agosto de 1994"
16,2,47,779,141,137,278,"21 de agosto de 1994"
16,2,47,780,129,125,254,"21 de agosto de 1994"
16,2,47,781,70,67,137,"21 de agosto de 1994"
16,2,47,782,120,116,236,"21 de agosto de 1994"
16,2,47,783,224,234,458,"21 de agosto de 1994"
16,2,47,784,529,599,1128,"21 de agosto de 1994"
16,2,47,785,166,151,317,"21 de agosto de 1994"
16,2,48,786,403,419,822,"21 de agosto de 1994"
16,2,48,787,478,467,945,"21 de agosto de 1994"
16,2,48,788,612,622,1234,"21 de agosto de 1994"
16,2,48,789,164,139,303,"21 de agosto de 1994"
16,2,48,790,431,437,868,"21 de agosto de 1994"
16,2,48,791,283,278,561,"21 de agosto de 1994"
16,2,48,792,317,287,604,"21 de agosto de 1994"
16,2,48,793,293,295,588,"21 de agosto de 1994"
16,2,48,794,105,98,203,"21 de agosto de 1994"
16,2,48,795,167,130,297,"21 de agosto de 1994"
16,2,48,796,219,174,393,"21 de agosto de 1994"
16,2,48,797,106,110,216,"21 de agosto de 1994"
16,2,48,798,180,171,351,"21 de agosto de 1994"
16,2,48,799,162,152,314,"21 de agosto de 1994"
16,2,48,800,172,162,334,"21 de agosto de 1994"
16,2,48,801,61,44,105,"21 de agosto de 1994"
16,2,73,1647,347,459,806,"21 de agosto de 1994"
16,2,73,1648,314,396,710,"21 de agosto de 1994"
16,2,73,1649,268,336,604,"21 de agosto de 1994"
16,2,73,1650,314,375,689,"21 de agosto de 1994"
16,2,73,1651,509,611,1120,"21 de agosto de 1994"
16,2,73,1652,293,317,610,"21 de agosto de 1994"
16,2,73,1653,95,121,216,"21 de agosto de 1994"
16,2,73,1654,124,134,258,"21 de agosto de 1994"
16,2,73,1655,149,193,342,"21 de agosto de 1994"
16,2,73,1656,377,413,790,"21 de agosto de 1994"
16,2,73,1657,88,109,197,"21 de agosto de 1994"
16,2,73,1658,125,113,238,"21 de agosto de 1994"
16,2,73,1659,104,91,195,"21 de agosto de 1994"
16,2,73,1660,81,54,135,"21 de agosto de 1994"
16,2,82,1832,264,297,561,"21 de agosto de 1994"
16,2,82,1833,278,272,550,"21 de agosto de 1994"
16,2,82,1834,297,272,569,"21 de agosto de 1994"
16,2,82,1835,82,75,157,"21 de agosto de 1994"
16,2,82,1836,408,370,778,"21 de agosto de 1994"
16,2,82,1837,82,72,154,"21 de agosto de 1994"
16,2,82,1838,39,38,77,"21 de agosto de 1994"
16,2,82,1839,189,205,394,"21 de agosto de 1994"
16,2,82,1840,95,96,191,"21 de agosto de 1994"
16,2,82,1841,152,141,293,"21 de agosto de 1994"
16,2,82,1842,24,28,52,"21 de agosto de 1994"
16,2,82,1843,80,84,164,"21 de agosto de 1994"
16,2,99,2113,379,387,766,"21 de agosto de 1994"
16,2,99,2114,380,433,813,"21 de agosto de 1994"
16,2,99,2115,464,569,1033,"21 de agosto de 1994"
16,2,99,2116,562,567,1129,"21 de agosto de 1994"
16,2,99,2117,470,537,1007,"21 de agosto de 1994"
16,2,99,2118,665,702,1367,"21 de agosto de 1994"
16,2,99,2119,385,413,798,"21 de agosto de 1994"
16,2,99,2120,231,209,440,"21 de agosto de 1994"
16,2,99,2121,298,290,588,"21 de agosto de 1994"
16,2,99,2122,266,236,502,"21 de agosto de 1994"
16,2,99,2123,394,392,786,"21 de agosto de 1994"
16,2,99,2124,108,110,218,"21 de agosto de 1994"
16,2,99,2125,190,187,377,"21 de agosto de 1994"
16,2,99,2126,184,153,337,"21 de agosto de 1994"
16,2,99,2127,215,209,424,"21 de agosto de 1994"
16,2,99,2128,85,82,167,"21 de agosto de 1994"
16,2,99,2129,78,69,147,"21 de agosto de 1994"
16,2,100,2130,302,343,645,"21 de agosto de 1994"
16,2,100,2131,447,522,969,"21 de agosto de 1994"
16,2,100,2132,210,129,339,"21 de agosto de 1994"
16,2,100,2133,357,325,682,"21 de agosto de 1994"
16,2,100,2134,191,164,355,"21 de agosto de 1994"
16,2,100,2135,266,252,518,"21 de agosto de 1994"
16,2,100,2136,191,168,359,"21 de agosto de 1994"
16,2,100,2137,107,106,213,"21 de agosto de 1994"
16,2,100,2138,155,160,315,"21 de agosto de 1994"
16,2,100,2139,261,256,517,"21 de agosto de 1994"
16,2,100,2140,213,211,424,"21 de agosto de 1994"
16,2,100,2141,294,290,584,"21 de agosto de 1994"
16,2,100,2142,136,137,273,"21 de agosto de 1994"
16,2,100,2143,59,56,115,"21 de agosto de 1994"
16,2,100,2144,125,131,256,"21 de agosto de 1994"
16,2,100,2145,89,103,192,"21 de agosto de 1994"
16,2,100,2146,439,448,887,"21 de agosto de 1994"
16,2,100,2147,196,207,403,"21 de agosto de 1994"
16,2,100,2148,47,47,94,"21 de agosto de 1994"
16,2,100,2149,97,85,182,"21 de agosto de 1994"
16,2,100,2150,69,69,138,"21 de agosto de 1994"
16,2,102,2160,211,185,396,"21 de agosto de 1994"
16,2,102,2161,278,247,525,"21 de agosto de 1994"
16,2,102,2162,69,53,122,"21 de agosto de 1994"
16,2,102,2163,122,96,218,"21 de agosto de 1994"
16,2,102,2164,95,90,185,"21 de agosto de 1994"
16,2,102,2165,84,75,159,"21 de agosto de 1994"
16,2,102,2166,311,318,629,"21 de agosto de 1994"
16,2,102,2167,103,89,192,"21 de agosto de 1994"
16,2,102,2168,270,250,520,"21 de agosto de 1994"
16,2,102,2169,358,330,688,"21 de agosto de 1994"
16,2,102,2170,256,223,479,"21 de agosto de 1994"
16,2,102,2171,197,144,341,"21 de agosto de 1994"
16,2,102,2172,98,80,178,"21 de agosto de 1994"
16,2,102,2173,127,113,240,"21 de agosto de 1994"
16,2,102,2174,53,39,92,"21 de agosto de 1994"
16,2,111,2538,300,326,626,"21 de agosto de 1994"
16,2,111,2539,186,241,427,"21 de agosto de 1994"
16,2,111,2540,412,474,886,"21 de agosto de 1994"
16,2,111,2541,336,421,757,"21 de agosto de 1994"
16,2,111,2542,567,706,1273,"21 de agosto de 1994"
16,2,111,2543,358,412,770,"21 de agosto de 1994"
16,2,111,2544,386,456,842,"21 de agosto de 1994"
16,2,111,2545,412,500,912,"21 de agosto de 1994"
16,2,111,2546,406,476,882,"21 de agosto de 1994"
16,2,111,2547,242,323,565,"21 de agosto de 1994"
16,2,111,2548,205,270,475,"21 de agosto de 1994"
16,2,111,2549,383,453,836,"21 de agosto de 1994"
16,2,111,2550,571,699,1270,"21 de agosto de 1994"
16,2,111,2551,222,219,441,"21 de agosto de 1994"
16,2,111,2552,374,506,880,"21 de agosto de 1994"
16,2,111,2553,290,326,616,"21 de agosto de 1994"
16,2,111,2554,92,111,203,"21 de agosto de 1994"
16,2,111,2555,330,356,686,"21 de agosto de 1994"
16,2,111,2556,277,364,641,"21 de agosto de 1994"
16,2,111,2557,458,570,1028,"21 de agosto de 1994"
16,2,111,2558,239,404,643,"21 de agosto de 1994"
16,2,111,2559,293,367,660,"21 de agosto de 1994"
16,2,111,2560,428,525,953,"21 de agosto de 1994"
16,2,111,2561,275,400,675,"21 de agosto de 1994"
16,2,111,2562,112,136,248,"21 de agosto de 1994"
16,2,111,2563,264,344,608,"21 de agosto de 1994"
16,2,111,2564,358,445,803,"21 de agosto de 1994"
16,2,111,2565,518,597,1115,"21 de agosto de 1994"
16,2,111,2566,279,336,615,"21 de agosto de 1994"
16,2,111,2567,221,323,544,"21 de agosto de 1994"
16,2,111,2568,444,483,927,"21 de agosto de 1994"
16,2,111,2569,151,202,353,"21 de agosto de 1994"
16,3,16,257,239,285,524,"21 de agosto de 1994"
16,3,16,258,284,345,629,"21 de agosto de 1994"
16,3,16,259,408,497,905,"21 de agosto de 1994"
16,3,16,260,303,347,650,"21 de agosto de 1994"
16,3,16,261,159,248,407,"21 de agosto de 1994"
16,3,16,262,284,495,779,"21 de agosto de 1994"
16,3,16,263,239,277,516,"21 de agosto de 1994"
16,3,16,264,179,213,392,"21 de agosto de 1994"
16,3,16,265,184,258,442,"21 de agosto de 1994"
16,3,16,266,49,80,129,"21 de agosto de 1994"
16,3,16,267,341,448,789,"21 de agosto de 1994"
16,3,16,268,144,181,325,"21 de agosto de 1994"
16,3,16,269,158,224,382,"21 de agosto de 1994"
16,3,16,270,204,259,463,"21 de agosto de 1994"
16,3,16,271,162,229,391,"21 de agosto de 1994"
16,3,16,272,170,285,455,"21 de agosto de 1994"
16,3,16,273,180,271,451,"21 de agosto de 1994"
16,3,16,274,179,224,403,"21 de agosto de 1994"
16,3,16,275,149,179,328,"21 de agosto de 1994"
16,3,16,276,84,134,218,"21 de agosto de 1994"
16,3,16,277,186,314,500,"21 de agosto de 1994"
16,3,16,278,286,381,667,"21 de agosto de 1994"
16,3,16,279,161,201,362,"21 de agosto de 1994"
16,3,16,280,255,341,596,"21 de agosto de 1994"
16,3,16,281,165,224,389,"21 de agosto de 1994"
16,3,16,282,288,384,672,"21 de agosto de 1994"
16,3,16,283,83,80,163,"21 de agosto de 1994"
16,3,16,284,207,259,466,"21 de agosto de 1994"
16,3,16,285,192,358,550,"21 de agosto de 1994"
16,3,24,372,503,595,1098,"21 de agosto de 1994"
16,3,24,373,526,664,1190,"21 de agosto de 1994"
16,3,24,374,395,491,886,"21 de agosto de 1994"
16,3,24,375,364,436,800,"21 de agosto de 1994"
16,3,24,376,519,598,1117,"21 de agosto de 1994"
16,3,24,377,337,377,714,"21 de agosto de 1994"
16,3,24,378,393,389,782,"21 de agosto de 1994"
16,3,24,379,223,226,449,"21 de agosto de 1994"
16,3,32,457,599,644,1243,"21 de agosto de 1994"
16,3,32,458,287,296,583,"21 de agosto de 1994"
16,3,32,459,185,225,410,"21 de agosto de 1994"
16,3,32,460,186,178,364,"21 de agosto de 1994"
16,3,32,461,427,481,908,"21 de agosto de 1994"
16,3,32,462,148,165,313,"21 de agosto de 1994"
16,3,32,463,414,436,850,"21 de agosto de 1994"
16,3,32,464,491,448,939,"21 de agosto de 1994"
16,3,32,465,279,287,566,"21 de agosto de 1994"
16,3,32,466,202,239,441,"21 de agosto de 1994"
16,3,44,712,418,493,911,"21 de agosto de 1994"
16,3,44,713,283,391,674,"21 de agosto de 1994"
16,3,44,714,452,585,1037,"21 de agosto de 1994"
16,3,44,715,323,401,724,"21 de agosto de 1994"
16,3,44,716,401,439,840,"21 de agosto de 1994"
16,3,44,717,290,355,645,"21 de agosto de 1994"
16,3,44,718,241,291,532,"21 de agosto de 1994"
16,3,44,719,284,331,615,"21 de agosto de 1994"
16,3,44,720,150,193,343,"21 de agosto de 1994"
16,3,44,721,234,296,530,"21 de agosto de 1994"
16,3,44,722,385,430,815,"21 de agosto de 1994"
16,3,44,723,244,293,537,"21 de agosto de 1994"
16,3,44,724,128,154,282,"21 de agosto de 1994"
16,3,44,725,124,188,312,"21 de agosto de 1994"
16,3,57,1321,446,506,952,"21 de agosto de 1994"
16,3,57,1322,341,429,770,"21 de agosto de 1994"
16,3,57,1323,491,532,1023,"21 de agosto de 1994"
16,3,57,1324,510,627,1137,"21 de agosto de 1994"
16,3,57,1325,193,210,403,"21 de agosto de 1994"
16,3,57,1326,310,348,658,"21 de agosto de 1994"
16,3,57,1327,331,346,677,"21 de agosto de 1994"
16,3,57,1328,445,443,888,"21 de agosto de 1994"
16,3,57,1329,253,271,524,"21 de agosto de 1994"
16,3,57,1330,166,194,360,"21 de agosto de 1994"
16,3,57,1331,294,296,590,"21 de agosto de 1994"
16,3,57,1332,272,281,553,"21 de agosto de 1994"
16,3,57,1333,309,345,654,"21 de agosto de 1994"
16,3,57,1334,317,371,688,"21 de agosto de 1994"
16,3,57,1335,212,234,446,"21 de agosto de 1994"
16,3,67,1456,569,696,1265,"21 de agosto de 1994"
16,3,67,1457,453,508,961,"21 de agosto de 1994"
16,3,67,1458,579,660,1239,"21 de agosto de 1994"
16,3,67,1459,711,800,1511,"21 de agosto de 1994"
16,3,67,1460,690,761,1451,"21 de agosto de 1994"
16,3,67,1461,309,380,689,"21 de agosto de 1994"
16,3,67,1462,474,563,1037,"21 de agosto de 1994"
16,3,67,1463,196,257,453,"21 de agosto de 1994"
16,3,67,1464,358,433,791,"21 de agosto de 1994"
16,3,67,1465,455,538,993,"21 de agosto de 1994"
16,3,67,1466,374,491,865,"21 de agosto de 1994"
16,3,67,1467,483,611,1094,"21 de agosto de 1994"
16,3,67,1468,224,298,522,"21 de agosto de 1994"
16,3,67,1469,414,518,932,"21 de agosto de 1994"
16,3,67,1470,537,593,1130,"21 de agosto de 1994"
16,3,67,1471,549,641,1190,"21 de agosto de 1994"
16,3,67,1472,446,546,992,"21 de agosto de 1994"
16,3,67,1473,597,666,1263,"21 de agosto de 1994"
16,3,67,1474,368,433,801,"21 de agosto de 1994"
16,3,67,1475,377,473,850,"21 de agosto de 1994"
16,3,67,1476,679,778,1457,"21 de agosto de 1994"
16,3,67,1477,588,676,1264,"21 de agosto de 1994"
16,3,67,1478,351,427,778,"21 de agosto de 1994"
16,3,67,1479,525,562,1087,"21 de agosto de 1994"
16,3,67,1480,550,542,1092,"21 de agosto de 1994"
16,3,67,1481,256,271,527,"21 de agosto de 1994"
16,3,67,1482,243,288,531,"21 de agosto de 1994"
16,3,67,1483,434,361,795,"21 de agosto de 1994"
16,3,67,1484,218,264,482,"21 de agosto de 1994"
16,3,67,1485,286,370,656,"21 de agosto de 1994"
16,3,67,1486,269,300,569,"21 de agosto de 1994"
16,3,67,1487,284,316,600,"21 de agosto de 1994"
16,3,67,1488,184,210,394,"21 de agosto de 1994"
16,3,67,1489,249,295,544,"21 de agosto de 1994"
16,3,67,1490,283,306,589,"21 de agosto de 1994"
16,3,67,1491,337,317,654,"21 de agosto de 1994"
16,3,67,1492,260,331,591,"21 de agosto de 1994"
16,3,67,1493,349,369,718,"21 de agosto de 1994"
16,3,67,1494,90,115,205,"21 de agosto de 1994"
16,3,67,1495,70,65,135,"21 de agosto de 1994"
16,3,67,1496,283,281,564,"21 de agosto de 1994"
16,3,67,1497,348,423,771,"21 de agosto de 1994"
16,3,80,1799,383,443,826,"21 de agosto de 1994"
16,3,80,1800,621,704,1325,"21 de agosto de 1994"
16,3,80,1801,689,818,1507,"21 de agosto de 1994"
16,3,80,1802,687,756,1443,"21 de agosto de 1994"
16,3,80,1803,675,836,1511,"21 de agosto de 1994"
16,3,80,1804,570,724,1294,"21 de agosto de 1994"
16,3,80,1805,390,462,852,"21 de agosto de 1994"
16,3,80,1806,486,566,1052,"21 de agosto de 1994"
16,3,80,1807,146,182,328,"21 de agosto de 1994"
16,3,80,1808,173,220,393,"21 de agosto de 1994"
16,3,80,1809,146,156,302,"21 de agosto de 1994"
16,3,80,1810,280,313,593,"21 de agosto de 1994"
16,3,80,1811,139,196,335,"21 de agosto de 1994"
16,3,80,1812,259,359,618,"21 de agosto de 1994"
16,3,80,1813,151,211,362,"21 de agosto de 1994"
16,3,80,1814,164,174,338,"21 de agosto de 1994"
16,3,80,1815,286,337,623,"21 de agosto de 1994"
16,3,80,1816,168,212,380,"21 de agosto de 1994"
16,3,80,1817,234,278,512,"21 de agosto de 1994"
16,3,80,1818,298,375,673,"21 de agosto de 1994"
16,3,80,1819,194,221,415,"21 de agosto de 1994"
16,3,80,1820,322,388,710,"21 de agosto de 1994"
16,3,80,2673,154,162,316,"21 de agosto de 1994"
16,3,80,2674,154,191,345,"21 de agosto de 1994"
16,3,108,2389,511,640,1151,"21 de agosto de 1994"
16,3,108,2390,411,498,909,"21 de agosto de 1994"
16,3,108,2391,540,637,1177,"21 de agosto de 1994"
16,3,108,2392,500,550,1050,"21 de agosto de 1994"
16,3,108,2393,446,539,985,"21 de agosto de 1994"
16,3,108,2394,466,564,1030,"21 de agosto de 1994"
16,3,108,2395,286,324,610,"21 de agosto de 1994"
16,3,108,2396,348,374,722,"21 de agosto de 1994"
16,3,108,2397,392,450,842,"21 de agosto de 1994"
16,3,108,2398,370,441,811,"21 de agosto de 1994"
16,3,108,2399,631,722,1353,"21 de agosto de 1994"
16,3,108,2400,301,387,688,"21 de agosto de 1994"
16,3,108,2401,326,384,710,"21 de agosto de 1994"
16,3,108,2402,314,368,682,"21 de agosto de 1994"
16,3,108,2403,511,609,1120,"21 de agosto de 1994"
16,3,108,2404,549,632,1181,"21 de agosto de 1994"
16,3,108,2405,361,427,788,"21 de agosto de 1994"
16,3,108,2406,575,613,1188,"21 de agosto de 1994"
16,3,108,2407,435,467,902,"21 de agosto de 1994"
16,3,108,2408,458,514,972,"21 de agosto de 1994"
16,3,108,2409,386,440,826,"21 de agosto de 1994"
16,3,108,2410,421,500,921,"21 de agosto de 1994"
16,3,108,2411,598,647,1245,"21 de agosto de 1994"
16,3,108,2412,615,690,1305,"21 de agosto de 1994"
16,3,108,2413,290,334,624,"21 de agosto de 1994"
16,3,108,2414,275,315,590,"21 de agosto de 1994"
16,3,108,2415,242,255,497,"21 de agosto de 1994"
16,3,108,2416,530,602,1132,"21 de agosto de 1994"
16,3,108,2417,254,290,544,"21 de agosto de 1994"
16,3,108,2418,364,448,812,"21 de agosto de 1994"
16,3,108,2419,305,364,669,"21 de agosto de 1994"
16,3,108,2420,380,423,803,"21 de agosto de 1994"
16,3,108,2421,411,581,992,"21 de agosto de 1994"
16,3,108,2422,545,647,1192,"21 de agosto de 1994"
16,3,108,2423,461,501,962,"21 de agosto de 1994"
16,3,108,2424,186,227,413,"21 de agosto de 1994"
16,3,108,2425,250,286,536,"21 de agosto de 1994"
16,3,108,2426,194,249,443,"21 de agosto de 1994"
16,3,108,2427,240,317,557,"21 de agosto de 1994"
16,3,108,2428,235,301,536,"21 de agosto de 1994"
16,3,108,2429,114,115,229,"21 de agosto de 1994"
16,3,108,2430,180,192,372,"21 de agosto de 1994"
16,3,108,2431,191,247,438,"21 de agosto de 1994"
16,3,108,2432,146,160,306,"21 de agosto de 1994"
16,3,108,2433,250,286,536,"21 de agosto de 1994"
16,3,108,2434,184,229,413,"21 de agosto de 1994"
16,3,108,2435,102,88,190,"21 de agosto de 1994"
16,4,4,38,290,334,624,"21 de agosto de 1994"
16,4,4,39,368,431,799,"21 de agosto de 1994"
16,4,4,40,259,309,568,"21 de agosto de 1994"
16,4,4,41,442,535,977,"21 de agosto de 1994"
16,4,4,42,288,319,607,"21 de agosto de 1994"
16,4,4,43,345,433,778,"21 de agosto de 1994"
16,4,4,44,176,215,391,"21 de agosto de 1994"
16,4,4,45,582,624,1206,"21 de agosto de 1994"
16,4,4,46,210,216,426,"21 de agosto de 1994"
16,4,4,47,38,50,88,"21 de agosto de 1994"
16,4,4,48,108,139,247,"21 de agosto de 1994"
16,4,4,49,166,180,346,"21 de agosto de 1994"
16,4,4,50,221,328,549,"21 de agosto de 1994"
16,4,4,51,314,374,688,"21 de agosto de 1994"
16,4,28,411,341,449,790,"21 de agosto de 1994"
16,4,28,412,348,413,761,"21 de agosto de 1994"
16,4,28,413,272,338,610,"21 de agosto de 1994"
16,4,28,414,308,450,758,"21 de agosto de 1994"
16,4,28,415,38,55,93,"21 de agosto de 1994"
16,4,28,416,193,380,573,"21 de agosto de 1994"
16,4,28,417,232,331,563,"21 de agosto de 1994"
16,4,28,418,196,289,485,"21 de agosto de 1994"
16,4,28,419,109,124,233,"21 de agosto de 1994"
16,4,46,756,370,396,766,"21 de agosto de 1994"
16,4,46,757,241,249,490,"21 de agosto de 1994"
16,4,46,758,609,760,1369,"21 de agosto de 1994"
16,4,46,759,410,524,934,"21 de agosto de 1994"
16,4,46,760,656,769,1425,"21 de agosto de 1994"
16,4,46,761,339,413,752,"21 de agosto de 1994"
16,4,46,762,390,486,876,"21 de agosto de 1994"
16,4,46,763,254,330,584,"21 de agosto de 1994"
16,4,46,764,486,617,1103,"21 de agosto de 1994"
16,4,46,765,355,417,772,"21 de agosto de 1994"
16,4,46,766,511,635,1146,"21 de agosto de 1994"
16,4,46,767,62,85,147,"21 de agosto de 1994"
16,4,46,768,171,215,386,"21 de agosto de 1994"
16,4,46,769,340,431,771,"21 de agosto de 1994"
16,4,46,770,504,617,1121,"21 de agosto de 1994"
16,4,46,771,340,447,787,"21 de agosto de 1994"
16,4,46,772,362,394,756,"21 de agosto de 1994"
16,4,46,773,305,355,660,"21 de agosto de 1994"
16,4,61,1369,496,640,1136,"21 de agosto de 1994"
16,4,61,1370,635,762,1397,"21 de agosto de 1994"
16,4,61,1371,68,78,146,"21 de agosto de 1994"
16,4,61,1372,93,121,214,"21 de agosto de 1994"
16,4,61,1373,532,661,1193,"21 de agosto de 1994"
16,4,61,1374,183,193,376,"21 de agosto de 1994"
16,4,61,1375,212,229,441,"21 de agosto de 1994"
16,4,61,1376,192,214,406,"21 de agosto de 1994"
16,4,61,1377,206,228,434,"21 de agosto de 1994"
16,4,64,1407,54,49,103,"21 de agosto de 1994"
16,4,64,1408,52,57,109,"21 de agosto de 1994"
16,4,64,1409,280,330,610,"21 de agosto de 1994"
16,4,64,1410,191,244,435,"21 de agosto de 1994"
16,4,64,1411,276,365,641,"21 de agosto de 1994"
16,4,64,1412,319,394,713,"21 de agosto de 1994"
16,4,64,1413,368,446,814,"21 de agosto de 1994"
16,4,64,1414,247,374,621,"21 de agosto de 1994"
16,4,64,1415,165,221,386,"21 de agosto de 1994"
16,4,64,1416,43,89,132,"21 de agosto de 1994"
16,4,64,1417,306,400,706,"21 de agosto de 1994"
16,4,64,1418,173,207,380,"21 de agosto de 1994"
16,4,64,1419,243,293,536,"21 de agosto de 1994"
16,4,64,1420,102,149,251,"21 de agosto de 1994"
16,4,64,1421,378,577,955,"21 de agosto de 1994"
16,4,64,1422,124,179,303,"21 de agosto de 1994"
16,4,64,1423,162,211,373,"21 de agosto de 1994"
16,4,64,1424,291,396,687,"21 de agosto de 1994"
16,4,64,1425,291,380,671,"21 de agosto de 1994"
16,4,68,1498,287,382,669,"21 de agosto de 1994"
16,4,68,1499,182,252,434,"21 de agosto de 1994"
16,4,68,1500,316,441,757,"21 de agosto de 1994"
16,4,68,1501,276,409,685,"21 de agosto de 1994"
16,4,68,1502,163,217,380,"21 de agosto de 1994"
16,4,68,1503,276,409,685,"21 de agosto de 1994"
16,4,68,1504,351,464,815,"21 de agosto de 1994"
16,4,68,1505,180,262,442,"21 de agosto de 1994"
16,4,68,1506,304,359,663,"21 de agosto de 1994"
16,4,68,1507,414,576,990,"21 de agosto de 1994"
16,4,68,1508,446,502,948,"21 de agosto de 1994"
16,4,68,1509,203,276,479,"21 de agosto de 1994"
16,4,68,1510,128,178,306,"21 de agosto de 1994"
16,4,68,1511,177,243,420,"21 de agosto de 1994"
16,4,68,1512,282,439,721,"21 de agosto de 1994"
16,4,68,1513,196,308,504,"21 de agosto de 1994"
16,4,68,1514,183,260,443,"21 de agosto de 1994"
16,4,68,1515,219,234,453,"21 de agosto de 1994"
16,4,68,1516,158,263,421,"21 de agosto de 1994"
16,4,70,1529,433,473,906,"21 de agosto de 1994"
16,4,70,1530,569,622,1191,"21 de agosto de 1994"
16,4,70,1531,433,524,957,"21 de agosto de 1994"
16,4,70,1532,464,537,1001,"21 de agosto de 1994"
16,4,70,1533,342,353,695,"21 de agosto de 1994"
16,4,70,1534,432,491,923,"21 de agosto de 1994"
16,4,70,1535,515,643,1158,"21 de agosto de 1994"
16,4,70,1536,340,415,755,"21 de agosto de 1994"
16,4,70,1537,535,716,1251,"21 de agosto de 1994"
16,4,70,1538,407,458,865,"21 de agosto de 1994"
16,4,70,1539,384,478,862,"21 de agosto de 1994"
16,4,70,1540,309,365,674,"21 de agosto de 1994"
16,4,70,1541,473,570,1043,"21 de agosto de 1994"
16,4,70,1542,145,166,311,"21 de agosto de 1994"
16,4,70,1543,724,835,1559,"21 de agosto de 1994"
16,4,70,1544,430,487,917,"21 de agosto de 1994"
16,4,70,1545,493,556,1049,"21 de agosto de 1994"
16,4,70,1546,397,528,925,"21 de agosto de 1994"
16,4,70,1547,362,472,834,"21 de agosto de 1994"
16,4,70,1548,322,391,713,"21 de agosto de 1994"
16,4,70,1549,207,215,422,"21 de agosto de 1994"
16,4,70,1550,238,324,562,"21 de agosto de 1994"
16,4,70,1551,239,293,532,"21 de agosto de 1994"
16,4,70,1552,405,515,920,"21 de agosto de 1994"
16,4,70,1553,372,449,821,"21 de agosto de 1994"
16,4,70,1554,272,339,611,"21 de agosto de 1994"
16,4,70,1555,350,418,768,"21 de agosto de 1994"
16,4,70,1556,264,323,587,"21 de agosto de 1994"
16,4,70,1557,244,307,551,"21 de agosto de 1994"
16,4,70,1558,258,297,555,"21 de agosto de 1994"
16,4,70,1559,309,394,703,"21 de agosto de 1994"
16,4,70,1560,336,380,716,"21 de agosto de 1994"
16,4,70,1561,314,392,706,"21 de agosto de 1994"
16,4,70,1562,324,429,753,"21 de agosto de 1994"
16,4,70,1563,423,555,978,"21 de agosto de 1994"
16,4,70,1564,275,336,611,"21 de agosto de 1994"
16,4,70,1565,312,421,733,"21 de agosto de 1994"
16,4,70,1566,510,666,1176,"21 de agosto de 1994"
16,4,70,1567,542,687,1229,"21 de agosto de 1994"
16,4,70,1568,466,600,1066,"21 de agosto de 1994"
16,4,70,1569,281,369,650,"21 de agosto de 1994"
16,4,70,1570,373,446,819,"21 de agosto de 1994"
16,4,70,1571,440,512,952,"21 de agosto de 1994"
16,4,70,1572,509,627,1136,"21 de agosto de 1994"
16,4,70,1573,477,691,1168,"21 de agosto de 1994"
16,4,70,1574,111,135,246,"21 de agosto de 1994"
16,4,70,1575,119,164,283,"21 de agosto de 1994"
16,4,70,1576,244,317,561,"21 de agosto de 1994"
16,4,70,1577,317,427,744,"21 de agosto de 1994"
16,4,70,1578,160,210,370,"21 de agosto de 1994"
16,4,70,1579,159,215,374,"21 de agosto de 1994"
16,4,70,1580,228,308,536,"21 de agosto de 1994"
16,4,70,1581,100,124,224,"21 de agosto de 1994"
16,4,70,1582,65,81,146,"21 de agosto de 1994"
16,4,70,1583,274,356,630,"21 de agosto de 1994"
16,4,70,1584,415,592,1007,"21 de agosto de 1994"
16,4,70,1585,129,193,322,"21 de agosto de 1994"
16,4,70,1586,223,388,611,"21 de agosto de 1994"
16,4,70,1587,350,740,1090,"21 de agosto de 1994"
16,4,70,1588,96,146,242,"21 de agosto de 1994"
16,4,70,1589,368,467,835,"21 de agosto de 1994"
16,4,72,1601,249,314,563,"21 de agosto de 1994"
16,4,72,1602,545,700,1245,"21 de agosto de 1994"
16,4,72,1603,386,452,838,"21 de agosto de 1994"
16,4,72,1604,348,477,825,"21 de agosto de 1994"
16,4,72,1605,272,374,646,"21 de agosto de 1994"
16,4,72,1606,375,471,846,"21 de agosto de 1994"
16,4,72,1607,576,751,1327,"21 de agosto de 1994"
16,4,72,1608,444,531,975,"21 de agosto de 1994"
16,4,72,1609,650,707,1357,"21 de agosto de 1994"
16,4,72,1610,296,390,686,"21 de agosto de 1994"
16,4,72,1611,505,656,1161,"21 de agosto de 1994"
16,4,72,1612,321,393,714,"21 de agosto de 1994"
16,4,72,1613,540,655,1195,"21 de agosto de 1994"
16,4,72,1614,259,274,533,"21 de agosto de 1994"
16,4,72,1615,457,608,1065,"21 de agosto de 1994"
16,4,72,1616,287,372,659,"21 de agosto de 1994"
16,4,72,1617,232,308,540,"21 de agosto de 1994"
16,4,72,1618,330,422,752,"21 de agosto de 1994"
16,4,72,1619,262,342,604,"21 de agosto de 1994"
16,4,72,1620,256,312,568,"21 de agosto de 1994"
16,4,72,1621,206,340,546,"21 de agosto de 1994"
16,4,72,1622,87,230,317,"21 de agosto de 1994"
16,4,72,1623,388,521,909,"21 de agosto de 1994"
16,4,72,1624,529,656,1185,"21 de agosto de 1994"
16,4,72,1625,605,709,1314,"21 de agosto de 1994"
16,4,72,1626,258,324,582,"21 de agosto de 1994"
16,4,72,1627,113,132,245,"21 de agosto de 1994"
16,4,72,1628,201,321,522,"21 de agosto de 1994"
16,4,72,1629,335,455,790,"21 de agosto de 1994"
16,4,72,1630,149,193,342,"21 de agosto de 1994"
16,4,72,1631,231,274,505,"21 de agosto de 1994"
16,4,72,1632,295,391,686,"21 de agosto de 1994"
16,4,72,1633,363,473,836,"21 de agosto de 1994"
16,4,72,1634,203,357,560,"21 de agosto de 1994"
16,4,72,1635,256,494,750,"21 de agosto de 1994"
16,4,72,1636,360,460,820,"21 de agosto de 1994"
16,4,72,1637,532,707,1239,"21 de agosto de 1994"
16,4,72,1638,533,588,1121,"21 de agosto de 1994"
16,4,72,1639,182,217,399,"21 de agosto de 1994"
16,4,72,1640,283,380,663,"21 de agosto de 1994"
16,4,72,1641,256,364,620,"21 de agosto de 1994"
16,4,72,1642,195,280,475,"21 de agosto de 1994"
16,4,72,1643,254,356,610,"21 de agosto de 1994"
16,4,72,1644,213,364,577,"21 de agosto de 1994"
16,4,72,1645,225,353,578,"21 de agosto de 1994"
16,4,72,1646,307,478,785,"21 de agosto de 1994"
16,4,110,2531,237,296,533,"21 de agosto de 1994"
16,4,110,2532,213,299,512,"21 de agosto de 1994"
16,4,110,2533,172,269,441,"21 de agosto de 1994"
16,4,110,2534,68,115,183,"21 de agosto de 1994"
16,4,110,2535,109,176,285,"21 de agosto de 1994"
16,4,110,2536,165,216,381,"21 de agosto de 1994"
16,4,110,2537,228,315,543,"21 de agosto de 1994"
16,5,23,361,247,316,563,"21 de agosto de 1994"
16,5,23,362,254,354,608,"21 de agosto de 1994"
16,5,23,363,204,287,491,"21 de agosto de 1994"
16,5,23,364,278,340,618,"21 de agosto de 1994"
16,5,23,365,225,260,485,"21 de agosto de 1994"
16,5,23,366,222,281,503,"21 de agosto de 1994"
16,5,23,367,249,292,541,"21 de agosto de 1994"
16,5,23,368,189,230,419,"21 de agosto de 1994"
16,5,23,369,385,501,886,"21 de agosto de 1994"
16,5,23,370,183,200,383,"21 de agosto de 1994"
16,5,23,371,272,367,639,"21 de agosto de 1994"
16,5,43,685,289,328,617,"21 de agosto de 1994"
16,5,43,686,311,421,732,"21 de agosto de 1994"
16,5,43,687,263,313,576,"21 de agosto de 1994"
16,5,43,688,448,547,995,"21 de agosto de 1994"
16,5,43,689,446,548,994,"21 de agosto de 1994"
16,5,43,690,470,616,1086,"21 de agosto de 1994"
16,5,43,691,359,431,790,"21 de agosto de 1994"
16,5,43,692,388,436,824,"21 de agosto de 1994"
16,5,43,693,413,524,937,"21 de agosto de 1994"
16,5,43,694,234,340,574,"21 de agosto de 1994"
16,5,43,695,488,518,1006,"21 de agosto de 1994"
16,5,43,696,391,526,917,"21 de agosto de 1994"
16,5,43,697,357,482,839,"21 de agosto de 1994"
16,5,43,698,471,571,1042,"21 de agosto de 1994"
16,5,43,699,238,277,515,"21 de agosto de 1994"
16,5,43,700,237,308,545,"21 de agosto de 1994"
16,5,43,701,297,372,669,"21 de agosto de 1994"
16,5,43,702,380,475,855,"21 de agosto de 1994"
16,5,43,703,666,804,1470,"21 de agosto de 1994"
16,5,43,704,355,480,835,"21 de agosto de 1994"
16,5,43,705,286,382,668,"21 de agosto de 1994"
16,5,43,706,276,382,658,"21 de agosto de 1994"
16,5,43,707,484,587,1071,"21 de agosto de 1994"
16,5,43,708,673,876,1549,"21 de agosto de 1994"
16,5,43,709,351,426,777,"21 de agosto de 1994"
16,5,43,710,322,399,721,"21 de agosto de 1994"
16,5,43,711,254,322,576,"21 de agosto de 1994"
16,5,85,1898,290,316,606,"21 de agosto de 1994"
16,5,85,1899,441,506,947,"21 de agosto de 1994"
16,5,85,1900,528,596,1124,"21 de agosto de 1994"
16,5,85,1901,390,471,861,"21 de agosto de 1994"
16,5,85,1902,350,397,747,"21 de agosto de 1994"
16,5,85,1903,350,404,754,"21 de agosto de 1994"
16,5,85,1904,375,433,808,"21 de agosto de 1994"
16,5,85,1905,399,477,876,"21 de agosto de 1994"
16,5,85,1906,287,362,649,"21 de agosto de 1994"
16,5,85,1907,304,399,703,"21 de agosto de 1994"
16,5,85,1908,367,446,813,"21 de agosto de 1994"
16,5,85,1909,448,521,969,"21 de agosto de 1994"
16,5,85,1910,329,363,692,"21 de agosto de 1994"
16,5,85,1911,365,480,845,"21 de agosto de 1994"
16,5,105,2339,346,476,822,"21 de agosto de 1994"
16,5,105,2340,361,466,827,"21 de agosto de 1994"
16,5,105,2341,417,517,934,"21 de agosto de 1994"
16,5,105,2342,242,320,562,"21 de agosto de 1994"
16,5,105,2343,381,484,865,"21 de agosto de 1994"
16,5,105,2344,231,309,540,"21 de agosto de 1994"
16,5,105,2345,98,121,219,"21 de agosto de 1994"
16,5,105,2346,129,198,327,"21 de agosto de 1994"
16,5,105,2347,199,237,436,"21 de agosto de 1994"
16,5,105,2348,323,369,692,"21 de agosto de 1994"
16,5,105,2349,236,263,499,"21 de agosto de 1994"
16,5,105,2350,464,609,1073,"21 de agosto de 1994"
16,5,105,2351,128,166,294,"21 de agosto de 1994"
16,5,105,2352,309,419,728,"21 de agosto de 1994"
16,5,105,2353,202,263,465,"21 de agosto de 1994"
16,5,105,2354,245,472,717,"21 de agosto de 1994"
16,5,105,2355,131,215,346,"21 de agosto de 1994"
16,5,105,2356,141,160,301,"21 de agosto de 1994"
16,5,109,2436,333,389,722,"21 de agosto de 1994"
16,5,109,2437,422,456,878,"21 de agosto de 1994"
16,5,109,2438,496,550,1046,"21 de agosto de 1994"
16,5,109,2439,321,377,698,"21 de agosto de 1994"
16,5,109,2440,405,452,857,"21 de agosto de 1994"
16,5,109,2441,546,635,1181,"21 de agosto de 1994"
16,5,109,2442,453,585,1038,"21 de agosto de 1994"
16,5,109,2443,417,469,886,"21 de agosto de 1994"
16,5,109,2444,249,317,566,"21 de agosto de 1994"
16,5,109,2445,286,391,677,"21 de agosto de 1994"
16,5,109,2446,241,273,514,"21 de agosto de 1994"
16,5,109,2447,533,596,1129,"21 de agosto de 1994"
16,5,109,2448,422,530,952,"21 de agosto de 1994"
16,5,109,2449,412,512,924,"21 de agosto de 1994"
16,5,109,2450,368,439,807,"21 de agosto de 1994"
16,5,109,2451,559,663,1222,"21 de agosto de 1994"
16,5,109,2452,333,403,736,"21 de agosto de 1994"
16,5,109,2453,324,396,720,"21 de agosto de 1994"
16,5,109,2454,485,630,1115,"21 de agosto de 1994"
16,5,109,2455,275,337,612,"21 de agosto de 1994"
16,5,109,2456,327,416,743,"21 de agosto de 1994"
16,5,109,2457,449,522,971,"21 de agosto de 1994"
16,5,109,2458,437,554,991,"21 de agosto de 1994"
16,5,109,2459,565,641,1206,"21 de agosto de 1994"
16,5,109,2460,509,637,1146,"21 de agosto de 1994"
16,5,109,2461,238,342,580,"21 de agosto de 1994"
16,5,109,2462,709,910,1619,"21 de agosto de 1994"
16,5,109,2463,390,434,824,"21 de agosto de 1994"
16,5,109,2464,255,352,607,"21 de agosto de 1994"
16,5,109,2465,282,357,639,"21 de agosto de 1994"
16,5,109,2466,381,444,825,"21 de agosto de 1994"
16,5,109,2467,350,426,776,"21 de agosto de 1994"
16,5,109,2468,323,403,726,"21 de agosto de 1994"
16,5,109,2469,356,378,734,"21 de agosto de 1994"
16,5,109,2470,368,446,814,"21 de agosto de 1994"
16,5,109,2471,442,535,977,"21 de agosto de 1994"
16,5,109,2472,529,655,1184,"21 de agosto de 1994"
16,5,109,2473,276,324,600,"21 de agosto de 1994"
16,5,109,2474,256,424,680,"21 de agosto de 1994"
16,5,109,2475,228,298,526,"21 de agosto de 1994"
16,5,109,2476,726,827,1553,"21 de agosto de 1994"
16,5,109,2477,296,0,296,"21 de agosto de 1994"
16,5,109,2478,321,410,731,"21 de agosto de 1994"
16,5,109,2479,151,209,360,"21 de agosto de 1994"
16,5,109,2480,314,390,704,"21 de agosto de 1994"
16,5,109,2481,230,309,539,"21 de agosto de 1994"
16,5,109,2482,256,323,579,"21 de agosto de 1994"
16,5,109,2483,149,161,310,"21 de agosto de 1994"
16,5,109,2484,190,228,418,"21 de agosto de 1994"
16,5,109,2485,378,446,824,"21 de agosto de 1994"
16,5,109,2486,351,406,757,"21 de agosto de 1994"
16,5,109,2487,411,559,970,"21 de agosto de 1994"
16,5,109,2488,346,461,807,"21 de agosto de 1994"
16,5,109,2489,607,751,1358,"21 de agosto de 1994"
16,5,109,2490,314,381,695,"21 de agosto de 1994"
16,5,109,2491,383,453,836,"21 de agosto de 1994"
16,5,109,2492,354,463,817,"21 de agosto de 1994"
16,5,109,2493,396,488,884,"21 de agosto de 1994"
16,5,109,2494,175,274,449,"21 de agosto de 1994"
16,5,109,2495,653,740,1393,"21 de agosto de 1994"
16,5,109,2496,380,430,810,"21 de agosto de 1994"
16,5,109,2497,485,587,1072,"21 de agosto de 1994"
16,5,109,2498,537,677,1214,"21 de agosto de 1994"
16,5,109,2499,435,527,962,"21 de agosto de 1994"
16,5,109,2500,336,419,755,"21 de agosto de 1994"
16,5,109,2501,194,261,455,"21 de agosto de 1994"
16,5,109,2502,313,362,675,"21 de agosto de 1994"
16,5,109,2503,478,596,1074,"21 de agosto de 1994"
16,5,109,2504,291,345,636,"21 de agosto de 1994"
16,5,109,2505,284,324,608,"21 de agosto de 1994"
16,5,109,2506,357,412,769,"21 de agosto de 1994"
16,5,109,2507,263,395,658,"21 de agosto de 1994"
16,5,109,2508,404,502,906,"21 de agosto de 1994"
16,5,109,2509,294,407,701,"21 de agosto de 1994"
16,5,109,2510,482,648,1130,"21 de agosto de 1994"
16,5,109,2511,262,376,638,"21 de agosto de 1994"
16,5,109,2512,156,244,400,"21 de agosto de 1994"
16,5,109,2513,278,398,676,"21 de agosto de 1994"
16,5,109,2514,399,477,876,"21 de agosto de 1994"
16,5,109,2515,296,367,663,"21 de agosto de 1994"
16,5,109,2516,208,227,435,"21 de agosto de 1994"
16,5,109,2517,132,181,313,"21 de agosto de 1994"
16,5,109,2518,165,210,375,"21 de agosto de 1994"
16,5,109,2519,363,480,843,"21 de agosto de 1994"
16,5,109,2520,377,483,860,"21 de agosto de 1994"
16,5,109,2521,489,573,1062,"21 de agosto de 1994"
16,5,109,2522,386,457,843,"21 de agosto de 1994"
16,5,109,2523,247,365,612,"21 de agosto de 1994"
16,5,109,2524,186,273,459,"21 de agosto de 1994"
16,5,109,2525,404,495,899,"21 de agosto de 1994"
16,5,109,2526,235,367,602,"21 de agosto de 1994"
16,5,109,2527,245,318,563,"21 de agosto de 1994"
16,5,109,2528,337,413,750,"21 de agosto de 1994"
16,5,109,2529,495,654,1149,"21 de agosto de 1994"
16,5,109,2530,196,231,427,"21 de agosto de 1994"
16,6,33,467,523,506,1029,"21 de agosto de 1994"
16,6,33,468,211,219,430,"21 de agosto de 1994"
16,6,33,469,379,397,776,"21 de agosto de 1994"
16,6,33,470,311,335,646,"21 de agosto de 1994"
16,6,33,471,436,468,904,"21 de agosto de 1994"
16,6,33,472,449,495,944,"21 de agosto de 1994"
16,6,33,473,435,467,902,"21 de agosto de 1994"
16,6,33,474,429,404,833,"21 de agosto de 1994"
16,6,33,475,340,336,676,"21 de agosto de 1994"
16,6,33,476,312,262,574,"21 de agosto de 1994"
16,6,33,477,414,382,796,"21 de agosto de 1994"
16,6,33,478,370,316,686,"21 de agosto de 1994"
16,6,33,479,104,82,186,"21 de agosto de 1994"
16,6,59,1349,211,228,439,"21 de agosto de 1994"
16,6,59,1350,363,418,781,"21 de agosto de 1994"
16,6,59,1351,498,604,1102,"21 de agosto de 1994"
16,6,59,1352,439,547,986,"21 de agosto de 1994"
16,6,59,1353,501,578,1079,"21 de agosto de 1994"
16,6,59,1354,573,623,1196,"21 de agosto de 1994"
16,6,59,1355,175,162,337,"21 de agosto de 1994"
16,6,59,1356,272,278,550,"21 de agosto de 1994"
16,6,59,1357,236,194,430,"21 de agosto de 1994"
16,6,59,1358,40,38,78,"21 de agosto de 1994"
16,6,59,1359,71,64,135,"21 de agosto de 1994"
16,6,60,1360,640,557,1197,"21 de agosto de 1994"
16,6,60,1361,229,195,424,"21 de agosto de 1994"
16,6,60,1362,193,166,359,"21 de agosto de 1994"
16,6,60,1363,215,178,393,"21 de agosto de 1994"
16,6,60,1364,261,298,559,"21 de agosto de 1994"
16,6,60,1365,94,78,172,"21 de agosto de 1994"
16,6,60,1366,147,138,285,"21 de agosto de 1994"
16,6,60,1367,107,92,199,"21 de agosto de 1994"
16,6,60,1368,71,46,117,"21 de agosto de 1994"
16,6,88,1950,377,380,757,"21 de agosto de 1994"
16,6,88,1951,464,515,979,"21 de agosto de 1994"
16,6,88,1952,506,558,1064,"21 de agosto de 1994"
16,6,88,1953,510,521,1031,"21 de agosto de 1994"
16,6,88,1954,331,341,672,"21 de agosto de 1994"
16,6,88,1955,566,594,1160,"21 de agosto de 1994"
16,6,88,1956,255,290,545,"21 de agosto de 1994"
16,6,88,1957,269,244,513,"21 de agosto de 1994"
16,6,88,1958,80,80,160,"21 de agosto de 1994"
16,6,91,1995,285,335,620,"21 de agosto de 1994"
16,6,91,1996,461,510,971,"21 de agosto de 1994"
16,6,91,1997,405,458,863,"21 de agosto de 1994"
16,6,91,1998,323,383,706,"21 de agosto de 1994"
16,6,91,1999,343,363,706,"21 de agosto de 1994"
16,6,91,2000,421,452,873,"21 de agosto de 1994"
16,6,91,2001,195,197,392,"21 de agosto de 1994"
16,6,103,2175,536,665,1201,"21 de agosto de 1994"
16,6,103,2176,344,408,752,"21 de agosto de 1994"
16,6,103,2177,484,546,1030,"21 de agosto de 1994"
16,6,103,2178,257,301,558,"21 de agosto de 1994"
16,6,103,2179,451,533,984,"21 de agosto de 1994"
16,6,103,2180,314,384,698,"21 de agosto de 1994"
16,6,103,2181,438,552,990,"21 de agosto de 1994"
16,6,103,2182,413,475,888,"21 de agosto de 1994"
16,6,103,2183,289,349,638,"21 de agosto de 1994"
16,6,103,2184,464,514,978,"21 de agosto de 1994"
16,6,103,2185,456,519,975,"21 de agosto de 1994"
16,6,103,2186,377,487,864,"21 de agosto de 1994"
16,6,103,2187,513,637,1150,"21 de agosto de 1994"
16,6,103,2188,442,520,962,"21 de agosto de 1994"
16,6,103,2189,541,632,1173,"21 de agosto de 1994"
16,6,103,2190,282,366,648,"21 de agosto de 1994"
16,6,103,2191,362,384,746,"21 de agosto de 1994"
16,6,103,2192,415,469,884,"21 de agosto de 1994"
16,6,103,2193,352,391,743,"21 de agosto de 1994"
16,6,103,2194,415,505,920,"21 de agosto de 1994"
16,6,103,2195,445,520,965,"21 de agosto de 1994"
16,6,103,2196,319,388,707,"21 de agosto de 1994"
16,6,103,2197,399,440,839,"21 de agosto de 1994"
16,6,103,2198,493,568,1061,"21 de agosto de 1994"
16,6,103,2199,347,444,791,"21 de agosto de 1994"
16,6,103,2200,459,502,961,"21 de agosto de 1994"
16,6,103,2201,437,539,976,"21 de agosto de 1994"
16,6,103,2202,336,424,760,"21 de agosto de 1994"
16,6,103,2203,401,491,892,"21 de agosto de 1994"
16,6,103,2204,340,377,717,"21 de agosto de 1994"
16,6,103,2205,258,312,570,"21 de agosto de 1994"
16,6,103,2206,437,530,967,"21 de agosto de 1994"
16,6,103,2207,336,351,687,"21 de agosto de 1994"
16,6,103,2208,430,467,897,"21 de agosto de 1994"
16,6,103,2209,344,413,757,"21 de agosto de 1994"
16,6,103,2210,399,478,877,"21 de agosto de 1994"
16,6,103,2211,445,541,986,"21 de agosto de 1994"
16,6,103,2212,365,481,846,"21 de agosto de 1994"
16,6,103,2213,534,626,1160,"21 de agosto de 1994"
16,6,103,2214,443,484,927,"21 de agosto de 1994"
16,6,103,2215,335,448,783,"21 de agosto de 1994"
16,6,103,2216,238,362,600,"21 de agosto de 1994"
16,6,103,2217,331,398,729,"21 de agosto de 1994"
16,6,103,2218,359,380,739,"21 de agosto de 1994"
16,6,103,2219,493,585,1078,"21 de agosto de 1994"
16,6,103,2220,367,517,884,"21 de agosto de 1994"
16,6,103,2221,293,397,690,"21 de agosto de 1994"
16,6,103,2222,386,444,830,"21 de agosto de 1994"
16,6,103,2223,290,369,659,"21 de agosto de 1994"
16,6,103,2224,373,444,817,"21 de agosto de 1994"
16,6,103,2225,527,623,1150,"21 de agosto de 1994"
16,6,103,2226,601,724,1325,"21 de agosto de 1994"
16,6,103,2227,444,572,1016,"21 de agosto de 1994"
16,6,103,2228,391,494,885,"21 de agosto de 1994"
16,6,103,2229,485,548,1033,"21 de agosto de 1994"
16,6,103,2230,335,332,667,"21 de agosto de 1994"
16,6,103,2231,380,440,820,"21 de agosto de 1994"
16,6,103,2232,376,464,840,"21 de agosto de 1994"
16,6,103,2233,280,320,600,"21 de agosto de 1994"
16,6,103,2234,419,530,949,"21 de agosto de 1994"
16,6,103,2235,379,419,798,"21 de agosto de 1994"
16,6,103,2236,323,410,733,"21 de agosto de 1994"
16,6,103,2237,214,263,477,"21 de agosto de 1994"
16,6,103,2238,436,543,979,"21 de agosto de 1994"
16,6,103,2239,521,620,1141,"21 de agosto de 1994"
16,6,103,2240,349,434,783,"21 de agosto de 1994"
16,6,103,2241,349,445,794,"21 de agosto de 1994"
16,6,103,2242,284,368,652,"21 de agosto de 1994"
16,6,103,2243,453,493,946,"21 de agosto de 1994"
16,6,103,2244,339,422,761,"21 de agosto de 1994"
16,6,103,2245,246,303,549,"21 de agosto de 1994"
16,6,103,2246,270,336,606,"21 de agosto de 1994"
16,6,103,2247,258,323,581,"21 de agosto de 1994"
16,6,103,2248,293,358,651,"21 de agosto de 1994"
16,6,103,2249,341,420,761,"21 de agosto de 1994"
16,6,103,2250,369,454,823,"21 de agosto de 1994"
16,6,103,2251,366,439,805,"21 de agosto de 1994"
16,6,103,2252,262,321,583,"21 de agosto de 1994"
16,6,103,2253,380,471,851,"21 de agosto de 1994"
16,6,103,2254,368,428,796,"21 de agosto de 1994"
16,6,103,2255,484,597,1081,"21 de agosto de 1994"
16,6,103,2256,626,764,1390,"21 de agosto de 1994"
16,6,103,2257,331,351,682,"21 de agosto de 1994"
16,6,103,2258,319,353,672,"21 de agosto de 1994"
16,6,103,2259,534,613,1147,"21 de agosto de 1994"
16,6,103,2260,403,483,886,"21 de agosto de 1994"
16,6,103,2261,379,433,812,"21 de agosto de 1994"
16,6,103,2262,493,609,1102,"21 de agosto de 1994"
16,6,103,2263,562,671,1233,"21 de agosto de 1994"
16,6,103,2264,500,604,1104,"21 de agosto de 1994"
16,6,103,2265,356,467,823,"21 de agosto de 1994"
16,6,103,2266,417,501,918,"21 de agosto de 1994"
16,6,103,2267,379,468,847,"21 de agosto de 1994"
16,6,103,2268,545,672,1217,"21 de agosto de 1994"
16,6,103,2269,256,314,570,"21 de agosto de 1994"
16,6,103,2270,310,358,668,"21 de agosto de 1994"
16,6,103,2271,355,421,776,"21 de agosto de 1994"
16,6,103,2272,446,558,1004,"21 de agosto de 1994"
16,6,103,2273,646,707,1353,"21 de agosto de 1994"
16,6,103,2274,404,493,897,"21 de agosto de 1994"
16,6,103,2275,424,530,954,"21 de agosto de 1994"
16,6,103,2276,451,511,962,"21 de agosto de 1994"
16,6,103,2277,361,435,796,"21 de agosto de 1994"
16,6,103,2278,311,345,656,"21 de agosto de 1994"
16,6,103,2279,201,200,401,"21 de agosto de 1994"
16,6,103,2280,444,524,968,"21 de agosto de 1994"
16,6,103,2281,290,349,639,"21 de agosto de 1994"
16,6,103,2282,355,455,810,"21 de agosto de 1994"
16,6,103,2283,358,435,793,"21 de agosto de 1994"
16,6,103,2284,441,544,985,"21 de agosto de 1994"
16,6,103,2285,498,577,1075,"21 de agosto de 1994"
16,6,103,2286,571,641,1212,"21 de agosto de 1994"
16,6,103,2287,504,597,1101,"21 de agosto de 1994"
16,6,103,2288,447,519,966,"21 de agosto de 1994"
16,6,103,2289,335,414,749,"21 de agosto de 1994"
16,6,103,2290,473,638,1111,"21 de agosto de 1994"
16,6,103,2291,495,544,1039,"21 de agosto de 1994"
16,6,103,2292,430,475,905,"21 de agosto de 1994"
16,6,103,2293,559,571,1130,"21 de agosto de 1994"
16,6,103,2294,194,249,443,"21 de agosto de 1994"
16,6,103,2295,439,417,856,"21 de agosto de 1994"
16,6,103,2296,342,347,689,"21 de agosto de 1994"
16,6,103,2297,412,449,861,"21 de agosto de 1994"
16,6,103,2298,307,357,664,"21 de agosto de 1994"
16,6,103,2299,487,444,931,"21 de agosto de 1994"
16,6,103,2300,550,467,1017,"21 de agosto de 1994"
16,6,103,2301,289,326,615,"21 de agosto de 1994"
16,6,103,2302,251,281,532,"21 de agosto de 1994"
16,6,103,2303,340,314,654,"21 de agosto de 1994"
16,6,103,2304,361,337,698,"21 de agosto de 1994"
16,6,103,2305,423,488,911,"21 de agosto de 1994"
16,6,103,2306,251,252,503,"21 de agosto de 1994"
16,6,103,2307,103,90,193,"21 de agosto de 1994"
16,6,103,2308,200,225,425,"21 de agosto de 1994"
16,6,103,2309,285,291,576,"21 de agosto de 1994"
16,6,103,2310,248,249,497,"21 de agosto de 1994"
16,6,103,2311,400,439,839,"21 de agosto de 1994"
16,6,103,2312,217,216,433,"21 de agosto de 1994"
16,6,103,2313,148,139,287,"21 de agosto de 1994"
16,6,103,2314,261,238,499,"21 de agosto de 1994"
16,6,103,2315,104,77,181,"21 de agosto de 1994"
16,6,103,2316,244,248,492,"21 de agosto de 1994"
16,6,112,2570,515,533,1048,"21 de agosto de 1994"
16,6,112,2571,332,325,657,"21 de agosto de 1994"
16,6,112,2572,708,761,1469,"21 de agosto de 1994"
16,6,112,2573,444,524,968,"21 de agosto de 1994"
16,6,112,2574,301,317,618,"21 de agosto de 1994"
16,6,112,2575,261,256,517,"21 de agosto de 1994"
16,6,112,2576,227,232,459,"21 de agosto de 1994"
16,6,112,2577,81,74,155,"21 de agosto de 1994"
16,7,9,149,432,550,982,"21 de agosto de 1994"
16,7,9,150,294,316,610,"21 de agosto de 1994"
16,7,9,151,598,675,1273,"21 de agosto de 1994"
16,7,9,152,225,316,541,"21 de agosto de 1994"
16,7,9,153,311,373,684,"21 de agosto de 1994"
16,7,9,154,592,700,1292,"21 de agosto de 1994"
16,7,9,155,522,620,1142,"21 de agosto de 1994"
16,7,9,156,411,472,883,"21 de agosto de 1994"
16,7,9,157,372,346,718,"21 de agosto de 1994"
16,7,9,158,266,379,645,"21 de agosto de 1994"
16,7,9,159,416,445,861,"21 de agosto de 1994"
16,7,9,160,388,388,776,"21 de agosto de 1994"
16,7,9,161,448,437,885,"21 de agosto de 1994"
16,7,9,162,86,82,168,"21 de agosto de 1994"
16,7,9,163,342,329,671,"21 de agosto de 1994"
16,7,9,164,253,253,506,"21 de agosto de 1994"
16,7,9,165,256,260,516,"21 de agosto de 1994"
16,7,9,166,349,332,681,"21 de agosto de 1994"
16,7,9,167,171,110,281,"21 de agosto de 1994"
16,7,9,168,187,166,353,"21 de agosto de 1994"
16,7,9,169,116,94,210,"21 de agosto de 1994"
16,7,13,213,569,590,1159,"21 de agosto de 1994"
16,7,13,214,185,179,364,"21 de agosto de 1994"
16,7,13,215,86,64,150,"21 de agosto de 1994"
16,7,13,216,95,65,160,"21 de agosto de 1994"
16,7,13,217,280,185,465,"21 de agosto de 1994"
16,7,13,218,89,81,170,"21 de agosto de 1994"
16,7,13,219,444,396,840,"21 de agosto de 1994"
16,7,13,220,124,108,232,"21 de agosto de 1994"
16,7,13,221,135,121,256,"21 de agosto de 1994"
16,7,13,222,81,58,139,"21 de agosto de 1994"
16,7,13,223,80,69,149,"21 de agosto de 1994"
16,7,13,224,123,101,224,"21 de agosto de 1994"
16,7,29,420,275,256,531,"21 de agosto de 1994"
16,7,29,421,362,356,718,"21 de agosto de 1994"
16,7,29,422,445,409,854,"21 de agosto de 1994"
16,7,29,423,246,238,484,"21 de agosto de 1994"
16,7,29,424,278,240,518,"21 de agosto de 1994"
16,7,29,425,138,110,248,"21 de agosto de 1994"
16,7,29,426,272,290,562,"21 de agosto de 1994"
16,7,29,427,172,148,320,"21 de agosto de 1994"
16,7,29,428,210,145,355,"21 de agosto de 1994"
16,7,29,429,317,245,562,"21 de agosto de 1994"
16,7,29,430,189,154,343,"21 de agosto de 1994"
16,7,29,431,118,90,208,"21 de agosto de 1994"
16,7,29,432,227,196,423,"21 de agosto de 1994"
16,7,38,601,162,204,366,"21 de agosto de 1994"
16,7,38,602,186,198,384,"21 de agosto de 1994"
16,7,38,603,277,324,601,"21 de agosto de 1994"
16,7,38,604,260,334,594,"21 de agosto de 1994"
16,7,38,605,432,533,965,"21 de agosto de 1994"
16,7,38,606,329,427,756,"21 de agosto de 1994"
16,7,38,607,405,514,919,"21 de agosto de 1994"
16,7,38,608,417,500,917,"21 de agosto de 1994"
16,7,38,609,363,420,783,"21 de agosto de 1994"
16,7,38,610,302,343,645,"21 de agosto de 1994"
16,7,38,611,361,424,785,"21 de agosto de 1994"
16,7,38,612,263,345,608,"21 de agosto de 1994"
16,7,38,613,436,487,923,"21 de agosto de 1994"
16,7,38,614,245,317,562,"21 de agosto de 1994"
16,7,38,615,162,166,328,"21 de agosto de 1994"
16,7,38,616,246,260,506,"21 de agosto de 1994"
16,7,38,617,116,134,250,"21 de agosto de 1994"
16,7,38,618,125,99,224,"21 de agosto de 1994"
16,7,38,619,174,195,369,"21 de agosto de 1994"
16,7,38,620,23,23,46,"21 de agosto de 1994"
16,7,38,621,159,151,310,"21 de agosto de 1994"
16,7,38,622,229,272,501,"21 de agosto de 1994"
16,7,38,623,212,288,500,"21 de agosto de 1994"
16,7,38,624,111,122,233,"21 de agosto de 1994"
16,7,38,625,180,209,389,"21 de agosto de 1994"
16,7,38,626,50,42,92,"21 de agosto de 1994"
16,7,38,627,246,249,495,"21 de agosto de 1994"
16,7,38,628,391,429,820,"21 de agosto de 1994"
16,7,38,629,277,328,605,"21 de agosto de 1994"
16,7,38,630,182,202,384,"21 de agosto de 1994"
16,7,38,631,130,184,314,"21 de agosto de 1994"
16,7,38,632,282,259,541,"21 de agosto de 1994"
16,7,38,633,250,241,491,"21 de agosto de 1994"
16,7,38,634,282,337,619,"21 de agosto de 1994"
16,7,38,635,201,211,412,"21 de agosto de 1994"
16,7,38,636,90,77,167,"21 de agosto de 1994"
16,7,38,637,46,46,92,"21 de agosto de 1994"
16,7,38,638,95,96,191,"21 de agosto de 1994"
16,7,38,639,47,41,88,"21 de agosto de 1994"
16,7,38,640,127,108,235,"21 de agosto de 1994"
16,7,38,641,50,54,104,"21 de agosto de 1994"
16,7,38,642,93,90,183,"21 de agosto de 1994"
16,7,38,643,72,66,138,"21 de agosto de 1994"
16,7,38,644,98,110,208,"21 de agosto de 1994"
16,7,38,645,88,77,165,"21 de agosto de 1994"
16,7,38,646,83,90,173,"21 de agosto de 1994"
16,7,51,871,669,721,1390,"21 de agosto de 1994"
16,7,51,872,369,367,736,"21 de agosto de 1994"
16,7,51,873,523,610,1133,"21 de agosto de 1994"
16,7,51,874,251,234,485,"21 de agosto de 1994"
16,7,51,875,385,396,781,"21 de agosto de 1994"
16,7,51,876,123,102,225,"21 de agosto de 1994"
16,7,51,877,121,110,231,"21 de agosto de 1994"
16,7,51,878,147,104,251,"21 de agosto de 1994"
16,7,51,879,74,62,136,"21 de agosto de 1994"
16,7,51,880,316,275,591,"21 de agosto de 1994"
16,7,51,881,362,285,647,"21 de agosto de 1994"
16,7,51,882,194,109,303,"21 de agosto de 1994"
16,7,51,883,63,33,96,"21 de agosto de 1994"
16,7,51,884,45,41,86,"21 de agosto de 1994"
16,7,58,1336,89,83,172,"21 de agosto de 1994"
16,7,58,1337,237,277,514,"21 de agosto de 1994"
16,7,58,1338,330,345,675,"21 de agosto de 1994"
16,7,58,1339,103,101,204,"21 de agosto de 1994"
16,7,58,1340,53,42,95,"21 de agosto de 1994"
16,7,58,1341,112,103,215,"21 de agosto de 1994"
16,7,58,1342,246,233,479,"21 de agosto de 1994"
16,7,58,1343,122,131,253,"21 de agosto de 1994"
16,7,58,1344,188,143,331,"21 de agosto de 1994"
16,7,58,1345,54,47,101,"21 de agosto de 1994"
16,7,58,1346,99,84,183,"21 de agosto de 1994"
16,7,58,1347,76,61,137,"21 de agosto de 1994"
16,7,58,1348,171,144,315,"21 de agosto de 1994"
16,7,78,1768,269,330,599,"21 de agosto de 1994"
16,7,78,1769,258,249,507,"21 de agosto de 1994"
16,7,78,1770,284,326,610,"21 de agosto de 1994"
16,7,78,1771,183,214,397,"21 de agosto de 1994"
16,7,78,1772,193,165,358,"21 de agosto de 1994"
16,7,78,1773,249,272,521,"21 de agosto de 1994"
16,7,78,1774,266,293,559,"21 de agosto de 1994"
16,7,78,1775,177,220,397,"21 de agosto de 1994"
16,7,78,1776,126,140,266,"21 de agosto de 1994"
16,7,78,1777,58,71,129,"21 de agosto de 1994"
16,7,78,1778,183,241,424,"21 de agosto de 1994"
16,7,78,1779,238,322,560,"21 de agosto de 1994"
16,7,78,1780,59,73,132,"21 de agosto de 1994"
16,7,78,1781,318,386,704,"21 de agosto de 1994"
16,7,78,1782,261,287,548,"21 de agosto de 1994"
16,7,78,1783,193,253,446,"21 de agosto de 1994"
16,7,78,1784,296,329,625,"21 de agosto de 1994"
16,7,78,1785,238,244,482,"21 de agosto de 1994"
16,7,78,1786,271,349,620,"21 de agosto de 1994"
16,7,78,1787,164,195,359,"21 de agosto de 1994"
16,7,83,1844,348,340,688,"21 de agosto de 1994"
16,7,83,1845,413,525,938,"21 de agosto de 1994"
16,7,83,1846,314,379,693,"21 de agosto de 1994"
16,7,83,1847,454,550,1004,"21 de agosto de 1994"
16,7,83,1848,504,531,1035,"21 de agosto de 1994"
16,7,83,1849,452,524,976,"21 de agosto de 1994"
16,7,83,1850,138,190,328,"21 de agosto de 1994"
16,7,83,1851,462,618,1080,"21 de agosto de 1994"
16,7,83,1852,220,223,443,"21 de agosto de 1994"
16,7,83,1853,544,587,1131,"21 de agosto de 1994"
16,7,83,1854,400,453,853,"21 de agosto de 1994"
16,7,83,1855,391,376,767,"21 de agosto de 1994"
16,7,83,1856,554,587,1141,"21 de agosto de 1994"
16,7,83,1857,110,106,216,"21 de agosto de 1994"
16,7,83,1858,99,93,192,"21 de agosto de 1994"
16,7,83,1859,400,398,798,"21 de agosto de 1994"
16,7,83,1860,225,310,535,"21 de agosto de 1994"
16,7,83,1861,235,223,458,"21 de agosto de 1994"
16,7,83,1862,282,266,548,"21 de agosto de 1994"
16,7,83,1863,347,343,690,"21 de agosto de 1994"
16,7,83,1864,405,391,796,"21 de agosto de 1994"
16,7,83,1865,197,200,397,"21 de agosto de 1994"
16,7,83,1866,260,260,520,"21 de agosto de 1994"
16,7,83,1867,602,647,1249,"21 de agosto de 1994"
16,7,83,1868,464,443,907,"21 de agosto de 1994"
16,7,83,1869,297,292,589,"21 de agosto de 1994"
16,7,83,1870,359,314,673,"21 de agosto de 1994"
16,7,83,1871,58,52,110,"21 de agosto de 1994"
16,7,83,1872,265,253,518,"21 de agosto de 1994"
16,7,83,1873,405,450,855,"21 de agosto de 1994"
16,7,83,1874,262,255,517,"21 de agosto de 1994"
16,7,83,1875,358,385,743,"21 de agosto de 1994"
16,7,83,1876,636,670,1306,"21 de agosto de 1994"
16,7,83,1877,376,387,763,"21 de agosto de 1994"
16,7,83,1878,289,269,558,"21 de agosto de 1994"
16,7,83,1879,411,433,844,"21 de agosto de 1994"
16,7,83,1880,291,295,586,"21 de agosto de 1994"
16,7,83,1881,30,25,55,"21 de agosto de 1994"
16,7,93,2013,340,384,724,"21 de agosto de 1994"
16,7,93,2014,483,506,989,"21 de agosto de 1994"
16,7,93,2015,182,110,292,"21 de agosto de 1994"
16,7,93,2016,65,38,103,"21 de agosto de 1994"
16,7,93,2017,436,375,811,"21 de agosto de 1994"
16,7,93,2018,294,259,553,"21 de agosto de 1994"
16,7,93,2019,329,359,688,"21 de agosto de 1994"
16,7,93,2020,243,206,449,"21 de agosto de 1994"
16,7,93,2021,153,172,325,"21 de agosto de 1994"
16,7,93,2022,300,288,588,"21 de agosto de 1994"
16,7,93,2023,219,225,444,"21 de agosto de 1994"
16,7,93,2024,173,148,321,"21 de agosto de 1994"
16,7,97,2065,463,392,855,"21 de agosto de 1994"
16,7,97,2066,285,257,542,"21 de agosto de 1994"
16,7,97,2067,232,221,453,"21 de agosto de 1994"
16,7,97,2068,479,391,870,"21 de agosto de 1994"
16,7,97,2069,86,56,142,"21 de agosto de 1994"
16,7,97,2070,31,21,52,"21 de agosto de 1994"
16,7,97,2071,194,113,307,"21 de agosto de 1994"
16,7,97,2072,44,30,74,"21 de agosto de 1994"
16,7,97,2073,35,26,61,"21 de agosto de 1994"
16,7,97,2074,158,81,239,"21 de agosto de 1994"
16,7,98,2075,226,254,480,"21 de agosto de 1994"
16,7,98,2076,303,315,618,"21 de agosto de 1994"
16,7,98,2077,232,212,444,"21 de agosto de 1994"
16,7,98,2078,164,153,317,"21 de agosto de 1994"
16,7,98,2079,372,373,745,"21 de agosto de 1994"
16,7,98,2080,253,234,487,"21 de agosto de 1994"
16,7,98,2081,342,363,705,"21 de agosto de 1994"
16,7,98,2082,217,231,448,"21 de agosto de 1994"
16,7,98,2083,371,415,786,"21 de agosto de 1994"
16,7,98,2084,215,249,464,"21 de agosto de 1994"
16,7,98,2085,120,135,255,"21 de agosto de 1994"
16,7,98,2086,594,609,1203,"21 de agosto de 1994"
16,7,98,2087,205,308,513,"21 de agosto de 1994"
16,7,98,2088,234,361,595,"21 de agosto de 1994"
16,7,98,2089,189,240,429,"21 de agosto de 1994"
16,7,98,2090,116,112,228,"21 de agosto de 1994"
16,7,98,2091,202,197,399,"21 de agosto de 1994"
16,7,98,2092,230,239,469,"21 de agosto de 1994"
16,7,98,2093,210,195,405,"21 de agosto de 1994"
16,7,98,2094,120,88,208,"21 de agosto de 1994"
16,7,98,2095,138,116,254,"21 de agosto de 1994"
16,7,98,2096,427,403,830,"21 de agosto de 1994"
16,7,98,2097,350,304,654,"21 de agosto de 1994"
16,7,98,2098,141,129,270,"21 de agosto de 1994"
16,7,98,2099,203,196,399,"21 de agosto de 1994"
16,7,98,2100,43,25,68,"21 de agosto de 1994"
16,7,98,2101,74,52,126,"21 de agosto de 1994"
16,7,98,2102,328,279,607,"21 de agosto de 1994"
16,7,98,2103,43,26,69,"21 de agosto de 1994"
16,7,98,2104,129,93,222,"21 de agosto de 1994"
16,7,98,2105,52,49,101,"21 de agosto de 1994"
16,7,98,2106,27,21,48,"21 de agosto de 1994"
16,7,98,2107,75,51,126,"21 de agosto de 1994"
16,7,98,2108,49,42,91,"21 de agosto de 1994"
16,7,98,2109,142,103,245,"21 de agosto de 1994"
16,7,98,2110,233,204,437,"21 de agosto de 1994"
16,7,98,2111,94,41,135,"21 de agosto de 1994"
16,7,98,2112,100,74,174,"21 de agosto de 1994"
16,8,5,52,320,347,667,"21 de agosto de 1994"
16,8,5,53,309,327,636,"21 de agosto de 1994"
16,8,5,54,271,310,581,"21 de agosto de 1994"
16,8,5,55,677,740,1417,"21 de agosto de 1994"
16,8,5,56,321,343,664,"21 de agosto de 1994"
16,8,5,57,593,639,1232,"21 de agosto de 1994"
16,8,7,132,274,313,587,"21 de agosto de 1994"
16,8,7,133,221,249,470,"21 de agosto de 1994"
16,8,7,134,59,62,121,"21 de agosto de 1994"
16,8,7,135,93,98,191,"21 de agosto de 1994"
16,8,17,286,593,585,1178,"21 de agosto de 1994"
16,8,17,287,208,183,391,"21 de agosto de 1994"
16,8,17,288,822,795,1617,"21 de agosto de 1994"
16,8,17,289,217,208,425,"21 de agosto de 1994"
16,8,17,290,326,288,614,"21 de agosto de 1994"
16,8,17,291,309,270,579,"21 de agosto de 1994"
16,8,17,292,528,533,1061,"21 de agosto de 1994"
16,8,17,293,636,586,1222,"21 de agosto de 1994"
16,8,17,294,738,712,1450,"21 de agosto de 1994"
16,8,17,295,458,457,915,"21 de agosto de 1994"
16,8,17,296,396,365,761,"21 de agosto de 1994"
16,8,17,297,740,728,1468,"21 de agosto de 1994"
16,8,17,298,347,387,734,"21 de agosto de 1994"
16,8,31,446,325,344,669,"21 de agosto de 1994"
16,8,31,447,359,453,812,"21 de agosto de 1994"
16,8,31,448,323,335,658,"21 de agosto de 1994"
16,8,31,449,331,329,660,"21 de agosto de 1994"
16,8,31,450,370,349,719,"21 de agosto de 1994"
16,8,31,451,298,292,590,"21 de agosto de 1994"
16,8,31,452,263,265,528,"21 de agosto de 1994"
16,8,31,453,192,183,375,"21 de agosto de 1994"
16,8,31,454,409,354,763,"21 de agosto de 1994"
16,8,31,455,558,557,1115,"21 de agosto de 1994"
16,8,31,456,389,342,731,"21 de agosto de 1994"
16,8,52,885,304,304,608,"21 de agosto de 1994"
16,8,52,886,237,251,488,"21 de agosto de 1994"
16,8,52,887,385,433,818,"21 de agosto de 1994"
16,8,52,888,321,356,677,"21 de agosto de 1994"
16,8,52,889,397,438,835,"21 de agosto de 1994"
16,8,52,890,568,639,1207,"21 de agosto de 1994"
16,8,52,891,370,397,767,"21 de agosto de 1994"
16,8,52,892,303,348,651,"21 de agosto de 1994"
16,8,52,893,385,463,848,"21 de agosto de 1994"
16,8,52,894,174,196,370,"21 de agosto de 1994"
16,8,52,895,329,349,678,"21 de agosto de 1994"
16,8,52,896,408,484,892,"21 de agosto de 1994"
16,8,52,897,334,380,714,"21 de agosto de 1994"
16,8,52,898,424,464,888,"21 de agosto de 1994"
16,8,52,899,236,252,488,"21 de agosto de 1994"
16,8,52,900,394,457,851,"21 de agosto de 1994"
16,8,52,901,343,367,710,"21 de agosto de 1994"
16,8,52,902,278,366,644,"21 de agosto de 1994"
16,8,52,903,601,647,1248,"21 de agosto de 1994"
16,8,52,904,340,457,797,"21 de agosto de 1994"
16,8,52,905,332,351,683,"21 de agosto de 1994"
16,8,52,906,277,329,606,"21 de agosto de 1994"
16,8,52,907,139,136,275,"21 de agosto de 1994"
16,8,52,908,504,449,953,"21 de agosto de 1994"
16,8,52,909,318,328,646,"21 de agosto de 1994"
16,8,52,910,266,263,529,"21 de agosto de 1994"
16,8,52,911,284,286,570,"21 de agosto de 1994"
16,8,52,912,634,658,1292,"21 de agosto de 1994"
16,8,52,913,107,99,206,"21 de agosto de 1994"
16,8,52,914,537,532,1069,"21 de agosto de 1994"
16,8,52,915,232,248,480,"21 de agosto de 1994"
16,8,52,916,395,370,765,"21 de agosto de 1994"
16,8,52,917,217,229,446,"21 de agosto de 1994"
16,8,52,918,162,177,339,"21 de agosto de 1994"
16,8,52,919,321,306,627,"21 de agosto de 1994"
16,8,52,920,291,257,548,"21 de agosto de 1994"
16,8,52,921,170,175,345,"21 de agosto de 1994"
16,8,52,922,507,534,1041,"21 de agosto de 1994"
16,8,52,923,265,275,540,"21 de agosto de 1994"
16,8,52,924,430,414,844,"21 de agosto de 1994"
16,8,52,925,204,202,406,"21 de agosto de 1994"
16,8,52,926,203,214,417,"21 de agosto de 1994"
16,8,52,927,101,93,194,"21 de agosto de 1994"
16,8,52,928,459,487,946,"21 de agosto de 1994"
16,8,62,1378,378,380,758,"21 de agosto de 1994"
16,8,62,1379,382,434,816,"21 de agosto de 1994"
16,8,62,1380,230,221,451,"21 de agosto de 1994"
16,8,62,1381,391,405,796,"21 de agosto de 1994"
16,8,62,1382,118,104,222,"21 de agosto de 1994"
16,8,62,1383,330,335,665,"21 de agosto de 1994"
16,8,62,1384,473,446,919,"21 de agosto de 1994"
16,8,62,1385,506,465,971,"21 de agosto de 1994"
16,8,62,1386,387,351,738,"21 de agosto de 1994"
16,8,62,1387,219,205,424,"21 de agosto de 1994"
16,8,62,1388,485,476,961,"21 de agosto de 1994"
16,8,81,1821,329,368,697,"21 de agosto de 1994"
16,8,81,1822,460,532,992,"21 de agosto de 1994"
16,8,81,1823,246,251,497,"21 de agosto de 1994"
16,8,81,1824,477,455,932,"21 de agosto de 1994"
16,8,81,1825,622,678,1300,"21 de agosto de 1994"
16,8,81,1826,262,290,552,"21 de agosto de 1994"
16,8,81,1827,424,387,811,"21 de agosto de 1994"
16,8,81,1828,572,581,1153,"21 de agosto de 1994"
16,8,81,1829,268,302,570,"21 de agosto de 1994"
16,8,81,1830,188,197,385,"21 de agosto de 1994"
16,8,81,1831,181,192,373,"21 de agosto de 1994"
16,8,94,2025,418,461,879,"21 de agosto de 1994"
16,8,94,2026,460,498,958,"21 de agosto de 1994"
16,8,94,2027,159,189,348,"21 de agosto de 1994"
16,8,94,2028,231,227,458,"21 de agosto de 1994"
16,8,94,2029,467,545,1012,"21 de agosto de 1994"
16,8,94,2030,318,351,669,"21 de agosto de 1994"
16,8,94,2031,412,475,887,"21 de agosto de 1994"
16,8,94,2032,367,460,827,"21 de agosto de 1994"
16,8,94,2033,610,700,1310,"21 de agosto de 1994"
16,8,94,2034,533,639,1172,"21 de agosto de 1994"
16,8,94,2035,271,272,543,"21 de agosto de 1994"
16,8,94,2036,128,117,245,"21 de agosto de 1994"
16,8,94,2037,385,391,776,"21 de agosto de 1994"
16,8,94,2038,396,403,799,"21 de agosto de 1994"
16,8,94,2039,142,147,289,"21 de agosto de 1994"
16,8,113,2578,298,337,635,"21 de agosto de 1994"
16,8,113,2579,475,555,1030,"21 de agosto de 1994"
16,8,113,2580,357,409,766,"21 de agosto de 1994"
16,8,113,2581,378,439,817,"21 de agosto de 1994"
16,8,113,2582,338,358,696,"21 de agosto de 1994"
16,8,113,2583,520,568,1088,"21 de agosto de 1994"
16,8,113,2584,427,493,920,"21 de agosto de 1994"
16,8,113,2585,574,583,1157,"21 de agosto de 1994"
16,8,113,2586,280,305,585,"21 de agosto de 1994"
16,8,113,2587,411,467,878,"21 de agosto de 1994"
16,8,113,2588,554,646,1200,"21 de agosto de 1994"
16,8,113,2589,444,510,954,"21 de agosto de 1994"
16,8,113,2590,301,334,635,"21 de agosto de 1994"
16,8,113,2591,434,511,945,"21 de agosto de 1994"
16,8,113,2592,529,625,1154,"21 de agosto de 1994"
16,8,113,2593,437,467,904,"21 de agosto de 1994"
16,8,113,2594,526,581,1107,"21 de agosto de 1994"
16,8,113,2595,276,295,571,"21 de agosto de 1994"
16,8,113,2596,193,220,413,"21 de agosto de 1994"
16,8,113,2597,239,280,519,"21 de agosto de 1994"
16,8,113,2598,401,523,924,"21 de agosto de 1994"
16,8,113,2599,502,570,1072,"21 de agosto de 1994"
16,8,113,2600,373,399,772,"21 de agosto de 1994"
16,8,113,2601,285,350,635,"21 de agosto de 1994"
16,8,113,2602,402,436,838,"21 de agosto de 1994"
16,8,113,2603,451,498,949,"21 de agosto de 1994"
16,8,113,2604,359,427,786,"21 de agosto de 1994"
16,8,113,2605,402,477,879,"21 de agosto de 1994"
16,8,113,2606,300,372,672,"21 de agosto de 1994"
16,8,113,2607,393,492,885,"21 de agosto de 1994"
16,8,113,2608,322,374,696,"21 de agosto de 1994"
16,8,113,2609,349,400,749,"21 de agosto de 1994"
16,8,113,2610,378,412,790,"21 de agosto de 1994"
16,8,113,2611,241,264,505,"21 de agosto de 1994"
16,8,113,2612,224,287,511,"21 de agosto de 1994"
16,8,113,2613,462,508,970,"21 de agosto de 1994"
16,8,113,2614,275,299,574,"21 de agosto de 1994"
16,8,113,2615,252,294,546,"21 de agosto de 1994"
16,8,113,2616,310,331,641,"21 de agosto de 1994"
16,8,113,2617,284,320,604,"21 de agosto de 1994"
16,8,113,2618,267,316,583,"21 de agosto de 1994"
16,8,113,2619,226,275,501,"21 de agosto de 1994"
16,8,113,2620,379,414,793,"21 de agosto de 1994"
16,8,113,2621,135,133,268,"21 de agosto de 1994"
16,8,113,2622,528,565,1093,"21 de agosto de 1994"
16,8,113,2623,362,347,709,"21 de agosto de 1994"
16,8,113,2624,47,47,94,"21 de agosto de 1994"
16,8,113,2625,377,425,802,"21 de agosto de 1994"
16,8,113,2626,304,328,632,"21 de agosto de 1994"
16,8,113,2627,130,135,265,"21 de agosto de 1994"
16,8,113,2628,450,419,869,"21 de agosto de 1994"
16,8,113,2629,631,594,1225,"21 de agosto de 1994"
16,8,113,2630,270,254,524,"21 de agosto de 1994"
16,8,113,2631,222,210,432,"21 de agosto de 1994"
16,8,113,2632,206,228,434,"21 de agosto de 1994"
16,8,113,2633,194,218,412,"21 de agosto de 1994"
16,8,113,2634,245,270,515,"21 de agosto de 1994"
16,8,113,2635,222,230,452,"21 de agosto de 1994"
16,8,113,2636,345,345,690,"21 de agosto de 1994"
16,8,113,2637,224,250,474,"21 de agosto de 1994"
16,8,113,2638,627,605,1232,"21 de agosto de 1994"
16,8,113,2639,237,252,489,"21 de agosto de 1994"
16,8,113,2640,555,582,1137,"21 de agosto de 1994"
16,8,113,2641,401,406,807,"21 de agosto de 1994"
16,8,113,2642,495,473,968,"21 de agosto de 1994"
16,8,113,2643,561,544,1105,"21 de agosto de 1994"
16,8,113,2644,461,470,931,"21 de agosto de 1994"
16,8,113,2645,369,405,774,"21 de agosto de 1994"
16,8,113,2646,328,324,652,"21 de agosto de 1994"
16,8,113,2647,199,191,390,"21 de agosto de 1994"
16,8,113,2648,90,96,186,"21 de agosto de 1994"
16,8,113,2649,325,281,606,"21 de agosto de 1994"
16,8,113,2650,444,462,906,"21 de agosto de 1994"
16,8,113,2651,389,355,744,"21 de agosto de 1994"
16,8,113,2652,398,412,810,"21 de agosto de 1994"
16,8,113,2653,255,236,491,"21 de agosto de 1994"
16,8,113,2654,341,350,691,"21 de agosto de 1994"
16,8,113,2655,268,286,554,"21 de agosto de 1994"
16,8,113,2656,102,99,201,"21 de agosto de 1994"
16,8,113,2657,180,183,363,"21 de agosto de 1994"
16,8,113,2658,400,438,838,"21 de agosto de 1994"
16,8,113,2659,115,112,227,"21 de agosto de 1994"
16,9,6,58,252,309,561,"21 de agosto de 1994"
16,9,6,59,283,347,630,"21 de agosto de 1994"
16,9,6,60,305,299,604,"21 de agosto de 1994"
16,9,6,61,265,319,584,"21 de agosto de 1994"
16,9,6,62,368,427,795,"21 de agosto de 1994"
16,9,6,63,186,199,385,"21 de agosto de 1994"
16,9,6,64,205,243,448,"21 de agosto de 1994"
16,9,6,65,273,322,595,"21 de agosto de 1994"
16,9,6,66,473,531,1004,"21 de agosto de 1994"
16,9,6,67,194,233,427,"21 de agosto de 1994"
16,9,6,68,245,296,541,"21 de agosto de 1994"
16,9,6,69,253,297,550,"21 de agosto de 1994"
16,9,6,70,356,255,611,"21 de agosto de 1994"
16,9,6,71,380,430,810,"21 de agosto de 1994"
16,9,6,72,250,270,520,"21 de agosto de 1994"
16,9,6,73,279,277,556,"21 de agosto de 1994"
16,9,6,74,380,472,852,"21 de agosto de 1994"
16,9,6,75,355,397,752,"21 de agosto de 1994"
16,9,6,76,328,363,691,"21 de agosto de 1994"
16,9,6,77,589,720,1309,"21 de agosto de 1994"
16,9,6,78,431,489,920,"21 de agosto de 1994"
16,9,6,79,326,407,733,"21 de agosto de 1994"
16,9,6,80,377,446,823,"21 de agosto de 1994"
16,9,6,81,285,380,665,"21 de agosto de 1994"
16,9,6,82,352,456,808,"21 de agosto de 1994"
16,9,6,83,273,300,573,"21 de agosto de 1994"
16,9,6,84,257,262,519,"21 de agosto de 1994"
16,9,6,85,362,430,792,"21 de agosto de 1994"
16,9,6,86,291,330,621,"21 de agosto de 1994"
16,9,6,87,294,355,649,"21 de agosto de 1994"
16,9,6,88,384,435,819,"21 de agosto de 1994"
16,9,6,89,266,331,597,"21 de agosto de 1994"
16,9,6,90,314,408,722,"21 de agosto de 1994"
16,9,6,91,204,237,441,"21 de agosto de 1994"
16,9,6,92,343,417,760,"21 de agosto de 1994"
16,9,6,93,181,258,439,"21 de agosto de 1994"
16,9,6,94,251,295,546,"21 de agosto de 1994"
16,9,6,95,308,362,670,"21 de agosto de 1994"
16,9,6,96,278,306,584,"21 de agosto de 1994"
16,9,6,97,334,341,675,"21 de agosto de 1994"
16,9,6,98,473,464,937,"21 de agosto de 1994"
16,9,6,99,364,413,777,"21 de agosto de 1994"
16,9,6,100,241,286,527,"21 de agosto de 1994"
16,9,6,101,341,423,764,"21 de agosto de 1994"
16,9,6,102,296,308,604,"21 de agosto de 1994"
16,9,6,103,223,235,458,"21 de agosto de 1994"
16,9,6,104,329,380,709,"21 de agosto de 1994"
16,9,6,105,485,539,1024,"21 de agosto de 1994"
16,9,6,106,272,297,569,"21 de agosto de 1994"
16,9,6,107,271,343,614,"21 de agosto de 1994"
16,9,6,108,459,535,994,"21 de agosto de 1994"
16,9,6,109,444,548,992,"21 de agosto de 1994"
16,9,6,110,313,342,655,"21 de agosto de 1994"
16,9,6,111,326,363,689,"21 de agosto de 1994"
16,9,6,112,541,585,1126,"21 de agosto de 1994"
16,9,6,113,642,668,1310,"21 de agosto de 1994"
16,9,6,114,329,298,627,"21 de agosto de 1994"
16,9,6,115,350,320,670,"21 de agosto de 1994"
16,9,6,116,224,201,425,"21 de agosto de 1994"
16,9,6,117,366,353,719,"21 de agosto de 1994"
16,9,6,118,196,192,388,"21 de agosto de 1994"
16,9,6,119,376,362,738,"21 de agosto de 1994"
16,9,6,120,339,322,661,"21 de agosto de 1994"
16,9,6,121,308,253,561,"21 de agosto de 1994"
16,9,6,122,200,221,421,"21 de agosto de 1994"
16,9,6,123,76,80,156,"21 de agosto de 1994"
16,9,6,124,192,188,380,"21 de agosto de 1994"
16,9,6,125,280,293,573,"21 de agosto de 1994"
16,9,6,126,196,192,388,"21 de agosto de 1994"
16,9,6,127,223,226,449,"21 de agosto de 1994"
16,9,6,128,256,248,504,"21 de agosto de 1994"
16,9,6,129,271,244,515,"21 de agosto de 1994"
16,9,6,130,157,103,260,"21 de agosto de 1994"
16,9,6,131,88,82,170,"21 de agosto de 1994"
16,9,6,2660,64,50,114,"21 de agosto de 1994"
16,9,6,2661,125,97,222,"21 de agosto de 1994"
16,9,6,2662,163,165,328,"21 de agosto de 1994"
16,9,6,2663,67,55,122,"21 de agosto de 1994"
16,9,6,2664,73,73,146,"21 de agosto de 1994"
16,9,6,2665,126,101,227,"21 de agosto de 1994"
16,9,35,557,391,421,812,"21 de agosto de 1994"
16,9,35,558,416,492,908,"21 de agosto de 1994"
16,9,35,559,456,534,990,"21 de agosto de 1994"
16,9,35,560,370,442,812,"21 de agosto de 1994"
16,9,35,561,367,389,756,"21 de agosto de 1994"
16,9,35,562,263,282,545,"21 de agosto de 1994"
16,9,35,563,99,85,184,"21 de agosto de 1994"
16,9,35,564,338,321,659,"21 de agosto de 1994"
16,9,35,565,178,155,333,"21 de agosto de 1994"
16,9,35,566,261,243,504,"21 de agosto de 1994"
16,9,35,567,166,166,332,"21 de agosto de 1994"
16,9,35,568,297,283,580,"21 de agosto de 1994"
16,9,35,569,234,205,439,"21 de agosto de 1994"
16,9,35,570,310,304,614,"21 de agosto de 1994"
16,9,35,571,268,264,532,"21 de agosto de 1994"
16,9,35,572,607,581,1188,"21 de agosto de 1994"
16,9,35,573,394,425,819,"21 de agosto de 1994"
16,9,35,574,285,339,624,"21 de agosto de 1994"
16,9,35,575,216,198,414,"21 de agosto de 1994"
16,9,35,576,129,109,238,"21 de agosto de 1994"
16,9,35,577,344,307,651,"21 de agosto de 1994"
16,9,35,578,203,211,414,"21 de agosto de 1994"
16,9,35,579,231,174,405,"21 de agosto de 1994"
16,9,35,2666,92,74,166,"21 de agosto de 1994"
16,9,35,2667,82,81,163,"21 de agosto de 1994"
16,9,35,2668,181,167,348,"21 de agosto de 1994"
16,9,35,2669,228,230,458,"21 de agosto de 1994"
16,9,35,2670,174,154,328,"21 de agosto de 1994"
16,9,56,1297,214,245,459,"21 de agosto de 1994"
16,9,56,1298,456,503,959,"21 de agosto de 1994"
16,9,56,1299,424,445,869,"21 de agosto de 1994"
16,9,56,1300,466,501,967,"21 de agosto de 1994"
16,9,56,1301,417,441,858,"21 de agosto de 1994"
16,9,56,1302,467,524,991,"21 de agosto de 1994"
16,9,56,1303,454,459,913,"21 de agosto de 1994"
16,9,56,1304,379,412,791,"21 de agosto de 1994"
16,9,56,1305,581,565,1146,"21 de agosto de 1994"
16,9,56,1306,441,451,892,"21 de agosto de 1994"
16,9,56,1307,471,495,966,"21 de agosto de 1994"
16,9,56,1308,367,382,749,"21 de agosto de 1994"
16,9,56,1309,314,362,676,"21 de agosto de 1994"
16,9,56,1310,456,436,892,"21 de agosto de 1994"
16,9,56,1311,306,308,614,"21 de agosto de 1994"
16,9,56,1312,320,356,676,"21 de agosto de 1994"
16,9,56,1313,421,491,912,"21 de agosto de 1994"
16,9,56,1314,210,213,423,"21 de agosto de 1994"
16,9,56,1315,574,518,1092,"21 de agosto de 1994"
16,9,56,1316,289,281,570,"21 de agosto de 1994"
16,9,56,1317,378,347,725,"21 de agosto de 1994"
16,9,56,1318,463,499,962,"21 de agosto de 1994"
16,9,56,1319,283,279,562,"21 de agosto de 1994"
16,9,56,1320,165,189,354,"21 de agosto de 1994"
16,9,65,1426,288,325,613,"21 de agosto de 1994"
16,9,65,1427,654,661,1315,"21 de agosto de 1994"
16,9,65,1428,398,400,798,"21 de agosto de 1994"
16,9,65,1429,207,196,403,"21 de agosto de 1994"
16,9,65,1430,288,252,540,"21 de agosto de 1994"
16,9,65,1431,363,385,748,"21 de agosto de 1994"
16,9,65,1432,334,328,662,"21 de agosto de 1994"
16,9,65,1433,378,397,775,"21 de agosto de 1994"
16,9,65,1434,541,508,1049,"21 de agosto de 1994"
16,9,65,1435,418,427,845,"21 de agosto de 1994"
16,9,65,1436,460,464,924,"21 de agosto de 1994"
16,9,65,1437,231,222,453,"21 de agosto de 1994"
16,9,65,1438,171,159,330,"21 de agosto de 1994"
16,9,65,1439,172,176,348,"21 de agosto de 1994"
16,9,65,2671,179,169,348,"21 de agosto de 1994"
16,9,65,2672,109,106,215,"21 de agosto de 1994"
16,10,1,1,324,406,730,"21 de agosto de 1994"
16,10,1,2,344,416,760,"21 de agosto de 1994"
16,10,1,3,347,430,777,"21 de agosto de 1994"
16,10,1,4,311,405,716,"21 de agosto de 1994"
16,10,1,5,255,276,531,"21 de agosto de 1994"
16,10,1,6,131,129,260,"21 de agosto de 1994"
16,10,1,7,202,222,424,"21 de agosto de 1994"
16,10,1,8,129,125,254,"21 de agosto de 1994"
16,10,1,9,87,92,179,"21 de agosto de 1994"
16,10,1,10,342,306,648,"21 de agosto de 1994"
16,10,3,26,447,584,1031,"21 de agosto de 1994"
16,10,3,27,535,668,1203,"21 de agosto de 1994"
16,10,3,28,504,623,1127,"21 de agosto de 1994"
16,10,3,29,248,281,529,"21 de agosto de 1994"
16,10,3,30,279,387,666,"21 de agosto de 1994"
16,10,3,31,365,458,823,"21 de agosto de 1994"
16,10,3,32,395,439,834,"21 de agosto de 1994"
16,10,3,33,286,318,604,"21 de agosto de 1994"
16,10,3,34,306,423,729,"21 de agosto de 1994"
16,10,3,35,326,454,780,"21 de agosto de 1994"
16,10,3,36,294,369,663,"21 de agosto de 1994"
16,10,3,37,212,266,478,"21 de agosto de 1994"
16,10,18,299,296,373,669,"21 de agosto de 1994"
16,10,18,300,321,382,703,"21 de agosto de 1994"
16,10,18,301,404,545,949,"21 de agosto de 1994"
16,10,18,302,314,406,720,"21 de agosto de 1994"
16,10,18,303,306,359,665,"21 de agosto de 1994"
16,10,18,304,400,435,835,"21 de agosto de 1994"
16,10,20,324,553,624,1177,"21 de agosto de 1994"
16,10,20,325,264,337,601,"21 de agosto de 1994"
16,10,20,326,371,439,810,"21 de agosto de 1994"
16,10,20,327,266,373,639,"21 de agosto de 1994"
16,10,20,328,316,376,692,"21 de agosto de 1994"
16,10,20,329,291,355,646,"21 de agosto de 1994"
16,10,20,330,225,365,590,"21 de agosto de 1994"
16,10,20,331,358,518,876,"21 de agosto de 1994"
16,10,20,332,252,416,668,"21 de agosto de 1994"
16,10,20,333,396,653,1049,"21 de agosto de 1994"
16,10,20,334,27,63,90,"21 de agosto de 1994"
16,10,20,335,237,323,560,"21 de agosto de 1994"
16,10,20,336,242,325,567,"21 de agosto de 1994"
16,10,20,337,572,630,1202,"21 de agosto de 1994"
16,10,20,338,477,645,1122,"21 de agosto de 1994"
16,10,20,339,400,500,900,"21 de agosto de 1994"
16,10,27,405,259,341,600,"21 de agosto de 1994"
16,10,27,406,254,329,583,"21 de agosto de 1994"
16,10,27,407,375,526,901,"21 de agosto de 1994"
16,10,27,408,248,302,550,"21 de agosto de 1994"
16,10,27,409,487,583,1070,"21 de agosto de 1994"
16,10,27,410,189,264,453,"21 de agosto de 1994"
16,10,36,580,153,241,394,"21 de agosto de 1994"
16,10,36,581,284,407,691,"21 de agosto de 1994"
16,10,36,582,219,298,517,"21 de agosto de 1994"
16,10,36,583,250,342,592,"21 de agosto de 1994"
16,10,36,584,260,351,611,"21 de agosto de 1994"
16,10,36,585,227,282,509,"21 de agosto de 1994"
16,10,36,586,333,458,791,"21 de agosto de 1994"
16,10,36,587,179,298,477,"21 de agosto de 1994"
16,10,36,588,281,380,661,"21 de agosto de 1994"
16,10,36,589,333,535,868,"21 de agosto de 1994"
16,10,37,590,213,264,477,"21 de agosto de 1994"
16,10,37,591,185,268,453,"21 de agosto de 1994"
16,10,37,592,383,550,933,"21 de agosto de 1994"
16,10,37,593,278,436,714,"21 de agosto de 1994"
16,10,37,594,193,307,500,"21 de agosto de 1994"
16,10,37,595,131,193,324,"21 de agosto de 1994"
16,10,37,596,181,272,453,"21 de agosto de 1994"
16,10,37,597,189,278,467,"21 de agosto de 1994"
16,10,37,598,367,536,903,"21 de agosto de 1994"
16,10,37,599,235,312,547,"21 de agosto de 1994"
16,10,37,600,241,298,539,"21 de agosto de 1994"
16,10,39,647,694,721,1415,"21 de agosto de 1994"
16,10,39,648,200,254,454,"21 de agosto de 1994"
16,10,39,649,135,184,319,"21 de agosto de 1994"
16,10,39,650,467,457,924,"21 de agosto de 1994"
16,10,49,802,393,454,847,"21 de agosto de 1994"
16,10,49,803,408,471,879,"21 de agosto de 1994"
16,10,49,804,299,312,611,"21 de agosto de 1994"
16,10,49,805,243,292,535,"21 de agosto de 1994"
16,10,54,1191,554,648,1202,"21 de agosto de 1994"
16,10,54,1192,655,767,1422,"21 de agosto de 1994"
16,10,54,1193,436,553,989,"21 de agosto de 1994"
16,10,54,1194,572,680,1252,"21 de agosto de 1994"
16,10,54,1195,497,600,1097,"21 de agosto de 1994"
16,10,54,1196,796,961,1757,"21 de agosto de 1994"
16,10,54,1197,394,454,848,"21 de agosto de 1994"
16,10,54,1198,448,541,989,"21 de agosto de 1994"
16,10,54,1199,538,614,1152,"21 de agosto de 1994"
16,10,54,1200,225,288,513,"21 de agosto de 1994"
16,10,54,1201,332,373,705,"21 de agosto de 1994"
16,10,54,1202,564,646,1210,"21 de agosto de 1994"
16,10,54,1203,403,452,855,"21 de agosto de 1994"
16,10,54,1204,467,578,1045,"21 de agosto de 1994"
16,10,54,1205,554,621,1175,"21 de agosto de 1994"
16,10,54,1206,641,733,1374,"21 de agosto de 1994"
16,10,54,1207,480,598,1078,"21 de agosto de 1994"
16,10,54,1208,501,608,1109,"21 de agosto de 1994"
16,10,54,1209,549,626,1175,"21 de agosto de 1994"
16,10,54,1210,276,315,591,"21 de agosto de 1994"
16,10,54,1211,439,537,976,"21 de agosto de 1994"
16,10,54,1212,431,533,964,"21 de agosto de 1994"
16,10,54,1213,344,397,741,"21 de agosto de 1994"
16,10,54,1214,384,476,860,"21 de agosto de 1994"
16,10,54,1215,477,544,1021,"21 de agosto de 1994"
16,10,54,1216,556,636,1192,"21 de agosto de 1994"
16,10,54,1217,380,414,794,"21 de agosto de 1994"
16,10,54,1218,473,548,1021,"21 de agosto de 1994"
16,10,54,1219,450,533,983,"21 de agosto de 1994"
16,10,54,1220,621,716,1337,"21 de agosto de 1994"
16,10,54,1221,602,679,1281,"21 de agosto de 1994"
16,10,54,1222,398,439,837,"21 de agosto de 1994"
16,10,54,1223,408,322,730,"21 de agosto de 1994"
16,10,54,1224,695,810,1505,"21 de agosto de 1994"
16,10,54,1225,668,865,1533,"21 de agosto de 1994"
16,10,54,1226,467,569,1036,"21 de agosto de 1994"
16,10,54,1227,192,248,440,"21 de agosto de 1994"
16,10,54,1228,192,227,419,"21 de agosto de 1994"
16,10,54,1229,309,356,665,"21 de agosto de 1994"
16,10,54,1230,321,418,739,"21 de agosto de 1994"
16,10,54,1231,234,266,500,"21 de agosto de 1994"
16,10,54,1232,650,773,1423,"21 de agosto de 1994"
16,10,54,1233,275,309,584,"21 de agosto de 1994"
16,10,54,1234,378,455,833,"21 de agosto de 1994"
16,10,54,1235,375,449,824,"21 de agosto de 1994"
16,10,54,1236,391,439,830,"21 de agosto de 1994"
16,10,54,1237,320,310,630,"21 de agosto de 1994"
16,10,54,1238,218,236,454,"21 de agosto de 1994"
16,10,54,1239,575,656,1231,"21 de agosto de 1994"
16,10,54,1240,407,476,883,"21 de agosto de 1994"
16,10,54,1241,481,549,1030,"21 de agosto de 1994"
16,10,54,1242,471,523,994,"21 de agosto de 1994"
16,10,54,1243,41,50,91,"21 de agosto de 1994"
16,10,54,1244,203,238,441,"21 de agosto de 1994"
16,10,54,1245,361,398,759,"21 de agosto de 1994"
16,10,54,1246,48,52,100,"21 de agosto de 1994"
16,10,54,1247,352,530,882,"21 de agosto de 1994"
16,10,54,1248,226,265,491,"21 de agosto de 1994"
16,10,54,1249,190,213,403,"21 de agosto de 1994"
16,10,54,1250,563,706,1269,"21 de agosto de 1994"
16,10,54,1251,446,542,988,"21 de agosto de 1994"
16,10,54,1252,516,575,1091,"21 de agosto de 1994"
16,10,54,1253,233,243,476,"21 de agosto de 1994"
16,10,54,1254,182,181,363,"21 de agosto de 1994"
16,10,54,1255,268,325,593,"21 de agosto de 1994"
16,10,54,1256,410,425,835,"21 de agosto de 1994"
16,10,54,1257,263,300,563,"21 de agosto de 1994"
16,10,54,1258,78,75,153,"21 de agosto de 1994"
16,10,54,1259,109,115,224,"21 de agosto de 1994"
16,10,54,1260,268,304,572,"21 de agosto de 1994"
16,10,54,1261,319,396,715,"21 de agosto de 1994"
16,10,54,1262,399,394,793,"21 de agosto de 1994"
16,10,54,1263,521,645,1166,"21 de agosto de 1994"
16,10,54,1264,441,497,938,"21 de agosto de 1994"
16,10,54,1265,252,307,559,"21 de agosto de 1994"
16,10,54,1266,329,366,695,"21 de agosto de 1994"
16,10,54,1267,343,342,685,"21 de agosto de 1994"
16,10,54,1268,498,607,1105,"21 de agosto de 1994"
16,10,54,1269,248,233,481,"21 de agosto de 1994"
16,10,54,1270,538,559,1097,"21 de agosto de 1994"
16,10,54,1271,458,519,977,"21 de agosto de 1994"
16,10,54,1272,162,160,322,"21 de agosto de 1994"
16,10,54,1273,234,194,428,"21 de agosto de 1994"
16,10,54,1274,46,49,95,"21 de agosto de 1994"
16,10,54,1275,132,134,266,"21 de agosto de 1994"
16,10,54,1276,485,520,1005,"21 de agosto de 1994"
16,10,54,1277,453,478,931,"21 de agosto de 1994"
16,10,54,1278,194,213,407,"21 de agosto de 1994"
16,10,54,1279,295,303,598,"21 de agosto de 1994"
16,10,54,1280,480,448,928,"21 de agosto de 1994"
16,10,54,1281,99,123,222,"21 de agosto de 1994"
16,10,54,1282,269,278,547,"21 de agosto de 1994"
16,10,54,1283,596,742,1338,"21 de agosto de 1994"
16,10,54,1284,455,572,1027,"21 de agosto de 1994"
16,10,54,1285,441,545,986,"21 de agosto de 1994"
16,10,54,1286,540,674,1214,"21 de agosto de 1994"
16,10,54,1287,146,152,298,"21 de agosto de 1994"
16,10,55,1288,275,360,635,"21 de agosto de 1994"
16,10,55,1289,350,488,838,"21 de agosto de 1994"
16,10,55,1290,222,303,525,"21 de agosto de 1994"
16,10,55,1291,155,247,402,"21 de agosto de 1994"
16,10,55,1292,356,594,950,"21 de agosto de 1994"
16,10,55,1293,260,409,669,"21 de agosto de 1994"
16,10,55,1294,209,307,516,"21 de agosto de 1994"
16,10,55,1295,245,367,612,"21 de agosto de 1994"
16,10,55,1296,225,323,548,"21 de agosto de 1994"
16,10,74,1661,487,568,1055,"21 de agosto de 1994"
16,10,74,1662,728,837,1565,"21 de agosto de 1994"
16,10,74,1663,458,568,1026,"21 de agosto de 1994"
16,10,74,1664,523,594,1117,"21 de agosto de 1994"
16,10,74,1665,519,657,1176,"21 de agosto de 1994"
16,10,74,1666,406,478,884,"21 de agosto de 1994"
16,10,74,1667,256,350,606,"21 de agosto de 1994"
16,10,74,1668,196,322,518,"21 de agosto de 1994"
16,10,74,1669,503,487,990,"21 de agosto de 1994"
16,10,74,1670,480,468,948,"21 de agosto de 1994"
16,10,74,1671,222,373,595,"21 de agosto de 1994"
16,10,74,1672,206,323,529,"21 de agosto de 1994"
16,10,74,1673,104,127,231,"21 de agosto de 1994"
16,10,74,1674,81,80,161,"21 de agosto de 1994"
16,10,79,1788,186,256,442,"21 de agosto de 1994"
16,10,79,1789,408,545,953,"21 de agosto de 1994"
16,10,79,1790,506,626,1132,"21 de agosto de 1994"
16,10,79,1791,463,579,1042,"21 de agosto de 1994"
16,10,79,1792,321,526,847,"21 de agosto de 1994"
16,10,79,1793,233,396,629,"21 de agosto de 1994"
16,10,79,1794,77,75,152,"21 de agosto de 1994"
16,10,79,1795,320,475,795,"21 de agosto de 1994"
16,10,79,1796,247,319,566,"21 de agosto de 1994"
16,10,79,1797,190,232,422,"21 de agosto de 1994"
16,10,79,1798,182,260,442,"21 de agosto de 1994"
16,10,89,1959,330,472,802,"21 de agosto de 1994"
16,10,89,1960,325,444,769,"21 de agosto de 1994"
16,10,89,1961,332,443,775,"21 de agosto de 1994"
16,10,89,1962,334,453,787,"21 de agosto de 1994"
16,10,89,1963,345,486,831,"21 de agosto de 1994"
16,10,89,1964,194,252,446,"21 de agosto de 1994"
16,10,89,1965,369,461,830,"21 de agosto de 1994"
16,10,89,1966,500,537,1037,"21 de agosto de 1994"
16,10,89,1967,663,667,1330,"21 de agosto de 1994"
16,10,89,1968,170,264,434,"21 de agosto de 1994"
16,10,89,1969,214,316,530,"21 de agosto de 1994"
16,10,89,1970,313,373,686,"21 de agosto de 1994"
16,10,89,1971,560,566,1126,"21 de agosto de 1994"
16,10,89,1972,296,421,717,"21 de agosto de 1994"
16,10,89,1973,203,252,455,"21 de agosto de 1994"
16,10,89,1974,423,428,851,"21 de agosto de 1994"
16,10,89,1975,386,448,834,"21 de agosto de 1994"
16,10,89,1976,332,422,754,"21 de agosto de 1994"
16,10,89,1977,493,559,1052,"21 de agosto de 1994"
16,10,89,1978,217,258,475,"21 de agosto de 1994"
16,10,101,2151,359,439,798,"21 de agosto de 1994"
16,10,101,2152,492,528,1020,"21 de agosto de 1994"
16,10,101,2153,348,376,724,"21 de agosto de 1994"
16,10,101,2154,194,204,398,"21 de agosto de 1994"
16,10,101,2155,274,350,624,"21 de agosto de 1994"
16,10,101,2156,85,86,171,"21 de agosto de 1994"
16,10,101,2157,234,269,503,"21 de agosto de 1994"
16,10,101,2158,410,435,845,"21 de agosto de 1994"
16,10,101,2159,328,348,676,"21 de agosto de 1994"
16,11,11,184,426,533,959,"21 de agosto de 1994"
16,11,11,185,548,581,1129,"21 de agosto de 1994"
16,11,11,186,236,294,530,"21 de agosto de 1994"
16,11,11,187,225,263,488,"21 de agosto de 1994"
16,11,11,188,485,584,1069,"21 de agosto de 1994"
16,11,11,189,399,487,886,"21 de agosto de 1994"
16,11,19,305,145,190,335,"21 de agosto de 1994"
16,11,19,306,228,306,534,"21 de agosto de 1994"
16,11,19,307,430,588,1018,"21 de agosto de 1994"
16,11,19,308,221,321,542,"21 de agosto de 1994"
16,11,19,309,238,324,562,"21 de agosto de 1994"
16,11,19,310,315,392,707,"21 de agosto de 1994"
16,11,19,311,354,486,840,"21 de agosto de 1994"
16,11,19,312,284,394,678,"21 de agosto de 1994"
16,11,19,313,379,550,929,"21 de agosto de 1994"
16,11,19,314,322,367,689,"21 de agosto de 1994"
16,11,19,315,135,192,327,"21 de agosto de 1994"
16,11,19,316,95,171,266,"21 de agosto de 1994"
16,11,19,317,113,143,256,"21 de agosto de 1994"
16,11,19,318,405,509,914,"21 de agosto de 1994"
16,11,19,319,180,286,466,"21 de agosto de 1994"
16,11,19,320,96,95,191,"21 de agosto de 1994"
16,11,19,321,312,339,651,"21 de agosto de 1994"
16,11,19,322,175,132,307,"21 de agosto de 1994"
16,11,19,323,56,26,82,"21 de agosto de 1994"
16,11,30,433,329,451,780,"21 de agosto de 1994"
16,11,30,434,218,333,551,"21 de agosto de 1994"
16,11,30,435,170,228,398,"21 de agosto de 1994"
16,11,30,436,404,560,964,"21 de agosto de 1994"
16,11,30,437,213,377,590,"21 de agosto de 1994"
16,11,30,438,199,334,533,"21 de agosto de 1994"
16,11,30,439,536,875,1411,"21 de agosto de 1994"
16,11,30,440,285,482,767,"21 de agosto de 1994"
16,11,30,441,231,316,547,"21 de agosto de 1994"
16,11,30,442,203,299,502,"21 de agosto de 1994"
16,11,30,443,165,243,408,"21 de agosto de 1994"
16,11,30,444,188,294,482,"21 de agosto de 1994"
16,11,30,445,159,286,445,"21 de agosto de 1994"
16,11,42,673,444,509,953,"21 de agosto de 1994"
16,11,42,674,430,491,921,"21 de agosto de 1994"
16,11,42,675,283,325,608,"21 de agosto de 1994"
16,11,42,676,212,243,455,"21 de agosto de 1994"
16,11,42,677,237,294,531,"21 de agosto de 1994"
16,11,42,678,430,474,904,"21 de agosto de 1994"
16,11,42,679,255,306,561,"21 de agosto de 1994"
16,11,42,680,212,229,441,"21 de agosto de 1994"
16,11,42,681,290,404,694,"21 de agosto de 1994"
16,11,42,682,390,505,895,"21 de agosto de 1994"
16,11,42,683,385,507,892,"21 de agosto de 1994"
16,11,42,684,140,230,370,"21 de agosto de 1994"
16,11,45,726,137,158,295,"21 de agosto de 1994"
16,11,45,727,396,497,893,"21 de agosto de 1994"
16,11,45,728,277,306,583,"21 de agosto de 1994"
16,11,45,729,371,466,837,"21 de agosto de 1994"
16,11,45,730,322,443,765,"21 de agosto de 1994"
16,11,45,731,271,353,624,"21 de agosto de 1994"
16,11,45,732,178,227,405,"21 de agosto de 1994"
16,11,45,733,394,464,858,"21 de agosto de 1994"
16,11,45,734,444,597,1041,"21 de agosto de 1994"
16,11,45,735,305,444,749,"21 de agosto de 1994"
16,11,45,736,259,302,561,"21 de agosto de 1994"
16,11,45,737,246,395,641,"21 de agosto de 1994"
16,11,45,738,503,668,1171,"21 de agosto de 1994"
16,11,45,739,227,299,526,"21 de agosto de 1994"
16,11,45,740,266,312,578,"21 de agosto de 1994"
16,11,45,741,178,242,420,"21 de agosto de 1994"
16,11,45,742,469,527,996,"21 de agosto de 1994"
16,11,45,743,272,343,615,"21 de agosto de 1994"
16,11,45,744,373,440,813,"21 de agosto de 1994"
16,11,45,745,163,214,377,"21 de agosto de 1994"
16,11,45,746,247,322,569,"21 de agosto de 1994"
16,11,45,747,379,550,929,"21 de agosto de 1994"
16,11,45,748,125,180,305,"21 de agosto de 1994"
16,11,45,749,37,46,83,"21 de agosto de 1994"
16,11,45,750,134,196,330,"21 de agosto de 1994"
16,11,45,751,375,419,794,"21 de agosto de 1994"
16,11,45,752,425,530,955,"21 de agosto de 1994"
16,11,45,753,67,99,166,"21 de agosto de 1994"
16,11,45,754,227,334,561,"21 de agosto de 1994"
16,11,45,755,36,82,118,"21 de agosto de 1994"
16,11,53,929,330,453,783,"21 de agosto de 1994"
16,11,53,930,450,550,1000,"21 de agosto de 1994"
16,11,53,931,322,385,707,"21 de agosto de 1994"
16,11,53,932,288,395,683,"21 de agosto de 1994"
16,11,53,933,271,350,621,"21 de agosto de 1994"
16,11,53,934,206,259,465,"21 de agosto de 1994"
16,11,53,935,25,13,38,"21 de agosto de 1994"
16,11,53,936,139,146,285,"21 de agosto de 1994"
16,11,53,937,260,348,608,"21 de agosto de 1994"
16,11,53,938,99,106,205,"21 de agosto de 1994"
16,11,53,939,177,201,378,"21 de agosto de 1994"
16,11,53,940,46,69,115,"21 de agosto de 1994"
16,11,63,1389,123,142,265,"21 de agosto de 1994"
16,11,63,1390,268,360,628,"21 de agosto de 1994"
16,11,63,1391,295,369,664,"21 de agosto de 1994"
16,11,63,1392,319,393,712,"21 de agosto de 1994"
16,11,63,1393,215,214,429,"21 de agosto de 1994"
16,11,63,1394,345,429,774,"21 de agosto de 1994"
16,11,63,1395,350,419,769,"21 de agosto de 1994"
16,11,63,1396,295,406,701,"21 de agosto de 1994"
16,11,63,1397,211,271,482,"21 de agosto de 1994"
16,11,63,1398,226,292,518,"21 de agosto de 1994"
16,11,63,1399,181,254,435,"21 de agosto de 1994"
16,11,63,1400,142,204,346,"21 de agosto de 1994"
16,11,63,1401,329,329,658,"21 de agosto de 1994"
16,11,63,1402,315,303,618,"21 de agosto de 1994"
16,11,63,1403,155,243,398,"21 de agosto de 1994"
16,11,63,1404,283,438,721,"21 de agosto de 1994"
16,11,63,1405,220,378,598,"21 de agosto de 1994"
16,11,63,1406,120,154,274,"21 de agosto de 1994"
16,11,75,1675,253,297,550,"21 de agosto de 1994"
16,11,75,1676,272,322,594,"21 de agosto de 1994"
16,11,75,1677,165,212,377,"21 de agosto de 1994"
16,11,75,1678,277,335,612,"21 de agosto de 1994"
16,11,75,1679,300,368,668,"21 de agosto de 1994"
16,11,75,1680,351,397,748,"21 de agosto de 1994"
16,11,75,1681,267,327,594,"21 de agosto de 1994"
16,11,75,1682,212,252,464,"21 de agosto de 1994"
16,11,75,1683,307,331,638,"21 de agosto de 1994"
16,11,77,1719,79,96,175,"21 de agosto de 1994"
16,11,77,1720,332,358,690,"21 de agosto de 1994"
16,11,77,1721,215,273,488,"21 de agosto de 1994"
16,11,77,1722,203,239,442,"21 de agosto de 1994"
16,11,77,1723,252,321,573,"21 de agosto de 1994"
16,11,77,1724,297,365,662,"21 de agosto de 1994"
16,11,77,1725,301,338,639,"21 de agosto de 1994"
16,11,77,1726,463,597,1060,"21 de agosto de 1994"
16,11,77,1727,242,326,568,"21 de agosto de 1994"
16,11,77,1728,330,428,758,"21 de agosto de 1994"
16,11,77,1729,265,330,595,"21 de agosto de 1994"
16,11,77,1730,256,323,579,"21 de agosto de 1994"
16,11,77,1731,404,511,915,"21 de agosto de 1994"
16,11,77,1732,204,222,426,"21 de agosto de 1994"
16,11,77,1733,415,486,901,"21 de agosto de 1994"
16,11,77,1734,373,432,805,"21 de agosto de 1994"
16,11,77,1735,247,338,585,"21 de agosto de 1994"
16,11,77,1736,238,328,566,"21 de agosto de 1994"
16,11,77,1737,314,373,687,"21 de agosto de 1994"
16,11,77,1738,527,626,1153,"21 de agosto de 1994"
16,11,77,1739,149,199,348,"21 de agosto de 1994"
16,11,77,1740,204,235,439,"21 de agosto de 1994"
16,11,77,1741,105,137,242,"21 de agosto de 1994"
16,11,77,1742,293,348,641,"21 de agosto de 1994"
16,11,77,1743,255,287,542,"21 de agosto de 1994"
16,11,77,1744,286,326,612,"21 de agosto de 1994"
16,11,77,1745,316,380,696,"21 de agosto de 1994"
16,11,77,1746,356,447,803,"21 de agosto de 1994"
16,11,77,1747,302,399,701,"21 de agosto de 1994"
16,11,77,1748,380,430,810,"21 de agosto de 1994"
16,11,77,1749,301,383,684,"21 de agosto de 1994"
16,11,77,1750,255,300,555,"21 de agosto de 1994"
16,11,77,1751,78,90,168,"21 de agosto de 1994"
16,11,77,1752,285,332,617,"21 de agosto de 1994"
16,11,77,1753,212,243,455,"21 de agosto de 1994"
16,11,77,1754,265,308,573,"21 de agosto de 1994"
16,11,77,1755,286,370,656,"21 de agosto de 1994"
16,11,77,1756,314,342,656,"21 de agosto de 1994"
16,11,77,1757,260,301,561,"21 de agosto de 1994"
16,11,77,1758,218,277,495,"21 de agosto de 1994"
16,11,77,1759,326,355,681,"21 de agosto de 1994"
16,11,77,1760,264,327,591,"21 de agosto de 1994"
16,11,77,1761,408,503,911,"21 de agosto de 1994"
16,11,77,1762,328,407,735,"21 de agosto de 1994"
16,11,77,1763,177,205,382,"21 de agosto de 1994"
16,11,77,1764,138,212,350,"21 de agosto de 1994"
16,11,77,1765,134,136,270,"21 de agosto de 1994"
16,11,77,1766,73,93,166,"21 de agosto de 1994"
16,11,77,1767,314,360,674,"21 de agosto de 1994"
16,11,87,1939,532,611,1143,"21 de agosto de 1994"
16,11,87,1940,184,226,410,"21 de agosto de 1994"
16,11,87,1941,379,416,795,"21 de agosto de 1994"
16,11,87,1942,432,486,918,"21 de agosto de 1994"
16,11,87,1943,341,429,770,"21 de agosto de 1994"
16,11,87,1944,364,378,742,"21 de agosto de 1994"
16,11,87,1945,424,465,889,"21 de agosto de 1994"
16,11,87,1946,250,321,571,"21 de agosto de 1994"
16,11,87,1947,289,366,655,"21 de agosto de 1994"
16,11,87,1948,207,279,486,"21 de agosto de 1994"
16,11,87,1949,208,214,422,"21 de agosto de 1994"
16,11,104,2317,90,109,199,"21 de agosto de 1994"
16,11,104,2318,308,402,710,"21 de agosto de 1994"
16,11,104,2319,336,458,794,"21 de agosto de 1994"
16,11,104,2320,334,403,737,"21 de agosto de 1994"
16,11,104,2321,69,93,162,"21 de agosto de 1994"
16,11,104,2322,220,307,527,"21 de agosto de 1994"
16,11,104,2323,342,396,738,"21 de agosto de 1994"
16,11,104,2324,440,548,988,"21 de agosto de 1994"
16,11,104,2325,209,269,478,"21 de agosto de 1994"
16,11,104,2326,265,345,610,"21 de agosto de 1994"
16,11,104,2327,160,206,366,"21 de agosto de 1994"
16,11,104,2328,292,307,599,"21 de agosto de 1994"
16,11,104,2329,356,431,787,"21 de agosto de 1994"
16,11,104,2330,235,309,544,"21 de agosto de 1994"
16,11,104,2331,243,335,578,"21 de agosto de 1994"
16,11,104,2332,305,378,683,"21 de agosto de 1994"
16,11,104,2333,230,264,494,"21 de agosto de 1994"
16,11,104,2334,208,238,446,"21 de agosto de 1994"
16,11,104,2335,323,366,689,"21 de agosto de 1994"
16,11,104,2336,122,149,271,"21 de agosto de 1994"
16,11,104,2337,168,203,371,"21 de agosto de 1994"
16,11,104,2338,256,318,574,"21 de agosto de 1994"
16,11,106,2357,481,500,981,"21 de agosto de 1994"
16,11,106,2358,311,356,667,"21 de agosto de 1994"
16,11,106,2359,237,261,498,"21 de agosto de 1994"
16,11,106,2360,458,480,938,"21 de agosto de 1994"
16,11,106,2361,613,688,1301,"21 de agosto de 1994"
16,11,106,2362,482,541,1023,"21 de agosto de 1994"
16,11,106,2363,295,296,591,"21 de agosto de 1994"
16,11,106,2364,164,168,332,"21 de agosto de 1994"
16,11,106,2365,383,485,868,"21 de agosto de 1994"
16,11,106,2366,275,323,598,"21 de agosto de 1994"
16,11,106,2367,263,293,556,"21 de agosto de 1994"
16,11,106,2368,278,280,558,"21 de agosto de 1994"
16,11,106,2369,459,479,938,"21 de agosto de 1994"
16,11,107,2370,300,340,640,"21 de agosto de 1994"
16,11,107,2371,295,332,627,"21 de agosto de 1994"
16,11,107,2372,276,328,604,"21 de agosto de 1994"
16,11,107,2373,474,561,1035,"21 de agosto de 1994"
16,11,107,2374,249,262,511,"21 de agosto de 1994"
16,11,107,2375,414,466,880,"21 de agosto de 1994"
16,11,107,2376,287,369,656,"21 de agosto de 1994"
16,11,107,2377,350,449,799,"21 de agosto de 1994"
16,11,107,2378,394,453,847,"21 de agosto de 1994"
16,11,107,2379,503,572,1075,"21 de agosto de 1994"
16,11,107,2380,627,667,1294,"21 de agosto de 1994"
16,11,107,2381,251,277,528,"21 de agosto de 1994"
16,11,107,2382,79,99,178,"21 de agosto de 1994"
16,11,107,2383,358,410,768,"21 de agosto de 1994"
16,11,107,2384,316,318,634,"21 de agosto de 1994"
16,11,107,2385,235,233,468,"21 de agosto de 1994"
16,11,107,2386,268,254,522,"21 de agosto de 1994"
16,11,107,2387,119,167,286,"21 de agosto de 1994"
16,11,107,2388,162,193,355,"21 de agosto de 1994"
16,12,21,340,307,358,665,"21 de agosto de 1994"
16,12,21,341,538,613,1151,"21 de agosto de 1994"
16,12,21,342,309,435,744,"21 de agosto de 1994"
16,12,21,343,255,391,646,"21 de agosto de 1994"
16,12,21,344,385,460,845,"21 de agosto de 1994"
16,12,21,345,287,494,781,"21 de agosto de 1994"
16,12,25,380,364,430,794,"21 de agosto de 1994"
16,12,25,381,430,520,950,"21 de agosto de 1994"
16,12,25,382,408,506,914,"21 de agosto de 1994"
16,12,25,383,267,267,534,"21 de agosto de 1994"
16,12,25,384,422,534,956,"21 de agosto de 1994"
16,12,25,385,220,289,509,"21 de agosto de 1994"
16,12,25,386,410,454,864,"21 de agosto de 1994"
16,12,25,387,430,471,901,"21 de agosto de 1994"
16,12,25,388,411,503,914,"21 de agosto de 1994"
16,12,25,389,577,633,1210,"21 de agosto de 1994"
16,12,25,390,257,235,492,"21 de agosto de 1994"
16,12,25,391,366,408,774,"21 de agosto de 1994"
16,12,25,392,241,261,502,"21 de agosto de 1994"
16,12,25,393,526,550,1076,"21 de agosto de 1994"
16,12,25,394,468,469,937,"21 de agosto de 1994"
16,12,25,395,238,279,517,"21 de agosto de 1994"
16,12,25,396,142,149,291,"21 de agosto de 1994"
16,12,66,1440,433,482,915,"21 de agosto de 1994"
16,12,66,1441,292,335,627,"21 de agosto de 1994"
16,12,66,1442,370,422,792,"21 de agosto de 1994"
16,12,66,1443,535,575,1110,"21 de agosto de 1994"
16,12,66,1444,387,428,815,"21 de agosto de 1994"
16,12,66,1445,533,597,1130,"21 de agosto de 1994"
16,12,66,1446,599,646,1245,"21 de agosto de 1994"
16,12,66,1447,339,381,720,"21 de agosto de 1994"
16,12,66,1448,333,401,734,"21 de agosto de 1994"
16,12,66,1449,422,587,1009,"21 de agosto de 1994"
16,12,66,1450,410,497,907,"21 de agosto de 1994"
16,12,66,1451,462,548,1010,"21 de agosto de 1994"
16,12,66,1452,339,486,825,"21 de agosto de 1994"
16,12,66,1453,284,368,652,"21 de agosto de 1994"
16,12,66,1454,296,394,690,"21 de agosto de 1994"
16,12,66,1455,439,455,894,"21 de agosto de 1994"
16,12,69,1517,423,418,841,"21 de agosto de 1994"
16,12,69,1518,284,272,556,"21 de agosto de 1994"
16,12,69,1519,326,350,676,"21 de agosto de 1994"
16,12,69,1520,403,424,827,"21 de agosto de 1994"
16,12,69,1521,391,404,795,"21 de agosto de 1994"
16,12,69,1522,340,370,710,"21 de agosto de 1994"
16,12,69,1523,247,254,501,"21 de agosto de 1994"
16,12,69,1524,345,395,740,"21 de agosto de 1994"
16,12,69,1525,633,693,1326,"21 de agosto de 1994"
16,12,69,1526,312,353,665,"21 de agosto de 1994"
16,12,69,1527,189,198,387,"21 de agosto de 1994"
16,12,69,1528,129,126,255,"21 de agosto de 1994"
16,12,71,1590,269,320,589,"21 de agosto de 1994"
16,12,71,1591,223,267,490,"21 de agosto de 1994"
16,12,71,1592,448,511,959,"21 de agosto de 1994"
16,12,71,1593,492,589,1081,"21 de agosto de 1994"
16,12,71,1594,373,428,801,"21 de agosto de 1994"
16,12,71,1595,344,407,751,"21 de agosto de 1994"
16,12,71,1596,329,439,768,"21 de agosto de 1994"
16,12,71,1597,482,552,1034,"21 de agosto de 1994"
16,12,71,1598,445,497,942,"21 de agosto de 1994"
16,12,71,1599,151,202,353,"21 de agosto de 1994"
16,12,71,1600,196,281,477,"21 de agosto de 1994"
16,12,76,1684,479,541,1020,"21 de agosto de 1994"
16,12,76,1685,362,372,734,"21 de agosto de 1994"
16,12,76,1686,370,391,761,"21 de agosto de 1994"
16,12,76,1687,327,337,664,"21 de agosto de 1994"
16,12,76,1688,411,475,886,"21 de agosto de 1994"
16,12,76,1689,359,412,771,"21 de agosto de 1994"
16,12,76,1690,327,402,729,"21 de agosto de 1994"
16,12,76,1691,367,411,778,"21 de agosto de 1994"
16,12,76,1692,338,404,742,"21 de agosto de 1994"
16,12,76,1693,373,424,797,"21 de agosto de 1994"
16,12,76,1694,341,453,794,"21 de agosto de 1994"
16,12,76,1695,326,442,768,"21 de agosto de 1994"
16,12,76,1696,364,441,805,"21 de agosto de 1994"
16,12,76,1697,399,458,857,"21 de agosto de 1994"
16,12,76,1698,330,390,720,"21 de agosto de 1994"
16,12,76,1699,291,304,595,"21 de agosto de 1994"
16,12,76,1700,336,388,724,"21 de agosto de 1994"
16,12,76,1701,488,521,1009,"21 de agosto de 1994"
16,12,76,1702,389,483,872,"21 de agosto de 1994"
16,12,76,1703,356,395,751,"21 de agosto de 1994"
16,12,76,1704,384,439,823,"21 de agosto de 1994"
16,12,76,1705,574,656,1230,"21 de agosto de 1994"
16,12,76,1706,253,275,528,"21 de agosto de 1994"
16,12,76,1707,193,237,430,"21 de agosto de 1994"
16,12,76,1708,259,301,560,"21 de agosto de 1994"
16,12,76,1709,262,263,525,"21 de agosto de 1994"
16,12,76,1710,366,396,762,"21 de agosto de 1994"
16,12,76,1711,346,376,722,"21 de agosto de 1994"
16,12,76,1712,540,606,1146,"21 de agosto de 1994"
16,12,76,1713,302,337,639,"21 de agosto de 1994"
16,12,76,1714,291,314,605,"21 de agosto de 1994"
16,12,76,1715,157,174,331,"21 de agosto de 1994"
16,12,76,1716,341,396,737,"21 de agosto de 1994"
16,12,76,1717,560,599,1159,"21 de agosto de 1994"
16,12,76,1718,230,261,491,"21 de agosto de 1994"
16,12,84,1882,499,494,993,"21 de agosto de 1994"
16,12,84,1883,317,325,642,"21 de agosto de 1994"
16,12,84,1884,549,515,1064,"21 de agosto de 1994"
16,12,84,1885,297,344,641,"21 de agosto de 1994"
16,12,84,1886,272,295,567,"21 de agosto de 1994"
16,12,84,1887,559,687,1246,"21 de agosto de 1994"
16,12,84,1888,382,405,787,"21 de agosto de 1994"
16,12,84,1889,246,230,476,"21 de agosto de 1994"
16,12,84,1890,483,426,909,"21 de agosto de 1994"
16,12,84,1891,314,314,628,"21 de agosto de 1994"
16,12,84,1892,211,234,445,"21 de agosto de 1994"
16,12,84,1893,383,365,748,"21 de agosto de 1994"
16,12,84,1894,162,146,308,"21 de agosto de 1994"
16,12,84,1895,109,111,220,"21 de agosto de 1994"
16,12,84,1896,240,223,463,"21 de agosto de 1994"
16,12,84,1897,24,25,49,"21 de agosto de 1994"
16,12,86,1912,358,420,778,"21 de agosto de 1994"
16,12,86,1913,308,362,670,"21 de agosto de 1994"
16,12,86,1914,448,541,989,"21 de agosto de 1994"
16,12,86,1915,272,377,649,"21 de agosto de 1994"
16,12,86,1916,397,448,845,"21 de agosto de 1994"
16,12,86,1917,233,280,513,"21 de agosto de 1994"
16,12,86,1918,226,246,472,"21 de agosto de 1994"
16,12,86,1919,367,433,800,"21 de agosto de 1994"
16,12,86,1920,602,708,1310,"21 de agosto de 1994"
16,12,86,1921,267,330,597,"21 de agosto de 1994"
16,12,86,1922,330,404,734,"21 de agosto de 1994"
16,12,86,1923,282,343,625,"21 de agosto de 1994"
16,12,86,1924,116,152,268,"21 de agosto de 1994"
16,12,86,1925,158,262,420,"21 de agosto de 1994"
16,12,86,1926,80,81,161,"21 de agosto de 1994"
16,12,86,1927,113,144,257,"21 de agosto de 1994"
16,12,86,1928,102,122,224,"21 de agosto de 1994"
16,12,86,1929,310,490,800,"21 de agosto de 1994"
16,12,86,1930,305,433,738,"21 de agosto de 1994"
16,12,86,1931,166,241,407,"21 de agosto de 1994"
16,12,86,1932,223,312,535,"21 de agosto de 1994"
16,12,86,1933,90,127,217,"21 de agosto de 1994"
16,12,86,1934,350,486,836,"21 de agosto de 1994"
16,12,86,1935,153,173,326,"21 de agosto de 1994"
16,12,86,1936,187,249,436,"21 de agosto de 1994"
16,12,86,1937,145,167,312,"21 de agosto de 1994"
16,12,86,1938,227,263,490,"21 de agosto de 1994"
16,12,92,2002,284,334,618,"21 de agosto de 1994"
16,12,92,2003,215,274,489,"21 de agosto de 1994"
16,12,92,2004,279,365,644,"21 de agosto de 1994"
16,12,92,2005,431,545,976,"21 de agosto de 1994"
16,12,92,2006,318,358,676,"21 de agosto de 1994"
16,12,92,2007,250,350,600,"21 de agosto de 1994"
16,12,92,2008,274,351,625,"21 de agosto de 1994"
16,12,92,2009,427,557,984,"21 de agosto de 1994"
16,12,92,2010,249,274,523,"21 de agosto de 1994"
16,12,92,2011,180,212,392,"21 de agosto de 1994"
16,12,92,2012,118,114,232,"21 de agosto de 1994"
16,12,95,2040,231,279,510,"21 de agosto de 1994"
16,12,95,2041,175,247,422,"21 de agosto de 1994"
16,12,95,2042,195,250,445,"21 de agosto de 1994"
16,12,95,2043,258,317,575,"21 de agosto de 1994"
16,12,95,2044,327,428,755,"21 de agosto de 1994"
16,12,95,2045,136,156,292,"21 de agosto de 1994"
16,12,95,2046,149,187,336,"21 de agosto de 1994"
16,12,95,2047,124,130,254,"21 de agosto de 1994"
16,12,95,2048,250,303,553,"21 de agosto de 1994"
16,12,95,2049,203,303,506,"21 de agosto de 1994"
16,12,95,2050,220,235,455,"21 de agosto de 1994"
16,12,95,2051,244,306,550,"21 de agosto de 1994"
16,12,96,2052,334,377,711,"21 de agosto de 1994"
16,12,96,2053,265,270,535,"21 de agosto de 1994"
16,12,96,2054,204,239,443,"21 de agosto de 1994"
16,12,96,2055,344,367,711,"21 de agosto de 1994"
16,12,96,2056,453,500,953,"21 de agosto de 1994"
16,12,96,2057,271,335,606,"21 de agosto de 1994"
16,12,96,2058,252,267,519,"21 de agosto de 1994"
16,12,96,2059,411,459,870,"21 de agosto de 1994"
16,12,96,2060,149,144,293,"21 de agosto de 1994"
16,12,96,2061,193,214,407,"21 de agosto de 1994"
16,12,96,2062,202,260,462,"21 de agosto de 1994"
16,12,96,2063,127,123,250,"21 de agosto de 1994"
16,12,96,2064,89,62,151,"21 de agosto de 1994"
16,13,2,11,565,576,1141,"21 de agosto de 1994"
16,13,2,12,310,280,590,"21 de agosto de 1994"
16,13,2,13,730,754,1484,"21 de agosto de 1994"
16,13,2,14,448,465,913,"21 de agosto de 1994"
16,13,2,15,211,169,380,"21 de agosto de 1994"
16,13,2,16,765,679,1444,"21 de agosto de 1994"
16,13,2,17,282,238,520,"21 de agosto de 1994"
16,13,2,18,372,288,660,"21 de agosto de 1994"
16,13,2,19,308,309,617,"21 de agosto de 1994"
16,13,2,20,214,162,376,"21 de agosto de 1994"
16,13,2,21,41,33,74,"21 de agosto de 1994"
16,13,2,22,160,93,253,"21 de agosto de 1994"
16,13,2,23,76,56,132,"21 de agosto de 1994"
16,13,2,24,13,10,23,"21 de agosto de 1994"
16,13,2,25,68,38,106,"21 de agosto de 1994"
16,13,8,136,211,203,414,"21 de agosto de 1994"
16,13,8,137,455,388,843,"21 de agosto de 1994"
16,13,8,138,268,246,514,"21 de agosto de 1994"
16,13,8,139,487,461,948,"21 de agosto de 1994"
16,13,8,140,426,447,873,"21 de agosto de 1994"
16,13,8,141,317,162,479,"21 de agosto de 1994"
16,13,8,142,483,348,831,"21 de agosto de 1994"
16,13,8,143,314,197,511,"21 de agosto de 1994"
16,13,8,144,64,12,76,"21 de agosto de 1994"
16,13,8,145,433,277,710,"21 de agosto de 1994"
16,13,8,146,61,42,103,"21 de agosto de 1994"
16,13,8,147,420,404,824,"21 de agosto de 1994"
16,13,8,148,224,168,392,"21 de agosto de 1994"
16,13,10,170,470,464,934,"21 de agosto de 1994"
16,13,10,171,546,534,1080,"21 de agosto de 1994"
16,13,10,172,567,523,1090,"21 de agosto de 1994"
16,13,10,173,465,430,895,"21 de agosto de 1994"
16,13,10,174,255,243,498,"21 de agosto de 1994"
16,13,10,175,147,95,242,"21 de agosto de 1994"
16,13,10,176,518,549,1067,"21 de agosto de 1994"
16,13,10,177,244,178,422,"21 de agosto de 1994"
16,13,10,178,313,267,580,"21 de agosto de 1994"
16,13,10,179,115,41,156,"21 de agosto de 1994"
16,13,10,180,259,193,452,"21 de agosto de 1994"
16,13,10,181,490,424,914,"21 de agosto de 1994"
16,13,10,182,94,61,155,"21 de agosto de 1994"
16,13,10,183,46,26,72,"21 de agosto de 1994"
16,13,12,190,620,693,1313,"21 de agosto de 1994"
16,13,12,191,686,664,1350,"21 de agosto de 1994"
16,13,12,192,416,442,858,"21 de agosto de 1994"
16,13,12,193,190,191,381,"21 de agosto de 1994"
16,13,12,194,194,188,382,"21 de agosto de 1994"
16,13,12,195,221,264,485,"21 de agosto de 1994"
16,13,12,196,35,41,76,"21 de agosto de 1994"
16,13,12,197,120,118,238,"21 de agosto de 1994"
16,13,12,198,359,356,715,"21 de agosto de 1994"
16,13,12,199,383,393,776,"21 de agosto de 1994"
16,13,12,200,550,545,1095,"21 de agosto de 1994"
16,13,12,201,425,442,867,"21 de agosto de 1994"
16,13,12,202,392,404,796,"21 de agosto de 1994"
16,13,12,203,385,423,808,"21 de agosto de 1994"
16,13,12,204,555,567,1122,"21 de agosto de 1994"
16,13,12,205,494,487,981,"21 de agosto de 1994"
16,13,12,206,247,208,455,"21 de agosto de 1994"
16,13,12,207,211,203,414,"21 de agosto de 1994"
16,13,12,208,376,355,731,"21 de agosto de 1994"
16,13,12,209,500,437,937,"21 de agosto de 1994"
16,13,12,210,247,252,499,"21 de agosto de 1994"
16,13,12,211,241,268,509,"21 de agosto de 1994"
16,13,12,212,136,131,267,"21 de agosto de 1994"
16,13,14,225,299,331,630,"21 de agosto de 1994"
16,13,14,226,441,414,855,"21 de agosto de 1994"
16,13,14,227,181,172,353,"21 de agosto de 1994"
16,13,14,228,228,213,441,"21 de agosto de 1994"
16,13,14,229,470,411,881,"21 de agosto de 1994"
16,13,14,230,56,47,103,"21 de agosto de 1994"
16,13,14,231,265,231,496,"21 de agosto de 1994"
16,13,14,232,390,394,784,"21 de agosto de 1994"
16,13,14,233,232,283,515,"21 de agosto de 1994"
16,13,14,234,245,222,467,"21 de agosto de 1994"
16,13,14,235,212,220,432,"21 de agosto de 1994"
16,13,14,236,45,32,77,"21 de agosto de 1994"
16,13,15,237,560,556,1116,"21 de agosto de 1994"
16,13,15,238,436,427,863,"21 de agosto de 1994"
16,13,15,239,339,334,673,"21 de agosto de 1994"
16,13,15,240,251,246,497,"21 de agosto de 1994"
16,13,15,241,180,186,366,"21 de agosto de 1994"
16,13,15,242,564,569,1133,"21 de agosto de 1994"
16,13,15,243,45,62,107,"21 de agosto de 1994"
16,13,15,244,55,40,95,"21 de agosto de 1994"
16,13,15,245,360,324,684,"21 de agosto de 1994"
16,13,15,246,157,131,288,"21 de agosto de 1994"
16,13,15,247,89,67,156,"21 de agosto de 1994"
16,13,15,248,73,62,135,"21 de agosto de 1994"
16,13,15,249,117,85,202,"21 de agosto de 1994"
16,13,15,250,91,51,142,"21 de agosto de 1994"
16,13,15,251,62,49,111,"21 de agosto de 1994"
16,13,15,252,142,88,230,"21 de agosto de 1994"
16,13,15,253,80,56,136,"21 de agosto de 1994"
16,13,15,254,60,45,105,"21 de agosto de 1994"
16,13,15,255,75,58,133,"21 de agosto de 1994"
16,13,15,256,164,117,281,"21 de agosto de 1994"
16,13,26,397,427,378,805,"21 de agosto de 1994"
16,13,26,398,200,162,362,"21 de agosto de 1994"
16,13,26,399,159,129,288,"21 de agosto de 1994"
16,13,26,400,110,81,191,"21 de agosto de 1994"
16,13,26,401,92,54,146,"21 de agosto de 1994"
16,13,26,402,162,155,317,"21 de agosto de 1994"
16,13,26,403,236,197,433,"21 de agosto de 1994"
16,13,26,404,229,183,412,"21 de agosto de 1994"
16,13,50,806,516,562,1078,"21 de agosto de 1994"
16,13,50,807,673,703,1376,"21 de agosto de 1994"
16,13,50,808,631,616,1247,"21 de agosto de 1994"
16,13,50,809,363,359,722,"21 de agosto de 1994"
16,13,50,810,312,287,599,"21 de agosto de 1994"
16,13,50,811,545,520,1065,"21 de agosto de 1994"
16,13,50,812,600,575,1175,"21 de agosto de 1994"
16,13,50,813,552,537,1089,"21 de agosto de 1994"
16,13,50,814,648,645,1293,"21 de agosto de 1994"
16,13,50,815,577,608,1185,"21 de agosto de 1994"
16,13,50,816,291,319,610,"21 de agosto de 1994"
16,13,50,817,536,491,1027,"21 de agosto de 1994"
16,13,50,818,569,478,1047,"21 de agosto de 1994"
16,13,50,819,358,377,735,"21 de agosto de 1994"
16,13,50,820,499,501,1000,"21 de agosto de 1994"
16,13,50,821,694,688,1382,"21 de agosto de 1994"
16,13,50,822,350,367,717,"21 de agosto de 1994"
16,13,50,823,702,696,1398,"21 de agosto de 1994"
16,13,50,824,440,376,816,"21 de agosto de 1994"
16,13,50,825,553,465,1018,"21 de agosto de 1994"
16,13,50,826,643,544,1187,"21 de agosto de 1994"
16,13,50,827,550,480,1030,"21 de agosto de 1994"
16,13,50,828,747,795,1542,"21 de agosto de 1994"
16,13,50,829,701,392,1093,"21 de agosto de 1994"
16,13,50,830,140,122,262,"21 de agosto de 1994"
16,13,50,831,253,253,506,"21 de agosto de 1994"
16,13,50,832,671,471,1142,"21 de agosto de 1994"
16,13,50,833,112,92,204,"21 de agosto de 1994"
16,13,50,834,615,527,1142,"21 de agosto de 1994"
16,13,50,835,637,612,1249,"21 de agosto de 1994"
16,13,50,836,571,526,1097,"21 de agosto de 1994"
16,13,50,837,665,628,1293,"21 de agosto de 1994"
16,13,50,838,314,334,648,"21 de agosto de 1994"
16,13,50,839,509,506,1015,"21 de agosto de 1994"
16,13,50,840,503,473,976,"21 de agosto de 1994"
16,13,50,841,691,639,1330,"21 de agosto de 1994"
16,13,50,842,527,570,1097,"21 de agosto de 1994"
16,13,50,843,374,370,744,"21 de agosto de 1994"
16,13,50,844,499,492,991,"21 de agosto de 1994"
16,13,50,845,716,710,1426,"21 de agosto de 1994"
16,13,50,846,399,461,860,"21 de agosto de 1994"
16,13,50,847,558,542,1100,"21 de agosto de 1994"
16,13,50,848,602,576,1178,"21 de agosto de 1994"
16,13,50,849,658,641,1299,"21 de agosto de 1994"
16,13,50,850,658,646,1304,"21 de agosto de 1994"
16,13,50,851,782,787,1569,"21 de agosto de 1994"
16,13,50,852,628,592,1220,"21 de agosto de 1994"
16,13,50,853,533,514,1047,"21 de agosto de 1994"
16,13,50,854,633,619,1252,"21 de agosto de 1994"
16,13,50,855,379,371,750,"21 de agosto de 1994"
16,13,50,856,416,388,804,"21 de agosto de 1994"
16,13,50,857,499,486,985,"21 de agosto de 1994"
16,13,50,858,546,543,1089,"21 de agosto de 1994"
16,13,50,859,553,518,1071,"21 de agosto de 1994"
16,13,50,860,547,522,1069,"21 de agosto de 1994"
16,13,50,861,194,191,385,"21 de agosto de 1994"
16,13,50,862,458,426,884,"21 de agosto de 1994"
16,13,50,863,722,715,1437,"21 de agosto de 1994"
16,13,50,864,194,174,368,"21 de agosto de 1994"
16,13,50,865,632,655,1287,"21 de agosto de 1994"
16,13,50,866,319,241,560,"21 de agosto de 1994"
16,13,50,867,284,244,528,"21 de agosto de 1994"
16,13,50,868,781,698,1479,"21 de agosto de 1994"
16,13,50,869,389,369,758,"21 de agosto de 1994"
16,13,50,870,348,326,674,"21 de agosto de 1994"
16,13,90,1979,587,590,1177,"21 de agosto de 1994"
16,13,90,1980,274,268,542,"21 de agosto de 1994"
16,13,90,1981,598,625,1223,"21 de agosto de 1994"
16,13,90,1982,612,601,1213,"21 de agosto de 1994"
16,13,90,1983,191,161,352,"21 de agosto de 1994"
16,13,90,1984,184,176,360,"21 de agosto de 1994"
16,13,90,1985,457,473,930,"21 de agosto de 1994"
16,13,90,1986,504,525,1029,"21 de agosto de 1994"
16,13,90,1987,112,126,238,"21 de agosto de 1994"
16,13,90,1988,211,177,388,"21 de agosto de 1994"
16,13,90,1989,624,535,1159,"21 de agosto de 1994"
16,13,90,1990,251,223,474,"21 de agosto de 1994"
16,13,90,1991,494,388,882,"21 de agosto de 1994"
16,13,90,1992,186,138,324,"21 de agosto de 1994"
16,13,90,1993,252,218,470,"21 de agosto de 1994"
16,13,90,1994,228,190,418,"21 de agosto de 1994"
17,1,7,188,604,653,1257,"21 de agosto de 1994"
17,1,7,189,294,336,630,"21 de agosto de 1994"
17,1,7,190,709,765,1474,"21 de agosto de 1994"
17,1,7,191,371,447,818,"21 de agosto de 1994"
17,1,7,192,637,700,1337,"21 de agosto de 1994"
17,1,7,193,715,765,1480,"21 de agosto de 1994"
17,1,7,194,733,788,1521,"21 de agosto de 1994"
17,1,7,195,464,483,947,"21 de agosto de 1994"
17,1,7,196,419,513,932,"21 de agosto de 1994"
17,1,7,197,664,760,1424,"21 de agosto de 1994"
17,1,7,198,410,460,870,"21 de agosto de 1994"
17,1,7,199,424,471,895,"21 de agosto de 1994"
17,1,7,200,230,284,514,"21 de agosto de 1994"
17,1,7,201,379,451,830,"21 de agosto de 1994"
17,1,7,202,799,913,1712,"21 de agosto de 1994"
17,1,7,203,333,359,692,"21 de agosto de 1994"
17,1,7,204,546,617,1163,"21 de agosto de 1994"
17,1,7,205,565,651,1216,"21 de agosto de 1994"
17,1,7,206,549,582,1131,"21 de agosto de 1994"
17,1,7,207,536,577,1113,"21 de agosto de 1994"
17,1,7,208,523,588,1111,"21 de agosto de 1994"
17,1,7,209,294,319,613,"21 de agosto de 1994"
17,1,7,210,213,235,448,"21 de agosto de 1994"
17,1,7,211,399,423,822,"21 de agosto de 1994"
17,1,7,212,506,576,1082,"21 de agosto de 1994"
17,1,7,213,549,697,1246,"21 de agosto de 1994"
17,1,7,214,566,643,1209,"21 de agosto de 1994"
17,1,7,215,352,459,811,"21 de agosto de 1994"
17,1,7,216,368,452,820,"21 de agosto de 1994"
17,1,7,217,253,283,536,"21 de agosto de 1994"
17,1,7,218,337,391,728,"21 de agosto de 1994"
17,1,7,219,477,561,1038,"21 de agosto de 1994"
17,1,7,220,542,614,1156,"21 de agosto de 1994"
17,1,7,221,356,392,748,"21 de agosto de 1994"
17,1,7,222,558,660,1218,"21 de agosto de 1994"
17,1,7,223,434,506,940,"21 de agosto de 1994"
17,1,7,224,430,542,972,"21 de agosto de 1994"
17,1,7,225,427,473,900,"21 de agosto de 1994"
17,1,7,226,492,571,1063,"21 de agosto de 1994"
17,1,7,227,574,694,1268,"21 de agosto de 1994"
17,1,7,228,93,100,193,"21 de agosto de 1994"
17,1,7,229,269,277,546,"21 de agosto de 1994"
17,1,7,230,561,638,1199,"21 de agosto de 1994"
17,1,7,231,400,481,881,"21 de agosto de 1994"
17,1,7,232,676,765,1441,"21 de agosto de 1994"
17,1,7,233,374,424,798,"21 de agosto de 1994"
17,1,7,234,313,395,708,"21 de agosto de 1994"
17,1,7,235,800,66,866,"21 de agosto de 1994"
17,1,7,236,166,206,372,"21 de agosto de 1994"
17,1,7,237,390,468,858,"21 de agosto de 1994"
17,1,7,238,244,298,542,"21 de agosto de 1994"
17,1,7,239,547,686,1233,"21 de agosto de 1994"
17,1,7,240,347,418,765,"21 de agosto de 1994"
17,1,7,241,448,520,968,"21 de agosto de 1994"
17,1,7,242,374,454,828,"21 de agosto de 1994"
17,1,7,243,210,242,452,"21 de agosto de 1994"
17,1,7,244,432,494,926,"21 de agosto de 1994"
17,1,7,245,342,389,731,"21 de agosto de 1994"
17,1,7,246,521,657,1178,"21 de agosto de 1994"
17,1,7,247,506,551,1057,"21 de agosto de 1994"
17,1,7,248,613,704,1317,"21 de agosto de 1994"
17,1,7,249,248,329,577,"21 de agosto de 1994"
17,1,7,250,385,459,844,"21 de agosto de 1994"
17,1,7,251,284,328,612,"21 de agosto de 1994"
17,1,7,252,414,523,937,"21 de agosto de 1994"
17,1,7,253,469,529,998,"21 de agosto de 1994"
17,1,7,254,476,602,1078,"21 de agosto de 1994"
17,1,7,255,751,871,1622,"21 de agosto de 1994"
17,1,7,256,549,635,1184,"21 de agosto de 1994"
17,1,7,257,694,770,1464,"21 de agosto de 1994"
17,1,7,258,224,269,493,"21 de agosto de 1994"
17,1,7,259,172,210,382,"21 de agosto de 1994"
17,1,7,260,270,329,599,"21 de agosto de 1994"
17,1,7,261,187,235,422,"21 de agosto de 1994"
17,1,7,262,216,236,452,"21 de agosto de 1994"
17,1,7,263,289,321,610,"21 de agosto de 1994"
17,1,7,264,303,338,641,"21 de agosto de 1994"
17,1,7,265,222,294,516,"21 de agosto de 1994"
17,1,7,266,343,411,754,"21 de agosto de 1994"
17,1,7,267,679,815,1494,"21 de agosto de 1994"
17,1,7,268,448,555,1003,"21 de agosto de 1994"
17,1,7,269,451,551,1002,"21 de agosto de 1994"
17,1,7,270,294,349,643,"21 de agosto de 1994"
17,1,7,271,368,498,866,"21 de agosto de 1994"
17,1,7,272,768,844,1612,"21 de agosto de 1994"
17,1,7,273,403,416,819,"21 de agosto de 1994"
17,1,7,274,605,744,1349,"21 de agosto de 1994"
17,1,7,275,387,474,861,"21 de agosto de 1994"
17,1,7,276,409,527,936,"21 de agosto de 1994"
17,1,7,277,309,363,672,"21 de agosto de 1994"
17,1,7,278,366,439,805,"21 de agosto de 1994"
17,1,7,279,501,611,1112,"21 de agosto de 1994"
17,1,7,280,152,213,365,"21 de agosto de 1994"
17,1,7,281,348,404,752,"21 de agosto de 1994"
17,1,7,282,494,595,1089,"21 de agosto de 1994"
17,1,7,283,395,495,890,"21 de agosto de 1994"
17,1,7,284,519,585,1104,"21 de agosto de 1994"
17,1,7,285,324,397,721,"21 de agosto de 1994"
17,1,7,286,421,463,884,"21 de agosto de 1994"
17,1,7,287,399,436,835,"21 de agosto de 1994"
17,1,7,288,695,766,1461,"21 de agosto de 1994"
17,1,7,289,229,251,480,"21 de agosto de 1994"
17,1,7,290,700,815,1515,"21 de agosto de 1994"
17,1,7,291,234,280,514,"21 de agosto de 1994"
17,1,7,292,606,752,1358,"21 de agosto de 1994"
17,1,7,293,238,347,585,"21 de agosto de 1994"
17,1,7,294,435,502,937,"21 de agosto de 1994"
17,1,7,295,315,357,672,"21 de agosto de 1994"
17,1,7,296,360,437,797,"21 de agosto de 1994"
17,1,7,297,432,484,916,"21 de agosto de 1994"
17,1,7,298,374,443,817,"21 de agosto de 1994"
17,1,7,299,194,226,420,"21 de agosto de 1994"
17,1,7,300,425,512,937,"21 de agosto de 1994"
17,1,7,301,448,525,973,"21 de agosto de 1994"
17,1,7,302,374,419,793,"21 de agosto de 1994"
17,1,7,303,738,885,1623,"21 de agosto de 1994"
17,1,7,304,570,657,1227,"21 de agosto de 1994"
17,1,7,305,423,480,903,"21 de agosto de 1994"
17,1,7,306,371,448,819,"21 de agosto de 1994"
17,1,7,307,300,362,662,"21 de agosto de 1994"
17,1,7,308,431,542,973,"21 de agosto de 1994"
17,1,7,309,844,969,1813,"21 de agosto de 1994"
17,1,7,310,319,398,717,"21 de agosto de 1994"
17,1,7,311,449,568,1017,"21 de agosto de 1994"
17,1,7,312,457,579,1036,"21 de agosto de 1994"
17,1,7,313,259,312,571,"21 de agosto de 1994"
17,1,7,314,477,581,1058,"21 de agosto de 1994"
17,1,7,315,323,392,715,"21 de agosto de 1994"
17,1,7,316,379,482,861,"21 de agosto de 1994"
17,1,7,317,725,811,1536,"21 de agosto de 1994"
17,1,7,318,482,517,999,"21 de agosto de 1994"
17,1,7,319,177,245,422,"21 de agosto de 1994"
17,1,7,320,656,754,1410,"21 de agosto de 1994"
17,1,7,321,374,435,809,"21 de agosto de 1994"
17,1,7,322,416,528,944,"21 de agosto de 1994"
17,1,7,323,224,256,480,"21 de agosto de 1994"
17,1,7,324,459,569,1028,"21 de agosto de 1994"
17,1,7,325,175,205,380,"21 de agosto de 1994"
17,1,7,326,133,174,307,"21 de agosto de 1994"
17,1,7,327,403,492,895,"21 de agosto de 1994"
17,1,7,328,325,370,695,"21 de agosto de 1994"
17,1,7,329,245,300,545,"21 de agosto de 1994"
17,1,7,330,334,434,768,"21 de agosto de 1994"
17,1,7,331,282,362,644,"21 de agosto de 1994"
17,1,7,332,539,636,1175,"21 de agosto de 1994"
17,1,7,333,612,749,1361,"21 de agosto de 1994"
17,1,7,334,648,747,1395,"21 de agosto de 1994"
17,1,7,335,642,721,1363,"21 de agosto de 1994"
17,1,7,336,489,555,1044,"21 de agosto de 1994"
17,1,7,337,343,374,717,"21 de agosto de 1994"
17,1,7,338,249,265,514,"21 de agosto de 1994"
17,1,7,339,375,434,809,"21 de agosto de 1994"
17,1,7,340,805,920,1725,"21 de agosto de 1994"
17,1,7,341,229,242,471,"21 de agosto de 1994"
17,1,7,342,296,398,694,"21 de agosto de 1994"
17,1,7,343,320,409,729,"21 de agosto de 1994"
17,1,7,344,515,606,1121,"21 de agosto de 1994"
17,1,7,345,227,290,517,"21 de agosto de 1994"
17,1,7,346,303,381,684,"21 de agosto de 1994"
17,1,7,347,193,242,435,"21 de agosto de 1994"
17,1,7,348,446,468,914,"21 de agosto de 1994"
17,1,7,349,438,547,985,"21 de agosto de 1994"
17,1,7,350,543,682,1225,"21 de agosto de 1994"
17,1,7,351,223,221,444,"21 de agosto de 1994"
17,1,7,352,335,402,737,"21 de agosto de 1994"
17,1,7,353,351,425,776,"21 de agosto de 1994"
17,1,7,354,420,524,944,"21 de agosto de 1994"
17,1,7,355,471,524,995,"21 de agosto de 1994"
17,1,7,356,485,572,1057,"21 de agosto de 1994"
17,1,7,357,344,414,758,"21 de agosto de 1994"
17,1,7,358,182,258,440,"21 de agosto de 1994"
17,1,7,359,407,497,904,"21 de agosto de 1994"
17,1,7,360,478,588,1066,"21 de agosto de 1994"
17,1,7,361,460,522,982,"21 de agosto de 1994"
17,1,7,362,248,317,565,"21 de agosto de 1994"
17,1,7,363,287,396,683,"21 de agosto de 1994"
17,1,7,364,412,470,882,"21 de agosto de 1994"
17,1,7,365,406,466,872,"21 de agosto de 1994"
17,1,7,366,408,434,842,"21 de agosto de 1994"
17,1,7,367,484,541,1025,"21 de agosto de 1994"
17,1,7,368,425,450,875,"21 de agosto de 1994"
17,1,7,369,533,690,1223,"21 de agosto de 1994"
17,1,7,370,643,719,1362,"21 de agosto de 1994"
17,1,7,371,457,498,955,"21 de agosto de 1994"
17,1,7,372,378,473,851,"21 de agosto de 1994"
17,1,7,373,455,550,1005,"21 de agosto de 1994"
17,1,7,374,326,359,685,"21 de agosto de 1994"
17,1,7,375,722,851,1573,"21 de agosto de 1994"
17,1,7,376,233,275,508,"21 de agosto de 1994"
17,1,7,377,352,379,731,"21 de agosto de 1994"
17,1,7,378,410,451,861,"21 de agosto de 1994"
17,1,7,379,351,423,774,"21 de agosto de 1994"
17,1,7,380,193,197,390,"21 de agosto de 1994"
17,1,7,381,208,247,455,"21 de agosto de 1994"
17,1,7,382,791,961,1752,"21 de agosto de 1994"
17,1,7,383,458,506,964,"21 de agosto de 1994"
17,1,7,384,340,433,773,"21 de agosto de 1994"
17,1,7,385,626,775,1401,"21 de agosto de 1994"
17,1,7,386,536,584,1120,"21 de agosto de 1994"
17,1,7,387,375,444,819,"21 de agosto de 1994"
17,1,7,388,702,828,1530,"21 de agosto de 1994"
17,1,7,389,191,202,393,"21 de agosto de 1994"
17,1,7,390,659,151,810,"21 de agosto de 1994"
17,2,3,24,325,330,655,"21 de agosto de 1994"
17,2,3,25,370,390,760,"21 de agosto de 1994"
17,2,3,26,615,668,1283,"21 de agosto de 1994"
17,2,3,27,389,430,819,"21 de agosto de 1994"
17,2,3,28,390,403,793,"21 de agosto de 1994"
17,2,3,29,455,498,953,"21 de agosto de 1994"
17,2,3,30,457,531,988,"21 de agosto de 1994"
17,2,3,31,523,604,1127,"21 de agosto de 1994"
17,2,3,32,272,296,568,"21 de agosto de 1994"
17,2,3,33,533,532,1065,"21 de agosto de 1994"
17,2,3,34,61,71,132,"21 de agosto de 1994"
17,2,3,35,293,299,592,"21 de agosto de 1994"
17,2,3,36,296,287,583,"21 de agosto de 1994"
17,2,3,37,241,235,476,"21 de agosto de 1994"
17,2,3,38,400,434,834,"21 de agosto de 1994"
17,2,3,39,299,322,621,"21 de agosto de 1994"
17,2,3,40,326,365,691,"21 de agosto de 1994"
17,2,3,41,280,298,578,"21 de agosto de 1994"
17,2,3,42,102,113,215,"21 de agosto de 1994"
17,2,3,43,210,215,425,"21 de agosto de 1994"
17,2,4,44,362,386,748,"21 de agosto de 1994"
17,2,4,45,557,686,1243,"21 de agosto de 1994"
17,2,4,46,349,387,736,"21 de agosto de 1994"
17,2,4,47,414,454,868,"21 de agosto de 1994"
17,2,4,48,364,383,747,"21 de agosto de 1994"
17,2,4,49,524,582,1106,"21 de agosto de 1994"
17,2,4,50,281,330,611,"21 de agosto de 1994"
17,2,4,51,347,386,733,"21 de agosto de 1994"
17,2,4,52,398,466,864,"21 de agosto de 1994"
17,2,4,53,92,98,190,"21 de agosto de 1994"
17,2,4,54,439,567,1006,"21 de agosto de 1994"
17,2,4,55,443,488,931,"21 de agosto de 1994"
17,2,4,56,436,516,952,"21 de agosto de 1994"
17,2,4,57,469,498,967,"21 de agosto de 1994"
17,2,4,58,451,521,972,"21 de agosto de 1994"
17,2,4,59,502,545,1047,"21 de agosto de 1994"
17,2,4,60,133,149,282,"21 de agosto de 1994"
17,2,4,61,461,565,1026,"21 de agosto de 1994"
17,2,4,62,534,611,1145,"21 de agosto de 1994"
17,2,4,63,32,36,68,"21 de agosto de 1994"
17,2,4,64,104,96,200,"21 de agosto de 1994"
17,2,4,65,225,245,470,"21 de agosto de 1994"
17,2,4,66,424,462,886,"21 de agosto de 1994"
17,2,4,67,490,508,998,"21 de agosto de 1994"
17,2,4,68,394,474,868,"21 de agosto de 1994"
17,2,4,69,385,458,843,"21 de agosto de 1994"
17,2,4,70,444,510,954,"21 de agosto de 1994"
17,2,4,71,411,455,866,"21 de agosto de 1994"
17,2,4,72,566,648,1214,"21 de agosto de 1994"
17,2,4,73,461,513,974,"21 de agosto de 1994"
17,2,4,74,592,632,1224,"21 de agosto de 1994"
17,2,4,75,421,414,835,"21 de agosto de 1994"
17,2,4,76,333,358,691,"21 de agosto de 1994"
17,2,4,77,531,516,1047,"21 de agosto de 1994"
17,2,4,78,53,58,111,"21 de agosto de 1994"
17,2,4,79,219,196,415,"21 de agosto de 1994"
17,2,4,80,415,412,827,"21 de agosto de 1994"
17,2,4,81,125,119,244,"21 de agosto de 1994"
17,2,4,82,59,63,122,"21 de agosto de 1994"
17,2,4,83,337,353,690,"21 de agosto de 1994"
17,2,4,84,419,409,828,"21 de agosto de 1994"
17,2,4,85,210,191,401,"21 de agosto de 1994"
17,2,6,97,344,346,690,"21 de agosto de 1994"
17,2,6,98,244,271,515,"21 de agosto de 1994"
17,2,6,99,478,523,1001,"21 de agosto de 1994"
17,2,6,100,434,437,871,"21 de agosto de 1994"
17,2,6,101,267,307,574,"21 de agosto de 1994"
17,2,6,102,399,436,835,"21 de agosto de 1994"
17,2,6,103,381,387,768,"21 de agosto de 1994"
17,2,6,104,304,346,650,"21 de agosto de 1994"
17,2,6,105,257,323,580,"21 de agosto de 1994"
17,2,6,106,284,352,636,"21 de agosto de 1994"
17,2,6,107,289,369,658,"21 de agosto de 1994"
17,2,6,108,481,551,1032,"21 de agosto de 1994"
17,2,6,109,402,474,876,"21 de agosto de 1994"
17,2,6,110,482,549,1031,"21 de agosto de 1994"
17,2,6,111,471,565,1036,"21 de agosto de 1994"
17,2,6,112,523,573,1096,"21 de agosto de 1994"
17,2,6,113,406,440,846,"21 de agosto de 1994"
17,2,6,114,663,698,1361,"21 de agosto de 1994"
17,2,6,115,304,326,630,"21 de agosto de 1994"
17,2,6,116,454,583,1037,"21 de agosto de 1994"
17,2,6,117,368,447,815,"21 de agosto de 1994"
17,2,6,118,395,470,865,"21 de agosto de 1994"
17,2,6,119,447,552,999,"21 de agosto de 1994"
17,2,6,120,427,499,926,"21 de agosto de 1994"
17,2,6,121,175,179,354,"21 de agosto de 1994"
17,2,6,122,265,332,597,"21 de agosto de 1994"
17,2,6,123,574,683,1257,"21 de agosto de 1994"
17,2,6,124,460,513,973,"21 de agosto de 1994"
17,2,6,125,570,615,1185,"21 de agosto de 1994"
17,2,6,126,348,404,752,"21 de agosto de 1994"
17,2,6,127,465,544,1009,"21 de agosto de 1994"
17,2,6,128,436,497,933,"21 de agosto de 1994"
17,2,6,129,422,467,889,"21 de agosto de 1994"
17,2,6,130,303,358,661,"21 de agosto de 1994"
17,2,6,131,556,627,1183,"21 de agosto de 1994"
17,2,6,132,460,553,1013,"21 de agosto de 1994"
17,2,6,133,149,166,315,"21 de agosto de 1994"
17,2,6,134,418,462,880,"21 de agosto de 1994"
17,2,6,135,709,819,1528,"21 de agosto de 1994"
17,2,6,136,347,429,776,"21 de agosto de 1994"
17,2,6,137,591,417,1008,"21 de agosto de 1994"
17,2,6,138,407,517,924,"21 de agosto de 1994"
17,2,6,139,311,369,680,"21 de agosto de 1994"
17,2,6,140,467,525,992,"21 de agosto de 1994"
17,2,6,141,384,395,779,"21 de agosto de 1994"
17,2,6,142,432,558,990,"21 de agosto de 1994"
17,2,6,143,538,670,1208,"21 de agosto de 1994"
17,2,6,144,341,414,755,"21 de agosto de 1994"
17,2,6,145,415,518,933,"21 de agosto de 1994"
17,2,6,146,468,568,1036,"21 de agosto de 1994"
17,2,6,147,417,460,877,"21 de agosto de 1994"
17,2,6,148,420,492,912,"21 de agosto de 1994"
17,2,6,149,281,353,634,"21 de agosto de 1994"
17,2,6,150,362,407,769,"21 de agosto de 1994"
17,2,6,151,450,503,953,"21 de agosto de 1994"
17,2,6,152,459,521,980,"21 de agosto de 1994"
17,2,6,153,251,327,578,"21 de agosto de 1994"
17,2,6,154,306,390,696,"21 de agosto de 1994"
17,2,6,155,441,535,976,"21 de agosto de 1994"
17,2,6,156,370,419,789,"21 de agosto de 1994"
17,2,6,157,329,413,742,"21 de agosto de 1994"
17,2,6,158,237,286,523,"21 de agosto de 1994"
17,2,6,159,591,718,1309,"21 de agosto de 1994"
17,2,6,160,300,389,689,"21 de agosto de 1994"
17,2,6,161,247,340,587,"21 de agosto de 1994"
17,2,6,162,445,528,973,"21 de agosto de 1994"
17,2,6,163,201,224,425,"21 de agosto de 1994"
17,2,6,164,182,210,392,"21 de agosto de 1994"
17,2,6,165,379,422,801,"21 de agosto de 1994"
17,2,6,166,454,517,971,"21 de agosto de 1994"
17,2,6,167,392,445,837,"21 de agosto de 1994"
17,2,6,168,337,427,764,"21 de agosto de 1994"
17,2,6,169,443,489,932,"21 de agosto de 1994"
17,2,6,170,343,418,761,"21 de agosto de 1994"
17,2,6,171,203,257,460,"21 de agosto de 1994"
17,2,6,172,267,316,583,"21 de agosto de 1994"
17,2,6,173,496,601,1097,"21 de agosto de 1994"
17,2,6,174,390,470,860,"21 de agosto de 1994"
17,2,6,175,366,412,778,"21 de agosto de 1994"
17,2,6,176,253,314,567,"21 de agosto de 1994"
17,2,6,177,409,449,858,"21 de agosto de 1994"
17,2,6,178,543,591,1134,"21 de agosto de 1994"
17,2,6,179,385,455,840,"21 de agosto de 1994"
17,2,6,180,380,462,842,"21 de agosto de 1994"
17,2,6,181,299,349,648,"21 de agosto de 1994"
17,2,6,182,371,423,794,"21 de agosto de 1994"
17,2,6,183,417,493,910,"21 de agosto de 1994"
17,2,6,184,202,219,421,"21 de agosto de 1994"
17,2,6,185,551,588,1139,"21 de agosto de 1994"
17,2,6,186,350,371,721,"21 de agosto de 1994"
17,2,6,187,47,59,106,"21 de agosto de 1994"
17,2,10,423,345,360,705,"21 de agosto de 1994"
17,2,10,424,362,390,752,"21 de agosto de 1994"
17,2,10,425,326,398,724,"21 de agosto de 1994"
17,2,10,426,538,537,1075,"21 de agosto de 1994"
17,2,10,427,443,434,877,"21 de agosto de 1994"
17,2,10,428,267,286,553,"21 de agosto de 1994"
17,2,10,429,458,497,955,"21 de agosto de 1994"
17,2,10,430,538,560,1098,"21 de agosto de 1994"
17,2,13,537,260,335,595,"21 de agosto de 1994"
17,2,13,538,409,436,845,"21 de agosto de 1994"
17,2,13,539,331,351,682,"21 de agosto de 1994"
17,2,13,540,451,457,908,"21 de agosto de 1994"
17,2,13,541,337,353,690,"21 de agosto de 1994"
17,2,13,542,321,368,689,"21 de agosto de 1994"
17,2,13,543,161,163,324,"21 de agosto de 1994"
17,2,13,544,470,453,923,"21 de agosto de 1994"
17,2,13,545,242,265,507,"21 de agosto de 1994"
17,2,13,546,245,250,495,"21 de agosto de 1994"
17,2,13,547,314,319,633,"21 de agosto de 1994"
17,2,19,654,597,563,1160,"21 de agosto de 1994"
17,2,19,655,479,498,977,"21 de agosto de 1994"
17,2,19,656,401,440,841,"21 de agosto de 1994"
17,2,19,657,476,460,936,"21 de agosto de 1994"
17,2,19,658,376,374,750,"21 de agosto de 1994"
17,2,19,659,114,132,246,"21 de agosto de 1994"
17,2,19,660,447,506,953,"21 de agosto de 1994"
17,2,19,661,319,335,654,"21 de agosto de 1994"
17,2,19,662,431,437,868,"21 de agosto de 1994"
17,2,19,663,480,459,939,"21 de agosto de 1994"
17,2,19,664,126,95,221,"21 de agosto de 1994"
17,2,19,665,361,346,707,"21 de agosto de 1994"
17,2,19,666,43,39,82,"21 de agosto de 1994"
17,2,19,667,467,473,940,"21 de agosto de 1994"
17,2,19,668,378,388,766,"21 de agosto de 1994"
17,2,19,669,434,443,877,"21 de agosto de 1994"
17,2,32,895,309,321,630,"21 de agosto de 1994"
17,2,32,896,411,393,804,"21 de agosto de 1994"
17,2,32,897,292,290,582,"21 de agosto de 1994"
17,2,32,898,312,335,647,"21 de agosto de 1994"
17,2,32,899,388,391,779,"21 de agosto de 1994"
17,2,32,900,426,403,829,"21 de agosto de 1994"
17,2,33,901,496,523,1019,"21 de agosto de 1994"
17,2,33,902,738,724,1462,"21 de agosto de 1994"
17,2,33,903,224,187,411,"21 de agosto de 1994"
17,2,33,904,299,299,598,"21 de agosto de 1994"
17,2,33,905,403,403,806,"21 de agosto de 1994"
17,2,33,906,649,608,1257,"21 de agosto de 1994"
17,3,2,12,542,531,1073,"21 de agosto de 1994"
17,3,2,13,505,515,1020,"21 de agosto de 1994"
17,3,2,14,437,439,876,"21 de agosto de 1994"
17,3,2,15,362,348,710,"21 de agosto de 1994"
17,3,2,16,147,144,291,"21 de agosto de 1994"
17,3,2,17,283,315,598,"21 de agosto de 1994"
17,3,2,18,197,172,369,"21 de agosto de 1994"
17,3,2,19,221,212,433,"21 de agosto de 1994"
17,3,2,20,89,98,187,"21 de agosto de 1994"
17,3,2,21,73,77,150,"21 de agosto de 1994"
17,3,2,22,78,81,159,"21 de agosto de 1994"
17,3,2,23,77,94,171,"21 de agosto de 1994"
17,3,8,391,319,376,695,"21 de agosto de 1994"
17,3,8,392,385,424,809,"21 de agosto de 1994"
17,3,8,393,251,275,526,"21 de agosto de 1994"
17,3,8,394,456,498,954,"21 de agosto de 1994"
17,3,8,395,350,407,757,"21 de agosto de 1994"
17,3,8,396,590,656,1246,"21 de agosto de 1994"
17,3,8,397,498,546,1044,"21 de agosto de 1994"
17,3,8,398,467,539,1006,"21 de agosto de 1994"
17,3,8,399,473,499,972,"21 de agosto de 1994"
17,3,8,400,580,681,1261,"21 de agosto de 1994"
17,3,8,401,356,426,782,"21 de agosto de 1994"
17,3,8,402,600,651,1251,"21 de agosto de 1994"
17,3,8,403,356,414,770,"21 de agosto de 1994"
17,3,8,404,521,637,1158,"21 de agosto de 1994"
17,3,8,405,316,346,662,"21 de agosto de 1994"
17,3,8,406,713,799,1512,"21 de agosto de 1994"
17,3,8,407,434,512,946,"21 de agosto de 1994"
17,3,8,408,397,427,824,"21 de agosto de 1994"
17,3,8,409,485,487,972,"21 de agosto de 1994"
17,3,8,410,511,577,1088,"21 de agosto de 1994"
17,3,8,411,311,352,663,"21 de agosto de 1994"
17,3,9,412,421,436,857,"21 de agosto de 1994"
17,3,9,413,360,338,698,"21 de agosto de 1994"
17,3,9,414,316,328,644,"21 de agosto de 1994"
17,3,9,415,38,39,77,"21 de agosto de 1994"
17,3,9,416,436,456,892,"21 de agosto de 1994"
17,3,9,417,547,549,1096,"21 de agosto de 1994"
17,3,9,418,290,288,578,"21 de agosto de 1994"
17,3,9,419,392,394,786,"21 de agosto de 1994"
17,3,9,420,155,171,326,"21 de agosto de 1994"
17,3,9,421,119,129,248,"21 de agosto de 1994"
17,3,9,422,161,175,336,"21 de agosto de 1994"
17,3,11,431,304,334,638,"21 de agosto de 1994"
17,3,11,432,265,316,581,"21 de agosto de 1994"
17,3,11,433,496,555,1051,"21 de agosto de 1994"
17,3,11,434,575,698,1273,"21 de agosto de 1994"
17,3,11,435,556,663,1219,"21 de agosto de 1994"
17,3,11,436,550,712,1262,"21 de agosto de 1994"
17,3,11,437,468,572,1040,"21 de agosto de 1994"
17,3,11,438,462,534,996,"21 de agosto de 1994"
17,3,11,439,427,507,934,"21 de agosto de 1994"
17,3,11,440,286,352,638,"21 de agosto de 1994"
17,3,11,441,427,493,920,"21 de agosto de 1994"
17,3,11,442,350,408,758,"21 de agosto de 1994"
17,3,11,443,420,499,919,"21 de agosto de 1994"
17,3,11,444,576,696,1272,"21 de agosto de 1994"
17,3,11,445,426,512,938,"21 de agosto de 1994"
17,3,11,446,378,417,795,"21 de agosto de 1994"
17,3,11,447,295,382,677,"21 de agosto de 1994"
17,3,11,448,504,561,1065,"21 de agosto de 1994"
17,3,11,449,859,920,1779,"21 de agosto de 1994"
17,3,11,450,506,612,1118,"21 de agosto de 1994"
17,3,11,451,468,542,1010,"21 de agosto de 1994"
17,3,11,452,471,544,1015,"21 de agosto de 1994"
17,3,11,453,599,655,1254,"21 de agosto de 1994"
17,3,11,454,668,780,1448,"21 de agosto de 1994"
17,3,11,455,767,908,1675,"21 de agosto de 1994"
17,3,11,456,335,353,688,"21 de agosto de 1994"
17,3,11,457,673,734,1407,"21 de agosto de 1994"
17,3,11,458,553,578,1131,"21 de agosto de 1994"
17,3,11,459,447,533,980,"21 de agosto de 1994"
17,3,11,460,306,340,646,"21 de agosto de 1994"
17,3,11,461,384,480,864,"21 de agosto de 1994"
17,3,11,462,439,478,917,"21 de agosto de 1994"
17,3,11,463,510,588,1098,"21 de agosto de 1994"
17,3,11,464,648,706,1354,"21 de agosto de 1994"
17,3,11,465,801,884,1685,"21 de agosto de 1994"
17,3,11,466,244,271,515,"21 de agosto de 1994"
17,3,11,467,344,394,738,"21 de agosto de 1994"
17,3,11,468,446,477,923,"21 de agosto de 1994"
17,3,11,469,720,796,1516,"21 de agosto de 1994"
17,3,11,470,551,651,1202,"21 de agosto de 1994"
17,3,11,471,741,851,1592,"21 de agosto de 1994"
17,3,11,472,645,766,1411,"21 de agosto de 1994"
17,3,11,473,286,316,602,"21 de agosto de 1994"
17,3,11,474,511,570,1081,"21 de agosto de 1994"
17,3,11,475,312,411,723,"21 de agosto de 1994"
17,3,11,476,237,269,506,"21 de agosto de 1994"
17,3,11,477,555,648,1203,"21 de agosto de 1994"
17,3,11,478,395,456,851,"21 de agosto de 1994"
17,3,11,479,406,493,899,"21 de agosto de 1994"
17,3,11,480,350,401,751,"21 de agosto de 1994"
17,3,11,481,504,550,1054,"21 de agosto de 1994"
17,3,11,482,352,412,764,"21 de agosto de 1994"
17,3,11,483,701,795,1496,"21 de agosto de 1994"
17,3,11,484,704,737,1441,"21 de agosto de 1994"
17,3,11,485,703,773,1476,"21 de agosto de 1994"
17,3,11,486,795,810,1605,"21 de agosto de 1994"
17,3,11,487,481,568,1049,"21 de agosto de 1994"
17,3,11,488,847,922,1769,"21 de agosto de 1994"
17,3,11,489,414,488,902,"21 de agosto de 1994"
17,3,11,490,240,265,505,"21 de agosto de 1994"
17,3,11,491,242,272,514,"21 de agosto de 1994"
17,3,11,492,225,276,501,"21 de agosto de 1994"
17,3,11,493,288,365,653,"21 de agosto de 1994"
17,3,11,494,293,332,625,"21 de agosto de 1994"
17,3,11,495,423,441,864,"21 de agosto de 1994"
17,3,11,496,360,357,717,"21 de agosto de 1994"
17,3,11,497,589,620,1209,"21 de agosto de 1994"
17,3,11,498,403,477,880,"21 de agosto de 1994"
17,3,11,499,442,504,946,"21 de agosto de 1994"
17,3,11,500,163,205,368,"21 de agosto de 1994"
17,3,16,569,558,564,1122,"21 de agosto de 1994"
17,3,16,570,293,295,588,"21 de agosto de 1994"
17,3,16,571,259,264,523,"21 de agosto de 1994"
17,3,16,572,314,329,643,"21 de agosto de 1994"
17,3,16,573,267,281,548,"21 de agosto de 1994"
17,3,16,574,218,210,428,"21 de agosto de 1994"
17,3,16,575,518,557,1075,"21 de agosto de 1994"
17,3,16,576,447,473,920,"21 de agosto de 1994"
17,3,16,577,181,193,374,"21 de agosto de 1994"
17,3,16,578,470,450,920,"21 de agosto de 1994"
17,3,18,611,382,442,824,"21 de agosto de 1994"
17,3,18,612,372,444,816,"21 de agosto de 1994"
17,3,18,613,244,266,510,"21 de agosto de 1994"
17,3,18,614,316,340,656,"21 de agosto de 1994"
17,3,18,615,493,596,1089,"21 de agosto de 1994"
17,3,18,616,463,544,1007,"21 de agosto de 1994"
17,3,18,617,351,420,771,"21 de agosto de 1994"
17,3,18,618,916,1035,1951,"21 de agosto de 1994"
17,3,18,619,514,585,1099,"21 de agosto de 1994"
17,3,18,620,410,433,843,"21 de agosto de 1994"
17,3,18,621,433,485,918,"21 de agosto de 1994"
17,3,18,622,507,611,1118,"21 de agosto de 1994"
17,3,18,623,478,539,1017,"21 de agosto de 1994"
17,3,18,624,420,497,917,"21 de agosto de 1994"
17,3,18,625,407,480,887,"21 de agosto de 1994"
17,3,18,626,479,565,1044,"21 de agosto de 1994"
17,3,18,627,438,452,890,"21 de agosto de 1994"
17,3,18,628,460,539,999,"21 de agosto de 1994"
17,3,18,629,167,180,347,"21 de agosto de 1994"
17,3,18,630,886,1023,1909,"21 de agosto de 1994"
17,3,18,631,514,597,1111,"21 de agosto de 1994"
17,3,18,632,301,347,648,"21 de agosto de 1994"
17,3,18,633,471,544,1015,"21 de agosto de 1994"
17,3,18,634,432,509,941,"21 de agosto de 1994"
17,3,18,635,517,577,1094,"21 de agosto de 1994"
17,3,18,636,612,726,1338,"21 de agosto de 1994"
17,3,18,637,419,530,949,"21 de agosto de 1994"
17,3,18,638,485,576,1061,"21 de agosto de 1994"
17,3,18,639,434,475,909,"21 de agosto de 1994"
17,3,18,640,331,393,724,"21 de agosto de 1994"
17,3,18,641,386,473,859,"21 de agosto de 1994"
17,3,18,642,467,548,1015,"21 de agosto de 1994"
17,3,18,643,269,325,594,"21 de agosto de 1994"
17,3,18,644,579,679,1258,"21 de agosto de 1994"
17,3,18,645,490,570,1060,"21 de agosto de 1994"
17,3,18,646,387,429,816,"21 de agosto de 1994"
17,3,18,647,419,475,894,"21 de agosto de 1994"
17,3,18,648,512,626,1138,"21 de agosto de 1994"
17,3,18,649,420,447,867,"21 de agosto de 1994"
17,3,18,650,137,160,297,"21 de agosto de 1994"
17,3,18,651,562,612,1174,"21 de agosto de 1994"
17,3,18,652,513,558,1071,"21 de agosto de 1994"
17,3,18,653,380,392,772,"21 de agosto de 1994"
17,3,20,670,322,356,678,"21 de agosto de 1994"
17,3,20,671,355,396,751,"21 de agosto de 1994"
17,3,20,672,165,186,351,"21 de agosto de 1994"
17,3,20,673,519,605,1124,"21 de agosto de 1994"
17,3,20,674,406,451,857,"21 de agosto de 1994"
17,3,20,675,495,531,1026,"21 de agosto de 1994"
17,3,20,676,482,486,968,"21 de agosto de 1994"
17,3,20,677,370,365,735,"21 de agosto de 1994"
17,3,20,678,259,285,544,"21 de agosto de 1994"
17,3,20,679,412,429,841,"21 de agosto de 1994"
17,3,20,680,362,394,756,"21 de agosto de 1994"
17,3,20,681,273,288,561,"21 de agosto de 1994"
17,3,20,682,425,414,839,"21 de agosto de 1994"
17,3,20,683,498,431,929,"21 de agosto de 1994"
17,3,20,684,229,197,426,"21 de agosto de 1994"
17,3,20,685,228,227,455,"21 de agosto de 1994"
17,3,20,686,311,318,629,"21 de agosto de 1994"
17,3,20,687,338,393,731,"21 de agosto de 1994"
17,3,20,688,155,189,344,"21 de agosto de 1994"
17,3,22,695,568,588,1156,"21 de agosto de 1994"
17,3,22,696,520,510,1030,"21 de agosto de 1994"
17,3,22,697,729,817,1546,"21 de agosto de 1994"
17,3,22,698,283,299,582,"21 de agosto de 1994"
17,3,22,699,348,357,705,"21 de agosto de 1994"
17,3,22,700,395,408,803,"21 de agosto de 1994"
17,3,22,701,365,351,716,"21 de agosto de 1994"
17,3,22,702,305,343,648,"21 de agosto de 1994"
17,3,23,703,486,484,970,"21 de agosto de 1994"
17,3,23,704,381,392,773,"21 de agosto de 1994"
17,3,23,705,234,208,442,"21 de agosto de 1994"
17,3,23,706,176,161,337,"21 de agosto de 1994"
17,3,26,760,407,397,804,"21 de agosto de 1994"
17,3,26,761,589,552,1141,"21 de agosto de 1994"
17,3,26,762,486,499,985,"21 de agosto de 1994"
17,3,26,763,333,311,644,"21 de agosto de 1994"
17,3,26,764,325,293,618,"21 de agosto de 1994"
17,3,26,765,169,152,321,"21 de agosto de 1994"
17,3,26,766,329,306,635,"21 de agosto de 1994"
17,3,26,767,154,163,317,"21 de agosto de 1994"
17,3,26,768,356,360,716,"21 de agosto de 1994"
17,3,27,769,585,562,1147,"21 de agosto de 1994"
17,3,27,770,432,453,885,"21 de agosto de 1994"
17,3,27,771,401,411,812,"21 de agosto de 1994"
17,3,27,772,54,62,116,"21 de agosto de 1994"
17,3,27,773,362,359,721,"21 de agosto de 1994"
17,3,27,774,84,76,160,"21 de agosto de 1994"
17,3,27,775,62,61,123,"21 de agosto de 1994"
17,3,29,799,465,535,1000,"21 de agosto de 1994"
17,3,29,800,446,436,882,"21 de agosto de 1994"
17,3,29,801,483,480,963,"21 de agosto de 1994"
17,3,29,802,403,423,826,"21 de agosto de 1994"
17,3,29,803,342,382,724,"21 de agosto de 1994"
17,3,29,804,486,488,974,"21 de agosto de 1994"
17,3,29,805,512,602,1114,"21 de agosto de 1994"
17,3,29,806,486,537,1023,"21 de agosto de 1994"
17,3,29,807,275,305,580,"21 de agosto de 1994"
17,3,29,808,471,572,1043,"21 de agosto de 1994"
17,3,29,809,458,534,992,"21 de agosto de 1994"
17,3,29,810,639,754,1393,"21 de agosto de 1994"
17,3,29,811,555,664,1219,"21 de agosto de 1994"
17,3,29,812,507,563,1070,"21 de agosto de 1994"
17,3,29,813,476,514,990,"21 de agosto de 1994"
17,3,29,814,196,214,410,"21 de agosto de 1994"
17,3,29,815,360,364,724,"21 de agosto de 1994"
17,3,29,816,480,576,1056,"21 de agosto de 1994"
17,3,29,817,660,773,1433,"21 de agosto de 1994"
17,3,29,818,391,408,799,"21 de agosto de 1994"
17,3,29,819,244,292,536,"21 de agosto de 1994"
17,3,29,820,327,372,699,"21 de agosto de 1994"
17,3,29,821,201,218,419,"21 de agosto de 1994"
17,3,29,822,284,301,585,"21 de agosto de 1994"
17,3,29,823,256,294,550,"21 de agosto de 1994"
17,3,29,824,313,336,649,"21 de agosto de 1994"
17,3,29,825,278,321,599,"21 de agosto de 1994"
17,3,29,826,213,255,468,"21 de agosto de 1994"
17,3,29,827,222,241,463,"21 de agosto de 1994"
17,3,29,828,376,410,786,"21 de agosto de 1994"
17,3,29,829,374,405,779,"21 de agosto de 1994"
17,3,29,830,326,356,682,"21 de agosto de 1994"
17,3,29,831,161,157,318,"21 de agosto de 1994"
17,3,29,832,181,196,377,"21 de agosto de 1994"
17,3,29,833,252,272,524,"21 de agosto de 1994"
17,3,29,834,509,546,1055,"21 de agosto de 1994"
17,3,29,835,164,189,353,"21 de agosto de 1994"
17,3,29,836,363,421,784,"21 de agosto de 1994"
17,3,29,837,240,282,522,"21 de agosto de 1994"
17,3,29,838,280,294,574,"21 de agosto de 1994"
17,3,29,839,538,619,1157,"21 de agosto de 1994"
17,3,29,840,415,446,861,"21 de agosto de 1994"
17,3,29,841,90,89,179,"21 de agosto de 1994"
17,3,29,842,312,376,688,"21 de agosto de 1994"
17,3,29,843,539,592,1131,"21 de agosto de 1994"
17,3,29,844,623,681,1304,"21 de agosto de 1994"
17,3,29,845,252,277,529,"21 de agosto de 1994"
17,3,29,846,245,234,479,"21 de agosto de 1994"
17,3,29,847,300,298,598,"21 de agosto de 1994"
17,3,29,848,332,330,662,"21 de agosto de 1994"
17,3,29,849,172,206,378,"21 de agosto de 1994"
17,3,30,850,450,469,919,"21 de agosto de 1994"
17,3,30,851,552,607,1159,"21 de agosto de 1994"
17,3,30,852,724,727,1451,"21 de agosto de 1994"
17,3,30,853,449,403,852,"21 de agosto de 1994"
17,3,30,854,350,335,685,"21 de agosto de 1994"
17,3,30,855,454,499,953,"21 de agosto de 1994"
17,3,30,856,587,506,1093,"21 de agosto de 1994"
17,3,30,857,383,371,754,"21 de agosto de 1994"
17,3,30,858,511,510,1021,"21 de agosto de 1994"
17,3,30,859,368,409,777,"21 de agosto de 1994"
17,3,30,860,296,356,652,"21 de agosto de 1994"
17,3,30,861,355,437,792,"21 de agosto de 1994"
17,3,30,862,515,577,1092,"21 de agosto de 1994"
17,3,30,863,476,541,1017,"21 de agosto de 1994"
17,3,30,864,381,466,847,"21 de agosto de 1994"
17,3,30,865,287,374,661,"21 de agosto de 1994"
17,3,30,866,168,190,358,"21 de agosto de 1994"
17,3,30,867,277,234,511,"21 de agosto de 1994"
17,3,30,868,121,107,228,"21 de agosto de 1994"
17,4,1,1,378,395,773,"21 de agosto de 1994"
17,4,1,2,213,237,450,"21 de agosto de 1994"
17,4,1,3,391,443,834,"21 de agosto de 1994"
17,4,1,4,430,478,908,"21 de agosto de 1994"
17,4,1,5,180,229,409,"21 de agosto de 1994"
17,4,1,6,567,636,1203,"21 de agosto de 1994"
17,4,1,7,266,292,558,"21 de agosto de 1994"
17,4,1,8,364,410,774,"21 de agosto de 1994"
17,4,1,9,398,424,822,"21 de agosto de 1994"
17,4,1,10,334,388,722,"21 de agosto de 1994"
17,4,1,11,200,213,413,"21 de agosto de 1994"
17,4,5,86,296,329,625,"21 de agosto de 1994"
17,4,5,87,463,502,965,"21 de agosto de 1994"
17,4,5,88,178,174,352,"21 de agosto de 1994"
17,4,5,89,462,441,903,"21 de agosto de 1994"
17,4,5,90,141,150,291,"21 de agosto de 1994"
17,4,5,91,94,103,197,"21 de agosto de 1994"
17,4,5,92,209,228,437,"21 de agosto de 1994"
17,4,5,93,293,300,593,"21 de agosto de 1994"
17,4,5,94,203,229,432,"21 de agosto de 1994"
17,4,5,95,119,118,237,"21 de agosto de 1994"
17,4,5,96,88,85,173,"21 de agosto de 1994"
17,4,12,501,538,631,1169,"21 de agosto de 1994"
17,4,12,502,354,435,789,"21 de agosto de 1994"
17,4,12,503,175,211,386,"21 de agosto de 1994"
17,4,12,504,675,770,1445,"21 de agosto de 1994"
17,4,12,505,582,678,1260,"21 de agosto de 1994"
17,4,12,506,321,356,677,"21 de agosto de 1994"
17,4,12,507,355,432,787,"21 de agosto de 1994"
17,4,12,508,282,313,595,"21 de agosto de 1994"
17,4,12,509,64,71,135,"21 de agosto de 1994"
17,4,12,510,291,299,590,"21 de agosto de 1994"
17,4,12,511,539,622,1161,"21 de agosto de 1994"
17,4,12,512,393,438,831,"21 de agosto de 1994"
17,4,12,513,449,509,958,"21 de agosto de 1994"
17,4,12,514,367,397,764,"21 de agosto de 1994"
17,4,12,515,332,378,710,"21 de agosto de 1994"
17,4,12,516,724,741,1465,"21 de agosto de 1994"
17,4,12,517,106,100,206,"21 de agosto de 1994"
17,4,12,518,394,411,805,"21 de agosto de 1994"
17,4,12,519,437,483,920,"21 de agosto de 1994"
17,4,12,520,253,274,527,"21 de agosto de 1994"
17,4,12,521,304,314,618,"21 de agosto de 1994"
17,4,12,522,316,363,679,"21 de agosto de 1994"
17,4,12,523,355,390,745,"21 de agosto de 1994"
17,4,12,524,343,412,755,"21 de agosto de 1994"
17,4,12,525,491,545,1036,"21 de agosto de 1994"
17,4,12,526,582,577,1159,"21 de agosto de 1994"
17,4,12,527,267,272,539,"21 de agosto de 1994"
17,4,12,528,420,433,853,"21 de agosto de 1994"
17,4,12,529,506,525,1031,"21 de agosto de 1994"
17,4,12,530,620,696,1316,"21 de agosto de 1994"
17,4,12,531,439,495,934,"21 de agosto de 1994"
17,4,12,532,303,311,614,"21 de agosto de 1994"
17,4,12,533,498,606,1104,"21 de agosto de 1994"
17,4,12,534,565,619,1184,"21 de agosto de 1994"
17,4,12,535,535,589,1124,"21 de agosto de 1994"
17,4,12,536,261,263,524,"21 de agosto de 1994"
17,4,14,548,342,341,683,"21 de agosto de 1994"
17,4,14,549,479,516,995,"21 de agosto de 1994"
17,4,14,550,288,298,586,"21 de agosto de 1994"
17,4,14,551,290,298,588,"21 de agosto de 1994"
17,4,14,552,230,259,489,"21 de agosto de 1994"
17,4,14,553,247,247,494,"21 de agosto de 1994"
17,4,14,554,331,343,674,"21 de agosto de 1994"
17,4,15,555,472,492,964,"21 de agosto de 1994"
17,4,15,556,376,421,797,"21 de agosto de 1994"
17,4,15,557,426,453,879,"21 de agosto de 1994"
17,4,15,558,454,496,950,"21 de agosto de 1994"
17,4,15,559,249,268,517,"21 de agosto de 1994"
17,4,15,560,497,538,1035,"21 de agosto de 1994"
17,4,15,561,323,327,650,"21 de agosto de 1994"
17,4,15,562,301,306,607,"21 de agosto de 1994"
17,4,15,563,211,204,415,"21 de agosto de 1994"
17,4,15,564,481,533,1014,"21 de agosto de 1994"
17,4,15,565,644,681,1325,"21 de agosto de 1994"
17,4,15,566,120,162,282,"21 de agosto de 1994"
17,4,15,567,371,390,761,"21 de agosto de 1994"
17,4,15,568,473,495,968,"21 de agosto de 1994"
17,4,17,579,266,268,534,"21 de agosto de 1994"
17,4,17,580,419,497,916,"21 de agosto de 1994"
17,4,17,581,386,366,752,"21 de agosto de 1994"
17,4,17,582,337,355,692,"21 de agosto de 1994"
17,4,17,583,472,556,1028,"21 de agosto de 1994"
17,4,17,584,359,406,765,"21 de agosto de 1994"
17,4,17,585,387,405,792,"21 de agosto de 1994"
17,4,17,586,462,501,963,"21 de agosto de 1994"
17,4,17,587,418,442,860,"21 de agosto de 1994"
17,4,17,588,377,437,814,"21 de agosto de 1994"
17,4,17,589,291,315,606,"21 de agosto de 1994"
17,4,17,590,373,395,768,"21 de agosto de 1994"
17,4,17,591,439,472,911,"21 de agosto de 1994"
17,4,17,592,441,438,879,"21 de agosto de 1994"
17,4,17,593,291,282,573,"21 de agosto de 1994"
17,4,17,594,309,310,619,"21 de agosto de 1994"
17,4,17,595,641,679,1320,"21 de agosto de 1994"
17,4,17,596,808,794,1602,"21 de agosto de 1994"
17,4,17,597,612,596,1208,"21 de agosto de 1994"
17,4,17,598,696,686,1382,"21 de agosto de 1994"
17,4,17,599,538,530,1068,"21 de agosto de 1994"
17,4,17,600,389,342,731,"21 de agosto de 1994"
17,4,17,601,490,542,1032,"21 de agosto de 1994"
17,4,17,602,561,559,1120,"21 de agosto de 1994"
17,4,17,603,118,108,226,"21 de agosto de 1994"
17,4,17,604,114,113,227,"21 de agosto de 1994"
17,4,17,605,306,338,644,"21 de agosto de 1994"
17,4,17,606,259,295,554,"21 de agosto de 1994"
17,4,17,607,283,311,594,"21 de agosto de 1994"
17,4,17,608,420,473,893,"21 de agosto de 1994"
17,4,17,609,364,377,741,"21 de agosto de 1994"
17,4,17,610,103,106,209,"21 de agosto de 1994"
17,4,21,689,497,521,1018,"21 de agosto de 1994"
17,4,21,690,477,514,991,"21 de agosto de 1994"
17,4,21,691,390,412,802,"21 de agosto de 1994"
17,4,21,692,176,183,359,"21 de agosto de 1994"
17,4,21,693,225,199,424,"21 de agosto de 1994"
17,4,21,694,95,98,193,"21 de agosto de 1994"
17,4,24,707,529,569,1098,"21 de agosto de 1994"
17,4,24,708,579,639,1218,"21 de agosto de 1994"
17,4,24,709,576,638,1214,"21 de agosto de 1994"
17,4,24,710,809,790,1599,"21 de agosto de 1994"
17,4,24,711,338,370,708,"21 de agosto de 1994"
17,4,24,712,200,212,412,"21 de agosto de 1994"
17,4,24,713,361,420,781,"21 de agosto de 1994"
17,4,24,714,650,664,1314,"21 de agosto de 1994"
17,4,24,715,136,138,274,"21 de agosto de 1994"
17,4,24,716,390,395,785,"21 de agosto de 1994"
17,4,24,717,502,512,1014,"21 de agosto de 1994"
17,4,24,718,220,209,429,"21 de agosto de 1994"
17,4,24,719,335,334,669,"21 de agosto de 1994"
17,4,24,720,143,162,305,"21 de agosto de 1994"
17,4,24,721,236,250,486,"21 de agosto de 1994"
17,4,24,722,321,318,639,"21 de agosto de 1994"
17,4,24,723,485,535,1020,"21 de agosto de 1994"
17,4,24,724,389,450,839,"21 de agosto de 1994"
17,4,24,725,629,668,1297,"21 de agosto de 1994"
17,4,24,726,403,429,832,"21 de agosto de 1994"
17,4,24,727,428,481,909,"21 de agosto de 1994"
17,4,24,728,371,452,823,"21 de agosto de 1994"
17,4,24,729,283,344,627,"21 de agosto de 1994"
17,4,24,730,415,476,891,"21 de agosto de 1994"
17,4,24,731,667,705,1372,"21 de agosto de 1994"
17,4,24,732,287,288,575,"21 de agosto de 1994"
17,4,24,733,161,134,295,"21 de agosto de 1994"
17,4,25,734,503,495,998,"21 de agosto de 1994"
17,4,25,735,444,484,928,"21 de agosto de 1994"
17,4,25,736,314,348,662,"21 de agosto de 1994"
17,4,25,737,663,650,1313,"21 de agosto de 1994"
17,4,25,738,610,711,1321,"21 de agosto de 1994"
17,4,25,739,483,521,1004,"21 de agosto de 1994"
17,4,25,740,857,925,1782,"21 de agosto de 1994"
17,4,25,741,589,660,1249,"21 de agosto de 1994"
17,4,25,742,464,533,997,"21 de agosto de 1994"
17,4,25,743,395,426,821,"21 de agosto de 1994"
17,4,25,744,123,103,226,"21 de agosto de 1994"
17,4,25,745,255,221,476,"21 de agosto de 1994"
17,4,25,746,220,187,407,"21 de agosto de 1994"
17,4,25,747,98,95,193,"21 de agosto de 1994"
17,4,25,748,183,164,347,"21 de agosto de 1994"
17,4,25,749,337,331,668,"21 de agosto de 1994"
17,4,25,750,166,140,306,"21 de agosto de 1994"
17,4,25,751,119,119,238,"21 de agosto de 1994"
17,4,25,752,65,73,138,"21 de agosto de 1994"
17,4,25,753,150,150,300,"21 de agosto de 1994"
17,4,25,754,107,81,188,"21 de agosto de 1994"
17,4,25,755,111,113,224,"21 de agosto de 1994"
17,4,25,756,366,366,732,"21 de agosto de 1994"
17,4,25,757,114,111,225,"21 de agosto de 1994"
17,4,25,758,70,59,129,"21 de agosto de 1994"
17,4,25,759,73,59,132,"21 de agosto de 1994"
17,4,28,776,402,486,888,"21 de agosto de 1994"
17,4,28,777,590,706,1296,"21 de agosto de 1994"
17,4,28,778,376,416,792,"21 de agosto de 1994"
17,4,28,779,428,448,876,"21 de agosto de 1994"
17,4,28,780,375,402,777,"21 de agosto de 1994"
17,4,28,781,394,464,858,"21 de agosto de 1994"
17,4,28,782,398,459,857,"21 de agosto de 1994"
17,4,28,783,562,605,1167,"21 de agosto de 1994"
17,4,28,784,234,286,520,"21 de agosto de 1994"
17,4,28,785,261,316,577,"21 de agosto de 1994"
17,4,28,786,140,143,283,"21 de agosto de 1994"
17,4,28,787,474,500,974,"21 de agosto de 1994"
17,4,28,788,366,411,777,"21 de agosto de 1994"
17,4,28,789,264,283,547,"21 de agosto de 1994"
17,4,28,790,420,426,846,"21 de agosto de 1994"
17,4,28,791,423,445,868,"21 de agosto de 1994"
17,4,28,792,435,443,878,"21 de agosto de 1994"
17,4,28,793,256,225,481,"21 de agosto de 1994"
17,4,28,794,544,525,1069,"21 de agosto de 1994"
17,4,28,795,523,510,1033,"21 de agosto de 1994"
17,4,28,796,554,626,1180,"21 de agosto de 1994"
17,4,28,797,446,523,969,"21 de agosto de 1994"
17,4,28,798,326,409,735,"21 de agosto de 1994"
17,4,31,869,428,545,973,"21 de agosto de 1994"
17,4,31,870,535,624,1159,"21 de agosto de 1994"
17,4,31,871,523,613,1136,"21 de agosto de 1994"
17,4,31,872,165,222,387,"21 de agosto de 1994"
17,4,31,873,352,365,717,"21 de agosto de 1994"
17,4,31,874,674,729,1403,"21 de agosto de 1994"
17,4,31,875,415,490,905,"21 de agosto de 1994"
17,4,31,876,342,408,750,"21 de agosto de 1994"
17,4,31,877,145,188,333,"21 de agosto de 1994"
17,4,31,878,220,229,449,"21 de agosto de 1994"
17,4,31,879,436,494,930,"21 de agosto de 1994"
17,4,31,880,302,317,619,"21 de agosto de 1994"
17,4,31,881,521,601,1122,"21 de agosto de 1994"
17,4,31,882,587,685,1272,"21 de agosto de 1994"
17,4,31,883,430,482,912,"21 de agosto de 1994"
17,4,31,884,227,275,502,"21 de agosto de 1994"
17,4,31,885,507,551,1058,"21 de agosto de 1994"
17,4,31,886,53,52,105,"21 de agosto de 1994"
17,4,31,887,182,203,385,"21 de agosto de 1994"
17,4,31,888,348,387,735,"21 de agosto de 1994"
17,4,31,889,352,403,755,"21 de agosto de 1994"
17,4,31,890,301,338,639,"21 de agosto de 1994"
17,4,31,891,230,232,462,"21 de agosto de 1994"
17,4,31,892,314,368,682,"21 de agosto de 1994"
17,4,31,893,394,436,830,"21 de agosto de 1994"
17,4,31,894,378,422,800,"21 de agosto de 1994"
18,1,9,257,169,162,331,"21 de agosto de 1994"
18,1,9,258,343,294,637,"21 de agosto de 1994"
18,1,9,259,503,301,804,"21 de agosto de 1994"
18,1,9,260,215,186,401,"21 de agosto de 1994"
18,1,9,261,154,129,283,"21 de agosto de 1994"
18,1,9,262,268,159,427,"21 de agosto de 1994"
18,1,9,263,43,40,83,"21 de agosto de 1994"
18,1,9,264,104,77,181,"21 de agosto de 1994"
18,1,9,265,80,48,128,"21 de agosto de 1994"
18,1,9,266,118,62,180,"21 de agosto de 1994"
18,1,9,267,427,282,709,"21 de agosto de 1994"
18,1,9,268,310,222,532,"21 de agosto de 1994"
18,1,9,269,179,138,317,"21 de agosto de 1994"
18,1,9,270,310,269,579,"21 de agosto de 1994"
18,1,9,271,260,214,474,"21 de agosto de 1994"
18,1,9,272,71,64,135,"21 de agosto de 1994"
18,1,9,273,195,186,381,"21 de agosto de 1994"
18,1,9,274,187,126,313,"21 de agosto de 1994"
18,1,9,275,94,90,184,"21 de agosto de 1994"
18,1,9,276,153,130,283,"21 de agosto de 1994"
18,1,10,277,348,330,678,"21 de agosto de 1994"
18,1,10,278,180,179,359,"21 de agosto de 1994"
18,1,10,279,90,82,172,"21 de agosto de 1994"
18,1,10,280,103,83,186,"21 de agosto de 1994"
18,1,10,281,206,179,385,"21 de agosto de 1994"
18,1,10,282,242,243,485,"21 de agosto de 1994"
18,1,10,283,218,142,360,"21 de agosto de 1994"
18,1,10,284,70,64,134,"21 de agosto de 1994"
18,1,10,285,132,98,230,"21 de agosto de 1994"
18,1,10,286,250,201,451,"21 de agosto de 1994"
18,1,10,287,166,123,289,"21 de agosto de 1994"
18,1,10,288,311,244,555,"21 de agosto de 1994"
18,1,10,289,360,330,690,"21 de agosto de 1994"
18,1,10,290,240,227,467,"21 de agosto de 1994"
18,1,10,291,407,312,719,"21 de agosto de 1994"
18,1,10,292,117,93,210,"21 de agosto de 1994"
18,1,10,293,76,60,136,"21 de agosto de 1994"
18,1,10,294,72,57,129,"21 de agosto de 1994"
18,1,10,295,289,247,536,"21 de agosto de 1994"
18,1,10,296,293,244,537,"21 de agosto de 1994"
18,1,10,297,262,224,486,"21 de agosto de 1994"
18,1,10,298,223,236,459,"21 de agosto de 1994"
18,1,10,299,215,213,428,"21 de agosto de 1994"
18,1,10,300,297,268,565,"21 de agosto de 1994"
18,1,10,301,533,427,960,"21 de agosto de 1994"
18,1,10,302,330,304,634,"21 de agosto de 1994"
18,1,10,303,230,185,415,"21 de agosto de 1994"
18,1,10,304,305,259,564,"21 de agosto de 1994"
18,1,10,305,234,218,452,"21 de agosto de 1994"
18,1,10,306,335,292,627,"21 de agosto de 1994"
18,1,10,307,221,223,444,"21 de agosto de 1994"
18,1,10,308,224,236,460,"21 de agosto de 1994"
18,1,10,309,351,322,673,"21 de agosto de 1994"
18,1,10,310,340,340,680,"21 de agosto de 1994"
18,1,10,311,513,533,1046,"21 de agosto de 1994"
18,1,10,312,241,267,508,"21 de agosto de 1994"
18,1,10,313,237,241,478,"21 de agosto de 1994"
18,1,10,314,265,246,511,"21 de agosto de 1994"
18,1,10,315,200,196,396,"21 de agosto de 1994"
18,1,10,316,134,120,254,"21 de agosto de 1994"
18,1,10,317,153,138,291,"21 de agosto de 1994"
18,1,10,318,114,84,198,"21 de agosto de 1994"
18,1,10,319,95,72,167,"21 de agosto de 1994"
18,1,17,597,120,145,265,"21 de agosto de 1994"
18,1,17,598,732,843,1575,"21 de agosto de 1994"
18,1,17,599,130,146,276,"21 de agosto de 1994"
18,1,17,600,295,330,625,"21 de agosto de 1994"
18,1,17,601,425,463,888,"21 de agosto de 1994"
18,1,17,602,405,458,863,"21 de agosto de 1994"
18,1,17,603,351,380,731,"21 de agosto de 1994"
18,1,17,604,186,222,408,"21 de agosto de 1994"
18,1,17,605,261,296,557,"21 de agosto de 1994"
18,1,17,606,262,313,575,"21 de agosto de 1994"
18,1,17,607,441,486,927,"21 de agosto de 1994"
18,1,17,608,464,490,954,"21 de agosto de 1994"
18,1,17,609,813,884,1697,"21 de agosto de 1994"
18,1,17,610,582,693,1275,"21 de agosto de 1994"
18,1,17,611,800,821,1621,"21 de agosto de 1994"
18,1,17,612,546,627,1173,"21 de agosto de 1994"
18,1,17,613,389,450,839,"21 de agosto de 1994"
18,1,17,614,249,309,558,"21 de agosto de 1994"
18,1,17,615,368,433,801,"21 de agosto de 1994"
18,1,17,616,457,515,972,"21 de agosto de 1994"
18,1,17,617,600,699,1299,"21 de agosto de 1994"
18,1,17,618,243,272,515,"21 de agosto de 1994"
18,1,17,619,230,257,487,"21 de agosto de 1994"
18,1,17,620,378,384,762,"21 de agosto de 1994"
18,1,17,621,417,482,899,"21 de agosto de 1994"
18,1,17,622,266,342,608,"21 de agosto de 1994"
18,1,17,623,379,456,835,"21 de agosto de 1994"
18,1,17,624,266,303,569,"21 de agosto de 1994"
18,1,17,625,207,244,451,"21 de agosto de 1994"
18,1,17,626,510,546,1056,"21 de agosto de 1994"
18,1,17,627,476,512,988,"21 de agosto de 1994"
18,1,17,628,362,493,855,"21 de agosto de 1994"
18,1,17,629,373,436,809,"21 de agosto de 1994"
18,1,17,630,474,535,1009,"21 de agosto de 1994"
18,1,17,631,514,572,1086,"21 de agosto de 1994"
18,1,17,632,464,481,945,"21 de agosto de 1994"
18,1,17,633,562,631,1193,"21 de agosto de 1994"
18,1,17,634,590,777,1367,"21 de agosto de 1994"
18,1,17,635,446,506,952,"21 de agosto de 1994"
18,1,17,636,281,330,611,"21 de agosto de 1994"
18,1,17,637,329,387,716,"21 de agosto de 1994"
18,1,17,638,245,310,555,"21 de agosto de 1994"
18,1,17,639,325,387,712,"21 de agosto de 1994"
18,1,17,640,369,459,828,"21 de agosto de 1994"
18,1,17,641,233,293,526,"21 de agosto de 1994"
18,1,17,642,229,291,520,"21 de agosto de 1994"
18,1,17,643,379,486,865,"21 de agosto de 1994"
18,1,17,644,409,463,872,"21 de agosto de 1994"
18,1,17,645,358,440,798,"21 de agosto de 1994"
18,1,17,646,453,576,1029,"21 de agosto de 1994"
18,1,17,647,230,271,501,"21 de agosto de 1994"
18,1,17,648,296,319,615,"21 de agosto de 1994"
18,1,17,649,227,276,503,"21 de agosto de 1994"
18,1,17,650,268,315,583,"21 de agosto de 1994"
18,1,17,651,473,538,1011,"21 de agosto de 1994"
18,1,17,652,288,353,641,"21 de agosto de 1994"
18,1,17,653,248,309,557,"21 de agosto de 1994"
18,1,17,654,252,337,589,"21 de agosto de 1994"
18,1,17,655,267,347,614,"21 de agosto de 1994"
18,1,17,656,364,412,776,"21 de agosto de 1994"
18,1,17,657,308,354,662,"21 de agosto de 1994"
18,1,17,658,351,443,794,"21 de agosto de 1994"
18,1,17,659,255,279,534,"21 de agosto de 1994"
18,1,17,660,296,318,614,"21 de agosto de 1994"
18,1,17,661,163,179,342,"21 de agosto de 1994"
18,1,17,662,273,363,636,"21 de agosto de 1994"
18,1,17,663,307,353,660,"21 de agosto de 1994"
18,1,17,664,308,372,680,"21 de agosto de 1994"
18,1,17,665,375,449,824,"21 de agosto de 1994"
18,1,17,666,354,405,759,"21 de agosto de 1994"
18,1,17,667,327,393,720,"21 de agosto de 1994"
18,1,17,668,281,297,578,"21 de agosto de 1994"
18,1,17,669,297,349,646,"21 de agosto de 1994"
18,1,17,670,247,361,608,"21 de agosto de 1994"
18,1,17,671,143,203,346,"21 de agosto de 1994"
18,1,17,672,80,93,173,"21 de agosto de 1994"
18,1,17,673,229,325,554,"21 de agosto de 1994"
18,1,17,674,190,249,439,"21 de agosto de 1994"
18,1,17,675,196,223,419,"21 de agosto de 1994"
18,1,17,676,427,553,980,"21 de agosto de 1994"
18,1,17,677,381,407,788,"21 de agosto de 1994"
18,1,17,678,320,366,686,"21 de agosto de 1994"
18,1,17,679,466,517,983,"21 de agosto de 1994"
18,1,17,680,294,349,643,"21 de agosto de 1994"
18,1,17,681,343,453,796,"21 de agosto de 1994"
18,1,17,682,139,204,343,"21 de agosto de 1994"
18,1,17,683,115,161,276,"21 de agosto de 1994"
18,1,17,684,98,130,228,"21 de agosto de 1994"
18,1,17,685,181,257,438,"21 de agosto de 1994"
18,1,17,686,133,156,289,"21 de agosto de 1994"
18,1,17,687,328,411,739,"21 de agosto de 1994"
18,1,17,688,257,342,599,"21 de agosto de 1994"
18,1,17,689,209,288,497,"21 de agosto de 1994"
18,1,17,690,191,247,438,"21 de agosto de 1994"
18,1,17,691,262,339,601,"21 de agosto de 1994"
18,1,17,692,307,431,738,"21 de agosto de 1994"
18,1,17,693,346,386,732,"21 de agosto de 1994"
18,1,17,694,331,383,714,"21 de agosto de 1994"
18,1,17,695,538,570,1108,"21 de agosto de 1994"
18,1,17,696,432,517,949,"21 de agosto de 1994"
18,1,17,697,277,341,618,"21 de agosto de 1994"
18,1,17,698,224,275,499,"21 de agosto de 1994"
18,1,17,699,212,254,466,"21 de agosto de 1994"
18,1,17,700,350,426,776,"21 de agosto de 1994"
18,1,17,701,411,508,919,"21 de agosto de 1994"
18,1,17,702,332,444,776,"21 de agosto de 1994"
18,1,17,703,306,326,632,"21 de agosto de 1994"
18,1,17,704,148,174,322,"21 de agosto de 1994"
18,1,17,705,361,399,760,"21 de agosto de 1994"
18,1,17,706,296,375,671,"21 de agosto de 1994"
18,1,17,707,258,312,570,"21 de agosto de 1994"
18,1,17,708,347,452,799,"21 de agosto de 1994"
18,1,17,709,542,635,1177,"21 de agosto de 1994"
18,1,17,710,372,433,805,"21 de agosto de 1994"
18,1,17,711,410,455,865,"21 de agosto de 1994"
18,1,17,712,259,282,541,"21 de agosto de 1994"
18,1,17,713,277,301,578,"21 de agosto de 1994"
18,1,17,714,245,301,546,"21 de agosto de 1994"
18,1,17,715,507,619,1126,"21 de agosto de 1994"
18,1,17,716,236,266,502,"21 de agosto de 1994"
18,1,17,717,611,104,715,"21 de agosto de 1994"
18,1,17,718,241,291,532,"21 de agosto de 1994"
18,1,17,719,493,595,1088,"21 de agosto de 1994"
18,1,17,720,198,246,444,"21 de agosto de 1994"
18,1,17,721,235,285,520,"21 de agosto de 1994"
18,1,17,722,299,364,663,"21 de agosto de 1994"
18,1,17,723,620,722,1342,"21 de agosto de 1994"
18,1,17,724,652,742,1394,"21 de agosto de 1994"
18,1,17,725,453,577,1030,"21 de agosto de 1994"
18,1,17,726,300,359,659,"21 de agosto de 1994"
18,1,17,727,236,300,536,"21 de agosto de 1994"
18,1,17,728,287,340,627,"21 de agosto de 1994"
18,1,17,729,260,319,579,"21 de agosto de 1994"
18,1,17,730,366,422,788,"21 de agosto de 1994"
18,1,17,731,274,296,570,"21 de agosto de 1994"
18,1,17,732,116,118,234,"21 de agosto de 1994"
18,1,17,733,433,555,988,"21 de agosto de 1994"
18,1,17,734,321,386,707,"21 de agosto de 1994"
18,1,17,735,325,336,661,"21 de agosto de 1994"
18,1,17,736,482,497,979,"21 de agosto de 1994"
18,1,17,737,538,612,1150,"21 de agosto de 1994"
18,1,17,738,544,625,1169,"21 de agosto de 1994"
18,1,17,739,580,676,1256,"21 de agosto de 1994"
18,1,17,740,373,446,819,"21 de agosto de 1994"
18,1,17,741,255,308,563,"21 de agosto de 1994"
18,1,17,742,322,435,757,"21 de agosto de 1994"
18,1,17,743,247,290,537,"21 de agosto de 1994"
18,1,17,744,365,457,822,"21 de agosto de 1994"
18,1,17,745,423,517,940,"21 de agosto de 1994"
18,1,17,746,488,577,1065,"21 de agosto de 1994"
18,1,17,747,364,433,797,"21 de agosto de 1994"
18,1,17,748,350,437,787,"21 de agosto de 1994"
18,1,17,749,336,395,731,"21 de agosto de 1994"
18,1,17,750,269,353,622,"21 de agosto de 1994"
18,1,17,751,248,333,581,"21 de agosto de 1994"
18,1,17,752,398,484,882,"21 de agosto de 1994"
18,1,17,753,277,343,620,"21 de agosto de 1994"
18,1,17,754,339,368,707,"21 de agosto de 1994"
18,1,17,755,271,330,601,"21 de agosto de 1994"
18,1,17,756,401,490,891,"21 de agosto de 1994"
18,1,17,757,238,282,520,"21 de agosto de 1994"
18,1,17,758,522,522,1044,"21 de agosto de 1994"
18,1,17,759,266,296,562,"21 de agosto de 1994"
18,1,17,760,171,201,372,"21 de agosto de 1994"
18,1,17,761,247,291,538,"21 de agosto de 1994"
18,1,17,762,340,430,770,"21 de agosto de 1994"
18,1,17,763,343,458,801,"21 de agosto de 1994"
18,1,17,764,613,716,1329,"21 de agosto de 1994"
18,1,17,765,502,550,1052,"21 de agosto de 1994"
18,1,17,766,293,362,655,"21 de agosto de 1994"
18,1,17,767,212,276,488,"21 de agosto de 1994"
18,1,17,768,60,47,107,"21 de agosto de 1994"
18,1,17,769,531,146,677,"21 de agosto de 1994"
18,1,17,770,531,467,998,"21 de agosto de 1994"
18,1,17,771,148,127,275,"21 de agosto de 1994"
18,1,17,772,159,150,309,"21 de agosto de 1994"
18,1,17,773,175,145,320,"21 de agosto de 1994"
18,1,17,774,397,346,743,"21 de agosto de 1994"
18,1,17,775,116,76,192,"21 de agosto de 1994"
18,1,17,776,36,27,63,"21 de agosto de 1994"
18,1,17,777,49,37,86,"21 de agosto de 1994"
18,1,17,778,134,109,243,"21 de agosto de 1994"
18,1,17,779,339,334,673,"21 de agosto de 1994"
18,1,17,780,568,479,1047,"21 de agosto de 1994"
18,1,17,781,275,245,520,"21 de agosto de 1994"
18,1,17,782,349,308,657,"21 de agosto de 1994"
18,1,17,783,363,391,754,"21 de agosto de 1994"
18,1,17,784,104,95,199,"21 de agosto de 1994"
18,1,17,785,323,306,629,"21 de agosto de 1994"
18,1,17,786,124,118,242,"21 de agosto de 1994"
18,1,17,787,107,97,204,"21 de agosto de 1994"
18,1,17,788,323,373,696,"21 de agosto de 1994"
18,1,17,789,278,318,596,"21 de agosto de 1994"
18,1,17,790,104,76,180,"21 de agosto de 1994"
18,1,17,791,50,43,93,"21 de agosto de 1994"
18,1,17,792,187,161,348,"21 de agosto de 1994"
18,1,17,793,119,107,226,"21 de agosto de 1994"
18,1,17,794,106,94,200,"21 de agosto de 1994"
18,1,17,795,201,224,425,"21 de agosto de 1994"
18,1,17,796,241,214,455,"21 de agosto de 1994"
18,1,17,797,214,213,427,"21 de agosto de 1994"
18,1,17,798,177,148,325,"21 de agosto de 1994"
18,1,17,799,217,205,422,"21 de agosto de 1994"
18,1,17,800,148,148,296,"21 de agosto de 1994"
18,1,17,801,263,265,528,"21 de agosto de 1994"
18,1,17,802,211,174,385,"21 de agosto de 1994"
18,1,17,803,284,212,496,"21 de agosto de 1994"
18,1,17,804,506,512,1018,"21 de agosto de 1994"
18,1,17,805,313,317,630,"21 de agosto de 1994"
18,1,17,806,142,122,264,"21 de agosto de 1994"
18,1,17,807,602,557,1159,"21 de agosto de 1994"
18,1,17,808,185,182,367,"21 de agosto de 1994"
18,1,17,809,288,377,665,"21 de agosto de 1994"
18,1,18,810,335,359,694,"21 de agosto de 1994"
18,1,18,811,283,317,600,"21 de agosto de 1994"
18,1,18,812,360,430,790,"21 de agosto de 1994"
18,1,18,813,317,357,674,"21 de agosto de 1994"
18,1,18,814,300,340,640,"21 de agosto de 1994"
18,1,18,815,245,235,480,"21 de agosto de 1994"
18,1,18,816,294,287,581,"21 de agosto de 1994"
18,1,18,817,156,148,304,"21 de agosto de 1994"
18,1,18,818,184,235,419,"21 de agosto de 1994"
18,1,18,819,243,286,529,"21 de agosto de 1994"
18,1,18,820,183,233,416,"21 de agosto de 1994"
18,1,18,821,264,270,534,"21 de agosto de 1994"
18,1,18,822,249,258,507,"21 de agosto de 1994"
18,1,18,823,283,302,585,"21 de agosto de 1994"
18,1,18,824,380,377,757,"21 de agosto de 1994"
18,1,18,825,328,362,690,"21 de agosto de 1994"
18,1,18,826,184,195,379,"21 de agosto de 1994"
18,1,18,827,289,280,569,"21 de agosto de 1994"
18,1,18,828,204,197,401,"21 de agosto de 1994"
18,1,18,829,159,182,341,"21 de agosto de 1994"
18,1,18,830,290,315,605,"21 de agosto de 1994"
18,1,18,831,161,179,340,"21 de agosto de 1994"
18,1,18,832,236,262,498,"21 de agosto de 1994"
18,1,18,833,216,209,425,"21 de agosto de 1994"
18,1,18,834,189,192,381,"21 de agosto de 1994"
18,1,18,835,262,266,528,"21 de agosto de 1994"
18,1,18,836,398,355,753,"21 de agosto de 1994"
18,1,18,837,439,441,880,"21 de agosto de 1994"
18,1,18,838,436,395,831,"21 de agosto de 1994"
18,1,18,839,326,323,649,"21 de agosto de 1994"
18,1,18,840,287,272,559,"21 de agosto de 1994"
18,1,18,841,256,235,491,"21 de agosto de 1994"
18,1,18,842,409,359,768,"21 de agosto de 1994"
18,1,18,843,319,315,634,"21 de agosto de 1994"
18,2,1,1,230,210,440,"21 de agosto de 1994"
18,2,1,2,238,225,463,"21 de agosto de 1994"
18,2,1,3,928,464,1392,"21 de agosto de 1994"
18,2,1,4,234,276,510,"21 de agosto de 1994"
18,2,1,5,352,372,724,"21 de agosto de 1994"
18,2,1,6,260,282,542,"21 de agosto de 1994"
18,2,1,7,275,297,572,"21 de agosto de 1994"
18,2,1,8,365,386,751,"21 de agosto de 1994"
18,2,1,9,164,198,362,"21 de agosto de 1994"
18,2,1,10,328,354,682,"21 de agosto de 1994"
18,2,1,11,179,209,388,"21 de agosto de 1994"
18,2,1,12,344,376,720,"21 de agosto de 1994"
18,2,1,13,252,299,551,"21 de agosto de 1994"
18,2,1,14,144,181,325,"21 de agosto de 1994"
18,2,1,15,222,250,472,"21 de agosto de 1994"
18,2,1,16,204,219,423,"21 de agosto de 1994"
18,2,1,17,198,239,437,"21 de agosto de 1994"
18,2,1,18,223,252,475,"21 de agosto de 1994"
18,2,1,19,55,55,110,"21 de agosto de 1994"
18,2,1,20,123,90,213,"21 de agosto de 1994"
18,2,1,21,212,190,402,"21 de agosto de 1994"
18,2,1,22,86,65,151,"21 de agosto de 1994"
18,2,1,23,321,303,624,"21 de agosto de 1994"
18,2,1,24,332,251,583,"21 de agosto de 1994"
18,2,1,25,64,52,116,"21 de agosto de 1994"
18,2,1,26,83,64,147,"21 de agosto de 1994"
18,2,1,27,150,104,254,"21 de agosto de 1994"
18,2,1,28,96,91,187,"21 de agosto de 1994"
18,2,1,29,83,60,143,"21 de agosto de 1994"
18,2,1,30,91,83,174,"21 de agosto de 1994"
18,2,1,31,135,114,249,"21 de agosto de 1994"
18,2,1,32,157,156,313,"21 de agosto de 1994"
18,2,1,33,261,250,511,"21 de agosto de 1994"
18,2,1,34,126,103,229,"21 de agosto de 1994"
18,2,1,35,49,39,88,"21 de agosto de 1994"
18,2,1,36,351,282,633,"21 de agosto de 1994"
18,2,1,37,103,77,180,"21 de agosto de 1994"
18,2,1,38,350,309,659,"21 de agosto de 1994"
18,2,1,39,317,312,629,"21 de agosto de 1994"
18,2,1,40,291,307,598,"21 de agosto de 1994"
18,2,1,41,169,141,310,"21 de agosto de 1994"
18,2,1,42,54,43,97,"21 de agosto de 1994"
18,2,1,43,346,282,628,"21 de agosto de 1994"
18,2,1,44,69,52,121,"21 de agosto de 1994"
18,2,1,45,117,89,206,"21 de agosto de 1994"
18,2,1,46,362,309,671,"21 de agosto de 1994"
18,2,1,47,365,336,701,"21 de agosto de 1994"
18,2,1,48,57,42,99,"21 de agosto de 1994"
18,2,6,196,273,258,531,"21 de agosto de 1994"
18,2,6,197,401,380,781,"21 de agosto de 1994"
18,2,6,198,79,64,143,"21 de agosto de 1994"
18,2,6,199,87,66,153,"21 de agosto de 1994"
18,2,6,200,61,59,120,"21 de agosto de 1994"
18,2,6,201,55,58,113,"21 de agosto de 1994"
18,2,6,202,165,180,345,"21 de agosto de 1994"
18,2,6,203,210,162,372,"21 de agosto de 1994"
18,2,6,204,82,55,137,"21 de agosto de 1994"
18,2,6,205,82,58,140,"21 de agosto de 1994"
18,2,6,206,94,63,157,"21 de agosto de 1994"
18,2,6,207,86,71,157,"21 de agosto de 1994"
18,2,6,208,128,105,233,"21 de agosto de 1994"
18,2,6,209,90,53,143,"21 de agosto de 1994"
18,2,6,210,91,66,157,"21 de agosto de 1994"
18,2,6,211,104,77,181,"21 de agosto de 1994"
18,2,6,212,64,50,114,"21 de agosto de 1994"
18,2,6,213,82,64,146,"21 de agosto de 1994"
18,2,6,214,101,77,178,"21 de agosto de 1994"
18,2,11,320,427,409,836,"21 de agosto de 1994"
18,2,11,321,353,395,748,"21 de agosto de 1994"
18,2,11,322,364,377,741,"21 de agosto de 1994"
18,2,11,323,316,313,629,"21 de agosto de 1994"
18,2,11,324,357,346,703,"21 de agosto de 1994"
18,2,11,325,198,211,409,"21 de agosto de 1994"
18,2,11,326,265,320,585,"21 de agosto de 1994"
18,2,11,327,228,224,452,"21 de agosto de 1994"
18,2,11,328,296,301,597,"21 de agosto de 1994"
18,2,11,329,309,335,644,"21 de agosto de 1994"
18,2,11,330,203,186,389,"21 de agosto de 1994"
18,2,11,331,208,201,409,"21 de agosto de 1994"
18,2,11,332,41,23,64,"21 de agosto de 1994"
18,2,11,333,300,257,557,"21 de agosto de 1994"
18,2,11,334,90,71,161,"21 de agosto de 1994"
18,2,11,335,67,31,98,"21 de agosto de 1994"
18,2,11,336,131,105,236,"21 de agosto de 1994"
18,2,11,337,292,248,540,"21 de agosto de 1994"
18,2,11,338,228,214,442,"21 de agosto de 1994"
18,2,11,339,62,41,103,"21 de agosto de 1994"
18,2,11,340,115,108,223,"21 de agosto de 1994"
18,2,11,341,154,137,291,"21 de agosto de 1994"
18,2,11,342,129,106,235,"21 de agosto de 1994"
18,2,11,343,331,285,616,"21 de agosto de 1994"
18,2,11,344,218,185,403,"21 de agosto de 1994"
18,2,11,345,144,117,261,"21 de agosto de 1994"
18,2,11,346,182,145,327,"21 de agosto de 1994"
18,2,15,435,231,245,476,"21 de agosto de 1994"
18,2,15,436,353,399,752,"21 de agosto de 1994"
18,2,15,437,439,476,915,"21 de agosto de 1994"
18,2,15,438,256,293,549,"21 de agosto de 1994"
18,2,15,439,185,199,384,"21 de agosto de 1994"
18,2,15,440,201,241,442,"21 de agosto de 1994"
18,2,15,441,317,319,636,"21 de agosto de 1994"
18,2,15,442,251,273,524,"21 de agosto de 1994"
18,2,15,443,258,285,543,"21 de agosto de 1994"
18,2,15,444,168,193,361,"21 de agosto de 1994"
18,2,15,445,135,163,298,"21 de agosto de 1994"
18,2,15,446,232,268,500,"21 de agosto de 1994"
18,2,15,447,368,386,754,"21 de agosto de 1994"
18,2,15,448,297,329,626,"21 de agosto de 1994"
18,2,15,449,93,123,216,"21 de agosto de 1994"
18,2,15,450,245,264,509,"21 de agosto de 1994"
18,2,15,451,424,457,881,"21 de agosto de 1994"
18,2,15,452,197,186,383,"21 de agosto de 1994"
18,2,15,453,132,151,283,"21 de agosto de 1994"
18,2,15,454,90,99,189,"21 de agosto de 1994"
18,2,15,455,213,253,466,"21 de agosto de 1994"
18,2,15,456,129,140,269,"21 de agosto de 1994"
18,2,15,457,391,337,728,"21 de agosto de 1994"
18,2,15,458,225,206,431,"21 de agosto de 1994"
18,2,15,459,441,376,817,"21 de agosto de 1994"
18,2,15,460,344,311,655,"21 de agosto de 1994"
18,2,15,461,199,169,368,"21 de agosto de 1994"
18,2,15,462,87,75,162,"21 de agosto de 1994"
18,2,15,463,372,351,723,"21 de agosto de 1994"
18,2,15,464,144,101,245,"21 de agosto de 1994"
18,2,15,465,256,226,482,"21 de agosto de 1994"
18,2,15,466,255,213,468,"21 de agosto de 1994"
18,2,15,467,116,123,239,"21 de agosto de 1994"
18,2,15,468,178,176,354,"21 de agosto de 1994"
18,2,15,469,188,194,382,"21 de agosto de 1994"
18,2,15,470,311,291,602,"21 de agosto de 1994"
18,2,15,471,154,139,293,"21 de agosto de 1994"
18,2,15,472,278,240,518,"21 de agosto de 1994"
18,2,15,473,268,265,533,"21 de agosto de 1994"
18,2,15,474,284,242,526,"21 de agosto de 1994"
18,2,15,475,169,146,315,"21 de agosto de 1994"
18,2,15,476,113,126,239,"21 de agosto de 1994"
18,2,15,477,137,113,250,"21 de agosto de 1994"
18,2,15,478,174,148,322,"21 de agosto de 1994"
18,2,15,479,42,33,75,"21 de agosto de 1994"
18,2,15,480,209,160,369,"21 de agosto de 1994"
18,2,15,481,92,75,167,"21 de agosto de 1994"
18,2,15,482,284,289,573,"21 de agosto de 1994"
18,2,15,483,411,413,824,"21 de agosto de 1994"
18,2,15,484,349,361,710,"21 de agosto de 1994"
18,2,15,485,282,299,581,"21 de agosto de 1994"
18,2,15,486,128,124,252,"21 de agosto de 1994"
18,2,15,487,389,359,748,"21 de agosto de 1994"
18,2,15,488,295,269,564,"21 de agosto de 1994"
18,2,15,489,263,233,496,"21 de agosto de 1994"
18,2,15,490,217,210,427,"21 de agosto de 1994"
18,2,15,491,162,144,306,"21 de agosto de 1994"
18,2,15,492,129,115,244,"21 de agosto de 1994"
18,2,15,493,399,364,763,"21 de agosto de 1994"
18,2,15,494,255,230,485,"21 de agosto de 1994"
18,2,15,495,282,250,532,"21 de agosto de 1994"
18,2,15,496,233,198,431,"21 de agosto de 1994"
18,2,15,497,235,226,461,"21 de agosto de 1994"
18,2,15,498,231,233,464,"21 de agosto de 1994"
18,2,15,499,87,76,163,"21 de agosto de 1994"
18,2,15,500,150,120,270,"21 de agosto de 1994"
18,2,15,501,203,166,369,"21 de agosto de 1994"
18,2,15,502,263,273,536,"21 de agosto de 1994"
18,2,15,503,396,367,763,"21 de agosto de 1994"
18,2,15,504,282,283,565,"21 de agosto de 1994"
18,2,15,505,348,402,750,"21 de agosto de 1994"
18,2,15,506,211,199,410,"21 de agosto de 1994"
18,2,15,507,273,268,541,"21 de agosto de 1994"
18,2,15,508,328,324,652,"21 de agosto de 1994"
18,2,15,509,201,179,380,"21 de agosto de 1994"
18,2,15,510,170,169,339,"21 de agosto de 1994"
18,2,15,511,429,413,842,"21 de agosto de 1994"
18,2,15,512,336,313,649,"21 de agosto de 1994"
18,2,15,513,263,218,481,"21 de agosto de 1994"
18,2,15,514,102,78,180,"21 de agosto de 1994"
18,2,15,515,240,212,452,"21 de agosto de 1994"
18,2,15,516,248,230,478,"21 de agosto de 1994"
18,2,15,517,179,180,359,"21 de agosto de 1994"
18,2,15,518,89,79,168,"21 de agosto de 1994"
18,2,15,519,128,123,251,"21 de agosto de 1994"
18,2,15,520,279,223,502,"21 de agosto de 1994"
18,2,15,521,214,217,431,"21 de agosto de 1994"
18,2,15,522,352,378,730,"21 de agosto de 1994"
18,2,15,523,411,453,864,"21 de agosto de 1994"
18,2,15,524,246,270,516,"21 de agosto de 1994"
18,2,15,525,197,226,423,"21 de agosto de 1994"
18,2,15,526,357,373,730,"21 de agosto de 1994"
18,2,15,527,246,276,522,"21 de agosto de 1994"
18,2,15,528,432,443,875,"21 de agosto de 1994"
18,2,15,529,221,220,441,"21 de agosto de 1994"
18,2,15,530,250,246,496,"21 de agosto de 1994"
18,2,15,531,343,351,694,"21 de agosto de 1994"
18,2,15,532,430,426,856,"21 de agosto de 1994"
18,2,15,533,67,54,121,"21 de agosto de 1994"
18,2,15,534,118,126,244,"21 de agosto de 1994"
18,2,15,535,223,218,441,"21 de agosto de 1994"
18,2,15,536,170,178,348,"21 de agosto de 1994"
18,2,15,537,217,216,433,"21 de agosto de 1994"
18,2,15,538,277,268,545,"21 de agosto de 1994"
18,2,15,539,282,254,536,"21 de agosto de 1994"
18,2,15,540,270,238,508,"21 de agosto de 1994"
18,2,15,541,375,377,752,"21 de agosto de 1994"
18,2,15,542,357,333,690,"21 de agosto de 1994"
18,2,15,543,405,440,845,"21 de agosto de 1994"
18,2,15,544,194,192,386,"21 de agosto de 1994"
18,2,15,545,350,318,668,"21 de agosto de 1994"
18,2,15,546,273,243,516,"21 de agosto de 1994"
18,2,16,547,190,187,377,"21 de agosto de 1994"
18,2,16,548,217,233,450,"21 de agosto de 1994"
18,2,16,549,259,271,530,"21 de agosto de 1994"
18,2,16,550,350,322,672,"21 de agosto de 1994"
18,2,16,551,287,284,571,"21 de agosto de 1994"
18,2,16,552,285,294,579,"21 de agosto de 1994"
18,2,16,553,223,231,454,"21 de agosto de 1994"
18,2,16,554,334,324,658,"21 de agosto de 1994"
18,2,16,555,229,252,481,"21 de agosto de 1994"
18,2,16,556,158,173,331,"21 de agosto de 1994"
18,2,16,557,118,133,251,"21 de agosto de 1994"
18,2,16,558,186,206,392,"21 de agosto de 1994"
18,2,16,559,179,199,378,"21 de agosto de 1994"
18,2,16,560,187,254,441,"21 de agosto de 1994"
18,2,16,561,179,221,400,"21 de agosto de 1994"
18,2,16,562,238,231,469,"21 de agosto de 1994"
18,2,16,563,239,271,510,"21 de agosto de 1994"
18,2,16,564,280,270,550,"21 de agosto de 1994"
18,2,16,565,82,62,144,"21 de agosto de 1994"
18,2,16,566,54,35,89,"21 de agosto de 1994"
18,2,16,567,370,307,677,"21 de agosto de 1994"
18,2,16,568,389,336,725,"21 de agosto de 1994"
18,2,16,569,159,124,283,"21 de agosto de 1994"
18,2,16,570,465,456,921,"21 de agosto de 1994"
18,2,16,571,341,310,651,"21 de agosto de 1994"
18,2,16,572,295,284,579,"21 de agosto de 1994"
18,2,16,573,339,339,678,"21 de agosto de 1994"
18,2,16,574,299,283,582,"21 de agosto de 1994"
18,2,16,575,325,340,665,"21 de agosto de 1994"
18,2,16,576,330,338,668,"21 de agosto de 1994"
18,2,16,577,235,230,465,"21 de agosto de 1994"
18,2,16,578,394,351,745,"21 de agosto de 1994"
18,2,16,579,326,279,605,"21 de agosto de 1994"
18,2,16,580,356,307,663,"21 de agosto de 1994"
18,2,16,581,223,205,428,"21 de agosto de 1994"
18,2,16,582,386,345,731,"21 de agosto de 1994"
18,2,16,583,385,346,731,"21 de agosto de 1994"
18,2,16,584,341,325,666,"21 de agosto de 1994"
18,2,16,585,252,224,476,"21 de agosto de 1994"
18,2,16,586,240,218,458,"21 de agosto de 1994"
18,2,16,587,306,261,567,"21 de agosto de 1994"
18,2,16,588,391,362,753,"21 de agosto de 1994"
18,2,16,589,147,131,278,"21 de agosto de 1994"
18,2,16,590,95,80,175,"21 de agosto de 1994"
18,2,16,591,368,330,698,"21 de agosto de 1994"
18,2,16,592,118,84,202,"21 de agosto de 1994"
18,2,16,593,171,115,286,"21 de agosto de 1994"
18,2,16,594,153,105,258,"21 de agosto de 1994"
18,2,16,595,177,148,325,"21 de agosto de 1994"
18,2,16,596,141,97,238,"21 de agosto de 1994"
18,3,2,49,171,192,363,"21 de agosto de 1994"
18,3,2,50,237,269,506,"21 de agosto de 1994"
18,3,2,51,287,297,584,"21 de agosto de 1994"
18,3,2,52,293,306,599,"21 de agosto de 1994"
18,3,2,53,381,438,819,"21 de agosto de 1994"
18,3,2,54,461,539,1000,"21 de agosto de 1994"
18,3,2,55,117,111,228,"21 de agosto de 1994"
18,3,2,56,318,333,651,"21 de agosto de 1994"
18,3,2,57,382,368,750,"21 de agosto de 1994"
18,3,2,58,266,240,506,"21 de agosto de 1994"
18,3,2,59,507,443,950,"21 de agosto de 1994"
18,3,2,60,266,241,507,"21 de agosto de 1994"
18,3,2,61,388,362,750,"21 de agosto de 1994"
18,3,2,62,109,104,213,"21 de agosto de 1994"
18,3,2,63,104,127,231,"21 de agosto de 1994"
18,3,2,64,77,65,142,"21 de agosto de 1994"
18,3,2,65,236,206,442,"21 de agosto de 1994"
18,3,3,66,140,134,274,"21 de agosto de 1994"
18,3,3,67,240,202,442,"21 de agosto de 1994"
18,3,3,68,272,281,553,"21 de agosto de 1994"
18,3,3,69,172,214,386,"21 de agosto de 1994"
18,3,3,70,103,90,193,"21 de agosto de 1994"
18,3,3,71,75,67,142,"21 de agosto de 1994"
18,3,3,72,36,34,70,"21 de agosto de 1994"
18,3,3,73,40,37,77,"21 de agosto de 1994"
18,3,3,74,222,184,406,"21 de agosto de 1994"
18,3,3,75,207,194,401,"21 de agosto de 1994"
18,3,3,76,77,61,138,"21 de agosto de 1994"
18,3,3,77,196,206,402,"21 de agosto de 1994"
18,3,3,78,220,199,419,"21 de agosto de 1994"
18,3,3,79,331,354,685,"21 de agosto de 1994"
18,3,3,80,203,193,396,"21 de agosto de 1994"
18,3,3,81,106,95,201,"21 de agosto de 1994"
18,3,3,82,171,159,330,"21 de agosto de 1994"
18,3,3,83,200,229,429,"21 de agosto de 1994"
18,3,3,84,63,56,119,"21 de agosto de 1994"
18,3,3,85,31,27,58,"21 de agosto de 1994"
18,3,3,86,90,73,163,"21 de agosto de 1994"
18,3,3,87,51,45,96,"21 de agosto de 1994"
18,3,3,88,145,119,264,"21 de agosto de 1994"
18,3,3,89,155,144,299,"21 de agosto de 1994"
18,3,4,90,515,492,1007,"21 de agosto de 1994"
18,3,4,91,209,199,408,"21 de agosto de 1994"
18,3,4,92,115,114,229,"21 de agosto de 1994"
18,3,4,93,89,75,164,"21 de agosto de 1994"
18,3,4,94,201,184,385,"21 de agosto de 1994"
18,3,4,95,182,155,337,"21 de agosto de 1994"
18,3,4,96,256,240,496,"21 de agosto de 1994"
18,3,4,97,386,331,717,"21 de agosto de 1994"
18,3,4,98,413,371,784,"21 de agosto de 1994"
18,3,4,99,199,190,389,"21 de agosto de 1994"
18,3,4,100,398,389,787,"21 de agosto de 1994"
18,3,4,101,376,356,732,"21 de agosto de 1994"
18,3,4,102,273,285,558,"21 de agosto de 1994"
18,3,4,103,390,400,790,"21 de agosto de 1994"
18,3,4,104,519,527,1046,"21 de agosto de 1994"
18,3,4,105,391,361,752,"21 de agosto de 1994"
18,3,4,106,373,339,712,"21 de agosto de 1994"
18,3,4,107,483,450,933,"21 de agosto de 1994"
18,3,4,108,344,331,675,"21 de agosto de 1994"
18,3,4,109,153,120,273,"21 de agosto de 1994"
18,3,4,110,320,252,572,"21 de agosto de 1994"
18,3,4,111,721,606,1327,"21 de agosto de 1994"
18,3,4,112,528,520,1048,"21 de agosto de 1994"
18,3,4,113,403,374,777,"21 de agosto de 1994"
18,3,4,114,402,395,797,"21 de agosto de 1994"
18,3,4,115,461,481,942,"21 de agosto de 1994"
18,3,4,116,468,475,943,"21 de agosto de 1994"
18,3,4,117,340,293,633,"21 de agosto de 1994"
18,3,4,118,572,550,1122,"21 de agosto de 1994"
18,3,4,119,240,234,474,"21 de agosto de 1994"
18,3,4,120,378,337,715,"21 de agosto de 1994"
18,3,4,121,374,361,735,"21 de agosto de 1994"
18,3,4,122,303,279,582,"21 de agosto de 1994"
18,3,4,123,225,184,409,"21 de agosto de 1994"
18,3,5,124,220,237,457,"21 de agosto de 1994"
18,3,5,125,430,491,921,"21 de agosto de 1994"
18,3,5,126,161,190,351,"21 de agosto de 1994"
18,3,5,127,271,329,600,"21 de agosto de 1994"
18,3,5,128,321,376,697,"21 de agosto de 1994"
18,3,5,129,436,468,904,"21 de agosto de 1994"
18,3,5,130,224,234,458,"21 de agosto de 1994"
18,3,5,131,252,286,538,"21 de agosto de 1994"
18,3,5,132,247,271,518,"21 de agosto de 1994"
18,3,5,133,363,323,686,"21 de agosto de 1994"
18,3,5,134,331,363,694,"21 de agosto de 1994"
18,3,5,135,357,380,737,"21 de agosto de 1994"
18,3,5,136,273,317,590,"21 de agosto de 1994"
18,3,5,137,265,291,556,"21 de agosto de 1994"
18,3,5,138,139,144,283,"21 de agosto de 1994"
18,3,5,139,220,213,433,"21 de agosto de 1994"
18,3,5,140,233,189,422,"21 de agosto de 1994"
18,3,5,141,185,191,376,"21 de agosto de 1994"
18,3,5,142,47,59,106,"21 de agosto de 1994"
18,3,5,143,150,104,254,"21 de agosto de 1994"
18,3,5,144,293,273,566,"21 de agosto de 1994"
18,3,5,145,315,285,600,"21 de agosto de 1994"
18,3,5,146,114,110,224,"21 de agosto de 1994"
18,3,5,147,166,133,299,"21 de agosto de 1994"
18,3,5,148,337,338,675,"21 de agosto de 1994"
18,3,5,149,265,289,554,"21 de agosto de 1994"
18,3,5,150,245,251,496,"21 de agosto de 1994"
18,3,5,151,390,348,738,"21 de agosto de 1994"
18,3,5,152,227,233,460,"21 de agosto de 1994"
18,3,5,153,96,77,173,"21 de agosto de 1994"
18,3,5,154,144,131,275,"21 de agosto de 1994"
18,3,5,155,161,162,323,"21 de agosto de 1994"
18,3,5,156,179,170,349,"21 de agosto de 1994"
18,3,5,157,198,194,392,"21 de agosto de 1994"
18,3,5,158,219,223,442,"21 de agosto de 1994"
18,3,5,159,142,141,283,"21 de agosto de 1994"
18,3,5,160,224,250,474,"21 de agosto de 1994"
18,3,5,161,323,347,670,"21 de agosto de 1994"
18,3,5,162,144,133,277,"21 de agosto de 1994"
18,3,5,163,199,206,405,"21 de agosto de 1994"
18,3,5,164,235,262,497,"21 de agosto de 1994"
18,3,5,165,288,297,585,"21 de agosto de 1994"
18,3,5,166,271,252,523,"21 de agosto de 1994"
18,3,5,167,280,315,595,"21 de agosto de 1994"
18,3,5,168,355,414,769,"21 de agosto de 1994"
18,3,5,169,236,268,504,"21 de agosto de 1994"
18,3,5,170,61,51,112,"21 de agosto de 1994"
18,3,5,171,400,351,751,"21 de agosto de 1994"
18,3,5,172,39,35,74,"21 de agosto de 1994"
18,3,5,173,367,360,727,"21 de agosto de 1994"
18,3,5,174,39,34,73,"21 de agosto de 1994"
18,3,5,175,174,181,355,"21 de agosto de 1994"
18,3,5,176,217,229,446,"21 de agosto de 1994"
18,3,5,177,365,297,662,"21 de agosto de 1994"
18,3,5,178,235,166,401,"21 de agosto de 1994"
18,3,5,179,124,121,245,"21 de agosto de 1994"
18,3,5,180,204,214,418,"21 de agosto de 1994"
18,3,5,181,129,100,229,"21 de agosto de 1994"
18,3,5,182,92,64,156,"21 de agosto de 1994"
18,3,5,183,262,260,522,"21 de agosto de 1994"
18,3,5,184,247,247,494,"21 de agosto de 1994"
18,3,5,185,252,249,501,"21 de agosto de 1994"
18,3,5,186,216,203,419,"21 de agosto de 1994"
18,3,5,187,222,236,458,"21 de agosto de 1994"
18,3,5,188,260,267,527,"21 de agosto de 1994"
18,3,5,189,242,212,454,"21 de agosto de 1994"
18,3,5,190,478,433,911,"21 de agosto de 1994"
18,3,5,191,93,67,160,"21 de agosto de 1994"
18,3,5,192,336,339,675,"21 de agosto de 1994"
18,3,5,193,64,57,121,"21 de agosto de 1994"
18,3,5,194,104,89,193,"21 de agosto de 1994"
18,3,5,195,111,100,211,"21 de agosto de 1994"
18,3,7,215,440,498,938,"21 de agosto de 1994"
18,3,7,216,297,318,615,"21 de agosto de 1994"
18,3,7,217,313,369,682,"21 de agosto de 1994"
18,3,7,218,403,452,855,"21 de agosto de 1994"
18,3,7,219,273,317,590,"21 de agosto de 1994"
18,3,7,220,413,430,843,"21 de agosto de 1994"
18,3,7,221,373,396,769,"21 de agosto de 1994"
18,3,7,222,363,476,839,"21 de agosto de 1994"
18,3,7,223,362,378,740,"21 de agosto de 1994"
18,3,7,224,228,255,483,"21 de agosto de 1994"
18,3,7,225,280,301,581,"21 de agosto de 1994"
18,3,7,226,305,366,671,"21 de agosto de 1994"
18,3,7,227,233,284,517,"21 de agosto de 1994"
18,3,7,228,232,294,526,"21 de agosto de 1994"
18,3,7,229,343,367,710,"21 de agosto de 1994"
18,3,7,230,178,171,349,"21 de agosto de 1994"
18,3,7,231,348,379,727,"21 de agosto de 1994"
18,3,7,232,168,149,317,"21 de agosto de 1994"
18,3,7,233,104,109,213,"21 de agosto de 1994"
18,3,7,234,109,134,243,"21 de agosto de 1994"
18,3,7,235,148,165,313,"21 de agosto de 1994"
18,3,7,236,424,449,873,"21 de agosto de 1994"
18,3,7,237,69,58,127,"21 de agosto de 1994"
18,3,7,238,167,166,333,"21 de agosto de 1994"
18,3,8,239,193,190,383,"21 de agosto de 1994"
18,3,8,240,218,266,484,"21 de agosto de 1994"
18,3,8,241,327,371,698,"21 de agosto de 1994"
18,3,8,242,289,310,599,"21 de agosto de 1994"
18,3,8,243,244,261,505,"21 de agosto de 1994"
18,3,8,244,275,323,598,"21 de agosto de 1994"
18,3,8,245,90,81,171,"21 de agosto de 1994"
18,3,8,246,113,91,204,"21 de agosto de 1994"
18,3,8,247,98,118,216,"21 de agosto de 1994"
18,3,8,248,283,286,569,"21 de agosto de 1994"
18,3,8,249,209,241,450,"21 de agosto de 1994"
18,3,8,250,192,179,371,"21 de agosto de 1994"
18,3,8,251,115,118,233,"21 de agosto de 1994"
18,3,8,252,378,376,754,"21 de agosto de 1994"
18,3,8,253,417,471,888,"21 de agosto de 1994"
18,3,8,254,214,244,458,"21 de agosto de 1994"
18,3,8,255,175,232,407,"21 de agosto de 1994"
18,3,8,256,239,235,474,"21 de agosto de 1994"
18,3,12,347,459,467,926,"21 de agosto de 1994"
18,3,12,348,247,246,493,"21 de agosto de 1994"
18,3,12,349,289,305,594,"21 de agosto de 1994"
18,3,12,350,419,433,852,"21 de agosto de 1994"
18,3,12,351,530,383,913,"21 de agosto de 1994"
18,3,12,352,286,286,572,"21 de agosto de 1994"
18,3,12,353,214,202,416,"21 de agosto de 1994"
18,3,12,354,141,134,275,"21 de agosto de 1994"
18,3,12,355,134,131,265,"21 de agosto de 1994"
18,3,12,356,343,344,687,"21 de agosto de 1994"
18,3,12,357,261,296,557,"21 de agosto de 1994"
18,3,12,358,214,180,394,"21 de agosto de 1994"
18,3,12,359,204,195,399,"21 de agosto de 1994"
18,3,12,360,329,339,668,"21 de agosto de 1994"
18,3,12,361,271,286,557,"21 de agosto de 1994"
18,3,12,362,141,125,266,"21 de agosto de 1994"
18,3,12,363,81,57,138,"21 de agosto de 1994"
18,3,12,364,57,54,111,"21 de agosto de 1994"
18,3,12,365,180,137,317,"21 de agosto de 1994"
18,3,12,366,254,226,480,"21 de agosto de 1994"
18,3,12,367,458,409,867,"21 de agosto de 1994"
18,3,12,368,150,147,297,"21 de agosto de 1994"
18,3,12,369,308,291,599,"21 de agosto de 1994"
18,3,12,370,177,154,331,"21 de agosto de 1994"
18,3,12,371,37,26,63,"21 de agosto de 1994"
18,3,12,372,62,43,105,"21 de agosto de 1994"
18,3,12,373,142,126,268,"21 de agosto de 1994"
18,3,12,374,91,76,167,"21 de agosto de 1994"
18,3,12,375,65,47,112,"21 de agosto de 1994"
18,3,12,376,419,348,767,"21 de agosto de 1994"
18,3,12,377,51,40,91,"21 de agosto de 1994"
18,3,12,378,77,48,125,"21 de agosto de 1994"
18,3,12,379,38,18,56,"21 de agosto de 1994"
18,3,12,380,72,58,130,"21 de agosto de 1994"
18,3,12,381,72,55,127,"21 de agosto de 1994"
18,3,12,382,400,372,772,"21 de agosto de 1994"
18,3,12,383,323,266,589,"21 de agosto de 1994"
18,3,12,384,186,172,358,"21 de agosto de 1994"
18,3,12,385,309,266,575,"21 de agosto de 1994"
18,3,12,386,356,409,765,"21 de agosto de 1994"
18,3,12,387,369,367,736,"21 de agosto de 1994"
18,3,12,388,204,214,418,"21 de agosto de 1994"
18,3,12,389,237,243,480,"21 de agosto de 1994"
18,3,12,390,350,340,690,"21 de agosto de 1994"
18,3,12,391,117,94,211,"21 de agosto de 1994"
18,3,12,392,250,259,509,"21 de agosto de 1994"
18,3,12,393,112,118,230,"21 de agosto de 1994"
18,3,12,394,132,90,222,"21 de agosto de 1994"
18,3,12,395,321,259,580,"21 de agosto de 1994"
18,3,12,396,84,71,155,"21 de agosto de 1994"
18,3,12,397,51,34,85,"21 de agosto de 1994"
18,3,13,398,326,306,632,"21 de agosto de 1994"
18,3,13,399,309,329,638,"21 de agosto de 1994"
18,3,13,400,228,250,478,"21 de agosto de 1994"
18,3,13,401,232,226,458,"21 de agosto de 1994"
18,3,13,402,70,71,141,"21 de agosto de 1994"
18,3,13,403,95,79,174,"21 de agosto de 1994"
18,3,13,404,154,148,302,"21 de agosto de 1994"
18,3,13,405,41,27,68,"21 de agosto de 1994"
18,3,13,406,209,174,383,"21 de agosto de 1994"
18,3,13,407,98,112,210,"21 de agosto de 1994"
18,3,13,408,184,179,363,"21 de agosto de 1994"
18,3,13,409,138,152,290,"21 de agosto de 1994"
18,3,13,410,286,282,568,"21 de agosto de 1994"
18,3,14,411,445,459,904,"21 de agosto de 1994"
18,3,14,412,561,578,1139,"21 de agosto de 1994"
18,3,14,413,89,73,162,"21 de agosto de 1994"
18,3,14,414,287,266,553,"21 de agosto de 1994"
18,3,14,415,246,231,477,"21 de agosto de 1994"
18,3,14,416,463,446,909,"21 de agosto de 1994"
18,3,14,417,92,78,170,"21 de agosto de 1994"
18,3,14,418,115,103,218,"21 de agosto de 1994"
18,3,14,419,163,148,311,"21 de agosto de 1994"
18,3,14,420,106,112,218,"21 de agosto de 1994"
18,3,14,421,467,451,918,"21 de agosto de 1994"
18,3,14,422,249,188,437,"21 de agosto de 1994"
18,3,14,423,259,235,494,"21 de agosto de 1994"
18,3,14,424,167,151,318,"21 de agosto de 1994"
18,3,14,425,185,188,373,"21 de agosto de 1994"
18,3,14,426,76,57,133,"21 de agosto de 1994"
18,3,14,427,280,259,539,"21 de agosto de 1994"
18,3,14,428,60,45,105,"21 de agosto de 1994"
18,3,14,429,257,268,525,"21 de agosto de 1994"
18,3,14,430,219,223,442,"21 de agosto de 1994"
18,3,14,431,171,166,337,"21 de agosto de 1994"
18,3,14,432,69,64,133,"21 de agosto de 1994"
18,3,14,433,406,426,832,"21 de agosto de 1994"
18,3,14,434,52,39,91,"21 de agosto de 1994"
18,3,19,844,383,426,809,"21 de agosto de 1994"
18,3,19,845,533,636,1169,"21 de agosto de 1994"
18,3,19,846,589,637,1226,"21 de agosto de 1994"
18,3,19,847,623,709,1332,"21 de agosto de 1994"
18,3,19,848,481,543,1024,"21 de agosto de 1994"
18,3,19,849,278,321,599,"21 de agosto de 1994"
18,3,19,850,196,219,415,"21 de agosto de 1994"
18,3,19,851,209,272,481,"21 de agosto de 1994"
18,3,19,852,347,408,755,"21 de agosto de 1994"
18,3,19,853,264,305,569,"21 de agosto de 1994"
18,3,19,854,395,448,843,"21 de agosto de 1994"
18,3,19,855,242,274,516,"21 de agosto de 1994"
18,3,19,856,278,250,528,"21 de agosto de 1994"
18,3,19,857,402,433,835,"21 de agosto de 1994"
18,3,19,858,335,354,689,"21 de agosto de 1994"
18,3,19,859,494,486,980,"21 de agosto de 1994"
18,3,19,860,173,146,319,"21 de agosto de 1994"
18,3,19,861,265,310,575,"21 de agosto de 1994"
18,3,19,862,379,306,685,"21 de agosto de 1994"
18,3,19,863,147,114,261,"21 de agosto de 1994"
18,3,19,864,476,463,939,"21 de agosto de 1994"
18,3,19,865,372,358,730,"21 de agosto de 1994"
18,3,20,866,196,164,360,"21 de agosto de 1994"
18,3,20,867,244,217,461,"21 de agosto de 1994"
18,3,20,868,103,99,202,"21 de agosto de 1994"
18,3,20,869,403,358,761,"21 de agosto de 1994"
18,3,20,870,382,314,696,"21 de agosto de 1994"
18,3,20,871,24,22,46,"21 de agosto de 1994"
18,3,20,872,137,103,240,"21 de agosto de 1994"
18,3,20,873,173,127,300,"21 de agosto de 1994"
18,3,20,874,140,102,242,"21 de agosto de 1994"
18,3,20,875,92,96,188,"21 de agosto de 1994"
18,3,20,876,53,37,90,"21 de agosto de 1994"
18,3,20,877,18,16,34,"21 de agosto de 1994"
18,3,20,878,242,186,428,"21 de agosto de 1994"
19,1,40,975,305,329,634,"21 de agosto de 1994"
19,1,40,976,659,655,1314,"21 de agosto de 1994"
19,1,40,977,531,563,1094,"21 de agosto de 1994"
19,1,40,978,667,677,1344,"21 de agosto de 1994"
19,1,40,979,658,666,1324,"21 de agosto de 1994"
19,1,40,980,625,674,1299,"21 de agosto de 1994"
19,1,40,981,489,576,1065,"21 de agosto de 1994"
19,1,40,982,638,659,1297,"21 de agosto de 1994"
19,1,40,983,631,663,1294,"21 de agosto de 1994"
19,1,40,984,591,638,1229,"21 de agosto de 1994"
19,1,40,985,599,643,1242,"21 de agosto de 1994"
19,1,40,986,444,481,925,"21 de agosto de 1994"
19,1,40,987,596,596,1192,"21 de agosto de 1994"
19,1,40,988,578,687,1265,"21 de agosto de 1994"
19,1,40,989,633,754,1387,"21 de agosto de 1994"
19,1,40,990,435,494,929,"21 de agosto de 1994"
19,1,40,991,477,563,1040,"21 de agosto de 1994"
19,1,40,992,424,499,923,"21 de agosto de 1994"
19,1,40,993,446,564,1010,"21 de agosto de 1994"
19,1,40,994,348,374,722,"21 de agosto de 1994"
19,1,40,995,643,706,1349,"21 de agosto de 1994"
19,1,40,996,280,318,598,"21 de agosto de 1994"
19,1,40,997,516,507,1023,"21 de agosto de 1994"
19,1,40,998,354,411,765,"21 de agosto de 1994"
19,1,40,999,333,347,680,"21 de agosto de 1994"
19,1,40,1000,297,334,631,"21 de agosto de 1994"
19,1,40,1001,379,437,816,"21 de agosto de 1994"
19,1,40,1002,636,699,1335,"21 de agosto de 1994"
19,1,40,1003,473,520,993,"21 de agosto de 1994"
19,1,40,1004,452,518,970,"21 de agosto de 1994"
19,1,40,1005,501,581,1082,"21 de agosto de 1994"
19,1,40,1006,494,554,1048,"21 de agosto de 1994"
19,1,40,1007,432,499,931,"21 de agosto de 1994"
19,1,40,1008,430,464,894,"21 de agosto de 1994"
19,1,40,1009,366,431,797,"21 de agosto de 1994"
19,1,40,1010,342,342,684,"21 de agosto de 1994"
19,1,40,1011,230,263,493,"21 de agosto de 1994"
19,1,40,1012,690,775,1465,"21 de agosto de 1994"
19,1,40,1013,497,573,1070,"21 de agosto de 1994"
19,1,40,1014,626,713,1339,"21 de agosto de 1994"
19,1,40,1015,627,685,1312,"21 de agosto de 1994"
19,1,40,1016,107,115,222,"21 de agosto de 1994"
19,1,40,1017,486,617,1103,"21 de agosto de 1994"
19,1,40,1018,518,605,1123,"21 de agosto de 1994"
19,1,40,1019,297,340,637,"21 de agosto de 1994"
19,1,40,1020,297,331,628,"21 de agosto de 1994"
19,1,40,1021,295,347,642,"21 de agosto de 1994"
19,1,40,1022,134,143,277,"21 de agosto de 1994"
19,1,40,1023,372,403,775,"21 de agosto de 1994"
19,1,40,1024,257,286,543,"21 de agosto de 1994"
19,1,40,1025,408,387,795,"21 de agosto de 1994"
19,1,40,1026,223,218,441,"21 de agosto de 1994"
19,1,40,1027,210,190,400,"21 de agosto de 1994"
19,1,40,1028,168,178,346,"21 de agosto de 1994"
19,1,40,1029,436,416,852,"21 de agosto de 1994"
19,1,40,1030,260,304,564,"21 de agosto de 1994"
19,1,40,1031,349,414,763,"21 de agosto de 1994"
19,1,40,1032,356,424,780,"21 de agosto de 1994"
19,1,40,1033,317,368,685,"21 de agosto de 1994"
19,1,40,1034,387,453,840,"21 de agosto de 1994"
19,1,40,1035,300,377,677,"21 de agosto de 1994"
19,1,40,1036,403,473,876,"21 de agosto de 1994"
19,1,40,1037,198,215,413,"21 de agosto de 1994"
19,1,40,1038,294,316,610,"21 de agosto de 1994"
19,1,40,1039,334,379,713,"21 de agosto de 1994"
19,1,40,1040,367,394,761,"21 de agosto de 1994"
19,1,40,1041,717,834,1551,"21 de agosto de 1994"
19,1,40,1042,540,580,1120,"21 de agosto de 1994"
19,1,40,1043,574,639,1213,"21 de agosto de 1994"
19,1,40,1044,560,636,1196,"21 de agosto de 1994"
19,1,40,1045,628,651,1279,"21 de agosto de 1994"
19,1,40,1046,574,622,1196,"21 de agosto de 1994"
19,1,40,1047,573,633,1206,"21 de agosto de 1994"
19,1,40,1048,233,262,495,"21 de agosto de 1994"
19,1,40,1049,306,364,670,"21 de agosto de 1994"
19,1,40,1050,323,427,750,"21 de agosto de 1994"
19,1,40,1051,160,229,389,"21 de agosto de 1994"
19,1,40,1052,427,551,978,"21 de agosto de 1994"
19,1,40,1053,173,193,366,"21 de agosto de 1994"
19,1,40,1054,393,439,832,"21 de agosto de 1994"
19,1,40,1055,236,265,501,"21 de agosto de 1994"
19,1,40,1056,200,210,410,"21 de agosto de 1994"
19,1,40,1057,189,208,397,"21 de agosto de 1994"
19,1,40,1058,425,436,861,"21 de agosto de 1994"
19,1,40,1059,463,499,962,"21 de agosto de 1994"
19,1,40,1060,207,236,443,"21 de agosto de 1994"
19,1,40,1061,208,190,398,"21 de agosto de 1994"
19,1,40,1062,156,179,335,"21 de agosto de 1994"
19,1,40,1063,389,388,777,"21 de agosto de 1994"
19,1,40,1064,517,523,1040,"21 de agosto de 1994"
19,1,40,1065,741,791,1532,"21 de agosto de 1994"
19,1,40,1066,476,548,1024,"21 de agosto de 1994"
19,1,40,1067,262,293,555,"21 de agosto de 1994"
19,1,40,1068,302,309,611,"21 de agosto de 1994"
19,1,40,1069,384,403,787,"21 de agosto de 1994"
19,1,40,1070,223,279,502,"21 de agosto de 1994"
19,1,40,1071,248,320,568,"21 de agosto de 1994"
19,1,40,1072,197,218,415,"21 de agosto de 1994"
19,1,40,1073,234,301,535,"21 de agosto de 1994"
19,1,40,1074,288,320,608,"21 de agosto de 1994"
19,1,40,1075,232,262,494,"21 de agosto de 1994"
19,1,40,1076,170,221,391,"21 de agosto de 1994"
19,1,40,1077,142,140,282,"21 de agosto de 1994"
19,1,40,1078,294,294,588,"21 de agosto de 1994"
19,1,40,1079,197,221,418,"21 de agosto de 1994"
19,1,40,1080,210,235,445,"21 de agosto de 1994"
19,1,40,1081,208,248,456,"21 de agosto de 1994"
19,1,40,1082,214,309,523,"21 de agosto de 1994"
19,1,40,1083,293,374,667,"21 de agosto de 1994"
19,1,40,1084,495,562,1057,"21 de agosto de 1994"
19,1,40,1085,415,462,877,"21 de agosto de 1994"
19,1,40,1086,290,382,672,"21 de agosto de 1994"
19,1,40,1087,251,281,532,"21 de agosto de 1994"
19,1,40,1088,397,424,821,"21 de agosto de 1994"
19,1,40,1089,339,391,730,"21 de agosto de 1994"
19,1,40,1090,521,583,1104,"21 de agosto de 1994"
19,1,40,1091,701,761,1462,"21 de agosto de 1994"
19,1,40,1092,465,529,994,"21 de agosto de 1994"
19,1,40,1093,574,669,1243,"21 de agosto de 1994"
19,1,40,1094,453,510,963,"21 de agosto de 1994"
19,1,40,1095,416,477,893,"21 de agosto de 1994"
19,1,40,1096,422,480,902,"21 de agosto de 1994"
19,1,40,1097,419,462,881,"21 de agosto de 1994"
19,1,40,1098,619,692,1311,"21 de agosto de 1994"
19,1,40,1099,313,359,672,"21 de agosto de 1994"
19,1,40,1100,326,378,704,"21 de agosto de 1994"
19,1,40,1101,350,421,771,"21 de agosto de 1994"
19,1,40,1102,203,261,464,"21 de agosto de 1994"
19,1,40,1103,318,394,712,"21 de agosto de 1994"
19,1,40,1104,134,157,291,"21 de agosto de 1994"
19,1,40,1105,172,210,382,"21 de agosto de 1994"
19,1,40,1106,194,229,423,"21 de agosto de 1994"
19,1,40,1107,211,242,453,"21 de agosto de 1994"
19,1,40,1108,235,285,520,"21 de agosto de 1994"
19,1,40,1109,226,317,543,"21 de agosto de 1994"
19,1,40,1110,195,250,445,"21 de agosto de 1994"
19,1,40,1111,173,233,406,"21 de agosto de 1994"
19,1,40,1112,132,160,292,"21 de agosto de 1994"
19,1,40,1113,159,235,394,"21 de agosto de 1994"
19,1,40,1114,138,209,347,"21 de agosto de 1994"
19,1,40,1115,264,283,547,"21 de agosto de 1994"
19,1,40,1116,386,454,840,"21 de agosto de 1994"
19,1,40,1117,308,407,715,"21 de agosto de 1994"
19,1,40,1118,195,255,450,"21 de agosto de 1994"
19,1,40,1119,83,85,168,"21 de agosto de 1994"
19,1,40,1120,354,468,822,"21 de agosto de 1994"
19,1,40,1121,276,335,611,"21 de agosto de 1994"
19,1,40,1122,233,306,539,"21 de agosto de 1994"
19,1,40,1123,308,346,654,"21 de agosto de 1994"
19,1,40,1124,805,814,1619,"21 de agosto de 1994"
19,1,40,1125,492,517,1009,"21 de agosto de 1994"
19,1,40,1126,560,615,1175,"21 de agosto de 1994"
19,1,40,1127,695,716,1411,"21 de agosto de 1994"
19,1,40,1128,414,416,830,"21 de agosto de 1994"
19,1,40,1129,339,380,719,"21 de agosto de 1994"
19,1,40,1130,292,332,624,"21 de agosto de 1994"
19,2,40,1131,105,114,219,"21 de agosto de 1994"
19,2,40,1132,98,96,194,"21 de agosto de 1994"
19,2,40,1133,196,232,428,"21 de agosto de 1994"
19,2,40,1134,567,627,1194,"21 de agosto de 1994"
19,2,40,1135,247,249,496,"21 de agosto de 1994"
19,2,40,1136,296,290,586,"21 de agosto de 1994"
19,2,40,1137,247,274,521,"21 de agosto de 1994"
19,2,40,1138,160,184,344,"21 de agosto de 1994"
19,2,40,1139,132,155,287,"21 de agosto de 1994"
19,2,40,1140,161,148,309,"21 de agosto de 1994"
19,2,40,1141,202,242,444,"21 de agosto de 1994"
19,2,40,1142,52,62,114,"21 de agosto de 1994"
19,2,40,1143,120,163,283,"21 de agosto de 1994"
19,2,40,1144,153,188,341,"21 de agosto de 1994"
19,2,40,1145,156,145,301,"21 de agosto de 1994"
19,2,40,1146,225,249,474,"21 de agosto de 1994"
19,2,40,1147,208,232,440,"21 de agosto de 1994"
19,2,40,1148,223,301,524,"21 de agosto de 1994"
19,2,40,1149,206,222,428,"21 de agosto de 1994"
19,2,40,1150,297,355,652,"21 de agosto de 1994"
19,2,40,1151,139,168,307,"21 de agosto de 1994"
19,2,40,1152,253,282,535,"21 de agosto de 1994"
19,2,40,1153,156,132,288,"21 de agosto de 1994"
19,2,40,1154,415,441,856,"21 de agosto de 1994"
19,2,40,1155,152,165,317,"21 de agosto de 1994"
19,2,40,1156,199,193,392,"21 de agosto de 1994"
19,2,40,1157,242,244,486,"21 de agosto de 1994"
19,2,40,1158,224,232,456,"21 de agosto de 1994"
19,2,40,1159,147,168,315,"21 de agosto de 1994"
19,2,40,1160,140,120,260,"21 de agosto de 1994"
19,2,40,1161,162,153,315,"21 de agosto de 1994"
19,2,40,1162,188,150,338,"21 de agosto de 1994"
19,2,40,1163,163,175,338,"21 de agosto de 1994"
19,2,40,1164,109,130,239,"21 de agosto de 1994"
19,2,40,1165,133,140,273,"21 de agosto de 1994"
19,2,40,1166,252,251,503,"21 de agosto de 1994"
19,2,40,1167,202,215,417,"21 de agosto de 1994"
19,2,40,1168,55,79,134,"21 de agosto de 1994"
19,2,40,1169,70,70,140,"21 de agosto de 1994"
19,2,40,1170,44,29,73,"21 de agosto de 1994"
19,2,40,1171,79,83,162,"21 de agosto de 1994"
19,2,40,1172,39,25,64,"21 de agosto de 1994"
19,2,40,1173,123,92,215,"21 de agosto de 1994"
19,2,40,1174,118,127,245,"21 de agosto de 1994"
19,2,40,1175,214,250,464,"21 de agosto de 1994"
19,2,40,1176,121,132,253,"21 de agosto de 1994"
19,2,40,1177,107,74,181,"21 de agosto de 1994"
19,2,40,1178,120,105,225,"21 de agosto de 1994"
19,2,40,1179,41,30,71,"21 de agosto de 1994"
19,2,40,1180,137,135,272,"21 de agosto de 1994"
19,2,40,1181,109,102,211,"21 de agosto de 1994"
19,2,40,1182,106,122,228,"21 de agosto de 1994"
19,2,40,1183,167,172,339,"21 de agosto de 1994"
19,2,40,1184,74,81,155,"21 de agosto de 1994"
19,2,40,1185,37,44,81,"21 de agosto de 1994"
19,2,40,1186,104,121,225,"21 de agosto de 1994"
19,2,40,1187,128,155,283,"21 de agosto de 1994"
19,2,40,1188,135,165,300,"21 de agosto de 1994"
19,2,40,1189,197,211,408,"21 de agosto de 1994"
19,2,40,1190,48,54,102,"21 de agosto de 1994"
19,2,40,1191,138,147,285,"21 de agosto de 1994"
19,2,40,1192,56,48,104,"21 de agosto de 1994"
19,2,40,1193,88,115,203,"21 de agosto de 1994"
19,2,40,1194,46,65,111,"21 de agosto de 1994"
19,2,40,1195,118,148,266,"21 de agosto de 1994"
19,2,40,1196,250,297,547,"21 de agosto de 1994"
19,2,40,1197,66,75,141,"21 de agosto de 1994"
19,2,40,1198,65,65,130,"21 de agosto de 1994"
19,2,40,1199,97,120,217,"21 de agosto de 1994"
19,2,40,1200,51,38,89,"21 de agosto de 1994"
19,2,40,1201,90,86,176,"21 de agosto de 1994"
19,2,40,1202,109,106,215,"21 de agosto de 1994"
19,2,40,1203,47,54,101,"21 de agosto de 1994"
19,2,40,1204,88,86,174,"21 de agosto de 1994"
19,2,40,1205,335,344,679,"21 de agosto de 1994"
19,2,40,1206,223,281,504,"21 de agosto de 1994"
19,2,40,1207,308,324,632,"21 de agosto de 1994"
19,2,40,1208,305,290,595,"21 de agosto de 1994"
19,2,40,1209,268,296,564,"21 de agosto de 1994"
19,2,40,1210,201,226,427,"21 de agosto de 1994"
19,2,40,1211,308,325,633,"21 de agosto de 1994"
19,2,40,1212,209,237,446,"21 de agosto de 1994"
19,2,40,1213,249,268,517,"21 de agosto de 1994"
19,2,40,1214,177,187,364,"21 de agosto de 1994"
19,2,40,1215,191,208,399,"21 de agosto de 1994"
19,2,40,1216,154,186,340,"21 de agosto de 1994"
19,2,40,1217,199,212,411,"21 de agosto de 1994"
19,2,40,1218,297,312,609,"21 de agosto de 1994"
19,2,40,1219,338,375,713,"21 de agosto de 1994"
19,2,40,1220,371,431,802,"21 de agosto de 1994"
19,2,40,1221,283,315,598,"21 de agosto de 1994"
19,2,40,1222,416,430,846,"21 de agosto de 1994"
19,2,40,1223,409,438,847,"21 de agosto de 1994"
19,2,40,1224,299,320,619,"21 de agosto de 1994"
19,2,40,1225,492,517,1009,"21 de agosto de 1994"
19,2,40,1226,244,248,492,"21 de agosto de 1994"
19,2,40,1227,413,457,870,"21 de agosto de 1994"
19,2,40,1228,495,508,1003,"21 de agosto de 1994"
19,2,40,1229,343,327,670,"21 de agosto de 1994"
19,2,40,1230,614,667,1281,"21 de agosto de 1994"
19,2,40,1231,451,485,936,"21 de agosto de 1994"
19,2,40,1232,503,558,1061,"21 de agosto de 1994"
19,2,40,1233,597,585,1182,"21 de agosto de 1994"
19,2,40,1234,289,293,582,"21 de agosto de 1994"
19,2,40,1235,617,640,1257,"21 de agosto de 1994"
19,2,40,1236,474,477,951,"21 de agosto de 1994"
19,2,40,1237,508,508,1016,"21 de agosto de 1994"
19,2,40,1238,504,510,1014,"21 de agosto de 1994"
19,2,40,1239,328,356,684,"21 de agosto de 1994"
19,2,40,1240,365,394,759,"21 de agosto de 1994"
19,3,40,1241,279,260,539,"21 de agosto de 1994"
19,3,40,1242,259,275,534,"21 de agosto de 1994"
19,3,40,1243,367,410,777,"21 de agosto de 1994"
19,3,40,1244,315,347,662,"21 de agosto de 1994"
19,3,40,1245,146,142,288,"21 de agosto de 1994"
19,3,40,1246,305,339,644,"21 de agosto de 1994"
19,3,40,1247,465,465,930,"21 de agosto de 1994"
19,3,40,1248,344,371,715,"21 de agosto de 1994"
19,3,40,1249,189,214,403,"21 de agosto de 1994"
19,3,40,1250,304,311,615,"21 de agosto de 1994"
19,3,40,1251,216,242,458,"21 de agosto de 1994"
19,3,40,1252,245,261,506,"21 de agosto de 1994"
19,3,40,1253,368,418,786,"21 de agosto de 1994"
19,3,40,1254,177,195,372,"21 de agosto de 1994"
19,3,40,1255,213,215,428,"21 de agosto de 1994"
19,3,40,1256,185,230,415,"21 de agosto de 1994"
19,3,40,1257,276,321,597,"21 de agosto de 1994"
19,3,40,1258,307,339,646,"21 de agosto de 1994"
19,3,40,1259,213,249,462,"21 de agosto de 1994"
19,3,40,1260,187,218,405,"21 de agosto de 1994"
19,3,40,1261,185,189,374,"21 de agosto de 1994"
19,3,40,1262,122,129,251,"21 de agosto de 1994"
19,3,40,1263,222,240,462,"21 de agosto de 1994"
19,3,40,1264,249,286,535,"21 de agosto de 1994"
19,3,40,1265,46,53,99,"21 de agosto de 1994"
19,3,40,1266,224,267,491,"21 de agosto de 1994"
19,3,40,1267,342,352,694,"21 de agosto de 1994"
19,3,40,1268,126,157,283,"21 de agosto de 1994"
19,3,40,1269,194,226,420,"21 de agosto de 1994"
19,3,40,1270,149,196,345,"21 de agosto de 1994"
19,3,40,1271,116,140,256,"21 de agosto de 1994"
19,3,40,1272,126,144,270,"21 de agosto de 1994"
19,3,40,1273,130,154,284,"21 de agosto de 1994"
19,3,40,1274,294,321,615,"21 de agosto de 1994"
19,3,40,1275,265,290,555,"21 de agosto de 1994"
19,3,40,1276,175,194,369,"21 de agosto de 1994"
19,3,40,1277,176,228,404,"21 de agosto de 1994"
19,3,40,1278,163,199,362,"21 de agosto de 1994"
19,3,40,1279,170,201,371,"21 de agosto de 1994"
19,3,40,1280,90,90,180,"21 de agosto de 1994"
19,3,40,1281,333,325,658,"21 de agosto de 1994"
19,3,40,1282,213,239,452,"21 de agosto de 1994"
19,3,40,1283,85,123,208,"21 de agosto de 1994"
19,3,40,1284,243,285,528,"21 de agosto de 1994"
19,3,40,1285,478,572,1050,"21 de agosto de 1994"
19,3,40,1286,388,523,911,"21 de agosto de 1994"
19,3,40,1287,150,201,351,"21 de agosto de 1994"
19,3,40,1288,351,362,713,"21 de agosto de 1994"
19,3,40,1289,399,420,819,"21 de agosto de 1994"
19,3,40,1290,233,264,497,"21 de agosto de 1994"
19,3,40,1291,354,381,735,"21 de agosto de 1994"
19,3,40,1292,617,671,1288,"21 de agosto de 1994"
19,3,40,1293,271,313,584,"21 de agosto de 1994"
19,3,40,1294,342,428,770,"21 de agosto de 1994"
19,3,40,1295,240,249,489,"21 de agosto de 1994"
19,3,40,1296,361,383,744,"21 de agosto de 1994"
19,3,40,1297,216,262,478,"21 de agosto de 1994"
19,3,40,1298,217,229,446,"21 de agosto de 1994"
19,3,40,1299,608,656,1264,"21 de agosto de 1994"
19,3,40,1300,317,390,707,"21 de agosto de 1994"
19,3,40,1301,379,415,794,"21 de agosto de 1994"
19,3,40,1302,288,256,544,"21 de agosto de 1994"
19,3,40,1303,212,229,441,"21 de agosto de 1994"
19,3,40,1304,392,435,827,"21 de agosto de 1994"
19,3,40,1305,453,436,889,"21 de agosto de 1994"
19,3,40,1306,293,294,587,"21 de agosto de 1994"
19,3,40,1307,584,647,1231,"21 de agosto de 1994"
19,3,40,1308,315,340,655,"21 de agosto de 1994"
19,3,40,1309,451,508,959,"21 de agosto de 1994"
19,3,40,1310,630,680,1310,"21 de agosto de 1994"
19,3,40,1311,386,424,810,"21 de agosto de 1994"
19,3,40,1312,487,545,1032,"21 de agosto de 1994"
19,3,40,1313,382,359,741,"21 de agosto de 1994"
19,3,40,1314,593,594,1187,"21 de agosto de 1994"
19,3,40,1315,604,711,1315,"21 de agosto de 1994"
19,3,40,1316,591,659,1250,"21 de agosto de 1994"
19,3,40,1317,287,321,608,"21 de agosto de 1994"
19,3,40,1318,482,618,1100,"21 de agosto de 1994"
19,3,40,1319,407,459,866,"21 de agosto de 1994"
19,3,40,1320,339,381,720,"21 de agosto de 1994"
19,3,40,1321,331,319,650,"21 de agosto de 1994"
19,3,40,1322,224,255,479,"21 de agosto de 1994"
19,3,40,1323,185,190,375,"21 de agosto de 1994"
19,3,40,1324,214,227,441,"21 de agosto de 1994"
19,3,40,1325,396,406,802,"21 de agosto de 1994"
19,3,40,1326,638,751,1389,"21 de agosto de 1994"
19,3,40,1327,283,258,541,"21 de agosto de 1994"
19,3,40,1328,177,187,364,"21 de agosto de 1994"
19,3,40,1329,603,727,1330,"21 de agosto de 1994"
19,3,40,1330,512,553,1065,"21 de agosto de 1994"
19,3,40,1331,751,793,1544,"21 de agosto de 1994"
19,3,40,1332,667,697,1364,"21 de agosto de 1994"
19,3,40,1333,690,784,1474,"21 de agosto de 1994"
19,3,40,1334,671,830,1501,"21 de agosto de 1994"
19,3,40,1335,493,565,1058,"21 de agosto de 1994"
19,3,40,1336,699,743,1442,"21 de agosto de 1994"
19,3,40,1337,416,444,860,"21 de agosto de 1994"
19,3,40,1338,572,692,1264,"21 de agosto de 1994"
19,3,40,1339,403,453,856,"21 de agosto de 1994"
19,3,40,1340,156,195,351,"21 de agosto de 1994"
19,3,40,1341,295,332,627,"21 de agosto de 1994"
19,3,40,1342,409,455,864,"21 de agosto de 1994"
19,3,40,1343,448,488,936,"21 de agosto de 1994"
19,3,40,1344,332,363,695,"21 de agosto de 1994"
19,3,40,1345,297,358,655,"21 de agosto de 1994"
19,3,40,1346,562,542,1104,"21 de agosto de 1994"
19,3,40,1347,478,355,833,"21 de agosto de 1994"
19,3,40,1348,292,266,558,"21 de agosto de 1994"
19,3,40,1349,330,363,693,"21 de agosto de 1994"
19,3,40,1350,659,684,1343,"21 de agosto de 1994"
19,3,40,1351,643,667,1310,"21 de agosto de 1994"
19,3,40,1352,640,762,1402,"21 de agosto de 1994"
19,3,40,1353,464,494,958,"21 de agosto de 1994"
19,3,40,1354,432,493,925,"21 de agosto de 1994"
19,3,40,1355,711,749,1460,"21 de agosto de 1994"
19,3,40,1356,938,935,1873,"21 de agosto de 1994"
19,3,40,1357,596,649,1245,"21 de agosto de 1994"
19,3,40,1358,684,732,1416,"21 de agosto de 1994"
19,3,40,1359,691,733,1424,"21 de agosto de 1994"
19,3,40,1360,588,660,1248,"21 de agosto de 1994"
19,3,40,1361,367,407,774,"21 de agosto de 1994"
19,3,40,1362,436,461,897,"21 de agosto de 1994"
19,3,40,1363,387,426,813,"21 de agosto de 1994"
19,3,40,1364,659,747,1406,"21 de agosto de 1994"
19,3,40,1365,610,665,1275,"21 de agosto de 1994"
19,3,40,1366,471,500,971,"21 de agosto de 1994"
19,3,40,1367,450,525,975,"21 de agosto de 1994"
19,3,40,1368,449,518,967,"21 de agosto de 1994"
19,3,40,1369,458,506,964,"21 de agosto de 1994"
19,3,40,1370,277,304,581,"21 de agosto de 1994"
19,3,40,1371,489,451,940,"21 de agosto de 1994"
19,3,40,1372,416,490,906,"21 de agosto de 1994"
19,3,40,1373,427,453,880,"21 de agosto de 1994"
19,3,40,1374,468,512,980,"21 de agosto de 1994"
19,3,40,1375,518,505,1023,"21 de agosto de 1994"
19,3,40,1376,728,748,1476,"21 de agosto de 1994"
19,3,40,1377,396,463,859,"21 de agosto de 1994"
19,3,40,1378,442,436,878,"21 de agosto de 1994"
19,3,40,1379,363,400,763,"21 de agosto de 1994"
19,3,40,1380,603,610,1213,"21 de agosto de 1994"
19,3,40,1381,380,408,788,"21 de agosto de 1994"
19,3,40,1382,701,727,1428,"21 de agosto de 1994"
19,3,40,1383,603,626,1229,"21 de agosto de 1994"
19,3,40,1384,379,439,818,"21 de agosto de 1994"
19,3,40,1385,666,716,1382,"21 de agosto de 1994"
19,3,40,1386,535,550,1085,"21 de agosto de 1994"
19,3,40,1387,477,535,1012,"21 de agosto de 1994"
19,3,40,1388,574,650,1224,"21 de agosto de 1994"
19,3,40,1389,646,653,1299,"21 de agosto de 1994"
19,3,40,1390,481,541,1022,"21 de agosto de 1994"
19,3,40,1391,513,596,1109,"21 de agosto de 1994"
19,3,40,1392,508,589,1097,"21 de agosto de 1994"
19,3,40,1393,884,900,1784,"21 de agosto de 1994"
19,3,40,1394,678,728,1406,"21 de agosto de 1994"
19,3,40,1395,387,363,750,"21 de agosto de 1994"
19,3,40,1396,472,516,988,"21 de agosto de 1994"
19,3,40,1397,583,548,1131,"21 de agosto de 1994"
19,3,40,1398,562,570,1132,"21 de agosto de 1994"
19,3,40,1399,696,744,1440,"21 de agosto de 1994"
19,3,40,1400,731,808,1539,"21 de agosto de 1994"
19,3,40,1401,609,633,1242,"21 de agosto de 1994"
19,3,40,1402,701,683,1384,"21 de agosto de 1994"
19,3,40,1403,244,280,524,"21 de agosto de 1994"
19,3,40,1404,683,709,1392,"21 de agosto de 1994"
19,3,40,1405,459,497,956,"21 de agosto de 1994"
19,3,40,1406,480,506,986,"21 de agosto de 1994"
19,3,40,1407,342,345,687,"21 de agosto de 1994"
19,3,40,1408,585,654,1239,"21 de agosto de 1994"
19,3,40,1409,830,872,1702,"21 de agosto de 1994"
19,3,40,1410,610,664,1274,"21 de agosto de 1994"
19,3,40,1411,508,587,1095,"21 de agosto de 1994"
19,3,40,1412,621,705,1326,"21 de agosto de 1994"
19,3,40,1413,764,849,1613,"21 de agosto de 1994"
19,3,40,1414,617,704,1321,"21 de agosto de 1994"
19,3,40,1415,437,478,915,"21 de agosto de 1994"
19,3,40,1416,442,470,912,"21 de agosto de 1994"
19,3,40,1417,484,569,1053,"21 de agosto de 1994"
19,3,40,1418,646,713,1359,"21 de agosto de 1994"
19,3,40,1419,216,238,454,"21 de agosto de 1994"
19,3,40,1420,439,499,938,"21 de agosto de 1994"
19,3,40,1421,551,545,1096,"21 de agosto de 1994"
19,3,40,1422,536,515,1051,"21 de agosto de 1994"
19,3,40,1423,479,481,960,"21 de agosto de 1994"
19,3,40,1424,452,469,921,"21 de agosto de 1994"
19,3,40,1425,396,427,823,"21 de agosto de 1994"
19,3,40,1426,338,351,689,"21 de agosto de 1994"
19,3,40,1427,387,386,773,"21 de agosto de 1994"
19,3,40,1428,474,509,983,"21 de agosto de 1994"
19,3,40,1429,315,338,653,"21 de agosto de 1994"
19,3,40,1430,41,34,75,"21 de agosto de 1994"
19,3,40,1431,281,311,592,"21 de agosto de 1994"
19,4,26,526,177,177,354,"21 de agosto de 1994"
19,4,26,527,349,354,703,"21 de agosto de 1994"
19,4,26,528,432,440,872,"21 de agosto de 1994"
19,4,26,529,214,233,447,"21 de agosto de 1994"
19,4,26,530,219,212,431,"21 de agosto de 1994"
19,4,26,531,330,307,637,"21 de agosto de 1994"
19,4,26,532,339,338,677,"21 de agosto de 1994"
19,4,26,533,603,622,1225,"21 de agosto de 1994"
19,4,26,534,286,318,604,"21 de agosto de 1994"
19,4,26,535,513,554,1067,"21 de agosto de 1994"
19,4,26,536,478,537,1015,"21 de agosto de 1994"
19,4,26,537,776,850,1626,"21 de agosto de 1994"
19,4,26,538,727,824,1551,"21 de agosto de 1994"
19,4,26,539,679,713,1392,"21 de agosto de 1994"
19,4,26,540,456,437,893,"21 de agosto de 1994"
19,4,26,541,663,675,1338,"21 de agosto de 1994"
19,4,26,542,544,524,1068,"21 de agosto de 1994"
19,4,26,543,481,481,962,"21 de agosto de 1994"
19,4,26,544,779,796,1575,"21 de agosto de 1994"
19,4,26,545,195,200,395,"21 de agosto de 1994"
19,4,26,546,822,828,1650,"21 de agosto de 1994"
19,4,26,547,352,350,702,"21 de agosto de 1994"
19,4,26,548,685,689,1374,"21 de agosto de 1994"
19,4,26,549,541,602,1143,"21 de agosto de 1994"
19,4,26,550,425,401,826,"21 de agosto de 1994"
19,4,26,551,439,510,949,"21 de agosto de 1994"
19,4,26,552,644,671,1315,"21 de agosto de 1994"
19,4,26,553,338,394,732,"21 de agosto de 1994"
19,4,26,554,676,724,1400,"21 de agosto de 1994"
19,4,26,555,700,718,1418,"21 de agosto de 1994"
19,4,26,556,513,590,1103,"21 de agosto de 1994"
19,4,26,557,312,314,626,"21 de agosto de 1994"
19,4,26,558,443,491,934,"21 de agosto de 1994"
19,4,26,559,303,319,622,"21 de agosto de 1994"
19,4,26,560,688,833,1521,"21 de agosto de 1994"
19,4,26,561,322,310,632,"21 de agosto de 1994"
19,4,26,562,341,340,681,"21 de agosto de 1994"
19,4,26,563,376,428,804,"21 de agosto de 1994"
19,4,26,564,329,366,695,"21 de agosto de 1994"
19,4,26,565,328,348,676,"21 de agosto de 1994"
19,4,26,566,281,288,569,"21 de agosto de 1994"
19,4,26,567,265,304,569,"21 de agosto de 1994"
19,4,26,568,592,626,1218,"21 de agosto de 1994"
19,4,26,569,495,571,1066,"21 de agosto de 1994"
19,4,26,570,413,470,883,"21 de agosto de 1994"
19,4,26,571,562,612,1174,"21 de agosto de 1994"
19,4,26,572,416,453,869,"21 de agosto de 1994"
19,4,26,573,314,345,659,"21 de agosto de 1994"
19,4,26,574,291,324,615,"21 de agosto de 1994"
19,4,26,575,280,323,603,"21 de agosto de 1994"
19,4,26,576,594,584,1178,"21 de agosto de 1994"
19,4,26,577,726,774,1500,"21 de agosto de 1994"
19,4,26,578,526,534,1060,"21 de agosto de 1994"
19,4,26,579,386,390,776,"21 de agosto de 1994"
19,4,26,580,160,163,323,"21 de agosto de 1994"
19,4,26,581,635,700,1335,"21 de agosto de 1994"
19,4,26,582,657,702,1359,"21 de agosto de 1994"
19,4,26,583,818,824,1642,"21 de agosto de 1994"
19,4,26,584,830,924,1754,"21 de agosto de 1994"
19,4,26,585,519,568,1087,"21 de agosto de 1994"
19,4,26,586,663,738,1401,"21 de agosto de 1994"
19,4,26,587,609,610,1219,"21 de agosto de 1994"
19,4,26,588,425,486,911,"21 de agosto de 1994"
19,4,26,589,147,169,316,"21 de agosto de 1994"
19,4,26,590,535,619,1154,"21 de agosto de 1994"
19,4,26,591,206,231,437,"21 de agosto de 1994"
19,4,26,592,480,557,1037,"21 de agosto de 1994"
19,4,26,593,620,694,1314,"21 de agosto de 1994"
19,4,26,594,637,680,1317,"21 de agosto de 1994"
19,4,26,595,614,629,1243,"21 de agosto de 1994"
19,4,26,596,774,822,1596,"21 de agosto de 1994"
19,4,26,597,745,756,1501,"21 de agosto de 1994"
19,4,26,598,553,624,1177,"21 de agosto de 1994"
19,4,26,599,465,485,950,"21 de agosto de 1994"
19,4,26,600,692,775,1467,"21 de agosto de 1994"
19,4,26,601,708,796,1504,"21 de agosto de 1994"
19,4,26,602,813,832,1645,"21 de agosto de 1994"
19,4,26,603,701,708,1409,"21 de agosto de 1994"
19,5,7,151,385,346,731,"21 de agosto de 1994"
19,5,7,152,511,436,947,"21 de agosto de 1994"
19,5,7,153,196,145,341,"21 de agosto de 1994"
19,5,7,154,143,96,239,"21 de agosto de 1994"
19,5,7,155,247,172,419,"21 de agosto de 1994"
19,5,7,156,275,268,543,"21 de agosto de 1994"
19,5,7,157,242,229,471,"21 de agosto de 1994"
19,5,7,158,270,247,517,"21 de agosto de 1994"
19,5,7,159,92,62,154,"21 de agosto de 1994"
19,5,7,160,237,176,413,"21 de agosto de 1994"
19,5,7,161,313,252,565,"21 de agosto de 1994"
19,5,7,162,327,258,585,"21 de agosto de 1994"
19,5,7,163,203,155,358,"21 de agosto de 1994"
19,5,7,164,189,129,318,"21 de agosto de 1994"
19,5,7,165,282,242,524,"21 de agosto de 1994"
19,5,7,166,211,190,401,"21 de agosto de 1994"
19,5,7,167,122,108,230,"21 de agosto de 1994"
19,5,14,257,279,247,526,"21 de agosto de 1994"
19,5,14,258,543,582,1125,"21 de agosto de 1994"
19,5,14,259,284,326,610,"21 de agosto de 1994"
19,5,14,260,347,374,721,"21 de agosto de 1994"
19,5,14,261,324,348,672,"21 de agosto de 1994"
19,5,14,262,271,254,525,"21 de agosto de 1994"
19,5,14,263,252,287,539,"21 de agosto de 1994"
19,5,14,264,72,62,134,"21 de agosto de 1994"
19,5,14,265,237,199,436,"21 de agosto de 1994"
19,5,14,266,265,213,478,"21 de agosto de 1994"
19,5,14,267,131,120,251,"21 de agosto de 1994"
19,5,14,268,543,471,1014,"21 de agosto de 1994"
19,5,14,269,266,239,505,"21 de agosto de 1994"
19,5,14,270,290,234,524,"21 de agosto de 1994"
19,5,14,271,455,372,827,"21 de agosto de 1994"
19,5,14,272,246,229,475,"21 de agosto de 1994"
19,5,14,273,202,172,374,"21 de agosto de 1994"
19,5,14,274,240,207,447,"21 de agosto de 1994"
19,5,14,275,328,297,625,"21 de agosto de 1994"
19,5,14,276,384,346,730,"21 de agosto de 1994"
19,5,14,277,311,282,593,"21 de agosto de 1994"
19,5,14,278,100,96,196,"21 de agosto de 1994"
19,5,14,279,207,179,386,"21 de agosto de 1994"
19,5,14,280,177,158,335,"21 de agosto de 1994"
19,5,14,281,106,95,201,"21 de agosto de 1994"
19,5,14,282,241,220,461,"21 de agosto de 1994"
19,5,14,283,255,224,479,"21 de agosto de 1994"
19,5,14,284,161,140,301,"21 de agosto de 1994"
19,5,14,285,111,115,226,"21 de agosto de 1994"
19,5,14,286,163,215,378,"21 de agosto de 1994"
19,5,14,287,185,179,364,"21 de agosto de 1994"
19,5,14,288,235,226,461,"21 de agosto de 1994"
19,5,14,289,182,146,328,"21 de agosto de 1994"
19,5,14,290,171,142,313,"21 de agosto de 1994"
19,5,14,291,263,230,493,"21 de agosto de 1994"
19,5,14,292,305,273,578,"21 de agosto de 1994"
19,5,14,293,103,77,180,"21 de agosto de 1994"
19,5,17,309,489,570,1059,"21 de agosto de 1994"
19,5,17,310,467,553,1020,"21 de agosto de 1994"
19,5,17,311,442,482,924,"21 de agosto de 1994"
19,5,17,312,455,434,889,"21 de agosto de 1994"
19,5,17,313,301,227,528,"21 de agosto de 1994"
19,5,17,314,89,90,179,"21 de agosto de 1994"
19,5,17,315,222,158,380,"21 de agosto de 1994"
19,5,17,316,442,293,735,"21 de agosto de 1994"
19,5,17,317,382,254,636,"21 de agosto de 1994"
19,5,17,318,272,277,549,"21 de agosto de 1994"
19,5,17,319,327,241,568,"21 de agosto de 1994"
19,5,17,320,424,363,787,"21 de agosto de 1994"
19,5,17,321,409,363,772,"21 de agosto de 1994"
19,5,17,322,379,373,752,"21 de agosto de 1994"
19,5,17,323,315,235,550,"21 de agosto de 1994"
19,5,17,324,119,102,221,"21 de agosto de 1994"
19,5,17,325,337,256,593,"21 de agosto de 1994"
19,5,17,326,520,435,955,"21 de agosto de 1994"
19,5,17,327,204,166,370,"21 de agosto de 1994"
19,5,17,328,468,419,887,"21 de agosto de 1994"
19,5,17,329,407,334,741,"21 de agosto de 1994"
19,5,17,330,99,68,167,"21 de agosto de 1994"
19,5,17,331,165,124,289,"21 de agosto de 1994"
19,5,17,332,258,185,443,"21 de agosto de 1994"
19,5,17,333,105,85,190,"21 de agosto de 1994"
19,5,17,334,285,230,515,"21 de agosto de 1994"
19,5,17,335,175,148,323,"21 de agosto de 1994"
19,5,17,336,210,196,406,"21 de agosto de 1994"
19,5,17,337,70,79,149,"21 de agosto de 1994"
19,5,17,338,115,102,217,"21 de agosto de 1994"
19,5,17,339,89,80,169,"21 de agosto de 1994"
19,5,17,340,349,298,647,"21 de agosto de 1994"
19,5,17,341,123,99,222,"21 de agosto de 1994"
19,5,17,342,405,368,773,"21 de agosto de 1994"
19,5,17,343,515,443,958,"21 de agosto de 1994"
19,5,17,344,93,86,179,"21 de agosto de 1994"
19,5,17,345,375,271,646,"21 de agosto de 1994"
19,5,22,494,525,616,1141,"21 de agosto de 1994"
19,5,22,495,512,550,1062,"21 de agosto de 1994"
19,5,22,496,431,451,882,"21 de agosto de 1994"
19,5,22,497,405,393,798,"21 de agosto de 1994"
19,5,22,498,69,70,139,"21 de agosto de 1994"
19,5,22,499,45,47,92,"21 de agosto de 1994"
19,5,22,500,23,10,33,"21 de agosto de 1994"
19,5,22,501,27,19,46,"21 de agosto de 1994"
19,5,22,502,308,300,608,"21 de agosto de 1994"
19,5,22,503,240,196,436,"21 de agosto de 1994"
19,5,22,504,135,126,261,"21 de agosto de 1994"
19,5,22,505,335,324,659,"21 de agosto de 1994"
19,5,22,506,203,188,391,"21 de agosto de 1994"
19,5,22,507,289,273,562,"21 de agosto de 1994"
19,5,22,508,337,321,658,"21 de agosto de 1994"
19,5,22,509,340,291,631,"21 de agosto de 1994"
19,5,22,510,42,35,77,"21 de agosto de 1994"
19,5,22,511,39,29,68,"21 de agosto de 1994"
19,5,22,512,38,30,68,"21 de agosto de 1994"
19,5,22,513,127,122,249,"21 de agosto de 1994"
19,5,22,514,220,202,422,"21 de agosto de 1994"
19,5,24,518,352,317,669,"21 de agosto de 1994"
19,5,24,519,497,420,917,"21 de agosto de 1994"
19,5,24,520,116,76,192,"21 de agosto de 1994"
19,5,24,521,127,83,210,"21 de agosto de 1994"
19,5,24,522,349,249,598,"21 de agosto de 1994"
19,5,30,822,283,297,580,"21 de agosto de 1994"
19,5,30,823,301,343,644,"21 de agosto de 1994"
19,5,30,824,247,262,509,"21 de agosto de 1994"
19,5,30,825,274,295,569,"21 de agosto de 1994"
19,5,30,826,388,416,804,"21 de agosto de 1994"
19,5,30,827,178,157,335,"21 de agosto de 1994"
19,5,30,828,99,80,179,"21 de agosto de 1994"
19,5,30,829,53,51,104,"21 de agosto de 1994"
19,5,30,830,44,39,83,"21 de agosto de 1994"
19,5,31,831,435,372,807,"21 de agosto de 1994"
19,5,31,832,295,306,601,"21 de agosto de 1994"
19,5,31,833,126,85,211,"21 de agosto de 1994"
19,5,31,834,196,159,355,"21 de agosto de 1994"
19,5,34,860,325,332,657,"21 de agosto de 1994"
19,5,34,861,412,421,833,"21 de agosto de 1994"
19,5,34,862,420,481,901,"21 de agosto de 1994"
19,5,34,863,719,755,1474,"21 de agosto de 1994"
19,5,34,864,635,742,1377,"21 de agosto de 1994"
19,5,34,865,755,840,1595,"21 de agosto de 1994"
19,5,34,866,720,782,1502,"21 de agosto de 1994"
19,5,34,867,500,559,1059,"21 de agosto de 1994"
19,5,34,868,325,358,683,"21 de agosto de 1994"
19,5,34,869,539,608,1147,"21 de agosto de 1994"
19,5,34,870,146,132,278,"21 de agosto de 1994"
19,5,34,871,616,726,1342,"21 de agosto de 1994"
19,5,34,872,527,583,1110,"21 de agosto de 1994"
19,5,34,873,543,679,1222,"21 de agosto de 1994"
19,5,34,874,263,284,547,"21 de agosto de 1994"
19,5,34,875,332,377,709,"21 de agosto de 1994"
19,5,34,876,566,644,1210,"21 de agosto de 1994"
19,5,34,877,247,280,527,"21 de agosto de 1994"
19,5,34,878,270,315,585,"21 de agosto de 1994"
19,5,34,879,538,582,1120,"21 de agosto de 1994"
19,5,34,880,405,448,853,"21 de agosto de 1994"
19,5,34,881,530,556,1086,"21 de agosto de 1994"
19,5,34,882,388,373,761,"21 de agosto de 1994"
19,5,34,883,371,389,760,"21 de agosto de 1994"
19,5,34,884,408,462,870,"21 de agosto de 1994"
19,5,34,885,378,394,772,"21 de agosto de 1994"
19,5,34,886,711,761,1472,"21 de agosto de 1994"
19,5,34,887,527,538,1065,"21 de agosto de 1994"
19,5,34,888,365,346,711,"21 de agosto de 1994"
19,5,34,889,327,297,624,"21 de agosto de 1994"
19,5,34,890,80,61,141,"21 de agosto de 1994"
19,5,34,891,115,80,195,"21 de agosto de 1994"
19,5,34,892,217,166,383,"21 de agosto de 1994"
19,5,34,893,160,120,280,"21 de agosto de 1994"
19,5,34,894,135,116,251,"21 de agosto de 1994"
19,5,34,895,265,228,493,"21 de agosto de 1994"
19,5,34,896,147,119,266,"21 de agosto de 1994"
19,5,34,897,540,459,999,"21 de agosto de 1994"
19,5,34,898,413,374,787,"21 de agosto de 1994"
19,5,34,899,193,155,348,"21 de agosto de 1994"
19,5,34,900,265,203,468,"21 de agosto de 1994"
19,5,34,901,222,186,408,"21 de agosto de 1994"
19,5,34,902,588,487,1075,"21 de agosto de 1994"
19,5,34,903,123,123,246,"21 de agosto de 1994"
19,5,34,904,201,173,374,"21 de agosto de 1994"
19,5,34,905,21,28,49,"21 de agosto de 1994"
19,5,34,906,207,153,360,"21 de agosto de 1994"
19,5,34,907,396,297,693,"21 de agosto de 1994"
19,5,37,913,278,276,554,"21 de agosto de 1994"
19,5,37,914,144,150,294,"21 de agosto de 1994"
19,5,37,915,238,228,466,"21 de agosto de 1994"
19,5,37,916,98,106,204,"21 de agosto de 1994"
19,5,37,917,234,212,446,"21 de agosto de 1994"
19,5,37,918,146,144,290,"21 de agosto de 1994"
19,5,37,919,285,253,538,"21 de agosto de 1994"
19,5,37,920,162,157,319,"21 de agosto de 1994"
19,5,37,921,39,50,89,"21 de agosto de 1994"
19,5,37,922,67,57,124,"21 de agosto de 1994"
19,5,37,923,29,26,55,"21 de agosto de 1994"
19,6,1,1,108,118,226,"21 de agosto de 1994"
19,6,1,2,368,370,738,"21 de agosto de 1994"
19,6,2,3,249,251,500,"21 de agosto de 1994"
19,6,2,4,127,133,260,"21 de agosto de 1994"
19,6,2,5,174,193,367,"21 de agosto de 1994"
19,6,2,6,203,203,406,"21 de agosto de 1994"
19,6,2,7,111,118,229,"21 de agosto de 1994"
19,6,2,8,152,147,299,"21 de agosto de 1994"
19,6,2,9,138,137,275,"21 de agosto de 1994"
19,6,2,10,133,131,264,"21 de agosto de 1994"
19,6,2,11,121,102,223,"21 de agosto de 1994"
19,6,3,12,149,177,326,"21 de agosto de 1994"
19,6,3,13,212,196,408,"21 de agosto de 1994"
19,6,3,14,38,23,61,"21 de agosto de 1994"
19,6,3,15,143,123,266,"21 de agosto de 1994"
19,6,3,16,179,157,336,"21 de agosto de 1994"
19,6,3,17,153,146,299,"21 de agosto de 1994"
19,6,3,18,33,19,52,"21 de agosto de 1994"
19,6,3,19,80,42,122,"21 de agosto de 1994"
19,6,5,39,321,353,674,"21 de agosto de 1994"
19,6,5,40,435,485,920,"21 de agosto de 1994"
19,6,5,41,405,422,827,"21 de agosto de 1994"
19,6,5,42,239,231,470,"21 de agosto de 1994"
19,6,5,43,377,416,793,"21 de agosto de 1994"
19,6,5,44,459,482,941,"21 de agosto de 1994"
19,6,5,45,359,365,724,"21 de agosto de 1994"
19,6,5,46,364,408,772,"21 de agosto de 1994"
19,6,5,47,340,342,682,"21 de agosto de 1994"
19,6,5,48,404,412,816,"21 de agosto de 1994"
19,6,5,49,209,222,431,"21 de agosto de 1994"
19,6,5,50,15,7,22,"21 de agosto de 1994"
19,6,5,51,48,36,84,"21 de agosto de 1994"
19,6,5,52,67,58,125,"21 de agosto de 1994"
19,6,5,53,6,0,6,"21 de agosto de 1994"
19,6,5,54,69,22,91,"21 de agosto de 1994"
19,6,5,55,129,98,227,"21 de agosto de 1994"
19,6,5,56,52,45,97,"21 de agosto de 1994"
19,6,5,57,80,51,131,"21 de agosto de 1994"
19,6,5,58,55,50,105,"21 de agosto de 1994"
19,6,5,59,55,44,99,"21 de agosto de 1994"
19,6,5,60,50,44,94,"21 de agosto de 1994"
19,6,5,61,240,177,417,"21 de agosto de 1994"
19,6,5,62,101,77,178,"21 de agosto de 1994"
19,6,6,63,2441,912,3353,"21 de agosto de 1994"
19,6,6,64,521,554,1075,"21 de agosto de 1994"
19,6,6,65,739,761,1500,"21 de agosto de 1994"
19,6,6,66,707,677,1384,"21 de agosto de 1994"
19,6,6,67,967,1024,1991,"21 de agosto de 1994"
19,6,6,68,810,845,1655,"21 de agosto de 1994"
19,6,6,69,714,760,1474,"21 de agosto de 1994"
19,6,6,70,547,594,1141,"21 de agosto de 1994"
19,6,6,71,236,259,495,"21 de agosto de 1994"
19,6,6,72,188,222,410,"21 de agosto de 1994"
19,6,6,73,275,293,568,"21 de agosto de 1994"
19,6,6,74,315,336,651,"21 de agosto de 1994"
19,6,6,75,267,272,539,"21 de agosto de 1994"
19,6,6,76,364,380,744,"21 de agosto de 1994"
19,6,6,77,491,511,1002,"21 de agosto de 1994"
19,6,6,78,502,534,1036,"21 de agosto de 1994"
19,6,6,79,530,523,1053,"21 de agosto de 1994"
19,6,6,80,285,309,594,"21 de agosto de 1994"
19,6,6,81,395,458,853,"21 de agosto de 1994"
19,6,6,82,326,343,669,"21 de agosto de 1994"
19,6,6,83,205,220,425,"21 de agosto de 1994"
19,6,6,84,931,959,1890,"21 de agosto de 1994"
19,6,6,85,560,560,1120,"21 de agosto de 1994"
19,6,6,86,420,468,888,"21 de agosto de 1994"
19,6,6,87,387,425,812,"21 de agosto de 1994"
19,6,6,88,320,308,628,"21 de agosto de 1994"
19,6,6,89,557,595,1152,"21 de agosto de 1994"
19,6,6,90,462,486,948,"21 de agosto de 1994"
19,6,6,91,445,443,888,"21 de agosto de 1994"
19,6,6,92,481,555,1036,"21 de agosto de 1994"
19,6,6,93,431,498,929,"21 de agosto de 1994"
19,6,6,94,650,688,1338,"21 de agosto de 1994"
19,6,6,95,466,498,964,"21 de agosto de 1994"
19,6,6,96,809,831,1640,"21 de agosto de 1994"
19,6,6,97,483,504,987,"21 de agosto de 1994"
19,6,6,98,742,751,1493,"21 de agosto de 1994"
19,6,6,99,504,556,1060,"21 de agosto de 1994"
19,6,6,100,613,652,1265,"21 de agosto de 1994"
19,6,6,101,578,583,1161,"21 de agosto de 1994"
19,6,6,102,782,759,1541,"21 de agosto de 1994"
19,6,6,103,772,770,1542,"21 de agosto de 1994"
19,6,6,104,217,233,450,"21 de agosto de 1994"
19,6,6,105,357,371,728,"21 de agosto de 1994"
19,6,6,106,478,493,971,"21 de agosto de 1994"
19,6,6,107,607,632,1239,"21 de agosto de 1994"
19,6,6,108,335,348,683,"21 de agosto de 1994"
19,6,6,109,726,708,1434,"21 de agosto de 1994"
19,6,6,110,234,221,455,"21 de agosto de 1994"
19,6,6,111,469,489,958,"21 de agosto de 1994"
19,6,6,112,558,559,1117,"21 de agosto de 1994"
19,6,6,113,365,351,716,"21 de agosto de 1994"
19,6,6,114,351,340,691,"21 de agosto de 1994"
19,6,6,115,690,722,1412,"21 de agosto de 1994"
19,6,6,116,524,540,1064,"21 de agosto de 1994"
19,6,6,117,536,559,1095,"21 de agosto de 1994"
19,6,6,118,449,489,938,"21 de agosto de 1994"
19,6,6,119,468,495,963,"21 de agosto de 1994"
19,6,6,120,604,628,1232,"21 de agosto de 1994"
19,6,6,121,585,655,1240,"21 de agosto de 1994"
19,6,6,122,525,504,1029,"21 de agosto de 1994"
19,6,6,123,438,469,907,"21 de agosto de 1994"
19,6,6,124,464,455,919,"21 de agosto de 1994"
19,6,6,125,497,537,1034,"21 de agosto de 1994"
19,6,6,126,290,327,617,"21 de agosto de 1994"
19,6,6,127,311,319,630,"21 de agosto de 1994"
19,6,6,128,315,329,644,"21 de agosto de 1994"
19,6,6,129,316,324,640,"21 de agosto de 1994"
19,6,6,130,553,564,1117,"21 de agosto de 1994"
19,6,6,131,461,497,958,"21 de agosto de 1994"
19,6,6,132,181,197,378,"21 de agosto de 1994"
19,6,6,133,382,377,759,"21 de agosto de 1994"
19,6,6,134,323,340,663,"21 de agosto de 1994"
19,6,6,135,532,599,1131,"21 de agosto de 1994"
19,6,6,136,560,576,1136,"21 de agosto de 1994"
19,6,6,137,526,555,1081,"21 de agosto de 1994"
19,6,6,138,526,582,1108,"21 de agosto de 1994"
19,6,6,139,531,570,1101,"21 de agosto de 1994"
19,6,6,140,331,351,682,"21 de agosto de 1994"
19,6,6,141,471,474,945,"21 de agosto de 1994"
19,6,6,142,309,298,607,"21 de agosto de 1994"
19,6,6,143,614,633,1247,"21 de agosto de 1994"
19,6,6,144,758,702,1460,"21 de agosto de 1994"
19,6,6,145,535,558,1093,"21 de agosto de 1994"
19,6,6,146,565,559,1124,"21 de agosto de 1994"
19,6,6,147,507,537,1044,"21 de agosto de 1994"
19,6,6,148,525,527,1052,"21 de agosto de 1994"
19,6,6,149,457,428,885,"21 de agosto de 1994"
19,6,6,150,208,199,407,"21 de agosto de 1994"
19,6,8,168,245,224,469,"21 de agosto de 1994"
19,6,8,169,285,283,568,"21 de agosto de 1994"
19,6,8,170,215,240,455,"21 de agosto de 1994"
19,6,8,171,238,242,480,"21 de agosto de 1994"
19,6,10,218,431,440,871,"21 de agosto de 1994"
19,6,10,219,622,617,1239,"21 de agosto de 1994"
19,6,10,220,407,398,805,"21 de agosto de 1994"
19,6,11,221,311,332,643,"21 de agosto de 1994"
19,6,11,222,288,295,583,"21 de agosto de 1994"
19,6,11,223,367,394,761,"21 de agosto de 1994"
19,6,11,224,292,361,653,"21 de agosto de 1994"
19,6,11,225,350,370,720,"21 de agosto de 1994"
19,6,11,226,263,305,568,"21 de agosto de 1994"
19,6,11,227,48,25,73,"21 de agosto de 1994"
19,6,11,228,77,68,145,"21 de agosto de 1994"
19,6,11,229,27,15,42,"21 de agosto de 1994"
19,6,11,230,72,64,136,"21 de agosto de 1994"
19,6,11,231,68,59,127,"21 de agosto de 1994"
19,6,12,232,668,637,1305,"21 de agosto de 1994"
19,6,12,233,568,606,1174,"21 de agosto de 1994"
19,6,12,234,408,428,836,"21 de agosto de 1994"
19,6,12,235,392,376,768,"21 de agosto de 1994"
19,6,12,236,59,42,101,"21 de agosto de 1994"
19,6,13,237,168,164,332,"21 de agosto de 1994"
19,6,13,238,366,332,698,"21 de agosto de 1994"
19,6,13,239,255,260,515,"21 de agosto de 1994"
19,6,13,240,311,315,626,"21 de agosto de 1994"
19,6,13,241,386,427,813,"21 de agosto de 1994"
19,6,13,242,328,340,668,"21 de agosto de 1994"
19,6,13,243,273,264,537,"21 de agosto de 1994"
19,6,13,244,262,235,497,"21 de agosto de 1994"
19,6,13,245,202,225,427,"21 de agosto de 1994"
19,6,13,246,15,16,31,"21 de agosto de 1994"
19,6,13,247,61,48,109,"21 de agosto de 1994"
19,6,13,248,46,42,88,"21 de agosto de 1994"
19,6,13,249,26,21,47,"21 de agosto de 1994"
19,6,13,250,6,2,8,"21 de agosto de 1994"
19,6,13,251,22,6,28,"21 de agosto de 1994"
19,6,13,252,80,58,138,"21 de agosto de 1994"
19,6,13,253,160,117,277,"21 de agosto de 1994"
19,6,13,254,10,6,16,"21 de agosto de 1994"
19,6,13,255,18,5,23,"21 de agosto de 1994"
19,6,13,256,335,289,624,"21 de agosto de 1994"
19,6,15,294,84,79,163,"21 de agosto de 1994"
19,6,15,295,344,297,641,"21 de agosto de 1994"
19,6,15,296,115,99,214,"21 de agosto de 1994"
19,6,15,297,61,51,112,"21 de agosto de 1994"
19,6,15,298,23,21,44,"21 de agosto de 1994"
19,6,15,299,57,48,105,"21 de agosto de 1994"
19,6,15,300,34,33,67,"21 de agosto de 1994"
19,6,15,301,30,26,56,"21 de agosto de 1994"
19,6,15,302,24,28,52,"21 de agosto de 1994"
19,6,15,303,100,94,194,"21 de agosto de 1994"
19,6,15,304,116,107,223,"21 de agosto de 1994"
19,6,16,305,264,250,514,"21 de agosto de 1994"
19,6,16,306,235,253,488,"21 de agosto de 1994"
19,6,16,307,181,171,352,"21 de agosto de 1994"
19,6,16,308,66,56,122,"21 de agosto de 1994"
19,6,20,418,277,254,531,"21 de agosto de 1994"
19,6,20,419,145,151,296,"21 de agosto de 1994"
19,6,20,420,249,229,478,"21 de agosto de 1994"
19,6,20,421,253,252,505,"21 de agosto de 1994"
19,6,20,422,329,314,643,"21 de agosto de 1994"
19,6,20,423,249,240,489,"21 de agosto de 1994"
19,6,20,424,79,46,125,"21 de agosto de 1994"
19,6,20,425,23,16,39,"21 de agosto de 1994"
19,6,20,426,72,54,126,"21 de agosto de 1994"
19,6,20,427,25,22,47,"21 de agosto de 1994"
19,6,20,428,23,16,39,"21 de agosto de 1994"
19,6,20,429,29,20,49,"21 de agosto de 1994"
19,6,21,430,370,391,761,"21 de agosto de 1994"
19,6,21,431,259,308,567,"21 de agosto de 1994"
19,6,21,432,525,563,1088,"21 de agosto de 1994"
19,6,21,433,726,783,1509,"21 de agosto de 1994"
19,6,21,434,545,598,1143,"21 de agosto de 1994"
19,6,21,435,459,474,933,"21 de agosto de 1994"
19,6,21,436,472,470,942,"21 de agosto de 1994"
19,6,21,437,474,488,962,"21 de agosto de 1994"
19,6,21,438,442,482,924,"21 de agosto de 1994"
19,6,21,439,267,263,530,"21 de agosto de 1994"
19,6,21,440,465,492,957,"21 de agosto de 1994"
19,6,21,441,355,312,667,"21 de agosto de 1994"
19,6,21,442,60,49,109,"21 de agosto de 1994"
19,6,21,443,293,297,590,"21 de agosto de 1994"
19,6,21,444,787,801,1588,"21 de agosto de 1994"
19,6,21,445,537,516,1053,"21 de agosto de 1994"
19,6,21,446,437,462,899,"21 de agosto de 1994"
19,6,21,447,414,456,870,"21 de agosto de 1994"
19,6,21,448,624,685,1309,"21 de agosto de 1994"
19,6,21,449,554,626,1180,"21 de agosto de 1994"
19,6,21,450,569,596,1165,"21 de agosto de 1994"
19,6,21,451,753,728,1481,"21 de agosto de 1994"
19,6,21,452,789,827,1616,"21 de agosto de 1994"
19,6,21,453,634,706,1340,"21 de agosto de 1994"
19,6,21,454,425,476,901,"21 de agosto de 1994"
19,6,21,455,443,483,926,"21 de agosto de 1994"
19,6,21,456,138,139,277,"21 de agosto de 1994"
19,6,21,457,939,969,1908,"21 de agosto de 1994"
19,6,21,458,745,784,1529,"21 de agosto de 1994"
19,6,21,459,558,600,1158,"21 de agosto de 1994"
19,6,21,460,220,241,461,"21 de agosto de 1994"
19,6,21,461,412,439,851,"21 de agosto de 1994"
19,6,21,462,496,533,1029,"21 de agosto de 1994"
19,6,21,463,661,681,1342,"21 de agosto de 1994"
19,6,21,464,369,397,766,"21 de agosto de 1994"
19,6,21,465,332,346,678,"21 de agosto de 1994"
19,6,21,466,529,570,1099,"21 de agosto de 1994"
19,6,21,467,603,624,1227,"21 de agosto de 1994"
19,6,21,468,257,272,529,"21 de agosto de 1994"
19,6,21,469,452,482,934,"21 de agosto de 1994"
19,6,21,470,683,752,1435,"21 de agosto de 1994"
19,6,21,471,454,463,917,"21 de agosto de 1994"
19,6,21,472,519,562,1081,"21 de agosto de 1994"
19,6,21,473,371,399,770,"21 de agosto de 1994"
19,6,21,474,575,623,1198,"21 de agosto de 1994"
19,6,21,475,313,321,634,"21 de agosto de 1994"
19,6,21,476,756,771,1527,"21 de agosto de 1994"
19,6,21,477,451,458,909,"21 de agosto de 1994"
19,6,21,478,278,303,581,"21 de agosto de 1994"
19,6,21,479,445,478,923,"21 de agosto de 1994"
19,6,21,480,859,901,1760,"21 de agosto de 1994"
19,6,21,481,201,222,423,"21 de agosto de 1994"
19,6,21,482,692,729,1421,"21 de agosto de 1994"
19,6,21,483,655,697,1352,"21 de agosto de 1994"
19,6,21,484,418,454,872,"21 de agosto de 1994"
19,6,21,485,360,382,742,"21 de agosto de 1994"
19,6,21,486,356,365,721,"21 de agosto de 1994"
19,6,21,487,418,454,872,"21 de agosto de 1994"
19,6,21,488,429,427,856,"21 de agosto de 1994"
19,6,21,489,617,661,1278,"21 de agosto de 1994"
19,6,21,490,837,869,1706,"21 de agosto de 1994"
19,6,21,491,654,680,1334,"21 de agosto de 1994"
19,6,21,492,757,844,1601,"21 de agosto de 1994"
19,6,21,493,314,326,640,"21 de agosto de 1994"
19,6,23,515,60,59,119,"21 de agosto de 1994"
19,6,23,516,252,262,514,"21 de agosto de 1994"
19,6,23,517,266,248,514,"21 de agosto de 1994"
19,6,25,523,420,431,851,"21 de agosto de 1994"
19,6,25,524,506,509,1015,"21 de agosto de 1994"
19,6,25,525,494,461,955,"21 de agosto de 1994"
19,6,27,805,133,136,269,"21 de agosto de 1994"
19,6,27,806,178,167,345,"21 de agosto de 1994"
19,6,27,807,206,215,421,"21 de agosto de 1994"
19,6,27,808,225,206,431,"21 de agosto de 1994"
19,6,27,809,132,103,235,"21 de agosto de 1994"
19,6,27,810,152,114,266,"21 de agosto de 1994"
19,6,28,811,395,439,834,"21 de agosto de 1994"
19,6,28,812,258,286,544,"21 de agosto de 1994"
19,6,28,813,294,349,643,"21 de agosto de 1994"
19,6,28,814,281,282,563,"21 de agosto de 1994"
19,6,28,815,315,317,632,"21 de agosto de 1994"
19,6,28,816,655,676,1331,"21 de agosto de 1994"
19,6,28,817,651,641,1292,"21 de agosto de 1994"
19,6,28,818,279,291,570,"21 de agosto de 1994"
19,6,28,819,258,279,537,"21 de agosto de 1994"
19,6,29,820,112,109,221,"21 de agosto de 1994"
19,6,29,821,231,251,482,"21 de agosto de 1994"
19,6,32,835,699,737,1436,"21 de agosto de 1994"
19,6,32,836,669,691,1360,"21 de agosto de 1994"
19,6,32,837,368,386,754,"21 de agosto de 1994"
19,6,32,838,636,623,1259,"21 de agosto de 1994"
19,6,32,839,428,452,880,"21 de agosto de 1994"
19,6,32,840,273,251,524,"21 de agosto de 1994"
19,6,32,841,824,836,1660,"21 de agosto de 1994"
19,6,32,842,477,511,988,"21 de agosto de 1994"
19,6,32,843,190,202,392,"21 de agosto de 1994"
19,6,32,844,336,333,669,"21 de agosto de 1994"
19,6,32,845,634,627,1261,"21 de agosto de 1994"
19,6,32,846,457,484,941,"21 de agosto de 1994"
19,6,32,847,402,451,853,"21 de agosto de 1994"
19,6,32,848,59,51,110,"21 de agosto de 1994"
19,6,32,849,243,246,489,"21 de agosto de 1994"
19,6,32,850,569,529,1098,"21 de agosto de 1994"
19,6,32,851,139,96,235,"21 de agosto de 1994"
19,6,32,852,56,50,106,"21 de agosto de 1994"
19,6,32,853,106,89,195,"21 de agosto de 1994"
19,6,33,854,202,219,421,"21 de agosto de 1994"
19,6,33,855,306,371,677,"21 de agosto de 1994"
19,6,33,856,344,364,708,"21 de agosto de 1994"
19,6,33,857,320,310,630,"21 de agosto de 1994"
19,6,33,858,115,104,219,"21 de agosto de 1994"
19,6,33,859,19,15,34,"21 de agosto de 1994"
19,6,35,908,244,226,470,"21 de agosto de 1994"
19,6,35,909,251,252,503,"21 de agosto de 1994"
19,6,35,910,502,498,1000,"21 de agosto de 1994"
19,6,36,911,212,177,389,"21 de agosto de 1994"
19,6,36,912,166,145,311,"21 de agosto de 1994"
19,6,38,924,537,499,1036,"21 de agosto de 1994"
19,6,38,925,332,313,645,"21 de agosto de 1994"
19,6,38,926,32,4,36,"21 de agosto de 1994"
19,6,38,927,80,54,134,"21 de agosto de 1994"
19,6,38,928,94,58,152,"21 de agosto de 1994"
19,6,38,929,22,19,41,"21 de agosto de 1994"
19,6,38,930,64,53,117,"21 de agosto de 1994"
19,6,41,1700,90,94,184,"21 de agosto de 1994"
19,6,41,1701,208,173,381,"21 de agosto de 1994"
19,6,41,1702,150,93,243,"21 de agosto de 1994"
19,6,42,1703,344,311,655,"21 de agosto de 1994"
19,6,42,1704,339,315,654,"21 de agosto de 1994"
19,6,42,1705,515,519,1034,"21 de agosto de 1994"
19,6,42,1706,281,281,562,"21 de agosto de 1994"
19,6,42,1707,374,327,701,"21 de agosto de 1994"
19,6,42,1708,169,136,305,"21 de agosto de 1994"
19,6,42,1709,142,87,229,"21 de agosto de 1994"
19,6,42,1710,304,261,565,"21 de agosto de 1994"
19,6,42,1711,153,137,290,"21 de agosto de 1994"
19,6,43,1712,276,281,557,"21 de agosto de 1994"
19,6,43,1713,199,185,384,"21 de agosto de 1994"
19,6,43,1714,136,118,254,"21 de agosto de 1994"
19,6,43,1715,129,109,238,"21 de agosto de 1994"
19,6,43,1716,107,86,193,"21 de agosto de 1994"
19,6,43,1717,108,108,216,"21 de agosto de 1994"
19,6,43,1718,93,80,173,"21 de agosto de 1994"
19,6,43,1719,92,82,174,"21 de agosto de 1994"
19,6,43,1720,324,299,623,"21 de agosto de 1994"
19,6,43,1721,199,176,375,"21 de agosto de 1994"
19,6,43,1722,86,74,160,"21 de agosto de 1994"
19,6,43,1723,122,96,218,"21 de agosto de 1994"
19,6,45,1729,733,668,1401,"21 de agosto de 1994"
19,6,45,1730,440,510,950,"21 de agosto de 1994"
19,6,45,1731,442,473,915,"21 de agosto de 1994"
19,6,45,1732,637,682,1319,"21 de agosto de 1994"
19,6,45,1733,543,561,1104,"21 de agosto de 1994"
19,6,45,1734,439,457,896,"21 de agosto de 1994"
19,6,45,1735,341,317,658,"21 de agosto de 1994"
19,6,45,1736,348,371,719,"21 de agosto de 1994"
19,6,45,1737,527,522,1049,"21 de agosto de 1994"
19,6,45,1738,904,965,1869,"21 de agosto de 1994"
19,6,45,1739,523,544,1067,"21 de agosto de 1994"
19,6,45,1740,336,356,692,"21 de agosto de 1994"
19,6,45,1741,165,155,320,"21 de agosto de 1994"
19,6,45,1742,372,426,798,"21 de agosto de 1994"
19,6,45,1743,549,580,1129,"21 de agosto de 1994"
19,6,45,1744,342,374,716,"21 de agosto de 1994"
19,6,45,1745,413,393,806,"21 de agosto de 1994"
19,6,45,1746,360,345,705,"21 de agosto de 1994"
19,6,45,1747,27,17,44,"21 de agosto de 1994"
19,6,45,1748,24,19,43,"21 de agosto de 1994"
19,6,45,1749,234,208,442,"21 de agosto de 1994"
19,6,45,1750,38,34,72,"21 de agosto de 1994"
19,6,45,1751,153,144,297,"21 de agosto de 1994"
19,6,46,1752,379,347,726,"21 de agosto de 1994"
19,6,46,1753,392,383,775,"21 de agosto de 1994"
19,6,46,1754,479,568,1047,"21 de agosto de 1994"
19,6,46,1755,428,394,822,"21 de agosto de 1994"
19,6,46,1756,105,84,189,"21 de agosto de 1994"
19,6,46,1757,45,36,81,"21 de agosto de 1994"
19,6,46,1758,312,249,561,"21 de agosto de 1994"
19,6,46,1759,285,276,561,"21 de agosto de 1994"
19,6,46,1760,815,811,1626,"21 de agosto de 1994"
19,6,50,2111,80,85,165,"21 de agosto de 1994"
19,6,50,2112,55,56,111,"21 de agosto de 1994"
19,6,50,2113,52,47,99,"21 de agosto de 1994"
19,6,50,2114,71,58,129,"21 de agosto de 1994"
19,6,50,2115,163,165,328,"21 de agosto de 1994"
19,6,50,2116,131,113,244,"21 de agosto de 1994"
19,6,50,2117,206,180,386,"21 de agosto de 1994"
19,6,51,2118,611,606,1217,"21 de agosto de 1994"
19,6,51,2119,109,134,243,"21 de agosto de 1994"
19,6,51,2120,174,162,336,"21 de agosto de 1994"
19,6,51,2121,114,115,229,"21 de agosto de 1994"
19,6,51,2122,60,55,115,"21 de agosto de 1994"
19,6,51,2123,282,274,556,"21 de agosto de 1994"
19,7,18,346,572,533,1105,"21 de agosto de 1994"
19,7,18,347,771,708,1479,"21 de agosto de 1994"
19,7,18,348,593,521,1114,"21 de agosto de 1994"
19,7,18,349,630,596,1226,"21 de agosto de 1994"
19,7,18,350,674,620,1294,"21 de agosto de 1994"
19,7,18,351,604,539,1143,"21 de agosto de 1994"
19,7,18,352,82,59,141,"21 de agosto de 1994"
19,7,18,353,281,131,412,"21 de agosto de 1994"
19,7,18,354,111,85,196,"21 de agosto de 1994"
19,7,18,355,381,322,703,"21 de agosto de 1994"
19,7,19,356,448,465,913,"21 de agosto de 1994"
19,7,19,357,540,570,1110,"21 de agosto de 1994"
19,7,19,358,456,436,892,"21 de agosto de 1994"
19,7,19,359,549,605,1154,"21 de agosto de 1994"
19,7,19,360,666,668,1334,"21 de agosto de 1994"
19,7,19,361,547,576,1123,"21 de agosto de 1994"
19,7,19,362,492,519,1011,"21 de agosto de 1994"
19,7,19,363,523,549,1072,"21 de agosto de 1994"
19,7,19,364,498,553,1051,"21 de agosto de 1994"
19,7,19,365,573,594,1167,"21 de agosto de 1994"
19,7,19,366,771,773,1544,"21 de agosto de 1994"
19,7,19,367,613,688,1301,"21 de agosto de 1994"
19,7,19,368,463,515,978,"21 de agosto de 1994"
19,7,19,369,332,303,635,"21 de agosto de 1994"
19,7,19,370,546,389,935,"21 de agosto de 1994"
19,7,19,371,628,680,1308,"21 de agosto de 1994"
19,7,19,372,447,512,959,"21 de agosto de 1994"
19,7,19,373,615,698,1313,"21 de agosto de 1994"
19,7,19,374,760,803,1563,"21 de agosto de 1994"
19,7,19,375,610,667,1277,"21 de agosto de 1994"
19,7,19,376,459,465,924,"21 de agosto de 1994"
19,7,19,377,567,593,1160,"21 de agosto de 1994"
19,7,19,378,601,679,1280,"21 de agosto de 1994"
19,7,19,379,416,449,865,"21 de agosto de 1994"
19,7,19,380,745,784,1529,"21 de agosto de 1994"
19,7,19,381,362,331,693,"21 de agosto de 1994"
19,7,19,382,500,583,1083,"21 de agosto de 1994"
19,7,19,383,449,473,922,"21 de agosto de 1994"
19,7,19,384,510,579,1089,"21 de agosto de 1994"
19,7,19,385,618,694,1312,"21 de agosto de 1994"
19,7,19,386,540,594,1134,"21 de agosto de 1994"
19,7,19,387,481,619,1100,"21 de agosto de 1994"
19,7,19,388,680,699,1379,"21 de agosto de 1994"
19,7,19,389,700,757,1457,"21 de agosto de 1994"
19,7,19,390,638,730,1368,"21 de agosto de 1994"
19,7,19,391,542,624,1166,"21 de agosto de 1994"
19,7,19,392,605,720,1325,"21 de agosto de 1994"
19,7,19,393,534,586,1120,"21 de agosto de 1994"
19,7,19,394,423,505,928,"21 de agosto de 1994"
19,7,19,395,387,426,813,"21 de agosto de 1994"
19,7,19,396,453,528,981,"21 de agosto de 1994"
19,7,19,397,605,739,1344,"21 de agosto de 1994"
19,7,19,398,507,599,1106,"21 de agosto de 1994"
19,7,19,399,489,565,1054,"21 de agosto de 1994"
19,7,19,400,461,515,976,"21 de agosto de 1994"
19,7,19,401,605,633,1238,"21 de agosto de 1994"
19,7,19,402,671,724,1395,"21 de agosto de 1994"
19,7,19,403,600,604,1204,"21 de agosto de 1994"
19,7,19,404,549,637,1186,"21 de agosto de 1994"
19,7,19,405,443,561,1004,"21 de agosto de 1994"
19,7,19,406,603,656,1259,"21 de agosto de 1994"
19,7,19,407,517,547,1064,"21 de agosto de 1994"
19,7,19,408,468,593,1061,"21 de agosto de 1994"
19,7,19,409,619,781,1400,"21 de agosto de 1994"
19,7,19,410,554,619,1173,"21 de agosto de 1994"
19,7,19,411,676,699,1375,"21 de agosto de 1994"
19,7,19,412,529,606,1135,"21 de agosto de 1994"
19,7,19,413,675,703,1378,"21 de agosto de 1994"
19,7,19,414,478,470,948,"21 de agosto de 1994"
19,7,19,415,396,404,800,"21 de agosto de 1994"
19,7,19,416,502,538,1040,"21 de agosto de 1994"
19,7,19,417,257,273,530,"21 de agosto de 1994"
19,7,40,1432,588,657,1245,"21 de agosto de 1994"
19,7,40,1433,592,657,1249,"21 de agosto de 1994"
19,7,40,1434,679,683,1362,"21 de agosto de 1994"
19,7,40,1435,781,808,1589,"21 de agosto de 1994"
19,7,40,1436,563,579,1142,"21 de agosto de 1994"
19,7,40,1437,588,616,1204,"21 de agosto de 1994"
19,7,40,1438,639,662,1301,"21 de agosto de 1994"
19,7,40,1439,489,528,1017,"21 de agosto de 1994"
19,7,40,1440,633,652,1285,"21 de agosto de 1994"
19,7,40,1441,635,669,1304,"21 de agosto de 1994"
19,7,40,1442,752,776,1528,"21 de agosto de 1994"
19,7,40,1443,500,552,1052,"21 de agosto de 1994"
19,7,40,1444,422,446,868,"21 de agosto de 1994"
19,7,40,1445,366,406,772,"21 de agosto de 1994"
19,7,40,1446,702,744,1446,"21 de agosto de 1994"
19,7,40,1447,509,529,1038,"21 de agosto de 1994"
19,7,40,1448,516,601,1117,"21 de agosto de 1994"
19,7,40,1449,439,501,940,"21 de agosto de 1994"
19,7,40,1450,541,600,1141,"21 de agosto de 1994"
19,7,40,1451,559,641,1200,"21 de agosto de 1994"
19,7,40,1452,519,577,1096,"21 de agosto de 1994"
19,7,40,1453,423,451,874,"21 de agosto de 1994"
19,7,40,1454,549,561,1110,"21 de agosto de 1994"
19,7,40,1455,487,518,1005,"21 de agosto de 1994"
19,7,40,1456,521,509,1030,"21 de agosto de 1994"
19,7,40,1457,490,577,1067,"21 de agosto de 1994"
19,7,40,1458,513,600,1113,"21 de agosto de 1994"
19,7,40,1459,520,550,1070,"21 de agosto de 1994"
19,7,40,1460,475,527,1002,"21 de agosto de 1994"
19,7,40,1461,481,523,1004,"21 de agosto de 1994"
19,7,40,1462,461,557,1018,"21 de agosto de 1994"
19,7,40,1463,501,545,1046,"21 de agosto de 1994"
19,7,40,1464,429,457,886,"21 de agosto de 1994"
19,7,40,1465,521,567,1088,"21 de agosto de 1994"
19,7,40,1466,497,539,1036,"21 de agosto de 1994"
19,7,40,1467,456,488,944,"21 de agosto de 1994"
19,7,40,1468,482,518,1000,"21 de agosto de 1994"
19,7,40,1469,440,496,936,"21 de agosto de 1994"
19,7,40,1470,580,584,1164,"21 de agosto de 1994"
19,7,40,1471,613,667,1280,"21 de agosto de 1994"
19,7,40,1472,838,867,1705,"21 de agosto de 1994"
19,7,40,1473,520,566,1086,"21 de agosto de 1994"
19,7,40,1474,516,533,1049,"21 de agosto de 1994"
19,7,40,1475,666,717,1383,"21 de agosto de 1994"
19,7,40,1476,499,548,1047,"21 de agosto de 1994"
19,7,40,1477,809,805,1614,"21 de agosto de 1994"
19,7,40,1478,703,726,1429,"21 de agosto de 1994"
19,7,40,1479,696,722,1418,"21 de agosto de 1994"
19,7,40,1480,570,614,1184,"21 de agosto de 1994"
19,7,40,1481,800,816,1616,"21 de agosto de 1994"
19,7,40,1482,669,708,1377,"21 de agosto de 1994"
19,7,40,1483,658,684,1342,"21 de agosto de 1994"
19,7,40,1484,654,670,1324,"21 de agosto de 1994"
19,7,40,1485,458,488,946,"21 de agosto de 1994"
19,7,40,1486,596,662,1258,"21 de agosto de 1994"
19,7,40,1487,375,432,807,"21 de agosto de 1994"
19,7,40,1488,464,487,951,"21 de agosto de 1994"
19,7,40,1489,636,668,1304,"21 de agosto de 1994"
19,7,40,1490,560,613,1173,"21 de agosto de 1994"
19,7,40,1491,700,712,1412,"21 de agosto de 1994"
19,7,40,1492,846,888,1734,"21 de agosto de 1994"
19,7,40,1493,525,565,1090,"21 de agosto de 1994"
19,7,40,1494,517,559,1076,"21 de agosto de 1994"
19,7,40,1495,531,551,1082,"21 de agosto de 1994"
19,7,40,1496,714,707,1421,"21 de agosto de 1994"
19,7,40,1497,791,818,1609,"21 de agosto de 1994"
19,7,40,1498,667,694,1361,"21 de agosto de 1994"
19,7,40,1499,860,842,1702,"21 de agosto de 1994"
19,7,40,1500,743,794,1537,"21 de agosto de 1994"
19,7,40,1501,763,787,1550,"21 de agosto de 1994"
19,7,40,1502,705,691,1396,"21 de agosto de 1994"
19,7,40,1503,469,534,1003,"21 de agosto de 1994"
19,7,40,1504,520,543,1063,"21 de agosto de 1994"
19,7,40,1505,637,720,1357,"21 de agosto de 1994"
19,7,40,1506,555,634,1189,"21 de agosto de 1994"
19,7,40,1507,597,670,1267,"21 de agosto de 1994"
19,7,40,1508,635,679,1314,"21 de agosto de 1994"
19,7,40,1509,785,804,1589,"21 de agosto de 1994"
19,7,40,1510,857,867,1724,"21 de agosto de 1994"
19,7,40,1511,680,736,1416,"21 de agosto de 1994"
19,7,40,1512,820,883,1703,"21 de agosto de 1994"
19,7,40,1513,436,488,924,"21 de agosto de 1994"
19,7,40,1514,757,728,1485,"21 de agosto de 1994"
19,7,40,1515,645,689,1334,"21 de agosto de 1994"
19,7,40,1516,759,799,1558,"21 de agosto de 1994"
19,7,40,1517,705,734,1439,"21 de agosto de 1994"
19,7,40,1518,722,720,1442,"21 de agosto de 1994"
19,7,40,1519,785,844,1629,"21 de agosto de 1994"
19,7,40,1520,427,483,910,"21 de agosto de 1994"
19,7,40,1521,561,627,1188,"21 de agosto de 1994"
19,7,40,1522,562,605,1167,"21 de agosto de 1994"
19,7,40,1523,753,748,1501,"21 de agosto de 1994"
19,7,40,1524,749,756,1505,"21 de agosto de 1994"
19,7,40,1525,769,776,1545,"21 de agosto de 1994"
19,7,40,1526,689,739,1428,"21 de agosto de 1994"
19,7,40,1527,602,666,1268,"21 de agosto de 1994"
19,7,40,1528,841,846,1687,"21 de agosto de 1994"
19,7,40,1529,865,908,1773,"21 de agosto de 1994"
19,7,40,1530,816,829,1645,"21 de agosto de 1994"
19,7,40,1531,885,929,1814,"21 de agosto de 1994"
19,7,40,1532,567,575,1142,"21 de agosto de 1994"
19,7,40,1533,592,658,1250,"21 de agosto de 1994"
19,7,40,1534,580,590,1170,"21 de agosto de 1994"
19,7,40,1535,666,741,1407,"21 de agosto de 1994"
19,7,40,1536,884,877,1761,"21 de agosto de 1994"
19,7,40,1537,778,819,1597,"21 de agosto de 1994"
19,7,40,1538,778,786,1564,"21 de agosto de 1994"
19,7,40,1539,759,766,1525,"21 de agosto de 1994"
19,7,40,1540,731,782,1513,"21 de agosto de 1994"
19,7,40,1541,798,819,1617,"21 de agosto de 1994"
19,7,40,1542,584,586,1170,"21 de agosto de 1994"
19,7,40,1543,654,682,1336,"21 de agosto de 1994"
19,7,40,1544,740,731,1471,"21 de agosto de 1994"
19,7,40,1545,819,879,1698,"21 de agosto de 1994"
19,7,40,1546,752,773,1525,"21 de agosto de 1994"
19,7,40,1547,661,686,1347,"21 de agosto de 1994"
19,7,40,1548,671,647,1318,"21 de agosto de 1994"
19,7,40,1549,297,319,616,"21 de agosto de 1994"
19,7,40,1550,363,388,751,"21 de agosto de 1994"
19,7,40,1551,693,731,1424,"21 de agosto de 1994"
19,7,40,1552,874,897,1771,"21 de agosto de 1994"
19,7,40,1553,611,644,1255,"21 de agosto de 1994"
19,7,40,1554,515,579,1094,"21 de agosto de 1994"
19,7,40,1555,662,703,1365,"21 de agosto de 1994"
19,7,40,1556,582,589,1171,"21 de agosto de 1994"
19,7,40,1557,353,384,737,"21 de agosto de 1994"
19,7,40,1558,361,391,752,"21 de agosto de 1994"
19,7,40,1559,804,807,1611,"21 de agosto de 1994"
19,7,40,1560,768,851,1619,"21 de agosto de 1994"
19,7,40,1561,543,571,1114,"21 de agosto de 1994"
19,7,40,1562,651,693,1344,"21 de agosto de 1994"
19,7,40,1563,576,604,1180,"21 de agosto de 1994"
19,7,40,1564,828,864,1692,"21 de agosto de 1994"
19,7,40,1565,712,740,1452,"21 de agosto de 1994"
19,7,40,1566,531,562,1093,"21 de agosto de 1994"
19,7,40,1567,741,785,1526,"21 de agosto de 1994"
19,7,40,1568,719,797,1516,"21 de agosto de 1994"
19,7,40,1569,708,714,1422,"21 de agosto de 1994"
19,7,40,1570,364,414,778,"21 de agosto de 1994"
19,7,40,1571,619,694,1313,"21 de agosto de 1994"
19,7,40,1572,534,605,1139,"21 de agosto de 1994"
19,7,40,1573,600,661,1261,"21 de agosto de 1994"
19,7,40,1574,423,484,907,"21 de agosto de 1994"
19,7,40,1575,283,321,604,"21 de agosto de 1994"
19,7,40,1576,591,672,1263,"21 de agosto de 1994"
19,7,40,1577,298,312,610,"21 de agosto de 1994"
19,7,40,1578,322,348,670,"21 de agosto de 1994"
19,7,40,1579,556,611,1167,"21 de agosto de 1994"
19,7,40,1580,517,622,1139,"21 de agosto de 1994"
19,7,40,1581,637,721,1358,"21 de agosto de 1994"
19,7,40,1582,606,631,1237,"21 de agosto de 1994"
19,7,40,1583,536,662,1198,"21 de agosto de 1994"
19,7,40,1584,806,826,1632,"21 de agosto de 1994"
19,7,40,1585,591,654,1245,"21 de agosto de 1994"
19,7,40,1586,631,696,1327,"21 de agosto de 1994"
19,7,40,1587,576,632,1208,"21 de agosto de 1994"
19,7,40,1588,735,713,1448,"21 de agosto de 1994"
19,7,40,1589,637,672,1309,"21 de agosto de 1994"
19,7,40,1590,749,786,1535,"21 de agosto de 1994"
19,7,40,1591,771,837,1608,"21 de agosto de 1994"
19,7,40,1592,651,669,1320,"21 de agosto de 1994"
19,7,40,1593,621,683,1304,"21 de agosto de 1994"
19,7,40,1594,797,842,1639,"21 de agosto de 1994"
19,7,40,1595,786,834,1620,"21 de agosto de 1994"
19,7,40,1596,652,688,1340,"21 de agosto de 1994"
19,7,40,1597,657,710,1367,"21 de agosto de 1994"
19,7,40,1598,594,661,1255,"21 de agosto de 1994"
19,7,40,1599,704,781,1485,"21 de agosto de 1994"
19,7,40,1600,700,813,1513,"21 de agosto de 1994"
19,7,40,1601,668,689,1357,"21 de agosto de 1994"
19,7,40,1602,665,743,1408,"21 de agosto de 1994"
19,7,40,1603,876,866,1742,"21 de agosto de 1994"
19,7,40,1604,664,744,1408,"21 de agosto de 1994"
19,7,40,1605,572,624,1196,"21 de agosto de 1994"
19,7,40,1606,232,212,444,"21 de agosto de 1994"
19,7,40,1607,611,662,1273,"21 de agosto de 1994"
19,7,40,1608,599,695,1294,"21 de agosto de 1994"
19,7,40,1609,562,638,1200,"21 de agosto de 1994"
19,7,40,1610,526,554,1080,"21 de agosto de 1994"
19,7,40,1611,351,426,777,"21 de agosto de 1994"
19,8,40,1612,645,660,1305,"21 de agosto de 1994"
19,8,40,1613,778,862,1640,"21 de agosto de 1994"
19,8,40,1614,381,366,747,"21 de agosto de 1994"
19,8,40,1615,630,678,1308,"21 de agosto de 1994"
19,8,40,1616,653,668,1321,"21 de agosto de 1994"
19,8,40,1617,689,767,1456,"21 de agosto de 1994"
19,8,40,1618,849,827,1676,"21 de agosto de 1994"
19,8,40,1619,799,819,1618,"21 de agosto de 1994"
19,8,40,1620,732,789,1521,"21 de agosto de 1994"
19,8,40,1621,362,384,746,"21 de agosto de 1994"
19,8,40,1622,758,836,1594,"21 de agosto de 1994"
19,8,40,1623,680,733,1413,"21 de agosto de 1994"
19,8,40,1624,739,729,1468,"21 de agosto de 1994"
19,8,40,1625,663,714,1377,"21 de agosto de 1994"
19,8,40,1626,762,786,1548,"21 de agosto de 1994"
19,8,40,1627,659,652,1311,"21 de agosto de 1994"
19,8,40,1628,653,610,1263,"21 de agosto de 1994"
19,8,40,1629,54,49,103,"21 de agosto de 1994"
19,8,40,1630,509,518,1027,"21 de agosto de 1994"
19,8,40,1631,187,201,388,"21 de agosto de 1994"
19,8,40,1632,337,332,669,"21 de agosto de 1994"
19,8,40,1633,510,522,1032,"21 de agosto de 1994"
19,8,40,1634,114,142,256,"21 de agosto de 1994"
19,8,40,1635,420,479,899,"21 de agosto de 1994"
19,8,40,1636,451,466,917,"21 de agosto de 1994"
19,8,40,1637,460,487,947,"21 de agosto de 1994"
19,8,40,1638,471,517,988,"21 de agosto de 1994"
19,8,40,1639,257,211,468,"21 de agosto de 1994"
19,8,40,1640,139,62,201,"21 de agosto de 1994"
19,8,40,1641,75,72,147,"21 de agosto de 1994"
19,8,40,1642,603,630,1233,"21 de agosto de 1994"
19,8,40,1643,358,363,721,"21 de agosto de 1994"
19,8,40,1644,222,258,480,"21 de agosto de 1994"
19,8,40,1645,248,282,530,"21 de agosto de 1994"
19,8,40,1646,199,190,389,"21 de agosto de 1994"
19,8,40,1647,221,225,446,"21 de agosto de 1994"
19,8,40,1648,371,370,741,"21 de agosto de 1994"
19,8,40,1649,380,357,737,"21 de agosto de 1994"
19,8,40,1650,127,130,257,"21 de agosto de 1994"
19,8,40,1651,375,410,785,"21 de agosto de 1994"
19,8,40,1652,334,410,744,"21 de agosto de 1994"
19,8,40,1653,466,518,984,"21 de agosto de 1994"
19,8,40,1654,345,364,709,"21 de agosto de 1994"
19,8,40,1655,403,429,832,"21 de agosto de 1994"
19,8,40,1656,435,476,911,"21 de agosto de 1994"
19,8,40,1657,580,678,1258,"21 de agosto de 1994"
19,8,40,1658,583,621,1204,"21 de agosto de 1994"
19,8,40,1659,689,689,1378,"21 de agosto de 1994"
19,8,40,1660,438,433,871,"21 de agosto de 1994"
19,8,40,1661,416,385,801,"21 de agosto de 1994"
19,8,40,1662,387,397,784,"21 de agosto de 1994"
19,8,40,1663,381,402,783,"21 de agosto de 1994"
19,8,40,1664,365,343,708,"21 de agosto de 1994"
19,8,40,1665,262,250,512,"21 de agosto de 1994"
19,8,40,1666,245,242,487,"21 de agosto de 1994"
19,8,40,1667,432,391,823,"21 de agosto de 1994"
19,8,40,1668,291,298,589,"21 de agosto de 1994"
19,8,40,1669,215,232,447,"21 de agosto de 1994"
19,8,40,1670,368,421,789,"21 de agosto de 1994"
19,8,40,1671,426,432,858,"21 de agosto de 1994"
19,8,40,1672,373,385,758,"21 de agosto de 1994"
19,8,40,1673,632,648,1280,"21 de agosto de 1994"
19,8,40,1674,475,484,959,"21 de agosto de 1994"
19,8,40,1675,524,562,1086,"21 de agosto de 1994"
19,8,40,1676,539,552,1091,"21 de agosto de 1994"
19,8,40,1677,194,228,422,"21 de agosto de 1994"
19,8,40,1678,336,341,677,"21 de agosto de 1994"
19,8,40,1679,524,530,1054,"21 de agosto de 1994"
19,8,40,1680,588,627,1215,"21 de agosto de 1994"
19,8,40,1681,473,547,1020,"21 de agosto de 1994"
19,8,40,1682,644,734,1378,"21 de agosto de 1994"
19,8,40,1683,232,259,491,"21 de agosto de 1994"
19,8,40,1684,394,406,800,"21 de agosto de 1994"
19,8,40,1685,577,644,1221,"21 de agosto de 1994"
19,8,40,1686,766,839,1605,"21 de agosto de 1994"
19,8,40,1687,371,452,823,"21 de agosto de 1994"
19,8,40,1688,247,266,513,"21 de agosto de 1994"
19,8,40,1689,280,268,548,"21 de agosto de 1994"
19,8,40,1690,402,430,832,"21 de agosto de 1994"
19,8,40,1691,525,553,1078,"21 de agosto de 1994"
19,8,40,1692,302,327,629,"21 de agosto de 1994"
19,8,40,1693,204,231,435,"21 de agosto de 1994"
19,8,40,1694,367,396,763,"21 de agosto de 1994"
19,8,40,1695,303,341,644,"21 de agosto de 1994"
19,8,40,1696,210,208,418,"21 de agosto de 1994"
19,8,40,1697,502,588,1090,"21 de agosto de 1994"
19,8,40,1698,267,303,570,"21 de agosto de 1994"
19,8,40,1699,94,123,217,"21 de agosto de 1994"
19,9,26,604,590,610,1200,"21 de agosto de 1994"
19,9,26,605,425,458,883,"21 de agosto de 1994"
19,9,26,606,498,536,1034,"21 de agosto de 1994"
19,9,26,607,1189,1320,2509,"21 de agosto de 1994"
19,9,26,608,628,683,1311,"21 de agosto de 1994"
19,9,26,609,602,612,1214,"21 de agosto de 1994"
19,9,26,610,648,714,1362,"21 de agosto de 1994"
19,9,26,611,672,735,1407,"21 de agosto de 1994"
19,9,26,612,595,635,1230,"21 de agosto de 1994"
19,9,26,613,604,615,1219,"21 de agosto de 1994"
19,9,26,614,573,632,1205,"21 de agosto de 1994"
19,9,26,615,623,632,1255,"21 de agosto de 1994"
19,9,26,616,221,263,484,"21 de agosto de 1994"
19,9,26,617,377,404,781,"21 de agosto de 1994"
19,9,26,618,401,461,862,"21 de agosto de 1994"
19,9,26,619,416,421,837,"21 de agosto de 1994"
19,9,26,620,380,351,731,"21 de agosto de 1994"
19,9,26,621,841,841,1682,"21 de agosto de 1994"
19,9,26,622,483,491,974,"21 de agosto de 1994"
19,9,26,623,970,1000,1970,"21 de agosto de 1994"
19,9,26,624,722,752,1474,"21 de agosto de 1994"
19,9,26,625,789,865,1654,"21 de agosto de 1994"
19,9,26,626,620,683,1303,"21 de agosto de 1994"
19,9,26,627,576,613,1189,"21 de agosto de 1994"
19,9,26,628,415,464,879,"21 de agosto de 1994"
19,9,26,629,611,668,1279,"21 de agosto de 1994"
19,9,26,630,674,737,1411,"21 de agosto de 1994"
19,9,26,631,481,430,911,"21 de agosto de 1994"
19,9,26,632,570,565,1135,"21 de agosto de 1994"
19,9,26,633,440,455,895,"21 de agosto de 1994"
19,9,26,634,491,540,1031,"21 de agosto de 1994"
19,9,26,635,676,697,1373,"21 de agosto de 1994"
19,9,26,636,699,668,1367,"21 de agosto de 1994"
19,9,26,637,422,460,882,"21 de agosto de 1994"
19,9,26,638,429,499,928,"21 de agosto de 1994"
19,9,26,639,442,507,949,"21 de agosto de 1994"
19,9,26,640,572,704,1276,"21 de agosto de 1994"
19,9,26,641,768,769,1537,"21 de agosto de 1994"
19,9,26,642,910,915,1825,"21 de agosto de 1994"
19,9,26,643,891,887,1778,"21 de agosto de 1994"
19,9,26,644,521,562,1083,"21 de agosto de 1994"
19,9,26,645,577,577,1154,"21 de agosto de 1994"
19,9,26,646,475,563,1038,"21 de agosto de 1994"
19,9,26,647,534,590,1124,"21 de agosto de 1994"
19,9,26,648,670,661,1331,"21 de agosto de 1994"
19,9,26,649,570,583,1153,"21 de agosto de 1994"
19,9,26,650,626,662,1288,"21 de agosto de 1994"
19,9,26,651,509,526,1035,"21 de agosto de 1994"
19,9,26,652,478,529,1007,"21 de agosto de 1994"
19,9,26,653,655,669,1324,"21 de agosto de 1994"
19,9,26,654,645,738,1383,"21 de agosto de 1994"
19,9,26,655,515,577,1092,"21 de agosto de 1994"
19,9,26,656,450,543,993,"21 de agosto de 1994"
19,9,26,657,290,309,599,"21 de agosto de 1994"
19,9,26,658,280,349,629,"21 de agosto de 1994"
19,9,26,659,366,382,748,"21 de agosto de 1994"
19,9,26,660,368,480,848,"21 de agosto de 1994"
19,9,26,661,491,560,1051,"21 de agosto de 1994"
19,9,26,662,286,322,608,"21 de agosto de 1994"
19,9,26,663,474,547,1021,"21 de agosto de 1994"
19,9,26,664,477,536,1013,"21 de agosto de 1994"
19,9,26,665,438,494,932,"21 de agosto de 1994"
19,9,26,666,387,458,845,"21 de agosto de 1994"
19,9,26,667,720,704,1424,"21 de agosto de 1994"
19,9,26,668,740,786,1526,"21 de agosto de 1994"
19,9,26,669,591,661,1252,"21 de agosto de 1994"
19,9,26,670,761,807,1568,"21 de agosto de 1994"
19,9,26,671,817,861,1678,"21 de agosto de 1994"
19,9,26,672,799,793,1592,"21 de agosto de 1994"
19,9,26,673,647,694,1341,"21 de agosto de 1994"
19,9,26,674,767,807,1574,"21 de agosto de 1994"
19,9,26,675,607,622,1229,"21 de agosto de 1994"
19,9,26,676,630,638,1268,"21 de agosto de 1994"
19,9,26,677,106,119,225,"21 de agosto de 1994"
19,9,26,678,860,792,1652,"21 de agosto de 1994"
19,9,26,679,781,828,1609,"21 de agosto de 1994"
19,9,26,680,699,751,1450,"21 de agosto de 1994"
19,9,26,681,493,522,1015,"21 de agosto de 1994"
19,9,26,682,785,773,1558,"21 de agosto de 1994"
19,9,26,683,778,785,1563,"21 de agosto de 1994"
19,9,26,684,757,783,1540,"21 de agosto de 1994"
19,9,26,685,574,624,1198,"21 de agosto de 1994"
19,9,26,686,520,575,1095,"21 de agosto de 1994"
19,9,26,687,514,523,1037,"21 de agosto de 1994"
19,9,26,688,763,787,1550,"21 de agosto de 1994"
19,9,26,689,811,875,1686,"21 de agosto de 1994"
19,9,26,690,794,861,1655,"21 de agosto de 1994"
19,9,26,691,703,757,1460,"21 de agosto de 1994"
19,9,26,692,546,593,1139,"21 de agosto de 1994"
19,9,26,693,606,653,1259,"21 de agosto de 1994"
19,9,26,694,495,474,969,"21 de agosto de 1994"
19,9,26,695,697,704,1401,"21 de agosto de 1994"
19,9,26,696,564,595,1159,"21 de agosto de 1994"
19,9,26,697,709,766,1475,"21 de agosto de 1994"
19,9,26,698,623,661,1284,"21 de agosto de 1994"
19,9,26,699,859,890,1749,"21 de agosto de 1994"
19,9,26,700,458,501,959,"21 de agosto de 1994"
19,9,26,701,435,503,938,"21 de agosto de 1994"
19,9,26,702,463,501,964,"21 de agosto de 1994"
19,9,26,703,822,894,1716,"21 de agosto de 1994"
19,9,26,704,474,449,923,"21 de agosto de 1994"
19,9,26,705,728,746,1474,"21 de agosto de 1994"
19,9,26,706,846,921,1767,"21 de agosto de 1994"
19,9,26,707,461,484,945,"21 de agosto de 1994"
19,9,26,708,391,395,786,"21 de agosto de 1994"
19,9,26,709,545,607,1152,"21 de agosto de 1994"
19,9,26,710,398,432,830,"21 de agosto de 1994"
19,9,26,711,520,556,1076,"21 de agosto de 1994"
19,9,26,712,838,890,1728,"21 de agosto de 1994"
19,9,26,713,779,791,1570,"21 de agosto de 1994"
19,9,26,714,656,691,1347,"21 de agosto de 1994"
19,9,26,715,649,602,1251,"21 de agosto de 1994"
19,9,26,716,564,572,1136,"21 de agosto de 1994"
19,9,26,717,550,591,1141,"21 de agosto de 1994"
19,9,26,718,667,744,1411,"21 de agosto de 1994"
19,9,26,719,663,674,1337,"21 de agosto de 1994"
19,9,26,720,758,810,1568,"21 de agosto de 1994"
19,9,26,721,622,653,1275,"21 de agosto de 1994"
19,9,26,722,852,879,1731,"21 de agosto de 1994"
19,9,26,723,787,785,1572,"21 de agosto de 1994"
19,9,26,724,624,669,1293,"21 de agosto de 1994"
19,9,26,725,640,632,1272,"21 de agosto de 1994"
19,9,26,726,649,652,1301,"21 de agosto de 1994"
19,9,26,727,565,585,1150,"21 de agosto de 1994"
19,9,26,728,748,768,1516,"21 de agosto de 1994"
19,9,26,729,809,885,1694,"21 de agosto de 1994"
19,9,26,730,744,788,1532,"21 de agosto de 1994"
19,9,26,731,516,539,1055,"21 de agosto de 1994"
19,9,26,732,680,755,1435,"21 de agosto de 1994"
19,9,26,733,629,680,1309,"21 de agosto de 1994"
19,9,26,734,928,954,1882,"21 de agosto de 1994"
19,9,26,735,675,688,1363,"21 de agosto de 1994"
19,9,26,736,523,568,1091,"21 de agosto de 1994"
19,9,26,737,575,599,1174,"21 de agosto de 1994"
19,9,26,738,504,574,1078,"21 de agosto de 1994"
19,9,26,739,813,850,1663,"21 de agosto de 1994"
19,9,26,740,458,473,931,"21 de agosto de 1994"
19,9,26,741,851,840,1691,"21 de agosto de 1994"
19,9,26,742,1092,1164,2256,"21 de agosto de 1994"
19,9,26,743,374,417,791,"21 de agosto de 1994"
19,9,26,744,589,629,1218,"21 de agosto de 1994"
19,9,26,745,439,488,927,"21 de agosto de 1994"
19,9,26,746,475,543,1018,"21 de agosto de 1994"
19,9,26,747,479,515,994,"21 de agosto de 1994"
19,9,26,748,397,495,892,"21 de agosto de 1994"
19,9,26,749,482,532,1014,"21 de agosto de 1994"
19,9,26,750,604,641,1245,"21 de agosto de 1994"
19,9,26,751,624,724,1348,"21 de agosto de 1994"
19,9,26,752,607,646,1253,"21 de agosto de 1994"
19,9,26,753,825,826,1651,"21 de agosto de 1994"
19,9,26,754,701,759,1460,"21 de agosto de 1994"
19,9,26,755,888,963,1851,"21 de agosto de 1994"
19,9,26,756,579,631,1210,"21 de agosto de 1994"
19,9,26,757,686,714,1400,"21 de agosto de 1994"
19,9,26,758,683,720,1403,"21 de agosto de 1994"
19,9,26,759,929,1014,1943,"21 de agosto de 1994"
19,9,26,760,580,591,1171,"21 de agosto de 1994"
19,9,26,761,382,412,794,"21 de agosto de 1994"
19,9,26,762,457,475,932,"21 de agosto de 1994"
19,9,26,763,673,723,1396,"21 de agosto de 1994"
19,9,26,764,813,818,1631,"21 de agosto de 1994"
19,9,26,765,816,846,1662,"21 de agosto de 1994"
19,9,26,766,886,871,1757,"21 de agosto de 1994"
19,9,26,767,943,932,1875,"21 de agosto de 1994"
19,9,26,768,737,764,1501,"21 de agosto de 1994"
19,9,26,769,584,603,1187,"21 de agosto de 1994"
19,9,26,770,812,851,1663,"21 de agosto de 1994"
19,9,26,771,765,791,1556,"21 de agosto de 1994"
19,9,26,772,603,601,1204,"21 de agosto de 1994"
19,9,26,773,856,876,1732,"21 de agosto de 1994"
19,9,26,774,491,488,979,"21 de agosto de 1994"
19,9,26,775,583,600,1183,"21 de agosto de 1994"
19,9,26,776,919,914,1833,"21 de agosto de 1994"
19,9,26,777,677,749,1426,"21 de agosto de 1994"
19,9,26,778,384,452,836,"21 de agosto de 1994"
19,9,26,779,786,823,1609,"21 de agosto de 1994"
19,9,26,780,590,584,1174,"21 de agosto de 1994"
19,9,26,781,382,428,810,"21 de agosto de 1994"
19,9,26,782,519,598,1117,"21 de agosto de 1994"
19,9,26,783,735,791,1526,"21 de agosto de 1994"
19,9,26,784,496,527,1023,"21 de agosto de 1994"
19,9,26,785,791,805,1596,"21 de agosto de 1994"
19,9,26,786,563,591,1154,"21 de agosto de 1994"
19,9,26,787,559,598,1157,"21 de agosto de 1994"
19,9,26,788,585,594,1179,"21 de agosto de 1994"
19,9,26,789,513,549,1062,"21 de agosto de 1994"
19,9,26,790,765,766,1531,"21 de agosto de 1994"
19,9,26,791,729,775,1504,"21 de agosto de 1994"
19,9,26,792,819,857,1676,"21 de agosto de 1994"
19,9,26,793,601,661,1262,"21 de agosto de 1994"
19,9,26,794,511,532,1043,"21 de agosto de 1994"
19,9,26,795,541,562,1103,"21 de agosto de 1994"
19,9,26,796,537,581,1118,"21 de agosto de 1994"
19,9,26,797,488,520,1008,"21 de agosto de 1994"
19,9,26,798,225,264,489,"21 de agosto de 1994"
19,9,26,799,584,670,1254,"21 de agosto de 1994"
19,9,26,800,755,858,1613,"21 de agosto de 1994"
19,9,26,801,490,547,1037,"21 de agosto de 1994"
19,9,26,802,477,492,969,"21 de agosto de 1994"
19,9,26,803,620,661,1281,"21 de agosto de 1994"
19,9,26,804,454,510,964,"21 de agosto de 1994"
19,10,47,1761,485,546,1031,"21 de agosto de 1994"
19,10,47,1762,427,431,858,"21 de agosto de 1994"
19,10,47,1763,527,565,1092,"21 de agosto de 1994"
19,10,47,1764,555,591,1146,"21 de agosto de 1994"
19,10,47,1765,478,522,1000,"21 de agosto de 1994"
19,10,47,1766,519,590,1109,"21 de agosto de 1994"
19,10,47,1767,536,593,1129,"21 de agosto de 1994"
19,10,47,1768,454,470,924,"21 de agosto de 1994"
19,10,47,1769,670,728,1398,"21 de agosto de 1994"
19,10,47,1770,805,803,1608,"21 de agosto de 1994"
19,10,47,1771,407,406,813,"21 de agosto de 1994"
19,10,47,1772,762,783,1545,"21 de agosto de 1994"
19,10,47,1773,616,653,1269,"21 de agosto de 1994"
19,10,47,1774,498,525,1023,"21 de agosto de 1994"
19,10,47,1775,443,485,928,"21 de agosto de 1994"
19,10,47,1776,580,626,1206,"21 de agosto de 1994"
19,10,47,1777,623,671,1294,"21 de agosto de 1994"
19,10,47,1778,524,584,1108,"21 de agosto de 1994"
19,10,47,1779,488,526,1014,"21 de agosto de 1994"
19,10,47,1780,546,586,1132,"21 de agosto de 1994"
19,10,47,1781,478,555,1033,"21 de agosto de 1994"
19,10,47,1782,509,588,1097,"21 de agosto de 1994"
19,10,47,1783,674,679,1353,"21 de agosto de 1994"
19,10,47,1784,775,796,1571,"21 de agosto de 1994"
19,10,47,1785,264,294,558,"21 de agosto de 1994"
19,10,47,1786,587,620,1207,"21 de agosto de 1994"
19,10,47,1787,669,740,1409,"21 de agosto de 1994"
19,10,47,1788,554,556,1110,"21 de agosto de 1994"
19,10,47,1789,497,530,1027,"21 de agosto de 1994"
19,10,47,1790,466,460,926,"21 de agosto de 1994"
19,10,47,1791,525,582,1107,"21 de agosto de 1994"
19,10,47,1792,647,703,1350,"21 de agosto de 1994"
19,10,47,1793,620,689,1309,"21 de agosto de 1994"
19,10,47,1794,676,729,1405,"21 de agosto de 1994"
19,10,47,1795,302,340,642,"21 de agosto de 1994"
19,10,47,1796,277,327,604,"21 de agosto de 1994"
19,10,47,1797,589,600,1189,"21 de agosto de 1994"
19,10,47,1798,186,212,398,"21 de agosto de 1994"
19,10,47,1799,195,215,410,"21 de agosto de 1994"
19,10,47,1800,385,467,852,"21 de agosto de 1994"
19,10,47,1801,280,306,586,"21 de agosto de 1994"
19,10,47,1802,309,340,649,"21 de agosto de 1994"
19,10,47,1803,438,496,934,"21 de agosto de 1994"
19,10,47,1804,842,842,1684,"21 de agosto de 1994"
19,10,47,1805,545,583,1128,"21 de agosto de 1994"
19,10,47,1806,565,590,1155,"21 de agosto de 1994"
19,10,47,1807,490,530,1020,"21 de agosto de 1994"
19,10,47,1808,435,499,934,"21 de agosto de 1994"
19,10,47,1809,501,549,1050,"21 de agosto de 1994"
19,10,47,1810,609,663,1272,"21 de agosto de 1994"
19,10,47,1811,607,608,1215,"21 de agosto de 1994"
19,10,47,1812,574,588,1162,"21 de agosto de 1994"
19,10,47,1813,649,641,1290,"21 de agosto de 1994"
19,10,47,1814,481,518,999,"21 de agosto de 1994"
19,10,47,1815,558,596,1154,"21 de agosto de 1994"
19,10,47,1816,498,501,999,"21 de agosto de 1994"
19,10,47,1817,366,376,742,"21 de agosto de 1994"
19,10,47,1818,510,510,1020,"21 de agosto de 1994"
19,10,47,1819,704,680,1384,"21 de agosto de 1994"
19,10,47,1820,700,659,1359,"21 de agosto de 1994"
19,10,47,1821,482,484,966,"21 de agosto de 1994"
19,10,47,1822,367,382,749,"21 de agosto de 1994"
19,10,47,1823,360,396,756,"21 de agosto de 1994"
19,10,47,1824,306,342,648,"21 de agosto de 1994"
19,10,47,1825,370,403,773,"21 de agosto de 1994"
19,10,47,1826,525,583,1108,"21 de agosto de 1994"
19,10,47,1827,616,689,1305,"21 de agosto de 1994"
19,10,47,1828,496,575,1071,"21 de agosto de 1994"
19,10,47,1829,463,522,985,"21 de agosto de 1994"
19,10,47,1830,456,511,967,"21 de agosto de 1994"
19,10,47,1831,509,534,1043,"21 de agosto de 1994"
19,10,47,1832,530,554,1084,"21 de agosto de 1994"
19,10,47,1833,516,559,1075,"21 de agosto de 1994"
19,10,47,1834,388,458,846,"21 de agosto de 1994"
19,10,47,1835,357,384,741,"21 de agosto de 1994"
19,10,47,1836,485,546,1031,"21 de agosto de 1994"
19,10,47,1837,493,564,1057,"21 de agosto de 1994"
19,10,47,1838,319,333,652,"21 de agosto de 1994"
19,10,47,1839,340,364,704,"21 de agosto de 1994"
19,10,47,1840,310,391,701,"21 de agosto de 1994"
19,10,47,1841,340,399,739,"21 de agosto de 1994"
19,10,47,1842,670,733,1403,"21 de agosto de 1994"
19,10,47,1843,290,352,642,"21 de agosto de 1994"
19,10,47,1844,749,817,1566,"21 de agosto de 1994"
19,10,47,1845,719,779,1498,"21 de agosto de 1994"
19,10,47,1846,423,478,901,"21 de agosto de 1994"
19,10,47,1847,647,739,1386,"21 de agosto de 1994"
19,10,47,1848,668,700,1368,"21 de agosto de 1994"
19,10,47,1849,524,545,1069,"21 de agosto de 1994"
19,10,47,1850,490,575,1065,"21 de agosto de 1994"
19,10,47,1851,487,515,1002,"21 de agosto de 1994"
19,10,47,1852,595,691,1286,"21 de agosto de 1994"
19,10,47,1853,556,577,1133,"21 de agosto de 1994"
19,10,47,1854,634,643,1277,"21 de agosto de 1994"
19,10,47,1855,613,630,1243,"21 de agosto de 1994"
19,10,47,1856,447,484,931,"21 de agosto de 1994"
19,10,47,1857,416,414,830,"21 de agosto de 1994"
19,10,47,1858,557,612,1169,"21 de agosto de 1994"
19,10,47,1859,693,743,1436,"21 de agosto de 1994"
19,10,47,1860,512,590,1102,"21 de agosto de 1994"
19,10,47,1861,681,698,1379,"21 de agosto de 1994"
19,10,47,1862,663,655,1318,"21 de agosto de 1994"
19,10,47,1863,736,787,1523,"21 de agosto de 1994"
19,10,47,1864,703,777,1480,"21 de agosto de 1994"
19,10,47,1865,692,760,1452,"21 de agosto de 1994"
19,10,47,1866,327,360,687,"21 de agosto de 1994"
19,10,47,1867,409,425,834,"21 de agosto de 1994"
19,10,47,1868,505,570,1075,"21 de agosto de 1994"
19,10,47,1869,671,674,1345,"21 de agosto de 1994"
19,10,47,1870,640,711,1351,"21 de agosto de 1994"
19,10,47,1871,575,633,1208,"21 de agosto de 1994"
19,10,47,1872,414,458,872,"21 de agosto de 1994"
19,10,47,1873,417,420,837,"21 de agosto de 1994"
19,10,47,1874,549,569,1118,"21 de agosto de 1994"
19,10,47,1875,689,724,1413,"21 de agosto de 1994"
19,10,47,1876,613,622,1235,"21 de agosto de 1994"
19,10,47,1877,120,138,258,"21 de agosto de 1994"
19,10,47,1878,549,581,1130,"21 de agosto de 1994"
19,10,47,1879,560,570,1130,"21 de agosto de 1994"
19,10,47,1880,498,601,1099,"21 de agosto de 1994"
19,10,47,1881,551,566,1117,"21 de agosto de 1994"
19,10,47,1882,494,519,1013,"21 de agosto de 1994"
19,10,47,1883,462,523,985,"21 de agosto de 1994"
19,10,47,1884,588,658,1246,"21 de agosto de 1994"
19,10,47,1885,782,804,1586,"21 de agosto de 1994"
19,10,47,1886,687,728,1415,"21 de agosto de 1994"
19,10,47,1887,619,610,1229,"21 de agosto de 1994"
19,10,47,1888,597,636,1233,"21 de agosto de 1994"
19,10,47,1889,495,564,1059,"21 de agosto de 1994"
19,10,47,1890,354,397,751,"21 de agosto de 1994"
19,10,47,1891,593,617,1210,"21 de agosto de 1994"
19,10,47,1892,706,713,1419,"21 de agosto de 1994"
19,10,47,1893,634,645,1279,"21 de agosto de 1994"
19,10,47,1894,341,353,694,"21 de agosto de 1994"
19,10,47,1895,415,438,853,"21 de agosto de 1994"
19,10,47,1896,558,581,1139,"21 de agosto de 1994"
19,10,47,1897,866,946,1812,"21 de agosto de 1994"
19,10,47,1898,514,575,1089,"21 de agosto de 1994"
19,10,47,1899,492,516,1008,"21 de agosto de 1994"
19,10,47,1900,359,368,727,"21 de agosto de 1994"
19,10,47,1901,854,936,1790,"21 de agosto de 1994"
19,10,47,1902,845,903,1748,"21 de agosto de 1994"
19,10,47,1903,718,735,1453,"21 de agosto de 1994"
19,10,47,1904,733,764,1497,"21 de agosto de 1994"
19,10,47,1905,637,688,1325,"21 de agosto de 1994"
19,10,47,1906,273,308,581,"21 de agosto de 1994"
19,10,47,1907,693,727,1420,"21 de agosto de 1994"
19,10,47,1908,698,741,1439,"21 de agosto de 1994"
19,10,47,1909,624,704,1328,"21 de agosto de 1994"
19,10,47,1910,619,637,1256,"21 de agosto de 1994"
19,10,47,1911,658,696,1354,"21 de agosto de 1994"
19,10,47,1912,103,102,205,"21 de agosto de 1994"
19,10,47,1913,237,236,473,"21 de agosto de 1994"
19,10,47,1914,417,502,919,"21 de agosto de 1994"
19,10,47,1915,458,491,949,"21 de agosto de 1994"
19,10,47,1916,432,510,942,"21 de agosto de 1994"
19,10,47,1917,527,608,1135,"21 de agosto de 1994"
19,10,47,1918,685,725,1410,"21 de agosto de 1994"
19,10,47,1919,696,777,1473,"21 de agosto de 1994"
19,10,47,1920,761,797,1558,"21 de agosto de 1994"
19,10,47,1921,616,627,1243,"21 de agosto de 1994"
19,10,47,1922,524,503,1027,"21 de agosto de 1994"
19,10,47,1923,508,517,1025,"21 de agosto de 1994"
19,10,47,1924,630,659,1289,"21 de agosto de 1994"
19,10,47,1925,598,621,1219,"21 de agosto de 1994"
19,10,47,1926,589,628,1217,"21 de agosto de 1994"
19,10,47,1927,717,747,1464,"21 de agosto de 1994"
19,10,47,1928,565,600,1165,"21 de agosto de 1994"
19,10,47,1929,806,818,1624,"21 de agosto de 1994"
19,10,47,1930,423,401,824,"21 de agosto de 1994"
19,10,47,1931,635,601,1236,"21 de agosto de 1994"
19,10,47,1932,712,748,1460,"21 de agosto de 1994"
19,10,47,1933,520,484,1004,"21 de agosto de 1994"
19,10,47,1934,412,369,781,"21 de agosto de 1994"
19,10,47,1935,832,846,1678,"21 de agosto de 1994"
19,10,47,1936,720,768,1488,"21 de agosto de 1994"
19,10,47,1937,776,839,1615,"21 de agosto de 1994"
19,10,47,1938,505,513,1018,"21 de agosto de 1994"
19,10,47,1939,262,241,503,"21 de agosto de 1994"
19,10,47,1940,690,655,1345,"21 de agosto de 1994"
19,10,47,1941,365,369,734,"21 de agosto de 1994"
19,10,47,1942,493,482,975,"21 de agosto de 1994"
19,10,47,1943,590,669,1259,"21 de agosto de 1994"
19,10,47,1944,955,918,1873,"21 de agosto de 1994"
19,10,47,1945,633,696,1329,"21 de agosto de 1994"
19,10,47,1946,622,725,1347,"21 de agosto de 1994"
19,10,47,1947,496,537,1033,"21 de agosto de 1994"
19,10,47,1948,411,446,857,"21 de agosto de 1994"
19,10,47,1949,275,326,601,"21 de agosto de 1994"
19,10,47,1950,301,320,621,"21 de agosto de 1994"
19,10,47,1951,383,370,753,"21 de agosto de 1994"
19,10,47,1952,522,608,1130,"21 de agosto de 1994"
19,10,47,1953,500,545,1045,"21 de agosto de 1994"
19,10,47,1954,958,940,1898,"21 de agosto de 1994"
19,10,47,1955,806,802,1608,"21 de agosto de 1994"
19,10,47,1956,447,461,908,"21 de agosto de 1994"
19,10,47,1957,684,723,1407,"21 de agosto de 1994"
19,10,47,1958,863,871,1734,"21 de agosto de 1994"
19,10,47,1959,659,665,1324,"21 de agosto de 1994"
19,10,47,1960,531,551,1082,"21 de agosto de 1994"
19,10,47,1961,726,833,1559,"21 de agosto de 1994"
19,10,47,1962,765,777,1542,"21 de agosto de 1994"
19,10,47,1963,785,845,1630,"21 de agosto de 1994"
19,10,47,1964,304,309,613,"21 de agosto de 1994"
19,10,47,1965,485,555,1040,"21 de agosto de 1994"
19,10,47,1966,537,568,1105,"21 de agosto de 1994"
19,10,47,1967,505,531,1036,"21 de agosto de 1994"
19,10,47,1968,594,637,1231,"21 de agosto de 1994"
19,10,47,1969,614,656,1270,"21 de agosto de 1994"
19,10,47,1970,782,839,1621,"21 de agosto de 1994"
19,10,47,1971,525,551,1076,"21 de agosto de 1994"
19,10,47,1972,767,747,1514,"21 de agosto de 1994"
19,10,47,1973,647,634,1281,"21 de agosto de 1994"
19,10,47,1974,624,704,1328,"21 de agosto de 1994"
19,10,47,1975,446,484,930,"21 de agosto de 1994"
19,10,47,1976,775,831,1606,"21 de agosto de 1994"
19,10,47,1977,970,1008,1978,"21 de agosto de 1994"
19,10,47,1978,614,655,1269,"21 de agosto de 1994"
19,10,47,1979,695,760,1455,"21 de agosto de 1994"
19,10,47,1980,733,729,1462,"21 de agosto de 1994"
19,10,47,1981,419,448,867,"21 de agosto de 1994"
19,10,47,1982,271,275,546,"21 de agosto de 1994"
19,10,47,1983,317,331,648,"21 de agosto de 1994"
19,10,47,1984,581,616,1197,"21 de agosto de 1994"
19,10,47,1985,667,719,1386,"21 de agosto de 1994"
19,10,47,1986,294,263,557,"21 de agosto de 1994"
19,10,47,1987,703,711,1414,"21 de agosto de 1994"
19,10,47,1988,728,813,1541,"21 de agosto de 1994"
19,10,47,1989,537,568,1105,"21 de agosto de 1994"
19,10,47,1990,180,199,379,"21 de agosto de 1994"
19,10,47,1991,269,305,574,"21 de agosto de 1994"
19,10,47,1992,220,274,494,"21 de agosto de 1994"
19,10,47,1993,290,294,584,"21 de agosto de 1994"
19,10,47,1994,279,328,607,"21 de agosto de 1994"
19,10,47,1995,193,194,387,"21 de agosto de 1994"
19,10,47,1996,711,755,1466,"21 de agosto de 1994"
19,10,47,1997,711,770,1481,"21 de agosto de 1994"
19,10,47,1998,586,619,1205,"21 de agosto de 1994"
19,11,4,20,483,468,951,"21 de agosto de 1994"
19,11,4,21,577,603,1180,"21 de agosto de 1994"
19,11,4,22,535,548,1083,"21 de agosto de 1994"
19,11,4,23,564,573,1137,"21 de agosto de 1994"
19,11,4,24,314,328,642,"21 de agosto de 1994"
19,11,4,25,437,465,902,"21 de agosto de 1994"
19,11,4,26,373,378,751,"21 de agosto de 1994"
19,11,4,27,465,496,961,"21 de agosto de 1994"
19,11,4,28,490,497,987,"21 de agosto de 1994"
19,11,4,29,564,558,1122,"21 de agosto de 1994"
19,11,4,30,590,629,1219,"21 de agosto de 1994"
19,11,4,31,263,265,528,"21 de agosto de 1994"
19,11,4,32,274,267,541,"21 de agosto de 1994"
19,11,4,33,357,344,701,"21 de agosto de 1994"
19,11,4,34,260,251,511,"21 de agosto de 1994"
19,11,4,35,101,99,200,"21 de agosto de 1994"
19,11,4,36,102,93,195,"21 de agosto de 1994"
19,11,4,37,186,174,360,"21 de agosto de 1994"
19,11,4,38,247,224,471,"21 de agosto de 1994"
19,11,9,172,461,472,933,"21 de agosto de 1994"
19,11,9,173,561,520,1081,"21 de agosto de 1994"
19,11,9,174,828,802,1630,"21 de agosto de 1994"
19,11,9,175,590,582,1172,"21 de agosto de 1994"
19,11,9,176,518,473,991,"21 de agosto de 1994"
19,11,9,177,594,567,1161,"21 de agosto de 1994"
19,11,9,178,476,474,950,"21 de agosto de 1994"
19,11,9,179,576,577,1153,"21 de agosto de 1994"
19,11,9,180,536,519,1055,"21 de agosto de 1994"
19,11,9,181,526,596,1122,"21 de agosto de 1994"
19,11,9,182,477,464,941,"21 de agosto de 1994"
19,11,9,183,393,432,825,"21 de agosto de 1994"
19,11,9,184,534,554,1088,"21 de agosto de 1994"
19,11,9,185,476,520,996,"21 de agosto de 1994"
19,11,9,186,527,448,975,"21 de agosto de 1994"
19,11,9,187,540,572,1112,"21 de agosto de 1994"
19,11,9,188,472,453,925,"21 de agosto de 1994"
19,11,9,189,673,639,1312,"21 de agosto de 1994"
19,11,9,190,579,622,1201,"21 de agosto de 1994"
19,11,9,191,573,565,1138,"21 de agosto de 1994"
19,11,9,192,246,216,462,"21 de agosto de 1994"
19,11,9,193,312,325,637,"21 de agosto de 1994"
19,11,9,194,344,316,660,"21 de agosto de 1994"
19,11,9,195,76,59,135,"21 de agosto de 1994"
19,11,9,196,109,86,195,"21 de agosto de 1994"
19,11,9,197,254,218,472,"21 de agosto de 1994"
19,11,9,198,238,250,488,"21 de agosto de 1994"
19,11,9,199,283,271,554,"21 de agosto de 1994"
19,11,9,200,387,339,726,"21 de agosto de 1994"
19,11,9,201,404,385,789,"21 de agosto de 1994"
19,11,9,202,100,99,199,"21 de agosto de 1994"
19,11,9,203,204,197,401,"21 de agosto de 1994"
19,11,9,204,195,177,372,"21 de agosto de 1994"
19,11,9,205,318,309,627,"21 de agosto de 1994"
19,11,9,206,160,147,307,"21 de agosto de 1994"
19,11,9,207,99,64,163,"21 de agosto de 1994"
19,11,9,208,59,33,92,"21 de agosto de 1994"
19,11,9,209,145,122,267,"21 de agosto de 1994"
19,11,9,210,325,288,613,"21 de agosto de 1994"
19,11,9,211,163,149,312,"21 de agosto de 1994"
19,11,9,212,304,302,606,"21 de agosto de 1994"
19,11,9,213,226,196,422,"21 de agosto de 1994"
19,11,9,214,161,175,336,"21 de agosto de 1994"
19,11,9,215,87,70,157,"21 de agosto de 1994"
19,11,9,216,149,171,320,"21 de agosto de 1994"
19,11,9,217,417,413,830,"21 de agosto de 1994"
19,11,39,931,609,567,1176,"21 de agosto de 1994"
19,11,39,932,417,458,875,"21 de agosto de 1994"
19,11,39,933,637,691,1328,"21 de agosto de 1994"
19,11,39,934,470,538,1008,"21 de agosto de 1994"
19,11,39,935,470,498,968,"21 de agosto de 1994"
19,11,39,936,417,457,874,"21 de agosto de 1994"
19,11,39,937,365,451,816,"21 de agosto de 1994"
19,11,39,938,625,654,1279,"21 de agosto de 1994"
19,11,39,939,850,899,1749,"21 de agosto de 1994"
19,11,39,940,524,532,1056,"21 de agosto de 1994"
19,11,39,941,490,516,1006,"21 de agosto de 1994"
19,11,39,942,507,554,1061,"21 de agosto de 1994"
19,11,39,943,140,169,309,"21 de agosto de 1994"
19,11,39,944,525,540,1065,"21 de agosto de 1994"
19,11,39,945,287,309,596,"21 de agosto de 1994"
19,11,39,946,329,332,661,"21 de agosto de 1994"
19,11,39,947,407,393,800,"21 de agosto de 1994"
19,11,39,948,505,525,1030,"21 de agosto de 1994"
19,11,39,949,348,382,730,"21 de agosto de 1994"
19,11,39,950,486,547,1033,"21 de agosto de 1994"
19,11,39,951,646,702,1348,"21 de agosto de 1994"
19,11,39,952,433,457,890,"21 de agosto de 1994"
19,11,39,953,128,98,226,"21 de agosto de 1994"
19,11,39,954,289,258,547,"21 de agosto de 1994"
19,11,39,955,13,12,25,"21 de agosto de 1994"
19,11,39,956,184,142,326,"21 de agosto de 1994"
19,11,39,957,104,77,181,"21 de agosto de 1994"
19,11,39,958,274,237,511,"21 de agosto de 1994"
19,11,39,959,45,38,83,"21 de agosto de 1994"
19,11,39,960,119,92,211,"21 de agosto de 1994"
19,11,39,961,171,144,315,"21 de agosto de 1994"
19,11,39,962,162,147,309,"21 de agosto de 1994"
19,11,39,963,565,528,1093,"21 de agosto de 1994"
19,11,39,964,422,406,828,"21 de agosto de 1994"
19,11,39,965,266,250,516,"21 de agosto de 1994"
19,11,39,966,91,88,179,"21 de agosto de 1994"
19,11,39,967,68,54,122,"21 de agosto de 1994"
19,11,39,968,63,44,107,"21 de agosto de 1994"
19,11,39,969,183,162,345,"21 de agosto de 1994"
19,11,39,970,93,77,170,"21 de agosto de 1994"
19,11,39,971,149,123,272,"21 de agosto de 1994"
19,11,39,972,126,113,239,"21 de agosto de 1994"
19,11,39,973,160,121,281,"21 de agosto de 1994"
19,11,39,974,33,18,51,"21 de agosto de 1994"
19,11,44,1724,307,266,573,"21 de agosto de 1994"
19,11,44,1725,213,161,374,"21 de agosto de 1994"
19,11,44,1726,134,83,217,"21 de agosto de 1994"
19,11,44,1727,123,95,218,"21 de agosto de 1994"
19,11,44,1728,117,83,200,"21 de agosto de 1994"
19,11,48,1999,460,484,944,"21 de agosto de 1994"
19,11,48,2000,444,496,940,"21 de agosto de 1994"
19,11,48,2001,512,569,1081,"21 de agosto de 1994"
19,11,48,2002,507,555,1062,"21 de agosto de 1994"
19,11,48,2003,624,653,1277,"21 de agosto de 1994"
19,11,48,2004,552,612,1164,"21 de agosto de 1994"
19,11,48,2005,437,485,922,"21 de agosto de 1994"
19,11,48,2006,562,613,1175,"21 de agosto de 1994"
19,11,48,2007,840,827,1667,"21 de agosto de 1994"
19,11,48,2008,519,522,1041,"21 de agosto de 1994"
19,11,48,2009,528,582,1110,"21 de agosto de 1994"
19,11,48,2010,460,494,954,"21 de agosto de 1994"
19,11,48,2011,319,387,706,"21 de agosto de 1994"
19,11,48,2012,350,394,744,"21 de agosto de 1994"
19,11,48,2013,453,518,971,"21 de agosto de 1994"
19,11,48,2014,671,683,1354,"21 de agosto de 1994"
19,11,48,2015,555,580,1135,"21 de agosto de 1994"
19,11,48,2016,491,565,1056,"21 de agosto de 1994"
19,11,48,2017,172,179,351,"21 de agosto de 1994"
19,11,48,2018,822,780,1602,"21 de agosto de 1994"
19,11,48,2019,749,815,1564,"21 de agosto de 1994"
19,11,48,2020,407,424,831,"21 de agosto de 1994"
19,11,48,2021,497,592,1089,"21 de agosto de 1994"
19,11,48,2022,362,403,765,"21 de agosto de 1994"
19,11,48,2023,468,526,994,"21 de agosto de 1994"
19,11,48,2024,344,370,714,"21 de agosto de 1994"
19,11,48,2025,387,450,837,"21 de agosto de 1994"
19,11,48,2026,445,463,908,"21 de agosto de 1994"
19,11,48,2027,584,594,1178,"21 de agosto de 1994"
19,11,48,2028,494,545,1039,"21 de agosto de 1994"
19,11,48,2029,815,811,1626,"21 de agosto de 1994"
19,11,48,2030,798,805,1603,"21 de agosto de 1994"
19,11,48,2031,597,638,1235,"21 de agosto de 1994"
19,11,48,2032,565,566,1131,"21 de agosto de 1994"
19,11,48,2033,507,563,1070,"21 de agosto de 1994"
19,11,48,2034,444,460,904,"21 de agosto de 1994"
19,11,48,2035,449,461,910,"21 de agosto de 1994"
19,11,48,2036,441,462,903,"21 de agosto de 1994"
19,11,48,2037,398,454,852,"21 de agosto de 1994"
19,11,48,2038,596,577,1173,"21 de agosto de 1994"
19,11,48,2039,840,891,1731,"21 de agosto de 1994"
19,11,48,2040,297,277,574,"21 de agosto de 1994"
19,11,48,2041,975,1027,2002,"21 de agosto de 1994"
19,11,48,2042,471,496,967,"21 de agosto de 1994"
19,11,48,2043,520,508,1028,"21 de agosto de 1994"
19,11,48,2044,624,638,1262,"21 de agosto de 1994"
19,11,48,2045,656,659,1315,"21 de agosto de 1994"
19,11,48,2046,591,638,1229,"21 de agosto de 1994"
19,11,48,2047,1347,1365,2712,"21 de agosto de 1994"
19,11,48,2048,554,599,1153,"21 de agosto de 1994"
19,11,48,2049,582,630,1212,"21 de agosto de 1994"
19,11,48,2050,656,708,1364,"21 de agosto de 1994"
19,11,48,2051,848,847,1695,"21 de agosto de 1994"
19,11,48,2052,714,742,1456,"21 de agosto de 1994"
19,11,48,2053,712,711,1423,"21 de agosto de 1994"
19,11,48,2054,752,790,1542,"21 de agosto de 1994"
19,11,48,2055,551,617,1168,"21 de agosto de 1994"
19,11,48,2056,702,740,1442,"21 de agosto de 1994"
19,11,48,2057,140,152,292,"21 de agosto de 1994"
19,11,48,2058,799,809,1608,"21 de agosto de 1994"
19,11,48,2059,506,542,1048,"21 de agosto de 1994"
19,11,48,2060,546,566,1112,"21 de agosto de 1994"
19,11,48,2061,549,554,1103,"21 de agosto de 1994"
19,11,48,2062,319,337,656,"21 de agosto de 1994"
19,11,48,2063,680,714,1394,"21 de agosto de 1994"
19,11,48,2064,796,798,1594,"21 de agosto de 1994"
19,11,48,2065,629,699,1328,"21 de agosto de 1994"
19,11,48,2066,597,592,1189,"21 de agosto de 1994"
19,11,48,2067,578,607,1185,"21 de agosto de 1994"
19,11,48,2068,768,761,1529,"21 de agosto de 1994"
19,11,48,2069,794,766,1560,"21 de agosto de 1994"
19,11,48,2070,608,580,1188,"21 de agosto de 1994"
19,11,48,2071,688,749,1437,"21 de agosto de 1994"
19,11,48,2072,622,615,1237,"21 de agosto de 1994"
19,11,48,2073,691,747,1438,"21 de agosto de 1994"
19,11,48,2074,569,599,1168,"21 de agosto de 1994"
19,11,48,2075,587,658,1245,"21 de agosto de 1994"
19,11,48,2076,789,763,1552,"21 de agosto de 1994"
19,11,48,2077,710,693,1403,"21 de agosto de 1994"
19,11,48,2078,599,651,1250,"21 de agosto de 1994"
19,11,48,2079,654,599,1253,"21 de agosto de 1994"
19,11,48,2080,514,496,1010,"21 de agosto de 1994"
19,11,48,2081,550,582,1132,"21 de agosto de 1994"
19,11,48,2082,388,421,809,"21 de agosto de 1994"
19,11,48,2083,464,502,966,"21 de agosto de 1994"
19,11,48,2084,95,71,166,"21 de agosto de 1994"
19,11,48,2085,110,58,168,"21 de agosto de 1994"
19,11,49,2086,687,698,1385,"21 de agosto de 1994"
19,11,49,2087,569,609,1178,"21 de agosto de 1994"
19,11,49,2088,499,504,1003,"21 de agosto de 1994"
19,11,49,2089,530,576,1106,"21 de agosto de 1994"
19,11,49,2090,320,377,697,"21 de agosto de 1994"
19,11,49,2091,447,465,912,"21 de agosto de 1994"
19,11,49,2092,504,519,1023,"21 de agosto de 1994"
19,11,49,2093,339,348,687,"21 de agosto de 1994"
19,11,49,2094,478,430,908,"21 de agosto de 1994"
19,11,49,2095,679,672,1351,"21 de agosto de 1994"
19,11,49,2096,530,510,1040,"21 de agosto de 1994"
19,11,49,2097,578,544,1122,"21 de agosto de 1994"
19,11,49,2098,617,570,1187,"21 de agosto de 1994"
19,11,49,2099,545,523,1068,"21 de agosto de 1994"
19,11,49,2100,47,37,84,"21 de agosto de 1994"
19,11,49,2101,562,474,1036,"21 de agosto de 1994"
19,11,49,2102,184,201,385,"21 de agosto de 1994"
19,11,49,2103,380,361,741,"21 de agosto de 1994"
19,11,49,2104,417,375,792,"21 de agosto de 1994"
19,11,49,2105,459,450,909,"21 de agosto de 1994"
19,11,49,2106,103,87,190,"21 de agosto de 1994"
19,11,49,2107,41,17,58,"21 de agosto de 1994"
19,11,49,2108,101,73,174,"21 de agosto de 1994"
19,11,49,2109,256,187,443,"21 de agosto de 1994"
19,11,49,2110,155,115,270,"21 de agosto de 1994"
20,1,6,43,276,236,512,"21 de agosto de 1994"
20,1,6,44,299,288,587,"21 de agosto de 1994"
20,1,6,45,271,286,557,"21 de agosto de 1994"
20,1,6,46,273,308,581,"21 de agosto de 1994"
20,1,6,47,367,397,764,"21 de agosto de 1994"
20,1,6,48,236,263,499,"21 de agosto de 1994"
20,1,6,49,305,318,623,"21 de agosto de 1994"
20,1,6,50,297,320,617,"21 de agosto de 1994"
20,1,6,51,391,332,723,"21 de agosto de 1994"
20,1,6,52,298,299,597,"21 de agosto de 1994"
20,1,6,53,262,209,471,"21 de agosto de 1994"
20,1,6,54,273,253,526,"21 de agosto de 1994"
20,1,6,55,108,104,212,"21 de agosto de 1994"
20,1,6,56,357,311,668,"21 de agosto de 1994"
20,1,12,77,415,411,826,"21 de agosto de 1994"
20,1,12,78,368,368,736,"21 de agosto de 1994"
20,1,12,79,512,507,1019,"21 de agosto de 1994"
20,1,12,80,508,534,1042,"21 de agosto de 1994"
20,1,12,81,70,49,119,"21 de agosto de 1994"
20,1,12,82,311,290,601,"21 de agosto de 1994"
20,1,12,83,215,228,443,"21 de agosto de 1994"
20,1,12,84,393,374,767,"21 de agosto de 1994"
20,1,12,85,151,121,272,"21 de agosto de 1994"
20,1,12,86,367,368,735,"21 de agosto de 1994"
20,1,15,97,241,201,442,"21 de agosto de 1994"
20,1,15,98,314,274,588,"21 de agosto de 1994"
20,1,15,99,323,337,660,"21 de agosto de 1994"
20,1,15,100,338,313,651,"21 de agosto de 1994"
20,1,15,101,412,394,806,"21 de agosto de 1994"
20,1,15,102,405,423,828,"21 de agosto de 1994"
20,1,15,103,318,294,612,"21 de agosto de 1994"
20,1,30,180,339,322,661,"21 de agosto de 1994"
20,1,30,181,318,307,625,"21 de agosto de 1994"
20,1,30,182,267,282,549,"21 de agosto de 1994"
20,1,30,183,276,283,559,"21 de agosto de 1994"
20,1,30,184,302,293,595,"21 de agosto de 1994"
20,1,30,185,298,320,618,"21 de agosto de 1994"
20,1,30,186,301,300,601,"21 de agosto de 1994"
20,1,41,258,469,475,944,"21 de agosto de 1994"
20,1,41,259,381,448,829,"21 de agosto de 1994"
20,1,41,260,326,340,666,"21 de agosto de 1994"
20,1,41,261,379,402,781,"21 de agosto de 1994"
20,1,41,262,331,314,645,"21 de agosto de 1994"
20,1,41,263,332,387,719,"21 de agosto de 1994"
20,1,41,264,369,367,736,"21 de agosto de 1994"
20,1,41,265,306,281,587,"21 de agosto de 1994"
20,1,41,266,277,345,622,"21 de agosto de 1994"
20,1,41,267,331,353,684,"21 de agosto de 1994"
20,1,41,268,333,370,703,"21 de agosto de 1994"
20,1,41,269,352,358,710,"21 de agosto de 1994"
20,1,41,270,325,360,685,"21 de agosto de 1994"
20,1,41,271,411,267,678,"21 de agosto de 1994"
20,1,41,272,355,376,731,"21 de agosto de 1994"
20,1,41,273,353,385,738,"21 de agosto de 1994"
20,1,41,274,229,267,496,"21 de agosto de 1994"
20,1,41,275,42,36,78,"21 de agosto de 1994"
20,1,43,283,300,315,615,"21 de agosto de 1994"
20,1,43,284,400,412,812,"21 de agosto de 1994"
20,1,43,285,337,351,688,"21 de agosto de 1994"
20,1,43,286,366,394,760,"21 de agosto de 1994"
20,1,43,287,368,361,729,"21 de agosto de 1994"
20,1,43,288,434,439,873,"21 de agosto de 1994"
20,1,43,289,548,559,1107,"21 de agosto de 1994"
20,1,43,290,406,388,794,"21 de agosto de 1994"
20,1,43,291,499,417,916,"21 de agosto de 1994"
20,1,43,292,451,515,966,"21 de agosto de 1994"
20,1,43,293,602,645,1247,"21 de agosto de 1994"
20,1,43,294,376,391,767,"21 de agosto de 1994"
20,1,43,295,204,213,417,"21 de agosto de 1994"
20,1,43,296,360,389,749,"21 de agosto de 1994"
20,1,43,297,316,369,685,"21 de agosto de 1994"
20,1,43,298,272,303,575,"21 de agosto de 1994"
20,1,43,299,408,401,809,"21 de agosto de 1994"
20,1,43,300,246,247,493,"21 de agosto de 1994"
20,1,43,301,407,383,790,"21 de agosto de 1994"
20,1,43,302,478,520,998,"21 de agosto de 1994"
20,1,43,303,375,342,717,"21 de agosto de 1994"
20,1,43,304,484,457,941,"21 de agosto de 1994"
20,1,43,305,324,396,720,"21 de agosto de 1994"
20,1,43,306,326,315,641,"21 de agosto de 1994"
20,1,43,307,419,428,847,"21 de agosto de 1994"
20,1,43,308,380,386,766,"21 de agosto de 1994"
20,1,43,309,325,340,665,"21 de agosto de 1994"
20,1,43,310,556,513,1069,"21 de agosto de 1994"
20,1,43,311,419,376,795,"21 de agosto de 1994"
20,1,43,312,443,391,834,"21 de agosto de 1994"
20,1,43,313,444,466,910,"21 de agosto de 1994"
20,1,43,314,382,369,751,"21 de agosto de 1994"
20,1,43,315,364,377,741,"21 de agosto de 1994"
20,1,43,316,517,464,981,"21 de agosto de 1994"
20,1,43,317,357,311,668,"21 de agosto de 1994"
20,1,43,318,347,307,654,"21 de agosto de 1994"
20,1,43,319,265,209,474,"21 de agosto de 1994"
20,1,43,320,348,263,611,"21 de agosto de 1994"
20,1,43,321,478,417,895,"21 de agosto de 1994"
20,1,43,322,321,271,592,"21 de agosto de 1994"
20,1,43,323,303,283,586,"21 de agosto de 1994"
20,1,43,324,262,219,481,"21 de agosto de 1994"
20,1,43,325,496,492,988,"21 de agosto de 1994"
20,1,43,326,423,435,858,"21 de agosto de 1994"
20,1,43,327,233,229,462,"21 de agosto de 1994"
20,1,43,328,217,225,442,"21 de agosto de 1994"
20,1,43,329,277,315,592,"21 de agosto de 1994"
20,1,43,330,469,416,885,"21 de agosto de 1994"
20,1,43,331,419,346,765,"21 de agosto de 1994"
20,1,43,332,199,168,367,"21 de agosto de 1994"
20,1,57,397,555,585,1140,"21 de agosto de 1994"
20,1,57,398,384,403,787,"21 de agosto de 1994"
20,1,57,399,369,409,778,"21 de agosto de 1994"
20,1,57,400,487,515,1002,"21 de agosto de 1994"
20,1,57,401,412,428,840,"21 de agosto de 1994"
20,1,57,402,513,500,1013,"21 de agosto de 1994"
20,1,57,403,420,500,920,"21 de agosto de 1994"
20,1,57,404,382,447,829,"21 de agosto de 1994"
20,1,57,405,497,563,1060,"21 de agosto de 1994"
20,1,57,406,448,481,929,"21 de agosto de 1994"
20,1,57,407,566,584,1150,"21 de agosto de 1994"
20,1,57,408,434,450,884,"21 de agosto de 1994"
20,1,57,409,388,387,775,"21 de agosto de 1994"
20,1,57,410,366,385,751,"21 de agosto de 1994"
20,1,57,411,215,223,438,"21 de agosto de 1994"
20,1,57,412,363,332,695,"21 de agosto de 1994"
20,1,57,413,132,114,246,"21 de agosto de 1994"
20,1,57,414,399,345,744,"21 de agosto de 1994"
20,1,57,415,535,519,1054,"21 de agosto de 1994"
20,1,57,416,386,364,750,"21 de agosto de 1994"
20,1,57,417,326,308,634,"21 de agosto de 1994"
20,1,57,418,74,67,141,"21 de agosto de 1994"
20,1,57,419,205,163,368,"21 de agosto de 1994"
20,1,57,420,633,505,1138,"21 de agosto de 1994"
20,1,57,421,51,48,99,"21 de agosto de 1994"
20,1,72,661,329,323,652,"21 de agosto de 1994"
20,1,72,662,394,373,767,"21 de agosto de 1994"
20,1,127,838,459,414,873,"21 de agosto de 1994"
20,1,127,839,324,292,616,"21 de agosto de 1994"
20,1,127,840,357,325,682,"21 de agosto de 1994"
20,1,138,877,384,338,722,"21 de agosto de 1994"
20,1,138,878,320,321,641,"21 de agosto de 1994"
20,1,138,879,234,170,404,"21 de agosto de 1994"
20,1,138,880,66,59,125,"21 de agosto de 1994"
20,1,138,881,228,152,380,"21 de agosto de 1994"
20,1,140,883,386,362,748,"21 de agosto de 1994"
20,1,140,884,398,341,739,"21 de agosto de 1994"
20,1,140,885,385,369,754,"21 de agosto de 1994"
20,1,140,886,355,353,708,"21 de agosto de 1994"
20,1,140,887,338,277,615,"21 de agosto de 1994"
20,1,140,888,60,50,110,"21 de agosto de 1994"
20,1,140,889,268,234,502,"21 de agosto de 1994"
20,1,140,890,71,38,109,"21 de agosto de 1994"
20,1,199,1139,304,340,644,"21 de agosto de 1994"
20,1,199,1140,278,324,602,"21 de agosto de 1994"
20,1,199,1141,380,472,852,"21 de agosto de 1994"
20,1,199,1142,374,493,867,"21 de agosto de 1994"
20,1,199,1143,154,144,298,"21 de agosto de 1994"
20,1,199,1144,328,280,608,"21 de agosto de 1994"
20,1,199,1145,290,244,534,"21 de agosto de 1994"
20,1,199,1146,175,131,306,"21 de agosto de 1994"
20,1,199,1147,121,122,243,"21 de agosto de 1994"
20,1,199,1148,224,238,462,"21 de agosto de 1994"
20,1,199,1149,289,311,600,"21 de agosto de 1994"
20,1,199,1150,257,286,543,"21 de agosto de 1994"
20,1,199,1151,273,286,559,"21 de agosto de 1994"
20,1,199,1152,209,182,391,"21 de agosto de 1994"
20,1,199,1153,180,231,411,"21 de agosto de 1994"
20,1,199,1154,332,378,710,"21 de agosto de 1994"
20,1,199,1155,257,336,593,"21 de agosto de 1994"
20,1,199,1156,297,333,630,"21 de agosto de 1994"
20,1,199,1157,427,454,881,"21 de agosto de 1994"
20,1,199,1158,348,456,804,"21 de agosto de 1994"
20,1,199,1159,283,325,608,"21 de agosto de 1994"
20,1,199,1160,335,366,701,"21 de agosto de 1994"
20,1,199,1161,325,344,669,"21 de agosto de 1994"
20,1,263,1338,238,224,462,"21 de agosto de 1994"
20,1,263,1339,196,182,378,"21 de agosto de 1994"
20,1,263,1340,113,82,195,"21 de agosto de 1994"
20,1,263,1341,26,21,47,"21 de agosto de 1994"
20,1,263,1342,101,105,206,"21 de agosto de 1994"
20,1,263,1343,258,240,498,"21 de agosto de 1994"
20,1,263,1344,441,397,838,"21 de agosto de 1994"
20,1,325,1544,350,326,676,"21 de agosto de 1994"
20,1,325,1545,476,509,985,"21 de agosto de 1994"
20,1,325,1546,258,284,542,"21 de agosto de 1994"
20,1,325,1547,270,242,512,"21 de agosto de 1994"
20,1,325,1548,318,297,615,"21 de agosto de 1994"
20,1,325,1549,441,357,798,"21 de agosto de 1994"
20,1,325,1550,607,499,1106,"21 de agosto de 1994"
20,1,325,1551,85,52,137,"21 de agosto de 1994"
20,1,325,1552,164,107,271,"21 de agosto de 1994"
20,1,405,1810,625,568,1193,"21 de agosto de 1994"
20,1,405,1811,233,194,427,"21 de agosto de 1994"
20,1,405,1812,219,198,417,"21 de agosto de 1994"
20,1,405,1813,62,58,120,"21 de agosto de 1994"
20,1,405,1814,52,40,92,"21 de agosto de 1994"
20,1,405,1815,262,210,472,"21 de agosto de 1994"
20,1,427,1888,210,210,420,"21 de agosto de 1994"
20,1,427,1889,329,336,665,"21 de agosto de 1994"
20,1,427,1890,261,248,509,"21 de agosto de 1994"
20,1,427,1891,409,469,878,"21 de agosto de 1994"
20,1,427,1892,190,208,398,"21 de agosto de 1994"
20,1,427,1893,294,290,584,"21 de agosto de 1994"
20,1,427,1894,308,276,584,"21 de agosto de 1994"
20,1,427,1895,327,266,593,"21 de agosto de 1994"
20,1,427,1896,213,193,406,"21 de agosto de 1994"
20,1,427,1897,162,130,292,"21 de agosto de 1994"
20,1,442,1929,326,313,639,"21 de agosto de 1994"
20,1,442,1930,457,425,882,"21 de agosto de 1994"
20,1,442,1931,366,336,702,"21 de agosto de 1994"
20,1,442,1932,326,323,649,"21 de agosto de 1994"
20,1,481,2077,194,182,376,"21 de agosto de 1994"
20,1,481,2078,295,309,604,"21 de agosto de 1994"
20,1,481,2079,358,388,746,"21 de agosto de 1994"
20,1,481,2080,241,216,457,"21 de agosto de 1994"
20,1,481,2081,184,144,328,"21 de agosto de 1994"
20,1,481,2082,92,82,174,"21 de agosto de 1994"
20,1,481,2083,177,130,307,"21 de agosto de 1994"
20,1,509,2180,342,345,687,"21 de agosto de 1994"
20,1,509,2181,544,541,1085,"21 de agosto de 1994"
20,1,509,2182,494,475,969,"21 de agosto de 1994"
20,1,509,2183,289,305,594,"21 de agosto de 1994"
20,1,509,2184,430,388,818,"21 de agosto de 1994"
20,1,513,2190,258,236,494,"21 de agosto de 1994"
20,1,513,2191,271,264,535,"21 de agosto de 1994"
20,1,513,2192,318,318,636,"21 de agosto de 1994"
20,1,513,2193,349,299,648,"21 de agosto de 1994"
20,1,513,2194,212,207,419,"21 de agosto de 1994"
20,1,513,2195,226,189,415,"21 de agosto de 1994"
20,1,513,2196,153,119,272,"21 de agosto de 1994"
20,1,513,2197,86,75,161,"21 de agosto de 1994"
20,1,513,2198,100,91,191,"21 de agosto de 1994"
20,1,525,2249,428,437,865,"21 de agosto de 1994"
20,1,525,2250,411,368,779,"21 de agosto de 1994"
20,1,525,2251,323,311,634,"21 de agosto de 1994"
20,1,525,2252,324,325,649,"21 de agosto de 1994"
20,1,525,2253,386,394,780,"21 de agosto de 1994"
20,1,525,2254,194,155,349,"21 de agosto de 1994"
20,1,525,2255,193,199,392,"21 de agosto de 1994"
20,1,525,2256,50,41,91,"21 de agosto de 1994"
20,1,525,2257,319,277,596,"21 de agosto de 1994"
20,1,557,2394,265,260,525,"21 de agosto de 1994"
20,1,557,2395,305,307,612,"21 de agosto de 1994"
20,1,557,2396,297,294,591,"21 de agosto de 1994"
20,1,557,2397,269,283,552,"21 de agosto de 1994"
20,1,557,2398,284,303,587,"21 de agosto de 1994"
20,1,557,2399,265,304,569,"21 de agosto de 1994"
20,1,557,2400,323,324,647,"21 de agosto de 1994"
20,1,557,2401,382,351,733,"21 de agosto de 1994"
20,1,557,2402,368,340,708,"21 de agosto de 1994"
20,1,557,2403,332,375,707,"21 de agosto de 1994"
20,1,557,2404,284,292,576,"21 de agosto de 1994"
20,2,1,1,212,175,387,"21 de agosto de 1994"
20,2,11,74,335,336,671,"21 de agosto de 1994"
20,2,11,75,480,486,966,"21 de agosto de 1994"
20,2,11,76,250,236,486,"21 de agosto de 1994"
20,2,34,193,128,149,277,"21 de agosto de 1994"
20,2,42,276,257,296,553,"21 de agosto de 1994"
20,2,42,277,319,363,682,"21 de agosto de 1994"
20,2,42,278,232,206,438,"21 de agosto de 1994"
20,2,42,279,118,94,212,"21 de agosto de 1994"
20,2,42,280,137,136,273,"21 de agosto de 1994"
20,2,42,281,218,225,443,"21 de agosto de 1994"
20,2,42,282,250,244,494,"21 de agosto de 1994"
20,2,62,458,166,194,360,"21 de agosto de 1994"
20,2,65,469,325,392,717,"21 de agosto de 1994"
20,2,94,757,316,343,659,"21 de agosto de 1994"
20,2,94,758,208,210,418,"21 de agosto de 1994"
20,2,95,759,548,572,1120,"21 de agosto de 1994"
20,2,95,760,299,285,584,"21 de agosto de 1994"
20,2,97,762,145,178,323,"21 de agosto de 1994"
20,2,111,795,110,135,245,"21 de agosto de 1994"
20,2,111,796,60,56,116,"21 de agosto de 1994"
20,2,111,797,60,85,145,"21 de agosto de 1994"
20,2,117,809,500,749,1249,"21 de agosto de 1994"
20,2,119,811,137,170,307,"21 de agosto de 1994"
20,2,125,836,349,411,760,"21 de agosto de 1994"
20,2,131,851,350,341,691,"21 de agosto de 1994"
20,2,131,852,344,389,733,"21 de agosto de 1994"
20,2,131,853,421,436,857,"21 de agosto de 1994"
20,2,131,854,591,684,1275,"21 de agosto de 1994"
20,2,131,855,182,187,369,"21 de agosto de 1994"
20,2,131,856,605,557,1162,"21 de agosto de 1994"
20,2,131,857,543,544,1087,"21 de agosto de 1994"
20,2,131,858,460,500,960,"21 de agosto de 1994"
20,2,131,859,231,255,486,"21 de agosto de 1994"
20,2,131,860,156,155,311,"21 de agosto de 1994"
20,2,131,861,461,451,912,"21 de agosto de 1994"
20,2,133,866,592,629,1221,"21 de agosto de 1994"
20,2,133,867,559,565,1124,"21 de agosto de 1994"
20,2,133,868,610,639,1249,"21 de agosto de 1994"
20,2,133,869,380,349,729,"21 de agosto de 1994"
20,2,133,870,164,156,320,"21 de agosto de 1994"
20,2,135,874,143,185,328,"21 de agosto de 1994"
20,2,136,875,377,395,772,"21 de agosto de 1994"
20,2,142,893,351,358,709,"21 de agosto de 1994"
20,2,153,914,330,353,683,"21 de agosto de 1994"
20,2,153,915,200,201,401,"21 de agosto de 1994"
20,2,153,916,146,176,322,"21 de agosto de 1994"
20,2,164,943,606,583,1189,"21 de agosto de 1994"
20,2,164,944,397,402,799,"21 de agosto de 1994"
20,2,164,945,220,194,414,"21 de agosto de 1994"
20,2,164,946,357,335,692,"21 de agosto de 1994"
20,2,164,947,426,399,825,"21 de agosto de 1994"
20,2,164,948,321,328,649,"21 de agosto de 1994"
20,2,172,979,219,209,428,"21 de agosto de 1994"
20,2,172,980,208,233,441,"21 de agosto de 1994"
20,2,181,1009,388,414,802,"21 de agosto de 1994"
20,2,183,1084,406,367,773,"21 de agosto de 1994"
20,2,183,1085,329,278,607,"21 de agosto de 1994"
20,2,183,1086,382,366,748,"21 de agosto de 1994"
20,2,183,1087,499,438,937,"21 de agosto de 1994"
20,2,183,1088,397,345,742,"21 de agosto de 1994"
20,2,183,1089,356,385,741,"21 de agosto de 1994"
20,2,183,1090,416,369,785,"21 de agosto de 1994"
20,2,183,1091,400,376,776,"21 de agosto de 1994"
20,2,183,1092,214,175,389,"21 de agosto de 1994"
20,2,183,1093,183,127,310,"21 de agosto de 1994"
20,2,183,1094,290,269,559,"21 de agosto de 1994"
20,2,183,1095,379,348,727,"21 de agosto de 1994"
20,2,183,1096,232,185,417,"21 de agosto de 1994"
20,2,183,1097,185,175,360,"21 de agosto de 1994"
20,2,183,1098,209,188,397,"21 de agosto de 1994"
20,2,185,1106,103,117,220,"21 de agosto de 1994"
20,2,187,1108,355,472,827,"21 de agosto de 1994"
20,2,187,1109,300,312,612,"21 de agosto de 1994"
20,2,191,1117,253,236,489,"21 de agosto de 1994"
20,2,191,1118,161,137,298,"21 de agosto de 1994"
20,2,195,1133,314,383,697,"21 de agosto de 1994"
20,2,197,1136,134,151,285,"21 de agosto de 1994"
20,2,202,1168,180,191,371,"21 de agosto de 1994"
20,2,202,1169,206,238,444,"21 de agosto de 1994"
20,2,212,1213,258,276,534,"21 de agosto de 1994"
20,2,212,1214,194,99,293,"21 de agosto de 1994"
20,2,214,1217,322,402,724,"21 de agosto de 1994"
20,2,214,1218,94,93,187,"21 de agosto de 1994"
20,2,216,1220,279,292,571,"21 de agosto de 1994"
20,2,222,1234,281,336,617,"21 de agosto de 1994"
20,2,222,1235,101,94,195,"21 de agosto de 1994"
20,2,223,1236,114,110,224,"21 de agosto de 1994"
20,2,226,1241,529,496,1025,"21 de agosto de 1994"
20,2,226,1242,109,99,208,"21 de agosto de 1994"
20,2,233,1266,395,671,1066,"21 de agosto de 1994"
20,2,246,1296,115,135,250,"21 de agosto de 1994"
20,2,256,1318,266,312,578,"21 de agosto de 1994"
20,2,259,1322,366,374,740,"21 de agosto de 1994"
20,2,259,1323,137,135,272,"21 de agosto de 1994"
20,2,261,1333,89,107,196,"21 de agosto de 1994"
20,2,261,1334,28,23,51,"21 de agosto de 1994"
20,2,261,1335,161,164,325,"21 de agosto de 1994"
20,2,266,1352,75,106,181,"21 de agosto de 1994"
20,2,278,1398,259,319,578,"21 de agosto de 1994"
20,2,278,1399,245,291,536,"21 de agosto de 1994"
20,2,278,1400,170,180,350,"21 de agosto de 1994"
20,2,286,1416,129,125,254,"21 de agosto de 1994"
20,2,294,1437,298,315,613,"21 de agosto de 1994"
20,2,296,1440,345,439,784,"21 de agosto de 1994"
20,2,296,1441,310,393,703,"21 de agosto de 1994"
20,2,296,1442,336,380,716,"21 de agosto de 1994"
20,2,296,1443,306,400,706,"21 de agosto de 1994"
20,2,296,1444,475,555,1030,"21 de agosto de 1994"
20,2,296,1445,154,158,312,"21 de agosto de 1994"
20,2,296,1446,164,171,335,"21 de agosto de 1994"
20,2,296,1447,247,248,495,"21 de agosto de 1994"
20,2,297,1448,211,251,462,"21 de agosto de 1994"
20,2,301,1458,239,330,569,"21 de agosto de 1994"
20,2,324,1541,408,492,900,"21 de agosto de 1994"
20,2,324,1542,192,201,393,"21 de agosto de 1994"
20,2,324,1543,226,212,438,"21 de agosto de 1994"
20,2,328,1555,331,338,669,"21 de agosto de 1994"
20,2,328,1556,376,332,708,"21 de agosto de 1994"
20,2,328,1557,101,92,193,"21 de agosto de 1994"
20,2,333,1585,254,258,512,"21 de agosto de 1994"
20,2,333,1586,252,292,544,"21 de agosto de 1994"
20,2,333,1587,236,181,417,"21 de agosto de 1994"
20,2,333,1588,98,99,197,"21 de agosto de 1994"
20,2,336,1601,184,169,353,"21 de agosto de 1994"
20,2,337,1602,403,462,865,"21 de agosto de 1994"
20,2,337,1603,31,37,68,"21 de agosto de 1994"
20,2,355,1643,243,219,462,"21 de agosto de 1994"
20,2,356,1644,241,319,560,"21 de agosto de 1994"
20,2,356,1645,238,291,529,"21 de agosto de 1994"
20,2,359,1649,240,289,529,"21 de agosto de 1994"
20,2,363,1654,285,300,585,"21 de agosto de 1994"
20,2,363,1655,143,135,278,"21 de agosto de 1994"
20,2,363,1656,94,80,174,"21 de agosto de 1994"
20,2,363,1657,128,100,228,"21 de agosto de 1994"
20,2,365,1665,69,87,156,"21 de agosto de 1994"
20,2,365,1666,197,217,414,"21 de agosto de 1994"
20,2,365,1667,133,122,255,"21 de agosto de 1994"
20,2,418,1860,634,565,1199,"21 de agosto de 1994"
20,2,418,1861,342,285,627,"21 de agosto de 1994"
20,2,418,1862,362,348,710,"21 de agosto de 1994"
20,2,418,1863,84,78,162,"21 de agosto de 1994"
20,2,418,1864,305,323,628,"21 de agosto de 1994"
20,2,418,1865,338,320,658,"21 de agosto de 1994"
20,2,420,1873,155,181,336,"21 de agosto de 1994"
20,2,426,1887,503,465,968,"21 de agosto de 1994"
20,2,433,1907,203,210,413,"21 de agosto de 1994"
20,2,439,1918,295,282,577,"21 de agosto de 1994"
20,2,443,1933,100,119,219,"21 de agosto de 1994"
20,2,444,1934,141,133,274,"21 de agosto de 1994"
20,2,458,1976,282,252,534,"21 de agosto de 1994"
20,2,458,1977,348,318,666,"21 de agosto de 1994"
20,2,460,1987,332,330,662,"21 de agosto de 1994"
20,2,460,1988,310,308,618,"21 de agosto de 1994"
20,2,460,1989,92,93,185,"21 de agosto de 1994"
20,2,460,1990,238,263,501,"21 de agosto de 1994"
20,2,461,1991,262,264,526,"21 de agosto de 1994"
20,2,461,1992,119,113,232,"21 de agosto de 1994"
20,2,469,2025,385,372,757,"21 de agosto de 1994"
20,2,469,2026,273,249,522,"21 de agosto de 1994"
20,2,469,2027,146,113,259,"21 de agosto de 1994"
20,2,469,2028,51,44,95,"21 de agosto de 1994"
20,2,469,2029,310,290,600,"21 de agosto de 1994"
20,2,469,2030,329,288,617,"21 de agosto de 1994"
20,2,469,2031,337,366,703,"21 de agosto de 1994"
20,2,469,2032,356,333,689,"21 de agosto de 1994"
20,2,472,2056,132,129,261,"21 de agosto de 1994"
20,2,474,2060,193,219,412,"21 de agosto de 1994"
20,2,474,2061,150,179,329,"21 de agosto de 1994"
20,2,476,2065,305,390,695,"21 de agosto de 1994"
20,2,476,2066,181,230,411,"21 de agosto de 1994"
20,2,476,2067,223,312,535,"21 de agosto de 1994"
20,2,476,2068,254,312,566,"21 de agosto de 1994"
20,2,476,2069,603,555,1158,"21 de agosto de 1994"
20,2,497,2148,216,225,441,"21 de agosto de 1994"
20,2,497,2149,284,316,600,"21 de agosto de 1994"
20,2,503,2167,238,247,485,"21 de agosto de 1994"
20,2,503,2168,381,410,791,"21 de agosto de 1994"
20,2,503,2169,295,271,566,"21 de agosto de 1994"
20,2,503,2170,259,241,500,"21 de agosto de 1994"
20,2,504,2171,125,120,245,"21 de agosto de 1994"
20,2,505,2172,189,205,394,"21 de agosto de 1994"
20,2,514,2199,198,210,408,"21 de agosto de 1994"
20,2,517,2231,392,370,762,"21 de agosto de 1994"
20,2,517,2232,255,236,491,"21 de agosto de 1994"
20,2,517,2233,104,75,179,"21 de agosto de 1994"
20,2,522,2245,219,246,465,"21 de agosto de 1994"
20,2,540,2311,268,277,545,"21 de agosto de 1994"
20,2,540,2312,207,232,439,"21 de agosto de 1994"
20,2,540,2313,173,172,345,"21 de agosto de 1994"
20,2,540,2314,223,271,494,"21 de agosto de 1994"
20,2,540,2315,121,117,238,"21 de agosto de 1994"
20,2,541,2316,243,236,479,"21 de agosto de 1994"
20,2,541,2317,244,240,484,"21 de agosto de 1994"
20,2,544,2324,341,468,809,"21 de agosto de 1994"
20,2,546,2331,408,450,858,"21 de agosto de 1994"
20,2,546,2332,358,401,759,"21 de agosto de 1994"
20,2,546,2333,429,487,916,"21 de agosto de 1994"
20,2,546,2334,174,195,369,"21 de agosto de 1994"
20,2,550,2352,415,525,940,"21 de agosto de 1994"
20,2,550,2353,230,288,518,"21 de agosto de 1994"
20,2,550,2354,288,359,647,"21 de agosto de 1994"
20,2,550,2355,407,553,960,"21 de agosto de 1994"
20,2,550,2356,262,367,629,"21 de agosto de 1994"
20,2,550,2357,470,619,1089,"21 de agosto de 1994"
20,2,550,2358,336,468,804,"21 de agosto de 1994"
20,2,550,2359,137,201,338,"21 de agosto de 1994"
20,2,550,2360,217,446,663,"21 de agosto de 1994"
20,2,550,2361,100,81,181,"21 de agosto de 1994"
20,2,554,2386,255,334,589,"21 de agosto de 1994"
20,2,554,2387,223,250,473,"21 de agosto de 1994"
20,2,554,2388,235,221,456,"21 de agosto de 1994"
20,2,554,2389,245,235,480,"21 de agosto de 1994"
20,2,554,2390,93,106,199,"21 de agosto de 1994"
20,2,559,2407,323,373,696,"21 de agosto de 1994"
20,2,561,2412,423,438,861,"21 de agosto de 1994"
20,2,561,2413,396,444,840,"21 de agosto de 1994"
20,2,561,2414,262,300,562,"21 de agosto de 1994"
20,2,561,2415,291,367,658,"21 de agosto de 1994"
20,2,561,2416,91,99,190,"21 de agosto de 1994"
20,2,562,2417,216,250,466,"21 de agosto de 1994"
20,2,562,2418,221,253,474,"21 de agosto de 1994"
20,3,3,35,259,271,530,"21 de agosto de 1994"
20,3,3,36,345,389,734,"21 de agosto de 1994"
20,3,3,37,288,370,658,"21 de agosto de 1994"
20,3,3,38,275,304,579,"21 de agosto de 1994"
20,3,26,147,488,517,1005,"21 de agosto de 1994"
20,3,26,148,538,574,1112,"21 de agosto de 1994"
20,3,26,149,360,392,752,"21 de agosto de 1994"
20,3,26,150,363,377,740,"21 de agosto de 1994"
20,3,26,151,609,722,1331,"21 de agosto de 1994"
20,3,26,152,331,412,743,"21 de agosto de 1994"
20,3,66,470,428,456,884,"21 de agosto de 1994"
20,3,66,471,696,732,1428,"21 de agosto de 1994"
20,3,66,472,526,599,1125,"21 de agosto de 1994"
20,3,66,473,296,316,612,"21 de agosto de 1994"
20,3,66,474,376,398,774,"21 de agosto de 1994"
20,3,66,475,339,416,755,"21 de agosto de 1994"
20,3,66,476,310,352,662,"21 de agosto de 1994"
20,3,66,477,324,366,690,"21 de agosto de 1994"
20,3,66,478,336,355,691,"21 de agosto de 1994"
20,3,66,479,360,470,830,"21 de agosto de 1994"
20,3,66,480,388,450,838,"21 de agosto de 1994"
20,3,66,481,683,762,1445,"21 de agosto de 1994"
20,3,66,482,763,881,1644,"21 de agosto de 1994"
20,3,66,483,355,475,830,"21 de agosto de 1994"
20,3,66,484,378,422,800,"21 de agosto de 1994"
20,3,66,485,378,465,843,"21 de agosto de 1994"
20,3,66,486,352,412,764,"21 de agosto de 1994"
20,3,66,487,333,405,738,"21 de agosto de 1994"
20,3,66,488,331,408,739,"21 de agosto de 1994"
20,3,66,489,501,581,1082,"21 de agosto de 1994"
20,3,66,490,431,496,927,"21 de agosto de 1994"
20,3,66,491,430,500,930,"21 de agosto de 1994"
20,3,66,492,386,435,821,"21 de agosto de 1994"
20,3,66,493,422,448,870,"21 de agosto de 1994"
20,3,66,494,410,457,867,"21 de agosto de 1994"
20,3,66,495,490,566,1056,"21 de agosto de 1994"
20,3,66,496,363,405,768,"21 de agosto de 1994"
20,3,66,497,452,523,975,"21 de agosto de 1994"
20,3,66,498,418,560,978,"21 de agosto de 1994"
20,3,66,499,608,730,1338,"21 de agosto de 1994"
20,3,66,500,652,817,1469,"21 de agosto de 1994"
20,3,66,501,360,427,787,"21 de agosto de 1994"
20,3,66,502,550,603,1153,"21 de agosto de 1994"
20,3,66,503,376,449,825,"21 de agosto de 1994"
20,3,66,504,556,644,1200,"21 de agosto de 1994"
20,3,66,505,414,488,902,"21 de agosto de 1994"
20,3,66,506,371,447,818,"21 de agosto de 1994"
20,3,66,507,490,646,1136,"21 de agosto de 1994"
20,3,66,508,354,438,792,"21 de agosto de 1994"
20,3,66,509,550,695,1245,"21 de agosto de 1994"
20,3,66,510,515,702,1217,"21 de agosto de 1994"
20,3,66,511,622,813,1435,"21 de agosto de 1994"
20,3,66,512,477,622,1099,"21 de agosto de 1994"
20,3,66,513,328,382,710,"21 de agosto de 1994"
20,3,66,514,421,506,927,"21 de agosto de 1994"
20,3,66,515,295,392,687,"21 de agosto de 1994"
20,3,66,516,327,379,706,"21 de agosto de 1994"
20,3,66,517,351,448,799,"21 de agosto de 1994"
20,3,66,518,306,408,714,"21 de agosto de 1994"
20,3,66,519,463,611,1074,"21 de agosto de 1994"
20,3,66,520,437,528,965,"21 de agosto de 1994"
20,3,66,521,350,461,811,"21 de agosto de 1994"
20,3,66,522,364,431,795,"21 de agosto de 1994"
20,3,66,523,435,491,926,"21 de agosto de 1994"
20,3,66,524,415,480,895,"21 de agosto de 1994"
20,3,66,525,379,440,819,"21 de agosto de 1994"
20,3,66,526,337,412,749,"21 de agosto de 1994"
20,3,66,527,373,478,851,"21 de agosto de 1994"
20,3,66,528,546,594,1140,"21 de agosto de 1994"
20,3,66,529,492,581,1073,"21 de agosto de 1994"
20,3,66,530,382,500,882,"21 de agosto de 1994"
20,3,66,531,261,333,594,"21 de agosto de 1994"
20,3,66,532,406,513,919,"21 de agosto de 1994"
20,3,66,533,243,293,536,"21 de agosto de 1994"
20,3,66,534,437,612,1049,"21 de agosto de 1994"
20,3,66,535,460,565,1025,"21 de agosto de 1994"
20,3,66,536,285,349,634,"21 de agosto de 1994"
20,3,66,537,427,467,894,"21 de agosto de 1994"
20,3,66,538,421,480,901,"21 de agosto de 1994"
20,3,66,539,294,355,649,"21 de agosto de 1994"
20,3,66,540,278,337,615,"21 de agosto de 1994"
20,3,66,541,363,414,777,"21 de agosto de 1994"
20,3,66,542,278,340,618,"21 de agosto de 1994"
20,3,66,543,280,351,631,"21 de agosto de 1994"
20,3,66,544,330,367,697,"21 de agosto de 1994"
20,3,66,545,305,393,698,"21 de agosto de 1994"
20,3,66,546,207,272,479,"21 de agosto de 1994"
20,3,66,547,510,643,1153,"21 de agosto de 1994"
20,3,66,548,425,498,923,"21 de agosto de 1994"
20,3,66,549,230,278,508,"21 de agosto de 1994"
20,3,66,550,249,331,580,"21 de agosto de 1994"
20,3,66,551,445,515,960,"21 de agosto de 1994"
20,3,66,552,425,513,938,"21 de agosto de 1994"
20,3,66,553,541,625,1166,"21 de agosto de 1994"
20,3,66,554,377,537,914,"21 de agosto de 1994"
20,3,66,555,671,594,1265,"21 de agosto de 1994"
20,3,66,556,343,411,754,"21 de agosto de 1994"
20,3,66,557,326,396,722,"21 de agosto de 1994"
20,3,66,558,290,310,600,"21 de agosto de 1994"
20,3,66,559,342,385,727,"21 de agosto de 1994"
20,3,66,560,475,496,971,"21 de agosto de 1994"
20,3,66,561,351,373,724,"21 de agosto de 1994"
20,3,66,562,328,369,697,"21 de agosto de 1994"
20,3,66,563,326,356,682,"21 de agosto de 1994"
20,3,66,564,391,478,869,"21 de agosto de 1994"
20,3,66,565,283,355,638,"21 de agosto de 1994"
20,3,66,566,469,583,1052,"21 de agosto de 1994"
20,3,66,567,320,398,718,"21 de agosto de 1994"
20,3,66,568,510,706,1216,"21 de agosto de 1994"
20,3,66,569,408,505,913,"21 de agosto de 1994"
20,3,66,570,432,511,943,"21 de agosto de 1994"
20,3,66,571,352,456,808,"21 de agosto de 1994"
20,3,66,572,492,593,1085,"21 de agosto de 1994"
20,3,66,573,419,473,892,"21 de agosto de 1994"
20,3,66,574,606,705,1311,"21 de agosto de 1994"
20,3,66,575,359,357,716,"21 de agosto de 1994"
20,3,66,576,425,447,872,"21 de agosto de 1994"
20,3,66,577,401,435,836,"21 de agosto de 1994"
20,3,66,578,362,393,755,"21 de agosto de 1994"
20,3,66,579,341,393,734,"21 de agosto de 1994"
20,3,66,580,330,405,735,"21 de agosto de 1994"
20,3,66,581,571,621,1192,"21 de agosto de 1994"
20,3,66,582,529,633,1162,"21 de agosto de 1994"
20,3,66,583,602,653,1255,"21 de agosto de 1994"
20,3,66,584,448,541,989,"21 de agosto de 1994"
20,3,66,585,453,557,1010,"21 de agosto de 1994"
20,3,66,586,474,550,1024,"21 de agosto de 1994"
20,3,66,587,422,513,935,"21 de agosto de 1994"
20,3,66,588,372,455,827,"21 de agosto de 1994"
20,3,66,589,587,680,1267,"21 de agosto de 1994"
20,3,66,590,445,515,960,"21 de agosto de 1994"
20,3,66,591,321,363,684,"21 de agosto de 1994"
20,3,66,592,387,471,858,"21 de agosto de 1994"
20,3,66,593,462,527,989,"21 de agosto de 1994"
20,3,66,594,368,404,772,"21 de agosto de 1994"
20,3,66,595,344,338,682,"21 de agosto de 1994"
20,3,66,596,378,449,827,"21 de agosto de 1994"
20,3,66,597,475,555,1030,"21 de agosto de 1994"
20,3,66,598,271,385,656,"21 de agosto de 1994"
20,3,66,599,326,381,707,"21 de agosto de 1994"
20,3,66,600,564,699,1263,"21 de agosto de 1994"
20,3,66,601,318,377,695,"21 de agosto de 1994"
20,3,66,602,378,430,808,"21 de agosto de 1994"
20,3,66,603,232,265,497,"21 de agosto de 1994"
20,3,66,604,445,527,972,"21 de agosto de 1994"
20,3,66,605,441,532,973,"21 de agosto de 1994"
20,3,66,606,431,527,958,"21 de agosto de 1994"
20,3,66,607,545,466,1011,"21 de agosto de 1994"
20,3,66,608,337,404,741,"21 de agosto de 1994"
20,3,66,609,225,241,466,"21 de agosto de 1994"
20,3,66,610,279,312,591,"21 de agosto de 1994"
20,3,66,611,372,435,807,"21 de agosto de 1994"
20,3,66,612,468,591,1059,"21 de agosto de 1994"
20,3,66,613,305,360,665,"21 de agosto de 1994"
20,3,66,614,330,351,681,"21 de agosto de 1994"
20,3,66,615,187,204,391,"21 de agosto de 1994"
20,3,66,616,297,336,633,"21 de agosto de 1994"
20,3,66,1748,1,0,1,"21 de agosto de 1994"
20,3,75,668,316,317,633,"21 de agosto de 1994"
20,3,80,717,394,473,867,"21 de agosto de 1994"
20,3,80,718,327,329,656,"21 de agosto de 1994"
20,3,84,736,293,398,691,"21 de agosto de 1994"
20,3,84,737,218,300,518,"21 de agosto de 1994"
20,3,88,747,262,246,508,"21 de agosto de 1994"
20,3,88,748,329,392,721,"21 de agosto de 1994"
20,3,89,749,369,406,775,"21 de agosto de 1994"
20,3,104,777,607,637,1244,"21 de agosto de 1994"
20,3,104,778,425,461,886,"21 de agosto de 1994"
20,3,104,779,365,413,778,"21 de agosto de 1994"
20,3,104,780,377,425,802,"21 de agosto de 1994"
20,3,104,781,401,464,865,"21 de agosto de 1994"
20,3,112,798,308,352,660,"21 de agosto de 1994"
20,3,112,799,422,445,867,"21 de agosto de 1994"
20,3,112,800,239,287,526,"21 de agosto de 1994"
20,3,154,917,475,579,1054,"21 de agosto de 1994"
20,3,154,918,373,398,771,"21 de agosto de 1994"
20,3,154,919,282,317,599,"21 de agosto de 1994"
20,3,161,934,297,334,631,"21 de agosto de 1994"
20,3,161,935,244,272,516,"21 de agosto de 1994"
20,3,161,936,278,325,603,"21 de agosto de 1994"
20,3,161,937,214,322,536,"21 de agosto de 1994"
20,3,198,1137,430,512,942,"21 de agosto de 1994"
20,3,198,1138,265,331,596,"21 de agosto de 1994"
20,3,219,1226,351,449,800,"21 de agosto de 1994"
20,3,219,1227,320,375,695,"21 de agosto de 1994"
20,3,308,1482,357,371,728,"21 de agosto de 1994"
20,3,308,1483,339,370,709,"21 de agosto de 1994"
20,3,339,1605,352,434,786,"21 de agosto de 1994"
20,3,340,1606,500,590,1090,"21 de agosto de 1994"
20,3,346,1626,457,559,1016,"21 de agosto de 1994"
20,3,347,1627,681,763,1444,"21 de agosto de 1994"
20,3,347,1628,317,378,695,"21 de agosto de 1994"
20,3,347,1629,236,285,521,"21 de agosto de 1994"
20,3,347,1630,247,352,599,"21 de agosto de 1994"
20,3,347,1631,131,159,290,"21 de agosto de 1994"
20,3,347,1632,156,191,347,"21 de agosto de 1994"
20,3,347,1633,79,101,180,"21 de agosto de 1994"
20,3,376,1686,366,358,724,"21 de agosto de 1994"
20,3,376,1687,375,426,801,"21 de agosto de 1994"
20,3,376,1688,353,452,805,"21 de agosto de 1994"
20,3,376,1689,297,413,710,"21 de agosto de 1994"
20,3,381,1703,381,389,770,"21 de agosto de 1994"
20,3,386,1712,445,509,954,"21 de agosto de 1994"
20,3,386,1713,477,552,1029,"21 de agosto de 1994"
20,3,386,1714,386,462,848,"21 de agosto de 1994"
20,3,386,1715,385,430,815,"21 de agosto de 1994"
20,3,386,1716,583,631,1214,"21 de agosto de 1994"
20,3,386,1717,498,568,1066,"21 de agosto de 1994"
20,3,386,1718,601,609,1210,"21 de agosto de 1994"
20,3,386,1719,453,516,969,"21 de agosto de 1994"
20,3,386,1720,451,506,957,"21 de agosto de 1994"
20,3,386,1721,432,478,910,"21 de agosto de 1994"
20,3,386,1722,501,535,1036,"21 de agosto de 1994"
20,3,386,1723,410,428,838,"21 de agosto de 1994"
20,3,386,1724,459,548,1007,"21 de agosto de 1994"
20,3,386,1725,516,584,1100,"21 de agosto de 1994"
20,3,386,1726,571,640,1211,"21 de agosto de 1994"
20,3,386,1727,437,478,915,"21 de agosto de 1994"
20,3,386,1728,185,193,378,"21 de agosto de 1994"
20,3,386,1729,397,451,848,"21 de agosto de 1994"
20,3,392,1746,347,509,856,"21 de agosto de 1994"
20,3,392,1747,652,63,715,"21 de agosto de 1994"
20,3,392,1748,352,397,749,"21 de agosto de 1994"
20,3,392,1749,297,400,697,"21 de agosto de 1994"
20,3,392,1750,417,491,908,"21 de agosto de 1994"
20,3,392,1751,347,393,740,"21 de agosto de 1994"
20,3,392,1752,381,441,822,"21 de agosto de 1994"
20,3,392,1753,365,460,825,"21 de agosto de 1994"
20,3,392,1754,374,448,822,"21 de agosto de 1994"
20,3,392,1755,399,501,900,"21 de agosto de 1994"
20,3,392,1756,350,386,736,"21 de agosto de 1994"
20,3,392,1757,560,646,1206,"21 de agosto de 1994"
20,3,392,1758,600,696,1296,"21 de agosto de 1994"
20,3,392,1759,431,495,926,"21 de agosto de 1994"
20,3,392,1760,366,398,764,"21 de agosto de 1994"
20,3,392,1761,409,486,895,"21 de agosto de 1994"
20,3,392,1762,525,559,1084,"21 de agosto de 1994"
20,3,392,1763,307,316,623,"21 de agosto de 1994"
20,3,392,1764,319,362,681,"21 de agosto de 1994"
20,3,392,1765,398,440,838,"21 de agosto de 1994"
20,3,392,1766,345,387,732,"21 de agosto de 1994"
20,3,392,1767,391,450,841,"21 de agosto de 1994"
20,3,392,1768,413,327,740,"21 de agosto de 1994"
20,3,400,1784,382,405,787,"21 de agosto de 1994"
20,3,400,1785,807,818,1625,"21 de agosto de 1994"
20,3,400,1786,421,481,902,"21 de agosto de 1994"
20,3,408,1827,339,325,664,"21 de agosto de 1994"
20,3,410,1829,355,389,744,"21 de agosto de 1994"
20,3,410,1830,284,391,675,"21 de agosto de 1994"
20,3,410,1831,332,439,771,"21 de agosto de 1994"
20,3,410,1832,362,362,724,"21 de agosto de 1994"
20,3,410,1833,239,254,493,"21 de agosto de 1994"
20,3,412,1838,170,199,369,"21 de agosto de 1994"
20,3,519,2235,288,293,581,"21 de agosto de 1994"
20,3,519,2236,270,276,546,"21 de agosto de 1994"
20,3,552,2363,222,255,477,"21 de agosto de 1994"
20,3,552,2364,401,389,790,"21 de agosto de 1994"
20,3,552,2365,289,312,601,"21 de agosto de 1994"
20,3,552,2366,288,348,636,"21 de agosto de 1994"
20,4,2,2,261,258,519,"21 de agosto de 1994"
20,4,2,3,469,539,1008,"21 de agosto de 1994"
20,4,2,4,383,428,811,"21 de agosto de 1994"
20,4,2,5,293,256,549,"21 de agosto de 1994"
20,4,2,6,525,562,1087,"21 de agosto de 1994"
20,4,2,7,302,258,560,"21 de agosto de 1994"
20,4,2,8,202,198,400,"21 de agosto de 1994"
20,4,2,9,312,349,661,"21 de agosto de 1994"
20,4,2,10,400,488,888,"21 de agosto de 1994"
20,4,2,11,446,472,918,"21 de agosto de 1994"
20,4,2,12,441,482,923,"21 de agosto de 1994"
20,4,2,13,217,216,433,"21 de agosto de 1994"
20,4,2,14,255,198,453,"21 de agosto de 1994"
20,4,2,15,274,232,506,"21 de agosto de 1994"
20,4,2,16,112,84,196,"21 de agosto de 1994"
20,4,2,17,389,427,816,"21 de agosto de 1994"
20,4,2,18,173,152,325,"21 de agosto de 1994"
20,4,2,19,175,188,363,"21 de agosto de 1994"
20,4,2,20,222,232,454,"21 de agosto de 1994"
20,4,2,21,375,338,713,"21 de agosto de 1994"
20,4,2,22,210,179,389,"21 de agosto de 1994"
20,4,2,23,211,212,423,"21 de agosto de 1994"
20,4,2,24,383,336,719,"21 de agosto de 1994"
20,4,2,25,249,225,474,"21 de agosto de 1994"
20,4,2,26,341,311,652,"21 de agosto de 1994"
20,4,2,27,254,238,492,"21 de agosto de 1994"
20,4,2,28,272,252,524,"21 de agosto de 1994"
20,4,2,29,412,347,759,"21 de agosto de 1994"
20,4,2,30,246,242,488,"21 de agosto de 1994"
20,4,2,31,519,504,1023,"21 de agosto de 1994"
20,4,2,32,87,87,174,"21 de agosto de 1994"
20,4,2,33,407,405,812,"21 de agosto de 1994"
20,4,2,34,444,406,850,"21 de agosto de 1994"
20,4,24,134,360,408,768,"21 de agosto de 1994"
20,4,24,135,478,528,1006,"21 de agosto de 1994"
20,4,24,136,442,449,891,"21 de agosto de 1994"
20,4,24,137,248,250,498,"21 de agosto de 1994"
20,4,24,138,306,295,601,"21 de agosto de 1994"
20,4,24,139,397,400,797,"21 de agosto de 1994"
20,4,24,140,191,166,357,"21 de agosto de 1994"
20,4,24,141,298,281,579,"21 de agosto de 1994"
20,4,24,142,156,114,270,"21 de agosto de 1994"
20,4,24,143,229,278,507,"21 de agosto de 1994"
20,4,38,232,358,360,718,"21 de agosto de 1994"
20,4,38,233,103,98,201,"21 de agosto de 1994"
20,4,38,234,212,227,439,"21 de agosto de 1994"
20,4,38,235,324,389,713,"21 de agosto de 1994"
20,4,44,333,261,276,537,"21 de agosto de 1994"
20,4,44,334,299,313,612,"21 de agosto de 1994"
20,4,44,335,240,253,493,"21 de agosto de 1994"
20,4,44,336,262,276,538,"21 de agosto de 1994"
20,4,44,337,374,460,834,"21 de agosto de 1994"
20,4,44,338,470,520,990,"21 de agosto de 1994"
20,4,44,339,429,461,890,"21 de agosto de 1994"
20,4,44,340,274,288,562,"21 de agosto de 1994"
20,4,44,341,222,178,400,"21 de agosto de 1994"
20,4,44,342,430,523,953,"21 de agosto de 1994"
20,4,44,343,409,430,839,"21 de agosto de 1994"
20,4,44,344,304,362,666,"21 de agosto de 1994"
20,4,44,345,418,436,854,"21 de agosto de 1994"
20,4,44,346,180,178,358,"21 de agosto de 1994"
20,4,44,347,241,230,471,"21 de agosto de 1994"
20,4,44,348,403,451,854,"21 de agosto de 1994"
20,4,44,349,243,309,552,"21 de agosto de 1994"
20,4,44,350,167,210,377,"21 de agosto de 1994"
20,4,44,351,424,464,888,"21 de agosto de 1994"
20,4,44,352,463,518,981,"21 de agosto de 1994"
20,4,44,353,162,167,329,"21 de agosto de 1994"
20,4,44,354,380,475,855,"21 de agosto de 1994"
20,4,44,355,223,219,442,"21 de agosto de 1994"
20,4,44,356,123,139,262,"21 de agosto de 1994"
20,4,44,357,395,396,791,"21 de agosto de 1994"
20,4,44,358,213,169,382,"21 de agosto de 1994"
20,4,44,359,322,296,618,"21 de agosto de 1994"
20,4,44,360,380,322,702,"21 de agosto de 1994"
20,4,44,361,353,330,683,"21 de agosto de 1994"
20,4,44,362,402,352,754,"21 de agosto de 1994"
20,4,44,363,225,233,458,"21 de agosto de 1994"
20,4,44,364,144,140,284,"21 de agosto de 1994"
20,4,115,804,299,331,630,"21 de agosto de 1994"
20,4,115,805,218,272,490,"21 de agosto de 1994"
20,4,115,806,157,151,308,"21 de agosto de 1994"
20,4,167,952,581,573,1154,"21 de agosto de 1994"
20,4,167,953,128,131,259,"21 de agosto de 1994"
20,4,167,954,204,188,392,"21 de agosto de 1994"
20,4,170,962,490,557,1047,"21 de agosto de 1994"
20,4,170,963,157,173,330,"21 de agosto de 1994"
20,4,170,964,158,155,313,"21 de agosto de 1994"
20,4,170,965,150,124,274,"21 de agosto de 1994"
20,4,170,966,356,260,616,"21 de agosto de 1994"
20,4,170,967,283,284,567,"21 de agosto de 1994"
20,4,170,968,100,78,178,"21 de agosto de 1994"
20,4,170,969,177,182,359,"21 de agosto de 1994"
20,4,170,970,284,280,564,"21 de agosto de 1994"
20,4,170,971,52,59,111,"21 de agosto de 1994"
20,4,170,972,479,467,946,"21 de agosto de 1994"
20,4,170,973,132,129,261,"21 de agosto de 1994"
20,4,170,974,122,127,249,"21 de agosto de 1994"
20,4,170,975,223,200,423,"21 de agosto de 1994"
20,4,170,976,286,261,547,"21 de agosto de 1994"
20,4,170,977,314,257,571,"21 de agosto de 1994"
20,4,182,1010,409,400,809,"21 de agosto de 1994"
20,4,182,1011,264,278,542,"21 de agosto de 1994"
20,4,182,1012,250,260,510,"21 de agosto de 1994"
20,4,182,1013,272,323,595,"21 de agosto de 1994"
20,4,182,1014,346,341,687,"21 de agosto de 1994"
20,4,182,1015,408,438,846,"21 de agosto de 1994"
20,4,182,1016,372,406,778,"21 de agosto de 1994"
20,4,182,1017,486,549,1035,"21 de agosto de 1994"
20,4,182,1018,380,367,747,"21 de agosto de 1994"
20,4,182,1019,443,450,893,"21 de agosto de 1994"
20,4,182,1020,449,520,969,"21 de agosto de 1994"
20,4,182,1021,418,486,904,"21 de agosto de 1994"
20,4,182,1022,681,806,1487,"21 de agosto de 1994"
20,4,182,1023,493,533,1026,"21 de agosto de 1994"
20,4,182,1024,558,615,1173,"21 de agosto de 1994"
20,4,182,1025,394,414,808,"21 de agosto de 1994"
20,4,182,1026,195,217,412,"21 de agosto de 1994"
20,4,182,1027,287,320,607,"21 de agosto de 1994"
20,4,182,1028,474,539,1013,"21 de agosto de 1994"
20,4,182,1029,478,564,1042,"21 de agosto de 1994"
20,4,182,1030,395,433,828,"21 de agosto de 1994"
20,4,182,1031,503,536,1039,"21 de agosto de 1994"
20,4,182,1032,332,326,658,"21 de agosto de 1994"
20,4,182,1033,437,477,914,"21 de agosto de 1994"
20,4,182,1034,280,297,577,"21 de agosto de 1994"
20,4,182,1035,530,571,1101,"21 de agosto de 1994"
20,4,182,1036,517,529,1046,"21 de agosto de 1994"
20,4,182,1037,175,164,339,"21 de agosto de 1994"
20,4,182,1038,498,561,1059,"21 de agosto de 1994"
20,4,182,1039,519,524,1043,"21 de agosto de 1994"
20,4,182,1040,242,268,510,"21 de agosto de 1994"
20,4,182,1041,249,254,503,"21 de agosto de 1994"
20,4,182,1042,643,623,1266,"21 de agosto de 1994"
20,4,182,1043,407,430,837,"21 de agosto de 1994"
20,4,182,1044,340,341,681,"21 de agosto de 1994"
20,4,182,1045,344,330,674,"21 de agosto de 1994"
20,4,182,1046,288,325,613,"21 de agosto de 1994"
20,4,182,1047,274,312,586,"21 de agosto de 1994"
20,4,182,1048,578,576,1154,"21 de agosto de 1994"
20,4,182,1049,240,223,463,"21 de agosto de 1994"
20,4,182,1050,349,319,668,"21 de agosto de 1994"
20,4,182,1051,505,447,952,"21 de agosto de 1994"
20,4,182,1052,491,500,991,"21 de agosto de 1994"
20,4,182,1053,477,486,963,"21 de agosto de 1994"
20,4,182,1054,407,480,887,"21 de agosto de 1994"
20,4,182,1055,413,476,889,"21 de agosto de 1994"
20,4,182,1056,647,621,1268,"21 de agosto de 1994"
20,4,182,1057,376,304,680,"21 de agosto de 1994"
20,4,182,1058,478,403,881,"21 de agosto de 1994"
20,4,182,1059,225,216,441,"21 de agosto de 1994"
20,4,182,1060,448,448,896,"21 de agosto de 1994"
20,4,182,1061,348,313,661,"21 de agosto de 1994"
20,4,182,1062,389,363,752,"21 de agosto de 1994"
20,4,182,1063,215,188,403,"21 de agosto de 1994"
20,4,182,1064,654,595,1249,"21 de agosto de 1994"
20,4,182,1065,346,258,604,"21 de agosto de 1994"
20,4,182,1066,370,342,712,"21 de agosto de 1994"
20,4,182,1067,264,241,505,"21 de agosto de 1994"
20,4,182,1068,323,306,629,"21 de agosto de 1994"
20,4,182,1069,623,653,1276,"21 de agosto de 1994"
20,4,182,1070,462,348,810,"21 de agosto de 1994"
20,4,182,1071,200,165,365,"21 de agosto de 1994"
20,4,182,1072,336,326,662,"21 de agosto de 1994"
20,4,182,1073,438,418,856,"21 de agosto de 1994"
20,4,182,1074,294,331,625,"21 de agosto de 1994"
20,4,182,1075,430,382,812,"21 de agosto de 1994"
20,4,182,1076,344,268,612,"21 de agosto de 1994"
20,4,182,1077,187,147,334,"21 de agosto de 1994"
20,4,182,1078,474,427,901,"21 de agosto de 1994"
20,4,182,1079,458,440,898,"21 de agosto de 1994"
20,4,182,1080,310,281,591,"21 de agosto de 1994"
20,4,182,1081,516,469,985,"21 de agosto de 1994"
20,4,182,1082,256,227,483,"21 de agosto de 1994"
20,4,182,1083,256,292,548,"21 de agosto de 1994"
20,4,189,1111,432,493,925,"21 de agosto de 1994"
20,4,232,1254,224,239,463,"21 de agosto de 1994"
20,4,232,1255,368,471,839,"21 de agosto de 1994"
20,4,232,1256,349,401,750,"21 de agosto de 1994"
20,4,232,1257,257,274,531,"21 de agosto de 1994"
20,4,232,1258,335,376,711,"21 de agosto de 1994"
20,4,232,1259,445,437,882,"21 de agosto de 1994"
20,4,232,1260,265,269,534,"21 de agosto de 1994"
20,4,232,1261,379,388,767,"21 de agosto de 1994"
20,4,232,1262,247,232,479,"21 de agosto de 1994"
20,4,232,1263,474,476,950,"21 de agosto de 1994"
20,4,232,1264,359,282,641,"21 de agosto de 1994"
20,4,232,1265,167,146,313,"21 de agosto de 1994"
20,4,276,1372,342,333,675,"21 de agosto de 1994"
20,4,276,1373,284,303,587,"21 de agosto de 1994"
20,4,276,1374,340,356,696,"21 de agosto de 1994"
20,4,276,1375,324,371,695,"21 de agosto de 1994"
20,4,276,1376,317,310,627,"21 de agosto de 1994"
20,4,276,1377,336,292,628,"21 de agosto de 1994"
20,4,276,1378,110,85,195,"21 de agosto de 1994"
20,4,276,1379,403,346,749,"21 de agosto de 1994"
20,4,276,1380,247,192,439,"21 de agosto de 1994"
20,4,276,1381,233,207,440,"21 de agosto de 1994"
20,4,276,1382,322,291,613,"21 de agosto de 1994"
20,4,276,1383,424,453,877,"21 de agosto de 1994"
20,4,276,1384,278,284,562,"21 de agosto de 1994"
20,4,276,1385,355,361,716,"21 de agosto de 1994"
20,4,276,1386,470,403,873,"21 de agosto de 1994"
20,4,276,1387,234,219,453,"21 de agosto de 1994"
20,4,276,1388,425,334,759,"21 de agosto de 1994"
20,4,276,1389,261,246,507,"21 de agosto de 1994"
20,4,276,1390,233,177,410,"21 de agosto de 1994"
20,4,276,1391,309,282,591,"21 de agosto de 1994"
20,4,276,1392,374,345,719,"21 de agosto de 1994"
20,4,276,1393,309,282,591,"21 de agosto de 1994"
20,4,276,1394,151,145,296,"21 de agosto de 1994"
20,4,276,1395,287,213,500,"21 de agosto de 1994"
20,4,307,1473,347,378,725,"21 de agosto de 1994"
20,4,307,1474,471,501,972,"21 de agosto de 1994"
20,4,307,1475,118,113,231,"21 de agosto de 1994"
20,4,307,1476,242,236,478,"21 de agosto de 1994"
20,4,307,1477,145,146,291,"21 de agosto de 1994"
20,4,307,1478,277,321,598,"21 de agosto de 1994"
20,4,307,1479,180,185,365,"21 de agosto de 1994"
20,4,307,1480,208,222,430,"21 de agosto de 1994"
20,4,307,1481,176,180,356,"21 de agosto de 1994"
20,4,404,1793,375,381,756,"21 de agosto de 1994"
20,4,404,1794,317,295,612,"21 de agosto de 1994"
20,4,404,1795,428,398,826,"21 de agosto de 1994"
20,4,404,1796,378,304,682,"21 de agosto de 1994"
20,4,404,1797,214,190,404,"21 de agosto de 1994"
20,4,404,1798,294,299,593,"21 de agosto de 1994"
20,4,404,1799,158,146,304,"21 de agosto de 1994"
20,4,404,1800,214,193,407,"21 de agosto de 1994"
20,4,404,1801,58,43,101,"21 de agosto de 1994"
20,4,404,1802,206,216,422,"21 de agosto de 1994"
20,4,404,1803,248,222,470,"21 de agosto de 1994"
20,4,404,1804,78,69,147,"21 de agosto de 1994"
20,4,404,1805,297,303,600,"21 de agosto de 1994"
20,4,404,1806,95,94,189,"21 de agosto de 1994"
20,4,404,1807,86,75,161,"21 de agosto de 1994"
20,4,404,1808,184,173,357,"21 de agosto de 1994"
20,4,404,1809,244,272,516,"21 de agosto de 1994"
20,5,10,70,348,462,810,"21 de agosto de 1994"
20,5,10,71,264,343,607,"21 de agosto de 1994"
20,5,10,72,268,380,648,"21 de agosto de 1994"
20,5,10,73,73,87,160,"21 de agosto de 1994"
20,5,17,111,308,477,785,"21 de agosto de 1994"
20,5,17,112,256,404,660,"21 de agosto de 1994"
20,5,22,127,391,395,786,"21 de agosto de 1994"
20,5,22,128,141,130,271,"21 de agosto de 1994"
20,5,22,129,28,29,57,"21 de agosto de 1994"
20,5,22,130,236,209,445,"21 de agosto de 1994"
20,5,27,153,321,314,635,"21 de agosto de 1994"
20,5,27,154,108,104,212,"21 de agosto de 1994"
20,5,27,155,363,314,677,"21 de agosto de 1994"
20,5,27,156,142,129,271,"21 de agosto de 1994"
20,5,29,176,322,405,727,"21 de agosto de 1994"
20,5,29,177,45,57,102,"21 de agosto de 1994"
20,5,29,178,101,77,178,"21 de agosto de 1994"
20,5,29,179,204,229,433,"21 de agosto de 1994"
20,5,33,192,451,516,967,"21 de agosto de 1994"
20,5,39,236,427,507,934,"21 de agosto de 1994"
20,5,39,237,317,377,694,"21 de agosto de 1994"
20,5,39,238,288,354,642,"21 de agosto de 1994"
20,5,39,239,387,460,847,"21 de agosto de 1994"
20,5,39,240,291,322,613,"21 de agosto de 1994"
20,5,39,241,235,314,549,"21 de agosto de 1994"
20,5,39,242,123,152,275,"21 de agosto de 1994"
20,5,39,243,224,251,475,"21 de agosto de 1994"
20,5,39,244,328,420,748,"21 de agosto de 1994"
20,5,39,245,144,154,298,"21 de agosto de 1994"
20,5,39,246,330,340,670,"21 de agosto de 1994"
20,5,39,247,607,589,1196,"21 de agosto de 1994"
20,5,39,248,479,525,1004,"21 de agosto de 1994"
20,5,39,249,200,226,426,"21 de agosto de 1994"
20,5,39,250,611,704,1315,"21 de agosto de 1994"
20,5,39,251,300,369,669,"21 de agosto de 1994"
20,5,39,252,330,347,677,"21 de agosto de 1994"
20,5,39,253,314,366,680,"21 de agosto de 1994"
20,5,39,254,199,240,439,"21 de agosto de 1994"
20,5,45,365,309,336,645,"21 de agosto de 1994"
20,5,45,366,369,384,753,"21 de agosto de 1994"
20,5,45,367,129,128,257,"21 de agosto de 1994"
20,5,45,368,140,136,276,"21 de agosto de 1994"
20,5,47,373,199,200,399,"21 de agosto de 1994"
20,5,58,422,466,527,993,"21 de agosto de 1994"
20,5,58,423,179,167,346,"21 de agosto de 1994"
20,5,58,424,209,230,439,"21 de agosto de 1994"
20,5,58,425,255,214,469,"21 de agosto de 1994"
20,5,58,426,329,300,629,"21 de agosto de 1994"
20,5,58,427,174,171,345,"21 de agosto de 1994"
20,5,58,428,206,189,395,"21 de agosto de 1994"
20,5,58,429,187,153,340,"21 de agosto de 1994"
20,5,58,430,186,167,353,"21 de agosto de 1994"
20,5,58,431,246,232,478,"21 de agosto de 1994"
20,5,63,459,378,439,817,"21 de agosto de 1994"
20,5,63,460,454,476,930,"21 de agosto de 1994"
20,5,74,666,371,425,796,"21 de agosto de 1994"
20,5,74,667,263,285,548,"21 de agosto de 1994"
20,5,81,719,350,347,697,"21 de agosto de 1994"
20,5,81,720,342,369,711,"21 de agosto de 1994"
20,5,91,751,214,249,463,"21 de agosto de 1994"
20,5,91,752,221,241,462,"21 de agosto de 1994"
20,5,99,764,423,464,887,"21 de agosto de 1994"
20,5,99,765,276,308,584,"21 de agosto de 1994"
20,5,101,770,357,332,689,"21 de agosto de 1994"
20,5,101,771,105,125,230,"21 de agosto de 1994"
20,5,106,788,321,347,668,"21 de agosto de 1994"
20,5,120,812,235,220,455,"21 de agosto de 1994"
20,5,120,813,263,302,565,"21 de agosto de 1994"
20,5,132,862,314,297,611,"21 de agosto de 1994"
20,5,132,863,394,397,791,"21 de agosto de 1994"
20,5,132,864,290,276,566,"21 de agosto de 1994"
20,5,132,865,251,281,532,"21 de agosto de 1994"
20,5,139,882,272,328,600,"21 de agosto de 1994"
20,5,147,900,397,439,836,"21 de agosto de 1994"
20,5,147,901,376,404,780,"21 de agosto de 1994"
20,5,147,902,480,488,968,"21 de agosto de 1994"
20,5,147,903,547,630,1177,"21 de agosto de 1994"
20,5,147,904,79,88,167,"21 de agosto de 1994"
20,5,147,905,96,96,192,"21 de agosto de 1994"
20,5,158,927,143,190,333,"21 de agosto de 1994"
20,5,158,928,110,110,220,"21 de agosto de 1994"
20,5,158,929,254,288,542,"21 de agosto de 1994"
20,5,158,930,154,198,352,"21 de agosto de 1994"
20,5,160,932,276,315,591,"21 de agosto de 1994"
20,5,160,933,44,51,95,"21 de agosto de 1994"
20,5,173,981,340,338,678,"21 de agosto de 1994"
20,5,175,986,284,245,529,"21 de agosto de 1994"
20,5,175,987,278,299,577,"21 de agosto de 1994"
20,5,175,988,254,284,538,"21 de agosto de 1994"
20,5,175,989,137,130,267,"21 de agosto de 1994"
20,5,175,990,105,95,200,"21 de agosto de 1994"
20,5,175,991,71,72,143,"21 de agosto de 1994"
20,5,175,992,81,91,172,"21 de agosto de 1994"
20,5,175,993,294,292,586,"21 de agosto de 1994"
20,5,175,994,168,125,293,"21 de agosto de 1994"
20,5,175,995,204,244,448,"21 de agosto de 1994"
20,5,175,996,161,168,329,"21 de agosto de 1994"
20,5,175,997,108,93,201,"21 de agosto de 1994"
20,5,175,998,65,74,139,"21 de agosto de 1994"
20,5,176,999,224,252,476,"21 de agosto de 1994"
20,5,176,1000,214,283,497,"21 de agosto de 1994"
20,5,176,1001,383,405,788,"21 de agosto de 1994"
20,5,177,1002,331,322,653,"21 de agosto de 1994"
20,5,193,1129,455,398,853,"21 de agosto de 1994"
20,5,193,1130,171,144,315,"21 de agosto de 1994"
20,5,194,1131,284,293,577,"21 de agosto de 1994"
20,5,194,1132,283,298,581,"21 de agosto de 1994"
20,5,217,1221,131,133,264,"21 de agosto de 1994"
20,5,217,1222,171,188,359,"21 de agosto de 1994"
20,5,217,1223,233,249,482,"21 de agosto de 1994"
20,5,217,1224,48,62,110,"21 de agosto de 1994"
20,5,220,1228,162,155,317,"21 de agosto de 1994"
20,5,220,1229,268,234,502,"21 de agosto de 1994"
20,5,220,1230,163,141,304,"21 de agosto de 1994"
20,5,220,1231,174,162,336,"21 de agosto de 1994"
20,5,227,1243,586,610,1196,"21 de agosto de 1994"
20,5,227,1244,310,292,602,"21 de agosto de 1994"
20,5,227,1245,317,328,645,"21 de agosto de 1994"
20,5,227,1246,392,474,866,"21 de agosto de 1994"
20,5,227,1247,265,265,530,"21 de agosto de 1994"
20,5,228,1248,162,159,321,"21 de agosto de 1994"
20,5,234,1267,365,382,747,"21 de agosto de 1994"
20,5,234,1268,214,228,442,"21 de agosto de 1994"
20,5,234,1269,310,341,651,"21 de agosto de 1994"
20,5,234,1270,409,376,785,"21 de agosto de 1994"
20,5,243,1291,426,444,870,"21 de agosto de 1994"
20,5,244,1292,429,441,870,"21 de agosto de 1994"
20,5,244,1293,299,276,575,"21 de agosto de 1994"
20,5,255,1316,309,331,640,"21 de agosto de 1994"
20,5,255,1317,242,253,495,"21 de agosto de 1994"
20,5,270,1361,227,210,437,"21 de agosto de 1994"
20,5,270,1362,217,204,421,"21 de agosto de 1994"
20,5,272,1365,369,410,779,"21 de agosto de 1994"
20,5,272,1366,360,374,734,"21 de agosto de 1994"
20,5,275,1371,218,228,446,"21 de agosto de 1994"
20,5,290,1422,282,284,566,"21 de agosto de 1994"
20,5,291,1423,232,248,480,"21 de agosto de 1994"
20,5,291,1424,298,312,610,"21 de agosto de 1994"
20,5,291,1425,508,572,1080,"21 de agosto de 1994"
20,5,292,1426,219,272,491,"21 de agosto de 1994"
20,5,292,1427,305,340,645,"21 de agosto de 1994"
20,5,292,1428,306,337,643,"21 de agosto de 1994"
20,5,292,1429,317,383,700,"21 de agosto de 1994"
20,5,292,1430,45,51,96,"21 de agosto de 1994"
20,5,293,1431,274,347,621,"21 de agosto de 1994"
20,5,293,1432,333,479,812,"21 de agosto de 1994"
20,5,293,1433,315,418,733,"21 de agosto de 1994"
20,5,293,1434,227,302,529,"21 de agosto de 1994"
20,5,293,1435,238,311,549,"21 de agosto de 1994"
20,5,293,1436,264,315,579,"21 de agosto de 1994"
20,5,309,1484,125,143,268,"21 de agosto de 1994"
20,5,311,1492,273,309,582,"21 de agosto de 1994"
20,5,320,1514,165,197,362,"21 de agosto de 1994"
20,5,354,1642,114,116,230,"21 de agosto de 1994"
20,5,358,1647,273,393,666,"21 de agosto de 1994"
20,5,358,1648,195,233,428,"21 de agosto de 1994"
20,5,360,1650,369,482,851,"21 de agosto de 1994"
20,5,360,1651,261,310,571,"21 de agosto de 1994"
20,5,369,1675,380,448,828,"21 de agosto de 1994"
20,5,375,1685,206,252,458,"21 de agosto de 1994"
20,5,379,1699,237,246,483,"21 de agosto de 1994"
20,5,379,1700,93,86,179,"21 de agosto de 1994"
20,5,379,1701,284,342,626,"21 de agosto de 1994"
20,5,388,1738,216,299,515,"21 de agosto de 1994"
20,5,388,1739,231,328,559,"21 de agosto de 1994"
20,5,388,1740,90,113,203,"21 de agosto de 1994"
20,5,389,1741,359,397,756,"21 de agosto de 1994"
20,5,390,1742,210,327,537,"21 de agosto de 1994"
20,5,399,1782,315,488,803,"21 de agosto de 1994"
20,5,399,1783,246,338,584,"21 de agosto de 1994"
20,5,417,1859,187,202,389,"21 de agosto de 1994"
20,5,428,1898,240,264,504,"21 de agosto de 1994"
20,5,428,1899,286,303,589,"21 de agosto de 1994"
20,5,428,1900,252,270,522,"21 de agosto de 1994"
20,5,428,1901,245,240,485,"21 de agosto de 1994"
20,5,428,1902,206,223,429,"21 de agosto de 1994"
20,5,432,1906,477,443,920,"21 de agosto de 1994"
20,5,435,1909,278,371,649,"21 de agosto de 1994"
20,5,435,1910,305,367,672,"21 de agosto de 1994"
20,5,437,1913,261,269,530,"21 de agosto de 1994"
20,5,479,2072,275,295,570,"21 de agosto de 1994"
20,5,479,2073,106,119,225,"21 de agosto de 1994"
20,5,479,2074,156,162,318,"21 de agosto de 1994"
20,5,479,2075,125,104,229,"21 de agosto de 1994"
20,5,485,2112,451,526,977,"21 de agosto de 1994"
20,5,485,2113,352,368,720,"21 de agosto de 1994"
20,5,485,2114,337,365,702,"21 de agosto de 1994"
20,5,485,2115,146,144,290,"21 de agosto de 1994"
20,5,485,2116,225,220,445,"21 de agosto de 1994"
20,5,488,2125,174,188,362,"21 de agosto de 1994"
20,5,488,2126,220,208,428,"21 de agosto de 1994"
20,5,491,2131,293,348,641,"21 de agosto de 1994"
20,5,491,2132,175,216,391,"21 de agosto de 1994"
20,5,495,2140,251,289,540,"21 de agosto de 1994"
20,5,495,2141,217,243,460,"21 de agosto de 1994"
20,5,495,2142,229,263,492,"21 de agosto de 1994"
20,5,495,2143,144,189,333,"21 de agosto de 1994"
20,5,511,2186,151,145,296,"21 de agosto de 1994"
20,5,511,2187,164,164,328,"21 de agosto de 1994"
20,5,511,2188,356,351,707,"21 de agosto de 1994"
20,5,527,2261,394,336,730,"21 de agosto de 1994"
20,5,531,2272,504,493,997,"21 de agosto de 1994"
20,5,537,2301,335,378,713,"21 de agosto de 1994"
20,5,537,2302,203,202,405,"21 de agosto de 1994"
20,5,537,2303,296,306,602,"21 de agosto de 1994"
20,5,545,2325,289,304,593,"21 de agosto de 1994"
20,5,545,2326,359,410,769,"21 de agosto de 1994"
20,5,545,2327,322,385,707,"21 de agosto de 1994"
20,5,545,2328,286,301,587,"21 de agosto de 1994"
20,5,545,2329,125,119,244,"21 de agosto de 1994"
20,5,545,2330,151,161,312,"21 de agosto de 1994"
20,5,555,2391,350,414,764,"21 de agosto de 1994"
20,5,555,2392,296,341,637,"21 de agosto de 1994"
20,5,558,2405,220,259,479,"21 de agosto de 1994"
20,5,558,2406,166,175,341,"21 de agosto de 1994"
20,5,560,2408,287,333,620,"21 de agosto de 1994"
20,5,560,2409,375,445,820,"21 de agosto de 1994"
20,5,560,2410,380,458,838,"21 de agosto de 1994"
20,5,560,2411,393,416,809,"21 de agosto de 1994"
20,5,566,2423,465,567,1032,"21 de agosto de 1994"
20,5,566,2424,456,444,900,"21 de agosto de 1994"
20,5,566,2425,423,532,955,"21 de agosto de 1994"
20,5,566,2426,440,511,951,"21 de agosto de 1994"
20,5,566,2427,370,391,761,"21 de agosto de 1994"
20,5,566,2428,398,447,845,"21 de agosto de 1994"
20,5,566,2429,91,100,191,"21 de agosto de 1994"
20,5,570,2436,204,270,474,"21 de agosto de 1994"
20,5,570,2437,420,504,924,"21 de agosto de 1994"
20,5,570,2438,240,309,549,"21 de agosto de 1994"
20,5,570,2439,329,412,741,"21 de agosto de 1994"
20,5,570,2440,387,455,842,"21 de agosto de 1994"
20,5,570,2441,420,514,934,"21 de agosto de 1994"
20,5,570,2442,337,350,687,"21 de agosto de 1994"
20,5,570,2443,144,126,270,"21 de agosto de 1994"
20,5,570,2444,103,124,227,"21 de agosto de 1994"
20,5,570,2445,148,151,299,"21 de agosto de 1994"
20,5,570,2446,148,171,319,"21 de agosto de 1994"
20,5,570,2447,266,327,593,"21 de agosto de 1994"
20,5,570,2448,114,147,261,"21 de agosto de 1994"
20,5,570,2449,50,52,102,"21 de agosto de 1994"
20,6,5,42,211,243,454,"21 de agosto de 1994"
20,6,13,87,150,148,298,"21 de agosto de 1994"
20,6,13,88,51,53,104,"21 de agosto de 1994"
20,6,13,89,55,50,105,"21 de agosto de 1994"
20,6,19,117,248,241,489,"21 de agosto de 1994"
20,6,19,118,87,80,167,"21 de agosto de 1994"
20,6,19,119,456,376,832,"21 de agosto de 1994"
20,6,19,120,223,115,338,"21 de agosto de 1994"
20,6,21,125,105,119,224,"21 de agosto de 1994"
20,6,21,126,109,125,234,"21 de agosto de 1994"
20,6,25,144,132,168,300,"21 de agosto de 1994"
20,6,25,145,80,115,195,"21 de agosto de 1994"
20,6,25,146,40,48,88,"21 de agosto de 1994"
20,6,31,187,102,126,228,"21 de agosto de 1994"
20,6,31,188,103,139,242,"21 de agosto de 1994"
20,6,32,189,92,131,223,"21 de agosto de 1994"
20,6,32,190,82,105,187,"21 de agosto de 1994"
20,6,32,191,85,101,186,"21 de agosto de 1994"
20,6,37,201,215,257,472,"21 de agosto de 1994"
20,6,37,202,440,532,972,"21 de agosto de 1994"
20,6,37,203,275,342,617,"21 de agosto de 1994"
20,6,37,204,412,569,981,"21 de agosto de 1994"
20,6,37,205,465,611,1076,"21 de agosto de 1994"
20,6,37,206,501,627,1128,"21 de agosto de 1994"
20,6,37,207,563,722,1285,"21 de agosto de 1994"
20,6,37,208,204,240,444,"21 de agosto de 1994"
20,6,37,209,385,485,870,"21 de agosto de 1994"
20,6,37,210,418,541,959,"21 de agosto de 1994"
20,6,37,211,272,336,608,"21 de agosto de 1994"
20,6,37,212,365,496,861,"21 de agosto de 1994"
20,6,37,213,378,505,883,"21 de agosto de 1994"
20,6,37,214,333,418,751,"21 de agosto de 1994"
20,6,37,215,230,351,581,"21 de agosto de 1994"
20,6,37,216,458,552,1010,"21 de agosto de 1994"
20,6,37,217,385,418,803,"21 de agosto de 1994"
20,6,37,218,416,390,806,"21 de agosto de 1994"
20,6,37,219,521,677,1198,"21 de agosto de 1994"
20,6,37,220,365,449,814,"21 de agosto de 1994"
20,6,37,221,231,288,519,"21 de agosto de 1994"
20,6,37,222,213,247,460,"21 de agosto de 1994"
20,6,37,223,114,146,260,"21 de agosto de 1994"
20,6,37,224,52,79,131,"21 de agosto de 1994"
20,6,37,225,89,98,187,"21 de agosto de 1994"
20,6,37,226,152,185,337,"21 de agosto de 1994"
20,6,37,227,251,319,570,"21 de agosto de 1994"
20,6,37,228,419,563,982,"21 de agosto de 1994"
20,6,37,229,47,58,105,"21 de agosto de 1994"
20,6,37,230,61,82,143,"21 de agosto de 1994"
20,6,37,231,268,306,574,"21 de agosto de 1994"
20,6,40,255,197,305,502,"21 de agosto de 1994"
20,6,40,256,35,57,92,"21 de agosto de 1994"
20,6,40,257,53,89,142,"21 de agosto de 1994"
20,6,53,387,252,254,506,"21 de agosto de 1994"
20,6,55,389,221,237,458,"21 de agosto de 1994"
20,6,55,390,97,110,207,"21 de agosto de 1994"
20,6,55,391,127,158,285,"21 de agosto de 1994"
20,6,55,392,29,54,83,"21 de agosto de 1994"
20,6,55,393,119,157,276,"21 de agosto de 1994"
20,6,55,394,68,91,159,"21 de agosto de 1994"
20,6,55,395,65,71,136,"21 de agosto de 1994"
20,6,78,712,232,356,588,"21 de agosto de 1994"
20,6,78,713,101,153,254,"21 de agosto de 1994"
20,6,86,741,283,311,594,"21 de agosto de 1994"
20,6,86,742,106,117,223,"21 de agosto de 1994"
20,6,86,743,48,47,95,"21 de agosto de 1994"
20,6,90,750,151,187,338,"21 de agosto de 1994"
20,6,93,756,183,196,379,"21 de agosto de 1994"
20,6,96,761,96,121,217,"21 de agosto de 1994"
20,6,102,772,374,474,848,"21 de agosto de 1994"
20,6,102,773,144,149,293,"21 de agosto de 1994"
20,6,102,774,311,333,644,"21 de agosto de 1994"
20,6,102,775,274,346,620,"21 de agosto de 1994"
20,6,103,776,80,94,174,"21 de agosto de 1994"
20,6,113,801,170,213,383,"21 de agosto de 1994"
20,6,113,802,45,57,102,"21 de agosto de 1994"
20,6,126,837,93,106,199,"21 de agosto de 1994"
20,6,137,876,166,169,335,"21 de agosto de 1994"
20,6,148,906,116,110,226,"21 de agosto de 1994"
20,6,149,907,358,342,700,"21 de agosto de 1994"
20,6,157,924,146,169,315,"21 de agosto de 1994"
20,6,157,925,134,186,320,"21 de agosto de 1994"
20,6,157,926,94,114,208,"21 de agosto de 1994"
20,6,162,938,227,288,515,"21 de agosto de 1994"
20,6,162,939,111,172,283,"21 de agosto de 1994"
20,6,162,940,69,90,159,"21 de agosto de 1994"
20,6,163,941,153,180,333,"21 de agosto de 1994"
20,6,163,942,123,151,274,"21 de agosto de 1994"
20,6,174,982,150,173,323,"21 de agosto de 1994"
20,6,174,983,150,168,318,"21 de agosto de 1994"
20,6,174,984,234,241,475,"21 de agosto de 1994"
20,6,174,985,236,241,477,"21 de agosto de 1994"
20,6,179,1005,102,108,210,"21 de agosto de 1994"
20,6,179,1006,44,55,99,"21 de agosto de 1994"
20,6,180,1007,168,220,388,"21 de agosto de 1994"
20,6,180,1008,78,104,182,"21 de agosto de 1994"
20,6,188,1110,158,181,339,"21 de agosto de 1994"
20,6,200,1162,92,118,210,"21 de agosto de 1994"
20,6,200,1163,63,75,138,"21 de agosto de 1994"
20,6,208,1193,71,109,180,"21 de agosto de 1994"
20,6,208,1194,101,159,260,"21 de agosto de 1994"
20,6,208,1195,224,300,524,"21 de agosto de 1994"
20,6,208,1196,74,102,176,"21 de agosto de 1994"
20,6,208,1197,54,66,120,"21 de agosto de 1994"
20,6,208,1198,129,159,288,"21 de agosto de 1994"
20,6,208,1199,293,401,694,"21 de agosto de 1994"
20,6,208,1200,131,185,316,"21 de agosto de 1994"
20,6,208,1201,119,169,288,"21 de agosto de 1994"
20,6,208,1202,158,208,366,"21 de agosto de 1994"
20,6,208,1203,110,170,280,"21 de agosto de 1994"
20,6,210,1205,186,245,431,"21 de agosto de 1994"
20,6,210,1206,258,282,540,"21 de agosto de 1994"
20,6,210,1207,170,189,359,"21 de agosto de 1994"
20,6,210,1208,165,209,374,"21 de agosto de 1994"
20,6,210,1209,148,182,330,"21 de agosto de 1994"
20,6,215,1219,176,184,360,"21 de agosto de 1994"
20,6,221,1232,256,258,514,"21 de agosto de 1994"
20,6,221,1233,155,144,299,"21 de agosto de 1994"
20,6,230,1251,129,179,308,"21 de agosto de 1994"
20,6,230,1252,91,112,203,"21 de agosto de 1994"
20,6,237,1278,158,202,360,"21 de agosto de 1994"
20,6,237,1279,95,144,239,"21 de agosto de 1994"
20,6,237,1280,116,151,267,"21 de agosto de 1994"
20,6,237,1281,54,44,98,"21 de agosto de 1994"
20,6,239,1283,237,300,537,"21 de agosto de 1994"
20,6,242,1286,269,276,545,"21 de agosto de 1994"
20,6,242,1287,325,310,635,"21 de agosto de 1994"
20,6,242,1288,223,203,426,"21 de agosto de 1994"
20,6,242,1289,232,175,407,"21 de agosto de 1994"
20,6,242,1290,367,274,641,"21 de agosto de 1994"
20,6,245,1294,193,196,389,"21 de agosto de 1994"
20,6,245,1295,93,118,211,"21 de agosto de 1994"
20,6,248,1302,261,250,511,"21 de agosto de 1994"
20,6,249,1303,194,229,423,"21 de agosto de 1994"
20,6,254,1315,68,70,138,"21 de agosto de 1994"
20,6,258,1320,419,429,848,"21 de agosto de 1994"
20,6,258,1321,111,115,226,"21 de agosto de 1994"
20,6,260,1324,201,228,429,"21 de agosto de 1994"
20,6,260,1325,236,288,524,"21 de agosto de 1994"
20,6,260,1326,213,222,435,"21 de agosto de 1994"
20,6,260,1327,131,151,282,"21 de agosto de 1994"
20,6,260,1328,44,49,93,"21 de agosto de 1994"
20,6,260,1329,58,64,122,"21 de agosto de 1994"
20,6,260,1330,78,81,159,"21 de agosto de 1994"
20,6,260,1331,94,87,181,"21 de agosto de 1994"
20,6,260,1332,65,77,142,"21 de agosto de 1994"
20,6,279,1401,59,77,136,"21 de agosto de 1994"
20,6,281,1404,178,170,348,"21 de agosto de 1994"
20,6,281,1405,45,41,86,"21 de agosto de 1994"
20,6,281,1406,44,46,90,"21 de agosto de 1994"
20,6,284,1411,195,255,450,"21 de agosto de 1994"
20,6,284,1412,131,202,333,"21 de agosto de 1994"
20,6,284,1413,66,103,169,"21 de agosto de 1994"
20,6,284,1414,95,156,251,"21 de agosto de 1994"
20,6,285,1415,124,171,295,"21 de agosto de 1994"
20,6,288,1418,171,217,388,"21 de agosto de 1994"
20,6,315,1496,199,237,436,"21 de agosto de 1994"
20,6,315,1497,88,115,203,"21 de agosto de 1994"
20,6,319,1513,198,220,418,"21 de agosto de 1994"
20,6,330,1560,140,137,277,"21 de agosto de 1994"
20,6,334,1589,262,303,565,"21 de agosto de 1994"
20,6,334,1590,294,375,669,"21 de agosto de 1994"
20,6,334,1591,121,130,251,"21 de agosto de 1994"
20,6,334,1592,216,254,470,"21 de agosto de 1994"
20,6,334,1593,24,24,48,"21 de agosto de 1994"
20,6,335,1594,146,208,354,"21 de agosto de 1994"
20,6,335,1595,38,43,81,"21 de agosto de 1994"
20,6,335,1596,74,95,169,"21 de agosto de 1994"
20,6,335,1597,53,76,129,"21 de agosto de 1994"
20,6,335,1598,116,158,274,"21 de agosto de 1994"
20,6,335,1599,45,61,106,"21 de agosto de 1994"
20,6,335,1600,57,104,161,"21 de agosto de 1994"
20,6,338,1604,61,71,132,"21 de agosto de 1994"
20,6,343,1613,352,456,808,"21 de agosto de 1994"
20,6,345,1617,260,366,626,"21 de agosto de 1994"
20,6,345,1618,205,253,458,"21 de agosto de 1994"
20,6,345,1619,195,248,443,"21 de agosto de 1994"
20,6,345,1620,74,131,205,"21 de agosto de 1994"
20,6,345,1621,117,155,272,"21 de agosto de 1994"
20,6,345,1622,74,94,168,"21 de agosto de 1994"
20,6,345,1623,69,79,148,"21 de agosto de 1994"
20,6,345,1624,283,286,569,"21 de agosto de 1994"
20,6,345,1625,124,119,243,"21 de agosto de 1994"
20,6,349,1636,403,292,695,"21 de agosto de 1994"
20,6,352,1640,166,183,349,"21 de agosto de 1994"
20,6,374,1683,124,153,277,"21 de agosto de 1994"
20,6,374,1684,39,48,87,"21 de agosto de 1994"
20,6,377,1690,82,114,196,"21 de agosto de 1994"
20,6,382,1704,237,298,535,"21 de agosto de 1994"
20,6,382,1705,178,221,399,"21 de agosto de 1994"
20,6,382,1706,113,130,243,"21 de agosto de 1994"
20,6,384,1708,132,127,259,"21 de agosto de 1994"
20,6,396,1777,29,47,76,"21 de agosto de 1994"
20,6,401,1787,163,225,388,"21 de agosto de 1994"
20,6,401,1788,162,220,382,"21 de agosto de 1994"
20,6,402,1789,196,223,419,"21 de agosto de 1994"
20,6,403,1790,110,242,352,"21 de agosto de 1994"
20,6,403,1791,144,243,387,"21 de agosto de 1994"
20,6,403,1792,39,49,88,"21 de agosto de 1994"
20,6,423,1878,67,91,158,"21 de agosto de 1994"
20,6,423,1879,94,140,234,"21 de agosto de 1994"
20,6,424,1880,99,121,220,"21 de agosto de 1994"
20,6,424,1881,91,84,175,"21 de agosto de 1994"
20,6,456,1971,303,352,655,"21 de agosto de 1994"
20,6,456,1972,129,137,266,"21 de agosto de 1994"
20,6,457,1973,153,168,321,"21 de agosto de 1994"
20,6,457,1974,125,121,246,"21 de agosto de 1994"
20,6,457,1975,99,105,204,"21 de agosto de 1994"
20,6,459,1978,241,340,581,"21 de agosto de 1994"
20,6,459,1979,244,311,555,"21 de agosto de 1994"
20,6,459,1980,114,143,257,"21 de agosto de 1994"
20,6,459,1981,95,101,196,"21 de agosto de 1994"
20,6,459,1982,108,116,224,"21 de agosto de 1994"
20,6,459,1983,99,96,195,"21 de agosto de 1994"
20,6,459,1984,48,47,95,"21 de agosto de 1994"
20,6,459,1985,73,112,185,"21 de agosto de 1994"
20,6,459,1986,125,124,249,"21 de agosto de 1994"
20,6,462,1993,154,181,335,"21 de agosto de 1994"
20,6,462,1994,31,67,98,"21 de agosto de 1994"
20,6,463,1995,405,547,952,"21 de agosto de 1994"
20,6,463,1996,68,119,187,"21 de agosto de 1994"
20,6,463,1997,252,308,560,"21 de agosto de 1994"
20,6,463,1998,199,213,412,"21 de agosto de 1994"
20,6,465,2002,83,88,171,"21 de agosto de 1994"
20,6,465,2003,47,69,116,"21 de agosto de 1994"
20,6,470,2033,301,339,640,"21 de agosto de 1994"
20,6,470,2034,280,350,630,"21 de agosto de 1994"
20,6,470,2035,358,443,801,"21 de agosto de 1994"
20,6,470,2036,314,388,702,"21 de agosto de 1994"
20,6,470,2037,222,326,548,"21 de agosto de 1994"
20,6,470,2038,133,198,331,"21 de agosto de 1994"
20,6,470,2039,267,392,659,"21 de agosto de 1994"
20,6,470,2040,157,252,409,"21 de agosto de 1994"
20,6,470,2041,246,332,578,"21 de agosto de 1994"
20,6,470,2042,391,437,828,"21 de agosto de 1994"
20,6,470,2043,273,266,539,"21 de agosto de 1994"
20,6,470,2044,153,195,348,"21 de agosto de 1994"
20,6,470,2045,216,291,507,"21 de agosto de 1994"
20,6,470,2046,279,400,679,"21 de agosto de 1994"
20,6,470,2047,151,247,398,"21 de agosto de 1994"
20,6,470,2048,144,149,293,"21 de agosto de 1994"
20,6,470,2049,42,75,117,"21 de agosto de 1994"
20,6,477,2070,101,124,225,"21 de agosto de 1994"
20,6,480,2076,97,91,188,"21 de agosto de 1994"
20,6,486,2117,178,227,405,"21 de agosto de 1994"
20,6,486,2118,177,215,392,"21 de agosto de 1994"
20,6,486,2119,112,156,268,"21 de agosto de 1994"
20,6,486,2120,87,76,163,"21 de agosto de 1994"
20,6,486,2121,85,102,187,"21 de agosto de 1994"
20,6,486,2122,118,135,253,"21 de agosto de 1994"
20,6,489,2127,43,47,90,"21 de agosto de 1994"
20,6,494,2139,140,136,276,"21 de agosto de 1994"
20,6,500,2156,229,270,499,"21 de agosto de 1994"
20,6,500,2157,168,207,375,"21 de agosto de 1994"
20,6,502,2165,115,119,234,"21 de agosto de 1994"
20,6,502,2166,108,159,267,"21 de agosto de 1994"
20,6,518,2234,57,55,112,"21 de agosto de 1994"
20,6,520,2237,187,251,438,"21 de agosto de 1994"
20,6,520,2238,200,214,414,"21 de agosto de 1994"
20,6,520,2239,209,228,437,"21 de agosto de 1994"
20,6,520,2240,108,68,176,"21 de agosto de 1994"
20,6,520,2241,36,25,61,"21 de agosto de 1994"
20,6,520,2242,197,256,453,"21 de agosto de 1994"
20,6,520,2243,228,294,522,"21 de agosto de 1994"
20,6,521,2244,79,130,209,"21 de agosto de 1994"
20,6,523,2246,356,408,764,"21 de agosto de 1994"
20,6,523,2247,47,55,102,"21 de agosto de 1994"
20,6,524,2248,129,176,305,"21 de agosto de 1994"
20,6,532,2273,180,295,475,"21 de agosto de 1994"
20,6,533,2274,190,196,386,"21 de agosto de 1994"
20,6,534,2275,307,375,682,"21 de agosto de 1994"
20,6,534,2276,247,294,541,"21 de agosto de 1994"
20,6,534,2277,91,111,202,"21 de agosto de 1994"
20,6,534,2278,105,173,278,"21 de agosto de 1994"
20,6,534,2279,111,144,255,"21 de agosto de 1994"
20,6,534,2280,26,41,67,"21 de agosto de 1994"
20,6,534,2281,69,106,175,"21 de agosto de 1994"
20,6,534,2282,70,136,206,"21 de agosto de 1994"
20,6,534,2283,41,71,112,"21 de agosto de 1994"
20,6,534,2284,57,72,129,"21 de agosto de 1994"
20,6,534,2285,52,72,124,"21 de agosto de 1994"
20,6,534,2286,62,97,159,"21 de agosto de 1994"
20,6,534,2287,78,71,149,"21 de agosto de 1994"
20,6,534,2288,30,45,75,"21 de agosto de 1994"
20,6,534,2289,115,101,216,"21 de agosto de 1994"
20,6,539,2305,251,289,540,"21 de agosto de 1994"
20,6,539,2306,289,343,632,"21 de agosto de 1994"
20,6,539,2307,218,289,507,"21 de agosto de 1994"
20,6,539,2308,225,278,503,"21 de agosto de 1994"
20,6,539,2309,183,321,504,"21 de agosto de 1994"
20,6,539,2310,44,32,76,"21 de agosto de 1994"
20,6,543,2321,152,166,318,"21 de agosto de 1994"
20,6,543,2322,206,194,400,"21 de agosto de 1994"
20,6,543,2323,138,123,261,"21 de agosto de 1994"
20,6,547,2335,237,270,507,"21 de agosto de 1994"
20,6,548,2336,155,211,366,"21 de agosto de 1994"
20,6,548,2337,60,52,112,"21 de agosto de 1994"
20,6,548,2338,75,95,170,"21 de agosto de 1994"
20,6,549,2339,272,413,685,"21 de agosto de 1994"
20,6,549,2340,119,163,282,"21 de agosto de 1994"
20,6,549,2341,180,329,509,"21 de agosto de 1994"
20,6,549,2342,74,136,210,"21 de agosto de 1994"
20,6,549,2343,142,232,374,"21 de agosto de 1994"
20,6,549,2344,159,229,388,"21 de agosto de 1994"
20,6,549,2345,182,184,366,"21 de agosto de 1994"
20,6,549,2346,267,294,561,"21 de agosto de 1994"
20,6,549,2347,64,78,142,"21 de agosto de 1994"
20,6,549,2348,153,194,347,"21 de agosto de 1994"
20,6,549,2349,48,47,95,"21 de agosto de 1994"
20,6,549,2350,130,170,300,"21 de agosto de 1994"
20,6,549,2351,136,219,355,"21 de agosto de 1994"
20,6,551,2362,111,133,244,"21 de agosto de 1994"
20,6,556,2393,73,87,160,"21 de agosto de 1994"
20,6,568,2432,278,320,598,"21 de agosto de 1994"
20,6,568,2433,221,292,513,"21 de agosto de 1994"
20,6,568,2434,122,163,285,"21 de agosto de 1994"
20,6,569,2435,293,361,654,"21 de agosto de 1994"
20,7,7,57,394,446,840,"21 de agosto de 1994"
20,7,7,58,452,538,990,"21 de agosto de 1994"
20,7,7,59,493,558,1051,"21 de agosto de 1994"
20,7,7,60,482,531,1013,"21 de agosto de 1994"
20,7,7,61,271,283,554,"21 de agosto de 1994"
20,7,7,62,169,196,365,"21 de agosto de 1994"
20,7,7,63,205,229,434,"21 de agosto de 1994"
20,7,7,64,138,170,308,"21 de agosto de 1994"
20,7,16,104,247,263,510,"21 de agosto de 1994"
20,7,16,105,190,228,418,"21 de agosto de 1994"
20,7,16,106,218,212,430,"21 de agosto de 1994"
20,7,16,107,270,299,569,"21 de agosto de 1994"
20,7,16,108,157,196,353,"21 de agosto de 1994"
20,7,16,109,239,281,520,"21 de agosto de 1994"
20,7,16,110,311,335,646,"21 de agosto de 1994"
20,7,23,131,152,193,345,"21 de agosto de 1994"
20,7,23,132,141,142,283,"21 de agosto de 1994"
20,7,23,133,89,120,209,"21 de agosto de 1994"
20,7,36,198,466,550,1016,"21 de agosto de 1994"
20,7,36,199,72,83,155,"21 de agosto de 1994"
20,7,36,200,189,224,413,"21 de agosto de 1994"
20,7,46,369,338,373,711,"21 de agosto de 1994"
20,7,46,370,156,161,317,"21 de agosto de 1994"
20,7,46,371,288,323,611,"21 de agosto de 1994"
20,7,46,372,103,107,210,"21 de agosto de 1994"
20,7,49,375,175,168,343,"21 de agosto de 1994"
20,7,49,376,154,124,278,"21 de agosto de 1994"
20,7,49,377,183,160,343,"21 de agosto de 1994"
20,7,54,388,121,142,263,"21 de agosto de 1994"
20,7,71,643,339,458,797,"21 de agosto de 1994"
20,7,71,644,304,324,628,"21 de agosto de 1994"
20,7,71,645,412,439,851,"21 de agosto de 1994"
20,7,71,646,339,385,724,"21 de agosto de 1994"
20,7,71,647,363,444,807,"21 de agosto de 1994"
20,7,71,648,393,479,872,"21 de agosto de 1994"
20,7,71,649,190,286,476,"21 de agosto de 1994"
20,7,71,650,194,228,422,"21 de agosto de 1994"
20,7,71,651,124,177,301,"21 de agosto de 1994"
20,7,71,652,154,195,349,"21 de agosto de 1994"
20,7,71,653,167,205,372,"21 de agosto de 1994"
20,7,71,654,370,470,840,"21 de agosto de 1994"
20,7,71,655,275,361,636,"21 de agosto de 1994"
20,7,71,656,258,289,547,"21 de agosto de 1994"
20,7,71,657,308,303,611,"21 de agosto de 1994"
20,7,71,658,131,139,270,"21 de agosto de 1994"
20,7,71,659,397,439,836,"21 de agosto de 1994"
20,7,71,660,230,266,496,"21 de agosto de 1994"
20,7,73,663,184,261,445,"21 de agosto de 1994"
20,7,73,664,144,219,363,"21 de agosto de 1994"
20,7,73,665,139,149,288,"21 de agosto de 1994"
20,7,83,734,91,120,211,"21 de agosto de 1994"
20,7,83,735,91,125,216,"21 de agosto de 1994"
20,7,85,738,231,232,463,"21 de agosto de 1994"
20,7,85,739,147,148,295,"21 de agosto de 1994"
20,7,85,740,177,169,346,"21 de agosto de 1994"
20,7,105,782,202,255,457,"21 de agosto de 1994"
20,7,105,783,202,237,439,"21 de agosto de 1994"
20,7,105,784,251,222,473,"21 de agosto de 1994"
20,7,105,785,70,102,172,"21 de agosto de 1994"
20,7,105,786,113,142,255,"21 de agosto de 1994"
20,7,105,787,104,126,230,"21 de agosto de 1994"
20,7,107,789,193,235,428,"21 de agosto de 1994"
20,7,108,790,380,385,765,"21 de agosto de 1994"
20,7,108,791,206,166,372,"21 de agosto de 1994"
20,7,118,810,105,148,253,"21 de agosto de 1994"
20,7,124,835,205,180,385,"21 de agosto de 1994"
20,7,130,847,181,204,385,"21 de agosto de 1994"
20,7,130,848,139,138,277,"21 de agosto de 1994"
20,7,130,849,162,143,305,"21 de agosto de 1994"
20,7,130,850,162,153,315,"21 de agosto de 1994"
20,7,134,871,254,247,501,"21 de agosto de 1994"
20,7,134,872,133,138,271,"21 de agosto de 1994"
20,7,134,873,268,241,509,"21 de agosto de 1994"
20,7,141,891,147,151,298,"21 de agosto de 1994"
20,7,141,892,193,206,399,"21 de agosto de 1994"
20,7,144,896,106,99,205,"21 de agosto de 1994"
20,7,155,920,419,392,811,"21 de agosto de 1994"
20,7,171,978,158,180,338,"21 de agosto de 1994"
20,7,184,1099,308,346,654,"21 de agosto de 1994"
20,7,184,1100,371,400,771,"21 de agosto de 1994"
20,7,184,1101,184,228,412,"21 de agosto de 1994"
20,7,184,1102,210,207,417,"21 de agosto de 1994"
20,7,184,1103,152,158,310,"21 de agosto de 1994"
20,7,184,1104,105,115,220,"21 de agosto de 1994"
20,7,184,1105,78,73,151,"21 de agosto de 1994"
20,7,196,1134,244,271,515,"21 de agosto de 1994"
20,7,196,1135,139,177,316,"21 de agosto de 1994"
20,7,218,1225,126,130,256,"21 de agosto de 1994"
20,7,224,1237,206,225,431,"21 de agosto de 1994"
20,7,240,1284,362,474,836,"21 de agosto de 1994"
20,7,250,1304,189,247,436,"21 de agosto de 1994"
20,7,250,1305,107,101,208,"21 de agosto de 1994"
20,7,253,1314,353,372,725,"21 de agosto de 1994"
20,7,257,1319,242,253,495,"21 de agosto de 1994"
20,7,262,1336,196,260,456,"21 de agosto de 1994"
20,7,262,1337,178,234,412,"21 de agosto de 1994"
20,7,268,1354,130,164,294,"21 de agosto de 1994"
20,7,268,1355,159,205,364,"21 de agosto de 1994"
20,7,268,1356,134,194,328,"21 de agosto de 1994"
20,7,268,1357,120,187,307,"21 de agosto de 1994"
20,7,268,1358,141,173,314,"21 de agosto de 1994"
20,7,269,1359,181,215,396,"21 de agosto de 1994"
20,7,269,1360,212,250,462,"21 de agosto de 1994"
20,7,273,1367,304,331,635,"21 de agosto de 1994"
20,7,295,1438,164,116,280,"21 de agosto de 1994"
20,7,295,1439,167,108,275,"21 de agosto de 1994"
20,7,298,1449,420,432,852,"21 de agosto de 1994"
20,7,298,1450,230,230,460,"21 de agosto de 1994"
20,7,298,1451,249,273,522,"21 de agosto de 1994"
20,7,300,1454,150,182,332,"21 de agosto de 1994"
20,7,300,1455,246,315,561,"21 de agosto de 1994"
20,7,300,1456,57,52,109,"21 de agosto de 1994"
20,7,300,1457,53,52,105,"21 de agosto de 1994"
20,7,302,1459,198,207,405,"21 de agosto de 1994"
20,7,302,1460,68,66,134,"21 de agosto de 1994"
20,7,318,1512,153,181,334,"21 de agosto de 1994"
20,7,327,1554,289,279,568,"21 de agosto de 1994"
20,7,329,1558,103,116,219,"21 de agosto de 1994"
20,7,329,1559,94,129,223,"21 de agosto de 1994"
20,7,342,1609,255,247,502,"21 de agosto de 1994"
20,7,342,1610,201,234,435,"21 de agosto de 1994"
20,7,342,1611,87,95,182,"21 de agosto de 1994"
20,7,342,1612,179,181,360,"21 de agosto de 1994"
20,7,371,1677,169,189,358,"21 de agosto de 1994"
20,7,372,1678,43,77,120,"21 de agosto de 1994"
20,7,372,1679,95,142,237,"21 de agosto de 1994"
20,7,373,1680,125,152,277,"21 de agosto de 1994"
20,7,373,1681,54,94,148,"21 de agosto de 1994"
20,7,373,1682,120,139,259,"21 de agosto de 1994"
20,7,378,1691,227,244,471,"21 de agosto de 1994"
20,7,378,1692,155,141,296,"21 de agosto de 1994"
20,7,378,1693,311,273,584,"21 de agosto de 1994"
20,7,378,1694,82,78,160,"21 de agosto de 1994"
20,7,378,1695,429,460,889,"21 de agosto de 1994"
20,7,378,1696,174,161,335,"21 de agosto de 1994"
20,7,378,1697,242,197,439,"21 de agosto de 1994"
20,7,378,1698,311,284,595,"21 de agosto de 1994"
20,7,380,1702,401,501,902,"21 de agosto de 1994"
20,7,383,1707,270,316,586,"21 de agosto de 1994"
20,7,387,1730,307,282,589,"21 de agosto de 1994"
20,7,387,1731,252,251,503,"21 de agosto de 1994"
20,7,387,1732,370,323,693,"21 de agosto de 1994"
20,7,387,1733,436,429,865,"21 de agosto de 1994"
20,7,387,1734,397,340,737,"21 de agosto de 1994"
20,7,387,1735,178,145,323,"21 de agosto de 1994"
20,7,387,1736,366,340,706,"21 de agosto de 1994"
20,7,387,1737,432,314,746,"21 de agosto de 1994"
20,7,391,1743,168,174,342,"21 de agosto de 1994"
20,7,391,1744,175,196,371,"21 de agosto de 1994"
20,7,391,1745,153,174,327,"21 de agosto de 1994"
20,7,394,1771,201,241,442,"21 de agosto de 1994"
20,7,394,1772,170,191,361,"21 de agosto de 1994"
20,7,394,1773,244,285,529,"21 de agosto de 1994"
20,7,394,1774,264,256,520,"21 de agosto de 1994"
20,7,394,1775,262,309,571,"21 de agosto de 1994"
20,7,398,1780,268,318,586,"21 de agosto de 1994"
20,7,398,1781,200,222,422,"21 de agosto de 1994"
20,7,409,1828,107,101,208,"21 de agosto de 1994"
20,7,416,1856,302,305,607,"21 de agosto de 1994"
20,7,416,1857,237,244,481,"21 de agosto de 1994"
20,7,416,1858,176,263,439,"21 de agosto de 1994"
20,7,431,1905,80,97,177,"21 de agosto de 1994"
20,7,445,1935,98,114,212,"21 de agosto de 1994"
20,7,446,1936,223,282,505,"21 de agosto de 1994"
20,7,447,1937,400,422,822,"21 de agosto de 1994"
20,7,447,1938,476,456,932,"21 de agosto de 1994"
20,7,447,1939,377,374,751,"21 de agosto de 1994"
20,7,448,1940,237,376,613,"21 de agosto de 1994"
20,7,448,1941,237,302,539,"21 de agosto de 1994"
20,7,448,1942,296,362,658,"21 de agosto de 1994"
20,7,448,1943,243,260,503,"21 de agosto de 1994"
20,7,448,1944,193,262,455,"21 de agosto de 1994"
20,7,448,1945,185,216,401,"21 de agosto de 1994"
20,7,448,1946,234,276,510,"21 de agosto de 1994"
20,7,448,1947,253,293,546,"21 de agosto de 1994"
20,7,448,1948,171,166,337,"21 de agosto de 1994"
20,7,448,1949,146,193,339,"21 de agosto de 1994"
20,7,449,1950,228,199,427,"21 de agosto de 1994"
20,7,451,1955,350,355,705,"21 de agosto de 1994"
20,7,451,1956,325,338,663,"21 de agosto de 1994"
20,7,451,1957,318,258,576,"21 de agosto de 1994"
20,7,451,1958,280,209,489,"21 de agosto de 1994"
20,7,451,1959,284,263,547,"21 de agosto de 1994"
20,7,452,1960,166,167,333,"21 de agosto de 1994"
20,7,452,1961,189,253,442,"21 de agosto de 1994"
20,7,464,1999,171,179,350,"21 de agosto de 1994"
20,7,464,2000,26,31,57,"21 de agosto de 1994"
20,7,464,2001,54,51,105,"21 de agosto de 1994"
20,7,467,2005,458,402,860,"21 de agosto de 1994"
20,7,467,2006,60,48,108,"21 de agosto de 1994"
20,7,467,2007,253,223,476,"21 de agosto de 1994"
20,7,467,2008,129,130,259,"21 de agosto de 1994"
20,7,467,2009,295,247,542,"21 de agosto de 1994"
20,7,467,2010,371,388,759,"21 de agosto de 1994"
20,7,467,2011,163,178,341,"21 de agosto de 1994"
20,7,482,2084,120,126,246,"21 de agosto de 1994"
20,7,482,2085,85,79,164,"21 de agosto de 1994"
20,7,483,2086,330,356,686,"21 de agosto de 1994"
20,7,483,2087,292,303,595,"21 de agosto de 1994"
20,7,492,2133,481,446,927,"21 de agosto de 1994"
20,7,492,2134,134,110,244,"21 de agosto de 1994"
20,7,493,2135,187,223,410,"21 de agosto de 1994"
20,7,493,2136,154,172,326,"21 de agosto de 1994"
20,7,493,2137,268,302,570,"21 de agosto de 1994"
20,7,493,2138,192,185,377,"21 de agosto de 1994"
20,7,501,2158,211,263,474,"21 de agosto de 1994"
20,7,501,2159,161,209,370,"21 de agosto de 1994"
20,7,501,2160,288,374,662,"21 de agosto de 1994"
20,7,501,2161,121,130,251,"21 de agosto de 1994"
20,7,501,2162,284,327,611,"21 de agosto de 1994"
20,7,501,2163,229,224,453,"21 de agosto de 1994"
20,7,501,2164,325,292,617,"21 de agosto de 1994"
20,7,510,2185,151,197,348,"21 de agosto de 1994"
20,7,528,2262,369,441,810,"21 de agosto de 1994"
20,7,528,2263,382,426,808,"21 de agosto de 1994"
20,7,553,2367,472,555,1027,"21 de agosto de 1994"
20,7,553,2368,389,415,804,"21 de agosto de 1994"
20,7,553,2369,282,311,593,"21 de agosto de 1994"
20,7,553,2370,235,289,524,"21 de agosto de 1994"
20,7,553,2371,381,448,829,"21 de agosto de 1994"
20,7,553,2372,410,473,883,"21 de agosto de 1994"
20,7,553,2373,443,488,931,"21 de agosto de 1994"
20,7,553,2374,321,349,670,"21 de agosto de 1994"
20,7,553,2375,451,455,906,"21 de agosto de 1994"
20,7,553,2376,419,388,807,"21 de agosto de 1994"
20,7,553,2377,120,125,245,"21 de agosto de 1994"
20,7,553,2378,62,60,122,"21 de agosto de 1994"
20,7,553,2379,161,154,315,"21 de agosto de 1994"
20,7,553,2380,353,303,656,"21 de agosto de 1994"
20,7,553,2381,267,304,571,"21 de agosto de 1994"
20,7,553,2382,341,377,718,"21 de agosto de 1994"
20,7,553,2383,271,308,579,"21 de agosto de 1994"
20,7,553,2384,47,48,95,"21 de agosto de 1994"
20,7,553,2385,93,121,214,"21 de agosto de 1994"
20,7,565,2422,266,305,571,"21 de agosto de 1994"
20,7,567,2430,127,150,277,"21 de agosto de 1994"
20,7,567,2431,450,416,866,"21 de agosto de 1994"
20,8,20,121,238,309,547,"21 de agosto de 1994"
20,8,20,122,125,138,263,"21 de agosto de 1994"
20,8,20,123,199,311,510,"21 de agosto de 1994"
20,8,20,124,168,216,384,"21 de agosto de 1994"
20,8,56,396,254,293,547,"21 de agosto de 1994"
20,8,68,632,332,436,768,"21 de agosto de 1994"
20,8,69,633,280,342,622,"21 de agosto de 1994"
20,8,69,634,271,303,574,"21 de agosto de 1994"
20,8,69,635,215,207,422,"21 de agosto de 1994"
20,8,69,636,227,226,453,"21 de agosto de 1994"
20,8,69,637,222,206,428,"21 de agosto de 1994"
20,8,77,710,214,267,481,"21 de agosto de 1994"
20,8,77,711,214,245,459,"21 de agosto de 1994"
20,8,79,714,268,249,517,"21 de agosto de 1994"
20,8,79,715,278,251,529,"21 de agosto de 1994"
20,8,79,716,230,234,464,"21 de agosto de 1994"
20,8,87,744,388,374,762,"21 de agosto de 1994"
20,8,87,745,338,347,685,"21 de agosto de 1994"
20,8,87,746,365,363,728,"21 de agosto de 1994"
20,8,98,763,184,273,457,"21 de agosto de 1994"
20,8,110,794,507,547,1054,"21 de agosto de 1994"
20,8,116,807,193,173,366,"21 de agosto de 1994"
20,8,116,808,212,173,385,"21 de agosto de 1994"
20,8,146,899,261,271,532,"21 de agosto de 1994"
20,8,150,908,200,211,411,"21 de agosto de 1994"
20,8,150,909,228,236,464,"21 de agosto de 1994"
20,8,150,910,240,218,458,"21 de agosto de 1994"
20,8,152,913,168,141,309,"21 de agosto de 1994"
20,8,156,921,417,344,761,"21 de agosto de 1994"
20,8,156,922,200,179,379,"21 de agosto de 1994"
20,8,156,923,277,236,513,"21 de agosto de 1994"
20,8,166,951,161,162,323,"21 de agosto de 1994"
20,8,178,1003,260,256,516,"21 de agosto de 1994"
20,8,178,1004,286,298,584,"21 de agosto de 1994"
20,8,190,1112,417,442,859,"21 de agosto de 1994"
20,8,190,1113,390,465,855,"21 de agosto de 1994"
20,8,190,1114,251,273,524,"21 de agosto de 1994"
20,8,190,1115,328,346,674,"21 de agosto de 1994"
20,8,190,1116,156,154,310,"21 de agosto de 1994"
20,8,203,1170,381,349,730,"21 de agosto de 1994"
20,8,203,1171,295,277,572,"21 de agosto de 1994"
20,8,213,1215,248,218,466,"21 de agosto de 1994"
20,8,213,1216,209,191,400,"21 de agosto de 1994"
20,8,225,1238,328,312,640,"21 de agosto de 1994"
20,8,225,1239,316,278,594,"21 de agosto de 1994"
20,8,225,1240,324,373,697,"21 de agosto de 1994"
20,8,229,1249,526,588,1114,"21 de agosto de 1994"
20,8,229,1250,418,412,830,"21 de agosto de 1994"
20,8,241,1285,224,271,495,"21 de agosto de 1994"
20,8,264,1345,230,208,438,"21 de agosto de 1994"
20,8,264,1346,297,250,547,"21 de agosto de 1994"
20,8,271,1363,329,368,697,"21 de agosto de 1994"
20,8,271,1364,418,511,929,"21 de agosto de 1994"
20,8,283,1409,311,339,650,"21 de agosto de 1994"
20,8,283,1410,238,216,454,"21 de agosto de 1994"
20,8,289,1419,347,387,734,"21 de agosto de 1994"
20,8,289,1420,204,218,422,"21 de agosto de 1994"
20,8,289,1421,273,283,556,"21 de agosto de 1994"
20,8,310,1485,296,281,577,"21 de agosto de 1994"
20,8,310,1486,256,302,558,"21 de agosto de 1994"
20,8,310,1487,210,210,420,"21 de agosto de 1994"
20,8,310,1488,224,229,453,"21 de agosto de 1994"
20,8,310,1489,245,297,542,"21 de agosto de 1994"
20,8,310,1490,151,155,306,"21 de agosto de 1994"
20,8,310,1491,190,208,398,"21 de agosto de 1994"
20,8,312,1493,314,360,674,"21 de agosto de 1994"
20,8,316,1498,415,393,808,"21 de agosto de 1994"
20,8,316,1499,490,437,927,"21 de agosto de 1994"
20,8,316,1500,406,412,818,"21 de agosto de 1994"
20,8,316,1501,377,376,753,"21 de agosto de 1994"
20,8,316,1502,279,270,549,"21 de agosto de 1994"
20,8,316,1503,495,478,973,"21 de agosto de 1994"
20,8,316,1504,162,126,288,"21 de agosto de 1994"
20,8,316,1505,529,547,1076,"21 de agosto de 1994"
20,8,316,1506,616,612,1228,"21 de agosto de 1994"
20,8,316,1507,493,508,1001,"21 de agosto de 1994"
20,8,316,1508,172,150,322,"21 de agosto de 1994"
20,8,316,1509,375,359,734,"21 de agosto de 1994"
20,8,316,1510,184,165,349,"21 de agosto de 1994"
20,8,332,1564,368,349,717,"21 de agosto de 1994"
20,8,332,1565,351,348,699,"21 de agosto de 1994"
20,8,332,1566,322,320,642,"21 de agosto de 1994"
20,8,332,1567,269,271,540,"21 de agosto de 1994"
20,8,332,1568,403,387,790,"21 de agosto de 1994"
20,8,332,1569,236,253,489,"21 de agosto de 1994"
20,8,332,1570,393,408,801,"21 de agosto de 1994"
20,8,332,1571,325,321,646,"21 de agosto de 1994"
20,8,332,1572,364,355,719,"21 de agosto de 1994"
20,8,332,1573,408,434,842,"21 de agosto de 1994"
20,8,332,1574,302,352,654,"21 de agosto de 1994"
20,8,332,1575,376,296,672,"21 de agosto de 1994"
20,8,332,1576,715,643,1358,"21 de agosto de 1994"
20,8,332,1577,307,287,594,"21 de agosto de 1994"
20,8,332,1578,420,398,818,"21 de agosto de 1994"
20,8,332,1579,347,312,659,"21 de agosto de 1994"
20,8,332,1580,380,387,767,"21 de agosto de 1994"
20,8,332,1581,372,323,695,"21 de agosto de 1994"
20,8,332,1582,239,211,450,"21 de agosto de 1994"
20,8,332,1583,344,306,650,"21 de agosto de 1994"
20,8,332,1584,259,183,442,"21 de agosto de 1994"
20,8,341,1607,248,289,537,"21 de agosto de 1994"
20,8,341,1608,193,196,389,"21 de agosto de 1994"
20,8,350,1637,256,326,582,"21 de agosto de 1994"
20,8,350,1638,287,304,591,"21 de agosto de 1994"
20,8,351,1639,391,406,797,"21 de agosto de 1994"
20,8,364,1658,384,384,768,"21 de agosto de 1994"
20,8,364,1659,549,647,1196,"21 de agosto de 1994"
20,8,364,1660,211,226,437,"21 de agosto de 1994"
20,8,364,1661,303,278,581,"21 de agosto de 1994"
20,8,364,1662,195,201,396,"21 de agosto de 1994"
20,8,364,1663,311,206,517,"21 de agosto de 1994"
20,8,364,1664,213,168,381,"21 de agosto de 1994"
20,8,366,1668,276,279,555,"21 de agosto de 1994"
20,8,366,1669,211,208,419,"21 de agosto de 1994"
20,8,366,1670,299,278,577,"21 de agosto de 1994"
20,8,367,1671,312,383,695,"21 de agosto de 1994"
20,8,367,1672,338,316,654,"21 de agosto de 1994"
20,8,406,1816,302,279,581,"21 de agosto de 1994"
20,8,406,1817,853,482,1335,"21 de agosto de 1994"
20,8,406,1818,262,282,544,"21 de agosto de 1994"
20,8,406,1819,173,207,380,"21 de agosto de 1994"
20,8,406,1820,205,192,397,"21 de agosto de 1994"
20,8,406,1821,257,186,443,"21 de agosto de 1994"
20,8,406,1822,313,244,557,"21 de agosto de 1994"
20,8,406,1823,256,183,439,"21 de agosto de 1994"
20,8,406,1824,374,335,709,"21 de agosto de 1994"
20,8,406,1825,358,331,689,"21 de agosto de 1994"
20,8,407,1826,206,213,419,"21 de agosto de 1994"
20,8,415,1851,530,544,1074,"21 de agosto de 1994"
20,8,415,1852,540,561,1101,"21 de agosto de 1994"
20,8,415,1853,340,320,660,"21 de agosto de 1994"
20,8,415,1854,405,365,770,"21 de agosto de 1994"
20,8,415,1855,279,290,569,"21 de agosto de 1994"
20,8,421,1874,187,154,341,"21 de agosto de 1994"
20,8,430,1904,324,348,672,"21 de agosto de 1994"
20,8,434,1908,362,403,765,"21 de agosto de 1994"
20,8,468,2012,235,237,472,"21 de agosto de 1994"
20,8,468,2013,540,602,1142,"21 de agosto de 1994"
20,8,468,2014,285,286,571,"21 de agosto de 1994"
20,8,468,2015,280,259,539,"21 de agosto de 1994"
20,8,468,2016,313,368,681,"21 de agosto de 1994"
20,8,468,2017,241,236,477,"21 de agosto de 1994"
20,8,468,2018,423,413,836,"21 de agosto de 1994"
20,8,468,2019,137,123,260,"21 de agosto de 1994"
20,8,468,2020,242,220,462,"21 de agosto de 1994"
20,8,468,2021,202,206,408,"21 de agosto de 1994"
20,8,468,2022,280,301,581,"21 de agosto de 1994"
20,8,468,2023,211,208,419,"21 de agosto de 1994"
20,8,468,2024,197,160,357,"21 de agosto de 1994"
20,8,475,2062,388,457,845,"21 de agosto de 1994"
20,8,475,2063,111,136,247,"21 de agosto de 1994"
20,8,475,2064,174,186,360,"21 de agosto de 1994"
20,8,478,2071,296,243,539,"21 de agosto de 1994"
20,8,484,2088,253,256,509,"21 de agosto de 1994"
20,8,484,2089,283,305,588,"21 de agosto de 1994"
20,8,484,2090,219,243,462,"21 de agosto de 1994"
20,8,484,2091,267,255,522,"21 de agosto de 1994"
20,8,484,2092,586,582,1168,"21 de agosto de 1994"
20,8,484,2093,422,483,905,"21 de agosto de 1994"
20,8,484,2094,855,346,1201,"21 de agosto de 1994"
20,8,484,2095,390,454,844,"21 de agosto de 1994"
20,8,484,2096,461,535,996,"21 de agosto de 1994"
20,8,484,2097,443,499,942,"21 de agosto de 1994"
20,8,484,2098,303,311,614,"21 de agosto de 1994"
20,8,484,2099,478,448,926,"21 de agosto de 1994"
20,8,484,2100,353,364,717,"21 de agosto de 1994"
20,8,484,2101,281,287,568,"21 de agosto de 1994"
20,8,484,2102,202,217,419,"21 de agosto de 1994"
20,8,484,2103,300,325,625,"21 de agosto de 1994"
20,8,484,2104,287,268,555,"21 de agosto de 1994"
20,8,484,2105,304,340,644,"21 de agosto de 1994"
20,8,484,2106,346,306,652,"21 de agosto de 1994"
20,8,484,2107,283,209,492,"21 de agosto de 1994"
20,8,484,2108,279,234,513,"21 de agosto de 1994"
20,8,484,2109,276,261,537,"21 de agosto de 1994"
20,8,484,2110,288,279,567,"21 de agosto de 1994"
20,8,484,2111,379,391,770,"21 de agosto de 1994"
20,8,487,2123,330,297,627,"21 de agosto de 1994"
20,8,487,2124,263,250,513,"21 de agosto de 1994"
20,8,490,2128,363,299,662,"21 de agosto de 1994"
20,8,490,2129,353,327,680,"21 de agosto de 1994"
20,8,490,2130,257,236,493,"21 de agosto de 1994"
20,8,498,2150,470,409,879,"21 de agosto de 1994"
20,8,506,2173,253,251,504,"21 de agosto de 1994"
20,8,506,2174,242,223,465,"21 de agosto de 1994"
20,8,508,2176,312,276,588,"21 de agosto de 1994"
20,8,508,2177,352,319,671,"21 de agosto de 1994"
20,8,508,2178,312,253,565,"21 de agosto de 1994"
20,8,508,2179,264,226,490,"21 de agosto de 1994"
20,8,516,2229,428,435,863,"21 de agosto de 1994"
20,8,516,2230,330,296,626,"21 de agosto de 1994"
20,8,530,2265,399,397,796,"21 de agosto de 1994"
20,8,530,2266,286,292,578,"21 de agosto de 1994"
20,8,530,2267,232,268,500,"21 de agosto de 1994"
20,8,530,2268,430,396,826,"21 de agosto de 1994"
20,8,530,2269,371,291,662,"21 de agosto de 1994"
20,8,530,2270,360,306,666,"21 de agosto de 1994"
20,8,530,2271,290,298,588,"21 de agosto de 1994"
20,8,536,2291,167,161,328,"21 de agosto de 1994"
20,8,536,2292,407,474,881,"21 de agosto de 1994"
20,8,536,2293,353,362,715,"21 de agosto de 1994"
20,8,536,2294,239,233,472,"21 de agosto de 1994"
20,8,536,2295,246,213,459,"21 de agosto de 1994"
20,8,536,2296,170,121,291,"21 de agosto de 1994"
20,8,536,2297,221,197,418,"21 de agosto de 1994"
20,8,536,2298,275,254,529,"21 de agosto de 1994"
20,8,536,2299,270,205,475,"21 de agosto de 1994"
20,8,536,2300,253,217,470,"21 de agosto de 1994"
20,8,542,2318,455,362,817,"21 de agosto de 1994"
20,8,542,2319,221,221,442,"21 de agosto de 1994"
20,8,542,2320,317,299,616,"21 de agosto de 1994"
20,9,8,65,246,347,593,"21 de agosto de 1994"
20,9,8,66,230,285,515,"21 de agosto de 1994"
20,9,8,67,173,216,389,"21 de agosto de 1994"
20,9,14,90,483,486,969,"21 de agosto de 1994"
20,9,14,91,392,381,773,"21 de agosto de 1994"
20,9,14,92,40,32,72,"21 de agosto de 1994"
20,9,14,93,233,235,468,"21 de agosto de 1994"
20,9,14,94,139,135,274,"21 de agosto de 1994"
20,9,14,95,377,394,771,"21 de agosto de 1994"
20,9,14,96,313,266,579,"21 de agosto de 1994"
20,9,18,113,254,240,494,"21 de agosto de 1994"
20,9,18,114,280,196,476,"21 de agosto de 1994"
20,9,18,115,162,191,353,"21 de agosto de 1994"
20,9,18,116,233,237,470,"21 de agosto de 1994"
20,9,28,157,512,637,1149,"21 de agosto de 1994"
20,9,28,158,450,556,1006,"21 de agosto de 1994"
20,9,28,159,310,376,686,"21 de agosto de 1994"
20,9,28,160,486,515,1001,"21 de agosto de 1994"
20,9,28,161,257,298,555,"21 de agosto de 1994"
20,9,28,162,97,110,207,"21 de agosto de 1994"
20,9,28,163,91,94,185,"21 de agosto de 1994"
20,9,28,164,154,157,311,"21 de agosto de 1994"
20,9,28,165,25,31,56,"21 de agosto de 1994"
20,9,28,166,344,385,729,"21 de agosto de 1994"
20,9,28,167,200,220,420,"21 de agosto de 1994"
20,9,28,168,158,215,373,"21 de agosto de 1994"
20,9,28,169,236,273,509,"21 de agosto de 1994"
20,9,28,170,181,184,365,"21 de agosto de 1994"
20,9,28,171,66,73,139,"21 de agosto de 1994"
20,9,28,172,87,91,178,"21 de agosto de 1994"
20,9,28,173,290,267,557,"21 de agosto de 1994"
20,9,28,174,131,180,311,"21 de agosto de 1994"
20,9,28,175,161,164,325,"21 de agosto de 1994"
20,9,48,374,215,250,465,"21 de agosto de 1994"
20,9,50,378,352,379,731,"21 de agosto de 1994"
20,9,50,379,358,389,747,"21 de agosto de 1994"
20,9,59,432,286,359,645,"21 de agosto de 1994"
20,9,59,433,356,386,742,"21 de agosto de 1994"
20,9,59,434,417,493,910,"21 de agosto de 1994"
20,9,59,435,206,278,484,"21 de agosto de 1994"
20,9,59,436,216,298,514,"21 de agosto de 1994"
20,9,59,437,285,326,611,"21 de agosto de 1994"
20,9,59,438,302,302,604,"21 de agosto de 1994"
20,9,59,439,384,433,817,"21 de agosto de 1994"
20,9,59,440,363,345,708,"21 de agosto de 1994"
20,9,59,441,414,445,859,"21 de agosto de 1994"
20,9,59,442,481,448,929,"21 de agosto de 1994"
20,9,59,443,85,97,182,"21 de agosto de 1994"
20,9,59,444,275,298,573,"21 de agosto de 1994"
20,9,59,445,320,329,649,"21 de agosto de 1994"
20,9,59,446,419,554,973,"21 de agosto de 1994"
20,9,59,447,218,233,451,"21 de agosto de 1994"
20,9,59,448,137,189,326,"21 de agosto de 1994"
20,9,59,449,315,273,588,"21 de agosto de 1994"
20,9,59,450,154,98,252,"21 de agosto de 1994"
20,9,59,451,159,172,331,"21 de agosto de 1994"
20,9,59,452,196,215,411,"21 de agosto de 1994"
20,9,59,453,61,56,117,"21 de agosto de 1994"
20,9,61,456,210,285,495,"21 de agosto de 1994"
20,9,61,457,248,263,511,"21 de agosto de 1994"
20,9,67,617,412,446,858,"21 de agosto de 1994"
20,9,67,618,326,337,663,"21 de agosto de 1994"
20,9,67,619,435,474,909,"21 de agosto de 1994"
20,9,67,620,487,521,1008,"21 de agosto de 1994"
20,9,67,621,444,481,925,"21 de agosto de 1994"
20,9,67,622,498,503,1001,"21 de agosto de 1994"
20,9,67,623,233,248,481,"21 de agosto de 1994"
20,9,67,624,155,176,331,"21 de agosto de 1994"
20,9,67,625,136,172,308,"21 de agosto de 1994"
20,9,67,626,88,76,164,"21 de agosto de 1994"
20,9,67,627,69,74,143,"21 de agosto de 1994"
20,9,67,628,237,308,545,"21 de agosto de 1994"
20,9,67,629,74,95,169,"21 de agosto de 1994"
20,9,67,630,238,206,444,"21 de agosto de 1994"
20,9,67,631,116,126,242,"21 de agosto de 1994"
20,9,70,638,371,367,738,"21 de agosto de 1994"
20,9,70,639,47,40,87,"21 de agosto de 1994"
20,9,70,640,92,71,163,"21 de agosto de 1994"
20,9,70,641,89,74,163,"21 de agosto de 1994"
20,9,70,642,154,123,277,"21 de agosto de 1994"
20,9,82,721,251,264,515,"21 de agosto de 1994"
20,9,82,722,357,398,755,"21 de agosto de 1994"
20,9,82,723,493,433,926,"21 de agosto de 1994"
20,9,82,724,407,395,802,"21 de agosto de 1994"
20,9,82,725,297,288,585,"21 de agosto de 1994"
20,9,82,726,279,245,524,"21 de agosto de 1994"
20,9,82,727,294,257,551,"21 de agosto de 1994"
20,9,82,728,343,389,732,"21 de agosto de 1994"
20,9,82,729,443,430,873,"21 de agosto de 1994"
20,9,82,730,339,352,691,"21 de agosto de 1994"
20,9,82,731,286,230,516,"21 de agosto de 1994"
20,9,82,732,463,400,863,"21 de agosto de 1994"
20,9,82,733,212,260,472,"21 de agosto de 1994"
20,9,92,753,376,296,672,"21 de agosto de 1994"
20,9,92,754,211,156,367,"21 de agosto de 1994"
20,9,92,755,123,90,213,"21 de agosto de 1994"
20,9,100,766,274,268,542,"21 de agosto de 1994"
20,9,100,767,205,195,400,"21 de agosto de 1994"
20,9,100,768,202,236,438,"21 de agosto de 1994"
20,9,100,769,254,206,460,"21 de agosto de 1994"
20,9,109,792,351,388,739,"21 de agosto de 1994"
20,9,109,793,355,418,773,"21 de agosto de 1994"
20,9,123,831,273,283,556,"21 de agosto de 1994"
20,9,123,832,257,259,516,"21 de agosto de 1994"
20,9,123,833,35,41,76,"21 de agosto de 1994"
20,9,123,834,141,167,308,"21 de agosto de 1994"
20,9,128,841,567,559,1126,"21 de agosto de 1994"
20,9,128,842,660,646,1306,"21 de agosto de 1994"
20,9,128,843,268,332,600,"21 de agosto de 1994"
20,9,128,844,143,181,324,"21 de agosto de 1994"
20,9,128,845,255,260,515,"21 de agosto de 1994"
20,9,129,846,300,335,635,"21 de agosto de 1994"
20,9,143,894,174,206,380,"21 de agosto de 1994"
20,9,143,895,162,198,360,"21 de agosto de 1994"
20,9,145,897,259,243,502,"21 de agosto de 1994"
20,9,145,898,153,149,302,"21 de agosto de 1994"
20,9,151,911,253,294,547,"21 de agosto de 1994"
20,9,151,912,224,168,392,"21 de agosto de 1994"
20,9,159,931,255,289,544,"21 de agosto de 1994"
20,9,165,949,297,298,595,"21 de agosto de 1994"
20,9,165,950,75,70,145,"21 de agosto de 1994"
20,9,168,955,349,398,747,"21 de agosto de 1994"
20,9,168,956,135,142,277,"21 de agosto de 1994"
20,9,168,957,198,205,403,"21 de agosto de 1994"
20,9,169,958,382,384,766,"21 de agosto de 1994"
20,9,169,959,315,349,664,"21 de agosto de 1994"
20,9,169,960,269,281,550,"21 de agosto de 1994"
20,9,169,961,249,249,498,"21 de agosto de 1994"
20,9,186,1107,359,397,756,"21 de agosto de 1994"
20,9,204,1172,171,188,359,"21 de agosto de 1994"
20,9,204,1173,132,131,263,"21 de agosto de 1994"
20,9,204,1174,262,247,509,"21 de agosto de 1994"
20,9,204,1175,99,119,218,"21 de agosto de 1994"
20,9,209,1204,131,205,336,"21 de agosto de 1994"
20,9,211,1210,167,172,339,"21 de agosto de 1994"
20,9,211,1211,83,79,162,"21 de agosto de 1994"
20,9,211,1212,198,206,404,"21 de agosto de 1994"
20,9,235,1271,179,259,438,"21 de agosto de 1994"
20,9,235,1272,136,181,317,"21 de agosto de 1994"
20,9,235,1273,183,177,360,"21 de agosto de 1994"
20,9,235,1274,210,246,456,"21 de agosto de 1994"
20,9,235,1275,38,38,76,"21 de agosto de 1994"
20,9,236,1276,196,187,383,"21 de agosto de 1994"
20,9,236,1277,189,163,352,"21 de agosto de 1994"
20,9,238,1282,193,218,411,"21 de agosto de 1994"
20,9,251,1306,245,240,485,"21 de agosto de 1994"
20,9,251,1307,191,169,360,"21 de agosto de 1994"
20,9,251,1308,117,99,216,"21 de agosto de 1994"
20,9,251,1309,110,110,220,"21 de agosto de 1994"
20,9,252,1310,346,367,713,"21 de agosto de 1994"
20,9,252,1311,214,183,397,"21 de agosto de 1994"
20,9,252,1312,106,92,198,"21 de agosto de 1994"
20,9,252,1313,118,70,188,"21 de agosto de 1994"
20,9,265,1347,355,297,652,"21 de agosto de 1994"
20,9,265,1348,410,397,807,"21 de agosto de 1994"
20,9,265,1349,150,110,260,"21 de agosto de 1994"
20,9,265,1350,302,286,588,"21 de agosto de 1994"
20,9,265,1351,152,131,283,"21 de agosto de 1994"
20,9,267,1353,180,213,393,"21 de agosto de 1994"
20,9,277,1396,265,277,542,"21 de agosto de 1994"
20,9,277,1397,259,265,524,"21 de agosto de 1994"
20,9,282,1407,511,539,1050,"21 de agosto de 1994"
20,9,282,1408,182,200,382,"21 de agosto de 1994"
20,9,287,1417,276,339,615,"21 de agosto de 1994"
20,9,299,1452,188,217,405,"21 de agosto de 1994"
20,9,299,1453,214,314,528,"21 de agosto de 1994"
20,9,304,1463,349,361,710,"21 de agosto de 1994"
20,9,304,1464,246,207,453,"21 de agosto de 1994"
20,9,313,1494,358,448,806,"21 de agosto de 1994"
20,9,314,1495,170,199,369,"21 de agosto de 1994"
20,9,317,1511,224,244,468,"21 de agosto de 1994"
20,9,322,1516,363,344,707,"21 de agosto de 1994"
20,9,322,1517,358,314,672,"21 de agosto de 1994"
20,9,322,1518,692,658,1350,"21 de agosto de 1994"
20,9,322,1519,638,618,1256,"21 de agosto de 1994"
20,9,322,1520,485,476,961,"21 de agosto de 1994"
20,9,322,1521,283,266,549,"21 de agosto de 1994"
20,9,322,1522,467,435,902,"21 de agosto de 1994"
20,9,322,1523,205,170,375,"21 de agosto de 1994"
20,9,322,1524,217,189,406,"21 de agosto de 1994"
20,9,322,1525,337,282,619,"21 de agosto de 1994"
20,9,322,1526,26,19,45,"21 de agosto de 1994"
20,9,322,1527,517,513,1030,"21 de agosto de 1994"
20,9,322,1528,403,385,788,"21 de agosto de 1994"
20,9,322,1529,554,450,1004,"21 de agosto de 1994"
20,9,322,1530,374,312,686,"21 de agosto de 1994"
20,9,322,1531,423,388,811,"21 de agosto de 1994"
20,9,322,1532,358,254,612,"21 de agosto de 1994"
20,9,322,1533,595,400,995,"21 de agosto de 1994"
20,9,322,1534,404,346,750,"21 de agosto de 1994"
20,9,326,1553,188,184,372,"21 de agosto de 1994"
20,9,331,1561,394,439,833,"21 de agosto de 1994"
20,9,331,1562,200,247,447,"21 de agosto de 1994"
20,9,331,1563,133,130,263,"21 de agosto de 1994"
20,9,344,1614,245,194,439,"21 de agosto de 1994"
20,9,344,1615,156,147,303,"21 de agosto de 1994"
20,9,344,1616,239,235,474,"21 de agosto de 1994"
20,9,348,1634,361,461,822,"21 de agosto de 1994"
20,9,348,1635,224,250,474,"21 de agosto de 1994"
20,9,353,1641,332,380,712,"21 de agosto de 1994"
20,9,361,1652,131,166,297,"21 de agosto de 1994"
20,9,362,1653,397,481,878,"21 de agosto de 1994"
20,9,368,1673,185,178,363,"21 de agosto de 1994"
20,9,368,1674,173,176,349,"21 de agosto de 1994"
20,9,370,1676,93,97,190,"21 de agosto de 1994"
20,9,385,1709,327,310,637,"21 de agosto de 1994"
20,9,385,1710,325,294,619,"21 de agosto de 1994"
20,9,385,1711,114,182,296,"21 de agosto de 1994"
20,9,393,1769,137,79,216,"21 de agosto de 1994"
20,9,393,1770,186,116,302,"21 de agosto de 1994"
20,9,395,1776,720,771,1491,"21 de agosto de 1994"
20,9,414,1841,459,409,868,"21 de agosto de 1994"
20,9,414,1842,771,694,1465,"21 de agosto de 1994"
20,9,414,1843,158,122,280,"21 de agosto de 1994"
20,9,414,1844,543,437,980,"21 de agosto de 1994"
20,9,414,1845,567,448,1015,"21 de agosto de 1994"
20,9,414,1846,841,685,1526,"21 de agosto de 1994"
20,9,414,1847,321,240,561,"21 de agosto de 1994"
20,9,414,1848,540,443,983,"21 de agosto de 1994"
20,9,414,1849,401,333,734,"21 de agosto de 1994"
20,9,414,1850,462,381,843,"21 de agosto de 1994"
20,9,425,1882,194,214,408,"21 de agosto de 1994"
20,9,425,1883,84,77,161,"21 de agosto de 1994"
20,9,425,1884,146,160,306,"21 de agosto de 1994"
20,9,425,1885,171,178,349,"21 de agosto de 1994"
20,9,425,1886,185,185,370,"21 de agosto de 1994"
20,9,440,1919,575,440,1015,"21 de agosto de 1994"
20,9,440,1920,309,289,598,"21 de agosto de 1994"
20,9,440,1921,218,183,401,"21 de agosto de 1994"
20,9,440,1922,449,419,868,"21 de agosto de 1994"
20,9,440,1923,329,248,577,"21 de agosto de 1994"
20,9,440,1924,317,222,539,"21 de agosto de 1994"
20,9,440,1925,554,447,1001,"21 de agosto de 1994"
20,9,440,1926,408,396,804,"21 de agosto de 1994"
20,9,440,1927,568,496,1064,"21 de agosto de 1994"
20,9,450,1951,316,319,635,"21 de agosto de 1994"
20,9,450,1952,298,356,654,"21 de agosto de 1994"
20,9,450,1953,177,185,362,"21 de agosto de 1994"
20,9,450,1954,128,134,262,"21 de agosto de 1994"
20,9,453,1962,190,218,408,"21 de agosto de 1994"
20,9,453,1963,299,350,649,"21 de agosto de 1994"
20,9,453,1964,246,274,520,"21 de agosto de 1994"
20,9,496,2144,163,142,305,"21 de agosto de 1994"
20,9,496,2145,76,85,161,"21 de agosto de 1994"
20,9,496,2146,157,132,289,"21 de agosto de 1994"
20,9,496,2147,196,190,386,"21 de agosto de 1994"
20,9,512,2189,187,195,382,"21 de agosto de 1994"
20,9,526,2258,99,120,219,"21 de agosto de 1994"
20,9,526,2259,124,122,246,"21 de agosto de 1994"
20,9,526,2260,348,335,683,"21 de agosto de 1994"
20,9,529,2264,355,367,722,"21 de agosto de 1994"
20,9,535,2290,135,152,287,"21 de agosto de 1994"
20,9,538,2304,180,282,462,"21 de agosto de 1994"
20,9,563,2419,211,219,430,"21 de agosto de 1994"
20,9,563,2420,215,223,438,"21 de agosto de 1994"
20,9,564,2421,366,430,796,"21 de agosto de 1994"
20,10,4,39,123,193,316,"21 de agosto de 1994"
20,10,4,40,53,34,87,"21 de agosto de 1994"
20,10,4,41,112,108,220,"21 de agosto de 1994"
20,10,9,68,171,191,362,"21 de agosto de 1994"
20,10,9,69,89,57,146,"21 de agosto de 1994"
20,10,35,194,354,229,583,"21 de agosto de 1994"
20,10,35,195,248,177,425,"21 de agosto de 1994"
20,10,35,196,356,251,607,"21 de agosto de 1994"
20,10,35,197,210,214,424,"21 de agosto de 1994"
20,10,51,380,415,388,803,"21 de agosto de 1994"
20,10,51,381,484,466,950,"21 de agosto de 1994"
20,10,51,382,547,515,1062,"21 de agosto de 1994"
20,10,51,383,62,53,115,"21 de agosto de 1994"
20,10,51,384,38,29,67,"21 de agosto de 1994"
20,10,51,385,193,145,338,"21 de agosto de 1994"
20,10,52,386,358,344,702,"21 de agosto de 1994"
20,10,60,454,191,159,350,"21 de agosto de 1994"
20,10,60,455,141,121,262,"21 de agosto de 1994"
20,10,64,461,233,239,472,"21 de agosto de 1994"
20,10,64,462,270,254,524,"21 de agosto de 1994"
20,10,64,463,248,249,497,"21 de agosto de 1994"
20,10,64,464,229,225,454,"21 de agosto de 1994"
20,10,64,465,96,24,120,"21 de agosto de 1994"
20,10,64,466,218,208,426,"21 de agosto de 1994"
20,10,64,467,34,27,61,"21 de agosto de 1994"
20,10,64,468,120,121,241,"21 de agosto de 1994"
20,10,76,669,649,649,1298,"21 de agosto de 1994"
20,10,76,670,542,524,1066,"21 de agosto de 1994"
20,10,76,671,381,399,780,"21 de agosto de 1994"
20,10,76,672,554,591,1145,"21 de agosto de 1994"
20,10,76,673,579,580,1159,"21 de agosto de 1994"
20,10,76,674,540,526,1066,"21 de agosto de 1994"
20,10,76,675,569,622,1191,"21 de agosto de 1994"
20,10,76,676,558,554,1112,"21 de agosto de 1994"
20,10,76,677,462,472,934,"21 de agosto de 1994"
20,10,76,678,550,569,1119,"21 de agosto de 1994"
20,10,76,679,658,699,1357,"21 de agosto de 1994"
20,10,76,680,494,528,1022,"21 de agosto de 1994"
20,10,76,681,426,403,829,"21 de agosto de 1994"
20,10,76,682,405,375,780,"21 de agosto de 1994"
20,10,76,683,406,435,841,"21 de agosto de 1994"
20,10,76,684,340,339,679,"21 de agosto de 1994"
20,10,76,685,631,646,1277,"21 de agosto de 1994"
20,10,76,686,477,523,1000,"21 de agosto de 1994"
20,10,76,687,566,567,1133,"21 de agosto de 1994"
20,10,76,688,649,645,1294,"21 de agosto de 1994"
20,10,76,689,473,461,934,"21 de agosto de 1994"
20,10,76,690,270,310,580,"21 de agosto de 1994"
20,10,76,691,485,494,979,"21 de agosto de 1994"
20,10,76,692,449,499,948,"21 de agosto de 1994"
20,10,76,693,506,494,1000,"21 de agosto de 1994"
20,10,76,694,589,568,1157,"21 de agosto de 1994"
20,10,76,695,415,445,860,"21 de agosto de 1994"
20,10,76,696,505,525,1030,"21 de agosto de 1994"
20,10,76,697,547,627,1174,"21 de agosto de 1994"
20,10,76,698,703,168,871,"21 de agosto de 1994"
20,10,76,699,486,467,953,"21 de agosto de 1994"
20,10,76,700,393,380,773,"21 de agosto de 1994"
20,10,76,701,471,455,926,"21 de agosto de 1994"
20,10,76,702,517,435,952,"21 de agosto de 1994"
20,10,76,703,560,545,1105,"21 de agosto de 1994"
20,10,76,704,108,97,205,"21 de agosto de 1994"
20,10,76,705,69,55,124,"21 de agosto de 1994"
20,10,76,706,152,134,286,"21 de agosto de 1994"
20,10,76,707,185,176,361,"21 de agosto de 1994"
20,10,76,708,450,348,798,"21 de agosto de 1994"
20,10,76,709,358,422,780,"21 de agosto de 1994"
20,10,114,803,216,207,423,"21 de agosto de 1994"
20,10,121,814,495,441,936,"21 de agosto de 1994"
20,10,121,815,557,492,1049,"21 de agosto de 1994"
20,10,121,816,653,650,1303,"21 de agosto de 1994"
20,10,121,817,563,576,1139,"21 de agosto de 1994"
20,10,121,818,582,541,1123,"21 de agosto de 1994"
20,10,121,819,514,563,1077,"21 de agosto de 1994"
20,10,122,820,180,169,349,"21 de agosto de 1994"
20,10,122,821,125,5,130,"21 de agosto de 1994"
20,10,122,822,125,95,220,"21 de agosto de 1994"
20,10,122,823,132,52,184,"21 de agosto de 1994"
20,10,122,824,352,318,670,"21 de agosto de 1994"
20,10,122,825,173,154,327,"21 de agosto de 1994"
20,10,122,826,219,168,387,"21 de agosto de 1994"
20,10,122,827,149,112,261,"21 de agosto de 1994"
20,10,122,828,122,92,214,"21 de agosto de 1994"
20,10,122,829,306,252,558,"21 de agosto de 1994"
20,10,122,830,52,54,106,"21 de agosto de 1994"
20,10,192,1119,342,276,618,"21 de agosto de 1994"
20,10,192,1120,524,442,966,"21 de agosto de 1994"
20,10,192,1121,382,341,723,"21 de agosto de 1994"
20,10,192,1122,587,551,1138,"21 de agosto de 1994"
20,10,192,1123,579,558,1137,"21 de agosto de 1994"
20,10,192,1124,746,708,1454,"21 de agosto de 1994"
20,10,192,1125,363,316,679,"21 de agosto de 1994"
20,10,192,1126,369,298,667,"21 de agosto de 1994"
20,10,192,1127,376,418,794,"21 de agosto de 1994"
20,10,192,1128,112,103,215,"21 de agosto de 1994"
20,10,201,1164,199,229,428,"21 de agosto de 1994"
20,10,201,1165,236,264,500,"21 de agosto de 1994"
20,10,201,1166,89,112,201,"21 de agosto de 1994"
20,10,201,1167,166,137,303,"21 de agosto de 1994"
20,10,205,1176,153,205,358,"21 de agosto de 1994"
20,10,206,1177,305,300,605,"21 de agosto de 1994"
20,10,206,1178,488,442,930,"21 de agosto de 1994"
20,10,206,1179,474,430,904,"21 de agosto de 1994"
20,10,206,1180,277,302,579,"21 de agosto de 1994"
20,10,206,1181,246,197,443,"21 de agosto de 1994"
20,10,206,1182,621,617,1238,"21 de agosto de 1994"
20,10,206,1183,603,604,1207,"21 de agosto de 1994"
20,10,207,1184,315,301,616,"21 de agosto de 1994"
20,10,207,1185,469,398,867,"21 de agosto de 1994"
20,10,207,1186,551,485,1036,"21 de agosto de 1994"
20,10,207,1187,410,362,772,"21 de agosto de 1994"
20,10,207,1188,158,159,317,"21 de agosto de 1994"
20,10,207,1189,408,336,744,"21 de agosto de 1994"
20,10,207,1190,228,220,448,"21 de agosto de 1994"
20,10,207,1191,196,176,372,"21 de agosto de 1994"
20,10,207,1192,209,202,411,"21 de agosto de 1994"
20,10,231,1253,368,340,708,"21 de agosto de 1994"
20,10,247,1297,539,422,961,"21 de agosto de 1994"
20,10,247,1298,491,408,899,"21 de agosto de 1994"
20,10,247,1299,443,373,816,"21 de agosto de 1994"
20,10,247,1300,510,456,966,"21 de agosto de 1994"
20,10,247,1301,463,376,839,"21 de agosto de 1994"
20,10,274,1368,382,285,667,"21 de agosto de 1994"
20,10,274,1369,404,293,697,"21 de agosto de 1994"
20,10,274,1370,286,223,509,"21 de agosto de 1994"
20,10,280,1402,188,170,358,"21 de agosto de 1994"
20,10,280,1403,43,18,61,"21 de agosto de 1994"
20,10,303,1461,592,656,1248,"21 de agosto de 1994"
20,10,303,1462,414,450,864,"21 de agosto de 1994"
20,10,305,1465,232,247,479,"21 de agosto de 1994"
20,10,305,1466,215,232,447,"21 de agosto de 1994"
20,10,305,1467,75,60,135,"21 de agosto de 1994"
20,10,305,1468,266,166,432,"21 de agosto de 1994"
20,10,305,1469,69,72,141,"21 de agosto de 1994"
20,10,305,1470,411,296,707,"21 de agosto de 1994"
20,10,305,1471,346,264,610,"21 de agosto de 1994"
20,10,306,1472,571,526,1097,"21 de agosto de 1994"
20,10,321,1515,329,278,607,"21 de agosto de 1994"
20,10,323,1535,269,257,526,"21 de agosto de 1994"
20,10,323,1536,321,300,621,"21 de agosto de 1994"
20,10,323,1537,346,311,657,"21 de agosto de 1994"
20,10,323,1538,245,234,479,"21 de agosto de 1994"
20,10,323,1539,294,235,529,"21 de agosto de 1994"
20,10,323,1540,330,344,674,"21 de agosto de 1994"
20,10,357,1646,246,259,505,"21 de agosto de 1994"
20,10,397,1778,344,307,651,"21 de agosto de 1994"
20,10,397,1779,218,247,465,"21 de agosto de 1994"
20,10,411,1834,252,272,524,"21 de agosto de 1994"
20,10,411,1835,140,117,257,"21 de agosto de 1994"
20,10,411,1836,218,209,427,"21 de agosto de 1994"
20,10,411,1837,244,223,467,"21 de agosto de 1994"
20,10,413,1839,362,272,634,"21 de agosto de 1994"
20,10,413,1840,121,58,179,"21 de agosto de 1994"
20,10,419,1866,462,487,949,"21 de agosto de 1994"
20,10,419,1867,393,430,823,"21 de agosto de 1994"
20,10,419,1868,402,445,847,"21 de agosto de 1994"
20,10,419,1869,321,343,664,"21 de agosto de 1994"
20,10,419,1870,399,446,845,"21 de agosto de 1994"
20,10,419,1871,202,157,359,"21 de agosto de 1994"
20,10,419,1872,283,288,571,"21 de agosto de 1994"
20,10,422,1875,303,335,638,"21 de agosto de 1994"
20,10,422,1876,365,395,760,"21 de agosto de 1994"
20,10,422,1877,304,320,624,"21 de agosto de 1994"
20,10,429,1903,315,269,584,"21 de agosto de 1994"
20,10,436,1911,148,165,313,"21 de agosto de 1994"
20,10,436,1912,88,70,158,"21 de agosto de 1994"
20,10,438,1914,307,292,599,"21 de agosto de 1994"
20,10,438,1915,382,392,774,"21 de agosto de 1994"
20,10,438,1916,234,206,440,"21 de agosto de 1994"
20,10,438,1917,230,197,427,"21 de agosto de 1994"
20,10,441,1928,247,255,502,"21 de agosto de 1994"
20,10,454,1965,246,227,473,"21 de agosto de 1994"
20,10,454,1966,231,187,418,"21 de agosto de 1994"
20,10,454,1967,34,21,55,"21 de agosto de 1994"
20,10,454,1968,158,131,289,"21 de agosto de 1994"
20,10,455,1969,217,190,407,"21 de agosto de 1994"
20,10,455,1970,201,165,366,"21 de agosto de 1994"
20,10,466,2004,246,261,507,"21 de agosto de 1994"
20,10,471,2050,307,204,511,"21 de agosto de 1994"
20,10,471,2051,267,189,456,"21 de agosto de 1994"
20,10,471,2052,188,181,369,"21 de agosto de 1994"
20,10,471,2053,157,151,308,"21 de agosto de 1994"
20,10,471,2054,201,170,371,"21 de agosto de 1994"
20,10,471,2055,124,78,202,"21 de agosto de 1994"
20,10,473,2057,297,296,593,"21 de agosto de 1994"
20,10,473,2058,364,379,743,"21 de agosto de 1994"
20,10,473,2059,76,70,146,"21 de agosto de 1994"
20,10,499,2151,188,175,363,"21 de agosto de 1994"
20,10,499,2152,189,138,327,"21 de agosto de 1994"
20,10,499,2153,467,386,853,"21 de agosto de 1994"
20,10,499,2154,253,228,481,"21 de agosto de 1994"
20,10,499,2155,254,253,507,"21 de agosto de 1994"
20,10,507,2175,399,397,796,"21 de agosto de 1994"
20,10,515,2200,516,534,1050,"21 de agosto de 1994"
20,10,515,2201,421,373,794,"21 de agosto de 1994"
20,10,515,2202,663,713,1376,"21 de agosto de 1994"
20,10,515,2203,444,533,977,"21 de agosto de 1994"
20,10,515,2204,365,387,752,"21 de agosto de 1994"
20,10,515,2205,430,468,898,"21 de agosto de 1994"
20,10,515,2206,488,533,1021,"21 de agosto de 1994"
20,10,515,2207,821,805,1626,"21 de agosto de 1994"
20,10,515,2208,328,345,673,"21 de agosto de 1994"
20,10,515,2209,441,469,910,"21 de agosto de 1994"
20,10,515,2210,586,622,1208,"21 de agosto de 1994"
20,10,515,2211,192,190,382,"21 de agosto de 1994"
20,10,515,2212,414,453,867,"21 de agosto de 1994"
20,10,515,2213,370,374,744,"21 de agosto de 1994"
20,10,515,2214,593,604,1197,"21 de agosto de 1994"
20,10,515,2215,544,573,1117,"21 de agosto de 1994"
20,10,515,2216,604,587,1191,"21 de agosto de 1994"
20,10,515,2217,527,543,1070,"21 de agosto de 1994"
20,10,515,2218,541,516,1057,"21 de agosto de 1994"
20,10,515,2219,413,380,793,"21 de agosto de 1994"
20,10,515,2220,227,265,492,"21 de agosto de 1994"
20,10,515,2221,371,414,785,"21 de agosto de 1994"
20,10,515,2222,266,222,488,"21 de agosto de 1994"
20,10,515,2223,198,170,368,"21 de agosto de 1994"
20,10,515,2224,357,315,672,"21 de agosto de 1994"
20,10,515,2225,92,69,161,"21 de agosto de 1994"
20,10,515,2226,473,414,887,"21 de agosto de 1994"
20,10,515,2227,410,324,734,"21 de agosto de 1994"
20,10,515,2228,397,313,710,"21 de agosto de 1994"
21,1,115,933,220,252,472,"21 de agosto de 1994"
21,1,115,934,200,225,425,"21 de agosto de 1994"
21,1,115,935,308,337,645,"21 de agosto de 1994"
21,1,115,936,262,270,532,"21 de agosto de 1994"
21,1,115,937,369,384,753,"21 de agosto de 1994"
21,1,115,938,148,160,308,"21 de agosto de 1994"
21,1,115,939,191,212,403,"21 de agosto de 1994"
21,1,115,940,395,446,841,"21 de agosto de 1994"
21,1,115,941,283,336,619,"21 de agosto de 1994"
21,1,115,942,519,658,1177,"21 de agosto de 1994"
21,1,115,943,457,524,981,"21 de agosto de 1994"
21,1,115,944,588,618,1206,"21 de agosto de 1994"
21,1,115,945,418,469,887,"21 de agosto de 1994"
21,1,115,946,326,360,686,"21 de agosto de 1994"
21,1,115,947,472,517,989,"21 de agosto de 1994"
21,1,115,948,538,624,1162,"21 de agosto de 1994"
21,1,115,949,322,341,663,"21 de agosto de 1994"
21,1,115,950,219,244,463,"21 de agosto de 1994"
21,1,115,951,428,485,913,"21 de agosto de 1994"
21,1,115,952,401,428,829,"21 de agosto de 1994"
21,1,115,953,453,503,956,"21 de agosto de 1994"
21,1,115,954,370,448,818,"21 de agosto de 1994"
21,1,115,955,326,359,685,"21 de agosto de 1994"
21,1,115,956,355,406,761,"21 de agosto de 1994"
21,1,115,957,328,437,765,"21 de agosto de 1994"
21,1,115,958,478,542,1020,"21 de agosto de 1994"
21,1,115,959,471,613,1084,"21 de agosto de 1994"
21,1,115,960,369,435,804,"21 de agosto de 1994"
21,1,115,961,590,694,1284,"21 de agosto de 1994"
21,1,115,962,550,669,1219,"21 de agosto de 1994"
21,1,115,963,384,493,877,"21 de agosto de 1994"
21,1,115,964,320,378,698,"21 de agosto de 1994"
21,1,115,965,319,353,672,"21 de agosto de 1994"
21,1,115,966,163,214,377,"21 de agosto de 1994"
21,1,115,967,256,308,564,"21 de agosto de 1994"
21,1,115,968,336,385,721,"21 de agosto de 1994"
21,1,115,969,234,246,480,"21 de agosto de 1994"
21,1,115,970,405,497,902,"21 de agosto de 1994"
21,1,115,971,298,330,628,"21 de agosto de 1994"
21,1,115,972,447,461,908,"21 de agosto de 1994"
21,1,115,973,561,619,1180,"21 de agosto de 1994"
21,1,115,974,406,415,821,"21 de agosto de 1994"
21,1,115,975,300,335,635,"21 de agosto de 1994"
21,1,115,976,558,620,1178,"21 de agosto de 1994"
21,1,115,977,654,743,1397,"21 de agosto de 1994"
21,1,115,978,455,524,979,"21 de agosto de 1994"
21,1,115,979,398,474,872,"21 de agosto de 1994"
21,1,115,980,491,530,1021,"21 de agosto de 1994"
21,1,115,981,476,494,970,"21 de agosto de 1994"
21,1,115,982,503,624,1127,"21 de agosto de 1994"
21,1,115,983,463,547,1010,"21 de agosto de 1994"
21,1,115,984,435,479,914,"21 de agosto de 1994"
21,1,115,985,312,410,722,"21 de agosto de 1994"
21,1,115,986,424,552,976,"21 de agosto de 1994"
21,1,115,987,278,277,555,"21 de agosto de 1994"
21,1,115,988,288,289,577,"21 de agosto de 1994"
21,1,115,989,185,234,419,"21 de agosto de 1994"
21,1,115,990,210,224,434,"21 de agosto de 1994"
21,1,115,991,290,308,598,"21 de agosto de 1994"
21,1,115,992,287,313,600,"21 de agosto de 1994"
21,1,115,993,438,521,959,"21 de agosto de 1994"
21,1,115,994,290,327,617,"21 de agosto de 1994"
21,1,115,995,329,463,792,"21 de agosto de 1994"
21,1,115,996,496,620,1116,"21 de agosto de 1994"
21,1,115,997,253,306,559,"21 de agosto de 1994"
21,1,115,998,360,442,802,"21 de agosto de 1994"
21,1,115,999,260,352,612,"21 de agosto de 1994"
21,1,115,1000,452,588,1040,"21 de agosto de 1994"
21,1,115,1001,352,389,741,"21 de agosto de 1994"
21,1,115,1002,513,518,1031,"21 de agosto de 1994"
21,1,115,1003,526,562,1088,"21 de agosto de 1994"
21,1,115,1004,608,645,1253,"21 de agosto de 1994"
21,1,115,1005,345,413,758,"21 de agosto de 1994"
21,1,115,1006,381,419,800,"21 de agosto de 1994"
21,1,115,1007,407,421,828,"21 de agosto de 1994"
21,1,115,1008,578,619,1197,"21 de agosto de 1994"
21,1,115,1009,399,484,883,"21 de agosto de 1994"
21,1,115,1010,656,689,1345,"21 de agosto de 1994"
21,1,115,1011,635,712,1347,"21 de agosto de 1994"
21,1,115,1012,262,331,593,"21 de agosto de 1994"
21,1,115,1013,497,641,1138,"21 de agosto de 1994"
21,1,115,1014,288,370,658,"21 de agosto de 1994"
21,1,115,1015,454,517,971,"21 de agosto de 1994"
21,1,115,1016,288,343,631,"21 de agosto de 1994"
21,1,115,1017,334,396,730,"21 de agosto de 1994"
21,1,115,1018,409,459,868,"21 de agosto de 1994"
21,1,115,1019,393,463,856,"21 de agosto de 1994"
21,1,115,1020,347,422,769,"21 de agosto de 1994"
21,1,115,1021,282,354,636,"21 de agosto de 1994"
21,1,115,1022,391,461,852,"21 de agosto de 1994"
21,1,115,1023,364,445,809,"21 de agosto de 1994"
21,1,115,1024,326,388,714,"21 de agosto de 1994"
21,1,115,1025,606,655,1261,"21 de agosto de 1994"
21,1,115,1026,464,542,1006,"21 de agosto de 1994"
21,1,115,1027,370,354,724,"21 de agosto de 1994"
21,1,115,1028,642,652,1294,"21 de agosto de 1994"
21,1,115,1029,307,323,630,"21 de agosto de 1994"
21,1,115,1030,425,453,878,"21 de agosto de 1994"
21,1,115,1031,568,622,1190,"21 de agosto de 1994"
21,1,115,1032,454,537,991,"21 de agosto de 1994"
21,1,115,1033,443,438,881,"21 de agosto de 1994"
21,1,115,1034,707,805,1512,"21 de agosto de 1994"
21,1,115,1035,706,828,1534,"21 de agosto de 1994"
21,1,115,1036,621,695,1316,"21 de agosto de 1994"
21,1,115,1037,386,468,854,"21 de agosto de 1994"
21,1,115,1038,477,524,1001,"21 de agosto de 1994"
21,1,115,1039,411,543,954,"21 de agosto de 1994"
21,1,115,1040,288,322,610,"21 de agosto de 1994"
21,1,115,1041,422,515,937,"21 de agosto de 1994"
21,1,115,1042,457,497,954,"21 de agosto de 1994"
21,1,115,1043,474,535,1009,"21 de agosto de 1994"
21,1,115,1044,522,560,1082,"21 de agosto de 1994"
21,1,115,1045,489,544,1033,"21 de agosto de 1994"
21,1,115,1046,205,201,406,"21 de agosto de 1994"
21,1,115,1047,754,746,1500,"21 de agosto de 1994"
21,1,115,1048,112,126,238,"21 de agosto de 1994"
21,1,115,1049,601,674,1275,"21 de agosto de 1994"
21,1,115,1050,577,629,1206,"21 de agosto de 1994"
21,1,115,1051,667,771,1438,"21 de agosto de 1994"
21,1,115,1052,472,516,988,"21 de agosto de 1994"
21,1,115,1053,413,453,866,"21 de agosto de 1994"
21,1,115,1054,535,622,1157,"21 de agosto de 1994"
21,1,115,1055,739,800,1539,"21 de agosto de 1994"
21,1,115,1056,444,534,978,"21 de agosto de 1994"
21,1,115,1057,399,435,834,"21 de agosto de 1994"
21,1,115,1058,516,571,1087,"21 de agosto de 1994"
21,1,115,1059,508,513,1021,"21 de agosto de 1994"
21,1,115,1060,402,468,870,"21 de agosto de 1994"
21,1,115,1061,317,405,722,"21 de agosto de 1994"
21,1,115,1062,604,626,1230,"21 de agosto de 1994"
21,1,115,1063,502,541,1043,"21 de agosto de 1994"
21,1,115,1064,515,545,1060,"21 de agosto de 1994"
21,1,115,1065,1027,1221,2248,"21 de agosto de 1994"
21,1,115,1066,201,170,371,"21 de agosto de 1994"
21,1,115,1067,518,483,1001,"21 de agosto de 1994"
21,1,115,1068,519,552,1071,"21 de agosto de 1994"
21,1,115,1069,350,410,760,"21 de agosto de 1994"
21,1,115,1070,595,646,1241,"21 de agosto de 1994"
21,1,115,1071,383,406,789,"21 de agosto de 1994"
21,1,115,1072,712,774,1486,"21 de agosto de 1994"
21,1,115,1073,357,385,742,"21 de agosto de 1994"
21,1,115,1074,339,354,693,"21 de agosto de 1994"
21,1,115,1075,146,143,289,"21 de agosto de 1994"
21,1,115,1076,350,353,703,"21 de agosto de 1994"
21,1,115,1077,283,320,603,"21 de agosto de 1994"
21,1,115,1078,239,283,522,"21 de agosto de 1994"
21,1,115,1079,198,226,424,"21 de agosto de 1994"
21,2,115,1080,146,159,305,"21 de agosto de 1994"
21,2,115,1081,200,234,434,"21 de agosto de 1994"
21,2,115,1082,134,182,316,"21 de agosto de 1994"
21,2,115,1083,129,147,276,"21 de agosto de 1994"
21,2,115,1084,217,255,472,"21 de agosto de 1994"
21,2,115,1085,238,318,556,"21 de agosto de 1994"
21,2,115,1086,454,636,1090,"21 de agosto de 1994"
21,2,115,1087,310,396,706,"21 de agosto de 1994"
21,2,115,1088,431,553,984,"21 de agosto de 1994"
21,2,115,1089,482,579,1061,"21 de agosto de 1994"
21,2,115,1090,408,528,936,"21 de agosto de 1994"
21,2,115,1091,664,770,1434,"21 de agosto de 1994"
21,2,115,1092,591,693,1284,"21 de agosto de 1994"
21,2,115,1093,478,496,974,"21 de agosto de 1994"
21,2,115,1094,480,513,993,"21 de agosto de 1994"
21,2,115,1095,249,245,494,"21 de agosto de 1994"
21,2,115,1096,491,532,1023,"21 de agosto de 1994"
21,2,115,1097,427,508,935,"21 de agosto de 1994"
21,2,115,1098,323,377,700,"21 de agosto de 1994"
21,2,115,1099,684,856,1540,"21 de agosto de 1994"
21,2,115,1100,432,547,979,"21 de agosto de 1994"
21,2,115,1101,710,842,1552,"21 de agosto de 1994"
21,2,115,1102,457,537,994,"21 de agosto de 1994"
21,2,115,1103,255,311,566,"21 de agosto de 1994"
21,2,115,1104,252,297,549,"21 de agosto de 1994"
21,2,115,1105,473,613,1086,"21 de agosto de 1994"
21,2,115,1106,309,340,649,"21 de agosto de 1994"
21,2,115,1107,251,246,497,"21 de agosto de 1994"
21,2,115,1108,134,181,315,"21 de agosto de 1994"
21,2,115,1109,206,309,515,"21 de agosto de 1994"
21,2,115,1110,180,248,428,"21 de agosto de 1994"
21,2,115,1111,530,657,1187,"21 de agosto de 1994"
21,2,115,1112,204,253,457,"21 de agosto de 1994"
21,2,115,1113,187,220,407,"21 de agosto de 1994"
21,2,115,1114,258,364,622,"21 de agosto de 1994"
21,2,115,1115,204,268,472,"21 de agosto de 1994"
21,2,115,1116,233,290,523,"21 de agosto de 1994"
21,2,115,1117,327,415,742,"21 de agosto de 1994"
21,2,115,1118,412,518,930,"21 de agosto de 1994"
21,2,115,1119,205,233,438,"21 de agosto de 1994"
21,2,115,1120,463,548,1011,"21 de agosto de 1994"
21,2,115,1121,541,688,1229,"21 de agosto de 1994"
21,2,115,1122,402,446,848,"21 de agosto de 1994"
21,2,115,1123,236,256,492,"21 de agosto de 1994"
21,2,115,1124,539,600,1139,"21 de agosto de 1994"
21,2,115,1125,370,501,871,"21 de agosto de 1994"
21,2,115,1126,326,350,676,"21 de agosto de 1994"
21,2,115,1127,727,803,1530,"21 de agosto de 1994"
21,2,115,1128,715,775,1490,"21 de agosto de 1994"
21,2,115,1129,369,427,796,"21 de agosto de 1994"
21,2,115,1130,473,569,1042,"21 de agosto de 1994"
21,2,115,1131,587,716,1303,"21 de agosto de 1994"
21,2,115,1132,387,439,826,"21 de agosto de 1994"
21,2,115,1133,454,562,1016,"21 de agosto de 1994"
21,2,115,1134,524,641,1165,"21 de agosto de 1994"
21,2,115,1135,408,530,938,"21 de agosto de 1994"
21,2,115,1136,449,566,1015,"21 de agosto de 1994"
21,2,115,1137,534,634,1168,"21 de agosto de 1994"
21,2,115,1138,289,432,721,"21 de agosto de 1994"
21,2,115,1139,255,338,593,"21 de agosto de 1994"
21,2,115,1140,464,616,1080,"21 de agosto de 1994"
21,2,115,1141,315,450,765,"21 de agosto de 1994"
21,2,115,1142,565,748,1313,"21 de agosto de 1994"
21,2,115,1143,254,352,606,"21 de agosto de 1994"
21,2,115,1144,307,425,732,"21 de agosto de 1994"
21,2,115,1145,334,410,744,"21 de agosto de 1994"
21,2,115,1146,359,509,868,"21 de agosto de 1994"
21,2,115,1147,376,567,943,"21 de agosto de 1994"
21,2,115,1148,568,686,1254,"21 de agosto de 1994"
21,2,115,1149,426,542,968,"21 de agosto de 1994"
21,2,115,1150,498,526,1024,"21 de agosto de 1994"
21,2,115,1151,445,542,987,"21 de agosto de 1994"
21,2,115,1152,293,382,675,"21 de agosto de 1994"
21,2,115,1153,481,598,1079,"21 de agosto de 1994"
21,2,115,1154,637,695,1332,"21 de agosto de 1994"
21,2,115,1155,376,448,824,"21 de agosto de 1994"
21,2,115,1156,388,461,849,"21 de agosto de 1994"
21,2,115,1157,502,567,1069,"21 de agosto de 1994"
21,2,115,1158,419,531,950,"21 de agosto de 1994"
21,2,115,1159,513,559,1072,"21 de agosto de 1994"
21,2,115,1160,345,453,798,"21 de agosto de 1994"
21,2,115,1161,363,460,823,"21 de agosto de 1994"
21,2,115,1162,381,500,881,"21 de agosto de 1994"
21,2,115,1163,441,560,1001,"21 de agosto de 1994"
21,2,115,1164,503,634,1137,"21 de agosto de 1994"
21,2,115,1165,496,593,1089,"21 de agosto de 1994"
21,2,115,1166,363,408,771,"21 de agosto de 1994"
21,2,115,1167,374,454,828,"21 de agosto de 1994"
21,2,115,1168,508,567,1075,"21 de agosto de 1994"
21,2,115,1169,619,685,1304,"21 de agosto de 1994"
21,2,115,1170,331,387,718,"21 de agosto de 1994"
21,2,115,1171,420,537,957,"21 de agosto de 1994"
21,2,115,1172,435,555,990,"21 de agosto de 1994"
21,2,115,1173,487,557,1044,"21 de agosto de 1994"
21,2,115,1174,448,537,985,"21 de agosto de 1994"
21,2,115,1175,508,581,1089,"21 de agosto de 1994"
21,2,115,1176,691,826,1517,"21 de agosto de 1994"
21,2,115,1177,490,569,1059,"21 de agosto de 1994"
21,2,115,1178,565,599,1164,"21 de agosto de 1994"
21,2,115,1179,466,573,1039,"21 de agosto de 1994"
21,2,115,1180,358,439,797,"21 de agosto de 1994"
21,2,115,1181,389,446,835,"21 de agosto de 1994"
21,2,115,1182,545,660,1205,"21 de agosto de 1994"
21,2,115,1183,309,389,698,"21 de agosto de 1994"
21,2,115,1184,305,370,675,"21 de agosto de 1994"
21,2,115,1185,515,587,1102,"21 de agosto de 1994"
21,2,115,1186,530,642,1172,"21 de agosto de 1994"
21,2,115,1187,566,697,1263,"21 de agosto de 1994"
21,2,115,1188,614,736,1350,"21 de agosto de 1994"
21,2,115,1189,427,518,945,"21 de agosto de 1994"
21,2,115,1190,660,855,1515,"21 de agosto de 1994"
21,2,115,1191,521,555,1076,"21 de agosto de 1994"
21,2,115,1192,524,614,1138,"21 de agosto de 1994"
21,2,115,1193,596,719,1315,"21 de agosto de 1994"
21,2,115,1194,659,755,1414,"21 de agosto de 1994"
21,2,115,1195,643,739,1382,"21 de agosto de 1994"
21,2,115,1196,656,776,1432,"21 de agosto de 1994"
21,2,115,1197,367,425,792,"21 de agosto de 1994"
21,2,115,1198,412,423,835,"21 de agosto de 1994"
21,2,115,1199,373,393,766,"21 de agosto de 1994"
21,2,115,1200,402,442,844,"21 de agosto de 1994"
21,2,115,1201,596,735,1331,"21 de agosto de 1994"
21,2,115,1202,465,512,977,"21 de agosto de 1994"
21,2,115,1203,418,483,901,"21 de agosto de 1994"
21,2,115,1204,690,839,1529,"21 de agosto de 1994"
21,2,115,1205,360,467,827,"21 de agosto de 1994"
21,2,115,1206,649,755,1404,"21 de agosto de 1994"
21,2,115,1207,396,472,868,"21 de agosto de 1994"
21,2,115,1208,378,416,794,"21 de agosto de 1994"
21,2,115,1209,623,715,1338,"21 de agosto de 1994"
21,2,115,1210,541,612,1153,"21 de agosto de 1994"
21,2,115,1211,555,602,1157,"21 de agosto de 1994"
21,2,115,1212,340,365,705,"21 de agosto de 1994"
21,2,115,1213,444,494,938,"21 de agosto de 1994"
21,2,115,1214,510,591,1101,"21 de agosto de 1994"
21,2,115,1215,467,479,946,"21 de agosto de 1994"
21,2,115,1216,583,623,1206,"21 de agosto de 1994"
21,2,115,1217,722,820,1542,"21 de agosto de 1994"
21,2,115,1218,534,650,1184,"21 de agosto de 1994"
21,2,115,1219,812,880,1692,"21 de agosto de 1994"
21,2,115,1220,504,581,1085,"21 de agosto de 1994"
21,2,115,1221,685,766,1451,"21 de agosto de 1994"
21,2,115,1222,488,559,1047,"21 de agosto de 1994"
21,2,115,1223,233,240,473,"21 de agosto de 1994"
21,2,115,1224,469,543,1012,"21 de agosto de 1994"
21,2,115,1225,503,582,1085,"21 de agosto de 1994"
21,2,115,1226,320,386,706,"21 de agosto de 1994"
21,2,115,1227,360,437,797,"21 de agosto de 1994"
21,2,115,1228,343,383,726,"21 de agosto de 1994"
21,2,115,1229,366,424,790,"21 de agosto de 1994"
21,2,115,1230,387,462,849,"21 de agosto de 1994"
21,2,115,1231,311,357,668,"21 de agosto de 1994"
21,2,115,1232,470,539,1009,"21 de agosto de 1994"
21,2,115,1233,584,717,1301,"21 de agosto de 1994"
21,2,115,1234,1959,2387,4346,"21 de agosto de 1994"
21,2,115,1235,291,355,646,"21 de agosto de 1994"
21,2,115,1236,247,323,570,"21 de agosto de 1994"
21,2,115,1237,263,330,593,"21 de agosto de 1994"
21,2,115,1238,1076,1319,2395,"21 de agosto de 1994"
21,2,115,1239,312,361,673,"21 de agosto de 1994"
21,2,115,1240,243,351,594,"21 de agosto de 1994"
21,2,115,1241,161,195,356,"21 de agosto de 1994"
21,2,115,1242,485,598,1083,"21 de agosto de 1994"
21,2,115,1243,573,651,1224,"21 de agosto de 1994"
21,2,115,1244,618,709,1327,"21 de agosto de 1994"
21,2,115,1245,462,513,975,"21 de agosto de 1994"
21,2,115,1246,529,616,1145,"21 de agosto de 1994"
21,2,115,1247,972,1091,2063,"21 de agosto de 1994"
21,2,115,1248,424,513,937,"21 de agosto de 1994"
21,2,115,1249,416,443,859,"21 de agosto de 1994"
21,2,115,1250,301,331,632,"21 de agosto de 1994"
21,2,115,1251,376,432,808,"21 de agosto de 1994"
21,2,115,1252,293,307,600,"21 de agosto de 1994"
21,2,115,1253,477,546,1023,"21 de agosto de 1994"
21,2,115,1254,353,422,775,"21 de agosto de 1994"
21,2,115,1255,404,464,868,"21 de agosto de 1994"
21,2,115,1256,301,298,599,"21 de agosto de 1994"
21,2,115,1257,335,305,640,"21 de agosto de 1994"
21,2,115,1258,244,205,449,"21 de agosto de 1994"
21,2,115,1259,491,389,880,"21 de agosto de 1994"
21,2,115,1260,546,553,1099,"21 de agosto de 1994"
21,3,35,282,350,347,697,"21 de agosto de 1994"
21,3,35,283,641,642,1283,"21 de agosto de 1994"
21,3,35,284,500,472,972,"21 de agosto de 1994"
21,3,35,285,515,527,1042,"21 de agosto de 1994"
21,3,35,286,279,286,565,"21 de agosto de 1994"
21,3,35,287,503,505,1008,"21 de agosto de 1994"
21,3,35,288,289,288,577,"21 de agosto de 1994"
21,3,35,289,516,480,996,"21 de agosto de 1994"
21,3,35,290,395,407,802,"21 de agosto de 1994"
21,3,35,291,551,517,1068,"21 de agosto de 1994"
21,3,35,292,457,423,880,"21 de agosto de 1994"
21,3,35,293,522,560,1082,"21 de agosto de 1994"
21,3,42,325,591,625,1216,"21 de agosto de 1994"
21,3,42,326,557,595,1152,"21 de agosto de 1994"
21,3,42,327,547,575,1122,"21 de agosto de 1994"
21,3,42,328,659,692,1351,"21 de agosto de 1994"
21,3,42,329,443,472,915,"21 de agosto de 1994"
21,3,42,330,512,541,1053,"21 de agosto de 1994"
21,3,42,331,351,376,727,"21 de agosto de 1994"
21,3,42,332,470,510,980,"21 de agosto de 1994"
21,3,42,333,458,509,967,"21 de agosto de 1994"
21,3,42,334,252,257,509,"21 de agosto de 1994"
21,3,42,335,131,150,281,"21 de agosto de 1994"
21,3,42,336,394,463,857,"21 de agosto de 1994"
21,3,42,337,452,483,935,"21 de agosto de 1994"
21,3,42,338,452,460,912,"21 de agosto de 1994"
21,3,42,339,500,511,1011,"21 de agosto de 1994"
21,3,49,415,601,666,1267,"21 de agosto de 1994"
21,3,49,416,409,416,825,"21 de agosto de 1994"
21,3,49,417,394,430,824,"21 de agosto de 1994"
21,3,49,418,630,574,1204,"21 de agosto de 1994"
21,3,49,419,378,384,762,"21 de agosto de 1994"
21,3,49,420,624,606,1230,"21 de agosto de 1994"
21,3,49,421,336,366,702,"21 de agosto de 1994"
21,3,49,422,398,427,825,"21 de agosto de 1994"
21,3,61,515,312,346,658,"21 de agosto de 1994"
21,3,61,516,504,519,1023,"21 de agosto de 1994"
21,3,61,517,425,435,860,"21 de agosto de 1994"
21,3,76,651,383,420,803,"21 de agosto de 1994"
21,3,76,652,537,562,1099,"21 de agosto de 1994"
21,3,76,653,519,568,1087,"21 de agosto de 1994"
21,3,76,654,476,544,1020,"21 de agosto de 1994"
21,3,76,655,483,545,1028,"21 de agosto de 1994"
21,3,76,656,409,455,864,"21 de agosto de 1994"
21,3,76,657,706,773,1479,"21 de agosto de 1994"
21,3,76,658,372,368,740,"21 de agosto de 1994"
21,3,76,659,437,461,898,"21 de agosto de 1994"
21,3,76,660,414,437,851,"21 de agosto de 1994"
21,3,76,661,635,700,1335,"21 de agosto de 1994"
21,3,76,662,488,537,1025,"21 de agosto de 1994"
21,3,76,663,425,472,897,"21 de agosto de 1994"
21,3,76,664,504,522,1026,"21 de agosto de 1994"
21,3,76,665,459,430,889,"21 de agosto de 1994"
21,3,76,666,457,522,979,"21 de agosto de 1994"
21,3,76,667,421,428,849,"21 de agosto de 1994"
21,3,76,668,563,541,1104,"21 de agosto de 1994"
21,3,76,669,144,115,259,"21 de agosto de 1994"
21,3,76,670,523,487,1010,"21 de agosto de 1994"
21,3,76,671,235,222,457,"21 de agosto de 1994"
21,3,76,672,721,677,1398,"21 de agosto de 1994"
21,3,123,1677,391,382,773,"21 de agosto de 1994"
21,3,123,1678,459,486,945,"21 de agosto de 1994"
21,3,123,1679,370,407,777,"21 de agosto de 1994"
21,3,123,1680,506,476,982,"21 de agosto de 1994"
21,3,123,1681,158,146,304,"21 de agosto de 1994"
21,3,133,1720,739,747,1486,"21 de agosto de 1994"
21,3,133,1721,475,535,1010,"21 de agosto de 1994"
21,3,133,1722,367,385,752,"21 de agosto de 1994"
21,3,133,1723,491,534,1025,"21 de agosto de 1994"
21,3,133,1724,566,664,1230,"21 de agosto de 1994"
21,3,133,1725,612,676,1288,"21 de agosto de 1994"
21,3,133,1726,392,427,819,"21 de agosto de 1994"
21,3,133,1727,530,575,1105,"21 de agosto de 1994"
21,3,133,1728,424,482,906,"21 de agosto de 1994"
21,3,133,1729,412,462,874,"21 de agosto de 1994"
21,3,133,1730,392,410,802,"21 de agosto de 1994"
21,3,133,1731,185,206,391,"21 de agosto de 1994"
21,3,133,1732,313,389,702,"21 de agosto de 1994"
21,3,133,1733,568,703,1271,"21 de agosto de 1994"
21,3,133,1734,509,547,1056,"21 de agosto de 1994"
21,3,133,1735,484,550,1034,"21 de agosto de 1994"
21,3,133,1736,254,286,540,"21 de agosto de 1994"
21,3,133,1737,286,315,601,"21 de agosto de 1994"
21,3,133,1738,284,330,614,"21 de agosto de 1994"
21,3,133,1739,386,418,804,"21 de agosto de 1994"
21,3,133,1740,390,480,870,"21 de agosto de 1994"
21,3,133,1741,367,428,795,"21 de agosto de 1994"
21,3,133,1742,366,350,716,"21 de agosto de 1994"
21,3,133,1743,546,586,1132,"21 de agosto de 1994"
21,3,133,1744,430,454,884,"21 de agosto de 1994"
21,3,133,1745,309,371,680,"21 de agosto de 1994"
21,3,133,1746,516,542,1058,"21 de agosto de 1994"
21,3,133,1747,419,392,811,"21 de agosto de 1994"
21,3,133,1748,689,654,1343,"21 de agosto de 1994"
21,3,133,1749,210,241,451,"21 de agosto de 1994"
21,3,133,1750,897,840,1737,"21 de agosto de 1994"
21,3,133,1751,561,531,1092,"21 de agosto de 1994"
21,3,133,1752,492,468,960,"21 de agosto de 1994"
21,3,133,1753,283,286,569,"21 de agosto de 1994"
21,3,133,1754,610,673,1283,"21 de agosto de 1994"
21,3,133,1755,617,643,1260,"21 de agosto de 1994"
21,3,133,1756,734,807,1541,"21 de agosto de 1994"
21,3,133,1757,361,407,768,"21 de agosto de 1994"
21,3,133,1758,543,587,1130,"21 de agosto de 1994"
21,3,133,1759,572,575,1147,"21 de agosto de 1994"
21,3,133,1760,575,577,1152,"21 de agosto de 1994"
21,3,133,1761,415,422,837,"21 de agosto de 1994"
21,3,133,1762,540,567,1107,"21 de agosto de 1994"
21,3,133,1763,481,497,978,"21 de agosto de 1994"
21,3,133,1764,393,396,789,"21 de agosto de 1994"
21,3,133,1765,250,279,529,"21 de agosto de 1994"
21,3,133,1766,637,685,1322,"21 de agosto de 1994"
21,3,133,1767,437,511,948,"21 de agosto de 1994"
21,3,133,1768,395,426,821,"21 de agosto de 1994"
21,3,133,1769,332,371,703,"21 de agosto de 1994"
21,3,133,1770,586,683,1269,"21 de agosto de 1994"
21,3,133,1771,800,886,1686,"21 de agosto de 1994"
21,3,133,1772,347,396,743,"21 de agosto de 1994"
21,3,133,1773,459,525,984,"21 de agosto de 1994"
21,3,135,1775,545,569,1114,"21 de agosto de 1994"
21,3,135,1776,491,459,950,"21 de agosto de 1994"
21,3,135,1777,559,571,1130,"21 de agosto de 1994"
21,3,135,1778,586,603,1189,"21 de agosto de 1994"
21,3,135,1779,356,377,733,"21 de agosto de 1994"
21,3,135,1780,281,292,573,"21 de agosto de 1994"
21,3,135,1781,400,366,766,"21 de agosto de 1994"
21,3,135,1782,249,243,492,"21 de agosto de 1994"
21,3,135,1783,266,259,525,"21 de agosto de 1994"
21,3,137,1785,531,563,1094,"21 de agosto de 1994"
21,3,137,1786,518,545,1063,"21 de agosto de 1994"
21,3,137,1787,389,402,791,"21 de agosto de 1994"
21,3,137,1788,563,538,1101,"21 de agosto de 1994"
21,3,141,1800,436,468,904,"21 de agosto de 1994"
21,3,141,1801,381,434,815,"21 de agosto de 1994"
21,3,141,1802,436,455,891,"21 de agosto de 1994"
21,3,141,1803,588,602,1190,"21 de agosto de 1994"
21,3,141,1804,542,580,1122,"21 de agosto de 1994"
21,3,141,1805,566,608,1174,"21 de agosto de 1994"
21,3,141,1806,239,275,514,"21 de agosto de 1994"
21,3,141,1807,588,601,1189,"21 de agosto de 1994"
21,3,141,1808,346,403,749,"21 de agosto de 1994"
21,3,141,1809,353,399,752,"21 de agosto de 1994"
21,3,141,1810,360,410,770,"21 de agosto de 1994"
21,3,141,1811,481,517,998,"21 de agosto de 1994"
21,3,141,1812,446,454,900,"21 de agosto de 1994"
21,3,141,1813,374,404,778,"21 de agosto de 1994"
21,3,141,1814,247,267,514,"21 de agosto de 1994"
21,3,141,1815,666,764,1430,"21 de agosto de 1994"
21,3,141,1816,578,695,1273,"21 de agosto de 1994"
21,3,141,1817,354,374,728,"21 de agosto de 1994"
21,3,141,1818,532,554,1086,"21 de agosto de 1994"
21,3,141,1819,347,364,711,"21 de agosto de 1994"
21,3,141,1820,617,632,1249,"21 de agosto de 1994"
21,3,141,1821,611,593,1204,"21 de agosto de 1994"
21,3,141,1822,416,394,810,"21 de agosto de 1994"
21,3,141,1823,337,307,644,"21 de agosto de 1994"
21,3,141,1824,789,884,1673,"21 de agosto de 1994"
21,3,141,1825,314,324,638,"21 de agosto de 1994"
21,3,141,1826,638,632,1270,"21 de agosto de 1994"
21,3,141,1827,427,419,846,"21 de agosto de 1994"
21,3,141,1828,530,511,1041,"21 de agosto de 1994"
21,3,141,1829,419,366,785,"21 de agosto de 1994"
21,3,141,1830,607,591,1198,"21 de agosto de 1994"
21,3,141,1831,337,382,719,"21 de agosto de 1994"
21,3,141,1832,273,269,542,"21 de agosto de 1994"
21,3,141,1833,360,338,698,"21 de agosto de 1994"
21,3,141,1834,411,477,888,"21 de agosto de 1994"
21,3,141,1835,279,329,608,"21 de agosto de 1994"
21,3,141,1836,332,354,686,"21 de agosto de 1994"
21,3,141,1837,367,387,754,"21 de agosto de 1994"
21,3,141,1838,284,299,583,"21 de agosto de 1994"
21,3,141,1839,497,523,1020,"21 de agosto de 1994"
21,3,141,1840,608,661,1269,"21 de agosto de 1994"
21,3,141,1841,402,435,837,"21 de agosto de 1994"
21,3,141,1842,389,427,816,"21 de agosto de 1994"
21,3,141,1843,490,501,991,"21 de agosto de 1994"
21,3,141,1844,373,404,777,"21 de agosto de 1994"
21,3,141,1845,410,473,883,"21 de agosto de 1994"
21,3,144,1858,577,592,1169,"21 de agosto de 1994"
21,3,144,1859,421,428,849,"21 de agosto de 1994"
21,3,144,1860,422,462,884,"21 de agosto de 1994"
21,3,144,1861,457,457,914,"21 de agosto de 1994"
21,3,144,1862,354,348,702,"21 de agosto de 1994"
21,3,144,1863,471,455,926,"21 de agosto de 1994"
21,3,144,1864,377,356,733,"21 de agosto de 1994"
21,3,144,1865,423,425,848,"21 de agosto de 1994"
21,3,144,1866,529,547,1076,"21 de agosto de 1994"
21,3,144,1867,689,683,1372,"21 de agosto de 1994"
21,3,180,2233,686,705,1391,"21 de agosto de 1994"
21,3,180,2234,577,561,1138,"21 de agosto de 1994"
21,3,180,2235,305,329,634,"21 de agosto de 1994"
21,3,180,2236,235,270,505,"21 de agosto de 1994"
21,3,180,2237,201,171,372,"21 de agosto de 1994"
21,3,180,2238,343,306,649,"21 de agosto de 1994"
21,3,180,2239,461,455,916,"21 de agosto de 1994"
21,3,180,2240,533,511,1044,"21 de agosto de 1994"
21,3,180,2241,289,308,597,"21 de agosto de 1994"
21,3,180,2242,201,175,376,"21 de agosto de 1994"
21,3,180,2243,229,206,435,"21 de agosto de 1994"
21,3,180,2244,526,534,1060,"21 de agosto de 1994"
21,3,180,2245,606,583,1189,"21 de agosto de 1994"
21,3,180,2246,657,584,1241,"21 de agosto de 1994"
21,3,180,2247,762,656,1418,"21 de agosto de 1994"
21,3,181,2248,253,284,537,"21 de agosto de 1994"
21,3,181,2249,404,433,837,"21 de agosto de 1994"
21,3,181,2250,306,337,643,"21 de agosto de 1994"
21,4,5,61,387,405,792,"21 de agosto de 1994"
21,4,5,62,276,266,542,"21 de agosto de 1994"
21,4,5,63,173,172,345,"21 de agosto de 1994"
21,4,19,154,525,572,1097,"21 de agosto de 1994"
21,4,19,155,105,140,245,"21 de agosto de 1994"
21,4,19,156,74,101,175,"21 de agosto de 1994"
21,4,19,157,229,283,512,"21 de agosto de 1994"
21,4,19,158,322,366,688,"21 de agosto de 1994"
21,4,19,159,349,368,717,"21 de agosto de 1994"
21,4,19,160,439,513,952,"21 de agosto de 1994"
21,4,19,161,365,465,830,"21 de agosto de 1994"
21,4,19,162,397,482,879,"21 de agosto de 1994"
21,4,19,163,667,787,1454,"21 de agosto de 1994"
21,4,19,164,566,684,1250,"21 de agosto de 1994"
21,4,19,165,552,653,1205,"21 de agosto de 1994"
21,4,19,166,468,609,1077,"21 de agosto de 1994"
21,4,19,167,417,539,956,"21 de agosto de 1994"
21,4,19,168,549,689,1238,"21 de agosto de 1994"
21,4,19,169,385,484,869,"21 de agosto de 1994"
21,4,19,170,344,435,779,"21 de agosto de 1994"
21,4,19,171,187,231,418,"21 de agosto de 1994"
21,4,19,172,89,106,195,"21 de agosto de 1994"
21,4,19,173,282,329,611,"21 de agosto de 1994"
21,4,19,174,480,613,1093,"21 de agosto de 1994"
21,4,19,175,250,290,540,"21 de agosto de 1994"
21,4,19,176,263,309,572,"21 de agosto de 1994"
21,4,19,177,566,702,1268,"21 de agosto de 1994"
21,4,19,178,445,563,1008,"21 de agosto de 1994"
21,4,19,179,260,349,609,"21 de agosto de 1994"
21,4,19,180,310,380,690,"21 de agosto de 1994"
21,4,19,181,213,264,477,"21 de agosto de 1994"
21,4,19,182,211,289,500,"21 de agosto de 1994"
21,4,19,183,193,256,449,"21 de agosto de 1994"
21,4,19,184,237,322,559,"21 de agosto de 1994"
21,4,19,185,539,715,1254,"21 de agosto de 1994"
21,4,19,186,549,649,1198,"21 de agosto de 1994"
21,4,19,187,297,392,689,"21 de agosto de 1994"
21,4,19,188,399,514,913,"21 de agosto de 1994"
21,4,19,189,462,554,1016,"21 de agosto de 1994"
21,4,19,190,347,431,778,"21 de agosto de 1994"
21,4,19,191,369,514,883,"21 de agosto de 1994"
21,4,19,192,273,348,621,"21 de agosto de 1994"
21,4,19,193,521,665,1186,"21 de agosto de 1994"
21,4,19,194,252,337,589,"21 de agosto de 1994"
21,4,19,195,98,102,200,"21 de agosto de 1994"
21,4,19,196,259,336,595,"21 de agosto de 1994"
21,4,19,197,469,578,1047,"21 de agosto de 1994"
21,4,19,198,368,511,879,"21 de agosto de 1994"
21,4,19,199,366,465,831,"21 de agosto de 1994"
21,4,19,200,470,113,583,"21 de agosto de 1994"
21,4,19,201,363,478,841,"21 de agosto de 1994"
21,4,19,202,320,384,704,"21 de agosto de 1994"
21,4,19,203,239,334,573,"21 de agosto de 1994"
21,4,19,204,277,407,684,"21 de agosto de 1994"
21,4,19,205,318,431,749,"21 de agosto de 1994"
21,4,19,206,301,383,684,"21 de agosto de 1994"
21,4,19,207,444,537,981,"21 de agosto de 1994"
21,4,19,208,415,418,833,"21 de agosto de 1994"
21,4,19,209,282,287,569,"21 de agosto de 1994"
21,4,19,210,85,117,202,"21 de agosto de 1994"
21,4,19,211,176,264,440,"21 de agosto de 1994"
21,4,19,212,459,624,1083,"21 de agosto de 1994"
21,4,19,213,283,456,739,"21 de agosto de 1994"
21,4,19,214,389,381,770,"21 de agosto de 1994"
21,4,19,215,418,479,897,"21 de agosto de 1994"
21,4,19,216,414,424,838,"21 de agosto de 1994"
21,4,19,217,336,391,727,"21 de agosto de 1994"
21,4,19,218,259,278,537,"21 de agosto de 1994"
21,4,19,219,412,507,919,"21 de agosto de 1994"
21,4,19,220,134,193,327,"21 de agosto de 1994"
21,4,19,221,204,243,447,"21 de agosto de 1994"
21,4,22,225,216,242,458,"21 de agosto de 1994"
21,4,22,226,368,384,752,"21 de agosto de 1994"
21,4,22,227,304,315,619,"21 de agosto de 1994"
21,4,22,228,270,288,558,"21 de agosto de 1994"
21,4,22,229,236,278,514,"21 de agosto de 1994"
21,4,22,230,220,214,434,"21 de agosto de 1994"
21,4,22,231,140,129,269,"21 de agosto de 1994"
21,4,22,232,269,253,522,"21 de agosto de 1994"
21,4,22,233,165,154,319,"21 de agosto de 1994"
21,4,26,245,222,281,503,"21 de agosto de 1994"
21,4,26,246,394,440,834,"21 de agosto de 1994"
21,4,26,247,383,392,775,"21 de agosto de 1994"
21,4,26,248,544,572,1116,"21 de agosto de 1994"
21,4,26,249,279,286,565,"21 de agosto de 1994"
21,4,26,250,247,242,489,"21 de agosto de 1994"
21,4,26,251,296,235,531,"21 de agosto de 1994"
21,4,26,252,205,181,386,"21 de agosto de 1994"
21,4,34,279,421,405,826,"21 de agosto de 1994"
21,4,34,280,360,409,769,"21 de agosto de 1994"
21,4,34,281,182,170,352,"21 de agosto de 1994"
21,4,70,569,370,443,813,"21 de agosto de 1994"
21,4,70,570,230,269,499,"21 de agosto de 1994"
21,4,70,571,183,265,448,"21 de agosto de 1994"
21,4,70,572,201,261,462,"21 de agosto de 1994"
21,4,70,573,178,261,439,"21 de agosto de 1994"
21,4,70,574,366,439,805,"21 de agosto de 1994"
21,4,70,575,319,344,663,"21 de agosto de 1994"
21,4,70,576,322,382,704,"21 de agosto de 1994"
21,4,70,577,188,245,433,"21 de agosto de 1994"
21,4,70,578,304,404,708,"21 de agosto de 1994"
21,4,70,579,382,395,777,"21 de agosto de 1994"
21,4,70,580,285,322,607,"21 de agosto de 1994"
21,4,70,581,144,202,346,"21 de agosto de 1994"
21,4,70,582,318,353,671,"21 de agosto de 1994"
21,4,70,583,246,329,575,"21 de agosto de 1994"
21,4,70,584,155,232,387,"21 de agosto de 1994"
21,4,70,585,358,470,828,"21 de agosto de 1994"
21,4,70,586,191,219,410,"21 de agosto de 1994"
21,4,70,587,95,96,191,"21 de agosto de 1994"
21,4,92,786,674,623,1297,"21 de agosto de 1994"
21,4,92,787,294,299,593,"21 de agosto de 1994"
21,4,92,788,346,406,752,"21 de agosto de 1994"
21,4,92,789,394,450,844,"21 de agosto de 1994"
21,4,92,790,558,584,1142,"21 de agosto de 1994"
21,4,92,791,552,541,1093,"21 de agosto de 1994"
21,4,103,838,372,400,772,"21 de agosto de 1994"
21,4,103,839,279,321,600,"21 de agosto de 1994"
21,4,103,840,376,374,750,"21 de agosto de 1994"
21,4,103,841,520,552,1072,"21 de agosto de 1994"
21,4,107,857,417,411,828,"21 de agosto de 1994"
21,4,107,858,333,297,630,"21 de agosto de 1994"
21,4,107,859,581,580,1161,"21 de agosto de 1994"
21,4,107,860,259,202,461,"21 de agosto de 1994"
21,4,107,861,239,176,415,"21 de agosto de 1994"
21,4,107,862,248,156,404,"21 de agosto de 1994"
21,4,107,863,82,64,146,"21 de agosto de 1994"
21,4,107,864,360,335,695,"21 de agosto de 1994"
21,4,107,865,333,313,646,"21 de agosto de 1994"
21,4,107,866,295,314,609,"21 de agosto de 1994"
21,4,120,1651,464,499,963,"21 de agosto de 1994"
21,4,120,1652,608,663,1271,"21 de agosto de 1994"
21,4,120,1653,427,407,834,"21 de agosto de 1994"
21,4,120,1654,473,491,964,"21 de agosto de 1994"
21,4,120,1655,378,393,771,"21 de agosto de 1994"
21,4,120,1656,300,262,562,"21 de agosto de 1994"
21,4,120,1657,491,414,905,"21 de agosto de 1994"
21,4,120,1658,394,402,796,"21 de agosto de 1994"
21,4,120,1659,435,431,866,"21 de agosto de 1994"
21,4,120,1660,615,666,1281,"21 de agosto de 1994"
21,4,120,1661,421,393,814,"21 de agosto de 1994"
21,4,120,1662,351,384,735,"21 de agosto de 1994"
21,4,120,1663,735,801,1536,"21 de agosto de 1994"
21,4,120,1664,500,517,1017,"21 de agosto de 1994"
21,4,120,1665,398,439,837,"21 de agosto de 1994"
21,4,120,1666,349,376,725,"21 de agosto de 1994"
21,4,120,1667,543,553,1096,"21 de agosto de 1994"
21,4,120,1668,492,519,1011,"21 de agosto de 1994"
21,4,120,1669,375,372,747,"21 de agosto de 1994"
21,4,120,1670,353,378,731,"21 de agosto de 1994"
21,4,120,1671,483,470,953,"21 de agosto de 1994"
21,4,126,1691,269,242,511,"21 de agosto de 1994"
21,4,126,1692,421,384,805,"21 de agosto de 1994"
21,4,126,1693,530,534,1064,"21 de agosto de 1994"
21,4,126,1694,391,406,797,"21 de agosto de 1994"
21,4,127,1695,457,490,947,"21 de agosto de 1994"
21,4,127,1696,187,110,297,"21 de agosto de 1994"
21,4,127,1697,263,257,520,"21 de agosto de 1994"
21,4,139,1793,344,296,640,"21 de agosto de 1994"
21,4,139,1794,555,485,1040,"21 de agosto de 1994"
21,4,139,1795,212,218,430,"21 de agosto de 1994"
21,4,139,1796,426,437,863,"21 de agosto de 1994"
21,4,139,1797,362,240,602,"21 de agosto de 1994"
21,4,148,1877,362,404,766,"21 de agosto de 1994"
21,4,148,1878,312,342,654,"21 de agosto de 1994"
21,4,148,1879,106,112,218,"21 de agosto de 1994"
21,4,148,1880,379,432,811,"21 de agosto de 1994"
21,4,148,1881,408,385,793,"21 de agosto de 1994"
21,4,164,2082,253,228,481,"21 de agosto de 1994"
21,4,174,2175,202,205,407,"21 de agosto de 1994"
21,4,174,2176,441,479,920,"21 de agosto de 1994"
21,4,174,2177,347,342,689,"21 de agosto de 1994"
21,4,174,2178,271,321,592,"21 de agosto de 1994"
21,4,174,2179,201,220,421,"21 de agosto de 1994"
21,4,174,2180,226,236,462,"21 de agosto de 1994"
21,4,188,2299,300,355,655,"21 de agosto de 1994"
21,4,188,2300,434,578,1012,"21 de agosto de 1994"
21,4,188,2301,472,567,1039,"21 de agosto de 1994"
21,4,188,2302,222,224,446,"21 de agosto de 1994"
21,4,188,2303,272,283,555,"21 de agosto de 1994"
21,4,188,2304,172,188,360,"21 de agosto de 1994"
21,4,188,2305,298,324,622,"21 de agosto de 1994"
21,4,188,2306,496,483,979,"21 de agosto de 1994"
21,4,188,2307,164,163,327,"21 de agosto de 1994"
21,4,188,2308,170,150,320,"21 de agosto de 1994"
21,4,188,2309,255,286,541,"21 de agosto de 1994"
21,5,3,28,363,517,880,"21 de agosto de 1994"
21,5,3,29,502,665,1167,"21 de agosto de 1994"
21,5,3,30,420,548,968,"21 de agosto de 1994"
21,5,3,31,509,727,1236,"21 de agosto de 1994"
21,5,3,32,437,531,968,"21 de agosto de 1994"
21,5,3,33,426,576,1002,"21 de agosto de 1994"
21,5,3,34,491,616,1107,"21 de agosto de 1994"
21,5,3,35,508,636,1144,"21 de agosto de 1994"
21,5,3,36,259,288,547,"21 de agosto de 1994"
21,5,3,37,430,565,995,"21 de agosto de 1994"
21,5,3,38,303,413,716,"21 de agosto de 1994"
21,5,3,39,386,556,942,"21 de agosto de 1994"
21,5,3,40,360,520,880,"21 de agosto de 1994"
21,5,3,41,135,145,280,"21 de agosto de 1994"
21,5,3,42,60,73,133,"21 de agosto de 1994"
21,5,3,43,79,133,212,"21 de agosto de 1994"
21,5,3,44,239,358,597,"21 de agosto de 1994"
21,5,7,71,141,162,303,"21 de agosto de 1994"
21,5,7,72,136,162,298,"21 de agosto de 1994"
21,5,7,73,139,213,352,"21 de agosto de 1994"
21,5,7,74,130,147,277,"21 de agosto de 1994"
21,5,18,148,206,211,417,"21 de agosto de 1994"
21,5,18,149,79,64,143,"21 de agosto de 1994"
21,5,18,150,78,67,145,"21 de agosto de 1994"
21,5,18,151,105,124,229,"21 de agosto de 1994"
21,5,18,152,101,116,217,"21 de agosto de 1994"
21,5,18,153,88,98,186,"21 de agosto de 1994"
21,5,27,253,174,192,366,"21 de agosto de 1994"
21,5,27,254,218,267,485,"21 de agosto de 1994"
21,5,27,255,101,137,238,"21 de agosto de 1994"
21,5,27,256,227,265,492,"21 de agosto de 1994"
21,5,27,257,75,78,153,"21 de agosto de 1994"
21,5,27,258,113,126,239,"21 de agosto de 1994"
21,5,27,259,27,33,60,"21 de agosto de 1994"
21,5,29,262,345,382,727,"21 de agosto de 1994"
21,5,29,263,283,298,581,"21 de agosto de 1994"
21,5,29,264,358,308,666,"21 de agosto de 1994"
21,5,29,265,589,511,1100,"21 de agosto de 1994"
21,5,29,266,120,100,220,"21 de agosto de 1994"
21,5,29,267,233,226,459,"21 de agosto de 1994"
21,5,29,268,322,301,623,"21 de agosto de 1994"
21,5,29,269,115,103,218,"21 de agosto de 1994"
21,5,29,270,533,519,1052,"21 de agosto de 1994"
21,5,32,274,180,224,404,"21 de agosto de 1994"
21,5,32,275,316,410,726,"21 de agosto de 1994"
21,5,32,276,90,102,192,"21 de agosto de 1994"
21,5,38,314,260,329,589,"21 de agosto de 1994"
21,5,38,315,96,99,195,"21 de agosto de 1994"
21,5,38,316,142,159,301,"21 de agosto de 1994"
21,5,43,340,319,356,675,"21 de agosto de 1994"
21,5,43,341,173,239,412,"21 de agosto de 1994"
21,5,43,342,132,132,264,"21 de agosto de 1994"
21,5,43,343,102,102,204,"21 de agosto de 1994"
21,5,53,459,154,170,324,"21 de agosto de 1994"
21,5,53,460,109,154,263,"21 de agosto de 1994"
21,5,56,496,377,441,818,"21 de agosto de 1994"
21,5,56,497,296,343,639,"21 de agosto de 1994"
21,5,56,498,202,225,427,"21 de agosto de 1994"
21,5,56,499,63,67,130,"21 de agosto de 1994"
21,5,64,526,433,453,886,"21 de agosto de 1994"
21,5,64,527,283,288,571,"21 de agosto de 1994"
21,5,64,528,333,370,703,"21 de agosto de 1994"
21,5,64,529,440,429,869,"21 de agosto de 1994"
21,5,64,530,169,142,311,"21 de agosto de 1994"
21,5,64,531,498,433,931,"21 de agosto de 1994"
21,5,64,532,308,268,576,"21 de agosto de 1994"
21,5,64,533,104,83,187,"21 de agosto de 1994"
21,5,64,534,120,107,227,"21 de agosto de 1994"
21,5,71,588,194,229,423,"21 de agosto de 1994"
21,5,71,589,99,129,228,"21 de agosto de 1994"
21,5,71,590,254,234,488,"21 de agosto de 1994"
21,5,71,591,220,249,469,"21 de agosto de 1994"
21,5,71,592,344,451,795,"21 de agosto de 1994"
21,5,71,593,72,41,113,"21 de agosto de 1994"
21,5,84,709,568,663,1231,"21 de agosto de 1994"
21,5,84,710,476,488,964,"21 de agosto de 1994"
21,5,84,711,240,216,456,"21 de agosto de 1994"
21,5,94,797,162,168,330,"21 de agosto de 1994"
21,5,94,798,170,177,347,"21 de agosto de 1994"
21,5,94,799,170,213,383,"21 de agosto de 1994"
21,5,94,800,372,355,727,"21 de agosto de 1994"
21,5,100,825,342,405,747,"21 de agosto de 1994"
21,5,100,826,318,412,730,"21 de agosto de 1994"
21,5,100,827,167,230,397,"21 de agosto de 1994"
21,5,100,828,107,98,205,"21 de agosto de 1994"
21,5,100,829,206,215,421,"21 de agosto de 1994"
21,5,111,897,355,402,757,"21 de agosto de 1994"
21,5,111,898,231,223,454,"21 de agosto de 1994"
21,5,111,899,398,393,791,"21 de agosto de 1994"
21,5,111,900,441,350,791,"21 de agosto de 1994"
21,5,111,901,429,322,751,"21 de agosto de 1994"
21,5,111,902,336,302,638,"21 de agosto de 1994"
21,5,111,903,309,283,592,"21 de agosto de 1994"
21,5,111,904,556,498,1054,"21 de agosto de 1994"
21,5,111,905,450,422,872,"21 de agosto de 1994"
21,5,111,906,146,129,275,"21 de agosto de 1994"
21,5,111,907,496,458,954,"21 de agosto de 1994"
21,5,111,908,201,233,434,"21 de agosto de 1994"
21,5,111,909,290,288,578,"21 de agosto de 1994"
21,5,111,910,338,355,693,"21 de agosto de 1994"
21,5,111,911,220,252,472,"21 de agosto de 1994"
21,5,113,922,364,423,787,"21 de agosto de 1994"
21,5,113,923,242,319,561,"21 de agosto de 1994"
21,5,113,924,231,226,457,"21 de agosto de 1994"
21,5,113,925,329,382,711,"21 de agosto de 1994"
21,5,113,926,231,305,536,"21 de agosto de 1994"
21,5,113,927,269,244,513,"21 de agosto de 1994"
21,5,125,1685,515,527,1042,"21 de agosto de 1994"
21,5,125,1686,454,451,905,"21 de agosto de 1994"
21,5,125,1687,490,544,1034,"21 de agosto de 1994"
21,5,125,1688,191,204,395,"21 de agosto de 1994"
21,5,125,1689,446,482,928,"21 de agosto de 1994"
21,5,125,1690,261,118,379,"21 de agosto de 1994"
21,5,128,1698,237,286,523,"21 de agosto de 1994"
21,5,128,1699,221,248,469,"21 de agosto de 1994"
21,5,128,1700,177,223,400,"21 de agosto de 1994"
21,5,128,1701,240,285,525,"21 de agosto de 1994"
21,5,130,1708,308,243,551,"21 de agosto de 1994"
21,5,130,1709,390,333,723,"21 de agosto de 1994"
21,5,130,1710,320,262,582,"21 de agosto de 1994"
21,5,130,1711,150,153,303,"21 de agosto de 1994"
21,5,130,1712,174,176,350,"21 de agosto de 1994"
21,5,130,1713,203,154,357,"21 de agosto de 1994"
21,5,130,1714,235,195,430,"21 de agosto de 1994"
21,5,136,1784,168,215,383,"21 de agosto de 1994"
21,5,142,1846,327,355,682,"21 de agosto de 1994"
21,5,142,1847,375,442,817,"21 de agosto de 1994"
21,5,146,1872,156,184,340,"21 de agosto de 1994"
21,5,147,1873,349,400,749,"21 de agosto de 1994"
21,5,147,1874,181,213,394,"21 de agosto de 1994"
21,5,147,1875,272,323,595,"21 de agosto de 1994"
21,5,147,1876,338,324,662,"21 de agosto de 1994"
21,5,160,2042,406,512,918,"21 de agosto de 1994"
21,5,160,2043,229,270,499,"21 de agosto de 1994"
21,5,160,2044,370,339,709,"21 de agosto de 1994"
21,5,160,2045,324,340,664,"21 de agosto de 1994"
21,5,160,2046,267,304,571,"21 de agosto de 1994"
21,5,160,2047,480,426,906,"21 de agosto de 1994"
21,5,160,2048,314,321,635,"21 de agosto de 1994"
21,5,168,2098,339,379,718,"21 de agosto de 1994"
21,5,168,2099,473,522,995,"21 de agosto de 1994"
21,5,168,2100,114,87,201,"21 de agosto de 1994"
21,5,168,2101,144,144,288,"21 de agosto de 1994"
21,5,168,2102,263,268,531,"21 de agosto de 1994"
21,5,168,2103,180,195,375,"21 de agosto de 1994"
21,5,168,2104,402,438,840,"21 de agosto de 1994"
21,5,168,2105,268,261,529,"21 de agosto de 1994"
21,5,168,2106,361,371,732,"21 de agosto de 1994"
21,5,168,2107,363,410,773,"21 de agosto de 1994"
21,5,168,2108,445,472,917,"21 de agosto de 1994"
21,5,176,2184,374,443,817,"21 de agosto de 1994"
21,5,176,2185,349,453,802,"21 de agosto de 1994"
21,5,176,2186,237,249,486,"21 de agosto de 1994"
21,5,176,2187,194,188,382,"21 de agosto de 1994"
21,5,176,2188,541,505,1046,"21 de agosto de 1994"
21,5,176,2189,526,449,975,"21 de agosto de 1994"
21,5,176,2190,554,548,1102,"21 de agosto de 1994"
21,5,176,2191,423,423,846,"21 de agosto de 1994"
21,5,176,2192,286,340,626,"21 de agosto de 1994"
21,5,176,2193,443,416,859,"21 de agosto de 1994"
21,5,176,2194,313,279,592,"21 de agosto de 1994"
21,5,176,2195,313,275,588,"21 de agosto de 1994"
21,5,176,2196,320,334,654,"21 de agosto de 1994"
21,5,176,2197,319,349,668,"21 de agosto de 1994"
21,5,176,2198,334,356,690,"21 de agosto de 1994"
21,5,176,2199,594,593,1187,"21 de agosto de 1994"
21,5,176,2200,289,295,584,"21 de agosto de 1994"
21,5,190,2317,191,218,409,"21 de agosto de 1994"
21,5,190,2318,68,57,125,"21 de agosto de 1994"
21,5,196,2360,173,231,404,"21 de agosto de 1994"
21,5,196,2361,157,201,358,"21 de agosto de 1994"
21,5,203,2413,382,386,768,"21 de agosto de 1994"
21,5,203,2414,290,280,570,"21 de agosto de 1994"
21,5,203,2415,61,71,132,"21 de agosto de 1994"
21,5,205,2420,473,465,938,"21 de agosto de 1994"
21,5,205,2421,449,421,870,"21 de agosto de 1994"
21,5,205,2422,181,163,344,"21 de agosto de 1994"
21,5,205,2423,305,350,655,"21 de agosto de 1994"
21,5,205,2424,321,346,667,"21 de agosto de 1994"
21,5,205,2425,406,432,838,"21 de agosto de 1994"
21,5,205,2426,380,423,803,"21 de agosto de 1994"
21,5,205,2427,75,71,146,"21 de agosto de 1994"
21,5,205,2428,248,252,500,"21 de agosto de 1994"
21,5,206,2429,217,280,497,"21 de agosto de 1994"
21,5,206,2430,132,165,297,"21 de agosto de 1994"
21,5,206,2431,310,303,613,"21 de agosto de 1994"
21,5,206,2432,122,112,234,"21 de agosto de 1994"
21,5,209,2490,459,553,1012,"21 de agosto de 1994"
21,5,209,2491,232,287,519,"21 de agosto de 1994"
21,5,209,2492,84,72,156,"21 de agosto de 1994"
21,5,209,2493,53,56,109,"21 de agosto de 1994"
21,5,209,2494,242,283,525,"21 de agosto de 1994"
21,5,209,2495,41,49,90,"21 de agosto de 1994"
21,5,209,2496,174,200,374,"21 de agosto de 1994"
21,5,209,2497,74,91,165,"21 de agosto de 1994"
21,5,209,2498,24,37,61,"21 de agosto de 1994"
21,6,10,80,480,391,871,"21 de agosto de 1994"
21,6,10,81,442,368,810,"21 de agosto de 1994"
21,6,10,82,514,509,1023,"21 de agosto de 1994"
21,6,10,83,476,452,928,"21 de agosto de 1994"
21,6,10,84,537,522,1059,"21 de agosto de 1994"
21,6,10,85,516,524,1040,"21 de agosto de 1994"
21,6,10,86,256,257,513,"21 de agosto de 1994"
21,6,10,87,304,309,613,"21 de agosto de 1994"
21,6,10,88,161,158,319,"21 de agosto de 1994"
21,6,10,89,305,279,584,"21 de agosto de 1994"
21,6,10,90,402,335,737,"21 de agosto de 1994"
21,6,10,91,282,265,547,"21 de agosto de 1994"
21,6,10,92,81,55,136,"21 de agosto de 1994"
21,6,10,93,44,35,79,"21 de agosto de 1994"
21,6,10,94,368,341,709,"21 de agosto de 1994"
21,6,10,95,337,322,659,"21 de agosto de 1994"
21,6,10,96,569,529,1098,"21 de agosto de 1994"
21,6,10,97,302,304,606,"21 de agosto de 1994"
21,6,10,98,92,92,184,"21 de agosto de 1994"
21,6,10,99,183,132,315,"21 de agosto de 1994"
21,6,10,100,212,196,408,"21 de agosto de 1994"
21,6,10,101,285,255,540,"21 de agosto de 1994"
21,6,13,107,478,450,928,"21 de agosto de 1994"
21,6,13,108,319,270,589,"21 de agosto de 1994"
21,6,13,109,399,359,758,"21 de agosto de 1994"
21,6,13,110,460,417,877,"21 de agosto de 1994"
21,6,13,111,329,283,612,"21 de agosto de 1994"
21,6,13,112,387,379,766,"21 de agosto de 1994"
21,6,36,294,240,261,501,"21 de agosto de 1994"
21,6,36,295,166,205,371,"21 de agosto de 1994"
21,6,36,296,484,544,1028,"21 de agosto de 1994"
21,6,36,297,279,292,571,"21 de agosto de 1994"
21,6,36,298,382,376,758,"21 de agosto de 1994"
21,6,36,299,406,380,786,"21 de agosto de 1994"
21,6,36,300,606,710,1316,"21 de agosto de 1994"
21,6,36,301,444,466,910,"21 de agosto de 1994"
21,6,36,302,276,272,548,"21 de agosto de 1994"
21,6,36,303,156,172,328,"21 de agosto de 1994"
21,6,36,304,134,120,254,"21 de agosto de 1994"
21,6,36,305,447,499,946,"21 de agosto de 1994"
21,6,37,306,446,630,1076,"21 de agosto de 1994"
21,6,37,307,359,437,796,"21 de agosto de 1994"
21,6,37,308,313,303,616,"21 de agosto de 1994"
21,6,37,309,65,92,157,"21 de agosto de 1994"
21,6,37,310,429,430,859,"21 de agosto de 1994"
21,6,37,311,243,317,560,"21 de agosto de 1994"
21,6,37,312,49,49,98,"21 de agosto de 1994"
21,6,37,313,238,318,556,"21 de agosto de 1994"
21,6,47,395,555,640,1195,"21 de agosto de 1994"
21,6,47,396,272,287,559,"21 de agosto de 1994"
21,6,47,397,134,115,249,"21 de agosto de 1994"
21,6,62,518,309,260,569,"21 de agosto de 1994"
21,6,62,519,658,627,1285,"21 de agosto de 1994"
21,6,62,520,249,221,470,"21 de agosto de 1994"
21,6,62,521,358,340,698,"21 de agosto de 1994"
21,6,62,522,306,283,589,"21 de agosto de 1994"
21,6,62,523,184,175,359,"21 de agosto de 1994"
21,6,104,842,131,107,238,"21 de agosto de 1994"
21,6,104,843,215,158,373,"21 de agosto de 1994"
21,6,104,844,500,511,1011,"21 de agosto de 1994"
21,6,104,845,84,95,179,"21 de agosto de 1994"
21,6,121,1672,412,498,910,"21 de agosto de 1994"
21,6,121,1673,226,230,456,"21 de agosto de 1994"
21,6,149,1882,460,476,936,"21 de agosto de 1994"
21,6,149,1883,443,496,939,"21 de agosto de 1994"
21,6,149,1884,648,726,1374,"21 de agosto de 1994"
21,6,149,1885,477,547,1024,"21 de agosto de 1994"
21,6,149,1886,91,80,171,"21 de agosto de 1994"
21,6,149,1887,127,155,282,"21 de agosto de 1994"
21,6,155,1934,752,871,1623,"21 de agosto de 1994"
21,6,155,1935,424,496,920,"21 de agosto de 1994"
21,6,155,1936,558,613,1171,"21 de agosto de 1994"
21,6,155,1937,607,697,1304,"21 de agosto de 1994"
21,6,155,1938,625,680,1305,"21 de agosto de 1994"
21,6,155,1939,220,244,464,"21 de agosto de 1994"
21,6,155,1940,161,166,327,"21 de agosto de 1994"
21,6,155,1941,419,449,868,"21 de agosto de 1994"
21,6,155,1942,638,696,1334,"21 de agosto de 1994"
21,6,155,1943,537,574,1111,"21 de agosto de 1994"
21,6,155,1944,777,250,1027,"21 de agosto de 1994"
21,6,155,1945,469,498,967,"21 de agosto de 1994"
21,6,155,1946,370,403,773,"21 de agosto de 1994"
21,6,155,1947,279,363,642,"21 de agosto de 1994"
21,6,155,1948,446,520,966,"21 de agosto de 1994"
21,6,155,1949,342,399,741,"21 de agosto de 1994"
21,6,155,1950,382,423,805,"21 de agosto de 1994"
21,6,155,1951,499,602,1101,"21 de agosto de 1994"
21,6,155,1952,913,1052,1965,"21 de agosto de 1994"
21,6,155,1953,559,667,1226,"21 de agosto de 1994"
21,6,155,1954,367,440,807,"21 de agosto de 1994"
21,6,155,1955,667,840,1507,"21 de agosto de 1994"
21,6,155,1956,430,536,966,"21 de agosto de 1994"
21,6,155,1957,519,602,1121,"21 de agosto de 1994"
21,6,155,1958,482,608,1090,"21 de agosto de 1994"
21,6,155,1959,585,697,1282,"21 de agosto de 1994"
21,6,155,1960,506,576,1082,"21 de agosto de 1994"
21,6,155,1961,536,648,1184,"21 de agosto de 1994"
21,6,155,1962,467,543,1010,"21 de agosto de 1994"
21,6,155,1963,320,350,670,"21 de agosto de 1994"
21,6,155,1964,410,436,846,"21 de agosto de 1994"
21,6,155,1965,283,316,599,"21 de agosto de 1994"
21,6,155,1966,414,481,895,"21 de agosto de 1994"
21,6,155,1967,300,406,706,"21 de agosto de 1994"
21,6,155,1968,417,518,935,"21 de agosto de 1994"
21,6,155,1969,300,339,639,"21 de agosto de 1994"
21,6,155,1970,524,633,1157,"21 de agosto de 1994"
21,6,155,1971,555,663,1218,"21 de agosto de 1994"
21,6,155,1972,518,623,1141,"21 de agosto de 1994"
21,6,155,1973,530,611,1141,"21 de agosto de 1994"
21,6,155,1974,255,287,542,"21 de agosto de 1994"
21,6,155,1975,248,307,555,"21 de agosto de 1994"
21,6,155,1976,370,411,781,"21 de agosto de 1994"
21,6,155,1977,468,540,1008,"21 de agosto de 1994"
21,6,155,1978,557,678,1235,"21 de agosto de 1994"
21,6,155,1979,603,727,1330,"21 de agosto de 1994"
21,6,155,1980,363,423,786,"21 de agosto de 1994"
21,6,155,1981,399,494,893,"21 de agosto de 1994"
21,6,155,1982,424,526,950,"21 de agosto de 1994"
21,6,155,1983,154,191,345,"21 de agosto de 1994"
21,6,155,1984,204,250,454,"21 de agosto de 1994"
21,6,155,1985,606,741,1347,"21 de agosto de 1994"
21,6,155,1986,594,634,1228,"21 de agosto de 1994"
21,6,155,1987,529,586,1115,"21 de agosto de 1994"
21,6,155,1988,851,812,1663,"21 de agosto de 1994"
21,6,155,1989,482,538,1020,"21 de agosto de 1994"
21,6,155,1990,644,702,1346,"21 de agosto de 1994"
21,6,155,1991,483,594,1077,"21 de agosto de 1994"
21,6,155,1992,310,359,669,"21 de agosto de 1994"
21,6,155,1993,496,596,1092,"21 de agosto de 1994"
21,6,155,1994,512,578,1090,"21 de agosto de 1994"
21,6,155,1995,361,418,779,"21 de agosto de 1994"
21,6,155,1996,492,569,1061,"21 de agosto de 1994"
21,6,155,1997,178,201,379,"21 de agosto de 1994"
21,6,155,1998,472,500,972,"21 de agosto de 1994"
21,6,155,1999,522,608,1130,"21 de agosto de 1994"
21,6,155,2000,484,529,1013,"21 de agosto de 1994"
21,6,155,2001,298,293,591,"21 de agosto de 1994"
21,6,155,2002,520,573,1093,"21 de agosto de 1994"
21,6,155,2003,655,764,1419,"21 de agosto de 1994"
21,6,155,2004,265,307,572,"21 de agosto de 1994"
21,6,155,2005,526,587,1113,"21 de agosto de 1994"
21,6,155,2006,625,713,1338,"21 de agosto de 1994"
21,6,155,2007,485,537,1022,"21 de agosto de 1994"
21,6,155,2008,737,958,1695,"21 de agosto de 1994"
21,6,155,2009,547,597,1144,"21 de agosto de 1994"
21,6,155,2010,282,234,516,"21 de agosto de 1994"
21,6,155,2011,281,302,583,"21 de agosto de 1994"
21,6,155,2012,692,719,1411,"21 de agosto de 1994"
21,6,155,2013,367,409,776,"21 de agosto de 1994"
21,6,155,2014,266,286,552,"21 de agosto de 1994"
21,6,155,2015,303,323,626,"21 de agosto de 1994"
21,6,155,2016,315,286,601,"21 de agosto de 1994"
21,6,177,2201,597,488,1085,"21 de agosto de 1994"
21,6,177,2202,119,81,200,"21 de agosto de 1994"
21,6,177,2203,347,315,662,"21 de agosto de 1994"
21,6,177,2204,324,278,602,"21 de agosto de 1994"
21,6,177,2205,162,150,312,"21 de agosto de 1994"
21,6,177,2206,391,387,778,"21 de agosto de 1994"
21,6,177,2207,279,304,583,"21 de agosto de 1994"
21,6,177,2208,201,196,397,"21 de agosto de 1994"
21,6,195,2349,382,419,801,"21 de agosto de 1994"
21,6,195,2350,220,240,460,"21 de agosto de 1994"
21,6,195,2351,405,340,745,"21 de agosto de 1994"
21,6,195,2352,241,203,444,"21 de agosto de 1994"
21,6,195,2353,347,357,704,"21 de agosto de 1994"
21,6,195,2354,171,126,297,"21 de agosto de 1994"
21,6,195,2355,636,590,1226,"21 de agosto de 1994"
21,6,195,2356,326,303,629,"21 de agosto de 1994"
21,6,195,2357,667,659,1326,"21 de agosto de 1994"
21,6,195,2358,122,83,205,"21 de agosto de 1994"
21,6,195,2359,486,541,1027,"21 de agosto de 1994"
21,6,214,2527,570,700,1270,"21 de agosto de 1994"
21,6,214,2528,511,605,1116,"21 de agosto de 1994"
21,6,214,2529,287,355,642,"21 de agosto de 1994"
21,6,214,2530,295,348,643,"21 de agosto de 1994"
21,6,214,2531,305,334,639,"21 de agosto de 1994"
21,6,214,2532,550,624,1174,"21 de agosto de 1994"
21,6,217,2537,351,347,698,"21 de agosto de 1994"
21,6,217,2538,343,431,774,"21 de agosto de 1994"
21,6,217,2539,440,529,969,"21 de agosto de 1994"
21,6,217,2540,79,77,156,"21 de agosto de 1994"
21,6,217,2541,357,335,692,"21 de agosto de 1994"
21,6,217,2542,153,145,298,"21 de agosto de 1994"
21,6,217,2543,158,143,301,"21 de agosto de 1994"
21,6,217,2544,165,195,360,"21 de agosto de 1994"
21,6,217,2545,640,761,1401,"21 de agosto de 1994"
21,6,217,2546,111,82,193,"21 de agosto de 1994"
21,6,217,2547,320,305,625,"21 de agosto de 1994"
21,6,217,2548,440,523,963,"21 de agosto de 1994"
21,7,12,103,349,386,735,"21 de agosto de 1994"
21,7,12,104,483,545,1028,"21 de agosto de 1994"
21,7,12,105,433,454,887,"21 de agosto de 1994"
21,7,12,106,278,260,538,"21 de agosto de 1994"
21,7,23,234,432,433,865,"21 de agosto de 1994"
21,7,23,235,324,273,597,"21 de agosto de 1994"
21,7,23,236,173,169,342,"21 de agosto de 1994"
21,7,23,237,418,367,785,"21 de agosto de 1994"
21,7,23,238,227,230,457,"21 de agosto de 1994"
21,7,45,364,387,429,816,"21 de agosto de 1994"
21,7,45,365,606,623,1229,"21 de agosto de 1994"
21,7,45,366,356,306,662,"21 de agosto de 1994"
21,7,45,367,545,580,1125,"21 de agosto de 1994"
21,7,45,368,309,306,615,"21 de agosto de 1994"
21,7,45,369,453,438,891,"21 de agosto de 1994"
21,7,45,370,374,401,775,"21 de agosto de 1994"
21,7,46,371,507,521,1028,"21 de agosto de 1994"
21,7,46,372,488,488,976,"21 de agosto de 1994"
21,7,46,373,496,555,1051,"21 de agosto de 1994"
21,7,46,374,591,703,1294,"21 de agosto de 1994"
21,7,46,375,577,678,1255,"21 de agosto de 1994"
21,7,46,376,337,402,739,"21 de agosto de 1994"
21,7,46,377,334,416,750,"21 de agosto de 1994"
21,7,46,378,324,376,700,"21 de agosto de 1994"
21,7,46,379,559,600,1159,"21 de agosto de 1994"
21,7,46,380,523,619,1142,"21 de agosto de 1994"
21,7,46,381,393,424,817,"21 de agosto de 1994"
21,7,46,382,327,289,616,"21 de agosto de 1994"
21,7,46,383,136,138,274,"21 de agosto de 1994"
21,7,46,384,183,175,358,"21 de agosto de 1994"
21,7,46,385,297,281,578,"21 de agosto de 1994"
21,7,46,386,609,632,1241,"21 de agosto de 1994"
21,7,46,387,135,140,275,"21 de agosto de 1994"
21,7,46,388,358,380,738,"21 de agosto de 1994"
21,7,46,389,312,313,625,"21 de agosto de 1994"
21,7,46,390,461,446,907,"21 de agosto de 1994"
21,7,46,391,412,386,798,"21 de agosto de 1994"
21,7,46,392,189,174,363,"21 de agosto de 1994"
21,7,46,393,280,269,549,"21 de agosto de 1994"
21,7,46,394,70,56,126,"21 de agosto de 1994"
21,7,51,430,676,657,1333,"21 de agosto de 1994"
21,7,51,431,148,118,266,"21 de agosto de 1994"
21,7,51,432,365,365,730,"21 de agosto de 1994"
21,7,51,433,562,630,1192,"21 de agosto de 1994"
21,7,51,434,106,102,208,"21 de agosto de 1994"
21,7,51,435,402,371,773,"21 de agosto de 1994"
21,7,51,436,405,385,790,"21 de agosto de 1994"
21,7,51,437,332,346,678,"21 de agosto de 1994"
21,7,51,438,517,523,1040,"21 de agosto de 1994"
21,7,59,505,392,379,771,"21 de agosto de 1994"
21,7,59,506,499,492,991,"21 de agosto de 1994"
21,7,59,507,411,401,812,"21 de agosto de 1994"
21,7,59,508,391,374,765,"21 de agosto de 1994"
21,7,59,509,586,540,1126,"21 de agosto de 1994"
21,7,59,510,746,674,1420,"21 de agosto de 1994"
21,7,59,511,480,430,910,"21 de agosto de 1994"
21,7,66,544,535,543,1078,"21 de agosto de 1994"
21,7,66,545,469,492,961,"21 de agosto de 1994"
21,7,66,546,285,358,643,"21 de agosto de 1994"
21,7,66,547,504,571,1075,"21 de agosto de 1994"
21,7,66,548,427,492,919,"21 de agosto de 1994"
21,7,66,549,418,443,861,"21 de agosto de 1994"
21,7,66,550,565,599,1164,"21 de agosto de 1994"
21,7,68,555,537,587,1124,"21 de agosto de 1994"
21,7,68,556,438,465,903,"21 de agosto de 1994"
21,7,68,557,298,361,659,"21 de agosto de 1994"
21,7,68,558,337,372,709,"21 de agosto de 1994"
21,7,68,559,443,421,864,"21 de agosto de 1994"
21,7,68,560,156,147,303,"21 de agosto de 1994"
21,7,68,561,249,238,487,"21 de agosto de 1994"
21,7,68,562,131,125,256,"21 de agosto de 1994"
21,7,68,563,156,119,275,"21 de agosto de 1994"
21,7,68,564,157,113,270,"21 de agosto de 1994"
21,7,85,712,304,281,585,"21 de agosto de 1994"
21,7,85,713,546,477,1023,"21 de agosto de 1994"
21,7,85,714,368,287,655,"21 de agosto de 1994"
21,7,85,715,526,464,990,"21 de agosto de 1994"
21,7,85,716,613,495,1108,"21 de agosto de 1994"
21,7,85,717,380,314,694,"21 de agosto de 1994"
21,7,85,718,343,361,704,"21 de agosto de 1994"
21,7,85,719,480,506,986,"21 de agosto de 1994"
21,7,85,720,452,405,857,"21 de agosto de 1994"
21,7,85,721,383,338,721,"21 de agosto de 1994"
21,7,85,722,324,344,668,"21 de agosto de 1994"
21,7,85,723,601,651,1252,"21 de agosto de 1994"
21,7,85,724,233,242,475,"21 de agosto de 1994"
21,7,85,725,354,309,663,"21 de agosto de 1994"
21,7,85,726,421,340,761,"21 de agosto de 1994"
21,7,95,801,331,318,649,"21 de agosto de 1994"
21,7,95,802,490,493,983,"21 de agosto de 1994"
21,7,95,803,78,82,160,"21 de agosto de 1994"
21,7,95,804,293,280,573,"21 de agosto de 1994"
21,7,95,805,244,215,459,"21 de agosto de 1994"
21,7,95,806,138,125,263,"21 de agosto de 1994"
21,7,95,807,553,551,1104,"21 de agosto de 1994"
21,7,95,808,426,415,841,"21 de agosto de 1994"
21,7,96,809,517,575,1092,"21 de agosto de 1994"
21,7,96,810,683,738,1421,"21 de agosto de 1994"
21,7,96,811,546,630,1176,"21 de agosto de 1994"
21,7,96,812,317,339,656,"21 de agosto de 1994"
21,7,96,813,326,334,660,"21 de agosto de 1994"
21,7,96,814,500,460,960,"21 de agosto de 1994"
21,7,96,815,479,517,996,"21 de agosto de 1994"
21,7,96,816,488,443,931,"21 de agosto de 1994"
21,7,96,817,349,337,686,"21 de agosto de 1994"
21,7,96,818,247,234,481,"21 de agosto de 1994"
21,7,96,819,496,548,1044,"21 de agosto de 1994"
21,7,98,821,203,213,416,"21 de agosto de 1994"
21,7,98,822,325,350,675,"21 de agosto de 1994"
21,7,106,854,396,409,805,"21 de agosto de 1994"
21,7,106,855,437,462,899,"21 de agosto de 1994"
21,7,106,856,211,176,387,"21 de agosto de 1994"
21,7,109,875,441,501,942,"21 de agosto de 1994"
21,7,109,876,484,520,1004,"21 de agosto de 1994"
21,7,109,877,462,516,978,"21 de agosto de 1994"
21,7,109,878,296,334,630,"21 de agosto de 1994"
21,7,109,879,374,402,776,"21 de agosto de 1994"
21,7,109,880,317,373,690,"21 de agosto de 1994"
21,7,109,881,256,242,498,"21 de agosto de 1994"
21,7,109,882,174,177,351,"21 de agosto de 1994"
21,7,116,1610,471,486,957,"21 de agosto de 1994"
21,7,116,1611,397,443,840,"21 de agosto de 1994"
21,7,116,1612,333,342,675,"21 de agosto de 1994"
21,7,116,1613,474,516,990,"21 de agosto de 1994"
21,7,116,1614,399,425,824,"21 de agosto de 1994"
21,7,116,1615,447,502,949,"21 de agosto de 1994"
21,7,116,1616,590,630,1220,"21 de agosto de 1994"
21,7,116,1617,621,652,1273,"21 de agosto de 1994"
21,7,116,1618,288,299,587,"21 de agosto de 1994"
21,7,116,1619,764,758,1522,"21 de agosto de 1994"
21,7,116,1620,262,260,522,"21 de agosto de 1994"
21,7,116,1621,324,318,642,"21 de agosto de 1994"
21,7,116,1622,413,428,841,"21 de agosto de 1994"
21,7,116,1623,457,474,931,"21 de agosto de 1994"
21,7,116,1624,166,151,317,"21 de agosto de 1994"
21,7,116,1625,309,327,636,"21 de agosto de 1994"
21,7,117,1626,424,452,876,"21 de agosto de 1994"
21,7,117,1627,225,213,438,"21 de agosto de 1994"
21,7,117,1628,121,95,216,"21 de agosto de 1994"
21,7,117,1629,474,424,898,"21 de agosto de 1994"
21,7,117,1630,276,220,496,"21 de agosto de 1994"
21,7,117,1631,240,240,480,"21 de agosto de 1994"
21,7,117,1632,445,471,916,"21 de agosto de 1994"
21,7,117,1633,308,255,563,"21 de agosto de 1994"
21,7,117,1634,466,413,879,"21 de agosto de 1994"
21,7,117,1635,532,515,1047,"21 de agosto de 1994"
21,7,131,1715,229,247,476,"21 de agosto de 1994"
21,7,131,1716,374,415,789,"21 de agosto de 1994"
21,7,131,1717,156,162,318,"21 de agosto de 1994"
21,7,131,1718,191,182,373,"21 de agosto de 1994"
21,7,138,1789,470,463,933,"21 de agosto de 1994"
21,7,138,1790,504,518,1022,"21 de agosto de 1994"
21,7,138,1791,591,528,1119,"21 de agosto de 1994"
21,7,138,1792,352,344,696,"21 de agosto de 1994"
21,7,143,1848,460,385,845,"21 de agosto de 1994"
21,7,143,1849,497,498,995,"21 de agosto de 1994"
21,7,143,1850,472,444,916,"21 de agosto de 1994"
21,7,143,1851,393,402,795,"21 de agosto de 1994"
21,7,143,1852,531,504,1035,"21 de agosto de 1994"
21,7,143,1853,336,332,668,"21 de agosto de 1994"
21,7,143,1854,375,398,773,"21 de agosto de 1994"
21,7,143,1855,712,726,1438,"21 de agosto de 1994"
21,7,143,1856,614,628,1242,"21 de agosto de 1994"
21,7,143,1857,494,468,962,"21 de agosto de 1994"
21,7,179,2219,532,540,1072,"21 de agosto de 1994"
21,7,179,2220,412,385,797,"21 de agosto de 1994"
21,7,179,2221,378,392,770,"21 de agosto de 1994"
21,7,179,2222,321,311,632,"21 de agosto de 1994"
21,7,179,2223,287,250,537,"21 de agosto de 1994"
21,7,179,2224,603,608,1211,"21 de agosto de 1994"
21,7,179,2225,385,366,751,"21 de agosto de 1994"
21,7,179,2226,319,332,651,"21 de agosto de 1994"
21,7,179,2227,493,450,943,"21 de agosto de 1994"
21,7,179,2228,590,569,1159,"21 de agosto de 1994"
21,7,179,2229,404,337,741,"21 de agosto de 1994"
21,7,179,2230,357,319,676,"21 de agosto de 1994"
21,7,179,2231,429,431,860,"21 de agosto de 1994"
21,7,179,2232,415,359,774,"21 de agosto de 1994"
21,7,212,2508,287,335,622,"21 de agosto de 1994"
21,7,212,2509,161,206,367,"21 de agosto de 1994"
21,7,212,2510,321,365,686,"21 de agosto de 1994"
21,7,212,2511,327,402,729,"21 de agosto de 1994"
21,7,212,2512,313,342,655,"21 de agosto de 1994"
21,7,212,2513,404,538,942,"21 de agosto de 1994"
21,7,212,2514,135,177,312,"21 de agosto de 1994"
21,7,212,2515,506,550,1056,"21 de agosto de 1994"
21,7,212,2516,487,518,1005,"21 de agosto de 1994"
21,7,212,2517,188,218,406,"21 de agosto de 1994"
21,7,212,2518,260,300,560,"21 de agosto de 1994"
21,7,212,2519,327,420,747,"21 de agosto de 1994"
21,8,2,20,424,406,830,"21 de agosto de 1994"
21,8,2,21,389,383,772,"21 de agosto de 1994"
21,8,2,22,190,185,375,"21 de agosto de 1994"
21,8,2,23,205,186,391,"21 de agosto de 1994"
21,8,2,24,250,215,465,"21 de agosto de 1994"
21,8,2,25,103,73,176,"21 de agosto de 1994"
21,8,2,26,298,285,583,"21 de agosto de 1994"
21,8,2,27,355,301,656,"21 de agosto de 1994"
21,8,17,139,467,552,1019,"21 de agosto de 1994"
21,8,17,140,508,567,1075,"21 de agosto de 1994"
21,8,17,141,196,229,425,"21 de agosto de 1994"
21,8,17,142,30,30,60,"21 de agosto de 1994"
21,8,17,143,510,478,988,"21 de agosto de 1994"
21,8,17,144,435,446,881,"21 de agosto de 1994"
21,8,17,145,659,682,1341,"21 de agosto de 1994"
21,8,17,146,328,319,647,"21 de agosto de 1994"
21,8,17,147,89,95,184,"21 de agosto de 1994"
21,8,44,344,275,347,622,"21 de agosto de 1994"
21,8,44,345,280,314,594,"21 de agosto de 1994"
21,8,44,346,389,481,870,"21 de agosto de 1994"
21,8,44,347,228,241,469,"21 de agosto de 1994"
21,8,44,348,372,340,712,"21 de agosto de 1994"
21,8,44,349,561,555,1116,"21 de agosto de 1994"
21,8,44,350,363,341,704,"21 de agosto de 1994"
21,8,44,351,473,481,954,"21 de agosto de 1994"
21,8,44,352,689,611,1300,"21 de agosto de 1994"
21,8,44,353,386,362,748,"21 de agosto de 1994"
21,8,44,354,567,582,1149,"21 de agosto de 1994"
21,8,44,355,689,686,1375,"21 de agosto de 1994"
21,8,44,356,375,340,715,"21 de agosto de 1994"
21,8,44,357,341,348,689,"21 de agosto de 1994"
21,8,44,358,374,354,728,"21 de agosto de 1994"
21,8,44,359,661,555,1216,"21 de agosto de 1994"
21,8,44,360,470,452,922,"21 de agosto de 1994"
21,8,44,361,293,301,594,"21 de agosto de 1994"
21,8,44,362,275,265,540,"21 de agosto de 1994"
21,8,44,363,449,382,831,"21 de agosto de 1994"
21,8,55,489,526,585,1111,"21 de agosto de 1994"
21,8,55,490,538,530,1068,"21 de agosto de 1994"
21,8,55,491,554,609,1163,"21 de agosto de 1994"
21,8,55,492,572,516,1088,"21 de agosto de 1994"
21,8,55,493,688,718,1406,"21 de agosto de 1994"
21,8,55,494,570,568,1138,"21 de agosto de 1994"
21,8,55,495,406,406,812,"21 de agosto de 1994"
21,8,77,673,345,356,701,"21 de agosto de 1994"
21,8,77,674,502,549,1051,"21 de agosto de 1994"
21,8,77,675,109,82,191,"21 de agosto de 1994"
21,8,77,676,324,304,628,"21 de agosto de 1994"
21,8,77,677,421,419,840,"21 de agosto de 1994"
21,8,78,678,524,536,1060,"21 de agosto de 1994"
21,8,78,679,358,362,720,"21 de agosto de 1994"
21,8,78,680,95,93,188,"21 de agosto de 1994"
21,8,78,681,441,383,824,"21 de agosto de 1994"
21,8,78,682,615,552,1167,"21 de agosto de 1994"
21,8,78,683,468,449,917,"21 de agosto de 1994"
21,8,78,684,184,179,363,"21 de agosto de 1994"
21,8,78,685,500,426,926,"21 de agosto de 1994"
21,8,78,686,444,402,846,"21 de agosto de 1994"
21,8,78,687,527,475,1002,"21 de agosto de 1994"
21,8,78,688,284,240,524,"21 de agosto de 1994"
21,8,78,689,71,73,144,"21 de agosto de 1994"
21,8,78,690,516,473,989,"21 de agosto de 1994"
21,8,78,691,207,180,387,"21 de agosto de 1994"
21,8,78,692,298,287,585,"21 de agosto de 1994"
21,8,169,2109,611,626,1237,"21 de agosto de 1994"
21,8,169,2110,482,435,917,"21 de agosto de 1994"
21,8,169,2111,358,325,683,"21 de agosto de 1994"
21,8,169,2112,556,542,1098,"21 de agosto de 1994"
21,8,169,2113,410,381,791,"21 de agosto de 1994"
21,8,169,2114,518,441,959,"21 de agosto de 1994"
21,8,169,2115,396,359,755,"21 de agosto de 1994"
21,8,172,2132,466,576,1042,"21 de agosto de 1994"
21,8,172,2133,405,467,872,"21 de agosto de 1994"
21,8,173,2134,327,396,723,"21 de agosto de 1994"
21,8,173,2135,199,275,474,"21 de agosto de 1994"
21,8,173,2136,528,520,1048,"21 de agosto de 1994"
21,8,173,2137,605,720,1325,"21 de agosto de 1994"
21,8,173,2138,382,492,874,"21 de agosto de 1994"
21,8,173,2139,326,392,718,"21 de agosto de 1994"
21,8,173,2140,413,454,867,"21 de agosto de 1994"
21,8,173,2141,195,209,404,"21 de agosto de 1994"
21,8,173,2142,671,817,1488,"21 de agosto de 1994"
21,8,173,2143,235,290,525,"21 de agosto de 1994"
21,8,173,2144,333,415,748,"21 de agosto de 1994"
21,8,173,2145,125,171,296,"21 de agosto de 1994"
21,8,173,2146,517,597,1114,"21 de agosto de 1994"
21,8,173,2147,547,714,1261,"21 de agosto de 1994"
21,8,173,2148,360,486,846,"21 de agosto de 1994"
21,8,173,2149,361,419,780,"21 de agosto de 1994"
21,8,173,2150,430,500,930,"21 de agosto de 1994"
21,8,173,2151,465,644,1109,"21 de agosto de 1994"
21,8,173,2152,198,281,479,"21 de agosto de 1994"
21,8,173,2153,431,548,979,"21 de agosto de 1994"
21,8,173,2154,472,564,1036,"21 de agosto de 1994"
21,8,173,2155,225,260,485,"21 de agosto de 1994"
21,8,173,2156,443,541,984,"21 de agosto de 1994"
21,8,173,2157,476,600,1076,"21 de agosto de 1994"
21,8,173,2158,517,633,1150,"21 de agosto de 1994"
21,8,173,2159,248,321,569,"21 de agosto de 1994"
21,8,173,2160,366,458,824,"21 de agosto de 1994"
21,8,173,2161,360,411,771,"21 de agosto de 1994"
21,8,173,2162,509,654,1163,"21 de agosto de 1994"
21,8,173,2163,623,716,1339,"21 de agosto de 1994"
21,8,173,2164,647,685,1332,"21 de agosto de 1994"
21,8,173,2165,145,183,328,"21 de agosto de 1994"
21,8,173,2166,285,291,576,"21 de agosto de 1994"
21,8,173,2167,623,657,1280,"21 de agosto de 1994"
21,8,173,2168,379,385,764,"21 de agosto de 1994"
21,8,173,2169,506,531,1037,"21 de agosto de 1994"
21,8,173,2170,252,307,559,"21 de agosto de 1994"
21,8,173,2171,140,149,289,"21 de agosto de 1994"
21,8,173,2172,348,388,736,"21 de agosto de 1994"
21,8,173,2173,654,692,1346,"21 de agosto de 1994"
21,8,173,2174,351,365,716,"21 de agosto de 1994"
21,8,186,2272,442,524,966,"21 de agosto de 1994"
21,8,186,2273,499,610,1109,"21 de agosto de 1994"
21,8,186,2274,554,649,1203,"21 de agosto de 1994"
21,8,186,2275,476,568,1044,"21 de agosto de 1994"
21,8,186,2276,451,400,851,"21 de agosto de 1994"
21,8,186,2277,229,193,422,"21 de agosto de 1994"
21,8,186,2278,169,150,319,"21 de agosto de 1994"
21,8,186,2279,440,370,810,"21 de agosto de 1994"
21,8,186,2280,445,386,831,"21 de agosto de 1994"
21,8,186,2281,343,322,665,"21 de agosto de 1994"
21,8,186,2282,533,557,1090,"21 de agosto de 1994"
21,8,186,2283,475,521,996,"21 de agosto de 1994"
21,8,186,2284,326,388,714,"21 de agosto de 1994"
21,8,186,2285,255,262,517,"21 de agosto de 1994"
21,8,186,2286,707,799,1506,"21 de agosto de 1994"
21,8,186,2287,294,316,610,"21 de agosto de 1994"
21,8,186,2288,404,443,847,"21 de agosto de 1994"
21,8,186,2289,492,636,1128,"21 de agosto de 1994"
21,8,186,2290,264,287,551,"21 de agosto de 1994"
21,8,186,2291,537,613,1150,"21 de agosto de 1994"
21,8,186,2292,262,282,544,"21 de agosto de 1994"
21,8,186,2293,365,352,717,"21 de agosto de 1994"
21,8,186,2294,357,371,728,"21 de agosto de 1994"
21,8,199,2393,527,557,1084,"21 de agosto de 1994"
21,8,199,2394,536,555,1091,"21 de agosto de 1994"
21,8,199,2395,392,445,837,"21 de agosto de 1994"
21,8,199,2396,340,334,674,"21 de agosto de 1994"
21,8,199,2397,472,533,1005,"21 de agosto de 1994"
21,8,199,2398,357,363,720,"21 de agosto de 1994"
21,8,199,2399,558,589,1147,"21 de agosto de 1994"
21,8,199,2400,581,593,1174,"21 de agosto de 1994"
21,8,199,2401,557,555,1112,"21 de agosto de 1994"
21,8,199,2402,447,427,874,"21 de agosto de 1994"
21,8,199,2403,436,411,847,"21 de agosto de 1994"
21,8,199,2404,271,257,528,"21 de agosto de 1994"
21,8,204,2416,249,270,519,"21 de agosto de 1994"
21,8,204,2417,307,320,627,"21 de agosto de 1994"
21,8,204,2418,227,217,444,"21 de agosto de 1994"
21,8,204,2419,419,443,862,"21 de agosto de 1994"
21,8,207,2433,331,385,716,"21 de agosto de 1994"
21,8,207,2434,340,407,747,"21 de agosto de 1994"
21,8,207,2435,409,468,877,"21 de agosto de 1994"
21,8,207,2436,624,718,1342,"21 de agosto de 1994"
21,8,207,2437,423,493,916,"21 de agosto de 1994"
21,8,207,2438,401,414,815,"21 de agosto de 1994"
21,8,207,2439,340,291,631,"21 de agosto de 1994"
21,8,207,2440,664,629,1293,"21 de agosto de 1994"
21,8,207,2441,155,163,318,"21 de agosto de 1994"
21,8,207,2442,155,164,319,"21 de agosto de 1994"
21,8,207,2443,288,326,614,"21 de agosto de 1994"
21,8,207,2444,135,161,296,"21 de agosto de 1994"
21,8,207,2445,684,637,1321,"21 de agosto de 1994"
21,8,207,2446,359,336,695,"21 de agosto de 1994"
21,8,207,2447,377,366,743,"21 de agosto de 1994"
21,8,207,2448,164,182,346,"21 de agosto de 1994"
21,8,207,2449,370,408,778,"21 de agosto de 1994"
21,8,207,2450,203,209,412,"21 de agosto de 1994"
21,8,207,2451,195,192,387,"21 de agosto de 1994"
21,8,207,2452,575,617,1192,"21 de agosto de 1994"
21,8,207,2453,101,104,205,"21 de agosto de 1994"
21,8,207,2454,190,219,409,"21 de agosto de 1994"
21,8,207,2455,130,142,272,"21 de agosto de 1994"
21,8,207,2456,152,146,298,"21 de agosto de 1994"
21,8,207,2457,223,278,501,"21 de agosto de 1994"
21,8,207,2458,398,462,860,"21 de agosto de 1994"
21,8,207,2459,127,147,274,"21 de agosto de 1994"
21,8,211,2502,336,422,758,"21 de agosto de 1994"
21,8,211,2503,450,506,956,"21 de agosto de 1994"
21,8,211,2504,531,630,1161,"21 de agosto de 1994"
21,8,211,2505,562,675,1237,"21 de agosto de 1994"
21,8,211,2506,311,363,674,"21 de agosto de 1994"
21,8,211,2507,257,318,575,"21 de agosto de 1994"
21,9,6,64,325,328,653,"21 de agosto de 1994"
21,9,6,65,414,450,864,"21 de agosto de 1994"
21,9,6,66,469,383,852,"21 de agosto de 1994"
21,9,6,67,428,447,875,"21 de agosto de 1994"
21,9,6,68,334,367,701,"21 de agosto de 1994"
21,9,6,69,232,250,482,"21 de agosto de 1994"
21,9,6,70,359,472,831,"21 de agosto de 1994"
21,9,14,113,470,480,950,"21 de agosto de 1994"
21,9,14,114,167,186,353,"21 de agosto de 1994"
21,9,14,115,355,387,742,"21 de agosto de 1994"
21,9,16,134,585,594,1179,"21 de agosto de 1994"
21,9,16,135,185,205,390,"21 de agosto de 1994"
21,9,16,136,446,441,887,"21 de agosto de 1994"
21,9,16,137,397,409,806,"21 de agosto de 1994"
21,9,16,138,269,222,491,"21 de agosto de 1994"
21,9,25,241,416,451,867,"21 de agosto de 1994"
21,9,25,242,476,456,932,"21 de agosto de 1994"
21,9,25,243,325,265,590,"21 de agosto de 1994"
21,9,25,244,327,294,621,"21 de agosto de 1994"
21,9,28,260,273,297,570,"21 de agosto de 1994"
21,9,28,261,97,101,198,"21 de agosto de 1994"
21,9,30,271,391,365,756,"21 de agosto de 1994"
21,9,30,272,238,226,464,"21 de agosto de 1994"
21,9,31,273,181,199,380,"21 de agosto de 1994"
21,9,40,319,664,684,1348,"21 de agosto de 1994"
21,9,40,320,399,403,802,"21 de agosto de 1994"
21,9,40,321,336,339,675,"21 de agosto de 1994"
21,9,40,322,224,271,495,"21 de agosto de 1994"
21,9,54,461,469,550,1019,"21 de agosto de 1994"
21,9,54,462,362,394,756,"21 de agosto de 1994"
21,9,54,463,346,374,720,"21 de agosto de 1994"
21,9,54,464,403,448,851,"21 de agosto de 1994"
21,9,54,465,346,414,760,"21 de agosto de 1994"
21,9,54,466,405,425,830,"21 de agosto de 1994"
21,9,54,467,562,711,1273,"21 de agosto de 1994"
21,9,54,468,430,507,937,"21 de agosto de 1994"
21,9,54,469,421,396,817,"21 de agosto de 1994"
21,9,54,470,488,429,917,"21 de agosto de 1994"
21,9,54,471,419,363,782,"21 de agosto de 1994"
21,9,54,472,292,303,595,"21 de agosto de 1994"
21,9,54,473,235,199,434,"21 de agosto de 1994"
21,9,54,474,389,351,740,"21 de agosto de 1994"
21,9,54,475,296,296,592,"21 de agosto de 1994"
21,9,54,476,418,423,841,"21 de agosto de 1994"
21,9,54,477,133,122,255,"21 de agosto de 1994"
21,9,54,478,348,295,643,"21 de agosto de 1994"
21,9,54,479,499,496,995,"21 de agosto de 1994"
21,9,54,480,285,254,539,"21 de agosto de 1994"
21,9,54,481,386,352,738,"21 de agosto de 1994"
21,9,54,482,569,566,1135,"21 de agosto de 1994"
21,9,54,483,490,478,968,"21 de agosto de 1994"
21,9,54,484,352,359,711,"21 de agosto de 1994"
21,9,54,485,364,332,696,"21 de agosto de 1994"
21,9,54,486,402,379,781,"21 de agosto de 1994"
21,9,54,487,416,442,858,"21 de agosto de 1994"
21,9,54,488,454,433,887,"21 de agosto de 1994"
21,9,69,565,602,574,1176,"21 de agosto de 1994"
21,9,69,566,370,343,713,"21 de agosto de 1994"
21,9,69,567,184,178,362,"21 de agosto de 1994"
21,9,69,568,405,343,748,"21 de agosto de 1994"
21,9,73,631,436,403,839,"21 de agosto de 1994"
21,9,73,632,468,505,973,"21 de agosto de 1994"
21,9,73,633,328,316,644,"21 de agosto de 1994"
21,9,73,634,306,307,613,"21 de agosto de 1994"
21,9,73,635,195,186,381,"21 de agosto de 1994"
21,9,73,636,492,436,928,"21 de agosto de 1994"
21,9,73,637,365,332,697,"21 de agosto de 1994"
21,9,73,638,317,250,567,"21 de agosto de 1994"
21,9,73,639,389,401,790,"21 de agosto de 1994"
21,9,79,693,344,330,674,"21 de agosto de 1994"
21,9,79,694,188,178,366,"21 de agosto de 1994"
21,9,79,695,490,390,880,"21 de agosto de 1994"
21,9,80,696,606,586,1192,"21 de agosto de 1994"
21,9,80,697,208,193,401,"21 de agosto de 1994"
21,9,80,698,457,445,902,"21 de agosto de 1994"
21,9,80,699,304,266,570,"21 de agosto de 1994"
21,9,80,700,384,342,726,"21 de agosto de 1994"
21,9,82,704,337,368,705,"21 de agosto de 1994"
21,9,82,705,245,262,507,"21 de agosto de 1994"
21,9,86,727,504,558,1062,"21 de agosto de 1994"
21,9,86,728,710,819,1529,"21 de agosto de 1994"
21,9,86,729,106,104,210,"21 de agosto de 1994"
21,9,90,776,365,384,749,"21 de agosto de 1994"
21,9,90,777,195,188,383,"21 de agosto de 1994"
21,9,90,778,533,464,997,"21 de agosto de 1994"
21,9,91,779,465,537,1002,"21 de agosto de 1994"
21,9,91,780,376,360,736,"21 de agosto de 1994"
21,9,91,781,268,273,541,"21 de agosto de 1994"
21,9,91,782,220,185,405,"21 de agosto de 1994"
21,9,91,783,335,307,642,"21 de agosto de 1994"
21,9,91,784,90,83,173,"21 de agosto de 1994"
21,9,91,785,399,353,752,"21 de agosto de 1994"
21,9,102,835,517,591,1108,"21 de agosto de 1994"
21,9,102,836,229,231,460,"21 de agosto de 1994"
21,9,102,837,116,145,261,"21 de agosto de 1994"
21,9,108,867,379,362,741,"21 de agosto de 1994"
21,9,108,868,416,473,889,"21 de agosto de 1994"
21,9,108,869,347,329,676,"21 de agosto de 1994"
21,9,108,870,205,227,432,"21 de agosto de 1994"
21,9,108,871,384,398,782,"21 de agosto de 1994"
21,9,108,872,253,267,520,"21 de agosto de 1994"
21,9,108,873,161,166,327,"21 de agosto de 1994"
21,9,108,874,185,157,342,"21 de agosto de 1994"
21,9,124,1682,423,408,831,"21 de agosto de 1994"
21,9,124,1683,274,273,547,"21 de agosto de 1994"
21,9,124,1684,271,213,484,"21 de agosto de 1994"
21,9,157,2025,401,394,795,"21 de agosto de 1994"
21,9,157,2026,526,504,1030,"21 de agosto de 1994"
21,9,157,2027,349,311,660,"21 de agosto de 1994"
21,9,157,2028,112,98,210,"21 de agosto de 1994"
21,9,157,2029,107,111,218,"21 de agosto de 1994"
21,9,157,2030,113,118,231,"21 de agosto de 1994"
21,9,157,2031,206,144,350,"21 de agosto de 1994"
21,9,157,2032,85,69,154,"21 de agosto de 1994"
21,9,161,2049,353,336,689,"21 de agosto de 1994"
21,9,161,2050,390,368,758,"21 de agosto de 1994"
21,9,166,2089,254,301,555,"21 de agosto de 1994"
21,9,166,2090,336,373,709,"21 de agosto de 1994"
21,9,166,2091,154,204,358,"21 de agosto de 1994"
21,9,166,2092,334,379,713,"21 de agosto de 1994"
21,9,166,2093,419,572,991,"21 de agosto de 1994"
21,9,166,2094,130,183,313,"21 de agosto de 1994"
21,9,171,2117,427,510,937,"21 de agosto de 1994"
21,9,171,2118,531,579,1110,"21 de agosto de 1994"
21,9,171,2119,402,361,763,"21 de agosto de 1994"
21,9,171,2120,363,306,669,"21 de agosto de 1994"
21,9,171,2121,117,127,244,"21 de agosto de 1994"
21,9,171,2122,670,717,1387,"21 de agosto de 1994"
21,9,171,2123,232,225,457,"21 de agosto de 1994"
21,9,171,2124,323,356,679,"21 de agosto de 1994"
21,9,171,2125,394,422,816,"21 de agosto de 1994"
21,9,171,2126,535,556,1091,"21 de agosto de 1994"
21,9,171,2127,402,392,794,"21 de agosto de 1994"
21,9,171,2128,302,305,607,"21 de agosto de 1994"
21,9,171,2129,494,454,948,"21 de agosto de 1994"
21,9,171,2130,153,154,307,"21 de agosto de 1994"
21,9,171,2131,326,243,569,"21 de agosto de 1994"
21,9,192,2326,428,491,919,"21 de agosto de 1994"
21,9,192,2327,457,476,933,"21 de agosto de 1994"
21,9,192,2328,424,454,878,"21 de agosto de 1994"
21,9,200,2405,538,620,1158,"21 de agosto de 1994"
21,9,200,2406,355,314,669,"21 de agosto de 1994"
21,9,202,2409,671,643,1314,"21 de agosto de 1994"
21,9,202,2410,500,534,1034,"21 de agosto de 1994"
21,9,202,2411,583,722,1305,"21 de agosto de 1994"
21,9,202,2412,520,610,1130,"21 de agosto de 1994"
21,9,208,2460,405,536,941,"21 de agosto de 1994"
21,9,208,2461,498,619,1117,"21 de agosto de 1994"
21,9,208,2462,394,506,900,"21 de agosto de 1994"
21,9,208,2463,464,592,1056,"21 de agosto de 1994"
21,9,208,2464,272,314,586,"21 de agosto de 1994"
21,9,208,2465,487,587,1074,"21 de agosto de 1994"
21,9,208,2466,382,506,888,"21 de agosto de 1994"
21,9,208,2467,337,409,746,"21 de agosto de 1994"
21,9,208,2468,626,738,1364,"21 de agosto de 1994"
21,9,208,2469,395,492,887,"21 de agosto de 1994"
21,9,208,2470,501,488,989,"21 de agosto de 1994"
21,9,208,2471,539,592,1131,"21 de agosto de 1994"
21,9,208,2472,520,546,1066,"21 de agosto de 1994"
21,9,208,2473,466,474,940,"21 de agosto de 1994"
21,9,208,2474,496,481,977,"21 de agosto de 1994"
21,9,208,2475,522,527,1049,"21 de agosto de 1994"
21,9,208,2476,426,410,836,"21 de agosto de 1994"
21,9,208,2477,317,312,629,"21 de agosto de 1994"
21,9,208,2478,640,661,1301,"21 de agosto de 1994"
21,9,208,2479,618,691,1309,"21 de agosto de 1994"
21,9,208,2480,638,720,1358,"21 de agosto de 1994"
21,9,208,2481,454,532,986,"21 de agosto de 1994"
21,9,208,2482,398,447,845,"21 de agosto de 1994"
21,9,208,2483,367,383,750,"21 de agosto de 1994"
21,9,208,2484,589,657,1246,"21 de agosto de 1994"
21,9,208,2485,424,484,908,"21 de agosto de 1994"
21,9,208,2486,433,426,859,"21 de agosto de 1994"
21,9,208,2487,466,575,1041,"21 de agosto de 1994"
21,9,208,2488,245,241,486,"21 de agosto de 1994"
21,9,208,2489,334,363,697,"21 de agosto de 1994"
21,9,210,2499,455,453,908,"21 de agosto de 1994"
21,9,210,2500,251,226,477,"21 de agosto de 1994"
21,9,210,2501,471,451,922,"21 de agosto de 1994"
21,9,215,2533,585,632,1217,"21 de agosto de 1994"
21,9,215,2534,311,345,656,"21 de agosto de 1994"
21,9,216,2535,471,516,987,"21 de agosto de 1994"
21,9,216,2536,138,178,316,"21 de agosto de 1994"
21,10,8,75,431,422,853,"21 de agosto de 1994"
21,10,8,76,527,553,1080,"21 de agosto de 1994"
21,10,8,77,667,722,1389,"21 de agosto de 1994"
21,10,8,78,289,285,574,"21 de agosto de 1994"
21,10,50,423,386,457,843,"21 de agosto de 1994"
21,10,50,424,487,477,964,"21 de agosto de 1994"
21,10,50,425,162,163,325,"21 de agosto de 1994"
21,10,50,426,289,293,582,"21 de agosto de 1994"
21,10,50,427,235,251,486,"21 de agosto de 1994"
21,10,50,428,405,430,835,"21 de agosto de 1994"
21,10,50,429,193,147,340,"21 de agosto de 1994"
21,10,58,502,454,459,913,"21 de agosto de 1994"
21,10,58,503,367,378,745,"21 de agosto de 1994"
21,10,58,504,600,579,1179,"21 de agosto de 1994"
21,10,65,535,643,649,1292,"21 de agosto de 1994"
21,10,65,536,425,427,852,"21 de agosto de 1994"
21,10,65,537,515,446,961,"21 de agosto de 1994"
21,10,65,538,536,457,993,"21 de agosto de 1994"
21,10,65,539,271,262,533,"21 de agosto de 1994"
21,10,65,540,317,277,594,"21 de agosto de 1994"
21,10,65,541,456,440,896,"21 de agosto de 1994"
21,10,65,542,358,322,680,"21 de agosto de 1994"
21,10,65,543,222,246,468,"21 de agosto de 1994"
21,10,72,594,414,541,955,"21 de agosto de 1994"
21,10,72,595,322,382,704,"21 de agosto de 1994"
21,10,72,596,541,586,1127,"21 de agosto de 1994"
21,10,72,597,475,571,1046,"21 de agosto de 1994"
21,10,72,598,679,779,1458,"21 de agosto de 1994"
21,10,72,599,530,642,1172,"21 de agosto de 1994"
21,10,72,600,559,643,1202,"21 de agosto de 1994"
21,10,72,601,403,489,892,"21 de agosto de 1994"
21,10,72,602,383,453,836,"21 de agosto de 1994"
21,10,72,603,699,860,1559,"21 de agosto de 1994"
21,10,72,604,691,824,1515,"21 de agosto de 1994"
21,10,72,605,369,415,784,"21 de agosto de 1994"
21,10,72,606,300,330,630,"21 de agosto de 1994"
21,10,72,607,634,712,1346,"21 de agosto de 1994"
21,10,72,608,458,497,955,"21 de agosto de 1994"
21,10,72,609,642,675,1317,"21 de agosto de 1994"
21,10,72,610,434,486,920,"21 de agosto de 1994"
21,10,72,611,559,630,1189,"21 de agosto de 1994"
21,10,72,612,639,688,1327,"21 de agosto de 1994"
21,10,72,613,289,281,570,"21 de agosto de 1994"
21,10,72,614,316,373,689,"21 de agosto de 1994"
21,10,72,615,581,700,1281,"21 de agosto de 1994"
21,10,72,616,799,780,1579,"21 de agosto de 1994"
21,10,72,617,254,260,514,"21 de agosto de 1994"
21,10,72,618,483,483,966,"21 de agosto de 1994"
21,10,72,619,389,412,801,"21 de agosto de 1994"
21,10,72,620,158,173,331,"21 de agosto de 1994"
21,10,72,621,100,86,186,"21 de agosto de 1994"
21,10,72,622,294,370,664,"21 de agosto de 1994"
21,10,72,623,551,606,1157,"21 de agosto de 1994"
21,10,72,624,357,392,749,"21 de agosto de 1994"
21,10,72,625,154,179,333,"21 de agosto de 1994"
21,10,72,626,268,234,502,"21 de agosto de 1994"
21,10,72,627,307,250,557,"21 de agosto de 1994"
21,10,72,628,408,303,711,"21 de agosto de 1994"
21,10,72,629,580,521,1101,"21 de agosto de 1994"
21,10,72,630,247,209,456,"21 de agosto de 1994"
21,10,88,764,516,481,997,"21 de agosto de 1994"
21,10,88,765,461,416,877,"21 de agosto de 1994"
21,10,88,766,260,227,487,"21 de agosto de 1994"
21,10,88,767,446,467,913,"21 de agosto de 1994"
21,10,88,768,436,446,882,"21 de agosto de 1994"
21,10,88,769,177,146,323,"21 de agosto de 1994"
21,10,93,792,524,603,1127,"21 de agosto de 1994"
21,10,93,793,558,621,1179,"21 de agosto de 1994"
21,10,93,794,336,373,709,"21 de agosto de 1994"
21,10,93,795,210,237,447,"21 de agosto de 1994"
21,10,93,796,107,101,208,"21 de agosto de 1994"
21,10,101,830,269,315,584,"21 de agosto de 1994"
21,10,101,831,322,280,602,"21 de agosto de 1994"
21,10,101,832,395,384,779,"21 de agosto de 1994"
21,10,101,833,323,374,697,"21 de agosto de 1994"
21,10,101,834,399,500,899,"21 de agosto de 1994"
21,10,110,883,329,341,670,"21 de agosto de 1994"
21,10,110,884,360,352,712,"21 de agosto de 1994"
21,10,110,885,240,235,475,"21 de agosto de 1994"
21,10,110,886,97,81,178,"21 de agosto de 1994"
21,10,110,887,323,293,616,"21 de agosto de 1994"
21,10,110,888,235,212,447,"21 de agosto de 1994"
21,10,110,889,358,332,690,"21 de agosto de 1994"
21,10,110,890,426,541,967,"21 de agosto de 1994"
21,10,110,891,107,121,228,"21 de agosto de 1994"
21,10,110,892,86,84,170,"21 de agosto de 1994"
21,10,110,893,319,346,665,"21 de agosto de 1994"
21,10,110,894,170,192,362,"21 de agosto de 1994"
21,10,110,895,94,97,191,"21 de agosto de 1994"
21,10,110,896,404,478,882,"21 de agosto de 1994"
21,10,112,912,270,270,540,"21 de agosto de 1994"
21,10,112,913,583,581,1164,"21 de agosto de 1994"
21,10,112,914,260,240,500,"21 de agosto de 1994"
21,10,112,915,401,376,777,"21 de agosto de 1994"
21,10,112,916,256,245,501,"21 de agosto de 1994"
21,10,112,917,474,474,948,"21 de agosto de 1994"
21,10,112,918,360,367,727,"21 de agosto de 1994"
21,10,112,919,437,454,891,"21 de agosto de 1994"
21,10,112,920,433,441,874,"21 de agosto de 1994"
21,10,112,921,349,310,659,"21 de agosto de 1994"
21,10,178,2209,519,489,1008,"21 de agosto de 1994"
21,10,178,2210,339,320,659,"21 de agosto de 1994"
21,10,178,2211,261,320,581,"21 de agosto de 1994"
21,10,178,2212,485,409,894,"21 de agosto de 1994"
21,10,178,2213,364,433,797,"21 de agosto de 1994"
21,10,178,2214,209,196,405,"21 de agosto de 1994"
21,10,178,2215,388,394,782,"21 de agosto de 1994"
21,10,178,2216,206,166,372,"21 de agosto de 1994"
21,10,178,2217,277,245,522,"21 de agosto de 1994"
21,10,178,2218,323,289,612,"21 de agosto de 1994"
21,10,183,2253,271,298,569,"21 de agosto de 1994"
21,10,183,2254,600,585,1185,"21 de agosto de 1994"
21,10,183,2255,228,239,467,"21 de agosto de 1994"
21,10,183,2256,106,123,229,"21 de agosto de 1994"
21,10,183,2257,621,624,1245,"21 de agosto de 1994"
21,10,183,2258,324,318,642,"21 de agosto de 1994"
21,10,183,2259,460,443,903,"21 de agosto de 1994"
21,10,183,2260,384,426,810,"21 de agosto de 1994"
21,10,183,2261,216,255,471,"21 de agosto de 1994"
21,10,184,2262,291,258,549,"21 de agosto de 1994"
21,10,184,2263,160,150,310,"21 de agosto de 1994"
21,10,184,2264,353,324,677,"21 de agosto de 1994"
21,10,184,2265,169,142,311,"21 de agosto de 1994"
21,10,184,2266,184,161,345,"21 de agosto de 1994"
21,10,187,2295,295,265,560,"21 de agosto de 1994"
21,10,187,2296,323,283,606,"21 de agosto de 1994"
21,10,187,2297,384,306,690,"21 de agosto de 1994"
21,10,187,2298,284,254,538,"21 de agosto de 1994"
21,10,194,2333,428,472,900,"21 de agosto de 1994"
21,10,194,2334,298,352,650,"21 de agosto de 1994"
21,10,194,2335,369,403,772,"21 de agosto de 1994"
21,10,194,2336,323,366,689,"21 de agosto de 1994"
21,10,194,2337,92,101,193,"21 de agosto de 1994"
21,10,194,2338,366,323,689,"21 de agosto de 1994"
21,10,194,2339,185,177,362,"21 de agosto de 1994"
21,10,194,2340,198,162,360,"21 de agosto de 1994"
21,10,194,2341,79,85,164,"21 de agosto de 1994"
21,10,194,2342,541,636,1177,"21 de agosto de 1994"
21,10,194,2343,504,592,1096,"21 de agosto de 1994"
21,10,194,2344,501,510,1011,"21 de agosto de 1994"
21,10,194,2345,613,569,1182,"21 de agosto de 1994"
21,10,194,2346,360,377,737,"21 de agosto de 1994"
21,10,194,2347,268,351,619,"21 de agosto de 1994"
21,10,194,2348,285,317,602,"21 de agosto de 1994"
21,10,197,2362,391,430,821,"21 de agosto de 1994"
21,10,197,2363,522,529,1051,"21 de agosto de 1994"
21,10,197,2364,485,532,1017,"21 de agosto de 1994"
21,10,197,2365,499,642,1141,"21 de agosto de 1994"
21,10,197,2366,747,829,1576,"21 de agosto de 1994"
21,10,197,2367,634,738,1372,"21 de agosto de 1994"
21,10,197,2368,328,400,728,"21 de agosto de 1994"
21,10,197,2369,554,635,1189,"21 de agosto de 1994"
21,10,197,2370,608,712,1320,"21 de agosto de 1994"
21,10,197,2371,551,609,1160,"21 de agosto de 1994"
21,10,197,2372,484,563,1047,"21 de agosto de 1994"
21,10,197,2373,688,801,1489,"21 de agosto de 1994"
21,10,197,2374,350,416,766,"21 de agosto de 1994"
21,10,197,2375,420,466,886,"21 de agosto de 1994"
21,10,197,2376,598,659,1257,"21 de agosto de 1994"
21,10,197,2377,567,626,1193,"21 de agosto de 1994"
21,10,197,2378,528,626,1154,"21 de agosto de 1994"
21,10,197,2379,340,402,742,"21 de agosto de 1994"
21,10,197,2380,561,648,1209,"21 de agosto de 1994"
21,10,197,2381,297,334,631,"21 de agosto de 1994"
21,10,197,2382,348,339,687,"21 de agosto de 1994"
21,10,197,2383,575,536,1111,"21 de agosto de 1994"
21,10,197,2384,288,263,551,"21 de agosto de 1994"
21,10,197,2385,401,400,801,"21 de agosto de 1994"
21,10,197,2386,240,202,442,"21 de agosto de 1994"
21,10,197,2387,241,229,470,"21 de agosto de 1994"
21,10,197,2388,278,311,589,"21 de agosto de 1994"
21,10,197,2389,507,473,980,"21 de agosto de 1994"
21,10,197,2390,280,302,582,"21 de agosto de 1994"
21,10,213,2520,492,495,987,"21 de agosto de 1994"
21,10,213,2521,203,193,396,"21 de agosto de 1994"
21,10,213,2522,448,413,861,"21 de agosto de 1994"
21,10,213,2523,336,306,642,"21 de agosto de 1994"
21,10,213,2524,405,397,802,"21 de agosto de 1994"
21,10,213,2525,169,151,320,"21 de agosto de 1994"
21,10,213,2526,525,536,1061,"21 de agosto de 1994"
21,11,115,1261,189,208,397,"21 de agosto de 1994"
21,11,115,1262,225,256,481,"21 de agosto de 1994"
21,11,115,1263,232,292,524,"21 de agosto de 1994"
21,11,115,1264,225,278,503,"21 de agosto de 1994"
21,11,115,1265,215,252,467,"21 de agosto de 1994"
21,11,115,1266,235,252,487,"21 de agosto de 1994"
21,11,115,1267,343,393,736,"21 de agosto de 1994"
21,11,115,1268,350,441,791,"21 de agosto de 1994"
21,11,115,1269,252,324,576,"21 de agosto de 1994"
21,11,115,1270,248,261,509,"21 de agosto de 1994"
21,11,115,1271,434,518,952,"21 de agosto de 1994"
21,11,115,1272,214,239,453,"21 de agosto de 1994"
21,11,115,1273,293,347,640,"21 de agosto de 1994"
21,11,115,1274,201,294,495,"21 de agosto de 1994"
21,11,115,1275,67,87,154,"21 de agosto de 1994"
21,11,115,1276,419,523,942,"21 de agosto de 1994"
21,11,115,1277,186,212,398,"21 de agosto de 1994"
21,11,115,1278,342,396,738,"21 de agosto de 1994"
21,11,115,1279,310,372,682,"21 de agosto de 1994"
21,11,115,1280,256,312,568,"21 de agosto de 1994"
21,11,115,1281,405,472,877,"21 de agosto de 1994"
21,11,115,1282,345,458,803,"21 de agosto de 1994"
21,11,115,1283,203,277,480,"21 de agosto de 1994"
21,11,115,1284,158,177,335,"21 de agosto de 1994"
21,11,115,1285,212,234,446,"21 de agosto de 1994"
21,11,115,1286,334,386,720,"21 de agosto de 1994"
21,11,115,1287,465,519,984,"21 de agosto de 1994"
21,11,115,1288,441,540,981,"21 de agosto de 1994"
21,11,115,1289,435,496,931,"21 de agosto de 1994"
21,11,115,1290,394,501,895,"21 de agosto de 1994"
21,11,115,1291,551,658,1209,"21 de agosto de 1994"
21,11,115,1292,617,755,1372,"21 de agosto de 1994"
21,11,115,1293,418,457,875,"21 de agosto de 1994"
21,11,115,1294,349,393,742,"21 de agosto de 1994"
21,11,115,1295,514,530,1044,"21 de agosto de 1994"
21,11,115,1296,568,614,1182,"21 de agosto de 1994"
21,11,115,1297,373,406,779,"21 de agosto de 1994"
21,11,115,1298,226,217,443,"21 de agosto de 1994"
21,11,115,1299,571,640,1211,"21 de agosto de 1994"
21,11,115,1300,423,525,948,"21 de agosto de 1994"
21,11,115,1301,405,444,849,"21 de agosto de 1994"
21,11,115,1302,259,409,668,"21 de agosto de 1994"
21,11,115,1303,646,732,1378,"21 de agosto de 1994"
21,11,115,1304,668,711,1379,"21 de agosto de 1994"
21,11,115,1305,466,524,990,"21 de agosto de 1994"
21,11,115,1306,536,592,1128,"21 de agosto de 1994"
21,11,115,1307,613,673,1286,"21 de agosto de 1994"
21,11,115,1308,412,514,926,"21 de agosto de 1994"
21,11,115,1309,468,543,1011,"21 de agosto de 1994"
21,11,115,1310,476,558,1034,"21 de agosto de 1994"
21,11,115,1311,395,449,844,"21 de agosto de 1994"
21,11,115,1312,254,274,528,"21 de agosto de 1994"
21,11,115,1313,635,731,1366,"21 de agosto de 1994"
21,11,115,1314,480,643,1123,"21 de agosto de 1994"
21,11,115,1315,380,416,796,"21 de agosto de 1994"
21,11,115,1316,428,479,907,"21 de agosto de 1994"
21,11,115,1317,338,374,712,"21 de agosto de 1994"
21,11,115,1318,113,19,132,"21 de agosto de 1994"
21,11,115,1319,566,722,1288,"21 de agosto de 1994"
21,11,115,1320,727,891,1618,"21 de agosto de 1994"
21,11,115,1321,474,513,987,"21 de agosto de 1994"
21,11,115,1322,548,564,1112,"21 de agosto de 1994"
21,11,115,1323,504,565,1069,"21 de agosto de 1994"
21,11,115,1324,431,486,917,"21 de agosto de 1994"
21,11,115,1325,410,435,845,"21 de agosto de 1994"
21,11,115,1326,377,392,769,"21 de agosto de 1994"
21,11,115,1327,608,675,1283,"21 de agosto de 1994"
21,11,115,1328,648,762,1410,"21 de agosto de 1994"
21,11,115,1329,725,855,1580,"21 de agosto de 1994"
21,11,115,1330,314,374,688,"21 de agosto de 1994"
21,11,115,1331,450,519,969,"21 de agosto de 1994"
21,11,115,1332,358,435,793,"21 de agosto de 1994"
21,11,115,1333,393,443,836,"21 de agosto de 1994"
21,11,115,1334,471,516,987,"21 de agosto de 1994"
21,11,115,1335,301,382,683,"21 de agosto de 1994"
21,11,115,1336,168,195,363,"21 de agosto de 1994"
21,11,115,1337,160,225,385,"21 de agosto de 1994"
21,11,115,1338,578,640,1218,"21 de agosto de 1994"
21,11,115,1339,622,743,1365,"21 de agosto de 1994"
21,11,115,1340,612,680,1292,"21 de agosto de 1994"
21,11,115,1341,382,413,795,"21 de agosto de 1994"
21,11,115,1342,365,416,781,"21 de agosto de 1994"
21,11,115,1343,147,196,343,"21 de agosto de 1994"
21,11,115,1344,266,290,556,"21 de agosto de 1994"
21,11,115,1345,518,593,1111,"21 de agosto de 1994"
21,11,115,1346,524,537,1061,"21 de agosto de 1994"
21,11,115,1347,601,651,1252,"21 de agosto de 1994"
21,11,115,1348,525,618,1143,"21 de agosto de 1994"
21,11,115,1349,441,456,897,"21 de agosto de 1994"
21,11,115,1350,486,531,1017,"21 de agosto de 1994"
21,11,115,1351,535,633,1168,"21 de agosto de 1994"
21,11,115,1352,548,573,1121,"21 de agosto de 1994"
21,11,115,1353,493,549,1042,"21 de agosto de 1994"
21,11,115,1354,479,528,1007,"21 de agosto de 1994"
21,11,115,1355,675,800,1475,"21 de agosto de 1994"
21,11,115,1356,466,576,1042,"21 de agosto de 1994"
21,11,115,1357,498,543,1041,"21 de agosto de 1994"
21,11,115,1358,596,732,1328,"21 de agosto de 1994"
21,11,115,1359,592,639,1231,"21 de agosto de 1994"
21,11,115,1360,439,544,983,"21 de agosto de 1994"
21,11,115,1361,645,817,1462,"21 de agosto de 1994"
21,11,115,1362,412,490,902,"21 de agosto de 1994"
21,11,115,1363,429,482,911,"21 de agosto de 1994"
21,11,115,1364,365,390,755,"21 de agosto de 1994"
21,11,115,1365,708,802,1510,"21 de agosto de 1994"
21,11,115,1366,603,695,1298,"21 de agosto de 1994"
21,11,115,1367,413,480,893,"21 de agosto de 1994"
21,11,115,1368,260,257,517,"21 de agosto de 1994"
21,11,115,1369,823,911,1734,"21 de agosto de 1994"
21,11,115,1370,620,728,1348,"21 de agosto de 1994"
21,11,115,1371,473,549,1022,"21 de agosto de 1994"
21,11,115,1372,542,610,1152,"21 de agosto de 1994"
21,11,115,1373,409,459,868,"21 de agosto de 1994"
21,11,115,1374,625,718,1343,"21 de agosto de 1994"
21,11,115,1375,521,561,1082,"21 de agosto de 1994"
21,11,115,1376,577,641,1218,"21 de agosto de 1994"
21,11,115,1377,613,636,1249,"21 de agosto de 1994"
21,11,115,1378,539,611,1150,"21 de agosto de 1994"
21,11,115,1379,572,622,1194,"21 de agosto de 1994"
21,11,115,1380,590,662,1252,"21 de agosto de 1994"
21,11,115,1381,225,215,440,"21 de agosto de 1994"
21,11,115,1382,652,669,1321,"21 de agosto de 1994"
21,11,115,1383,343,394,737,"21 de agosto de 1994"
21,11,115,1384,307,410,717,"21 de agosto de 1994"
21,11,115,1385,358,405,763,"21 de agosto de 1994"
21,11,115,1386,523,538,1061,"21 de agosto de 1994"
21,11,115,1387,361,422,783,"21 de agosto de 1994"
21,11,115,1388,420,484,904,"21 de agosto de 1994"
21,11,115,1389,560,625,1185,"21 de agosto de 1994"
21,11,115,1390,701,772,1473,"21 de agosto de 1994"
21,11,115,1391,676,702,1378,"21 de agosto de 1994"
21,11,115,1392,317,384,701,"21 de agosto de 1994"
21,11,115,1393,438,498,936,"21 de agosto de 1994"
21,11,115,1394,371,395,766,"21 de agosto de 1994"
21,11,115,1395,407,497,904,"21 de agosto de 1994"
21,11,115,1396,556,594,1150,"21 de agosto de 1994"
21,11,115,1397,644,719,1363,"21 de agosto de 1994"
21,11,115,1398,606,651,1257,"21 de agosto de 1994"
21,11,115,1399,403,483,886,"21 de agosto de 1994"
21,11,115,1400,565,685,1250,"21 de agosto de 1994"
21,11,115,1401,316,366,682,"21 de agosto de 1994"
21,11,115,1402,413,500,913,"21 de agosto de 1994"
21,11,115,1403,391,472,863,"21 de agosto de 1994"
21,11,115,1404,418,492,910,"21 de agosto de 1994"
21,11,115,1405,886,1095,1981,"21 de agosto de 1994"
21,11,115,1406,423,511,934,"21 de agosto de 1994"
21,11,115,1407,667,682,1349,"21 de agosto de 1994"
21,11,115,1408,690,803,1493,"21 de agosto de 1994"
21,11,115,1409,425,460,885,"21 de agosto de 1994"
21,11,115,1410,443,470,913,"21 de agosto de 1994"
21,11,115,1411,761,758,1519,"21 de agosto de 1994"
21,11,115,1412,526,510,1036,"21 de agosto de 1994"
21,11,115,1413,1134,1021,2155,"21 de agosto de 1994"
21,11,115,1414,659,674,1333,"21 de agosto de 1994"
21,11,115,1415,421,437,858,"21 de agosto de 1994"
21,11,115,1416,720,791,1511,"21 de agosto de 1994"
21,11,115,1417,502,511,1013,"21 de agosto de 1994"
21,11,115,1418,565,639,1204,"21 de agosto de 1994"
21,11,115,1419,573,581,1154,"21 de agosto de 1994"
21,11,115,1420,567,602,1169,"21 de agosto de 1994"
21,11,115,1421,429,438,867,"21 de agosto de 1994"
21,11,115,1422,450,455,905,"21 de agosto de 1994"
21,12,115,1423,204,172,376,"21 de agosto de 1994"
21,12,115,1424,119,143,262,"21 de agosto de 1994"
21,12,115,1425,227,282,509,"21 de agosto de 1994"
21,12,115,1426,329,384,713,"21 de agosto de 1994"
21,12,115,1427,366,408,774,"21 de agosto de 1994"
21,12,115,1428,309,352,661,"21 de agosto de 1994"
21,12,115,1429,246,287,533,"21 de agosto de 1994"
21,12,115,1430,427,470,897,"21 de agosto de 1994"
21,12,115,1431,369,421,790,"21 de agosto de 1994"
21,12,115,1432,276,290,566,"21 de agosto de 1994"
21,12,115,1433,530,611,1141,"21 de agosto de 1994"
21,12,115,1434,573,676,1249,"21 de agosto de 1994"
21,12,115,1435,374,537,911,"21 de agosto de 1994"
21,12,115,1436,416,492,908,"21 de agosto de 1994"
21,12,115,1437,501,673,1174,"21 de agosto de 1994"
21,12,115,1438,437,553,990,"21 de agosto de 1994"
21,12,115,1439,285,324,609,"21 de agosto de 1994"
21,12,115,1440,315,417,732,"21 de agosto de 1994"
21,12,115,1441,445,550,995,"21 de agosto de 1994"
21,12,115,1442,379,460,839,"21 de agosto de 1994"
21,12,115,1443,557,641,1198,"21 de agosto de 1994"
21,12,115,1444,376,419,795,"21 de agosto de 1994"
21,12,115,1445,317,440,757,"21 de agosto de 1994"
21,12,115,1446,468,532,1000,"21 de agosto de 1994"
21,12,115,1447,461,556,1017,"21 de agosto de 1994"
21,12,115,1448,507,638,1145,"21 de agosto de 1994"
21,12,115,1449,368,512,880,"21 de agosto de 1994"
21,12,115,1450,335,425,760,"21 de agosto de 1994"
21,12,115,1451,285,331,616,"21 de agosto de 1994"
21,12,115,1452,457,548,1005,"21 de agosto de 1994"
21,12,115,1453,774,874,1648,"21 de agosto de 1994"
21,12,115,1454,553,663,1216,"21 de agosto de 1994"
21,12,115,1455,532,659,1191,"21 de agosto de 1994"
21,12,115,1456,427,544,971,"21 de agosto de 1994"
21,12,115,1457,437,561,998,"21 de agosto de 1994"
21,12,115,1458,509,592,1101,"21 de agosto de 1994"
21,12,115,1459,603,660,1263,"21 de agosto de 1994"
21,12,115,1460,588,654,1242,"21 de agosto de 1994"
21,12,115,1461,318,364,682,"21 de agosto de 1994"
21,12,115,1462,366,470,836,"21 de agosto de 1994"
21,12,115,1463,362,417,779,"21 de agosto de 1994"
21,12,115,1464,480,604,1084,"21 de agosto de 1994"
21,12,115,1465,497,652,1149,"21 de agosto de 1994"
21,12,115,1466,482,578,1060,"21 de agosto de 1994"
21,12,115,1467,469,584,1053,"21 de agosto de 1994"
21,12,115,1468,425,431,856,"21 de agosto de 1994"
21,12,115,1469,457,511,968,"21 de agosto de 1994"
21,12,115,1470,431,528,959,"21 de agosto de 1994"
21,12,115,1471,603,675,1278,"21 de agosto de 1994"
21,12,115,1472,551,663,1214,"21 de agosto de 1994"
21,12,115,1473,697,787,1484,"21 de agosto de 1994"
21,12,115,1474,500,551,1051,"21 de agosto de 1994"
21,12,115,1475,452,525,977,"21 de agosto de 1994"
21,12,115,1476,413,436,849,"21 de agosto de 1994"
21,12,115,1477,635,715,1350,"21 de agosto de 1994"
21,12,115,1478,416,517,933,"21 de agosto de 1994"
21,12,115,1479,408,495,903,"21 de agosto de 1994"
21,12,115,1480,448,568,1016,"21 de agosto de 1994"
21,12,115,1481,427,536,963,"21 de agosto de 1994"
21,12,115,1482,462,559,1021,"21 de agosto de 1994"
21,12,115,1483,458,523,981,"21 de agosto de 1994"
21,12,115,1484,470,590,1060,"21 de agosto de 1994"
21,12,115,1485,364,474,838,"21 de agosto de 1994"
21,12,115,1486,377,433,810,"21 de agosto de 1994"
21,12,115,1487,347,428,775,"21 de agosto de 1994"
21,12,115,1488,459,582,1041,"21 de agosto de 1994"
21,12,115,1489,506,585,1091,"21 de agosto de 1994"
21,12,115,1490,452,538,990,"21 de agosto de 1994"
21,12,115,1491,693,791,1484,"21 de agosto de 1994"
21,12,115,1492,1271,33,1304,"21 de agosto de 1994"
21,12,115,1493,543,14,557,"21 de agosto de 1994"
21,12,115,1494,498,591,1089,"21 de agosto de 1994"
21,12,115,1495,287,327,614,"21 de agosto de 1994"
21,12,115,1496,287,307,594,"21 de agosto de 1994"
21,12,115,1497,327,419,746,"21 de agosto de 1994"
21,12,115,1498,472,555,1027,"21 de agosto de 1994"
21,12,115,1499,324,348,672,"21 de agosto de 1994"
21,12,115,1500,526,581,1107,"21 de agosto de 1994"
21,12,115,1501,675,775,1450,"21 de agosto de 1994"
21,12,115,1502,471,577,1048,"21 de agosto de 1994"
21,12,115,1503,450,559,1009,"21 de agosto de 1994"
21,12,115,1504,335,410,745,"21 de agosto de 1994"
21,12,115,1505,580,675,1255,"21 de agosto de 1994"
21,12,115,1506,461,629,1090,"21 de agosto de 1994"
21,12,115,1507,467,559,1026,"21 de agosto de 1994"
21,12,115,1508,423,550,973,"21 de agosto de 1994"
21,12,115,1509,611,735,1346,"21 de agosto de 1994"
21,12,115,1510,486,636,1122,"21 de agosto de 1994"
21,12,115,1511,543,660,1203,"21 de agosto de 1994"
21,12,115,1512,502,629,1131,"21 de agosto de 1994"
21,12,115,1513,585,672,1257,"21 de agosto de 1994"
21,12,115,1514,348,406,754,"21 de agosto de 1994"
21,12,115,1515,236,291,527,"21 de agosto de 1994"
21,12,115,1516,481,497,978,"21 de agosto de 1994"
21,12,115,1517,314,325,639,"21 de agosto de 1994"
21,12,115,1518,449,494,943,"21 de agosto de 1994"
21,12,115,1519,397,458,855,"21 de agosto de 1994"
21,12,115,1520,496,588,1084,"21 de agosto de 1994"
21,12,115,1521,298,342,640,"21 de agosto de 1994"
21,12,115,1522,563,616,1179,"21 de agosto de 1994"
21,12,115,1523,384,455,839,"21 de agosto de 1994"
21,12,115,1524,498,642,1140,"21 de agosto de 1994"
21,12,115,1525,325,436,761,"21 de agosto de 1994"
21,12,115,1526,350,434,784,"21 de agosto de 1994"
21,12,115,1527,320,389,709,"21 de agosto de 1994"
21,12,115,1528,312,369,681,"21 de agosto de 1994"
21,12,115,1529,570,639,1209,"21 de agosto de 1994"
21,12,115,1530,604,672,1276,"21 de agosto de 1994"
21,12,115,1531,581,641,1222,"21 de agosto de 1994"
21,12,115,1532,523,605,1128,"21 de agosto de 1994"
21,12,115,1533,487,617,1104,"21 de agosto de 1994"
21,12,115,1534,828,932,1760,"21 de agosto de 1994"
21,12,115,1535,424,438,862,"21 de agosto de 1994"
21,12,115,1536,504,561,1065,"21 de agosto de 1994"
21,12,115,1537,613,688,1301,"21 de agosto de 1994"
21,12,115,1538,509,576,1085,"21 de agosto de 1994"
21,12,115,1539,672,715,1387,"21 de agosto de 1994"
21,12,115,1540,445,484,929,"21 de agosto de 1994"
21,12,115,1541,394,442,836,"21 de agosto de 1994"
21,12,115,1542,363,428,791,"21 de agosto de 1994"
21,12,115,1543,502,501,1003,"21 de agosto de 1994"
21,12,115,1544,518,508,1026,"21 de agosto de 1994"
21,12,115,1545,561,582,1143,"21 de agosto de 1994"
21,12,115,1546,531,572,1103,"21 de agosto de 1994"
21,12,115,1547,542,537,1079,"21 de agosto de 1994"
21,12,115,1548,629,730,1359,"21 de agosto de 1994"
21,12,115,1549,433,497,930,"21 de agosto de 1994"
21,12,115,1550,654,753,1407,"21 de agosto de 1994"
21,12,115,1551,565,632,1197,"21 de agosto de 1994"
21,12,115,1552,406,471,877,"21 de agosto de 1994"
21,12,115,1553,389,470,859,"21 de agosto de 1994"
21,12,115,1554,351,413,764,"21 de agosto de 1994"
21,12,115,1555,563,669,1232,"21 de agosto de 1994"
21,12,115,1556,471,576,1047,"21 de agosto de 1994"
21,12,115,1557,502,522,1024,"21 de agosto de 1994"
21,12,115,1558,359,418,777,"21 de agosto de 1994"
21,12,115,1559,250,309,559,"21 de agosto de 1994"
21,12,115,1560,167,188,355,"21 de agosto de 1994"
21,12,115,1561,358,368,726,"21 de agosto de 1994"
21,12,115,1562,661,702,1363,"21 de agosto de 1994"
21,12,115,1563,517,529,1046,"21 de agosto de 1994"
21,12,115,1564,319,397,716,"21 de agosto de 1994"
21,12,115,1565,480,526,1006,"21 de agosto de 1994"
21,12,115,1566,464,541,1005,"21 de agosto de 1994"
21,12,115,1567,524,614,1138,"21 de agosto de 1994"
21,12,115,1568,485,505,990,"21 de agosto de 1994"
21,12,115,1569,644,758,1402,"21 de agosto de 1994"
21,12,115,1570,566,568,1134,"21 de agosto de 1994"
21,12,115,1571,466,500,966,"21 de agosto de 1994"
21,12,115,1572,615,665,1280,"21 de agosto de 1994"
21,12,115,1573,601,657,1258,"21 de agosto de 1994"
21,12,115,1574,790,793,1583,"21 de agosto de 1994"
21,12,115,1575,827,845,1672,"21 de agosto de 1994"
21,12,115,1576,504,558,1062,"21 de agosto de 1994"
21,12,115,1577,383,448,831,"21 de agosto de 1994"
21,12,115,1578,604,684,1288,"21 de agosto de 1994"
21,12,115,1579,451,503,954,"21 de agosto de 1994"
21,12,115,1580,435,498,933,"21 de agosto de 1994"
21,12,115,1581,396,437,833,"21 de agosto de 1994"
21,12,115,1582,387,409,796,"21 de agosto de 1994"
21,12,115,1583,497,538,1035,"21 de agosto de 1994"
21,12,115,1584,481,503,984,"21 de agosto de 1994"
21,12,115,1585,395,445,840,"21 de agosto de 1994"
21,12,115,1586,313,354,667,"21 de agosto de 1994"
21,12,115,1587,670,749,1419,"21 de agosto de 1994"
21,12,115,1588,705,746,1451,"21 de agosto de 1994"
21,12,115,1589,673,777,1450,"21 de agosto de 1994"
21,12,115,1590,600,623,1223,"21 de agosto de 1994"
21,12,115,1591,188,245,433,"21 de agosto de 1994"
21,12,115,1592,431,491,922,"21 de agosto de 1994"
21,12,115,1593,602,616,1218,"21 de agosto de 1994"
21,12,115,1594,516,564,1080,"21 de agosto de 1994"
21,12,115,1595,427,441,868,"21 de agosto de 1994"
21,12,115,1596,928,1030,1958,"21 de agosto de 1994"
21,12,115,1597,305,321,626,"21 de agosto de 1994"
21,12,115,1598,191,218,409,"21 de agosto de 1994"
21,12,115,1599,270,271,541,"21 de agosto de 1994"
21,12,115,1600,159,171,330,"21 de agosto de 1994"
21,12,115,1601,276,265,541,"21 de agosto de 1994"
21,12,115,1602,67,76,143,"21 de agosto de 1994"
21,12,115,1603,524,518,1042,"21 de agosto de 1994"
21,12,115,1604,520,493,1013,"21 de agosto de 1994"
21,12,115,1605,416,459,875,"21 de agosto de 1994"
21,12,115,1606,663,709,1372,"21 de agosto de 1994"
21,12,115,1607,445,513,958,"21 de agosto de 1994"
21,12,115,1608,351,357,708,"21 de agosto de 1994"
21,12,115,1609,495,494,989,"21 de agosto de 1994"
21,13,9,79,430,649,1079,"21 de agosto de 1994"
21,13,11,102,291,458,749,"21 de agosto de 1994"
21,13,21,224,263,295,558,"21 de agosto de 1994"
21,13,24,239,142,173,315,"21 de agosto de 1994"
21,13,24,240,97,143,240,"21 de agosto de 1994"
21,13,33,277,252,312,564,"21 de agosto de 1994"
21,13,33,278,114,120,234,"21 de agosto de 1994"
21,13,48,398,522,658,1180,"21 de agosto de 1994"
21,13,48,399,268,321,589,"21 de agosto de 1994"
21,13,48,400,366,486,852,"21 de agosto de 1994"
21,13,48,401,260,281,541,"21 de agosto de 1994"
21,13,48,402,348,412,760,"21 de agosto de 1994"
21,13,48,403,329,404,733,"21 de agosto de 1994"
21,13,48,404,427,494,921,"21 de agosto de 1994"
21,13,48,405,347,349,696,"21 de agosto de 1994"
21,13,48,406,212,261,473,"21 de agosto de 1994"
21,13,48,407,81,104,185,"21 de agosto de 1994"
21,13,48,408,210,216,426,"21 de agosto de 1994"
21,13,48,409,90,105,195,"21 de agosto de 1994"
21,13,48,410,67,66,133,"21 de agosto de 1994"
21,13,48,411,31,30,61,"21 de agosto de 1994"
21,13,48,412,320,336,656,"21 de agosto de 1994"
21,13,48,413,58,69,127,"21 de agosto de 1994"
21,13,48,414,80,85,165,"21 de agosto de 1994"
21,13,52,439,418,515,933,"21 de agosto de 1994"
21,13,52,440,390,464,854,"21 de agosto de 1994"
21,13,52,441,467,580,1047,"21 de agosto de 1994"
21,13,52,442,285,275,560,"21 de agosto de 1994"
21,13,52,443,266,306,572,"21 de agosto de 1994"
21,13,52,444,477,609,1086,"21 de agosto de 1994"
21,13,52,445,323,369,692,"21 de agosto de 1994"
21,13,52,446,406,459,865,"21 de agosto de 1994"
21,13,52,447,550,711,1261,"21 de agosto de 1994"
21,13,52,448,335,394,729,"21 de agosto de 1994"
21,13,52,449,479,548,1027,"21 de agosto de 1994"
21,13,52,450,579,667,1246,"21 de agosto de 1994"
21,13,52,451,252,272,524,"21 de agosto de 1994"
21,13,52,452,550,633,1183,"21 de agosto de 1994"
21,13,52,453,412,519,931,"21 de agosto de 1994"
21,13,52,454,286,324,610,"21 de agosto de 1994"
21,13,52,455,264,266,530,"21 de agosto de 1994"
21,13,52,456,260,299,559,"21 de agosto de 1994"
21,13,52,457,267,277,544,"21 de agosto de 1994"
21,13,52,458,464,538,1002,"21 de agosto de 1994"
21,13,57,500,244,320,564,"21 de agosto de 1994"
21,13,57,501,120,167,287,"21 de agosto de 1994"
21,13,60,512,302,378,680,"21 de agosto de 1994"
21,13,60,513,94,120,214,"21 de agosto de 1994"
21,13,60,514,74,108,182,"21 de agosto de 1994"
21,13,63,524,416,554,970,"21 de agosto de 1994"
21,13,63,525,396,519,915,"21 de agosto de 1994"
21,13,67,551,389,525,914,"21 de agosto de 1994"
21,13,67,552,284,412,696,"21 de agosto de 1994"
21,13,67,553,344,479,823,"21 de agosto de 1994"
21,13,67,554,282,416,698,"21 de agosto de 1994"
21,13,74,640,540,629,1169,"21 de agosto de 1994"
21,13,74,641,523,650,1173,"21 de agosto de 1994"
21,13,74,642,328,354,682,"21 de agosto de 1994"
21,13,74,643,336,388,724,"21 de agosto de 1994"
21,13,74,644,73,78,151,"21 de agosto de 1994"
21,13,74,645,108,160,268,"21 de agosto de 1994"
21,13,83,706,341,443,784,"21 de agosto de 1994"
21,13,83,707,269,297,566,"21 de agosto de 1994"
21,13,83,708,215,268,483,"21 de agosto de 1994"
21,13,87,730,323,373,696,"21 de agosto de 1994"
21,13,87,731,343,450,793,"21 de agosto de 1994"
21,13,87,732,458,527,985,"21 de agosto de 1994"
21,13,87,733,372,470,842,"21 de agosto de 1994"
21,13,87,734,440,541,981,"21 de agosto de 1994"
21,13,87,735,480,577,1057,"21 de agosto de 1994"
21,13,87,736,448,555,1003,"21 de agosto de 1994"
21,13,87,737,505,623,1128,"21 de agosto de 1994"
21,13,87,738,313,355,668,"21 de agosto de 1994"
21,13,87,739,376,478,854,"21 de agosto de 1994"
21,13,87,740,469,564,1033,"21 de agosto de 1994"
21,13,87,741,382,443,825,"21 de agosto de 1994"
21,13,87,742,388,472,860,"21 de agosto de 1994"
21,13,87,743,418,507,925,"21 de agosto de 1994"
21,13,87,744,349,405,754,"21 de agosto de 1994"
21,13,87,745,580,664,1244,"21 de agosto de 1994"
21,13,87,746,497,577,1074,"21 de agosto de 1994"
21,13,87,747,255,341,596,"21 de agosto de 1994"
21,13,87,748,377,471,848,"21 de agosto de 1994"
21,13,87,749,437,499,936,"21 de agosto de 1994"
21,13,87,750,227,282,509,"21 de agosto de 1994"
21,13,87,751,310,423,733,"21 de agosto de 1994"
21,13,87,752,481,628,1109,"21 de agosto de 1994"
21,13,87,753,476,616,1092,"21 de agosto de 1994"
21,13,87,754,354,497,851,"21 de agosto de 1994"
21,13,87,755,304,412,716,"21 de agosto de 1994"
21,13,87,756,342,444,786,"21 de agosto de 1994"
21,13,87,757,246,354,600,"21 de agosto de 1994"
21,13,87,758,534,739,1273,"21 de agosto de 1994"
21,13,87,759,344,485,829,"21 de agosto de 1994"
21,13,87,760,300,376,676,"21 de agosto de 1994"
21,13,87,761,251,334,585,"21 de agosto de 1994"
21,13,87,762,436,598,1034,"21 de agosto de 1994"
21,13,87,763,279,383,662,"21 de agosto de 1994"
21,13,89,770,569,587,1156,"21 de agosto de 1994"
21,13,89,771,495,577,1072,"21 de agosto de 1994"
21,13,89,772,317,319,636,"21 de agosto de 1994"
21,13,89,773,492,504,996,"21 de agosto de 1994"
21,13,89,774,242,298,540,"21 de agosto de 1994"
21,13,89,775,197,189,386,"21 de agosto de 1994"
21,13,114,928,481,575,1056,"21 de agosto de 1994"
21,13,114,929,155,167,322,"21 de agosto de 1994"
21,13,114,930,63,71,134,"21 de agosto de 1994"
21,13,114,931,88,129,217,"21 de agosto de 1994"
21,13,114,932,289,416,705,"21 de agosto de 1994"
21,13,122,1674,136,139,275,"21 de agosto de 1994"
21,13,122,1675,69,56,125,"21 de agosto de 1994"
21,13,122,1676,42,60,102,"21 de agosto de 1994"
21,13,134,1774,127,166,293,"21 de agosto de 1994"
21,13,140,1798,591,668,1259,"21 de agosto de 1994"
21,13,140,1799,181,231,412,"21 de agosto de 1994"
21,13,154,1929,258,371,629,"21 de agosto de 1994"
21,13,154,1930,264,274,538,"21 de agosto de 1994"
21,13,154,1931,216,309,525,"21 de agosto de 1994"
21,13,154,1932,55,75,130,"21 de agosto de 1994"
21,13,154,1933,269,332,601,"21 de agosto de 1994"
21,13,156,2017,453,585,1038,"21 de agosto de 1994"
21,13,156,2018,447,587,1034,"21 de agosto de 1994"
21,13,156,2019,444,538,982,"21 de agosto de 1994"
21,13,156,2020,302,376,678,"21 de agosto de 1994"
21,13,156,2021,258,347,605,"21 de agosto de 1994"
21,13,156,2022,236,312,548,"21 de agosto de 1994"
21,13,156,2023,362,470,832,"21 de agosto de 1994"
21,13,156,2024,132,189,321,"21 de agosto de 1994"
21,13,159,2038,309,317,626,"21 de agosto de 1994"
21,13,159,2039,165,178,343,"21 de agosto de 1994"
21,13,159,2040,142,180,322,"21 de agosto de 1994"
21,13,159,2041,54,63,117,"21 de agosto de 1994"
21,13,165,2083,268,365,633,"21 de agosto de 1994"
21,13,165,2084,352,401,753,"21 de agosto de 1994"
21,13,165,2085,406,555,961,"21 de agosto de 1994"
21,13,165,2086,178,253,431,"21 de agosto de 1994"
21,13,165,2087,258,438,696,"21 de agosto de 1994"
21,13,165,2088,97,119,216,"21 de agosto de 1994"
21,13,167,2095,341,386,727,"21 de agosto de 1994"
21,13,167,2096,368,425,793,"21 de agosto de 1994"
21,13,167,2097,389,443,832,"21 de agosto de 1994"
21,13,175,2181,617,714,1331,"21 de agosto de 1994"
21,13,175,2182,479,522,1001,"21 de agosto de 1994"
21,13,175,2183,510,621,1131,"21 de agosto de 1994"
21,13,185,2267,363,467,830,"21 de agosto de 1994"
21,13,185,2268,241,302,543,"21 de agosto de 1994"
21,13,185,2269,313,411,724,"21 de agosto de 1994"
21,13,185,2270,356,464,820,"21 de agosto de 1994"
21,13,185,2271,271,287,558,"21 de agosto de 1994"
21,13,191,2319,235,307,542,"21 de agosto de 1994"
21,13,191,2320,235,304,539,"21 de agosto de 1994"
21,13,191,2321,437,533,970,"21 de agosto de 1994"
21,13,191,2322,203,274,477,"21 de agosto de 1994"
21,13,191,2323,125,161,286,"21 de agosto de 1994"
21,13,191,2324,228,326,554,"21 de agosto de 1994"
21,13,191,2325,105,158,263,"21 de agosto de 1994"
21,13,198,2391,143,185,328,"21 de agosto de 1994"
21,13,198,2392,120,143,263,"21 de agosto de 1994"
21,13,201,2407,403,525,928,"21 de agosto de 1994"
21,13,201,2408,163,215,378,"21 de agosto de 1994"
21,14,1,1,476,492,968,"21 de agosto de 1994"
21,14,1,2,486,487,973,"21 de agosto de 1994"
21,14,1,3,413,436,849,"21 de agosto de 1994"
21,14,1,4,481,525,1006,"21 de agosto de 1994"
21,14,1,5,582,630,1212,"21 de agosto de 1994"
21,14,1,6,424,427,851,"21 de agosto de 1994"
21,14,1,7,527,524,1051,"21 de agosto de 1994"
21,14,1,8,529,576,1105,"21 de agosto de 1994"
21,14,1,9,459,452,911,"21 de agosto de 1994"
21,14,1,10,600,677,1277,"21 de agosto de 1994"
21,14,1,11,532,626,1158,"21 de agosto de 1994"
21,14,1,12,415,505,920,"21 de agosto de 1994"
21,14,1,13,330,425,755,"21 de agosto de 1994"
21,14,1,14,430,443,873,"21 de agosto de 1994"
21,14,1,15,700,803,1503,"21 de agosto de 1994"
21,14,1,16,667,789,1456,"21 de agosto de 1994"
21,14,1,17,632,783,1415,"21 de agosto de 1994"
21,14,1,18,512,605,1117,"21 de agosto de 1994"
21,14,1,19,366,474,840,"21 de agosto de 1994"
21,14,4,45,548,583,1131,"21 de agosto de 1994"
21,14,4,46,728,631,1359,"21 de agosto de 1994"
21,14,4,47,505,507,1012,"21 de agosto de 1994"
21,14,4,48,311,288,599,"21 de agosto de 1994"
21,14,4,49,449,495,944,"21 de agosto de 1994"
21,14,4,50,520,456,976,"21 de agosto de 1994"
21,14,4,51,479,482,961,"21 de agosto de 1994"
21,14,4,52,565,640,1205,"21 de agosto de 1994"
21,14,4,53,433,407,840,"21 de agosto de 1994"
21,14,4,54,266,242,508,"21 de agosto de 1994"
21,14,4,55,454,461,915,"21 de agosto de 1994"
21,14,4,56,125,113,238,"21 de agosto de 1994"
21,14,4,57,594,568,1162,"21 de agosto de 1994"
21,14,4,58,469,407,876,"21 de agosto de 1994"
21,14,4,59,422,397,819,"21 de agosto de 1994"
21,14,4,60,462,457,919,"21 de agosto de 1994"
21,14,15,116,652,651,1303,"21 de agosto de 1994"
21,14,15,117,431,421,852,"21 de agosto de 1994"
21,14,15,118,504,495,999,"21 de agosto de 1994"
21,14,15,119,497,498,995,"21 de agosto de 1994"
21,14,15,120,472,450,922,"21 de agosto de 1994"
21,14,15,121,455,450,905,"21 de agosto de 1994"
21,14,15,122,554,541,1095,"21 de agosto de 1994"
21,14,15,123,306,317,623,"21 de agosto de 1994"
21,14,15,124,335,389,724,"21 de agosto de 1994"
21,14,15,125,550,594,1144,"21 de agosto de 1994"
21,14,15,126,428,474,902,"21 de agosto de 1994"
21,14,15,127,663,681,1344,"21 de agosto de 1994"
21,14,15,128,365,445,810,"21 de agosto de 1994"
21,14,15,129,771,848,1619,"21 de agosto de 1994"
21,14,15,130,419,426,845,"21 de agosto de 1994"
21,14,15,131,559,571,1130,"21 de agosto de 1994"
21,14,15,132,517,500,1017,"21 de agosto de 1994"
21,14,15,133,299,299,598,"21 de agosto de 1994"
21,14,20,222,485,503,988,"21 de agosto de 1994"
21,14,20,223,699,599,1298,"21 de agosto de 1994"
21,14,39,317,668,675,1343,"21 de agosto de 1994"
21,14,39,318,496,495,991,"21 de agosto de 1994"
21,14,41,323,656,635,1291,"21 de agosto de 1994"
21,14,41,324,618,659,1277,"21 de agosto de 1994"
21,14,75,646,286,316,602,"21 de agosto de 1994"
21,14,75,647,409,390,799,"21 de agosto de 1994"
21,14,75,648,353,339,692,"21 de agosto de 1994"
21,14,75,649,156,175,331,"21 de agosto de 1994"
21,14,75,650,113,136,249,"21 de agosto de 1994"
21,14,81,701,369,383,752,"21 de agosto de 1994"
21,14,81,702,356,389,745,"21 de agosto de 1994"
21,14,81,703,286,298,584,"21 de agosto de 1994"
21,14,97,820,107,112,219,"21 de agosto de 1994"
21,14,99,823,257,313,570,"21 de agosto de 1994"
21,14,99,824,131,160,291,"21 de agosto de 1994"
21,14,105,846,475,493,968,"21 de agosto de 1994"
21,14,105,847,617,685,1302,"21 de agosto de 1994"
21,14,105,848,414,464,878,"21 de agosto de 1994"
21,14,105,849,44,38,82,"21 de agosto de 1994"
21,14,105,850,510,503,1013,"21 de agosto de 1994"
21,14,105,851,509,504,1013,"21 de agosto de 1994"
21,14,105,852,768,717,1485,"21 de agosto de 1994"
21,14,105,853,226,181,407,"21 de agosto de 1994"
21,14,118,1636,455,503,958,"21 de agosto de 1994"
21,14,118,1637,398,445,843,"21 de agosto de 1994"
21,14,118,1638,396,469,865,"21 de agosto de 1994"
21,14,118,1639,328,353,681,"21 de agosto de 1994"
21,14,118,1640,270,286,556,"21 de agosto de 1994"
21,14,118,1641,535,592,1127,"21 de agosto de 1994"
21,14,118,1642,529,514,1043,"21 de agosto de 1994"
21,14,119,1643,347,357,704,"21 de agosto de 1994"
21,14,119,1644,466,461,927,"21 de agosto de 1994"
21,14,119,1645,481,464,945,"21 de agosto de 1994"
21,14,119,1646,531,507,1038,"21 de agosto de 1994"
21,14,119,1647,149,141,290,"21 de agosto de 1994"
21,14,119,1648,587,536,1123,"21 de agosto de 1994"
21,14,119,1649,551,521,1072,"21 de agosto de 1994"
21,14,119,1650,642,673,1315,"21 de agosto de 1994"
21,14,129,1702,210,220,430,"21 de agosto de 1994"
21,14,129,1703,221,234,455,"21 de agosto de 1994"
21,14,129,1704,266,251,517,"21 de agosto de 1994"
21,14,129,1705,164,151,315,"21 de agosto de 1994"
21,14,129,1706,319,308,627,"21 de agosto de 1994"
21,14,129,1707,169,151,320,"21 de agosto de 1994"
21,14,132,1719,158,152,310,"21 de agosto de 1994"
21,14,145,1868,460,426,886,"21 de agosto de 1994"
21,14,145,1869,480,428,908,"21 de agosto de 1994"
21,14,145,1870,539,516,1055,"21 de agosto de 1994"
21,14,145,1871,424,389,813,"21 de agosto de 1994"
21,14,150,1888,363,405,768,"21 de agosto de 1994"
21,14,150,1889,469,498,967,"21 de agosto de 1994"
21,14,150,1890,484,539,1023,"21 de agosto de 1994"
21,14,151,1891,198,197,395,"21 de agosto de 1994"
21,14,151,1892,615,670,1285,"21 de agosto de 1994"
21,14,151,1893,374,383,757,"21 de agosto de 1994"
21,14,151,1894,429,426,855,"21 de agosto de 1994"
21,14,151,1895,412,356,768,"21 de agosto de 1994"
21,14,151,1896,465,427,892,"21 de agosto de 1994"
21,14,152,1897,555,575,1130,"21 de agosto de 1994"
21,14,152,1898,561,585,1146,"21 de agosto de 1994"
21,14,152,1899,218,193,411,"21 de agosto de 1994"
21,14,152,1900,271,308,579,"21 de agosto de 1994"
21,14,152,1901,404,402,806,"21 de agosto de 1994"
21,14,152,1902,310,356,666,"21 de agosto de 1994"
21,14,152,1903,453,434,887,"21 de agosto de 1994"
21,14,152,1904,358,355,713,"21 de agosto de 1994"
21,14,152,1905,428,461,889,"21 de agosto de 1994"
21,14,153,1906,457,471,928,"21 de agosto de 1994"
21,14,153,1907,461,499,960,"21 de agosto de 1994"
21,14,153,1908,496,580,1076,"21 de agosto de 1994"
21,14,153,1909,454,541,995,"21 de agosto de 1994"
21,14,153,1910,691,756,1447,"21 de agosto de 1994"
21,14,153,1911,651,731,1382,"21 de agosto de 1994"
21,14,153,1912,690,713,1403,"21 de agosto de 1994"
21,14,153,1913,471,509,980,"21 de agosto de 1994"
21,14,153,1914,498,502,1000,"21 de agosto de 1994"
21,14,153,1915,360,360,720,"21 de agosto de 1994"
21,14,153,1916,444,446,890,"21 de agosto de 1994"
21,14,153,1917,346,347,693,"21 de agosto de 1994"
21,14,153,1918,344,374,718,"21 de agosto de 1994"
21,14,153,1919,699,748,1447,"21 de agosto de 1994"
21,14,153,1920,649,642,1291,"21 de agosto de 1994"
21,14,153,1921,317,283,600,"21 de agosto de 1994"
21,14,153,1922,294,302,596,"21 de agosto de 1994"
21,14,153,1923,195,179,374,"21 de agosto de 1994"
21,14,153,1924,244,224,468,"21 de agosto de 1994"
21,14,153,1925,755,766,1521,"21 de agosto de 1994"
21,14,153,1926,650,619,1269,"21 de agosto de 1994"
21,14,153,1927,437,447,884,"21 de agosto de 1994"
21,14,153,1928,425,396,821,"21 de agosto de 1994"
21,14,158,2033,460,646,1106,"21 de agosto de 1994"
21,14,158,2034,342,544,886,"21 de agosto de 1994"
21,14,158,2035,176,164,340,"21 de agosto de 1994"
21,14,158,2036,79,100,179,"21 de agosto de 1994"
21,14,158,2037,98,118,216,"21 de agosto de 1994"
21,14,162,2051,441,522,963,"21 de agosto de 1994"
21,14,162,2052,333,438,771,"21 de agosto de 1994"
21,14,162,2053,392,454,846,"21 de agosto de 1994"
21,14,162,2054,410,514,924,"21 de agosto de 1994"
21,14,162,2055,545,657,1202,"21 de agosto de 1994"
21,14,162,2056,329,388,717,"21 de agosto de 1994"
21,14,162,2057,285,338,623,"21 de agosto de 1994"
21,14,163,2058,239,269,508,"21 de agosto de 1994"
21,14,163,2059,659,680,1339,"21 de agosto de 1994"
21,14,163,2060,456,544,1000,"21 de agosto de 1994"
21,14,163,2061,384,463,847,"21 de agosto de 1994"
21,14,163,2062,576,620,1196,"21 de agosto de 1994"
21,14,163,2063,407,435,842,"21 de agosto de 1994"
21,14,163,2064,562,648,1210,"21 de agosto de 1994"
21,14,163,2065,571,632,1203,"21 de agosto de 1994"
21,14,163,2066,619,672,1291,"21 de agosto de 1994"
21,14,163,2067,441,481,922,"21 de agosto de 1994"
21,14,163,2068,646,594,1240,"21 de agosto de 1994"
21,14,163,2069,353,398,751,"21 de agosto de 1994"
21,14,163,2070,454,583,1037,"21 de agosto de 1994"
21,14,163,2071,414,359,773,"21 de agosto de 1994"
21,14,163,2072,578,635,1213,"21 de agosto de 1994"
21,14,163,2073,474,503,977,"21 de agosto de 1994"
21,14,163,2074,460,508,968,"21 de agosto de 1994"
21,14,163,2075,672,690,1362,"21 de agosto de 1994"
21,14,163,2076,503,554,1057,"21 de agosto de 1994"
21,14,163,2077,453,488,941,"21 de agosto de 1994"
21,14,163,2078,324,384,708,"21 de agosto de 1994"
21,14,163,2079,294,277,571,"21 de agosto de 1994"
21,14,163,2080,603,565,1168,"21 de agosto de 1994"
21,14,163,2081,507,497,1004,"21 de agosto de 1994"
21,14,170,2116,640,642,1282,"21 de agosto de 1994"
21,14,182,2251,394,409,803,"21 de agosto de 1994"
21,14,182,2252,326,398,724,"21 de agosto de 1994"
21,14,189,2310,723,753,1476,"21 de agosto de 1994"
21,14,189,2311,630,636,1266,"21 de agosto de 1994"
21,14,189,2312,510,504,1014,"21 de agosto de 1994"
21,14,189,2313,470,522,992,"21 de agosto de 1994"
21,14,189,2314,395,393,788,"21 de agosto de 1994"
21,14,189,2315,314,323,637,"21 de agosto de 1994"
21,14,189,2316,389,351,740,"21 de agosto de 1994"
21,14,193,2329,286,304,590,"21 de agosto de 1994"
21,14,193,2330,334,290,624,"21 de agosto de 1994"
21,14,193,2331,278,352,630,"21 de agosto de 1994"
21,14,193,2332,336,280,616,"21 de agosto de 1994"
22,1,14,266,731,743,1474,"21 de agosto de 1994"
22,1,14,267,489,482,971,"21 de agosto de 1994"
22,1,14,268,438,496,934,"21 de agosto de 1994"
22,1,14,269,478,481,959,"21 de agosto de 1994"
22,1,14,270,576,592,1168,"21 de agosto de 1994"
22,1,14,271,1216,1410,2626,"21 de agosto de 1994"
22,1,14,272,471,495,966,"21 de agosto de 1994"
22,1,14,273,627,695,1322,"21 de agosto de 1994"
22,1,14,274,600,633,1233,"21 de agosto de 1994"
22,1,14,275,406,492,898,"21 de agosto de 1994"
22,1,14,276,499,544,1043,"21 de agosto de 1994"
22,1,14,277,443,458,901,"21 de agosto de 1994"
22,1,14,278,422,451,873,"21 de agosto de 1994"
22,1,14,279,256,306,562,"21 de agosto de 1994"
22,1,14,280,533,526,1059,"21 de agosto de 1994"
22,1,14,281,587,567,1154,"21 de agosto de 1994"
22,1,14,282,511,560,1071,"21 de agosto de 1994"
22,1,14,283,428,453,881,"21 de agosto de 1994"
22,1,14,284,407,484,891,"21 de agosto de 1994"
22,1,14,285,491,518,1009,"21 de agosto de 1994"
22,1,14,286,345,400,745,"21 de agosto de 1994"
22,1,14,287,459,520,979,"21 de agosto de 1994"
22,1,14,288,490,530,1020,"21 de agosto de 1994"
22,1,14,289,437,472,909,"21 de agosto de 1994"
22,1,14,290,373,400,773,"21 de agosto de 1994"
22,1,14,291,364,442,806,"21 de agosto de 1994"
22,1,14,292,506,465,971,"21 de agosto de 1994"
22,1,14,293,395,400,795,"21 de agosto de 1994"
22,1,14,294,358,360,718,"21 de agosto de 1994"
22,1,14,295,424,437,861,"21 de agosto de 1994"
22,1,14,296,397,421,818,"21 de agosto de 1994"
22,1,14,297,507,546,1053,"21 de agosto de 1994"
22,1,14,298,380,425,805,"21 de agosto de 1994"
22,1,14,299,421,457,878,"21 de agosto de 1994"
22,1,14,300,384,414,798,"21 de agosto de 1994"
22,1,14,301,417,434,851,"21 de agosto de 1994"
22,1,14,302,446,519,965,"21 de agosto de 1994"
22,1,14,303,476,491,967,"21 de agosto de 1994"
22,1,14,304,513,577,1090,"21 de agosto de 1994"
22,1,14,305,375,389,764,"21 de agosto de 1994"
22,1,14,306,377,435,812,"21 de agosto de 1994"
22,1,14,307,337,370,707,"21 de agosto de 1994"
22,1,14,308,403,431,834,"21 de agosto de 1994"
22,1,14,309,360,400,760,"21 de agosto de 1994"
22,1,14,310,366,425,791,"21 de agosto de 1994"
22,1,14,311,328,359,687,"21 de agosto de 1994"
22,1,14,312,367,419,786,"21 de agosto de 1994"
22,1,14,313,364,445,809,"21 de agosto de 1994"
22,1,14,314,375,434,809,"21 de agosto de 1994"
22,1,14,315,302,355,657,"21 de agosto de 1994"
22,1,14,316,457,514,971,"21 de agosto de 1994"
22,1,14,317,318,345,663,"21 de agosto de 1994"
22,1,14,318,542,636,1178,"21 de agosto de 1994"
22,1,14,319,822,962,1784,"21 de agosto de 1994"
22,1,14,320,558,617,1175,"21 de agosto de 1994"
22,1,14,321,274,316,590,"21 de agosto de 1994"
22,1,14,322,317,358,675,"21 de agosto de 1994"
22,1,14,323,465,511,976,"21 de agosto de 1994"
22,1,14,324,470,496,966,"21 de agosto de 1994"
22,1,14,325,506,566,1072,"21 de agosto de 1994"
22,1,14,326,654,655,1309,"21 de agosto de 1994"
22,1,14,327,212,215,427,"21 de agosto de 1994"
22,1,14,328,562,660,1222,"21 de agosto de 1994"
22,1,14,329,717,793,1510,"21 de agosto de 1994"
22,1,14,330,393,453,846,"21 de agosto de 1994"
22,1,14,331,625,652,1277,"21 de agosto de 1994"
22,1,14,332,534,609,1143,"21 de agosto de 1994"
22,1,14,333,371,450,821,"21 de agosto de 1994"
22,1,14,334,435,486,921,"21 de agosto de 1994"
22,1,14,335,462,532,994,"21 de agosto de 1994"
22,1,14,336,491,552,1043,"21 de agosto de 1994"
22,1,14,337,401,406,807,"21 de agosto de 1994"
22,1,14,338,649,776,1425,"21 de agosto de 1994"
22,1,14,339,347,387,734,"21 de agosto de 1994"
22,1,14,340,631,650,1281,"21 de agosto de 1994"
22,1,14,341,399,448,847,"21 de agosto de 1994"
22,1,14,342,285,358,643,"21 de agosto de 1994"
22,1,14,343,336,387,723,"21 de agosto de 1994"
22,1,14,344,987,1152,2139,"21 de agosto de 1994"
22,1,14,345,611,655,1266,"21 de agosto de 1994"
22,1,14,346,581,606,1187,"21 de agosto de 1994"
22,1,14,347,445,477,922,"21 de agosto de 1994"
22,1,14,348,552,539,1091,"21 de agosto de 1994"
22,1,14,349,412,469,881,"21 de agosto de 1994"
22,1,14,350,464,587,1051,"21 de agosto de 1994"
22,1,14,351,475,508,983,"21 de agosto de 1994"
22,1,14,352,328,366,694,"21 de agosto de 1994"
22,1,14,353,411,451,862,"21 de agosto de 1994"
22,1,14,354,475,579,1054,"21 de agosto de 1994"
22,1,14,355,508,580,1088,"21 de agosto de 1994"
22,1,14,356,585,679,1264,"21 de agosto de 1994"
22,1,14,357,513,580,1093,"21 de agosto de 1994"
22,1,14,358,314,349,663,"21 de agosto de 1994"
22,1,14,359,441,547,988,"21 de agosto de 1994"
22,1,14,360,648,724,1372,"21 de agosto de 1994"
22,1,14,361,433,487,920,"21 de agosto de 1994"
22,1,14,362,452,504,956,"21 de agosto de 1994"
22,1,14,363,547,577,1124,"21 de agosto de 1994"
22,1,14,364,452,445,897,"21 de agosto de 1994"
22,1,14,365,413,440,853,"21 de agosto de 1994"
22,1,14,366,292,321,613,"21 de agosto de 1994"
22,1,14,367,309,362,671,"21 de agosto de 1994"
22,1,14,368,575,574,1149,"21 de agosto de 1994"
22,1,14,369,344,375,719,"21 de agosto de 1994"
22,1,14,370,305,375,680,"21 de agosto de 1994"
22,1,14,371,344,350,694,"21 de agosto de 1994"
22,1,14,372,503,580,1083,"21 de agosto de 1994"
22,1,14,373,501,503,1004,"21 de agosto de 1994"
22,1,14,374,371,416,787,"21 de agosto de 1994"
22,1,14,375,498,552,1050,"21 de agosto de 1994"
22,1,14,376,537,531,1068,"21 de agosto de 1994"
22,1,14,377,544,606,1150,"21 de agosto de 1994"
22,1,14,378,331,373,704,"21 de agosto de 1994"
22,1,14,379,386,442,828,"21 de agosto de 1994"
22,1,14,380,590,651,1241,"21 de agosto de 1994"
22,1,14,381,400,445,845,"21 de agosto de 1994"
22,1,14,382,560,646,1206,"21 de agosto de 1994"
22,1,14,383,358,394,752,"21 de agosto de 1994"
22,1,14,384,308,358,666,"21 de agosto de 1994"
22,1,14,385,245,344,589,"21 de agosto de 1994"
22,1,14,386,559,526,1085,"21 de agosto de 1994"
22,1,14,387,461,458,919,"21 de agosto de 1994"
22,1,14,388,518,533,1051,"21 de agosto de 1994"
22,1,14,389,481,479,960,"21 de agosto de 1994"
22,1,14,390,241,333,574,"21 de agosto de 1994"
22,1,14,391,268,278,546,"21 de agosto de 1994"
22,1,14,392,469,510,979,"21 de agosto de 1994"
22,1,14,393,680,737,1417,"21 de agosto de 1994"
22,1,14,394,464,514,978,"21 de agosto de 1994"
22,1,14,395,461,487,948,"21 de agosto de 1994"
22,1,14,396,459,525,984,"21 de agosto de 1994"
22,1,14,397,302,358,660,"21 de agosto de 1994"
22,1,14,398,277,312,589,"21 de agosto de 1994"
22,1,14,399,436,510,946,"21 de agosto de 1994"
22,1,14,400,263,294,557,"21 de agosto de 1994"
22,1,14,401,406,462,868,"21 de agosto de 1994"
22,1,14,402,403,466,869,"21 de agosto de 1994"
22,1,14,403,430,488,918,"21 de agosto de 1994"
22,1,14,404,364,443,807,"21 de agosto de 1994"
22,1,14,405,340,432,772,"21 de agosto de 1994"
22,1,14,406,331,384,715,"21 de agosto de 1994"
22,1,14,407,587,634,1221,"21 de agosto de 1994"
22,1,14,408,471,511,982,"21 de agosto de 1994"
22,1,14,409,207,238,445,"21 de agosto de 1994"
22,1,14,410,436,670,1106,"21 de agosto de 1994"
22,1,14,411,249,301,550,"21 de agosto de 1994"
22,1,14,412,276,348,624,"21 de agosto de 1994"
22,1,14,413,351,431,782,"21 de agosto de 1994"
22,1,14,414,342,401,743,"21 de agosto de 1994"
22,1,14,415,365,429,794,"21 de agosto de 1994"
22,1,14,416,1004,663,1667,"21 de agosto de 1994"
22,1,14,417,362,409,771,"21 de agosto de 1994"
22,1,14,418,397,466,863,"21 de agosto de 1994"
22,1,14,419,253,355,608,"21 de agosto de 1994"
22,1,14,420,437,506,943,"21 de agosto de 1994"
22,1,14,421,505,554,1059,"21 de agosto de 1994"
22,1,14,422,387,446,833,"21 de agosto de 1994"
22,1,14,423,296,366,662,"21 de agosto de 1994"
22,1,14,424,313,410,723,"21 de agosto de 1994"
22,1,14,425,383,556,939,"21 de agosto de 1994"
22,1,14,426,475,604,1079,"21 de agosto de 1994"
22,1,14,427,300,332,632,"21 de agosto de 1994"
22,1,14,428,418,472,890,"21 de agosto de 1994"
22,1,14,429,358,436,794,"21 de agosto de 1994"
22,1,14,430,496,591,1087,"21 de agosto de 1994"
22,1,14,431,285,359,644,"21 de agosto de 1994"
22,1,14,432,260,319,579,"21 de agosto de 1994"
22,1,14,433,301,346,647,"21 de agosto de 1994"
22,1,14,434,406,441,847,"21 de agosto de 1994"
22,1,14,435,467,564,1031,"21 de agosto de 1994"
22,1,14,436,345,422,767,"21 de agosto de 1994"
22,1,14,437,455,539,994,"21 de agosto de 1994"
22,1,14,438,333,423,756,"21 de agosto de 1994"
22,1,14,439,423,508,931,"21 de agosto de 1994"
22,1,14,440,505,603,1108,"21 de agosto de 1994"
22,1,14,441,203,245,448,"21 de agosto de 1994"
22,1,14,442,444,522,966,"21 de agosto de 1994"
22,1,14,443,387,421,808,"21 de agosto de 1994"
22,1,14,444,695,753,1448,"21 de agosto de 1994"
22,1,14,445,580,654,1234,"21 de agosto de 1994"
22,1,14,446,369,465,834,"21 de agosto de 1994"
22,1,14,447,201,223,424,"21 de agosto de 1994"
22,1,14,448,385,431,816,"21 de agosto de 1994"
22,1,14,449,372,411,783,"21 de agosto de 1994"
22,1,14,450,319,359,678,"21 de agosto de 1994"
22,1,14,451,300,337,637,"21 de agosto de 1994"
22,1,14,452,474,561,1035,"21 de agosto de 1994"
22,1,14,453,403,486,889,"21 de agosto de 1994"
22,1,14,454,492,611,1103,"21 de agosto de 1994"
22,1,14,455,439,461,900,"21 de agosto de 1994"
22,1,14,456,396,479,875,"21 de agosto de 1994"
22,1,14,457,395,466,861,"21 de agosto de 1994"
22,1,14,458,478,580,1058,"21 de agosto de 1994"
22,1,14,459,310,334,644,"21 de agosto de 1994"
22,1,14,460,450,504,954,"21 de agosto de 1994"
22,1,14,461,519,535,1054,"21 de agosto de 1994"
22,1,14,462,441,493,934,"21 de agosto de 1994"
22,1,14,463,477,523,1000,"21 de agosto de 1994"
22,1,14,464,496,535,1031,"21 de agosto de 1994"
22,1,14,465,415,442,857,"21 de agosto de 1994"
22,1,14,466,453,506,959,"21 de agosto de 1994"
22,1,14,467,410,454,864,"21 de agosto de 1994"
22,1,14,468,427,495,922,"21 de agosto de 1994"
22,1,14,469,362,375,737,"21 de agosto de 1994"
22,1,14,470,368,421,789,"21 de agosto de 1994"
22,1,14,471,370,462,832,"21 de agosto de 1994"
22,1,14,472,547,607,1154,"21 de agosto de 1994"
22,1,14,473,426,492,918,"21 de agosto de 1994"
22,1,14,474,327,393,720,"21 de agosto de 1994"
22,1,14,475,967,1100,2067,"21 de agosto de 1994"
22,1,14,476,451,529,980,"21 de agosto de 1994"
22,1,14,477,548,596,1144,"21 de agosto de 1994"
22,1,14,478,489,560,1049,"21 de agosto de 1994"
22,1,14,479,544,641,1185,"21 de agosto de 1994"
22,1,14,480,427,531,958,"21 de agosto de 1994"
22,1,14,481,512,602,1114,"21 de agosto de 1994"
22,1,14,482,374,407,781,"21 de agosto de 1994"
22,1,14,483,189,207,396,"21 de agosto de 1994"
22,1,14,484,429,454,883,"21 de agosto de 1994"
22,1,14,485,262,281,543,"21 de agosto de 1994"
22,1,14,486,556,592,1148,"21 de agosto de 1994"
22,1,14,487,564,612,1176,"21 de agosto de 1994"
22,1,14,488,811,863,1674,"21 de agosto de 1994"
22,1,14,489,527,571,1098,"21 de agosto de 1994"
22,1,14,490,480,474,954,"21 de agosto de 1994"
22,1,14,491,593,671,1264,"21 de agosto de 1994"
22,1,14,492,406,454,860,"21 de agosto de 1994"
22,1,14,493,512,602,1114,"21 de agosto de 1994"
22,1,14,494,501,568,1069,"21 de agosto de 1994"
22,1,14,495,541,641,1182,"21 de agosto de 1994"
22,1,14,496,595,649,1244,"21 de agosto de 1994"
22,1,14,497,576,618,1194,"21 de agosto de 1994"
22,1,14,498,563,623,1186,"21 de agosto de 1994"
22,1,14,499,506,538,1044,"21 de agosto de 1994"
22,1,14,500,493,526,1019,"21 de agosto de 1994"
22,1,14,501,441,462,903,"21 de agosto de 1994"
22,1,14,502,429,523,952,"21 de agosto de 1994"
22,1,14,503,382,485,867,"21 de agosto de 1994"
22,1,14,504,496,483,979,"21 de agosto de 1994"
22,1,14,505,527,596,1123,"21 de agosto de 1994"
22,1,14,506,366,442,808,"21 de agosto de 1994"
22,1,14,507,354,433,787,"21 de agosto de 1994"
22,1,14,508,457,524,981,"21 de agosto de 1994"
22,1,14,509,437,517,954,"21 de agosto de 1994"
22,1,14,510,502,556,1058,"21 de agosto de 1994"
22,1,14,511,438,497,935,"21 de agosto de 1994"
22,1,14,512,397,431,828,"21 de agosto de 1994"
22,1,14,513,438,525,963,"21 de agosto de 1994"
22,1,14,514,375,447,822,"21 de agosto de 1994"
22,1,14,515,391,469,860,"21 de agosto de 1994"
22,1,14,516,365,343,708,"21 de agosto de 1994"
22,1,14,517,566,581,1147,"21 de agosto de 1994"
22,1,14,518,658,642,1300,"21 de agosto de 1994"
22,1,14,519,544,540,1084,"21 de agosto de 1994"
22,1,14,520,320,279,599,"21 de agosto de 1994"
22,1,14,521,261,252,513,"21 de agosto de 1994"
22,1,14,522,794,802,1596,"21 de agosto de 1994"
22,1,14,523,327,301,628,"21 de agosto de 1994"
22,1,14,524,436,463,899,"21 de agosto de 1994"
22,1,14,525,423,397,820,"21 de agosto de 1994"
22,1,14,526,376,383,759,"21 de agosto de 1994"
22,1,14,527,944,968,1912,"21 de agosto de 1994"
22,1,14,528,321,362,683,"21 de agosto de 1994"
22,1,14,529,723,760,1483,"21 de agosto de 1994"
22,1,14,530,300,312,612,"21 de agosto de 1994"
22,1,14,531,322,347,669,"21 de agosto de 1994"
22,1,14,532,427,517,944,"21 de agosto de 1994"
22,1,14,533,245,265,510,"21 de agosto de 1994"
22,1,14,534,523,562,1085,"21 de agosto de 1994"
22,1,14,535,326,379,705,"21 de agosto de 1994"
22,1,14,536,465,524,989,"21 de agosto de 1994"
22,1,14,537,427,519,946,"21 de agosto de 1994"
22,1,14,538,334,371,705,"21 de agosto de 1994"
22,1,14,539,596,549,1145,"21 de agosto de 1994"
22,1,14,540,443,450,893,"21 de agosto de 1994"
22,1,14,541,262,285,547,"21 de agosto de 1994"
22,1,14,542,464,476,940,"21 de agosto de 1994"
22,1,14,543,300,278,578,"21 de agosto de 1994"
22,1,14,544,384,398,782,"21 de agosto de 1994"
22,1,14,545,370,367,737,"21 de agosto de 1994"
22,1,14,546,549,504,1053,"21 de agosto de 1994"
22,1,14,547,548,541,1089,"21 de agosto de 1994"
22,1,14,548,275,279,554,"21 de agosto de 1994"
22,1,14,549,668,691,1359,"21 de agosto de 1994"
22,1,14,550,388,372,760,"21 de agosto de 1994"
22,1,14,551,542,563,1105,"21 de agosto de 1994"
22,1,14,552,815,865,1680,"21 de agosto de 1994"
22,1,14,553,742,781,1523,"21 de agosto de 1994"
22,1,14,554,425,436,861,"21 de agosto de 1994"
22,1,14,555,221,197,418,"21 de agosto de 1994"
22,2,1,1,364,403,767,"21 de agosto de 1994"
22,2,1,2,308,361,669,"21 de agosto de 1994"
22,2,1,3,362,411,773,"21 de agosto de 1994"
22,2,1,4,384,436,820,"21 de agosto de 1994"
22,2,1,5,309,378,687,"21 de agosto de 1994"
22,2,1,6,259,264,523,"21 de agosto de 1994"
22,2,1,7,153,125,278,"21 de agosto de 1994"
22,2,1,8,334,309,643,"21 de agosto de 1994"
22,2,1,9,379,458,837,"21 de agosto de 1994"
22,2,1,10,295,304,599,"21 de agosto de 1994"
22,2,1,11,222,217,439,"21 de agosto de 1994"
22,2,1,12,229,224,453,"21 de agosto de 1994"
22,2,1,13,503,507,1010,"21 de agosto de 1994"
22,2,1,14,468,462,930,"21 de agosto de 1994"
22,2,1,15,362,350,712,"21 de agosto de 1994"
22,2,1,16,297,280,577,"21 de agosto de 1994"
22,2,1,17,330,297,627,"21 de agosto de 1994"
22,2,1,18,211,185,396,"21 de agosto de 1994"
22,2,1,19,521,498,1019,"21 de agosto de 1994"
22,2,1,20,262,271,533,"21 de agosto de 1994"
22,2,1,21,137,154,291,"21 de agosto de 1994"
22,2,1,22,462,454,916,"21 de agosto de 1994"
22,2,1,23,504,492,996,"21 de agosto de 1994"
22,2,1,24,424,426,850,"21 de agosto de 1994"
22,2,1,25,359,377,736,"21 de agosto de 1994"
22,2,1,26,391,368,759,"21 de agosto de 1994"
22,2,1,27,279,271,550,"21 de agosto de 1994"
22,2,1,28,271,271,542,"21 de agosto de 1994"
22,2,1,29,259,275,534,"21 de agosto de 1994"
22,2,1,30,364,397,761,"21 de agosto de 1994"
22,2,1,31,194,220,414,"21 de agosto de 1994"
22,2,1,32,253,245,498,"21 de agosto de 1994"
22,2,1,33,525,481,1006,"21 de agosto de 1994"
22,2,1,34,269,250,519,"21 de agosto de 1994"
22,2,3,46,545,612,1157,"21 de agosto de 1994"
22,2,3,47,428,477,905,"21 de agosto de 1994"
22,2,3,48,410,408,818,"21 de agosto de 1994"
22,2,3,49,424,483,907,"21 de agosto de 1994"
22,2,3,50,516,622,1138,"21 de agosto de 1994"
22,2,3,51,462,519,981,"21 de agosto de 1994"
22,2,3,52,236,263,499,"21 de agosto de 1994"
22,2,3,53,224,235,459,"21 de agosto de 1994"
22,2,3,54,217,211,428,"21 de agosto de 1994"
22,2,3,55,345,405,750,"21 de agosto de 1994"
22,2,3,56,274,283,557,"21 de agosto de 1994"
22,2,3,57,229,230,459,"21 de agosto de 1994"
22,2,3,58,313,281,594,"21 de agosto de 1994"
22,2,3,59,284,356,640,"21 de agosto de 1994"
22,2,3,60,430,378,808,"21 de agosto de 1994"
22,2,3,61,530,560,1090,"21 de agosto de 1994"
22,2,3,62,122,117,239,"21 de agosto de 1994"
22,2,3,63,258,262,520,"21 de agosto de 1994"
22,2,3,64,224,221,445,"21 de agosto de 1994"
22,2,3,65,448,417,865,"21 de agosto de 1994"
22,2,3,66,714,738,1452,"21 de agosto de 1994"
22,2,3,67,223,278,501,"21 de agosto de 1994"
22,2,3,68,181,158,339,"21 de agosto de 1994"
22,2,3,69,526,601,1127,"21 de agosto de 1994"
22,2,3,70,645,754,1399,"21 de agosto de 1994"
22,2,3,71,458,547,1005,"21 de agosto de 1994"
22,2,3,72,333,398,731,"21 de agosto de 1994"
22,2,3,73,620,571,1191,"21 de agosto de 1994"
22,2,3,74,193,157,350,"21 de agosto de 1994"
22,2,3,75,470,468,938,"21 de agosto de 1994"
22,2,6,122,400,470,870,"21 de agosto de 1994"
22,2,6,123,251,319,570,"21 de agosto de 1994"
22,2,6,124,345,411,756,"21 de agosto de 1994"
22,2,6,125,349,448,797,"21 de agosto de 1994"
22,2,6,126,440,493,933,"21 de agosto de 1994"
22,2,6,127,336,386,722,"21 de agosto de 1994"
22,2,6,128,442,518,960,"21 de agosto de 1994"
22,2,6,129,312,354,666,"21 de agosto de 1994"
22,2,6,130,316,343,659,"21 de agosto de 1994"
22,2,6,131,228,258,486,"21 de agosto de 1994"
22,2,6,132,234,265,499,"21 de agosto de 1994"
22,2,6,133,253,443,696,"21 de agosto de 1994"
22,2,6,134,237,325,562,"21 de agosto de 1994"
22,2,6,135,294,415,709,"21 de agosto de 1994"
22,2,6,136,240,346,586,"21 de agosto de 1994"
22,2,6,137,298,337,635,"21 de agosto de 1994"
22,2,6,138,165,148,313,"21 de agosto de 1994"
22,2,11,210,391,429,820,"21 de agosto de 1994"
22,2,11,211,438,442,880,"21 de agosto de 1994"
22,2,11,212,412,463,875,"21 de agosto de 1994"
22,2,11,213,389,386,775,"21 de agosto de 1994"
22,2,11,214,367,394,761,"21 de agosto de 1994"
22,2,11,215,455,453,908,"21 de agosto de 1994"
22,2,11,216,576,582,1158,"21 de agosto de 1994"
22,2,11,217,440,465,905,"21 de agosto de 1994"
22,2,11,218,306,315,621,"21 de agosto de 1994"
22,2,11,219,393,381,774,"21 de agosto de 1994"
22,2,11,220,421,399,820,"21 de agosto de 1994"
22,2,11,221,468,469,937,"21 de agosto de 1994"
22,2,11,222,601,631,1232,"21 de agosto de 1994"
22,2,11,223,505,517,1022,"21 de agosto de 1994"
22,2,11,224,636,650,1286,"21 de agosto de 1994"
22,2,11,225,452,465,917,"21 de agosto de 1994"
22,2,11,226,520,522,1042,"21 de agosto de 1994"
22,2,11,227,536,591,1127,"21 de agosto de 1994"
22,2,11,228,466,480,946,"21 de agosto de 1994"
22,2,11,229,240,236,476,"21 de agosto de 1994"
22,2,11,230,823,849,1672,"21 de agosto de 1994"
22,2,11,231,621,621,1242,"21 de agosto de 1994"
22,2,11,232,210,193,403,"21 de agosto de 1994"
22,2,11,233,415,433,848,"21 de agosto de 1994"
22,2,16,563,474,532,1006,"21 de agosto de 1994"
22,2,16,564,519,565,1084,"21 de agosto de 1994"
22,2,16,565,156,151,307,"21 de agosto de 1994"
22,2,16,566,632,672,1304,"21 de agosto de 1994"
22,2,16,567,470,550,1020,"21 de agosto de 1994"
22,2,16,568,419,470,889,"21 de agosto de 1994"
22,2,16,569,361,401,762,"21 de agosto de 1994"
22,2,16,570,505,520,1025,"21 de agosto de 1994"
22,2,16,571,455,515,970,"21 de agosto de 1994"
22,2,16,572,386,436,822,"21 de agosto de 1994"
22,2,16,573,257,321,578,"21 de agosto de 1994"
22,2,16,574,386,410,796,"21 de agosto de 1994"
22,2,16,575,268,304,572,"21 de agosto de 1994"
22,2,16,576,486,563,1049,"21 de agosto de 1994"
22,2,16,577,532,588,1120,"21 de agosto de 1994"
22,2,16,578,373,398,771,"21 de agosto de 1994"
22,2,16,579,460,537,997,"21 de agosto de 1994"
22,2,16,580,372,417,789,"21 de agosto de 1994"
22,2,16,581,364,414,778,"21 de agosto de 1994"
22,2,16,582,383,445,828,"21 de agosto de 1994"
22,2,16,583,364,425,789,"21 de agosto de 1994"
22,2,16,584,723,847,1570,"21 de agosto de 1994"
22,2,16,585,435,499,934,"21 de agosto de 1994"
22,2,16,586,451,491,942,"21 de agosto de 1994"
22,2,16,587,453,471,924,"21 de agosto de 1994"
22,2,16,588,291,343,634,"21 de agosto de 1994"
22,2,16,589,379,464,843,"21 de agosto de 1994"
22,2,16,590,569,688,1257,"21 de agosto de 1994"
22,2,16,591,449,572,1021,"21 de agosto de 1994"
22,2,16,592,420,472,892,"21 de agosto de 1994"
22,2,16,593,384,507,891,"21 de agosto de 1994"
22,2,16,594,460,543,1003,"21 de agosto de 1994"
22,2,16,595,457,524,981,"21 de agosto de 1994"
22,2,16,596,263,330,593,"21 de agosto de 1994"
22,2,16,597,304,355,659,"21 de agosto de 1994"
22,2,16,598,283,348,631,"21 de agosto de 1994"
22,2,16,599,386,431,817,"21 de agosto de 1994"
22,2,16,600,582,724,1306,"21 de agosto de 1994"
22,2,16,601,316,404,720,"21 de agosto de 1994"
22,2,16,602,467,501,968,"21 de agosto de 1994"
22,2,16,603,425,454,879,"21 de agosto de 1994"
22,2,16,604,398,437,835,"21 de agosto de 1994"
22,2,16,605,420,449,869,"21 de agosto de 1994"
22,2,16,606,321,323,644,"21 de agosto de 1994"
22,2,16,607,370,373,743,"21 de agosto de 1994"
22,2,16,608,483,519,1002,"21 de agosto de 1994"
22,2,16,609,558,637,1195,"21 de agosto de 1994"
22,2,16,610,319,339,658,"21 de agosto de 1994"
22,2,16,611,542,536,1078,"21 de agosto de 1994"
22,2,16,612,508,559,1067,"21 de agosto de 1994"
22,2,16,613,818,505,1323,"21 de agosto de 1994"
22,2,16,614,548,523,1071,"21 de agosto de 1994"
22,2,16,615,630,613,1243,"21 de agosto de 1994"
22,2,16,616,487,517,1004,"21 de agosto de 1994"
22,2,16,617,641,603,1244,"21 de agosto de 1994"
22,2,16,618,593,543,1136,"21 de agosto de 1994"
22,2,16,619,607,645,1252,"21 de agosto de 1994"
22,2,16,620,538,564,1102,"21 de agosto de 1994"
22,2,16,621,255,235,490,"21 de agosto de 1994"
22,2,16,622,514,521,1035,"21 de agosto de 1994"
22,2,16,623,555,581,1136,"21 de agosto de 1994"
22,2,16,624,486,483,969,"21 de agosto de 1994"
22,2,16,625,331,367,698,"21 de agosto de 1994"
22,2,16,626,356,396,752,"21 de agosto de 1994"
22,2,16,627,419,452,871,"21 de agosto de 1994"
22,2,16,628,245,288,533,"21 de agosto de 1994"
22,2,16,629,431,428,859,"21 de agosto de 1994"
22,2,16,630,438,403,841,"21 de agosto de 1994"
22,2,16,631,309,305,614,"21 de agosto de 1994"
22,2,16,632,444,417,861,"21 de agosto de 1994"
22,2,16,633,441,409,850,"21 de agosto de 1994"
22,2,16,634,506,477,983,"21 de agosto de 1994"
22,2,16,635,455,437,892,"21 de agosto de 1994"
22,2,16,636,323,314,637,"21 de agosto de 1994"
22,2,16,637,435,433,868,"21 de agosto de 1994"
22,2,16,638,355,378,733,"21 de agosto de 1994"
22,2,16,639,542,583,1125,"21 de agosto de 1994"
22,2,16,640,649,670,1319,"21 de agosto de 1994"
22,2,16,641,443,414,857,"21 de agosto de 1994"
22,2,16,642,514,530,1044,"21 de agosto de 1994"
22,2,16,643,345,293,638,"21 de agosto de 1994"
22,2,17,644,76,90,166,"21 de agosto de 1994"
22,2,17,645,249,258,507,"21 de agosto de 1994"
22,2,17,646,447,446,893,"21 de agosto de 1994"
22,2,17,647,484,511,995,"21 de agosto de 1994"
22,2,17,648,343,390,733,"21 de agosto de 1994"
22,2,17,649,344,350,694,"21 de agosto de 1994"
22,2,17,650,437,519,956,"21 de agosto de 1994"
22,2,17,651,348,380,728,"21 de agosto de 1994"
22,2,17,652,148,174,322,"21 de agosto de 1994"
22,2,17,653,392,410,802,"21 de agosto de 1994"
22,2,17,654,381,433,814,"21 de agosto de 1994"
22,2,17,655,309,380,689,"21 de agosto de 1994"
22,2,17,656,571,646,1217,"21 de agosto de 1994"
22,2,17,657,355,400,755,"21 de agosto de 1994"
22,2,17,658,445,471,916,"21 de agosto de 1994"
22,2,17,659,479,496,975,"21 de agosto de 1994"
22,2,17,660,522,525,1047,"21 de agosto de 1994"
22,2,17,661,349,372,721,"21 de agosto de 1994"
22,2,17,662,235,309,544,"21 de agosto de 1994"
22,2,17,663,255,257,512,"21 de agosto de 1994"
22,2,17,664,78,80,158,"21 de agosto de 1994"
22,2,17,665,380,417,797,"21 de agosto de 1994"
22,2,17,666,466,470,936,"21 de agosto de 1994"
22,2,17,667,498,531,1029,"21 de agosto de 1994"
22,2,17,668,561,572,1133,"21 de agosto de 1994"
22,2,17,669,328,333,661,"21 de agosto de 1994"
22,2,17,670,358,363,721,"21 de agosto de 1994"
22,2,17,671,375,352,727,"21 de agosto de 1994"
22,2,17,672,486,446,932,"21 de agosto de 1994"
22,2,17,673,471,473,944,"21 de agosto de 1994"
22,3,2,35,446,461,907,"21 de agosto de 1994"
22,3,2,36,226,235,461,"21 de agosto de 1994"
22,3,2,37,93,88,181,"21 de agosto de 1994"
22,3,2,38,80,99,179,"21 de agosto de 1994"
22,3,2,39,444,489,933,"21 de agosto de 1994"
22,3,2,40,123,117,240,"21 de agosto de 1994"
22,3,2,41,340,304,644,"21 de agosto de 1994"
22,3,2,42,255,279,534,"21 de agosto de 1994"
22,3,2,43,240,271,511,"21 de agosto de 1994"
22,3,2,44,126,124,250,"21 de agosto de 1994"
22,3,2,45,553,620,1173,"21 de agosto de 1994"
22,3,4,76,444,477,921,"21 de agosto de 1994"
22,3,4,77,407,421,828,"21 de agosto de 1994"
22,3,4,78,344,422,766,"21 de agosto de 1994"
22,3,4,79,550,585,1135,"21 de agosto de 1994"
22,3,4,80,208,198,406,"21 de agosto de 1994"
22,3,4,81,396,384,780,"21 de agosto de 1994"
22,3,4,82,300,306,606,"21 de agosto de 1994"
22,3,4,83,605,592,1197,"21 de agosto de 1994"
22,3,4,84,311,279,590,"21 de agosto de 1994"
22,3,4,85,226,299,525,"21 de agosto de 1994"
22,3,4,86,379,311,690,"21 de agosto de 1994"
22,3,4,87,410,405,815,"21 de agosto de 1994"
22,3,4,88,572,558,1130,"21 de agosto de 1994"
22,3,4,89,643,573,1216,"21 de agosto de 1994"
22,3,4,90,242,317,559,"21 de agosto de 1994"
22,3,4,91,305,351,656,"21 de agosto de 1994"
22,3,4,92,841,814,1655,"21 de agosto de 1994"
22,3,4,93,680,687,1367,"21 de agosto de 1994"
22,3,4,94,547,541,1088,"21 de agosto de 1994"
22,3,4,95,432,367,799,"21 de agosto de 1994"
22,3,4,96,604,553,1157,"21 de agosto de 1994"
22,3,5,97,501,574,1075,"21 de agosto de 1994"
22,3,5,98,531,577,1108,"21 de agosto de 1994"
22,3,5,99,615,577,1192,"21 de agosto de 1994"
22,3,5,100,545,567,1112,"21 de agosto de 1994"
22,3,5,101,513,574,1087,"21 de agosto de 1994"
22,3,5,102,502,538,1040,"21 de agosto de 1994"
22,3,5,103,538,548,1086,"21 de agosto de 1994"
22,3,5,104,526,565,1091,"21 de agosto de 1994"
22,3,5,105,579,594,1173,"21 de agosto de 1994"
22,3,5,106,545,572,1117,"21 de agosto de 1994"
22,3,5,107,520,563,1083,"21 de agosto de 1994"
22,3,5,108,477,549,1026,"21 de agosto de 1994"
22,3,5,109,494,550,1044,"21 de agosto de 1994"
22,3,5,110,576,584,1160,"21 de agosto de 1994"
22,3,5,111,461,507,968,"21 de agosto de 1994"
22,3,5,112,443,444,887,"21 de agosto de 1994"
22,3,5,113,813,863,1676,"21 de agosto de 1994"
22,3,5,114,544,591,1135,"21 de agosto de 1994"
22,3,5,115,662,656,1318,"21 de agosto de 1994"
22,3,5,116,382,369,751,"21 de agosto de 1994"
22,3,5,117,164,181,345,"21 de agosto de 1994"
22,3,5,118,443,488,931,"21 de agosto de 1994"
22,3,5,119,243,250,493,"21 de agosto de 1994"
22,3,5,120,599,572,1171,"21 de agosto de 1994"
22,3,5,121,669,692,1361,"21 de agosto de 1994"
22,3,7,139,455,521,976,"21 de agosto de 1994"
22,3,7,140,341,413,754,"21 de agosto de 1994"
22,3,7,141,501,456,957,"21 de agosto de 1994"
22,3,7,142,237,177,414,"21 de agosto de 1994"
22,3,7,143,417,406,823,"21 de agosto de 1994"
22,3,7,144,468,408,876,"21 de agosto de 1994"
22,3,7,145,453,402,855,"21 de agosto de 1994"
22,3,7,146,256,254,510,"21 de agosto de 1994"
22,3,7,147,611,626,1237,"21 de agosto de 1994"
22,3,7,148,314,298,612,"21 de agosto de 1994"
22,3,7,149,295,324,619,"21 de agosto de 1994"
22,3,7,150,415,469,884,"21 de agosto de 1994"
22,3,7,151,279,307,586,"21 de agosto de 1994"
22,3,7,152,496,563,1059,"21 de agosto de 1994"
22,3,8,153,383,461,844,"21 de agosto de 1994"
22,3,8,154,483,555,1038,"21 de agosto de 1994"
22,3,8,155,318,352,670,"21 de agosto de 1994"
22,3,8,156,365,438,803,"21 de agosto de 1994"
22,3,8,157,270,258,528,"21 de agosto de 1994"
22,3,8,158,393,427,820,"21 de agosto de 1994"
22,3,8,159,169,163,332,"21 de agosto de 1994"
22,3,8,160,190,200,390,"21 de agosto de 1994"
22,3,8,161,301,331,632,"21 de agosto de 1994"
22,3,8,162,190,242,432,"21 de agosto de 1994"
22,3,8,163,306,356,662,"21 de agosto de 1994"
22,3,8,164,266,284,550,"21 de agosto de 1994"
22,3,8,165,204,201,405,"21 de agosto de 1994"
22,3,8,166,196,214,410,"21 de agosto de 1994"
22,3,8,167,422,420,842,"21 de agosto de 1994"
22,3,9,168,448,519,967,"21 de agosto de 1994"
22,3,9,169,238,262,500,"21 de agosto de 1994"
22,3,9,170,232,237,469,"21 de agosto de 1994"
22,3,9,171,430,468,898,"21 de agosto de 1994"
22,3,9,172,204,225,429,"21 de agosto de 1994"
22,3,9,173,173,156,329,"21 de agosto de 1994"
22,3,9,174,307,333,640,"21 de agosto de 1994"
22,3,9,175,245,268,513,"21 de agosto de 1994"
22,3,9,176,489,493,982,"21 de agosto de 1994"
22,3,9,177,189,150,339,"21 de agosto de 1994"
22,3,9,178,158,176,334,"21 de agosto de 1994"
22,3,9,179,98,114,212,"21 de agosto de 1994"
22,3,9,180,436,460,896,"21 de agosto de 1994"
22,3,9,181,115,138,253,"21 de agosto de 1994"
22,3,10,182,580,565,1145,"21 de agosto de 1994"
22,3,10,183,620,640,1260,"21 de agosto de 1994"
22,3,10,184,474,484,958,"21 de agosto de 1994"
22,3,10,185,588,546,1134,"21 de agosto de 1994"
22,3,10,186,155,172,327,"21 de agosto de 1994"
22,3,10,187,223,204,427,"21 de agosto de 1994"
22,3,10,188,663,732,1395,"21 de agosto de 1994"
22,3,10,189,542,515,1057,"21 de agosto de 1994"
22,3,10,190,605,595,1200,"21 de agosto de 1994"
22,3,10,191,747,710,1457,"21 de agosto de 1994"
22,3,10,192,519,518,1037,"21 de agosto de 1994"
22,3,10,193,365,375,740,"21 de agosto de 1994"
22,3,10,194,364,307,671,"21 de agosto de 1994"
22,3,10,195,570,555,1125,"21 de agosto de 1994"
22,3,10,196,559,567,1126,"21 de agosto de 1994"
22,3,10,197,468,456,924,"21 de agosto de 1994"
22,3,10,198,455,492,947,"21 de agosto de 1994"
22,3,10,199,554,496,1050,"21 de agosto de 1994"
22,3,10,200,447,423,870,"21 de agosto de 1994"
22,3,10,201,652,615,1267,"21 de agosto de 1994"
22,3,10,202,751,669,1420,"21 de agosto de 1994"
22,3,10,203,743,708,1451,"21 de agosto de 1994"
22,3,10,204,560,563,1123,"21 de agosto de 1994"
22,3,10,205,686,692,1378,"21 de agosto de 1994"
22,3,10,206,411,435,846,"21 de agosto de 1994"
22,3,10,207,473,521,994,"21 de agosto de 1994"
22,3,10,208,568,587,1155,"21 de agosto de 1994"
22,3,10,209,407,393,800,"21 de agosto de 1994"
22,3,12,234,369,401,770,"21 de agosto de 1994"
22,3,12,235,151,130,281,"21 de agosto de 1994"
22,3,12,236,132,134,266,"21 de agosto de 1994"
22,3,12,237,501,464,965,"21 de agosto de 1994"
22,3,12,238,171,208,379,"21 de agosto de 1994"
22,3,12,239,165,152,317,"21 de agosto de 1994"
22,3,12,240,362,403,765,"21 de agosto de 1994"
22,3,12,241,293,327,620,"21 de agosto de 1994"
22,3,12,242,288,360,648,"21 de agosto de 1994"
22,3,12,243,198,202,400,"21 de agosto de 1994"
22,3,12,244,144,159,303,"21 de agosto de 1994"
22,3,12,245,474,489,963,"21 de agosto de 1994"
22,3,12,246,41,36,77,"21 de agosto de 1994"
22,3,12,247,487,449,936,"21 de agosto de 1994"
22,3,13,248,468,485,953,"21 de agosto de 1994"
22,3,13,249,293,292,585,"21 de agosto de 1994"
22,3,13,250,414,453,867,"21 de agosto de 1994"
22,3,13,251,413,439,852,"21 de agosto de 1994"
22,3,13,252,209,221,430,"21 de agosto de 1994"
22,3,13,253,466,540,1006,"21 de agosto de 1994"
22,3,13,254,326,362,688,"21 de agosto de 1994"
22,3,13,255,127,119,246,"21 de agosto de 1994"
22,3,13,256,265,279,544,"21 de agosto de 1994"
22,3,13,257,126,116,242,"21 de agosto de 1994"
22,3,13,258,376,361,737,"21 de agosto de 1994"
22,3,13,259,289,344,633,"21 de agosto de 1994"
22,3,13,260,370,433,803,"21 de agosto de 1994"
22,3,13,261,325,405,730,"21 de agosto de 1994"
22,3,13,262,479,459,938,"21 de agosto de 1994"
22,3,13,263,216,222,438,"21 de agosto de 1994"
22,3,13,264,211,213,424,"21 de agosto de 1994"
22,3,13,265,105,98,203,"21 de agosto de 1994"
22,3,15,556,320,339,659,"21 de agosto de 1994"
22,3,15,557,398,427,825,"21 de agosto de 1994"
22,3,15,558,197,226,423,"21 de agosto de 1994"
22,3,15,559,154,167,321,"21 de agosto de 1994"
22,3,15,560,246,293,539,"21 de agosto de 1994"
22,3,15,561,89,88,177,"21 de agosto de 1994"
22,3,15,562,93,90,183,"21 de agosto de 1994"
22,3,18,674,342,429,771,"21 de agosto de 1994"
22,3,18,675,308,363,671,"21 de agosto de 1994"
22,3,18,676,104,106,210,"21 de agosto de 1994"
22,3,18,677,345,338,683,"21 de agosto de 1994"
22,3,18,678,226,217,443,"21 de agosto de 1994"
22,3,18,679,473,523,996,"21 de agosto de 1994"
22,3,18,680,217,230,447,"21 de agosto de 1994"
22,3,18,681,231,330,561,"21 de agosto de 1994"
22,3,18,682,511,559,1070,"21 de agosto de 1994"
22,3,18,683,401,461,862,"21 de agosto de 1994"
22,3,18,684,618,767,1385,"21 de agosto de 1994"
22,3,18,685,31,26,57,"21 de agosto de 1994"
22,3,18,686,205,190,395,"21 de agosto de 1994"
22,3,18,687,359,371,730,"21 de agosto de 1994"
23,1,5,262,443,390,833,"21 de agosto de 1994"
23,1,5,263,354,309,663,"21 de agosto de 1994"
23,1,5,264,421,392,813,"21 de agosto de 1994"
23,1,5,265,523,476,999,"21 de agosto de 1994"
23,1,5,266,266,239,505,"21 de agosto de 1994"
23,1,5,267,196,147,343,"21 de agosto de 1994"
23,1,5,268,559,485,1044,"21 de agosto de 1994"
23,1,5,269,275,212,487,"21 de agosto de 1994"
23,1,5,270,404,349,753,"21 de agosto de 1994"
23,1,5,271,330,300,630,"21 de agosto de 1994"
23,1,5,272,186,131,317,"21 de agosto de 1994"
23,1,5,273,435,383,818,"21 de agosto de 1994"
23,1,5,274,336,297,633,"21 de agosto de 1994"
23,1,5,275,312,249,561,"21 de agosto de 1994"
23,1,5,276,318,285,603,"21 de agosto de 1994"
23,1,5,277,119,77,196,"21 de agosto de 1994"
23,1,5,278,223,150,373,"21 de agosto de 1994"
23,1,5,279,177,115,292,"21 de agosto de 1994"
23,1,5,280,145,102,247,"21 de agosto de 1994"
23,1,5,281,60,50,110,"21 de agosto de 1994"
23,1,5,282,210,165,375,"21 de agosto de 1994"
23,1,5,283,203,141,344,"21 de agosto de 1994"
23,1,7,298,104,86,190,"21 de agosto de 1994"
23,1,7,299,59,57,116,"21 de agosto de 1994"
23,1,7,300,290,311,601,"21 de agosto de 1994"
23,1,7,301,44,56,100,"21 de agosto de 1994"
23,1,7,302,231,258,489,"21 de agosto de 1994"
23,1,7,303,388,403,791,"21 de agosto de 1994"
23,1,7,304,397,391,788,"21 de agosto de 1994"
23,1,7,305,326,356,682,"21 de agosto de 1994"
23,1,7,306,295,327,622,"21 de agosto de 1994"
23,1,7,307,544,588,1132,"21 de agosto de 1994"
23,1,7,308,411,406,817,"21 de agosto de 1994"
23,1,7,309,511,537,1048,"21 de agosto de 1994"
23,1,7,310,486,499,985,"21 de agosto de 1994"
23,1,7,311,501,505,1006,"21 de agosto de 1994"
23,1,7,312,457,480,937,"21 de agosto de 1994"
23,1,7,313,174,202,376,"21 de agosto de 1994"
23,1,7,314,191,183,374,"21 de agosto de 1994"
23,1,7,315,480,484,964,"21 de agosto de 1994"
23,1,7,316,156,1,157,"21 de agosto de 1994"
23,1,7,317,244,250,494,"21 de agosto de 1994"
23,1,7,318,398,406,804,"21 de agosto de 1994"
23,1,7,319,282,330,612,"21 de agosto de 1994"
23,1,7,320,289,353,642,"21 de agosto de 1994"
23,1,7,321,237,267,504,"21 de agosto de 1994"
23,1,7,322,184,193,377,"21 de agosto de 1994"
23,1,7,323,297,329,626,"21 de agosto de 1994"
23,1,7,324,68,76,144,"21 de agosto de 1994"
23,1,7,325,324,334,658,"21 de agosto de 1994"
23,1,7,326,499,498,997,"21 de agosto de 1994"
23,1,7,327,290,327,617,"21 de agosto de 1994"
23,1,7,328,322,386,708,"21 de agosto de 1994"
23,1,7,329,336,353,689,"21 de agosto de 1994"
23,1,7,330,509,554,1063,"21 de agosto de 1994"
23,1,7,331,366,372,738,"21 de agosto de 1994"
23,1,7,332,329,363,692,"21 de agosto de 1994"
23,1,7,333,431,486,917,"21 de agosto de 1994"
23,1,7,334,312,313,625,"21 de agosto de 1994"
23,1,7,335,420,412,832,"21 de agosto de 1994"
23,1,7,336,224,239,463,"21 de agosto de 1994"
23,1,7,337,280,297,577,"21 de agosto de 1994"
23,1,7,338,250,280,530,"21 de agosto de 1994"
23,1,7,339,293,320,613,"21 de agosto de 1994"
23,1,7,340,151,177,328,"21 de agosto de 1994"
23,1,7,341,211,243,454,"21 de agosto de 1994"
23,1,7,342,332,360,692,"21 de agosto de 1994"
23,1,7,343,447,502,949,"21 de agosto de 1994"
23,1,7,344,474,452,926,"21 de agosto de 1994"
23,1,7,345,273,268,541,"21 de agosto de 1994"
23,1,7,346,450,421,871,"21 de agosto de 1994"
23,1,7,347,549,570,1119,"21 de agosto de 1994"
23,1,7,348,299,339,638,"21 de agosto de 1994"
23,1,7,349,333,346,679,"21 de agosto de 1994"
23,1,7,350,127,126,253,"21 de agosto de 1994"
23,1,7,351,76,79,155,"21 de agosto de 1994"
23,1,7,352,304,343,647,"21 de agosto de 1994"
23,1,7,353,379,345,724,"21 de agosto de 1994"
23,1,7,354,395,459,854,"21 de agosto de 1994"
23,1,7,355,272,246,518,"21 de agosto de 1994"
23,1,7,356,271,282,553,"21 de agosto de 1994"
23,1,7,357,466,521,987,"21 de agosto de 1994"
23,1,7,358,368,382,750,"21 de agosto de 1994"
23,1,7,359,388,410,798,"21 de agosto de 1994"
23,1,7,360,207,236,443,"21 de agosto de 1994"
23,1,7,361,411,430,841,"21 de agosto de 1994"
23,1,7,362,289,328,617,"21 de agosto de 1994"
23,1,7,363,401,441,842,"21 de agosto de 1994"
23,1,7,364,252,265,517,"21 de agosto de 1994"
23,1,7,365,480,523,1003,"21 de agosto de 1994"
23,1,7,366,297,283,580,"21 de agosto de 1994"
23,1,7,367,316,369,685,"21 de agosto de 1994"
23,1,7,368,407,419,826,"21 de agosto de 1994"
23,1,7,369,215,243,458,"21 de agosto de 1994"
23,1,7,370,282,278,560,"21 de agosto de 1994"
23,1,7,371,539,596,1135,"21 de agosto de 1994"
23,1,7,372,227,221,448,"21 de agosto de 1994"
23,1,7,373,54,3,57,"21 de agosto de 1994"
23,1,7,374,330,337,667,"21 de agosto de 1994"
23,1,7,375,474,451,925,"21 de agosto de 1994"
23,1,7,376,399,2,401,"21 de agosto de 1994"
23,1,7,377,580,729,1309,"21 de agosto de 1994"
23,1,7,378,326,370,696,"21 de agosto de 1994"
23,1,7,379,304,313,617,"21 de agosto de 1994"
23,1,7,380,438,427,865,"21 de agosto de 1994"
23,1,7,381,243,262,505,"21 de agosto de 1994"
23,1,7,382,402,420,822,"21 de agosto de 1994"
23,1,7,383,359,359,718,"21 de agosto de 1994"
23,1,7,384,284,226,510,"21 de agosto de 1994"
23,1,7,385,368,303,671,"21 de agosto de 1994"
23,1,7,386,171,142,313,"21 de agosto de 1994"
23,1,7,387,252,182,434,"21 de agosto de 1994"
23,1,7,388,147,116,263,"21 de agosto de 1994"
23,1,7,389,229,193,422,"21 de agosto de 1994"
23,1,7,390,194,176,370,"21 de agosto de 1994"
23,1,7,391,247,195,442,"21 de agosto de 1994"
23,1,7,392,459,388,847,"21 de agosto de 1994"
23,1,7,393,31,5,36,"21 de agosto de 1994"
23,1,7,394,252,222,474,"21 de agosto de 1994"
23,1,7,395,177,154,331,"21 de agosto de 1994"
23,1,7,396,141,98,239,"21 de agosto de 1994"
23,1,7,397,201,179,380,"21 de agosto de 1994"
23,1,7,398,125,100,225,"21 de agosto de 1994"
23,1,7,399,56,51,107,"21 de agosto de 1994"
23,1,7,400,193,138,331,"21 de agosto de 1994"
23,1,7,401,172,125,297,"21 de agosto de 1994"
23,1,7,402,255,199,454,"21 de agosto de 1994"
23,1,7,403,410,318,728,"21 de agosto de 1994"
23,1,7,404,275,235,510,"21 de agosto de 1994"
23,1,7,405,415,403,818,"21 de agosto de 1994"
23,1,7,406,344,322,666,"21 de agosto de 1994"
23,1,7,407,430,402,832,"21 de agosto de 1994"
23,1,7,408,474,454,928,"21 de agosto de 1994"
23,1,7,409,279,281,560,"21 de agosto de 1994"
23,1,7,410,134,68,202,"21 de agosto de 1994"
23,1,7,411,208,162,370,"21 de agosto de 1994"
23,1,7,412,205,159,364,"21 de agosto de 1994"
23,1,7,413,532,462,994,"21 de agosto de 1994"
23,1,7,414,452,326,778,"21 de agosto de 1994"
23,1,7,415,619,456,1075,"21 de agosto de 1994"
23,1,7,416,231,188,419,"21 de agosto de 1994"
23,1,7,417,455,358,813,"21 de agosto de 1994"
23,1,7,418,472,359,831,"21 de agosto de 1994"
23,1,7,419,452,360,812,"21 de agosto de 1994"
23,1,7,420,466,362,828,"21 de agosto de 1994"
23,1,7,421,381,298,679,"21 de agosto de 1994"
23,1,7,422,427,359,786,"21 de agosto de 1994"
23,1,7,423,476,357,833,"21 de agosto de 1994"
23,1,7,424,270,233,503,"21 de agosto de 1994"
23,1,7,425,429,384,813,"21 de agosto de 1994"
23,1,7,426,351,325,676,"21 de agosto de 1994"
23,1,7,427,401,398,799,"21 de agosto de 1994"
23,1,7,428,288,292,580,"21 de agosto de 1994"
23,1,7,429,619,452,1071,"21 de agosto de 1994"
23,1,7,430,210,144,354,"21 de agosto de 1994"
23,1,7,431,334,285,619,"21 de agosto de 1994"
23,1,7,432,282,194,476,"21 de agosto de 1994"
23,1,7,433,478,364,842,"21 de agosto de 1994"
23,1,7,434,43,29,72,"21 de agosto de 1994"
23,1,7,435,218,165,383,"21 de agosto de 1994"
23,1,7,436,285,193,478,"21 de agosto de 1994"
23,1,7,437,585,483,1068,"21 de agosto de 1994"
23,1,7,438,469,351,820,"21 de agosto de 1994"
23,1,7,439,448,336,784,"21 de agosto de 1994"
23,1,7,440,240,197,437,"21 de agosto de 1994"
23,1,7,441,456,334,790,"21 de agosto de 1994"
23,1,7,442,99,71,170,"21 de agosto de 1994"
23,1,7,443,220,167,387,"21 de agosto de 1994"
23,1,7,444,325,262,587,"21 de agosto de 1994"
23,1,7,445,71,71,142,"21 de agosto de 1994"
23,1,7,446,388,295,683,"21 de agosto de 1994"
23,1,7,447,258,164,422,"21 de agosto de 1994"
23,1,7,448,381,313,694,"21 de agosto de 1994"
23,1,7,449,735,808,1543,"21 de agosto de 1994"
23,1,7,450,250,217,467,"21 de agosto de 1994"
23,2,1,1,853,765,1618,"21 de agosto de 1994"
23,2,1,2,1241,1119,2360,"21 de agosto de 1994"
23,2,1,3,1218,1168,2386,"21 de agosto de 1994"
23,2,1,4,139,147,286,"21 de agosto de 1994"
23,2,1,5,253,251,504,"21 de agosto de 1994"
23,2,1,6,310,280,590,"21 de agosto de 1994"
23,2,1,7,482,428,910,"21 de agosto de 1994"
23,2,1,8,365,303,668,"21 de agosto de 1994"
23,2,1,9,347,265,612,"21 de agosto de 1994"
23,2,1,10,299,240,539,"21 de agosto de 1994"
23,2,1,11,1793,1756,3549,"21 de agosto de 1994"
23,2,1,12,908,817,1725,"21 de agosto de 1994"
23,2,1,13,550,518,1068,"21 de agosto de 1994"
23,2,1,14,271,228,499,"21 de agosto de 1994"
23,2,1,15,479,450,929,"21 de agosto de 1994"
23,2,1,16,632,621,1253,"21 de agosto de 1994"
23,2,1,17,524,537,1061,"21 de agosto de 1994"
23,2,1,18,546,506,1052,"21 de agosto de 1994"
23,2,1,19,679,570,1249,"21 de agosto de 1994"
23,2,1,20,197,163,360,"21 de agosto de 1994"
23,2,1,21,336,354,690,"21 de agosto de 1994"
23,2,1,22,338,275,613,"21 de agosto de 1994"
23,2,1,23,346,328,674,"21 de agosto de 1994"
23,2,1,24,273,287,560,"21 de agosto de 1994"
23,2,1,25,289,251,540,"21 de agosto de 1994"
23,2,1,26,272,281,553,"21 de agosto de 1994"
23,2,1,27,400,360,760,"21 de agosto de 1994"
23,2,1,28,438,398,836,"21 de agosto de 1994"
23,2,1,29,325,297,622,"21 de agosto de 1994"
23,2,1,30,279,227,506,"21 de agosto de 1994"
23,2,1,31,325,254,579,"21 de agosto de 1994"
23,2,1,32,389,269,658,"21 de agosto de 1994"
23,2,1,33,297,187,484,"21 de agosto de 1994"
23,2,1,34,360,248,608,"21 de agosto de 1994"
23,2,1,35,445,334,779,"21 de agosto de 1994"
23,2,1,36,450,392,842,"21 de agosto de 1994"
23,2,1,37,336,286,622,"21 de agosto de 1994"
23,2,1,38,530,397,927,"21 de agosto de 1994"
23,2,1,39,306,222,528,"21 de agosto de 1994"
23,2,1,40,466,347,813,"21 de agosto de 1994"
23,2,1,41,270,220,490,"21 de agosto de 1994"
23,2,1,42,294,236,530,"21 de agosto de 1994"
23,2,1,43,391,334,725,"21 de agosto de 1994"
23,2,1,44,561,466,1027,"21 de agosto de 1994"
23,2,1,45,476,481,957,"21 de agosto de 1994"
23,2,1,46,581,508,1089,"21 de agosto de 1994"
23,2,1,47,485,459,944,"21 de agosto de 1994"
23,2,1,48,404,408,812,"21 de agosto de 1994"
23,2,1,49,377,327,704,"21 de agosto de 1994"
23,2,1,50,537,497,1034,"21 de agosto de 1994"
23,2,1,51,371,335,706,"21 de agosto de 1994"
23,2,1,52,445,414,859,"21 de agosto de 1994"
23,2,1,53,715,668,1383,"21 de agosto de 1994"
23,2,1,54,735,655,1390,"21 de agosto de 1994"
23,2,1,55,466,420,886,"21 de agosto de 1994"
23,2,1,56,430,377,807,"21 de agosto de 1994"
23,2,1,57,181,200,381,"21 de agosto de 1994"
23,2,1,58,232,236,468,"21 de agosto de 1994"
23,2,1,59,207,207,414,"21 de agosto de 1994"
23,2,1,60,81,81,162,"21 de agosto de 1994"
23,2,1,61,343,315,658,"21 de agosto de 1994"
23,2,1,62,318,298,616,"21 de agosto de 1994"
23,2,1,63,300,267,567,"21 de agosto de 1994"
23,2,1,64,380,296,676,"21 de agosto de 1994"
23,2,1,65,482,425,907,"21 de agosto de 1994"
23,2,1,66,307,234,541,"21 de agosto de 1994"
23,2,1,67,345,223,568,"21 de agosto de 1994"
23,2,1,68,432,278,710,"21 de agosto de 1994"
23,2,1,69,345,269,614,"21 de agosto de 1994"
23,2,1,70,386,326,712,"21 de agosto de 1994"
23,2,1,71,377,365,742,"21 de agosto de 1994"
23,2,1,72,677,607,1284,"21 de agosto de 1994"
23,2,1,73,620,590,1210,"21 de agosto de 1994"
23,2,1,74,518,456,974,"21 de agosto de 1994"
23,2,1,75,408,363,771,"21 de agosto de 1994"
23,2,1,76,263,294,557,"21 de agosto de 1994"
23,2,1,77,159,148,307,"21 de agosto de 1994"
23,2,1,78,73,73,146,"21 de agosto de 1994"
23,2,1,79,356,285,641,"21 de agosto de 1994"
23,2,1,80,263,267,530,"21 de agosto de 1994"
23,2,1,81,379,271,650,"21 de agosto de 1994"
23,2,1,82,316,279,595,"21 de agosto de 1994"
23,2,1,83,477,319,796,"21 de agosto de 1994"
23,2,1,84,488,291,779,"21 de agosto de 1994"
23,2,1,85,376,236,612,"21 de agosto de 1994"
23,2,1,86,363,278,641,"21 de agosto de 1994"
23,2,1,87,290,234,524,"21 de agosto de 1994"
23,2,1,88,314,256,570,"21 de agosto de 1994"
23,2,1,89,251,212,463,"21 de agosto de 1994"
23,2,1,90,475,449,924,"21 de agosto de 1994"
23,2,1,91,493,485,978,"21 de agosto de 1994"
23,2,1,92,293,249,542,"21 de agosto de 1994"
23,2,1,93,344,315,659,"21 de agosto de 1994"
23,2,1,94,598,605,1203,"21 de agosto de 1994"
23,2,1,95,267,228,495,"21 de agosto de 1994"
23,2,1,96,279,246,525,"21 de agosto de 1994"
23,2,1,97,290,185,475,"21 de agosto de 1994"
23,2,1,98,347,265,612,"21 de agosto de 1994"
23,2,1,99,258,210,468,"21 de agosto de 1994"
23,2,1,100,209,213,422,"21 de agosto de 1994"
23,2,1,101,333,262,595,"21 de agosto de 1994"
23,2,1,102,134,128,262,"21 de agosto de 1994"
23,2,1,103,143,140,283,"21 de agosto de 1994"
23,2,1,104,382,377,759,"21 de agosto de 1994"
23,2,1,105,344,370,714,"21 de agosto de 1994"
23,2,1,106,276,276,552,"21 de agosto de 1994"
23,2,1,107,425,378,803,"21 de agosto de 1994"
23,2,1,108,366,278,644,"21 de agosto de 1994"
23,2,1,109,421,339,760,"21 de agosto de 1994"
23,2,1,110,251,212,463,"21 de agosto de 1994"
23,2,1,111,156,144,300,"21 de agosto de 1994"
23,2,1,112,211,186,397,"21 de agosto de 1994"
23,2,1,113,297,190,487,"21 de agosto de 1994"
23,2,1,114,248,159,407,"21 de agosto de 1994"
23,2,1,115,278,198,476,"21 de agosto de 1994"
23,2,1,116,269,242,511,"21 de agosto de 1994"
23,2,1,117,442,442,884,"21 de agosto de 1994"
23,2,1,118,190,177,367,"21 de agosto de 1994"
23,2,1,119,152,171,323,"21 de agosto de 1994"
23,2,1,120,326,275,601,"21 de agosto de 1994"
23,2,1,121,273,276,549,"21 de agosto de 1994"
23,2,1,122,246,265,511,"21 de agosto de 1994"
23,2,1,123,219,247,466,"21 de agosto de 1994"
23,2,1,124,304,334,638,"21 de agosto de 1994"
23,2,1,125,279,295,574,"21 de agosto de 1994"
23,2,1,126,352,397,749,"21 de agosto de 1994"
23,2,1,127,662,569,1231,"21 de agosto de 1994"
23,2,1,128,205,184,389,"21 de agosto de 1994"
23,2,1,129,111,130,241,"21 de agosto de 1994"
23,2,1,130,196,212,408,"21 de agosto de 1994"
23,2,1,131,314,356,670,"21 de agosto de 1994"
23,2,1,132,285,324,609,"21 de agosto de 1994"
23,2,1,133,354,332,686,"21 de agosto de 1994"
23,2,1,134,281,249,530,"21 de agosto de 1994"
23,2,1,135,311,251,562,"21 de agosto de 1994"
23,2,1,136,197,174,371,"21 de agosto de 1994"
23,2,1,137,331,265,596,"21 de agosto de 1994"
23,2,1,138,248,199,447,"21 de agosto de 1994"
23,2,1,139,303,251,554,"21 de agosto de 1994"
23,2,1,140,163,175,338,"21 de agosto de 1994"
23,2,1,141,214,199,413,"21 de agosto de 1994"
23,2,1,142,200,206,406,"21 de agosto de 1994"
23,2,1,143,253,241,494,"21 de agosto de 1994"
23,2,1,144,223,185,408,"21 de agosto de 1994"
23,2,1,145,191,188,379,"21 de agosto de 1994"
23,2,1,146,291,295,586,"21 de agosto de 1994"
23,2,1,147,673,741,1414,"21 de agosto de 1994"
23,2,1,148,431,388,819,"21 de agosto de 1994"
23,2,1,149,58,56,114,"21 de agosto de 1994"
23,2,1,150,21,32,53,"21 de agosto de 1994"
23,2,1,151,424,402,826,"21 de agosto de 1994"
23,2,1,152,581,486,1067,"21 de agosto de 1994"
23,2,1,153,488,462,950,"21 de agosto de 1994"
23,2,1,154,839,309,1148,"21 de agosto de 1994"
23,2,1,155,393,387,780,"21 de agosto de 1994"
23,2,1,156,416,412,828,"21 de agosto de 1994"
23,2,1,157,426,421,847,"21 de agosto de 1994"
23,2,1,158,374,356,730,"21 de agosto de 1994"
23,2,1,159,464,417,881,"21 de agosto de 1994"
23,2,1,160,661,673,1334,"21 de agosto de 1994"
23,2,1,161,356,392,748,"21 de agosto de 1994"
23,2,1,162,145,137,282,"21 de agosto de 1994"
23,2,1,163,678,616,1294,"21 de agosto de 1994"
23,2,1,164,432,413,845,"21 de agosto de 1994"
23,2,1,165,317,312,629,"21 de agosto de 1994"
23,2,1,166,455,429,884,"21 de agosto de 1994"
23,2,1,167,481,435,916,"21 de agosto de 1994"
23,2,1,168,358,344,702,"21 de agosto de 1994"
23,2,1,169,200,101,301,"21 de agosto de 1994"
23,2,1,170,241,256,497,"21 de agosto de 1994"
23,2,1,171,39,22,61,"21 de agosto de 1994"
23,2,1,172,14,13,27,"21 de agosto de 1994"
23,2,1,173,550,462,1012,"21 de agosto de 1994"
23,2,1,174,335,291,626,"21 de agosto de 1994"
23,2,1,175,320,261,581,"21 de agosto de 1994"
23,2,1,176,36,21,57,"21 de agosto de 1994"
23,2,1,177,357,314,671,"21 de agosto de 1994"
23,2,1,178,262,187,449,"21 de agosto de 1994"
23,2,1,179,258,222,480,"21 de agosto de 1994"
23,2,1,180,300,237,537,"21 de agosto de 1994"
23,2,1,181,411,356,767,"21 de agosto de 1994"
23,2,2,182,558,455,1013,"21 de agosto de 1994"
23,2,2,183,545,505,1050,"21 de agosto de 1994"
23,2,2,184,580,506,1086,"21 de agosto de 1994"
23,2,2,185,534,514,1048,"21 de agosto de 1994"
23,2,2,186,239,221,460,"21 de agosto de 1994"
23,2,2,187,371,344,715,"21 de agosto de 1994"
23,2,2,188,540,461,1001,"21 de agosto de 1994"
23,2,2,189,559,498,1057,"21 de agosto de 1994"
23,2,2,190,528,462,990,"21 de agosto de 1994"
23,2,2,191,367,335,702,"21 de agosto de 1994"
23,2,2,192,458,444,902,"21 de agosto de 1994"
23,2,2,193,522,438,960,"21 de agosto de 1994"
23,2,2,194,407,369,776,"21 de agosto de 1994"
23,2,2,195,408,349,757,"21 de agosto de 1994"
23,2,2,196,289,284,573,"21 de agosto de 1994"
23,2,2,197,611,593,1204,"21 de agosto de 1994"
23,2,2,198,617,526,1143,"21 de agosto de 1994"
23,2,2,199,508,432,940,"21 de agosto de 1994"
23,2,2,200,505,429,934,"21 de agosto de 1994"
23,2,2,201,487,429,916,"21 de agosto de 1994"
23,2,2,202,581,544,1125,"21 de agosto de 1994"
23,2,2,203,1042,947,1989,"21 de agosto de 1994"
23,2,3,215,263,247,510,"21 de agosto de 1994"
23,2,3,216,198,190,388,"21 de agosto de 1994"
23,2,3,217,173,201,374,"21 de agosto de 1994"
23,2,3,218,467,469,936,"21 de agosto de 1994"
23,2,3,219,141,143,284,"21 de agosto de 1994"
23,2,3,220,280,256,536,"21 de agosto de 1994"
23,2,3,221,350,363,713,"21 de agosto de 1994"
23,2,3,222,531,527,1058,"21 de agosto de 1994"
23,2,3,223,251,270,521,"21 de agosto de 1994"
23,2,3,224,241,228,469,"21 de agosto de 1994"
23,2,3,225,366,344,710,"21 de agosto de 1994"
23,2,3,226,225,208,433,"21 de agosto de 1994"
23,2,3,227,509,462,971,"21 de agosto de 1994"
23,2,3,228,378,352,730,"21 de agosto de 1994"
23,2,3,229,462,437,899,"21 de agosto de 1994"
23,2,3,230,198,141,339,"21 de agosto de 1994"
23,2,3,231,233,170,403,"21 de agosto de 1994"
23,2,3,232,446,407,853,"21 de agosto de 1994"
23,2,3,233,264,235,499,"21 de agosto de 1994"
23,2,3,234,638,557,1195,"21 de agosto de 1994"
23,2,3,235,366,332,698,"21 de agosto de 1994"
23,2,3,236,29,23,52,"21 de agosto de 1994"
23,2,3,237,274,252,526,"21 de agosto de 1994"
23,2,3,238,473,439,912,"21 de agosto de 1994"
23,2,3,239,478,412,890,"21 de agosto de 1994"
23,2,3,240,249,220,469,"21 de agosto de 1994"
23,2,3,241,557,489,1046,"21 de agosto de 1994"
23,2,3,242,395,347,742,"21 de agosto de 1994"
23,2,3,243,116,90,206,"21 de agosto de 1994"
23,2,3,244,385,337,722,"21 de agosto de 1994"
23,2,3,245,171,159,330,"21 de agosto de 1994"
23,2,3,246,15,4,19,"21 de agosto de 1994"
23,2,3,247,574,449,1023,"21 de agosto de 1994"
23,2,3,248,102,79,181,"21 de agosto de 1994"
23,2,3,249,584,475,1059,"21 de agosto de 1994"
23,2,3,250,242,206,448,"21 de agosto de 1994"
23,2,3,251,518,451,969,"21 de agosto de 1994"
23,2,4,252,387,313,700,"21 de agosto de 1994"
23,2,4,253,616,297,913,"21 de agosto de 1994"
23,2,4,254,187,184,371,"21 de agosto de 1994"
23,2,4,255,350,318,668,"21 de agosto de 1994"
23,2,4,256,198,176,374,"21 de agosto de 1994"
23,2,4,257,207,195,402,"21 de agosto de 1994"
23,2,4,258,466,383,849,"21 de agosto de 1994"
23,2,4,259,136,119,255,"21 de agosto de 1994"
23,2,4,260,28,19,47,"21 de agosto de 1994"
23,2,4,261,140,78,218,"21 de agosto de 1994"
23,2,6,284,322,253,575,"21 de agosto de 1994"
23,2,6,285,340,301,641,"21 de agosto de 1994"
23,2,6,286,631,576,1207,"21 de agosto de 1994"
23,2,6,287,331,245,576,"21 de agosto de 1994"
23,2,6,288,427,339,766,"21 de agosto de 1994"
23,2,6,289,177,147,324,"21 de agosto de 1994"
23,2,6,290,393,360,753,"21 de agosto de 1994"
23,2,6,291,272,216,488,"21 de agosto de 1994"
23,2,6,292,374,349,723,"21 de agosto de 1994"
23,2,6,293,337,290,627,"21 de agosto de 1994"
23,2,6,294,187,162,349,"21 de agosto de 1994"
23,2,6,295,210,184,394,"21 de agosto de 1994"
23,2,6,296,323,256,579,"21 de agosto de 1994"
23,2,6,297,160,129,289,"21 de agosto de 1994"
23,2,8,204,678,505,1183,"21 de agosto de 1994"
23,2,8,205,687,409,1096,"21 de agosto de 1994"
23,2,8,206,745,465,1210,"21 de agosto de 1994"
23,2,8,207,748,456,1204,"21 de agosto de 1994"
23,2,8,208,360,204,564,"21 de agosto de 1994"
23,2,8,209,819,623,1442,"21 de agosto de 1994"
23,2,8,210,338,255,593,"21 de agosto de 1994"
23,2,8,211,555,533,1088,"21 de agosto de 1994"
23,2,8,212,31,30,61,"21 de agosto de 1994"
23,2,8,213,35,18,53,"21 de agosto de 1994"
23,2,8,214,103,74,177,"21 de agosto de 1994"
24,1,28,773,221,262,483,"21 de agosto de 1994"
24,1,28,774,466,575,1041,"21 de agosto de 1994"
24,1,28,775,429,487,916,"21 de agosto de 1994"
24,1,28,776,317,397,714,"21 de agosto de 1994"
24,1,28,777,347,409,756,"21 de agosto de 1994"
24,1,28,778,485,579,1064,"21 de agosto de 1994"
24,1,28,779,361,409,770,"21 de agosto de 1994"
24,1,28,780,540,575,1115,"21 de agosto de 1994"
24,1,28,781,369,438,807,"21 de agosto de 1994"
24,1,28,782,564,642,1206,"21 de agosto de 1994"
24,1,28,783,418,501,919,"21 de agosto de 1994"
24,1,28,784,560,696,1256,"21 de agosto de 1994"
24,1,28,785,531,617,1148,"21 de agosto de 1994"
24,1,28,786,256,306,562,"21 de agosto de 1994"
24,1,28,787,753,869,1622,"21 de agosto de 1994"
24,1,28,788,288,350,638,"21 de agosto de 1994"
24,1,28,789,192,236,428,"21 de agosto de 1994"
24,1,28,790,752,888,1640,"21 de agosto de 1994"
24,1,28,791,515,611,1126,"21 de agosto de 1994"
24,1,28,792,632,724,1356,"21 de agosto de 1994"
24,1,28,793,385,519,904,"21 de agosto de 1994"
24,1,28,794,683,755,1438,"21 de agosto de 1994"
24,1,28,795,696,777,1473,"21 de agosto de 1994"
24,1,28,796,433,538,971,"21 de agosto de 1994"
24,1,28,797,408,430,838,"21 de agosto de 1994"
24,1,28,798,497,542,1039,"21 de agosto de 1994"
24,1,28,799,281,371,652,"21 de agosto de 1994"
24,1,28,800,513,647,1160,"21 de agosto de 1994"
24,1,28,801,627,766,1393,"21 de agosto de 1994"
24,1,28,802,571,652,1223,"21 de agosto de 1994"
24,1,28,803,647,735,1382,"21 de agosto de 1994"
24,1,28,804,214,265,479,"21 de agosto de 1994"
24,1,28,805,411,475,886,"21 de agosto de 1994"
24,1,28,806,456,556,1012,"21 de agosto de 1994"
24,1,28,807,502,625,1127,"21 de agosto de 1994"
24,1,28,808,752,830,1582,"21 de agosto de 1994"
24,1,28,809,699,805,1504,"21 de agosto de 1994"
24,1,28,810,469,531,1000,"21 de agosto de 1994"
24,1,28,811,337,435,772,"21 de agosto de 1994"
24,1,28,812,490,572,1062,"21 de agosto de 1994"
24,1,28,813,350,420,770,"21 de agosto de 1994"
24,1,28,814,328,365,693,"21 de agosto de 1994"
24,1,28,815,197,227,424,"21 de agosto de 1994"
24,1,28,816,449,505,954,"21 de agosto de 1994"
24,1,28,817,375,446,821,"21 de agosto de 1994"
24,1,28,818,338,386,724,"21 de agosto de 1994"
24,1,28,819,433,495,928,"21 de agosto de 1994"
24,1,28,820,357,435,792,"21 de agosto de 1994"
24,1,28,821,548,628,1176,"21 de agosto de 1994"
24,1,28,822,466,512,978,"21 de agosto de 1994"
24,1,28,823,515,670,1185,"21 de agosto de 1994"
24,1,28,824,513,655,1168,"21 de agosto de 1994"
24,1,28,825,411,485,896,"21 de agosto de 1994"
24,1,28,826,579,609,1188,"21 de agosto de 1994"
24,1,28,827,416,540,956,"21 de agosto de 1994"
24,1,28,828,788,906,1694,"21 de agosto de 1994"
24,1,28,829,691,761,1452,"21 de agosto de 1994"
24,1,28,830,531,564,1095,"21 de agosto de 1994"
24,1,28,831,502,607,1109,"21 de agosto de 1994"
24,1,28,832,442,514,956,"21 de agosto de 1994"
24,1,28,833,800,865,1665,"21 de agosto de 1994"
24,1,28,834,688,766,1454,"21 de agosto de 1994"
24,1,28,835,461,533,994,"21 de agosto de 1994"
24,1,28,836,276,335,611,"21 de agosto de 1994"
24,1,28,837,371,443,814,"21 de agosto de 1994"
24,1,28,838,332,375,707,"21 de agosto de 1994"
24,1,28,839,395,477,872,"21 de agosto de 1994"
24,1,28,840,477,566,1043,"21 de agosto de 1994"
24,1,28,841,360,441,801,"21 de agosto de 1994"
24,1,28,842,628,869,1497,"21 de agosto de 1994"
24,1,28,843,545,661,1206,"21 de agosto de 1994"
24,1,28,844,517,609,1126,"21 de agosto de 1994"
24,1,28,845,380,473,853,"21 de agosto de 1994"
24,1,28,846,350,377,727,"21 de agosto de 1994"
24,1,28,847,611,685,1296,"21 de agosto de 1994"
24,1,28,848,545,664,1209,"21 de agosto de 1994"
24,1,28,849,498,542,1040,"21 de agosto de 1994"
24,1,28,850,367,432,799,"21 de agosto de 1994"
24,1,28,851,652,820,1472,"21 de agosto de 1994"
24,1,28,852,384,455,839,"21 de agosto de 1994"
24,1,28,853,265,304,569,"21 de agosto de 1994"
24,1,28,854,428,518,946,"21 de agosto de 1994"
24,1,28,855,321,384,705,"21 de agosto de 1994"
24,1,28,856,438,503,941,"21 de agosto de 1994"
24,1,28,857,582,642,1224,"21 de agosto de 1994"
24,1,28,858,267,322,589,"21 de agosto de 1994"
24,1,28,859,466,575,1041,"21 de agosto de 1994"
24,1,28,860,503,627,1130,"21 de agosto de 1994"
24,1,28,861,282,328,610,"21 de agosto de 1994"
24,1,28,862,345,415,760,"21 de agosto de 1994"
24,1,28,863,607,761,1368,"21 de agosto de 1994"
24,1,28,864,327,373,700,"21 de agosto de 1994"
24,1,28,865,367,444,811,"21 de agosto de 1994"
24,1,28,866,520,620,1140,"21 de agosto de 1994"
24,1,28,867,434,470,904,"21 de agosto de 1994"
24,1,28,868,552,733,1285,"21 de agosto de 1994"
24,1,28,869,335,380,715,"21 de agosto de 1994"
24,1,28,870,543,671,1214,"21 de agosto de 1994"
24,1,28,871,480,640,1120,"21 de agosto de 1994"
24,1,28,872,370,459,829,"21 de agosto de 1994"
24,1,28,873,178,212,390,"21 de agosto de 1994"
24,1,28,874,326,400,726,"21 de agosto de 1994"
24,1,28,875,277,374,651,"21 de agosto de 1994"
24,1,28,876,395,476,871,"21 de agosto de 1994"
24,1,28,877,641,770,1411,"21 de agosto de 1994"
24,1,28,878,469,593,1062,"21 de agosto de 1994"
24,1,28,879,207,244,451,"21 de agosto de 1994"
24,1,28,880,295,336,631,"21 de agosto de 1994"
24,1,28,881,261,304,565,"21 de agosto de 1994"
24,1,28,882,196,227,423,"21 de agosto de 1994"
24,1,28,883,474,598,1072,"21 de agosto de 1994"
24,1,28,884,405,520,925,"21 de agosto de 1994"
24,1,28,885,520,630,1150,"21 de agosto de 1994"
24,1,28,886,554,639,1193,"21 de agosto de 1994"
24,1,28,887,357,466,823,"21 de agosto de 1994"
24,1,28,888,521,648,1169,"21 de agosto de 1994"
24,1,28,889,406,488,894,"21 de agosto de 1994"
24,1,28,890,503,699,1202,"21 de agosto de 1994"
24,1,28,891,211,247,458,"21 de agosto de 1994"
24,1,28,892,112,123,235,"21 de agosto de 1994"
24,1,28,893,122,184,306,"21 de agosto de 1994"
24,1,28,894,109,105,214,"21 de agosto de 1994"
24,1,28,895,256,272,528,"21 de agosto de 1994"
24,1,28,896,532,640,1172,"21 de agosto de 1994"
24,1,28,897,347,434,781,"21 de agosto de 1994"
24,1,28,898,294,332,626,"21 de agosto de 1994"
24,1,28,899,248,301,549,"21 de agosto de 1994"
24,1,28,900,267,325,592,"21 de agosto de 1994"
24,1,28,901,433,498,931,"21 de agosto de 1994"
24,1,28,902,277,399,676,"21 de agosto de 1994"
24,1,28,903,276,476,752,"21 de agosto de 1994"
24,1,28,904,415,547,962,"21 de agosto de 1994"
24,1,28,905,234,280,514,"21 de agosto de 1994"
24,1,28,906,504,735,1239,"21 de agosto de 1994"
24,1,28,907,536,664,1200,"21 de agosto de 1994"
24,1,28,908,363,458,821,"21 de agosto de 1994"
24,1,28,909,286,426,712,"21 de agosto de 1994"
24,1,28,910,570,673,1243,"21 de agosto de 1994"
24,1,28,911,298,356,654,"21 de agosto de 1994"
24,1,28,912,359,427,786,"21 de agosto de 1994"
24,1,28,913,577,651,1228,"21 de agosto de 1994"
24,1,28,914,441,518,959,"21 de agosto de 1994"
24,1,28,915,548,664,1212,"21 de agosto de 1994"
24,1,28,916,487,622,1109,"21 de agosto de 1994"
24,1,28,917,201,278,479,"21 de agosto de 1994"
24,1,28,918,257,368,625,"21 de agosto de 1994"
24,1,28,919,323,402,725,"21 de agosto de 1994"
24,1,28,920,379,500,879,"21 de agosto de 1994"
24,1,28,921,698,818,1516,"21 de agosto de 1994"
24,1,28,922,512,608,1120,"21 de agosto de 1994"
24,1,28,923,101,118,219,"21 de agosto de 1994"
24,1,28,924,347,442,789,"21 de agosto de 1994"
24,1,28,925,308,381,689,"21 de agosto de 1994"
24,1,28,926,520,616,1136,"21 de agosto de 1994"
24,1,28,927,376,536,912,"21 de agosto de 1994"
24,1,28,928,188,261,449,"21 de agosto de 1994"
24,1,28,929,114,120,234,"21 de agosto de 1994"
24,1,28,930,202,220,422,"21 de agosto de 1994"
24,1,28,931,580,784,1364,"21 de agosto de 1994"
24,1,28,932,523,643,1166,"21 de agosto de 1994"
24,1,28,933,245,281,526,"21 de agosto de 1994"
24,1,28,934,697,709,1406,"21 de agosto de 1994"
24,1,28,935,448,533,981,"21 de agosto de 1994"
24,1,28,936,505,582,1087,"21 de agosto de 1994"
24,1,28,937,480,559,1039,"21 de agosto de 1994"
24,1,28,938,397,516,913,"21 de agosto de 1994"
24,1,28,939,481,568,1049,"21 de agosto de 1994"
24,1,28,940,525,568,1093,"21 de agosto de 1994"
24,1,28,941,587,663,1250,"21 de agosto de 1994"
24,1,28,942,539,568,1107,"21 de agosto de 1994"
24,1,28,943,649,735,1384,"21 de agosto de 1994"
24,1,28,944,752,870,1622,"21 de agosto de 1994"
24,1,28,945,506,583,1089,"21 de agosto de 1994"
24,1,28,946,322,388,710,"21 de agosto de 1994"
24,1,28,947,449,554,1003,"21 de agosto de 1994"
24,1,28,948,421,450,871,"21 de agosto de 1994"
24,1,28,949,293,364,657,"21 de agosto de 1994"
24,1,28,950,421,521,942,"21 de agosto de 1994"
24,1,28,951,168,213,381,"21 de agosto de 1994"
24,1,28,952,337,387,724,"21 de agosto de 1994"
24,1,28,953,460,526,986,"21 de agosto de 1994"
24,1,28,954,362,406,768,"21 de agosto de 1994"
24,1,28,955,478,576,1054,"21 de agosto de 1994"
24,1,28,956,390,485,875,"21 de agosto de 1994"
24,1,28,957,427,494,921,"21 de agosto de 1994"
24,1,28,958,464,507,971,"21 de agosto de 1994"
24,1,28,959,365,442,807,"21 de agosto de 1994"
24,1,28,960,276,332,608,"21 de agosto de 1994"
24,1,28,961,718,784,1502,"21 de agosto de 1994"
24,1,28,962,379,481,860,"21 de agosto de 1994"
24,1,28,963,453,527,980,"21 de agosto de 1994"
24,1,28,964,410,503,913,"21 de agosto de 1994"
24,1,28,965,1113,1310,2423,"21 de agosto de 1994"
24,1,28,966,478,544,1022,"21 de agosto de 1994"
24,1,28,967,663,738,1401,"21 de agosto de 1994"
24,1,28,968,425,459,884,"21 de agosto de 1994"
24,1,28,969,453,527,980,"21 de agosto de 1994"
24,1,28,970,359,439,798,"21 de agosto de 1994"
24,1,28,971,263,304,567,"21 de agosto de 1994"
24,1,28,972,438,512,950,"21 de agosto de 1994"
24,1,28,973,287,316,603,"21 de agosto de 1994"
24,1,28,974,160,188,348,"21 de agosto de 1994"
24,1,28,975,59,59,118,"21 de agosto de 1994"
24,1,28,976,414,485,899,"21 de agosto de 1994"
24,1,28,977,466,487,953,"21 de agosto de 1994"
24,1,28,978,215,251,466,"21 de agosto de 1994"
24,1,28,979,419,464,883,"21 de agosto de 1994"
24,1,28,980,294,373,667,"21 de agosto de 1994"
24,1,28,981,277,314,591,"21 de agosto de 1994"
24,1,28,982,414,476,890,"21 de agosto de 1994"
24,1,28,983,254,283,537,"21 de agosto de 1994"
24,1,28,984,208,247,455,"21 de agosto de 1994"
24,1,28,985,502,610,1112,"21 de agosto de 1994"
24,1,28,995,0,1,1,"21 de agosto de 1994"
24,1,28,1004,1,0,1,"21 de agosto de 1994"
24,1,28,1277,3,5,8,"21 de agosto de 1994"
24,1,28,1298,0,1,1,"21 de agosto de 1994"
24,1,28,1500,0,1,1,"21 de agosto de 1994"
24,1,28,1613,1,0,1,"21 de agosto de 1994"
24,1,28,1625,1,0,1,"21 de agosto de 1994"
24,1,28,1727,0,1,1,"21 de agosto de 1994"
24,1,28,1790,1,0,1,"21 de agosto de 1994"
24,2,6,98,242,240,482,"21 de agosto de 1994"
24,2,6,99,42,42,84,"21 de agosto de 1994"
24,2,6,100,31,23,54,"21 de agosto de 1994"
24,2,6,101,99,61,160,"21 de agosto de 1994"
24,2,6,102,116,90,206,"21 de agosto de 1994"
24,2,6,103,173,149,322,"21 de agosto de 1994"
24,2,6,104,29,20,49,"21 de agosto de 1994"
24,2,6,105,145,98,243,"21 de agosto de 1994"
24,2,6,106,336,299,635,"21 de agosto de 1994"
24,2,6,107,73,54,127,"21 de agosto de 1994"
24,2,6,108,177,163,340,"21 de agosto de 1994"
24,2,6,109,46,50,96,"21 de agosto de 1994"
24,2,6,110,76,73,149,"21 de agosto de 1994"
24,2,6,111,129,114,243,"21 de agosto de 1994"
24,2,6,112,230,237,467,"21 de agosto de 1994"
24,2,6,113,112,122,234,"21 de agosto de 1994"
24,2,6,114,61,60,121,"21 de agosto de 1994"
24,2,6,115,98,96,194,"21 de agosto de 1994"
24,2,6,116,143,138,281,"21 de agosto de 1994"
24,2,6,117,104,100,204,"21 de agosto de 1994"
24,2,6,118,200,168,368,"21 de agosto de 1994"
24,2,7,119,607,643,1250,"21 de agosto de 1994"
24,2,7,120,434,461,895,"21 de agosto de 1994"
24,2,7,121,485,554,1039,"21 de agosto de 1994"
24,2,7,122,413,434,847,"21 de agosto de 1994"
24,2,7,123,82,63,145,"21 de agosto de 1994"
24,2,7,124,122,106,228,"21 de agosto de 1994"
24,2,7,125,185,163,348,"21 de agosto de 1994"
24,2,7,126,176,147,323,"21 de agosto de 1994"
24,2,7,127,161,128,289,"21 de agosto de 1994"
24,2,7,128,193,176,369,"21 de agosto de 1994"
24,2,7,129,65,59,124,"21 de agosto de 1994"
24,2,7,130,90,82,172,"21 de agosto de 1994"
24,2,7,131,271,237,508,"21 de agosto de 1994"
24,2,7,132,91,92,183,"21 de agosto de 1994"
24,2,7,133,149,123,272,"21 de agosto de 1994"
24,2,7,134,125,105,230,"21 de agosto de 1994"
24,2,7,135,198,178,376,"21 de agosto de 1994"
24,2,15,384,402,404,806,"21 de agosto de 1994"
24,2,15,385,185,247,432,"21 de agosto de 1994"
24,2,15,386,282,330,612,"21 de agosto de 1994"
24,2,15,387,338,360,698,"21 de agosto de 1994"
24,2,15,388,323,355,678,"21 de agosto de 1994"
24,2,15,389,262,286,548,"21 de agosto de 1994"
24,2,15,390,266,295,561,"21 de agosto de 1994"
24,2,15,391,328,378,706,"21 de agosto de 1994"
24,2,15,392,473,491,964,"21 de agosto de 1994"
24,2,15,393,117,94,211,"21 de agosto de 1994"
24,2,15,394,311,233,544,"21 de agosto de 1994"
24,2,15,395,135,85,220,"21 de agosto de 1994"
24,2,15,396,510,419,929,"21 de agosto de 1994"
24,2,15,397,142,119,261,"21 de agosto de 1994"
24,2,15,398,170,159,329,"21 de agosto de 1994"
24,2,15,399,84,63,147,"21 de agosto de 1994"
24,2,15,400,73,58,131,"21 de agosto de 1994"
24,2,15,401,359,329,688,"21 de agosto de 1994"
24,2,15,402,411,374,785,"21 de agosto de 1994"
24,2,15,403,333,324,657,"21 de agosto de 1994"
24,2,15,404,221,193,414,"21 de agosto de 1994"
24,2,20,490,339,408,747,"21 de agosto de 1994"
24,2,20,491,290,341,631,"21 de agosto de 1994"
24,2,20,492,30,34,64,"21 de agosto de 1994"
24,2,20,493,197,265,462,"21 de agosto de 1994"
24,2,20,494,158,206,364,"21 de agosto de 1994"
24,2,20,495,203,250,453,"21 de agosto de 1994"
24,2,20,496,261,313,574,"21 de agosto de 1994"
24,2,20,497,190,210,400,"21 de agosto de 1994"
24,2,20,498,372,460,832,"21 de agosto de 1994"
24,2,20,499,196,237,433,"21 de agosto de 1994"
24,2,20,500,89,98,187,"21 de agosto de 1994"
24,2,20,501,663,782,1445,"21 de agosto de 1994"
24,2,20,502,453,518,971,"21 de agosto de 1994"
24,2,20,503,244,270,514,"21 de agosto de 1994"
24,2,20,504,560,591,1151,"21 de agosto de 1994"
24,2,20,505,487,565,1052,"21 de agosto de 1994"
24,2,20,506,357,485,842,"21 de agosto de 1994"
24,2,20,507,453,616,1069,"21 de agosto de 1994"
24,2,20,508,406,551,957,"21 de agosto de 1994"
24,2,20,509,462,583,1045,"21 de agosto de 1994"
24,2,20,510,214,271,485,"21 de agosto de 1994"
24,2,20,511,515,637,1152,"21 de agosto de 1994"
24,2,20,512,427,535,962,"21 de agosto de 1994"
24,2,20,513,393,475,868,"21 de agosto de 1994"
24,2,20,514,248,317,565,"21 de agosto de 1994"
24,2,20,515,215,275,490,"21 de agosto de 1994"
24,2,20,516,345,424,769,"21 de agosto de 1994"
24,2,20,517,454,580,1034,"21 de agosto de 1994"
24,2,20,518,398,465,863,"21 de agosto de 1994"
24,2,20,519,320,404,724,"21 de agosto de 1994"
24,2,20,520,418,555,973,"21 de agosto de 1994"
24,2,20,521,169,234,403,"21 de agosto de 1994"
24,2,20,522,321,385,706,"21 de agosto de 1994"
24,2,20,523,374,451,825,"21 de agosto de 1994"
24,2,20,524,436,534,970,"21 de agosto de 1994"
24,2,20,525,531,632,1163,"21 de agosto de 1994"
24,2,20,526,449,556,1005,"21 de agosto de 1994"
24,2,20,527,339,414,753,"21 de agosto de 1994"
24,2,20,528,175,168,343,"21 de agosto de 1994"
24,2,20,529,183,167,350,"21 de agosto de 1994"
24,2,20,530,129,113,242,"21 de agosto de 1994"
24,2,20,531,356,365,721,"21 de agosto de 1994"
24,2,20,532,256,258,514,"21 de agosto de 1994"
24,2,20,533,136,178,314,"21 de agosto de 1994"
24,2,20,534,86,93,179,"21 de agosto de 1994"
24,2,20,535,60,55,115,"21 de agosto de 1994"
24,2,20,536,144,146,290,"21 de agosto de 1994"
24,2,20,537,45,35,80,"21 de agosto de 1994"
24,2,20,538,52,37,89,"21 de agosto de 1994"
24,2,20,539,145,126,271,"21 de agosto de 1994"
24,2,20,540,160,182,342,"21 de agosto de 1994"
24,2,20,541,141,143,284,"21 de agosto de 1994"
24,2,20,542,80,60,140,"21 de agosto de 1994"
24,2,20,543,68,66,134,"21 de agosto de 1994"
24,2,20,544,139,138,277,"21 de agosto de 1994"
24,2,20,545,273,329,602,"21 de agosto de 1994"
24,2,20,546,114,106,220,"21 de agosto de 1994"
24,2,20,547,157,151,308,"21 de agosto de 1994"
24,2,20,548,122,126,248,"21 de agosto de 1994"
24,2,20,549,185,176,361,"21 de agosto de 1994"
24,2,20,550,120,121,241,"21 de agosto de 1994"
24,2,20,551,80,90,170,"21 de agosto de 1994"
24,2,20,552,216,191,407,"21 de agosto de 1994"
24,2,20,553,265,216,481,"21 de agosto de 1994"
24,2,20,554,160,144,304,"21 de agosto de 1994"
24,2,25,724,431,471,902,"21 de agosto de 1994"
24,2,25,725,424,491,915,"21 de agosto de 1994"
24,2,25,726,298,344,642,"21 de agosto de 1994"
24,2,25,727,265,317,582,"21 de agosto de 1994"
24,2,25,728,383,472,855,"21 de agosto de 1994"
24,2,25,729,221,305,526,"21 de agosto de 1994"
24,2,25,730,554,666,1220,"21 de agosto de 1994"
24,2,25,731,151,146,297,"21 de agosto de 1994"
24,2,25,732,105,92,197,"21 de agosto de 1994"
24,2,25,733,166,165,331,"21 de agosto de 1994"
24,2,25,734,77,60,137,"21 de agosto de 1994"
24,2,25,735,228,260,488,"21 de agosto de 1994"
24,2,25,736,128,103,231,"21 de agosto de 1994"
24,2,25,737,93,77,170,"21 de agosto de 1994"
24,2,25,738,69,56,125,"21 de agosto de 1994"
24,2,25,739,19,13,32,"21 de agosto de 1994"
24,2,25,740,392,433,825,"21 de agosto de 1994"
24,2,25,741,87,124,211,"21 de agosto de 1994"
24,2,25,742,230,248,478,"21 de agosto de 1994"
24,2,25,743,83,73,156,"21 de agosto de 1994"
24,2,25,744,107,175,282,"21 de agosto de 1994"
24,2,25,745,50,65,115,"21 de agosto de 1994"
24,2,25,746,416,395,811,"21 de agosto de 1994"
24,2,25,747,164,157,321,"21 de agosto de 1994"
24,2,34,1221,177,190,367,"21 de agosto de 1994"
24,2,34,1222,38,31,69,"21 de agosto de 1994"
24,2,34,1223,159,133,292,"21 de agosto de 1994"
24,2,34,1224,60,67,127,"21 de agosto de 1994"
24,2,34,1225,113,110,223,"21 de agosto de 1994"
24,2,34,1226,163,204,367,"21 de agosto de 1994"
24,2,34,1227,147,156,303,"21 de agosto de 1994"
24,2,34,1228,110,107,217,"21 de agosto de 1994"
24,2,34,1229,198,146,344,"21 de agosto de 1994"
24,2,34,1230,65,55,120,"21 de agosto de 1994"
24,2,34,1231,50,46,96,"21 de agosto de 1994"
24,2,34,1232,57,68,125,"21 de agosto de 1994"
24,2,34,1233,144,144,288,"21 de agosto de 1994"
24,2,34,1234,115,107,222,"21 de agosto de 1994"
24,2,34,1235,88,97,185,"21 de agosto de 1994"
24,2,34,1236,114,101,215,"21 de agosto de 1994"
24,2,34,1237,225,229,454,"21 de agosto de 1994"
24,2,34,1238,610,576,1186,"21 de agosto de 1994"
24,2,34,1239,67,54,121,"21 de agosto de 1994"
24,2,34,1240,441,350,791,"21 de agosto de 1994"
24,2,34,1241,94,93,187,"21 de agosto de 1994"
24,2,44,1520,282,281,563,"21 de agosto de 1994"
24,2,44,1521,154,159,313,"21 de agosto de 1994"
24,2,44,1522,294,304,598,"21 de agosto de 1994"
24,2,44,1523,52,33,85,"21 de agosto de 1994"
24,2,44,1524,93,66,159,"21 de agosto de 1994"
24,2,44,1525,176,145,321,"21 de agosto de 1994"
24,2,44,1526,122,94,216,"21 de agosto de 1994"
24,2,44,1527,193,159,352,"21 de agosto de 1994"
24,2,44,1528,95,76,171,"21 de agosto de 1994"
24,2,44,1529,30,30,60,"21 de agosto de 1994"
24,2,44,1530,67,61,128,"21 de agosto de 1994"
24,2,44,1531,147,117,264,"21 de agosto de 1994"
24,2,44,1532,101,85,186,"21 de agosto de 1994"
24,2,44,1533,62,64,126,"21 de agosto de 1994"
24,2,44,1534,120,117,237,"21 de agosto de 1994"
24,2,44,1535,33,25,58,"21 de agosto de 1994"
24,2,45,1536,253,274,527,"21 de agosto de 1994"
24,2,45,1537,243,272,515,"21 de agosto de 1994"
24,2,45,1538,314,373,687,"21 de agosto de 1994"
24,2,45,1539,304,368,672,"21 de agosto de 1994"
24,2,45,1540,155,150,305,"21 de agosto de 1994"
24,2,45,1541,151,155,306,"21 de agosto de 1994"
24,2,45,1542,110,85,195,"21 de agosto de 1994"
24,2,45,1543,101,91,192,"21 de agosto de 1994"
24,2,45,1544,440,399,839,"21 de agosto de 1994"
24,2,45,1545,313,306,619,"21 de agosto de 1994"
24,2,45,1546,188,183,371,"21 de agosto de 1994"
24,2,45,1547,121,139,260,"21 de agosto de 1994"
24,2,45,1548,50,61,111,"21 de agosto de 1994"
24,2,45,1549,82,85,167,"21 de agosto de 1994"
24,2,45,1550,162,153,315,"21 de agosto de 1994"
24,2,45,1551,161,137,298,"21 de agosto de 1994"
24,2,45,1552,93,109,202,"21 de agosto de 1994"
24,2,45,1553,128,136,264,"21 de agosto de 1994"
24,2,45,1554,118,103,221,"21 de agosto de 1994"
24,2,45,1555,140,121,261,"21 de agosto de 1994"
24,2,46,1556,598,575,1173,"21 de agosto de 1994"
24,2,46,1557,569,561,1130,"21 de agosto de 1994"
24,2,46,1558,336,353,689,"21 de agosto de 1994"
24,2,46,1559,86,77,163,"21 de agosto de 1994"
24,2,46,1560,68,56,124,"21 de agosto de 1994"
24,2,46,1561,252,217,469,"21 de agosto de 1994"
24,2,46,1562,159,148,307,"21 de agosto de 1994"
24,2,46,1563,98,90,188,"21 de agosto de 1994"
24,2,46,1564,165,168,333,"21 de agosto de 1994"
24,2,46,1565,462,394,856,"21 de agosto de 1994"
24,2,46,1566,108,93,201,"21 de agosto de 1994"
24,2,46,1567,291,313,604,"21 de agosto de 1994"
24,2,46,1568,120,104,224,"21 de agosto de 1994"
24,2,48,1587,272,308,580,"21 de agosto de 1994"
24,2,48,1588,167,207,374,"21 de agosto de 1994"
24,2,48,1589,95,92,187,"21 de agosto de 1994"
24,2,48,1590,217,236,453,"21 de agosto de 1994"
24,2,48,1591,94,112,206,"21 de agosto de 1994"
24,2,48,1592,24,38,62,"21 de agosto de 1994"
24,2,48,1593,125,154,279,"21 de agosto de 1994"
24,2,48,1594,46,43,89,"21 de agosto de 1994"
24,2,48,1595,34,42,76,"21 de agosto de 1994"
24,2,48,1596,143,142,285,"21 de agosto de 1994"
24,2,48,1597,167,146,313,"21 de agosto de 1994"
24,2,48,1598,362,333,695,"21 de agosto de 1994"
24,2,48,1599,200,188,388,"21 de agosto de 1994"
24,2,48,1600,78,74,152,"21 de agosto de 1994"
24,2,48,1601,327,272,599,"21 de agosto de 1994"
24,2,48,1602,105,86,191,"21 de agosto de 1994"
24,2,48,1603,98,99,197,"21 de agosto de 1994"
24,2,49,1604,86,106,192,"21 de agosto de 1994"
24,2,49,1605,346,381,727,"21 de agosto de 1994"
24,2,49,1606,210,204,414,"21 de agosto de 1994"
24,2,49,1607,208,192,400,"21 de agosto de 1994"
24,2,49,1608,165,181,346,"21 de agosto de 1994"
24,2,49,1609,103,116,219,"21 de agosto de 1994"
24,2,49,1610,162,148,310,"21 de agosto de 1994"
24,2,49,1611,119,114,233,"21 de agosto de 1994"
24,2,50,1612,365,401,766,"21 de agosto de 1994"
24,2,50,1613,417,482,899,"21 de agosto de 1994"
24,2,50,1614,86,67,153,"21 de agosto de 1994"
24,2,50,1615,525,486,1011,"21 de agosto de 1994"
24,2,50,1616,443,412,855,"21 de agosto de 1994"
24,2,50,1617,305,316,621,"21 de agosto de 1994"
24,2,50,1618,323,293,616,"21 de agosto de 1994"
24,2,50,1619,336,302,638,"21 de agosto de 1994"
24,2,50,1620,367,347,714,"21 de agosto de 1994"
24,2,50,1621,86,72,158,"21 de agosto de 1994"
24,2,50,1622,532,446,978,"21 de agosto de 1994"
24,2,50,1623,501,456,957,"21 de agosto de 1994"
24,2,50,1624,116,110,226,"21 de agosto de 1994"
24,2,50,1625,122,110,232,"21 de agosto de 1994"
24,2,50,1626,43,42,85,"21 de agosto de 1994"
24,2,50,1627,146,161,307,"21 de agosto de 1994"
24,2,50,1628,263,308,571,"21 de agosto de 1994"
24,2,50,1629,507,555,1062,"21 de agosto de 1994"
24,2,50,1630,206,223,429,"21 de agosto de 1994"
24,2,50,1631,460,502,962,"21 de agosto de 1994"
24,2,50,1632,323,350,673,"21 de agosto de 1994"
24,2,50,1633,260,281,541,"21 de agosto de 1994"
24,2,50,1634,81,86,167,"21 de agosto de 1994"
24,2,50,1635,81,86,167,"21 de agosto de 1994"
24,2,50,1636,9,25,34,"21 de agosto de 1994"
24,2,50,1637,50,65,115,"21 de agosto de 1994"
24,2,52,1670,294,348,642,"21 de agosto de 1994"
24,2,52,1671,294,328,622,"21 de agosto de 1994"
24,2,52,1672,217,259,476,"21 de agosto de 1994"
24,2,52,1673,237,218,455,"21 de agosto de 1994"
24,2,52,1674,356,281,637,"21 de agosto de 1994"
24,2,52,1675,254,242,496,"21 de agosto de 1994"
24,2,52,1676,196,229,425,"21 de agosto de 1994"
24,2,52,1677,231,235,466,"21 de agosto de 1994"
24,2,52,1678,84,75,159,"21 de agosto de 1994"
24,2,52,1679,171,171,342,"21 de agosto de 1994"
24,2,52,1680,362,367,729,"21 de agosto de 1994"
24,2,52,1681,99,98,197,"21 de agosto de 1994"
24,2,52,1682,110,117,227,"21 de agosto de 1994"
24,2,52,1683,146,156,302,"21 de agosto de 1994"
24,2,52,1684,90,99,189,"21 de agosto de 1994"
24,2,52,1685,379,386,765,"21 de agosto de 1994"
24,2,52,1686,159,158,317,"21 de agosto de 1994"
24,2,52,1687,155,137,292,"21 de agosto de 1994"
24,2,52,1688,121,124,245,"21 de agosto de 1994"
24,3,11,220,215,280,495,"21 de agosto de 1994"
24,3,11,221,340,420,760,"21 de agosto de 1994"
24,3,11,222,373,377,750,"21 de agosto de 1994"
24,3,11,223,291,350,641,"21 de agosto de 1994"
24,3,11,224,365,406,771,"21 de agosto de 1994"
24,3,11,225,435,507,942,"21 de agosto de 1994"
24,3,11,226,338,426,764,"21 de agosto de 1994"
24,3,11,227,308,328,636,"21 de agosto de 1994"
24,3,11,228,541,630,1171,"21 de agosto de 1994"
24,3,11,229,246,281,527,"21 de agosto de 1994"
24,3,11,230,361,440,801,"21 de agosto de 1994"
24,3,11,231,364,452,816,"21 de agosto de 1994"
24,3,11,232,430,454,884,"21 de agosto de 1994"
24,3,11,233,280,359,639,"21 de agosto de 1994"
24,3,11,234,340,368,708,"21 de agosto de 1994"
24,3,11,235,81,97,178,"21 de agosto de 1994"
24,3,11,236,129,130,259,"21 de agosto de 1994"
24,3,11,237,84,85,169,"21 de agosto de 1994"
24,3,11,238,83,101,184,"21 de agosto de 1994"
24,3,11,239,53,51,104,"21 de agosto de 1994"
24,3,11,240,49,54,103,"21 de agosto de 1994"
24,3,11,241,272,262,534,"21 de agosto de 1994"
24,3,11,242,164,190,354,"21 de agosto de 1994"
24,3,11,243,467,503,970,"21 de agosto de 1994"
24,3,11,244,72,88,160,"21 de agosto de 1994"
24,3,11,245,271,273,544,"21 de agosto de 1994"
24,3,11,246,405,387,792,"21 de agosto de 1994"
24,3,11,247,275,293,568,"21 de agosto de 1994"
24,3,11,248,169,188,357,"21 de agosto de 1994"
24,3,11,249,218,219,437,"21 de agosto de 1994"
24,3,11,250,152,176,328,"21 de agosto de 1994"
24,3,21,555,385,369,754,"21 de agosto de 1994"
24,3,21,556,511,575,1086,"21 de agosto de 1994"
24,3,21,557,224,235,459,"21 de agosto de 1994"
24,3,21,558,217,305,522,"21 de agosto de 1994"
24,3,21,559,434,547,981,"21 de agosto de 1994"
24,3,21,560,301,335,636,"21 de agosto de 1994"
24,3,21,561,355,411,766,"21 de agosto de 1994"
24,3,21,562,308,309,617,"21 de agosto de 1994"
24,3,21,563,64,61,125,"21 de agosto de 1994"
24,3,21,564,114,140,254,"21 de agosto de 1994"
24,3,21,565,420,421,841,"21 de agosto de 1994"
24,3,21,566,252,284,536,"21 de agosto de 1994"
24,3,21,567,97,104,201,"21 de agosto de 1994"
24,3,21,568,267,269,536,"21 de agosto de 1994"
24,3,21,569,75,72,147,"21 de agosto de 1994"
24,3,21,570,191,176,367,"21 de agosto de 1994"
24,3,21,571,181,204,385,"21 de agosto de 1994"
24,3,21,572,395,374,769,"21 de agosto de 1994"
24,3,21,573,428,441,869,"21 de agosto de 1994"
24,3,21,574,215,210,425,"21 de agosto de 1994"
24,3,21,575,89,98,187,"21 de agosto de 1994"
24,3,21,576,98,106,204,"21 de agosto de 1994"
24,3,21,577,271,258,529,"21 de agosto de 1994"
24,3,21,578,281,280,561,"21 de agosto de 1994"
24,3,21,579,295,304,599,"21 de agosto de 1994"
24,3,21,580,394,412,806,"21 de agosto de 1994"
24,3,21,581,261,252,513,"21 de agosto de 1994"
24,3,21,582,277,282,559,"21 de agosto de 1994"
24,3,21,583,235,238,473,"21 de agosto de 1994"
24,3,21,584,255,243,498,"21 de agosto de 1994"
24,3,21,585,230,324,554,"21 de agosto de 1994"
24,3,21,586,379,521,900,"21 de agosto de 1994"
24,3,21,587,251,274,525,"21 de agosto de 1994"
24,3,21,588,341,368,709,"21 de agosto de 1994"
24,3,21,589,352,406,758,"21 de agosto de 1994"
24,3,21,590,264,295,559,"21 de agosto de 1994"
24,3,24,634,255,290,545,"21 de agosto de 1994"
24,3,24,635,190,206,396,"21 de agosto de 1994"
24,3,24,636,350,438,788,"21 de agosto de 1994"
24,3,24,637,325,399,724,"21 de agosto de 1994"
24,3,24,638,615,755,1370,"21 de agosto de 1994"
24,3,24,639,344,429,773,"21 de agosto de 1994"
24,3,24,640,332,419,751,"21 de agosto de 1994"
24,3,24,641,519,673,1192,"21 de agosto de 1994"
24,3,24,642,381,439,820,"21 de agosto de 1994"
24,3,24,643,367,440,807,"21 de agosto de 1994"
24,3,24,644,214,270,484,"21 de agosto de 1994"
24,3,24,645,293,394,687,"21 de agosto de 1994"
24,3,24,646,415,479,894,"21 de agosto de 1994"
24,3,24,647,349,440,789,"21 de agosto de 1994"
24,3,24,648,390,480,870,"21 de agosto de 1994"
24,3,24,649,339,398,737,"21 de agosto de 1994"
24,3,24,650,411,485,896,"21 de agosto de 1994"
24,3,24,651,423,500,923,"21 de agosto de 1994"
24,3,24,652,270,298,568,"21 de agosto de 1994"
24,3,24,653,329,396,725,"21 de agosto de 1994"
24,3,24,654,271,343,614,"21 de agosto de 1994"
24,3,24,655,295,347,642,"21 de agosto de 1994"
24,3,24,656,225,259,484,"21 de agosto de 1994"
24,3,24,657,433,553,986,"21 de agosto de 1994"
24,3,24,658,404,476,880,"21 de agosto de 1994"
24,3,24,659,466,535,1001,"21 de agosto de 1994"
24,3,24,660,328,391,719,"21 de agosto de 1994"
24,3,24,661,342,373,715,"21 de agosto de 1994"
24,3,24,662,334,341,675,"21 de agosto de 1994"
24,3,24,663,232,220,452,"21 de agosto de 1994"
24,3,24,664,107,111,218,"21 de agosto de 1994"
24,3,24,665,288,295,583,"21 de agosto de 1994"
24,3,24,666,263,290,553,"21 de agosto de 1994"
24,3,24,667,85,64,149,"21 de agosto de 1994"
24,3,24,668,232,211,443,"21 de agosto de 1994"
24,3,24,669,33,27,60,"21 de agosto de 1994"
24,3,24,670,388,407,795,"21 de agosto de 1994"
24,3,24,671,135,132,267,"21 de agosto de 1994"
24,3,24,672,115,138,253,"21 de agosto de 1994"
24,3,24,673,148,172,320,"21 de agosto de 1994"
24,3,24,674,118,106,224,"21 de agosto de 1994"
24,3,24,675,145,139,284,"21 de agosto de 1994"
24,3,24,676,139,160,299,"21 de agosto de 1994"
24,3,24,677,108,116,224,"21 de agosto de 1994"
24,3,24,678,169,183,352,"21 de agosto de 1994"
24,3,24,679,115,126,241,"21 de agosto de 1994"
24,3,24,680,50,54,104,"21 de agosto de 1994"
24,3,24,681,217,228,445,"21 de agosto de 1994"
24,3,24,682,67,66,133,"21 de agosto de 1994"
24,3,24,683,256,300,556,"21 de agosto de 1994"
24,3,24,684,153,131,284,"21 de agosto de 1994"
24,3,24,685,161,190,351,"21 de agosto de 1994"
24,3,24,686,239,264,503,"21 de agosto de 1994"
24,3,24,687,69,62,131,"21 de agosto de 1994"
24,3,24,688,141,135,276,"21 de agosto de 1994"
24,3,24,689,412,389,801,"21 de agosto de 1994"
24,3,24,690,177,207,384,"21 de agosto de 1994"
24,3,24,691,80,80,160,"21 de agosto de 1994"
24,3,24,692,152,147,299,"21 de agosto de 1994"
24,3,24,693,169,136,305,"21 de agosto de 1994"
24,3,24,694,45,52,97,"21 de agosto de 1994"
24,3,24,695,326,368,694,"21 de agosto de 1994"
24,3,24,696,474,488,962,"21 de agosto de 1994"
24,3,24,697,386,408,794,"21 de agosto de 1994"
24,3,24,698,202,220,422,"21 de agosto de 1994"
24,3,24,699,151,177,328,"21 de agosto de 1994"
24,3,24,700,225,224,449,"21 de agosto de 1994"
24,3,24,701,107,129,236,"21 de agosto de 1994"
24,3,24,702,63,59,122,"21 de agosto de 1994"
24,3,24,703,140,121,261,"21 de agosto de 1994"
24,3,24,704,94,77,171,"21 de agosto de 1994"
24,3,24,705,136,164,300,"21 de agosto de 1994"
24,3,24,706,512,510,1022,"21 de agosto de 1994"
24,3,24,707,153,161,314,"21 de agosto de 1994"
24,3,24,708,56,57,113,"21 de agosto de 1994"
24,3,24,709,294,303,597,"21 de agosto de 1994"
24,3,24,710,84,73,157,"21 de agosto de 1994"
24,3,24,711,436,416,852,"21 de agosto de 1994"
24,3,24,712,39,41,80,"21 de agosto de 1994"
24,3,24,713,169,146,315,"21 de agosto de 1994"
24,3,24,714,70,81,151,"21 de agosto de 1994"
24,3,24,715,147,131,278,"21 de agosto de 1994"
24,3,24,716,108,101,209,"21 de agosto de 1994"
24,3,24,717,158,177,335,"21 de agosto de 1994"
24,3,24,718,85,72,157,"21 de agosto de 1994"
24,3,24,719,24,28,52,"21 de agosto de 1994"
24,3,24,720,166,161,327,"21 de agosto de 1994"
24,3,24,721,61,54,115,"21 de agosto de 1994"
24,3,24,722,126,118,244,"21 de agosto de 1994"
24,3,24,723,73,62,135,"21 de agosto de 1994"
24,3,24,1298,1,0,1,"21 de agosto de 1994"
24,3,30,1148,192,217,409,"21 de agosto de 1994"
24,3,30,1149,81,103,184,"21 de agosto de 1994"
24,3,30,1150,56,89,145,"21 de agosto de 1994"
24,3,30,1151,75,113,188,"21 de agosto de 1994"
24,3,30,1152,102,144,246,"21 de agosto de 1994"
24,3,30,1153,211,232,443,"21 de agosto de 1994"
24,3,30,1154,23,42,65,"21 de agosto de 1994"
24,3,30,1155,127,178,305,"21 de agosto de 1994"
24,3,30,1156,105,148,253,"21 de agosto de 1994"
24,3,30,1157,43,41,84,"21 de agosto de 1994"
24,3,30,1158,141,140,281,"21 de agosto de 1994"
24,3,30,1159,450,529,979,"21 de agosto de 1994"
24,3,33,1188,333,430,763,"21 de agosto de 1994"
24,3,33,1189,365,484,849,"21 de agosto de 1994"
24,3,33,1190,249,314,563,"21 de agosto de 1994"
24,3,33,1191,320,426,746,"21 de agosto de 1994"
24,3,33,1192,441,602,1043,"21 de agosto de 1994"
24,3,33,1193,500,664,1164,"21 de agosto de 1994"
24,3,33,1194,398,430,828,"21 de agosto de 1994"
24,3,33,1195,187,191,378,"21 de agosto de 1994"
24,3,33,1196,209,249,458,"21 de agosto de 1994"
24,3,33,1197,67,65,132,"21 de agosto de 1994"
24,3,33,1198,59,53,112,"21 de agosto de 1994"
24,3,33,1199,41,41,82,"21 de agosto de 1994"
24,3,33,1200,101,120,221,"21 de agosto de 1994"
24,3,33,1201,305,363,668,"21 de agosto de 1994"
24,3,33,1202,147,170,317,"21 de agosto de 1994"
24,3,33,1203,226,262,488,"21 de agosto de 1994"
24,3,33,1204,243,262,505,"21 de agosto de 1994"
24,3,33,1205,418,426,844,"21 de agosto de 1994"
24,3,33,1206,305,345,650,"21 de agosto de 1994"
24,3,33,1207,239,256,495,"21 de agosto de 1994"
24,3,33,1208,209,219,428,"21 de agosto de 1994"
24,3,33,1209,35,32,67,"21 de agosto de 1994"
24,3,33,1210,111,127,238,"21 de agosto de 1994"
24,3,33,1211,208,218,426,"21 de agosto de 1994"
24,3,33,1212,272,257,529,"21 de agosto de 1994"
24,3,33,1213,126,126,252,"21 de agosto de 1994"
24,3,33,1214,380,395,775,"21 de agosto de 1994"
24,3,33,1215,178,156,334,"21 de agosto de 1994"
24,3,33,1216,195,201,396,"21 de agosto de 1994"
24,3,33,1217,166,185,351,"21 de agosto de 1994"
24,3,33,1218,320,316,636,"21 de agosto de 1994"
24,3,33,1219,358,375,733,"21 de agosto de 1994"
24,3,33,1220,166,199,365,"21 de agosto de 1994"
24,3,43,1507,163,195,358,"21 de agosto de 1994"
24,3,43,1508,274,372,646,"21 de agosto de 1994"
24,3,43,1509,286,409,695,"21 de agosto de 1994"
24,3,43,1510,150,218,368,"21 de agosto de 1994"
24,3,43,1511,275,385,660,"21 de agosto de 1994"
24,3,43,1512,229,273,502,"21 de agosto de 1994"
24,3,43,1513,125,139,264,"21 de agosto de 1994"
24,3,43,1514,106,107,213,"21 de agosto de 1994"
24,3,43,1515,92,73,165,"21 de agosto de 1994"
24,3,43,1516,86,96,182,"21 de agosto de 1994"
24,3,43,1517,58,57,115,"21 de agosto de 1994"
24,3,43,1518,37,42,79,"21 de agosto de 1994"
24,3,43,1519,27,28,55,"21 de agosto de 1994"
24,3,47,1569,337,370,707,"21 de agosto de 1994"
24,3,47,1570,313,348,661,"21 de agosto de 1994"
24,3,47,1571,275,306,581,"21 de agosto de 1994"
24,3,47,1572,156,150,306,"21 de agosto de 1994"
24,3,47,1573,48,58,106,"21 de agosto de 1994"
24,3,47,1574,160,154,314,"21 de agosto de 1994"
24,3,47,1575,299,290,589,"21 de agosto de 1994"
24,3,47,1576,320,274,594,"21 de agosto de 1994"
24,3,47,1577,84,80,164,"21 de agosto de 1994"
24,3,47,1578,105,86,191,"21 de agosto de 1994"
24,3,47,1579,343,322,665,"21 de agosto de 1994"
24,3,47,1580,137,113,250,"21 de agosto de 1994"
24,3,47,1581,232,230,462,"21 de agosto de 1994"
24,3,47,1582,77,55,132,"21 de agosto de 1994"
24,3,47,1583,74,72,146,"21 de agosto de 1994"
24,3,47,1584,156,144,300,"21 de agosto de 1994"
24,3,47,1585,81,83,164,"21 de agosto de 1994"
24,3,47,1586,71,76,147,"21 de agosto de 1994"
24,3,51,1638,260,263,523,"21 de agosto de 1994"
24,3,51,1639,307,328,635,"21 de agosto de 1994"
24,3,51,1640,231,259,490,"21 de agosto de 1994"
24,3,51,1641,329,356,685,"21 de agosto de 1994"
24,3,51,1642,270,297,567,"21 de agosto de 1994"
24,3,51,1643,335,346,681,"21 de agosto de 1994"
24,3,51,1644,80,62,142,"21 de agosto de 1994"
24,3,51,1645,573,628,1201,"21 de agosto de 1994"
24,3,51,1646,364,403,767,"21 de agosto de 1994"
24,3,51,1647,253,251,504,"21 de agosto de 1994"
24,3,51,1648,276,252,528,"21 de agosto de 1994"
24,3,51,1649,179,209,388,"21 de agosto de 1994"
24,3,51,1650,35,47,82,"21 de agosto de 1994"
24,3,51,1651,133,138,271,"21 de agosto de 1994"
24,3,51,1652,428,511,939,"21 de agosto de 1994"
24,3,51,1653,551,542,1093,"21 de agosto de 1994"
24,3,51,1654,165,166,331,"21 de agosto de 1994"
24,3,51,1655,319,304,623,"21 de agosto de 1994"
24,3,51,1656,229,214,443,"21 de agosto de 1994"
24,3,51,1657,140,145,285,"21 de agosto de 1994"
24,3,51,1658,286,284,570,"21 de agosto de 1994"
24,3,51,1659,310,324,634,"21 de agosto de 1994"
24,3,51,1660,219,205,424,"21 de agosto de 1994"
24,3,51,1661,274,268,542,"21 de agosto de 1994"
24,3,51,1662,83,90,173,"21 de agosto de 1994"
24,3,51,1663,97,97,194,"21 de agosto de 1994"
24,3,51,1664,63,55,118,"21 de agosto de 1994"
24,3,51,1665,241,234,475,"21 de agosto de 1994"
24,3,51,1666,458,435,893,"21 de agosto de 1994"
24,3,51,1667,201,234,435,"21 de agosto de 1994"
24,3,51,1668,608,649,1257,"21 de agosto de 1994"
24,3,51,1669,125,122,247,"21 de agosto de 1994"
24,3,56,1773,470,486,956,"21 de agosto de 1994"
24,3,56,1774,355,331,686,"21 de agosto de 1994"
24,3,56,1775,472,485,957,"21 de agosto de 1994"
24,3,56,1776,668,568,1236,"21 de agosto de 1994"
24,3,56,1777,79,67,146,"21 de agosto de 1994"
24,3,56,1778,134,147,281,"21 de agosto de 1994"
24,3,56,1779,245,278,523,"21 de agosto de 1994"
24,3,56,1780,40,47,87,"21 de agosto de 1994"
24,3,56,1781,132,145,277,"21 de agosto de 1994"
24,3,56,1782,76,80,156,"21 de agosto de 1994"
24,3,56,1783,111,129,240,"21 de agosto de 1994"
24,3,56,1784,152,158,310,"21 de agosto de 1994"
24,3,56,1785,162,163,325,"21 de agosto de 1994"
24,3,56,1786,114,105,219,"21 de agosto de 1994"
24,3,56,1787,290,287,577,"21 de agosto de 1994"
24,3,56,1788,85,80,165,"21 de agosto de 1994"
24,3,56,1789,62,62,124,"21 de agosto de 1994"
24,3,56,1790,175,161,336,"21 de agosto de 1994"
24,3,56,1791,79,91,170,"21 de agosto de 1994"
24,3,56,1792,104,141,245,"21 de agosto de 1994"
24,3,56,1793,154,166,320,"21 de agosto de 1994"
24,3,56,1794,65,85,150,"21 de agosto de 1994"
24,3,56,1795,118,115,233,"21 de agosto de 1994"
24,4,2,15,110,118,228,"21 de agosto de 1994"
24,4,2,16,96,95,191,"21 de agosto de 1994"
24,4,2,17,83,100,183,"21 de agosto de 1994"
24,4,2,18,56,58,114,"21 de agosto de 1994"
24,4,2,19,125,116,241,"21 de agosto de 1994"
24,4,2,20,64,65,129,"21 de agosto de 1994"
24,4,2,21,58,61,119,"21 de agosto de 1994"
24,4,2,22,75,87,162,"21 de agosto de 1994"
24,4,2,23,208,186,394,"21 de agosto de 1994"
24,4,2,24,50,46,96,"21 de agosto de 1994"
24,4,2,25,26,32,58,"21 de agosto de 1994"
24,4,2,26,291,326,617,"21 de agosto de 1994"
24,4,2,27,39,60,99,"21 de agosto de 1994"
24,4,2,28,212,245,457,"21 de agosto de 1994"
24,4,2,29,57,67,124,"21 de agosto de 1994"
24,4,2,30,170,161,331,"21 de agosto de 1994"
24,4,2,31,132,119,251,"21 de agosto de 1994"
24,4,2,32,173,132,305,"21 de agosto de 1994"
24,4,2,33,108,89,197,"21 de agosto de 1994"
24,4,3,34,497,416,913,"21 de agosto de 1994"
24,4,3,35,215,217,432,"21 de agosto de 1994"
24,4,3,36,329,292,621,"21 de agosto de 1994"
24,4,3,37,141,123,264,"21 de agosto de 1994"
24,4,3,38,241,212,453,"21 de agosto de 1994"
24,4,3,39,455,405,860,"21 de agosto de 1994"
24,4,3,40,71,60,131,"21 de agosto de 1994"
24,4,3,41,439,334,773,"21 de agosto de 1994"
24,4,3,42,222,144,366,"21 de agosto de 1994"
24,4,3,43,440,415,855,"21 de agosto de 1994"
24,4,3,44,505,447,952,"21 de agosto de 1994"
24,4,3,45,371,290,661,"21 de agosto de 1994"
24,4,3,46,497,322,819,"21 de agosto de 1994"
24,4,3,47,259,199,458,"21 de agosto de 1994"
24,4,3,48,452,390,842,"21 de agosto de 1994"
24,4,3,49,225,197,422,"21 de agosto de 1994"
24,4,3,50,221,213,434,"21 de agosto de 1994"
24,4,3,51,339,254,593,"21 de agosto de 1994"
24,4,3,52,245,173,418,"21 de agosto de 1994"
24,4,3,53,447,404,851,"21 de agosto de 1994"
24,4,3,54,258,183,441,"21 de agosto de 1994"
24,4,3,55,218,170,388,"21 de agosto de 1994"
24,4,3,56,202,164,366,"21 de agosto de 1994"
24,4,3,57,347,297,644,"21 de agosto de 1994"
24,4,3,58,225,189,414,"21 de agosto de 1994"
24,4,3,59,251,255,506,"21 de agosto de 1994"
24,4,4,60,134,131,265,"21 de agosto de 1994"
24,4,4,61,34,37,71,"21 de agosto de 1994"
24,4,4,62,49,46,95,"21 de agosto de 1994"
24,4,4,63,32,29,61,"21 de agosto de 1994"
24,4,4,64,148,132,280,"21 de agosto de 1994"
24,4,4,65,104,91,195,"21 de agosto de 1994"
24,4,4,66,43,39,82,"21 de agosto de 1994"
24,4,4,67,37,27,64,"21 de agosto de 1994"
24,4,4,68,202,222,424,"21 de agosto de 1994"
24,4,4,69,75,65,140,"21 de agosto de 1994"
24,4,4,70,163,143,306,"21 de agosto de 1994"
24,4,4,71,63,72,135,"21 de agosto de 1994"
24,4,4,72,67,60,127,"21 de agosto de 1994"
24,4,4,73,30,32,62,"21 de agosto de 1994"
24,4,4,74,27,26,53,"21 de agosto de 1994"
24,4,4,75,38,41,79,"21 de agosto de 1994"
24,4,4,76,49,40,89,"21 de agosto de 1994"
24,4,4,77,108,98,206,"21 de agosto de 1994"
24,4,5,78,174,186,360,"21 de agosto de 1994"
24,4,5,79,409,483,892,"21 de agosto de 1994"
24,4,5,80,343,423,766,"21 de agosto de 1994"
24,4,5,81,230,265,495,"21 de agosto de 1994"
24,4,5,82,197,245,442,"21 de agosto de 1994"
24,4,5,83,260,330,590,"21 de agosto de 1994"
24,4,5,84,394,448,842,"21 de agosto de 1994"
24,4,5,85,423,501,924,"21 de agosto de 1994"
24,4,5,86,251,250,501,"21 de agosto de 1994"
24,4,5,87,199,252,451,"21 de agosto de 1994"
24,4,5,88,197,223,420,"21 de agosto de 1994"
24,4,5,89,186,256,442,"21 de agosto de 1994"
24,4,5,90,323,363,686,"21 de agosto de 1994"
24,4,5,91,116,125,241,"21 de agosto de 1994"
24,4,5,92,118,111,229,"21 de agosto de 1994"
24,4,5,93,278,298,576,"21 de agosto de 1994"
24,4,5,94,114,115,229,"21 de agosto de 1994"
24,4,5,95,135,168,303,"21 de agosto de 1994"
24,4,5,96,116,109,225,"21 de agosto de 1994"
24,4,5,97,78,100,178,"21 de agosto de 1994"
24,4,8,136,183,233,416,"21 de agosto de 1994"
24,4,8,137,329,408,737,"21 de agosto de 1994"
24,4,8,138,199,248,447,"21 de agosto de 1994"
24,4,8,139,337,401,738,"21 de agosto de 1994"
24,4,8,140,316,384,700,"21 de agosto de 1994"
24,4,8,141,400,498,898,"21 de agosto de 1994"
24,4,8,142,251,324,575,"21 de agosto de 1994"
24,4,8,143,472,552,1024,"21 de agosto de 1994"
24,4,8,144,442,492,934,"21 de agosto de 1994"
24,4,8,145,71,66,137,"21 de agosto de 1994"
24,4,8,146,29,47,76,"21 de agosto de 1994"
24,4,8,147,169,195,364,"21 de agosto de 1994"
24,4,8,148,130,154,284,"21 de agosto de 1994"
24,4,8,149,87,80,167,"21 de agosto de 1994"
24,4,8,150,53,62,115,"21 de agosto de 1994"
24,4,8,151,33,50,83,"21 de agosto de 1994"
24,4,8,152,246,285,531,"21 de agosto de 1994"
24,4,8,153,86,95,181,"21 de agosto de 1994"
24,4,8,154,57,59,116,"21 de agosto de 1994"
24,4,8,155,116,127,243,"21 de agosto de 1994"
24,4,8,156,237,282,519,"21 de agosto de 1994"
24,4,8,157,46,50,96,"21 de agosto de 1994"
24,4,8,158,163,211,374,"21 de agosto de 1994"
24,4,8,159,31,37,68,"21 de agosto de 1994"
24,4,8,160,75,68,143,"21 de agosto de 1994"
24,4,8,161,134,151,285,"21 de agosto de 1994"
24,4,8,162,49,42,91,"21 de agosto de 1994"
24,4,8,163,140,155,295,"21 de agosto de 1994"
24,4,8,164,44,48,92,"21 de agosto de 1994"
24,4,9,165,79,54,133,"21 de agosto de 1994"
24,4,9,166,39,38,77,"21 de agosto de 1994"
24,4,9,167,46,48,94,"21 de agosto de 1994"
24,4,9,168,28,25,53,"21 de agosto de 1994"
24,4,9,169,34,47,81,"21 de agosto de 1994"
24,4,9,170,37,21,58,"21 de agosto de 1994"
24,4,9,171,303,290,593,"21 de agosto de 1994"
24,4,9,172,80,78,158,"21 de agosto de 1994"
24,4,10,173,386,374,760,"21 de agosto de 1994"
24,4,10,174,282,302,584,"21 de agosto de 1994"
24,4,10,175,347,379,726,"21 de agosto de 1994"
24,4,10,176,394,430,824,"21 de agosto de 1994"
24,4,10,177,234,251,485,"21 de agosto de 1994"
24,4,10,178,130,142,272,"21 de agosto de 1994"
24,4,10,179,297,346,643,"21 de agosto de 1994"
24,4,10,180,106,98,204,"21 de agosto de 1994"
24,4,10,181,163,145,308,"21 de agosto de 1994"
24,4,10,182,410,485,895,"21 de agosto de 1994"
24,4,10,183,119,137,256,"21 de agosto de 1994"
24,4,10,184,344,322,666,"21 de agosto de 1994"
24,4,10,185,300,338,638,"21 de agosto de 1994"
24,4,10,186,348,311,659,"21 de agosto de 1994"
24,4,10,187,357,301,658,"21 de agosto de 1994"
24,4,10,188,336,296,632,"21 de agosto de 1994"
24,4,10,189,179,184,363,"21 de agosto de 1994"
24,4,10,190,643,535,1178,"21 de agosto de 1994"
24,4,10,191,422,391,813,"21 de agosto de 1994"
24,4,10,192,421,455,876,"21 de agosto de 1994"
24,4,10,193,359,345,704,"21 de agosto de 1994"
24,4,10,194,237,193,430,"21 de agosto de 1994"
24,4,10,195,233,189,422,"21 de agosto de 1994"
24,4,10,196,117,82,199,"21 de agosto de 1994"
24,4,10,197,223,196,419,"21 de agosto de 1994"
24,4,10,198,363,379,742,"21 de agosto de 1994"
24,4,10,199,97,110,207,"21 de agosto de 1994"
24,4,10,200,58,77,135,"21 de agosto de 1994"
24,4,10,201,434,426,860,"21 de agosto de 1994"
24,4,10,202,404,365,769,"21 de agosto de 1994"
24,4,10,203,95,85,180,"21 de agosto de 1994"
24,4,10,204,110,73,183,"21 de agosto de 1994"
24,4,10,205,224,166,390,"21 de agosto de 1994"
24,4,10,206,157,129,286,"21 de agosto de 1994"
24,4,10,207,85,69,154,"21 de agosto de 1994"
24,4,10,208,190,177,367,"21 de agosto de 1994"
24,4,10,209,141,160,301,"21 de agosto de 1994"
24,4,10,210,166,130,296,"21 de agosto de 1994"
24,4,10,211,222,197,419,"21 de agosto de 1994"
24,4,10,212,303,229,532,"21 de agosto de 1994"
24,4,10,213,90,59,149,"21 de agosto de 1994"
24,4,10,214,203,173,376,"21 de agosto de 1994"
24,4,10,215,196,160,356,"21 de agosto de 1994"
24,4,10,216,140,152,292,"21 de agosto de 1994"
24,4,10,217,342,351,693,"21 de agosto de 1994"
24,4,10,218,89,58,147,"21 de agosto de 1994"
24,4,10,219,116,140,256,"21 de agosto de 1994"
24,4,17,437,216,219,435,"21 de agosto de 1994"
24,4,17,438,41,50,91,"21 de agosto de 1994"
24,4,17,439,203,210,413,"21 de agosto de 1994"
24,4,17,440,213,167,380,"21 de agosto de 1994"
24,4,17,441,368,335,703,"21 de agosto de 1994"
24,4,17,442,95,95,190,"21 de agosto de 1994"
24,4,17,443,243,188,431,"21 de agosto de 1994"
24,4,17,444,99,84,183,"21 de agosto de 1994"
24,4,17,445,182,172,354,"21 de agosto de 1994"
24,4,17,446,226,187,413,"21 de agosto de 1994"
24,4,17,447,433,443,876,"21 de agosto de 1994"
24,4,17,448,229,204,433,"21 de agosto de 1994"
24,4,17,449,256,215,471,"21 de agosto de 1994"
24,4,17,450,278,286,564,"21 de agosto de 1994"
24,4,17,451,574,484,1058,"21 de agosto de 1994"
24,4,17,452,127,133,260,"21 de agosto de 1994"
24,4,17,453,70,55,125,"21 de agosto de 1994"
24,4,17,454,268,244,512,"21 de agosto de 1994"
24,4,17,455,48,41,89,"21 de agosto de 1994"
24,4,17,456,75,64,139,"21 de agosto de 1994"
24,4,17,457,148,147,295,"21 de agosto de 1994"
24,4,17,458,163,154,317,"21 de agosto de 1994"
24,4,17,459,55,54,109,"21 de agosto de 1994"
24,4,17,460,82,92,174,"21 de agosto de 1994"
24,4,17,461,94,109,203,"21 de agosto de 1994"
24,4,17,462,240,253,493,"21 de agosto de 1994"
24,4,17,463,257,230,487,"21 de agosto de 1994"
24,4,17,464,145,145,290,"21 de agosto de 1994"
24,4,17,465,243,346,589,"21 de agosto de 1994"
24,4,17,466,358,407,765,"21 de agosto de 1994"
24,4,17,467,98,96,194,"21 de agosto de 1994"
24,4,19,478,67,82,149,"21 de agosto de 1994"
24,4,19,479,94,103,197,"21 de agosto de 1994"
24,4,19,480,42,58,100,"21 de agosto de 1994"
24,4,19,481,217,218,435,"21 de agosto de 1994"
24,4,19,482,337,340,677,"21 de agosto de 1994"
24,4,19,483,133,134,267,"21 de agosto de 1994"
24,4,19,484,54,49,103,"21 de agosto de 1994"
24,4,19,485,330,304,634,"21 de agosto de 1994"
24,4,19,486,181,165,346,"21 de agosto de 1994"
24,4,19,487,81,111,192,"21 de agosto de 1994"
24,4,19,488,115,127,242,"21 de agosto de 1994"
24,4,19,489,82,84,166,"21 de agosto de 1994"
24,4,23,616,469,539,1008,"21 de agosto de 1994"
24,4,23,617,425,474,899,"21 de agosto de 1994"
24,4,23,618,327,381,708,"21 de agosto de 1994"
24,4,23,619,171,208,379,"21 de agosto de 1994"
24,4,23,620,195,243,438,"21 de agosto de 1994"
24,4,23,621,199,231,430,"21 de agosto de 1994"
24,4,23,622,228,226,454,"21 de agosto de 1994"
24,4,23,623,383,356,739,"21 de agosto de 1994"
24,4,23,624,121,160,281,"21 de agosto de 1994"
24,4,23,625,108,106,214,"21 de agosto de 1994"
24,4,23,626,232,179,411,"21 de agosto de 1994"
24,4,23,627,284,275,559,"21 de agosto de 1994"
24,4,23,628,174,172,346,"21 de agosto de 1994"
24,4,23,629,45,60,105,"21 de agosto de 1994"
24,4,23,630,61,55,116,"21 de agosto de 1994"
24,4,23,631,60,66,126,"21 de agosto de 1994"
24,4,23,632,58,54,112,"21 de agosto de 1994"
24,4,23,633,275,304,579,"21 de agosto de 1994"
24,4,27,757,248,275,523,"21 de agosto de 1994"
24,4,27,758,252,306,558,"21 de agosto de 1994"
24,4,27,759,297,349,646,"21 de agosto de 1994"
24,4,27,760,136,134,270,"21 de agosto de 1994"
24,4,27,761,233,256,489,"21 de agosto de 1994"
24,4,27,762,194,265,459,"21 de agosto de 1994"
24,4,27,763,198,206,404,"21 de agosto de 1994"
24,4,27,764,144,182,326,"21 de agosto de 1994"
24,4,27,765,51,51,102,"21 de agosto de 1994"
24,4,27,766,79,89,168,"21 de agosto de 1994"
24,4,27,767,162,174,336,"21 de agosto de 1994"
24,4,27,768,55,52,107,"21 de agosto de 1994"
24,4,27,769,168,124,292,"21 de agosto de 1994"
24,4,27,770,70,68,138,"21 de agosto de 1994"
24,4,27,771,140,169,309,"21 de agosto de 1994"
24,4,27,772,175,165,340,"21 de agosto de 1994"
24,4,32,1179,59,56,115,"21 de agosto de 1994"
24,4,32,1180,318,307,625,"21 de agosto de 1994"
24,4,32,1181,291,277,568,"21 de agosto de 1994"
24,4,32,1182,49,58,107,"21 de agosto de 1994"
24,4,32,1183,308,307,615,"21 de agosto de 1994"
24,4,32,1184,202,239,441,"21 de agosto de 1994"
24,4,32,1185,183,193,376,"21 de agosto de 1994"
24,4,32,1186,302,270,572,"21 de agosto de 1994"
24,4,32,1187,504,451,955,"21 de agosto de 1994"
24,4,36,1319,445,464,909,"21 de agosto de 1994"
24,4,36,1320,309,328,637,"21 de agosto de 1994"
24,4,36,1321,292,279,571,"21 de agosto de 1994"
24,4,36,1322,189,133,322,"21 de agosto de 1994"
24,4,36,1323,226,208,434,"21 de agosto de 1994"
24,4,36,1324,530,517,1047,"21 de agosto de 1994"
24,4,36,1325,210,148,358,"21 de agosto de 1994"
24,4,36,1326,583,580,1163,"21 de agosto de 1994"
24,4,36,1327,608,599,1207,"21 de agosto de 1994"
24,4,36,1328,485,434,919,"21 de agosto de 1994"
24,4,36,1329,357,329,686,"21 de agosto de 1994"
24,4,36,1330,515,472,987,"21 de agosto de 1994"
24,4,36,1331,267,221,488,"21 de agosto de 1994"
24,4,36,1332,394,271,665,"21 de agosto de 1994"
24,4,36,1333,453,359,812,"21 de agosto de 1994"
24,4,36,1334,259,231,490,"21 de agosto de 1994"
24,4,36,1335,401,430,831,"21 de agosto de 1994"
24,4,53,1689,210,259,469,"21 de agosto de 1994"
24,4,53,1690,191,217,408,"21 de agosto de 1994"
24,4,53,1691,221,256,477,"21 de agosto de 1994"
24,4,53,1692,161,215,376,"21 de agosto de 1994"
24,4,53,1693,107,146,253,"21 de agosto de 1994"
24,4,53,1694,74,92,166,"21 de agosto de 1994"
24,4,53,1695,222,278,500,"21 de agosto de 1994"
24,4,53,1696,77,82,159,"21 de agosto de 1994"
24,4,53,1697,350,423,773,"21 de agosto de 1994"
24,4,53,1698,303,321,624,"21 de agosto de 1994"
24,4,53,1699,125,168,293,"21 de agosto de 1994"
24,4,53,1700,186,192,378,"21 de agosto de 1994"
24,4,53,1701,62,51,113,"21 de agosto de 1994"
24,4,53,1702,87,81,168,"21 de agosto de 1994"
24,4,53,1703,40,44,84,"21 de agosto de 1994"
24,4,53,1704,214,233,447,"21 de agosto de 1994"
24,5,13,266,409,436,845,"21 de agosto de 1994"
24,5,13,267,319,357,676,"21 de agosto de 1994"
24,5,13,268,263,322,585,"21 de agosto de 1994"
24,5,13,269,275,359,634,"21 de agosto de 1994"
24,5,13,270,280,358,638,"21 de agosto de 1994"
24,5,13,271,194,240,434,"21 de agosto de 1994"
24,5,13,272,168,180,348,"21 de agosto de 1994"
24,5,13,273,306,345,651,"21 de agosto de 1994"
24,5,13,274,365,405,770,"21 de agosto de 1994"
24,5,13,275,545,611,1156,"21 de agosto de 1994"
24,5,13,276,650,659,1309,"21 de agosto de 1994"
24,5,13,277,401,389,790,"21 de agosto de 1994"
24,5,13,278,363,432,795,"21 de agosto de 1994"
24,5,13,279,345,407,752,"21 de agosto de 1994"
24,5,13,280,409,466,875,"21 de agosto de 1994"
24,5,13,281,387,489,876,"21 de agosto de 1994"
24,5,13,282,584,696,1280,"21 de agosto de 1994"
24,5,13,283,716,826,1542,"21 de agosto de 1994"
24,5,13,284,492,590,1082,"21 de agosto de 1994"
24,5,13,285,327,344,671,"21 de agosto de 1994"
24,5,13,286,561,597,1158,"21 de agosto de 1994"
24,5,13,287,564,639,1203,"21 de agosto de 1994"
24,5,13,288,417,511,928,"21 de agosto de 1994"
24,5,13,289,651,746,1397,"21 de agosto de 1994"
24,5,13,290,279,294,573,"21 de agosto de 1994"
24,5,13,291,328,419,747,"21 de agosto de 1994"
24,5,13,292,453,533,986,"21 de agosto de 1994"
24,5,13,293,470,546,1016,"21 de agosto de 1994"
24,5,13,294,632,739,1371,"21 de agosto de 1994"
24,5,13,295,452,553,1005,"21 de agosto de 1994"
24,5,13,296,376,417,793,"21 de agosto de 1994"
24,5,13,297,267,312,579,"21 de agosto de 1994"
24,5,13,298,390,443,833,"21 de agosto de 1994"
24,5,13,299,402,438,840,"21 de agosto de 1994"
24,5,13,300,346,415,761,"21 de agosto de 1994"
24,5,13,301,489,587,1076,"21 de agosto de 1994"
24,5,13,302,250,306,556,"21 de agosto de 1994"
24,5,13,303,331,407,738,"21 de agosto de 1994"
24,5,13,304,544,634,1178,"21 de agosto de 1994"
24,5,13,305,324,355,679,"21 de agosto de 1994"
24,5,13,306,179,220,399,"21 de agosto de 1994"
24,5,13,307,261,294,555,"21 de agosto de 1994"
24,5,13,308,484,557,1041,"21 de agosto de 1994"
24,5,13,309,407,490,897,"21 de agosto de 1994"
24,5,13,310,425,478,903,"21 de agosto de 1994"
24,5,13,311,341,390,731,"21 de agosto de 1994"
24,5,13,312,287,311,598,"21 de agosto de 1994"
24,5,13,313,418,507,925,"21 de agosto de 1994"
24,5,13,314,313,370,683,"21 de agosto de 1994"
24,5,13,315,159,171,330,"21 de agosto de 1994"
24,5,13,316,356,364,720,"21 de agosto de 1994"
24,5,13,317,404,479,883,"21 de agosto de 1994"
24,5,13,318,256,351,607,"21 de agosto de 1994"
24,5,13,319,431,506,937,"21 de agosto de 1994"
24,5,13,320,640,384,1024,"21 de agosto de 1994"
24,5,13,321,327,375,702,"21 de agosto de 1994"
24,5,13,322,326,399,725,"21 de agosto de 1994"
24,5,13,323,224,278,502,"21 de agosto de 1994"
24,5,13,324,372,399,771,"21 de agosto de 1994"
24,5,13,325,288,387,675,"21 de agosto de 1994"
24,5,13,326,433,468,901,"21 de agosto de 1994"
24,5,13,327,281,326,607,"21 de agosto de 1994"
24,5,13,328,118,88,206,"21 de agosto de 1994"
24,5,13,329,127,103,230,"21 de agosto de 1994"
24,5,13,330,81,61,142,"21 de agosto de 1994"
24,5,13,331,201,148,349,"21 de agosto de 1994"
24,5,13,332,469,421,890,"21 de agosto de 1994"
24,5,13,333,461,312,773,"21 de agosto de 1994"
24,5,13,334,84,79,163,"21 de agosto de 1994"
24,5,13,335,259,238,497,"21 de agosto de 1994"
24,5,13,336,105,92,197,"21 de agosto de 1994"
24,5,13,337,129,117,246,"21 de agosto de 1994"
24,5,13,338,407,362,769,"21 de agosto de 1994"
24,5,13,339,141,116,257,"21 de agosto de 1994"
24,5,13,340,134,100,234,"21 de agosto de 1994"
24,5,13,341,156,121,277,"21 de agosto de 1994"
24,5,13,342,179,158,337,"21 de agosto de 1994"
24,5,13,343,138,136,274,"21 de agosto de 1994"
24,5,13,344,204,207,411,"21 de agosto de 1994"
24,5,13,345,224,200,424,"21 de agosto de 1994"
24,5,13,346,177,139,316,"21 de agosto de 1994"
24,5,13,347,199,183,382,"21 de agosto de 1994"
24,5,13,348,246,246,492,"21 de agosto de 1994"
24,5,13,349,260,231,491,"21 de agosto de 1994"
24,5,13,350,344,338,682,"21 de agosto de 1994"
24,5,13,351,171,181,352,"21 de agosto de 1994"
24,5,13,352,372,407,779,"21 de agosto de 1994"
24,5,13,353,315,321,636,"21 de agosto de 1994"
24,5,13,354,399,350,749,"21 de agosto de 1994"
24,5,13,355,190,167,357,"21 de agosto de 1994"
24,5,13,356,295,258,553,"21 de agosto de 1994"
24,5,13,357,204,172,376,"21 de agosto de 1994"
24,5,13,358,285,251,536,"21 de agosto de 1994"
24,5,13,359,299,287,586,"21 de agosto de 1994"
24,5,13,360,304,238,542,"21 de agosto de 1994"
24,5,13,361,339,258,597,"21 de agosto de 1994"
24,5,13,362,171,138,309,"21 de agosto de 1994"
24,5,13,363,109,97,206,"21 de agosto de 1994"
24,5,13,364,449,435,884,"21 de agosto de 1994"
24,5,13,365,204,156,360,"21 de agosto de 1994"
24,5,13,366,123,118,241,"21 de agosto de 1994"
24,5,13,367,380,297,677,"21 de agosto de 1994"
24,5,13,368,126,104,230,"21 de agosto de 1994"
24,5,13,369,163,123,286,"21 de agosto de 1994"
24,5,13,370,200,195,395,"21 de agosto de 1994"
24,5,16,405,324,299,623,"21 de agosto de 1994"
24,5,16,406,359,388,747,"21 de agosto de 1994"
24,5,16,407,379,396,775,"21 de agosto de 1994"
24,5,16,408,370,405,775,"21 de agosto de 1994"
24,5,16,409,363,374,737,"21 de agosto de 1994"
24,5,16,410,274,280,554,"21 de agosto de 1994"
24,5,16,411,412,436,848,"21 de agosto de 1994"
24,5,16,412,423,453,876,"21 de agosto de 1994"
24,5,16,413,260,269,529,"21 de agosto de 1994"
24,5,16,414,305,357,662,"21 de agosto de 1994"
24,5,16,415,478,534,1012,"21 de agosto de 1994"
24,5,16,416,326,367,693,"21 de agosto de 1994"
24,5,16,417,270,278,548,"21 de agosto de 1994"
24,5,16,418,577,626,1203,"21 de agosto de 1994"
24,5,16,419,424,419,843,"21 de agosto de 1994"
24,5,16,420,82,70,152,"21 de agosto de 1994"
24,5,16,421,383,373,756,"21 de agosto de 1994"
24,5,16,422,305,288,593,"21 de agosto de 1994"
24,5,16,423,443,452,895,"21 de agosto de 1994"
24,5,16,424,502,424,926,"21 de agosto de 1994"
24,5,16,425,483,399,882,"21 de agosto de 1994"
24,5,16,426,336,261,597,"21 de agosto de 1994"
24,5,16,427,563,453,1016,"21 de agosto de 1994"
24,5,16,428,117,99,216,"21 de agosto de 1994"
24,5,16,429,176,175,351,"21 de agosto de 1994"
24,5,16,430,367,312,679,"21 de agosto de 1994"
24,5,16,431,387,357,744,"21 de agosto de 1994"
24,5,16,432,50,34,84,"21 de agosto de 1994"
24,5,16,433,432,387,819,"21 de agosto de 1994"
24,5,16,434,267,214,481,"21 de agosto de 1994"
24,5,16,435,112,100,212,"21 de agosto de 1994"
24,5,16,436,101,73,174,"21 de agosto de 1994"
24,5,16,965,0,0,0,"21 de agosto de 1994"
24,5,26,748,265,283,548,"21 de agosto de 1994"
24,5,26,749,129,112,241,"21 de agosto de 1994"
24,5,26,750,74,59,133,"21 de agosto de 1994"
24,5,26,751,202,189,391,"21 de agosto de 1994"
24,5,26,752,377,315,692,"21 de agosto de 1994"
24,5,26,753,168,143,311,"21 de agosto de 1994"
24,5,26,754,265,224,489,"21 de agosto de 1994"
24,5,26,755,109,84,193,"21 de agosto de 1994"
24,5,26,756,340,274,614,"21 de agosto de 1994"
24,5,31,1160,257,257,514,"21 de agosto de 1994"
24,5,31,1161,388,364,752,"21 de agosto de 1994"
24,5,31,1162,364,361,725,"21 de agosto de 1994"
24,5,31,1163,328,307,635,"21 de agosto de 1994"
24,5,31,1164,196,202,398,"21 de agosto de 1994"
24,5,31,1165,91,74,165,"21 de agosto de 1994"
24,5,31,1166,51,35,86,"21 de agosto de 1994"
24,5,31,1167,169,143,312,"21 de agosto de 1994"
24,5,31,1168,104,92,196,"21 de agosto de 1994"
24,5,31,1169,144,130,274,"21 de agosto de 1994"
24,5,31,1170,69,63,132,"21 de agosto de 1994"
24,5,31,1171,93,79,172,"21 de agosto de 1994"
24,5,31,1172,72,59,131,"21 de agosto de 1994"
24,5,31,1173,130,86,216,"21 de agosto de 1994"
24,5,31,1174,168,133,301,"21 de agosto de 1994"
24,5,31,1175,80,60,140,"21 de agosto de 1994"
24,5,31,1176,139,119,258,"21 de agosto de 1994"
24,5,31,1177,163,136,299,"21 de agosto de 1994"
24,5,31,1178,355,333,688,"21 de agosto de 1994"
24,5,39,472,0,1,1,"21 de agosto de 1994"
24,5,39,1428,468,451,919,"21 de agosto de 1994"
24,5,39,1429,387,373,760,"21 de agosto de 1994"
24,5,39,1430,125,104,229,"21 de agosto de 1994"
24,5,39,1431,133,118,251,"21 de agosto de 1994"
24,5,39,1432,303,272,575,"21 de agosto de 1994"
24,5,39,1433,192,178,370,"21 de agosto de 1994"
24,5,39,1434,102,84,186,"21 de agosto de 1994"
24,5,39,1435,144,133,277,"21 de agosto de 1994"
24,5,39,1436,54,41,95,"21 de agosto de 1994"
24,5,39,1437,127,112,239,"21 de agosto de 1994"
24,5,39,1438,218,176,394,"21 de agosto de 1994"
24,5,39,1439,271,206,477,"21 de agosto de 1994"
24,5,39,1440,133,111,244,"21 de agosto de 1994"
24,5,39,1441,128,115,243,"21 de agosto de 1994"
24,5,39,1442,106,89,195,"21 de agosto de 1994"
24,5,39,1443,157,131,288,"21 de agosto de 1994"
24,5,39,1444,180,153,333,"21 de agosto de 1994"
24,5,40,1445,396,420,816,"21 de agosto de 1994"
24,5,40,1446,368,390,758,"21 de agosto de 1994"
24,5,40,1447,417,428,845,"21 de agosto de 1994"
24,5,40,1448,332,381,713,"21 de agosto de 1994"
24,5,40,1449,256,296,552,"21 de agosto de 1994"
24,5,40,1450,277,284,561,"21 de agosto de 1994"
24,5,40,1451,305,317,622,"21 de agosto de 1994"
24,5,40,1452,285,325,610,"21 de agosto de 1994"
24,5,40,1453,254,309,563,"21 de agosto de 1994"
24,5,40,1454,368,374,742,"21 de agosto de 1994"
24,5,40,1455,240,241,481,"21 de agosto de 1994"
24,5,40,1456,260,224,484,"21 de agosto de 1994"
24,5,40,1457,281,219,500,"21 de agosto de 1994"
24,5,40,1458,163,121,284,"21 de agosto de 1994"
24,5,40,1459,111,98,209,"21 de agosto de 1994"
24,5,40,1460,173,108,281,"21 de agosto de 1994"
24,5,40,1461,127,87,214,"21 de agosto de 1994"
24,5,40,1462,416,378,794,"21 de agosto de 1994"
24,5,40,1463,213,160,373,"21 de agosto de 1994"
24,5,40,1464,347,320,667,"21 de agosto de 1994"
24,5,40,1465,376,324,700,"21 de agosto de 1994"
24,5,40,1466,96,81,177,"21 de agosto de 1994"
24,5,40,1467,222,216,438,"21 de agosto de 1994"
24,5,40,1468,287,236,523,"21 de agosto de 1994"
24,5,40,1469,122,117,239,"21 de agosto de 1994"
24,5,40,1470,129,103,232,"21 de agosto de 1994"
24,5,40,1471,187,172,359,"21 de agosto de 1994"
24,5,40,1472,325,301,626,"21 de agosto de 1994"
24,5,40,1473,61,49,110,"21 de agosto de 1994"
24,5,40,1474,251,225,476,"21 de agosto de 1994"
24,5,40,1475,265,223,488,"21 de agosto de 1994"
24,5,40,1476,238,183,421,"21 de agosto de 1994"
24,5,40,1477,354,298,652,"21 de agosto de 1994"
24,5,40,1478,126,87,213,"21 de agosto de 1994"
24,5,40,1479,122,110,232,"21 de agosto de 1994"
24,5,41,1480,480,464,944,"21 de agosto de 1994"
24,5,41,1481,429,341,770,"21 de agosto de 1994"
24,5,41,1482,99,98,197,"21 de agosto de 1994"
24,5,41,1483,162,138,300,"21 de agosto de 1994"
24,5,41,1484,89,83,172,"21 de agosto de 1994"
24,5,41,1485,145,107,252,"21 de agosto de 1994"
24,5,41,1486,178,130,308,"21 de agosto de 1994"
24,5,41,1487,218,173,391,"21 de agosto de 1994"
24,5,41,1488,113,100,213,"21 de agosto de 1994"
24,5,41,1489,235,191,426,"21 de agosto de 1994"
24,5,41,1490,346,281,627,"21 de agosto de 1994"
24,5,41,1491,216,188,404,"21 de agosto de 1994"
24,5,41,1492,464,388,852,"21 de agosto de 1994"
24,5,41,1493,228,201,429,"21 de agosto de 1994"
24,5,41,1494,196,183,379,"21 de agosto de 1994"
24,5,41,1495,290,245,535,"21 de agosto de 1994"
24,6,1,1,300,390,690,"21 de agosto de 1994"
24,6,1,2,344,434,778,"21 de agosto de 1994"
24,6,1,3,105,125,230,"21 de agosto de 1994"
24,6,1,4,169,181,350,"21 de agosto de 1994"
24,6,1,5,121,120,241,"21 de agosto de 1994"
24,6,1,6,421,534,955,"21 de agosto de 1994"
24,6,1,7,373,503,876,"21 de agosto de 1994"
24,6,1,8,464,626,1090,"21 de agosto de 1994"
24,6,1,9,73,80,153,"21 de agosto de 1994"
24,6,1,10,58,68,126,"21 de agosto de 1994"
24,6,1,11,376,406,782,"21 de agosto de 1994"
24,6,1,12,205,254,459,"21 de agosto de 1994"
24,6,1,13,240,290,530,"21 de agosto de 1994"
24,6,1,14,539,487,1026,"21 de agosto de 1994"
24,6,22,591,206,242,448,"21 de agosto de 1994"
24,6,22,592,302,339,641,"21 de agosto de 1994"
24,6,22,593,403,461,864,"21 de agosto de 1994"
24,6,22,594,47,45,92,"21 de agosto de 1994"
24,6,22,595,33,18,51,"21 de agosto de 1994"
24,6,22,596,78,77,155,"21 de agosto de 1994"
24,6,22,597,132,133,265,"21 de agosto de 1994"
24,6,22,598,195,167,362,"21 de agosto de 1994"
24,6,22,599,105,94,199,"21 de agosto de 1994"
24,6,22,600,125,122,247,"21 de agosto de 1994"
24,6,22,601,237,229,466,"21 de agosto de 1994"
24,6,22,602,105,111,216,"21 de agosto de 1994"
24,6,22,603,140,126,266,"21 de agosto de 1994"
24,6,22,604,150,150,300,"21 de agosto de 1994"
24,6,22,605,148,139,287,"21 de agosto de 1994"
24,6,22,606,204,262,466,"21 de agosto de 1994"
24,6,22,607,251,265,516,"21 de agosto de 1994"
24,6,22,608,233,230,463,"21 de agosto de 1994"
24,6,22,609,211,227,438,"21 de agosto de 1994"
24,6,22,610,135,159,294,"21 de agosto de 1994"
24,6,22,611,140,173,313,"21 de agosto de 1994"
24,6,22,612,194,208,402,"21 de agosto de 1994"
24,6,22,613,261,304,565,"21 de agosto de 1994"
24,6,22,614,76,79,155,"21 de agosto de 1994"
24,6,22,615,111,178,289,"21 de agosto de 1994"
24,6,28,729,0,1,1,"21 de agosto de 1994"
24,6,28,906,1,0,1,"21 de agosto de 1994"
24,6,28,915,1,1,2,"21 de agosto de 1994"
24,6,28,917,0,1,1,"21 de agosto de 1994"
24,6,28,986,214,305,519,"21 de agosto de 1994"
24,6,28,987,336,371,707,"21 de agosto de 1994"
24,6,28,988,424,500,924,"21 de agosto de 1994"
24,6,28,989,353,484,837,"21 de agosto de 1994"
24,6,28,990,299,385,684,"21 de agosto de 1994"
24,6,28,991,229,263,492,"21 de agosto de 1994"
24,6,28,992,241,298,539,"21 de agosto de 1994"
24,6,28,993,282,358,640,"21 de agosto de 1994"
24,6,28,994,524,626,1150,"21 de agosto de 1994"
24,6,28,995,336,418,754,"21 de agosto de 1994"
24,6,28,996,495,598,1093,"21 de agosto de 1994"
24,6,28,997,575,714,1289,"21 de agosto de 1994"
24,6,28,998,589,761,1350,"21 de agosto de 1994"
24,6,28,999,506,624,1130,"21 de agosto de 1994"
24,6,28,1000,558,598,1156,"21 de agosto de 1994"
24,6,28,1001,597,661,1258,"21 de agosto de 1994"
24,6,28,1002,194,245,439,"21 de agosto de 1994"
24,6,28,1003,129,146,275,"21 de agosto de 1994"
24,6,28,1004,420,545,965,"21 de agosto de 1994"
24,6,28,1005,401,472,873,"21 de agosto de 1994"
24,6,28,1006,406,478,884,"21 de agosto de 1994"
24,6,28,1007,441,525,966,"21 de agosto de 1994"
24,6,28,1008,297,356,653,"21 de agosto de 1994"
24,6,28,1009,255,322,577,"21 de agosto de 1994"
24,6,28,1010,682,138,820,"21 de agosto de 1994"
24,6,28,1011,276,401,677,"21 de agosto de 1994"
24,6,28,1012,468,576,1044,"21 de agosto de 1994"
24,6,28,1013,412,450,862,"21 de agosto de 1994"
24,6,28,1014,446,491,937,"21 de agosto de 1994"
24,6,28,1015,438,551,989,"21 de agosto de 1994"
24,6,28,1016,97,157,254,"21 de agosto de 1994"
24,6,28,1017,332,441,773,"21 de agosto de 1994"
24,6,28,1018,527,643,1170,"21 de agosto de 1994"
24,6,28,1019,558,705,1263,"21 de agosto de 1994"
24,6,28,1020,507,589,1096,"21 de agosto de 1994"
24,6,28,1021,513,624,1137,"21 de agosto de 1994"
24,6,28,1022,420,463,883,"21 de agosto de 1994"
24,6,28,1023,646,748,1394,"21 de agosto de 1994"
24,6,28,1024,451,626,1077,"21 de agosto de 1994"
24,6,28,1025,403,531,934,"21 de agosto de 1994"
24,6,28,1026,493,562,1055,"21 de agosto de 1994"
24,6,28,1027,415,545,960,"21 de agosto de 1994"
24,6,28,1028,563,690,1253,"21 de agosto de 1994"
24,6,28,1029,479,601,1080,"21 de agosto de 1994"
24,6,28,1030,515,557,1072,"21 de agosto de 1994"
24,6,28,1031,606,698,1304,"21 de agosto de 1994"
24,6,28,1032,691,750,1441,"21 de agosto de 1994"
24,6,28,1033,439,487,926,"21 de agosto de 1994"
24,6,28,1034,563,640,1203,"21 de agosto de 1994"
24,6,28,1035,525,628,1153,"21 de agosto de 1994"
24,6,28,1036,572,636,1208,"21 de agosto de 1994"
24,6,28,1037,502,616,1118,"21 de agosto de 1994"
24,6,28,1038,407,531,938,"21 de agosto de 1994"
24,6,28,1039,568,582,1150,"21 de agosto de 1994"
24,6,28,1040,475,588,1063,"21 de agosto de 1994"
24,6,28,1041,514,655,1169,"21 de agosto de 1994"
24,6,28,1042,465,593,1058,"21 de agosto de 1994"
24,6,28,1043,448,527,975,"21 de agosto de 1994"
24,6,28,1044,497,606,1103,"21 de agosto de 1994"
24,6,28,1045,616,689,1305,"21 de agosto de 1994"
24,6,28,1046,401,490,891,"21 de agosto de 1994"
24,6,28,1047,406,470,876,"21 de agosto de 1994"
24,6,28,1048,414,486,900,"21 de agosto de 1994"
24,6,28,1049,600,723,1323,"21 de agosto de 1994"
24,6,28,1050,713,841,1554,"21 de agosto de 1994"
24,6,28,1051,429,449,878,"21 de agosto de 1994"
24,6,28,1052,348,405,753,"21 de agosto de 1994"
24,6,28,1053,625,675,1300,"21 de agosto de 1994"
24,6,28,1054,376,435,811,"21 de agosto de 1994"
24,6,28,1055,572,616,1188,"21 de agosto de 1994"
24,6,28,1056,464,558,1022,"21 de agosto de 1994"
24,6,28,1057,508,606,1114,"21 de agosto de 1994"
24,6,28,1058,372,420,792,"21 de agosto de 1994"
24,6,28,1059,569,689,1258,"21 de agosto de 1994"
24,6,28,1060,622,733,1355,"21 de agosto de 1994"
24,6,28,1061,590,649,1239,"21 de agosto de 1994"
24,6,28,1062,604,752,1356,"21 de agosto de 1994"
24,6,28,1063,663,736,1399,"21 de agosto de 1994"
24,6,28,1064,427,479,906,"21 de agosto de 1994"
24,6,28,1065,361,429,790,"21 de agosto de 1994"
24,6,28,1066,328,426,754,"21 de agosto de 1994"
24,6,28,1067,465,529,994,"21 de agosto de 1994"
24,6,28,1068,561,621,1182,"21 de agosto de 1994"
24,6,28,1069,606,689,1295,"21 de agosto de 1994"
24,6,28,1070,586,681,1267,"21 de agosto de 1994"
24,6,28,1071,417,489,906,"21 de agosto de 1994"
24,6,28,1072,620,735,1355,"21 de agosto de 1994"
24,6,28,1073,916,1038,1954,"21 de agosto de 1994"
24,6,28,1074,1564,1727,3291,"21 de agosto de 1994"
24,6,28,1075,358,409,767,"21 de agosto de 1994"
24,6,28,1076,131,124,255,"21 de agosto de 1994"
24,6,28,1077,183,155,338,"21 de agosto de 1994"
24,6,28,1078,56,67,123,"21 de agosto de 1994"
24,6,28,1079,95,85,180,"21 de agosto de 1994"
24,6,28,1080,34,31,65,"21 de agosto de 1994"
24,6,28,1081,51,54,105,"21 de agosto de 1994"
24,6,28,1082,82,83,165,"21 de agosto de 1994"
24,6,28,1083,34,73,107,"21 de agosto de 1994"
24,6,28,1084,87,158,245,"21 de agosto de 1994"
24,6,28,1085,55,68,123,"21 de agosto de 1994"
24,6,28,1086,238,235,473,"21 de agosto de 1994"
24,6,28,1087,71,86,157,"21 de agosto de 1994"
24,6,28,1088,136,147,283,"21 de agosto de 1994"
24,6,28,1089,130,137,267,"21 de agosto de 1994"
24,6,28,1090,143,146,289,"21 de agosto de 1994"
24,6,28,1091,69,103,172,"21 de agosto de 1994"
24,6,28,1092,179,234,413,"21 de agosto de 1994"
24,6,28,1093,147,143,290,"21 de agosto de 1994"
24,6,28,1094,23,32,55,"21 de agosto de 1994"
24,6,28,1095,45,73,118,"21 de agosto de 1994"
24,6,28,1096,188,308,496,"21 de agosto de 1994"
24,6,28,1097,112,159,271,"21 de agosto de 1994"
24,6,28,1098,69,86,155,"21 de agosto de 1994"
24,6,28,1099,37,61,98,"21 de agosto de 1994"
24,6,28,1100,217,212,429,"21 de agosto de 1994"
24,6,28,1101,200,192,392,"21 de agosto de 1994"
24,6,28,1102,41,48,89,"21 de agosto de 1994"
24,6,28,1103,40,63,103,"21 de agosto de 1994"
24,6,28,1104,202,206,408,"21 de agosto de 1994"
24,6,28,1105,102,118,220,"21 de agosto de 1994"
24,6,28,1106,294,294,588,"21 de agosto de 1994"
24,6,28,1107,228,237,465,"21 de agosto de 1994"
24,6,28,1108,83,99,182,"21 de agosto de 1994"
24,6,28,1109,336,318,654,"21 de agosto de 1994"
24,6,28,1110,455,506,961,"21 de agosto de 1994"
24,6,28,1111,238,260,498,"21 de agosto de 1994"
24,6,28,1112,167,174,341,"21 de agosto de 1994"
24,6,28,1113,496,514,1010,"21 de agosto de 1994"
24,6,28,1114,385,379,764,"21 de agosto de 1994"
24,6,28,1115,283,326,609,"21 de agosto de 1994"
24,6,28,1116,546,625,1171,"21 de agosto de 1994"
24,6,28,1117,364,384,748,"21 de agosto de 1994"
24,6,28,1118,446,466,912,"21 de agosto de 1994"
24,6,28,1119,148,135,283,"21 de agosto de 1994"
24,6,28,1120,188,172,360,"21 de agosto de 1994"
24,6,28,1121,311,316,627,"21 de agosto de 1994"
24,6,28,1122,48,44,92,"21 de agosto de 1994"
24,6,28,1123,261,252,513,"21 de agosto de 1994"
24,6,28,1124,268,284,552,"21 de agosto de 1994"
24,6,28,1125,464,454,918,"21 de agosto de 1994"
24,6,28,1126,301,295,596,"21 de agosto de 1994"
24,6,28,1127,117,122,239,"21 de agosto de 1994"
24,6,28,1284,1,0,1,"21 de agosto de 1994"
24,6,28,1777,0,1,1,"21 de agosto de 1994"
24,6,35,880,0,1,1,"21 de agosto de 1994"
24,6,35,972,0,1,1,"21 de agosto de 1994"
24,6,35,1014,1,0,1,"21 de agosto de 1994"
24,6,35,1242,201,226,427,"21 de agosto de 1994"
24,6,35,1243,169,195,364,"21 de agosto de 1994"
24,6,35,1244,327,377,704,"21 de agosto de 1994"
24,6,35,1245,364,414,778,"21 de agosto de 1994"
24,6,35,1246,501,630,1131,"21 de agosto de 1994"
24,6,35,1247,375,458,833,"21 de agosto de 1994"
24,6,35,1248,603,748,1351,"21 de agosto de 1994"
24,6,35,1249,445,529,974,"21 de agosto de 1994"
24,6,35,1250,426,507,933,"21 de agosto de 1994"
24,6,35,1251,449,543,992,"21 de agosto de 1994"
24,6,35,1252,313,379,692,"21 de agosto de 1994"
24,6,35,1253,369,509,878,"21 de agosto de 1994"
24,6,35,1254,418,524,942,"21 de agosto de 1994"
24,6,35,1255,388,469,857,"21 de agosto de 1994"
24,6,35,1256,615,660,1275,"21 de agosto de 1994"
24,6,35,1257,415,489,904,"21 de agosto de 1994"
24,6,35,1258,530,589,1119,"21 de agosto de 1994"
24,6,35,1259,373,474,847,"21 de agosto de 1994"
24,6,35,1260,484,579,1063,"21 de agosto de 1994"
24,6,35,1261,560,725,1285,"21 de agosto de 1994"
24,6,35,1262,238,278,516,"21 de agosto de 1994"
24,6,35,1263,211,271,482,"21 de agosto de 1994"
24,6,35,1264,305,375,680,"21 de agosto de 1994"
24,6,35,1265,216,273,489,"21 de agosto de 1994"
24,6,35,1266,212,243,455,"21 de agosto de 1994"
24,6,35,1267,290,348,638,"21 de agosto de 1994"
24,6,35,1268,315,360,675,"21 de agosto de 1994"
24,6,35,1269,196,239,435,"21 de agosto de 1994"
24,6,35,1270,146,163,309,"21 de agosto de 1994"
24,6,35,1271,513,617,1130,"21 de agosto de 1994"
24,6,35,1272,581,644,1225,"21 de agosto de 1994"
24,6,35,1273,232,278,510,"21 de agosto de 1994"
24,6,35,1274,692,747,1439,"21 de agosto de 1994"
24,6,35,1275,708,794,1502,"21 de agosto de 1994"
24,6,35,1276,709,803,1512,"21 de agosto de 1994"
24,6,35,1277,92,108,200,"21 de agosto de 1994"
24,6,35,1278,733,851,1584,"21 de agosto de 1994"
24,6,35,1279,415,505,920,"21 de agosto de 1994"
24,6,35,1280,569,685,1254,"21 de agosto de 1994"
24,6,35,1281,337,436,773,"21 de agosto de 1994"
24,6,35,1282,566,647,1213,"21 de agosto de 1994"
24,6,35,1283,618,707,1325,"21 de agosto de 1994"
24,6,35,1284,389,497,886,"21 de agosto de 1994"
24,6,35,1285,527,640,1167,"21 de agosto de 1994"
24,6,35,1286,608,697,1305,"21 de agosto de 1994"
24,6,35,1287,568,689,1257,"21 de agosto de 1994"
24,6,35,1288,196,227,423,"21 de agosto de 1994"
24,6,35,1289,177,222,399,"21 de agosto de 1994"
24,6,35,1290,397,526,923,"21 de agosto de 1994"
24,6,35,1291,728,819,1547,"21 de agosto de 1994"
24,6,35,1292,723,816,1539,"21 de agosto de 1994"
24,6,35,1293,764,878,1642,"21 de agosto de 1994"
24,6,35,1294,747,773,1520,"21 de agosto de 1994"
24,6,35,1295,539,546,1085,"21 de agosto de 1994"
24,6,35,1296,557,581,1138,"21 de agosto de 1994"
24,6,35,1297,619,702,1321,"21 de agosto de 1994"
24,6,35,1298,559,702,1261,"21 de agosto de 1994"
24,6,35,1299,595,693,1288,"21 de agosto de 1994"
24,6,35,1300,523,674,1197,"21 de agosto de 1994"
24,6,35,1301,476,583,1059,"21 de agosto de 1994"
24,6,35,1302,282,332,614,"21 de agosto de 1994"
24,6,35,1303,222,278,500,"21 de agosto de 1994"
24,6,35,1304,672,792,1464,"21 de agosto de 1994"
24,6,35,1305,415,501,916,"21 de agosto de 1994"
24,6,35,1306,359,438,797,"21 de agosto de 1994"
24,6,35,1307,181,245,426,"21 de agosto de 1994"
24,6,35,1308,158,235,393,"21 de agosto de 1994"
24,6,35,1309,120,110,230,"21 de agosto de 1994"
24,6,35,1310,202,246,448,"21 de agosto de 1994"
24,6,35,1311,145,137,282,"21 de agosto de 1994"
24,6,35,1312,334,437,771,"21 de agosto de 1994"
24,6,35,1313,202,267,469,"21 de agosto de 1994"
24,6,35,1314,556,633,1189,"21 de agosto de 1994"
24,6,35,1315,87,91,178,"21 de agosto de 1994"
24,6,35,1316,326,387,713,"21 de agosto de 1994"
24,6,35,1317,206,208,414,"21 de agosto de 1994"
24,6,35,1318,308,369,677,"21 de agosto de 1994"
24,6,35,1780,1,0,1,"21 de agosto de 1994"
24,7,12,251,261,295,556,"21 de agosto de 1994"
24,7,12,252,429,473,902,"21 de agosto de 1994"
24,7,12,253,398,369,767,"21 de agosto de 1994"
24,7,12,254,140,138,278,"21 de agosto de 1994"
24,7,12,255,208,203,411,"21 de agosto de 1994"
24,7,12,256,298,266,564,"21 de agosto de 1994"
24,7,12,257,415,402,817,"21 de agosto de 1994"
24,7,12,258,189,186,375,"21 de agosto de 1994"
24,7,12,259,480,447,927,"21 de agosto de 1994"
24,7,12,260,518,451,969,"21 de agosto de 1994"
24,7,12,261,149,150,299,"21 de agosto de 1994"
24,7,12,262,163,177,340,"21 de agosto de 1994"
24,7,12,263,211,207,418,"21 de agosto de 1994"
24,7,12,264,295,260,555,"21 de agosto de 1994"
24,7,12,265,417,336,753,"21 de agosto de 1994"
24,7,14,371,424,430,854,"21 de agosto de 1994"
24,7,14,372,283,262,545,"21 de agosto de 1994"
24,7,14,373,289,257,546,"21 de agosto de 1994"
24,7,14,374,257,241,498,"21 de agosto de 1994"
24,7,14,375,305,291,596,"21 de agosto de 1994"
24,7,14,376,232,227,459,"21 de agosto de 1994"
24,7,14,377,303,298,601,"21 de agosto de 1994"
24,7,14,378,303,277,580,"21 de agosto de 1994"
24,7,14,379,320,311,631,"21 de agosto de 1994"
24,7,14,380,161,145,306,"21 de agosto de 1994"
24,7,14,381,606,577,1183,"21 de agosto de 1994"
24,7,14,382,281,246,527,"21 de agosto de 1994"
24,7,14,383,389,395,784,"21 de agosto de 1994"
24,7,18,468,137,139,276,"21 de agosto de 1994"
24,7,18,469,186,154,340,"21 de agosto de 1994"
24,7,18,470,283,303,586,"21 de agosto de 1994"
24,7,18,471,195,171,366,"21 de agosto de 1994"
24,7,18,472,320,311,631,"21 de agosto de 1994"
24,7,18,473,294,260,554,"21 de agosto de 1994"
24,7,18,474,452,439,891,"21 de agosto de 1994"
24,7,18,475,522,507,1029,"21 de agosto de 1994"
24,7,18,476,325,330,655,"21 de agosto de 1994"
24,7,18,477,462,493,955,"21 de agosto de 1994"
24,7,29,1128,430,437,867,"21 de agosto de 1994"
24,7,29,1129,405,388,793,"21 de agosto de 1994"
24,7,29,1130,264,213,477,"21 de agosto de 1994"
24,7,29,1131,314,248,562,"21 de agosto de 1994"
24,7,29,1132,167,175,342,"21 de agosto de 1994"
24,7,29,1133,77,72,149,"21 de agosto de 1994"
24,7,29,1134,284,230,514,"21 de agosto de 1994"
24,7,29,1135,78,64,142,"21 de agosto de 1994"
24,7,29,1136,283,239,522,"21 de agosto de 1994"
24,7,29,1137,107,97,204,"21 de agosto de 1994"
24,7,29,1138,51,37,88,"21 de agosto de 1994"
24,7,29,1139,139,114,253,"21 de agosto de 1994"
24,7,29,1140,448,385,833,"21 de agosto de 1994"
24,7,29,1141,548,513,1061,"21 de agosto de 1994"
24,7,29,1142,381,376,757,"21 de agosto de 1994"
24,7,29,1143,473,439,912,"21 de agosto de 1994"
24,7,29,1144,121,89,210,"21 de agosto de 1994"
24,7,29,1145,221,184,405,"21 de agosto de 1994"
24,7,29,1146,114,109,223,"21 de agosto de 1994"
24,7,29,1147,442,387,829,"21 de agosto de 1994"
24,7,37,1336,464,556,1020,"21 de agosto de 1994"
24,7,37,1337,131,154,285,"21 de agosto de 1994"
24,7,37,1338,198,221,419,"21 de agosto de 1994"
24,7,37,1339,398,435,833,"21 de agosto de 1994"
24,7,37,1340,228,256,484,"21 de agosto de 1994"
24,7,37,1341,376,397,773,"21 de agosto de 1994"
24,7,37,1342,380,436,816,"21 de agosto de 1994"
24,7,37,1343,444,475,919,"21 de agosto de 1994"
24,7,37,1344,386,400,786,"21 de agosto de 1994"
24,7,37,1345,501,545,1046,"21 de agosto de 1994"
24,7,37,1346,442,466,908,"21 de agosto de 1994"
24,7,37,1347,538,561,1099,"21 de agosto de 1994"
24,7,37,1348,520,556,1076,"21 de agosto de 1994"
24,7,37,1349,364,324,688,"21 de agosto de 1994"
24,7,37,1350,271,227,498,"21 de agosto de 1994"
24,7,37,1351,369,318,687,"21 de agosto de 1994"
24,7,37,1352,261,239,500,"21 de agosto de 1994"
24,7,37,1353,425,389,814,"21 de agosto de 1994"
24,7,37,1354,48,50,98,"21 de agosto de 1994"
24,7,37,1355,466,505,971,"21 de agosto de 1994"
24,7,37,1356,403,399,802,"21 de agosto de 1994"
24,7,37,1357,195,164,359,"21 de agosto de 1994"
24,7,37,1358,705,598,1303,"21 de agosto de 1994"
24,7,37,1359,464,431,895,"21 de agosto de 1994"
24,7,37,1360,174,142,316,"21 de agosto de 1994"
24,7,37,1361,146,97,243,"21 de agosto de 1994"
24,7,37,1362,390,321,711,"21 de agosto de 1994"
24,7,37,1363,420,378,798,"21 de agosto de 1994"
24,7,37,1364,515,480,995,"21 de agosto de 1994"
24,7,37,1365,162,142,304,"21 de agosto de 1994"
24,7,37,1366,276,254,530,"21 de agosto de 1994"
24,7,37,1367,352,263,615,"21 de agosto de 1994"
24,7,37,1368,310,272,582,"21 de agosto de 1994"
24,7,37,1369,367,344,711,"21 de agosto de 1994"
24,7,37,1370,140,126,266,"21 de agosto de 1994"
24,7,37,1371,358,305,663,"21 de agosto de 1994"
24,7,37,1372,274,227,501,"21 de agosto de 1994"
24,7,37,1373,425,364,789,"21 de agosto de 1994"
24,7,37,1374,113,102,215,"21 de agosto de 1994"
24,7,37,1375,245,221,466,"21 de agosto de 1994"
24,7,37,1376,472,361,833,"21 de agosto de 1994"
24,7,37,1377,263,191,454,"21 de agosto de 1994"
24,7,37,1378,307,256,563,"21 de agosto de 1994"
24,7,37,1379,86,71,157,"21 de agosto de 1994"
24,7,37,1380,407,391,798,"21 de agosto de 1994"
24,7,37,1381,211,152,363,"21 de agosto de 1994"
24,7,37,1382,359,295,654,"21 de agosto de 1994"
24,7,37,1383,399,364,763,"21 de agosto de 1994"
24,7,37,1384,230,177,407,"21 de agosto de 1994"
24,7,37,1385,430,425,855,"21 de agosto de 1994"
24,7,37,1386,333,342,675,"21 de agosto de 1994"
24,7,37,1387,247,237,484,"21 de agosto de 1994"
24,7,37,1388,409,390,799,"21 de agosto de 1994"
24,7,37,1389,205,178,383,"21 de agosto de 1994"
24,7,37,1390,354,314,668,"21 de agosto de 1994"
24,7,37,1391,365,355,720,"21 de agosto de 1994"
24,7,37,1392,522,434,956,"21 de agosto de 1994"
24,7,37,1393,342,312,654,"21 de agosto de 1994"
24,7,37,1394,178,160,338,"21 de agosto de 1994"
24,7,37,1395,572,603,1175,"21 de agosto de 1994"
24,7,37,1396,311,308,619,"21 de agosto de 1994"
24,7,37,1397,222,220,442,"21 de agosto de 1994"
24,7,37,1398,475,373,848,"21 de agosto de 1994"
24,7,37,1399,285,266,551,"21 de agosto de 1994"
24,7,37,1400,195,172,367,"21 de agosto de 1994"
24,7,37,1401,273,256,529,"21 de agosto de 1994"
24,7,37,1402,267,231,498,"21 de agosto de 1994"
24,7,37,1403,119,119,238,"21 de agosto de 1994"
24,7,37,1404,306,293,599,"21 de agosto de 1994"
24,7,37,1405,207,193,400,"21 de agosto de 1994"
24,7,37,1406,200,167,367,"21 de agosto de 1994"
24,7,37,1407,228,206,434,"21 de agosto de 1994"
24,7,37,1408,202,159,361,"21 de agosto de 1994"
24,7,37,1409,461,391,852,"21 de agosto de 1994"
24,7,37,1410,443,392,835,"21 de agosto de 1994"
24,7,37,1411,341,360,701,"21 de agosto de 1994"
24,7,38,1412,218,220,438,"21 de agosto de 1994"
24,7,38,1413,105,113,218,"21 de agosto de 1994"
24,7,38,1414,257,219,476,"21 de agosto de 1994"
24,7,38,1415,156,146,302,"21 de agosto de 1994"
24,7,38,1416,95,88,183,"21 de agosto de 1994"
24,7,38,1417,343,306,649,"21 de agosto de 1994"
24,7,38,1418,432,374,806,"21 de agosto de 1994"
24,7,38,1419,129,112,241,"21 de agosto de 1994"
24,7,38,1420,85,75,160,"21 de agosto de 1994"
24,7,38,1421,188,162,350,"21 de agosto de 1994"
24,7,38,1422,249,213,462,"21 de agosto de 1994"
24,7,38,1423,280,238,518,"21 de agosto de 1994"
24,7,38,1424,245,235,480,"21 de agosto de 1994"
24,7,38,1425,305,261,566,"21 de agosto de 1994"
24,7,38,1426,200,177,377,"21 de agosto de 1994"
24,7,38,1427,471,426,897,"21 de agosto de 1994"
24,7,42,1496,552,495,1047,"21 de agosto de 1994"
24,7,42,1497,484,484,968,"21 de agosto de 1994"
24,7,42,1498,446,494,940,"21 de agosto de 1994"
24,7,42,1499,379,415,794,"21 de agosto de 1994"
24,7,42,1500,473,463,936,"21 de agosto de 1994"
24,7,42,1501,355,343,698,"21 de agosto de 1994"
24,7,42,1502,199,198,397,"21 de agosto de 1994"
24,7,42,1503,114,83,197,"21 de agosto de 1994"
24,7,42,1504,190,173,363,"21 de agosto de 1994"
24,7,42,1505,56,55,111,"21 de agosto de 1994"
24,7,42,1506,66,47,113,"21 de agosto de 1994"
24,7,54,372,1,0,1,"21 de agosto de 1994"
24,7,54,1705,477,460,937,"21 de agosto de 1994"
24,7,54,1706,425,447,872,"21 de agosto de 1994"
24,7,54,1707,256,284,540,"21 de agosto de 1994"
24,7,54,1708,380,422,802,"21 de agosto de 1994"
24,7,54,1709,293,274,567,"21 de agosto de 1994"
24,7,54,1710,232,216,448,"21 de agosto de 1994"
24,7,54,1711,472,451,923,"21 de agosto de 1994"
24,7,54,1712,187,171,358,"21 de agosto de 1994"
24,7,54,1713,168,141,309,"21 de agosto de 1994"
24,7,54,1714,341,347,688,"21 de agosto de 1994"
24,7,54,1715,235,237,472,"21 de agosto de 1994"
24,7,54,1716,390,368,758,"21 de agosto de 1994"
24,7,54,1717,241,226,467,"21 de agosto de 1994"
24,7,54,1718,249,238,487,"21 de agosto de 1994"
24,7,54,1719,370,336,706,"21 de agosto de 1994"
24,7,54,1720,610,594,1204,"21 de agosto de 1994"
24,7,54,1721,320,269,589,"21 de agosto de 1994"
24,7,54,1722,357,316,673,"21 de agosto de 1994"
24,7,54,1723,443,397,840,"21 de agosto de 1994"
24,7,54,1724,350,323,673,"21 de agosto de 1994"
24,7,54,1725,449,395,844,"21 de agosto de 1994"
24,7,55,1726,412,421,833,"21 de agosto de 1994"
24,7,55,1727,337,367,704,"21 de agosto de 1994"
24,7,55,1728,232,227,459,"21 de agosto de 1994"
24,7,55,1729,188,211,399,"21 de agosto de 1994"
24,7,55,1730,399,413,812,"21 de agosto de 1994"
24,7,55,1731,374,335,709,"21 de agosto de 1994"
24,7,55,1732,338,339,677,"21 de agosto de 1994"
24,7,55,1733,143,132,275,"21 de agosto de 1994"
24,7,55,1734,144,145,289,"21 de agosto de 1994"
24,7,55,1735,253,201,454,"21 de agosto de 1994"
24,7,55,1736,64,64,128,"21 de agosto de 1994"
24,7,55,1737,191,157,348,"21 de agosto de 1994"
24,7,55,1738,115,114,229,"21 de agosto de 1994"
24,7,55,1739,380,345,725,"21 de agosto de 1994"
24,7,55,1740,208,233,441,"21 de agosto de 1994"
24,7,55,1741,274,227,501,"21 de agosto de 1994"
24,7,55,1742,133,122,255,"21 de agosto de 1994"
24,7,55,1743,164,144,308,"21 de agosto de 1994"
24,7,55,1744,187,149,336,"21 de agosto de 1994"
24,7,55,1745,74,59,133,"21 de agosto de 1994"
24,7,55,1746,96,94,190,"21 de agosto de 1994"
24,7,55,1747,307,243,550,"21 de agosto de 1994"
24,7,55,1748,130,117,247,"21 de agosto de 1994"
24,7,55,1749,312,274,586,"21 de agosto de 1994"
24,7,55,1750,244,178,422,"21 de agosto de 1994"
24,7,55,1751,317,281,598,"21 de agosto de 1994"
24,7,55,1752,150,155,305,"21 de agosto de 1994"
24,7,55,1753,276,235,511,"21 de agosto de 1994"
24,7,55,1754,170,148,318,"21 de agosto de 1994"
24,7,55,1755,281,261,542,"21 de agosto de 1994"
24,7,55,1756,142,157,299,"21 de agosto de 1994"
24,7,55,1757,115,91,206,"21 de agosto de 1994"
24,7,55,1758,151,126,277,"21 de agosto de 1994"
24,7,55,1759,233,221,454,"21 de agosto de 1994"
24,7,55,1760,281,243,524,"21 de agosto de 1994"
24,7,55,1761,156,142,298,"21 de agosto de 1994"
24,7,55,1762,332,277,609,"21 de agosto de 1994"
24,7,55,1763,246,219,465,"21 de agosto de 1994"
24,7,55,1764,90,71,161,"21 de agosto de 1994"
24,7,55,1765,193,170,363,"21 de agosto de 1994"
24,7,55,1766,211,189,400,"21 de agosto de 1994"
24,7,55,1767,320,254,574,"21 de agosto de 1994"
24,7,55,1768,139,147,286,"21 de agosto de 1994"
24,7,55,1769,351,371,722,"21 de agosto de 1994"
24,7,55,1770,173,132,305,"21 de agosto de 1994"
24,7,55,1771,182,145,327,"21 de agosto de 1994"
24,7,55,1772,279,252,531,"21 de agosto de 1994"
25,1,1,1,132,180,312,"21 de agosto de 1994"
25,1,1,2,111,144,255,"21 de agosto de 1994"
25,1,1,3,136,166,302,"21 de agosto de 1994"
25,1,1,4,155,181,336,"21 de agosto de 1994"
25,1,1,5,167,203,370,"21 de agosto de 1994"
25,1,1,6,122,144,266,"21 de agosto de 1994"
25,1,1,7,234,282,516,"21 de agosto de 1994"
25,1,1,8,241,297,538,"21 de agosto de 1994"
25,1,1,9,132,155,287,"21 de agosto de 1994"
25,1,1,10,251,273,524,"21 de agosto de 1994"
25,1,1,11,224,239,463,"21 de agosto de 1994"
25,1,1,12,152,169,321,"21 de agosto de 1994"
25,1,1,13,190,182,372,"21 de agosto de 1994"
25,1,1,14,175,174,349,"21 de agosto de 1994"
25,1,1,15,161,170,331,"21 de agosto de 1994"
25,1,1,16,144,176,320,"21 de agosto de 1994"
25,1,1,17,215,213,428,"21 de agosto de 1994"
25,1,1,18,104,122,226,"21 de agosto de 1994"
25,1,1,19,187,231,418,"21 de agosto de 1994"
25,1,1,20,222,279,501,"21 de agosto de 1994"
25,1,1,21,77,94,171,"21 de agosto de 1994"
25,1,1,22,108,124,232,"21 de agosto de 1994"
25,1,1,23,129,146,275,"21 de agosto de 1994"
25,1,1,24,242,289,531,"21 de agosto de 1994"
25,1,1,25,270,348,618,"21 de agosto de 1994"
25,1,1,26,140,159,299,"21 de agosto de 1994"
25,1,1,27,151,141,292,"21 de agosto de 1994"
25,1,1,28,221,264,485,"21 de agosto de 1994"
25,1,1,29,165,199,364,"21 de agosto de 1994"
25,1,1,30,196,253,449,"21 de agosto de 1994"
25,1,1,31,157,173,330,"21 de agosto de 1994"
25,1,1,32,256,274,530,"21 de agosto de 1994"
25,1,1,33,131,151,282,"21 de agosto de 1994"
25,1,1,34,148,161,309,"21 de agosto de 1994"
25,1,1,35,172,169,341,"21 de agosto de 1994"
25,1,1,36,135,129,264,"21 de agosto de 1994"
25,1,1,37,134,159,293,"21 de agosto de 1994"
25,1,1,38,95,114,209,"21 de agosto de 1994"
25,1,1,39,209,265,474,"21 de agosto de 1994"
25,1,1,40,140,156,296,"21 de agosto de 1994"
25,1,1,41,180,209,389,"21 de agosto de 1994"
25,1,1,42,279,289,568,"21 de agosto de 1994"
25,1,1,43,181,223,404,"21 de agosto de 1994"
25,1,1,44,140,145,285,"21 de agosto de 1994"
25,1,1,45,249,230,479,"21 de agosto de 1994"
25,1,1,46,197,204,401,"21 de agosto de 1994"
25,1,1,47,187,171,358,"21 de agosto de 1994"
25,1,1,48,252,338,590,"21 de agosto de 1994"
25,1,1,49,39,38,77,"21 de agosto de 1994"
25,1,1,50,92,98,190,"21 de agosto de 1994"
25,1,1,51,125,158,283,"21 de agosto de 1994"
25,1,1,52,228,247,475,"21 de agosto de 1994"
25,1,1,53,217,237,454,"21 de agosto de 1994"
25,1,1,54,170,189,359,"21 de agosto de 1994"
25,1,1,55,296,315,611,"21 de agosto de 1994"
25,1,1,56,147,159,306,"21 de agosto de 1994"
25,1,1,57,171,167,338,"21 de agosto de 1994"
25,1,1,58,174,161,335,"21 de agosto de 1994"
25,1,1,59,113,144,257,"21 de agosto de 1994"
25,1,1,60,130,140,270,"21 de agosto de 1994"
25,1,1,61,211,252,463,"21 de agosto de 1994"
25,1,1,62,140,144,284,"21 de agosto de 1994"
25,1,1,63,361,395,756,"21 de agosto de 1994"
25,1,1,64,165,201,366,"21 de agosto de 1994"
25,1,1,65,220,226,446,"21 de agosto de 1994"
25,1,1,66,158,194,352,"21 de agosto de 1994"
25,1,1,67,178,206,384,"21 de agosto de 1994"
25,1,1,68,179,215,394,"21 de agosto de 1994"
25,1,1,69,421,449,870,"21 de agosto de 1994"
25,1,1,70,175,171,346,"21 de agosto de 1994"
25,1,1,71,91,100,191,"21 de agosto de 1994"
25,1,1,72,140,186,326,"21 de agosto de 1994"
25,1,1,73,115,148,263,"21 de agosto de 1994"
25,1,1,74,163,171,334,"21 de agosto de 1994"
25,1,1,75,173,175,348,"21 de agosto de 1994"
25,1,1,76,120,132,252,"21 de agosto de 1994"
25,1,1,77,166,183,349,"21 de agosto de 1994"
25,1,1,78,122,148,270,"21 de agosto de 1994"
25,1,1,79,178,209,387,"21 de agosto de 1994"
25,1,1,80,205,232,437,"21 de agosto de 1994"
25,1,1,81,206,219,425,"21 de agosto de 1994"
25,1,1,82,212,244,456,"21 de agosto de 1994"
25,1,1,83,126,144,270,"21 de agosto de 1994"
25,1,1,84,326,325,651,"21 de agosto de 1994"
25,1,1,85,183,201,384,"21 de agosto de 1994"
25,1,1,86,182,228,410,"21 de agosto de 1994"
25,1,1,87,316,358,674,"21 de agosto de 1994"
25,1,1,88,310,343,653,"21 de agosto de 1994"
25,1,1,89,135,136,271,"21 de agosto de 1994"
25,1,1,90,133,156,289,"21 de agosto de 1994"
25,1,1,91,213,243,456,"21 de agosto de 1994"
25,1,1,92,145,167,312,"21 de agosto de 1994"
25,1,1,93,163,188,351,"21 de agosto de 1994"
25,1,1,94,156,145,301,"21 de agosto de 1994"
25,1,1,95,217,246,463,"21 de agosto de 1994"
25,1,1,96,233,260,493,"21 de agosto de 1994"
25,1,1,97,215,255,470,"21 de agosto de 1994"
25,1,1,98,207,262,469,"21 de agosto de 1994"
25,1,1,99,206,231,437,"21 de agosto de 1994"
25,1,1,100,189,229,418,"21 de agosto de 1994"
25,1,1,101,237,265,502,"21 de agosto de 1994"
25,1,1,102,194,185,379,"21 de agosto de 1994"
25,1,1,103,83,79,162,"21 de agosto de 1994"
25,1,1,104,70,86,156,"21 de agosto de 1994"
25,1,1,105,128,145,273,"21 de agosto de 1994"
25,1,1,106,146,136,282,"21 de agosto de 1994"
25,1,1,107,134,141,275,"21 de agosto de 1994"
25,1,1,108,162,155,317,"21 de agosto de 1994"
25,1,1,109,79,93,172,"21 de agosto de 1994"
25,1,1,110,201,186,387,"21 de agosto de 1994"
25,1,1,111,173,234,407,"21 de agosto de 1994"
25,1,1,112,107,120,227,"21 de agosto de 1994"
25,1,1,113,106,150,256,"21 de agosto de 1994"
25,1,1,114,223,252,475,"21 de agosto de 1994"
25,1,1,115,314,337,651,"21 de agosto de 1994"
25,1,1,116,197,234,431,"21 de agosto de 1994"
25,1,1,117,162,179,341,"21 de agosto de 1994"
25,1,1,118,114,153,267,"21 de agosto de 1994"
25,1,1,119,302,325,627,"21 de agosto de 1994"
25,1,1,120,297,316,613,"21 de agosto de 1994"
25,1,1,121,229,253,482,"21 de agosto de 1994"
25,1,1,122,220,241,461,"21 de agosto de 1994"
25,1,1,123,127,136,263,"21 de agosto de 1994"
25,1,1,124,192,215,407,"21 de agosto de 1994"
25,1,1,125,139,175,314,"21 de agosto de 1994"
25,1,1,126,247,270,517,"21 de agosto de 1994"
25,1,1,127,158,176,334,"21 de agosto de 1994"
25,1,1,128,157,168,325,"21 de agosto de 1994"
25,1,1,129,216,242,458,"21 de agosto de 1994"
25,1,1,130,172,184,356,"21 de agosto de 1994"
25,1,1,131,146,176,322,"21 de agosto de 1994"
25,1,1,132,240,222,462,"21 de agosto de 1994"
25,1,1,133,286,348,634,"21 de agosto de 1994"
25,1,1,134,106,102,208,"21 de agosto de 1994"
25,1,1,135,121,155,276,"21 de agosto de 1994"
25,1,1,136,204,204,408,"21 de agosto de 1994"
25,1,1,137,215,237,452,"21 de agosto de 1994"
25,1,1,138,210,234,444,"21 de agosto de 1994"
25,1,1,139,228,277,505,"21 de agosto de 1994"
25,1,1,140,158,139,297,"21 de agosto de 1994"
25,1,1,141,197,219,416,"21 de agosto de 1994"
25,1,1,142,158,172,330,"21 de agosto de 1994"
25,1,1,143,277,295,572,"21 de agosto de 1994"
25,1,1,144,161,174,335,"21 de agosto de 1994"
25,1,1,145,122,159,281,"21 de agosto de 1994"
25,1,1,146,176,196,372,"21 de agosto de 1994"
25,1,1,147,214,262,476,"21 de agosto de 1994"
25,1,1,148,165,224,389,"21 de agosto de 1994"
25,1,1,149,131,167,298,"21 de agosto de 1994"
25,1,1,150,168,208,376,"21 de agosto de 1994"
25,1,1,151,172,204,376,"21 de agosto de 1994"
25,1,1,152,198,211,409,"21 de agosto de 1994"
25,1,1,153,164,183,347,"21 de agosto de 1994"
25,1,1,154,215,244,459,"21 de agosto de 1994"
25,1,1,155,123,158,281,"21 de agosto de 1994"
25,1,1,156,115,142,257,"21 de agosto de 1994"
25,1,1,157,294,293,587,"21 de agosto de 1994"
25,1,1,158,248,285,533,"21 de agosto de 1994"
25,1,1,159,62,70,132,"21 de agosto de 1994"
25,1,1,160,143,182,325,"21 de agosto de 1994"
25,1,1,161,213,235,448,"21 de agosto de 1994"
25,1,1,162,290,357,647,"21 de agosto de 1994"
25,1,1,163,135,144,279,"21 de agosto de 1994"
25,1,1,164,225,268,493,"21 de agosto de 1994"
25,1,1,165,187,225,412,"21 de agosto de 1994"
25,1,1,166,246,273,519,"21 de agosto de 1994"
25,1,1,167,156,176,332,"21 de agosto de 1994"
25,1,1,168,125,155,280,"21 de agosto de 1994"
25,1,1,169,229,252,481,"21 de agosto de 1994"
25,1,1,170,333,385,718,"21 de agosto de 1994"
25,1,1,171,257,321,578,"21 de agosto de 1994"
25,1,1,172,97,116,213,"21 de agosto de 1994"
25,1,1,173,106,144,250,"21 de agosto de 1994"
25,1,1,174,246,305,551,"21 de agosto de 1994"
25,1,1,175,160,178,338,"21 de agosto de 1994"
25,1,1,176,151,192,343,"21 de agosto de 1994"
25,1,1,177,138,160,298,"21 de agosto de 1994"
25,1,1,178,117,118,235,"21 de agosto de 1994"
25,1,1,179,233,260,493,"21 de agosto de 1994"
25,1,1,180,227,248,475,"21 de agosto de 1994"
25,1,1,181,207,211,418,"21 de agosto de 1994"
25,1,1,182,192,195,387,"21 de agosto de 1994"
25,1,1,183,129,176,305,"21 de agosto de 1994"
25,1,1,184,140,174,314,"21 de agosto de 1994"
25,1,1,185,336,377,713,"21 de agosto de 1994"
25,1,1,186,160,159,319,"21 de agosto de 1994"
25,1,1,187,151,147,298,"21 de agosto de 1994"
25,1,1,188,136,160,296,"21 de agosto de 1994"
25,1,1,189,205,229,434,"21 de agosto de 1994"
25,1,1,190,142,194,336,"21 de agosto de 1994"
25,1,1,191,251,279,530,"21 de agosto de 1994"
25,1,1,192,174,232,406,"21 de agosto de 1994"
25,1,1,193,203,256,459,"21 de agosto de 1994"
25,1,1,194,146,179,325,"21 de agosto de 1994"
25,1,1,195,152,206,358,"21 de agosto de 1994"
25,1,1,196,268,299,567,"21 de agosto de 1994"
25,1,1,197,211,252,463,"21 de agosto de 1994"
25,1,1,198,68,87,155,"21 de agosto de 1994"
25,1,1,199,408,432,840,"21 de agosto de 1994"
25,1,1,200,192,218,410,"21 de agosto de 1994"
25,1,1,201,63,82,145,"21 de agosto de 1994"
25,1,1,202,221,247,468,"21 de agosto de 1994"
25,1,1,203,140,157,297,"21 de agosto de 1994"
25,1,1,204,238,256,494,"21 de agosto de 1994"
25,1,1,205,170,176,346,"21 de agosto de 1994"
25,1,1,206,273,245,518,"21 de agosto de 1994"
25,1,1,207,273,286,559,"21 de agosto de 1994"
25,1,1,208,115,135,250,"21 de agosto de 1994"
25,1,1,209,327,387,714,"21 de agosto de 1994"
25,1,1,210,183,210,393,"21 de agosto de 1994"
25,1,1,211,171,214,385,"21 de agosto de 1994"
25,1,1,212,201,218,419,"21 de agosto de 1994"
25,1,1,213,240,260,500,"21 de agosto de 1994"
25,1,1,214,144,150,294,"21 de agosto de 1994"
25,1,1,215,221,209,430,"21 de agosto de 1994"
25,1,1,216,206,241,447,"21 de agosto de 1994"
25,1,1,217,193,201,394,"21 de agosto de 1994"
25,1,1,218,278,308,586,"21 de agosto de 1994"
25,1,1,219,258,297,555,"21 de agosto de 1994"
25,1,1,220,242,276,518,"21 de agosto de 1994"
25,1,1,221,210,222,432,"21 de agosto de 1994"
25,1,1,222,164,192,356,"21 de agosto de 1994"
25,1,1,223,241,277,518,"21 de agosto de 1994"
25,1,1,224,283,295,578,"21 de agosto de 1994"
25,1,1,225,116,111,227,"21 de agosto de 1994"
25,1,1,226,91,97,188,"21 de agosto de 1994"
25,1,1,227,124,148,272,"21 de agosto de 1994"
25,1,1,228,115,110,225,"21 de agosto de 1994"
25,1,1,229,153,167,320,"21 de agosto de 1994"
25,1,1,230,113,144,257,"21 de agosto de 1994"
25,1,1,231,111,129,240,"21 de agosto de 1994"
25,1,1,232,251,307,558,"21 de agosto de 1994"
25,1,1,233,199,280,479,"21 de agosto de 1994"
25,1,1,234,127,129,256,"21 de agosto de 1994"
25,1,1,235,101,136,237,"21 de agosto de 1994"
25,1,1,236,150,162,312,"21 de agosto de 1994"
25,1,1,237,184,181,365,"21 de agosto de 1994"
25,1,1,238,88,98,186,"21 de agosto de 1994"
25,1,1,239,110,122,232,"21 de agosto de 1994"
25,1,1,240,455,560,1015,"21 de agosto de 1994"
25,1,1,241,143,174,317,"21 de agosto de 1994"
25,1,1,242,122,101,223,"21 de agosto de 1994"
25,1,1,243,151,130,281,"21 de agosto de 1994"
25,1,1,244,226,194,420,"21 de agosto de 1994"
25,1,1,245,249,254,503,"21 de agosto de 1994"
25,1,1,246,147,176,323,"21 de agosto de 1994"
25,1,1,247,208,234,442,"21 de agosto de 1994"
25,1,1,248,346,337,683,"21 de agosto de 1994"
25,1,1,249,224,227,451,"21 de agosto de 1994"
25,1,1,250,203,247,450,"21 de agosto de 1994"
25,1,1,251,198,220,418,"21 de agosto de 1994"
25,1,1,252,255,242,497,"21 de agosto de 1994"
25,1,1,253,191,191,382,"21 de agosto de 1994"
25,1,1,254,202,168,370,"21 de agosto de 1994"
25,1,1,255,195,188,383,"21 de agosto de 1994"
25,1,1,256,205,208,413,"21 de agosto de 1994"
25,1,1,257,153,139,292,"21 de agosto de 1994"
25,1,1,258,255,268,523,"21 de agosto de 1994"
25,1,1,259,188,217,405,"21 de agosto de 1994"
25,1,1,260,333,333,666,"21 de agosto de 1994"
25,1,1,261,248,247,495,"21 de agosto de 1994"
25,1,1,262,577,215,792,"21 de agosto de 1994"
25,1,1,263,155,142,297,"21 de agosto de 1994"
25,1,1,264,112,110,222,"21 de agosto de 1994"
25,1,1,265,219,232,451,"21 de agosto de 1994"
25,1,1,266,31,22,53,"21 de agosto de 1994"
25,1,1,267,139,162,301,"21 de agosto de 1994"
25,1,1,268,42,36,78,"21 de agosto de 1994"
25,1,1,269,166,169,335,"21 de agosto de 1994"
25,1,1,270,186,182,368,"21 de agosto de 1994"
25,1,1,271,254,245,499,"21 de agosto de 1994"
25,1,1,272,129,113,242,"21 de agosto de 1994"
25,1,1,273,287,243,530,"21 de agosto de 1994"
25,1,1,274,112,84,196,"21 de agosto de 1994"
25,1,1,275,61,56,117,"21 de agosto de 1994"
25,1,1,276,159,149,308,"21 de agosto de 1994"
25,1,1,277,110,59,169,"21 de agosto de 1994"
25,1,1,278,210,279,489,"21 de agosto de 1994"
25,1,1,279,229,224,453,"21 de agosto de 1994"
25,1,1,280,217,218,435,"21 de agosto de 1994"
25,1,1,281,279,252,531,"21 de agosto de 1994"
25,1,1,282,305,283,588,"21 de agosto de 1994"
25,1,1,283,305,289,594,"21 de agosto de 1994"
25,1,1,284,191,202,393,"21 de agosto de 1994"
25,1,1,285,225,245,470,"21 de agosto de 1994"
25,1,1,286,122,151,273,"21 de agosto de 1994"
25,1,1,287,156,173,329,"21 de agosto de 1994"
25,1,1,288,147,128,275,"21 de agosto de 1994"
25,1,1,289,121,130,251,"21 de agosto de 1994"
25,1,1,290,330,314,644,"21 de agosto de 1994"
25,1,1,291,198,194,392,"21 de agosto de 1994"
25,1,1,292,212,192,404,"21 de agosto de 1994"
25,1,1,293,201,212,413,"21 de agosto de 1994"
25,1,1,294,236,257,493,"21 de agosto de 1994"
25,1,1,295,199,200,399,"21 de agosto de 1994"
25,1,1,296,67,59,126,"21 de agosto de 1994"
25,1,1,297,332,333,665,"21 de agosto de 1994"
25,1,1,298,416,441,857,"21 de agosto de 1994"
25,1,1,299,232,217,449,"21 de agosto de 1994"
25,1,1,300,109,97,206,"21 de agosto de 1994"
25,1,1,301,156,157,313,"21 de agosto de 1994"
25,1,1,302,190,197,387,"21 de agosto de 1994"
25,1,1,303,179,163,342,"21 de agosto de 1994"
25,1,1,304,305,297,602,"21 de agosto de 1994"
25,1,1,305,109,119,228,"21 de agosto de 1994"
25,1,1,306,220,200,420,"21 de agosto de 1994"
25,1,1,307,158,150,308,"21 de agosto de 1994"
25,1,1,308,164,163,327,"21 de agosto de 1994"
25,1,1,309,135,114,249,"21 de agosto de 1994"
25,1,1,310,34,38,72,"21 de agosto de 1994"
25,1,1,311,198,162,360,"21 de agosto de 1994"
25,1,1,312,311,251,562,"21 de agosto de 1994"
25,1,1,313,268,275,543,"21 de agosto de 1994"
25,1,1,314,225,234,459,"21 de agosto de 1994"
25,1,1,315,221,229,450,"21 de agosto de 1994"
25,1,1,316,242,239,481,"21 de agosto de 1994"
25,1,1,317,129,157,286,"21 de agosto de 1994"
25,1,1,318,207,194,401,"21 de agosto de 1994"
25,1,1,319,123,153,276,"21 de agosto de 1994"
25,1,1,320,187,194,381,"21 de agosto de 1994"
25,1,1,321,288,322,610,"21 de agosto de 1994"
25,1,1,322,127,139,266,"21 de agosto de 1994"
25,1,1,323,189,172,361,"21 de agosto de 1994"
25,1,1,324,213,180,393,"21 de agosto de 1994"
25,1,1,325,90,58,148,"21 de agosto de 1994"
25,1,1,326,247,239,486,"21 de agosto de 1994"
25,1,1,327,163,172,335,"21 de agosto de 1994"
25,1,1,328,212,180,392,"21 de agosto de 1994"
25,1,1,329,237,251,488,"21 de agosto de 1994"
25,1,1,330,141,121,262,"21 de agosto de 1994"
25,1,1,331,126,144,270,"21 de agosto de 1994"
25,1,1,332,130,130,260,"21 de agosto de 1994"
25,1,1,333,120,93,213,"21 de agosto de 1994"
25,1,1,334,179,171,350,"21 de agosto de 1994"
25,1,1,335,225,198,423,"21 de agosto de 1994"
25,1,1,336,271,251,522,"21 de agosto de 1994"
25,1,1,337,145,131,276,"21 de agosto de 1994"
25,1,1,338,77,64,141,"21 de agosto de 1994"
25,1,1,339,212,190,402,"21 de agosto de 1994"
25,1,1,340,121,93,214,"21 de agosto de 1994"
25,1,1,341,95,96,191,"21 de agosto de 1994"
25,1,1,342,253,243,496,"21 de agosto de 1994"
25,1,1,343,202,171,373,"21 de agosto de 1994"
25,1,1,344,201,183,384,"21 de agosto de 1994"
25,1,1,345,226,216,442,"21 de agosto de 1994"
25,1,1,346,239,220,459,"21 de agosto de 1994"
25,1,1,347,144,125,269,"21 de agosto de 1994"
25,1,1,348,108,113,221,"21 de agosto de 1994"
25,1,1,349,285,278,563,"21 de agosto de 1994"
25,1,1,350,168,173,341,"21 de agosto de 1994"
25,1,1,351,191,201,392,"21 de agosto de 1994"
25,1,1,352,222,208,430,"21 de agosto de 1994"
25,1,1,353,267,246,513,"21 de agosto de 1994"
25,1,1,354,268,274,542,"21 de agosto de 1994"
25,1,1,355,260,253,513,"21 de agosto de 1994"
25,1,1,356,229,172,401,"21 de agosto de 1994"
25,1,1,357,148,157,305,"21 de agosto de 1994"
25,1,1,358,211,182,393,"21 de agosto de 1994"
25,1,1,359,211,190,401,"21 de agosto de 1994"
25,1,1,360,344,364,708,"21 de agosto de 1994"
25,1,1,361,383,368,751,"21 de agosto de 1994"
25,1,1,362,362,347,709,"21 de agosto de 1994"
25,1,1,363,510,420,930,"21 de agosto de 1994"
25,1,1,364,350,345,695,"21 de agosto de 1994"
25,1,1,365,281,281,562,"21 de agosto de 1994"
25,1,1,366,239,176,415,"21 de agosto de 1994"
25,1,1,367,157,151,308,"21 de agosto de 1994"
25,2,11,2101,249,272,521,"21 de agosto de 1994"
25,2,11,2102,176,203,379,"21 de agosto de 1994"
25,2,11,2103,157,165,322,"21 de agosto de 1994"
25,2,11,2104,107,130,237,"21 de agosto de 1994"
25,2,11,2105,138,181,319,"21 de agosto de 1994"
25,2,11,2106,156,178,334,"21 de agosto de 1994"
25,2,11,2107,168,189,357,"21 de agosto de 1994"
25,2,11,2108,121,151,272,"21 de agosto de 1994"
25,2,11,2109,161,182,343,"21 de agosto de 1994"
25,2,11,2110,193,219,412,"21 de agosto de 1994"
25,2,11,2111,356,412,768,"21 de agosto de 1994"
25,2,11,2112,125,157,282,"21 de agosto de 1994"
25,2,11,2113,140,174,314,"21 de agosto de 1994"
25,2,11,2114,138,172,310,"21 de agosto de 1994"
25,2,11,2115,121,138,259,"21 de agosto de 1994"
25,2,11,2116,179,199,378,"21 de agosto de 1994"
25,2,11,2117,169,172,341,"21 de agosto de 1994"
25,2,11,2118,217,244,461,"21 de agosto de 1994"
25,2,11,2119,227,244,471,"21 de agosto de 1994"
25,2,11,2120,230,227,457,"21 de agosto de 1994"
25,2,11,2121,185,201,386,"21 de agosto de 1994"
25,2,11,2122,162,179,341,"21 de agosto de 1994"
25,2,11,2123,157,165,322,"21 de agosto de 1994"
25,2,11,2124,118,152,270,"21 de agosto de 1994"
25,2,11,2125,103,146,249,"21 de agosto de 1994"
25,2,11,2126,195,206,401,"21 de agosto de 1994"
25,2,11,2127,111,140,251,"21 de agosto de 1994"
25,2,11,2128,105,151,256,"21 de agosto de 1994"
25,2,11,2129,118,134,252,"21 de agosto de 1994"
25,2,11,2130,126,138,264,"21 de agosto de 1994"
25,2,11,2131,86,109,195,"21 de agosto de 1994"
25,2,11,2132,159,162,321,"21 de agosto de 1994"
25,2,11,2133,239,258,497,"21 de agosto de 1994"
25,2,11,2134,200,229,429,"21 de agosto de 1994"
25,2,11,2135,161,162,323,"21 de agosto de 1994"
25,2,11,2136,198,213,411,"21 de agosto de 1994"
25,2,11,2137,155,177,332,"21 de agosto de 1994"
25,2,11,2138,180,209,389,"21 de agosto de 1994"
25,2,11,2139,217,261,478,"21 de agosto de 1994"
25,2,11,2140,147,182,329,"21 de agosto de 1994"
25,2,11,2141,105,127,232,"21 de agosto de 1994"
25,2,11,2142,162,176,338,"21 de agosto de 1994"
25,2,11,2143,84,110,194,"21 de agosto de 1994"
25,2,11,2144,104,131,235,"21 de agosto de 1994"
25,2,11,2145,134,147,281,"21 de agosto de 1994"
25,2,11,2146,142,180,322,"21 de agosto de 1994"
25,2,11,2147,126,133,259,"21 de agosto de 1994"
25,2,11,2148,115,112,227,"21 de agosto de 1994"
25,2,11,2149,106,111,217,"21 de agosto de 1994"
25,2,11,2150,84,123,207,"21 de agosto de 1994"
25,2,11,2151,90,126,216,"21 de agosto de 1994"
25,2,11,2152,108,122,230,"21 de agosto de 1994"
25,2,11,2153,161,176,337,"21 de agosto de 1994"
25,2,11,2154,188,226,414,"21 de agosto de 1994"
25,2,11,2155,192,235,427,"21 de agosto de 1994"
25,2,11,2156,200,216,416,"21 de agosto de 1994"
25,2,11,2157,168,192,360,"21 de agosto de 1994"
25,2,11,2158,202,235,437,"21 de agosto de 1994"
25,2,11,2159,97,130,227,"21 de agosto de 1994"
25,2,11,2160,121,130,251,"21 de agosto de 1994"
25,2,11,2161,121,126,247,"21 de agosto de 1994"
25,2,11,2162,91,101,192,"21 de agosto de 1994"
25,2,11,2163,121,140,261,"21 de agosto de 1994"
25,2,11,2164,156,168,324,"21 de agosto de 1994"
25,2,11,2165,166,231,397,"21 de agosto de 1994"
25,2,11,2166,99,104,203,"21 de agosto de 1994"
25,2,11,2167,118,153,271,"21 de agosto de 1994"
25,2,11,2168,92,108,200,"21 de agosto de 1994"
25,2,11,2169,55,73,128,"21 de agosto de 1994"
25,2,11,2170,121,130,251,"21 de agosto de 1994"
25,2,11,2171,144,162,306,"21 de agosto de 1994"
25,2,11,2172,127,153,280,"21 de agosto de 1994"
25,2,11,2173,150,171,321,"21 de agosto de 1994"
25,2,11,2174,141,166,307,"21 de agosto de 1994"
25,2,11,2175,160,172,332,"21 de agosto de 1994"
25,2,11,2176,173,187,360,"21 de agosto de 1994"
25,2,11,2177,129,153,282,"21 de agosto de 1994"
25,2,11,2178,203,264,467,"21 de agosto de 1994"
25,2,11,2179,208,215,423,"21 de agosto de 1994"
25,2,11,2180,147,141,288,"21 de agosto de 1994"
25,2,11,2181,141,172,313,"21 de agosto de 1994"
25,2,11,2182,131,154,285,"21 de agosto de 1994"
25,2,11,2183,160,179,339,"21 de agosto de 1994"
25,2,11,2184,161,185,346,"21 de agosto de 1994"
25,2,11,2185,141,159,300,"21 de agosto de 1994"
25,2,11,2186,125,148,273,"21 de agosto de 1994"
25,2,11,2187,57,32,89,"21 de agosto de 1994"
25,2,11,2188,132,110,242,"21 de agosto de 1994"
25,2,11,2189,119,108,227,"21 de agosto de 1994"
25,2,11,2190,202,216,418,"21 de agosto de 1994"
25,2,11,2191,235,223,458,"21 de agosto de 1994"
25,2,11,2192,189,197,386,"21 de agosto de 1994"
25,2,11,2193,187,200,387,"21 de agosto de 1994"
25,2,11,2194,172,168,340,"21 de agosto de 1994"
25,2,11,2195,115,122,237,"21 de agosto de 1994"
25,2,11,2196,164,148,312,"21 de agosto de 1994"
25,2,11,2197,163,144,307,"21 de agosto de 1994"
25,2,11,2198,183,193,376,"21 de agosto de 1994"
25,2,11,2199,106,105,211,"21 de agosto de 1994"
25,2,11,2200,143,143,286,"21 de agosto de 1994"
25,2,11,2201,213,239,452,"21 de agosto de 1994"
25,2,11,2202,129,143,272,"21 de agosto de 1994"
25,2,11,2203,179,177,356,"21 de agosto de 1994"
25,2,11,2204,158,167,325,"21 de agosto de 1994"
25,2,11,2205,171,178,349,"21 de agosto de 1994"
25,2,11,2206,160,144,304,"21 de agosto de 1994"
25,2,11,2207,205,197,402,"21 de agosto de 1994"
25,2,11,2208,207,203,410,"21 de agosto de 1994"
25,2,11,2209,199,223,422,"21 de agosto de 1994"
25,2,11,2210,207,207,414,"21 de agosto de 1994"
25,2,11,2211,231,258,489,"21 de agosto de 1994"
25,2,11,2212,209,201,410,"21 de agosto de 1994"
25,2,11,2213,101,94,195,"21 de agosto de 1994"
25,2,11,2214,253,224,477,"21 de agosto de 1994"
25,2,11,2215,155,136,291,"21 de agosto de 1994"
25,2,11,2216,184,190,374,"21 de agosto de 1994"
25,2,11,2217,237,225,462,"21 de agosto de 1994"
25,2,11,2218,210,216,426,"21 de agosto de 1994"
25,2,11,2219,177,198,375,"21 de agosto de 1994"
25,2,11,2220,227,250,477,"21 de agosto de 1994"
25,2,11,2221,163,165,328,"21 de agosto de 1994"
25,2,11,2222,148,143,291,"21 de agosto de 1994"
25,2,11,2223,137,110,247,"21 de agosto de 1994"
25,2,11,2224,176,166,342,"21 de agosto de 1994"
25,2,11,2225,213,191,404,"21 de agosto de 1994"
25,2,11,2226,124,127,251,"21 de agosto de 1994"
25,2,11,2227,197,182,379,"21 de agosto de 1994"
25,2,11,2228,218,201,419,"21 de agosto de 1994"
25,2,11,2229,182,201,383,"21 de agosto de 1994"
25,2,11,2230,179,151,330,"21 de agosto de 1994"
25,2,11,2231,160,155,315,"21 de agosto de 1994"
25,2,11,2232,174,202,376,"21 de agosto de 1994"
25,2,11,2233,67,65,132,"21 de agosto de 1994"
25,2,11,2234,209,198,407,"21 de agosto de 1994"
25,2,11,2235,153,163,316,"21 de agosto de 1994"
25,2,11,2236,74,79,153,"21 de agosto de 1994"
25,2,11,2237,81,70,151,"21 de agosto de 1994"
25,2,11,2238,228,243,471,"21 de agosto de 1994"
25,2,11,2239,50,40,90,"21 de agosto de 1994"
25,2,11,2240,87,79,166,"21 de agosto de 1994"
25,2,11,2241,121,141,262,"21 de agosto de 1994"
25,2,11,2242,150,128,278,"21 de agosto de 1994"
25,2,11,2243,184,149,333,"21 de agosto de 1994"
25,2,11,2244,107,104,211,"21 de agosto de 1994"
25,2,11,2245,78,99,177,"21 de agosto de 1994"
25,2,11,2246,271,279,550,"21 de agosto de 1994"
25,2,11,2247,120,69,189,"21 de agosto de 1994"
25,2,11,2248,159,164,323,"21 de agosto de 1994"
25,2,11,2249,237,218,455,"21 de agosto de 1994"
25,2,11,2250,153,129,282,"21 de agosto de 1994"
25,2,11,2251,173,170,343,"21 de agosto de 1994"
25,2,11,2252,162,149,311,"21 de agosto de 1994"
25,2,11,2253,201,200,401,"21 de agosto de 1994"
25,2,11,2254,178,142,320,"21 de agosto de 1994"
25,2,11,2255,129,140,269,"21 de agosto de 1994"
25,2,11,2256,146,122,268,"21 de agosto de 1994"
25,2,11,2257,104,117,221,"21 de agosto de 1994"
25,2,11,2258,185,152,337,"21 de agosto de 1994"
25,2,11,2259,107,115,222,"21 de agosto de 1994"
25,2,11,2260,117,116,233,"21 de agosto de 1994"
25,2,11,2261,133,128,261,"21 de agosto de 1994"
25,2,11,2262,172,175,347,"21 de agosto de 1994"
25,2,11,2263,112,114,226,"21 de agosto de 1994"
25,2,11,2264,196,171,367,"21 de agosto de 1994"
25,2,11,2265,82,76,158,"21 de agosto de 1994"
25,2,11,2266,180,162,342,"21 de agosto de 1994"
25,2,11,2267,198,193,391,"21 de agosto de 1994"
25,2,11,2268,206,192,398,"21 de agosto de 1994"
25,2,11,2269,251,229,480,"21 de agosto de 1994"
25,2,11,2270,231,209,440,"21 de agosto de 1994"
25,2,11,2271,154,147,301,"21 de agosto de 1994"
25,2,11,2272,108,100,208,"21 de agosto de 1994"
25,2,11,2273,121,123,244,"21 de agosto de 1994"
25,2,11,2274,158,146,304,"21 de agosto de 1994"
25,2,11,2275,161,178,339,"21 de agosto de 1994"
25,2,11,2276,163,155,318,"21 de agosto de 1994"
25,2,11,2277,172,150,322,"21 de agosto de 1994"
25,2,11,2278,105,82,187,"21 de agosto de 1994"
25,2,11,2279,146,123,269,"21 de agosto de 1994"
25,2,11,2280,117,96,213,"21 de agosto de 1994"
25,2,11,2281,247,224,471,"21 de agosto de 1994"
25,2,11,2282,178,163,341,"21 de agosto de 1994"
25,2,11,2283,173,164,337,"21 de agosto de 1994"
25,2,11,2284,151,121,272,"21 de agosto de 1994"
25,2,11,2285,145,138,283,"21 de agosto de 1994"
25,2,11,2286,159,155,314,"21 de agosto de 1994"
25,2,11,2287,128,129,257,"21 de agosto de 1994"
25,2,11,2288,179,161,340,"21 de agosto de 1994"
25,2,11,2289,188,183,371,"21 de agosto de 1994"
25,2,11,2290,133,137,270,"21 de agosto de 1994"
25,2,11,2291,268,258,526,"21 de agosto de 1994"
25,2,11,2292,198,211,409,"21 de agosto de 1994"
25,2,11,2293,125,142,267,"21 de agosto de 1994"
25,2,11,2294,167,158,325,"21 de agosto de 1994"
25,2,11,2295,157,145,302,"21 de agosto de 1994"
25,2,11,2296,90,91,181,"21 de agosto de 1994"
25,2,11,2297,189,136,325,"21 de agosto de 1994"
25,2,11,2298,200,176,376,"21 de agosto de 1994"
25,2,11,2299,72,60,132,"21 de agosto de 1994"
25,2,11,2300,193,175,368,"21 de agosto de 1994"
25,2,11,2301,123,124,247,"21 de agosto de 1994"
25,2,11,2302,121,103,224,"21 de agosto de 1994"
25,2,11,2303,139,130,269,"21 de agosto de 1994"
25,2,11,2304,118,125,243,"21 de agosto de 1994"
25,2,11,2305,175,167,342,"21 de agosto de 1994"
25,2,11,2306,149,152,301,"21 de agosto de 1994"
25,2,11,2307,112,132,244,"21 de agosto de 1994"
25,2,11,2308,86,77,163,"21 de agosto de 1994"
25,2,11,2309,112,111,223,"21 de agosto de 1994"
25,2,11,2310,155,164,319,"21 de agosto de 1994"
25,2,11,2311,79,85,164,"21 de agosto de 1994"
25,2,11,2312,111,121,232,"21 de agosto de 1994"
25,2,11,2313,172,166,338,"21 de agosto de 1994"
25,2,11,2314,216,198,414,"21 de agosto de 1994"
25,2,11,2315,186,176,362,"21 de agosto de 1994"
25,2,11,2316,123,112,235,"21 de agosto de 1994"
25,2,11,2317,122,103,225,"21 de agosto de 1994"
25,2,11,2318,267,247,514,"21 de agosto de 1994"
25,2,11,2319,109,110,219,"21 de agosto de 1994"
25,2,11,2320,213,192,405,"21 de agosto de 1994"
25,2,11,2321,137,162,299,"21 de agosto de 1994"
25,2,11,2322,179,184,363,"21 de agosto de 1994"
25,2,11,2323,146,174,320,"21 de agosto de 1994"
25,2,11,2324,150,153,303,"21 de agosto de 1994"
25,2,11,2325,82,76,158,"21 de agosto de 1994"
25,2,11,2326,139,149,288,"21 de agosto de 1994"
25,2,11,2327,126,124,250,"21 de agosto de 1994"
25,2,11,2328,143,175,318,"21 de agosto de 1994"
25,2,11,2329,180,169,349,"21 de agosto de 1994"
25,2,11,2330,216,225,441,"21 de agosto de 1994"
25,2,11,2331,140,138,278,"21 de agosto de 1994"
25,2,11,2332,153,152,305,"21 de agosto de 1994"
25,2,11,2333,111,131,242,"21 de agosto de 1994"
25,2,11,2334,262,244,506,"21 de agosto de 1994"
25,2,11,2335,212,206,418,"21 de agosto de 1994"
25,2,11,2336,239,235,474,"21 de agosto de 1994"
25,2,11,2337,190,203,393,"21 de agosto de 1994"
25,2,11,2338,205,205,410,"21 de agosto de 1994"
25,2,11,2339,126,138,264,"21 de agosto de 1994"
25,2,11,2340,408,401,809,"21 de agosto de 1994"
25,2,11,2341,264,210,474,"21 de agosto de 1994"
25,2,11,2342,107,105,212,"21 de agosto de 1994"
25,2,11,2343,213,230,443,"21 de agosto de 1994"
25,2,11,2344,275,293,568,"21 de agosto de 1994"
25,2,11,2345,75,69,144,"21 de agosto de 1994"
25,2,11,2346,246,229,475,"21 de agosto de 1994"
25,2,11,2347,261,215,476,"21 de agosto de 1994"
25,2,11,2348,439,415,854,"21 de agosto de 1994"
25,2,11,2349,138,120,258,"21 de agosto de 1994"
25,2,11,2350,106,95,201,"21 de agosto de 1994"
25,2,11,2351,153,135,288,"21 de agosto de 1994"
25,2,11,2352,311,289,600,"21 de agosto de 1994"
25,2,11,2353,167,156,323,"21 de agosto de 1994"
25,2,11,2354,137,112,249,"21 de agosto de 1994"
25,2,11,2355,186,182,368,"21 de agosto de 1994"
25,2,11,2356,86,76,162,"21 de agosto de 1994"
25,2,11,2357,123,123,246,"21 de agosto de 1994"
25,2,11,2358,63,56,119,"21 de agosto de 1994"
25,2,11,2359,159,150,309,"21 de agosto de 1994"
25,2,11,2360,91,73,164,"21 de agosto de 1994"
25,2,11,2361,134,133,267,"21 de agosto de 1994"
25,2,11,2362,112,102,214,"21 de agosto de 1994"
25,2,11,2363,64,56,120,"21 de agosto de 1994"
25,2,11,2364,154,164,318,"21 de agosto de 1994"
25,2,11,2365,225,213,438,"21 de agosto de 1994"
25,2,11,2366,145,134,279,"21 de agosto de 1994"
25,2,11,2367,269,232,501,"21 de agosto de 1994"
25,2,11,2368,170,156,326,"21 de agosto de 1994"
25,2,11,2369,112,106,218,"21 de agosto de 1994"
25,2,11,2370,50,42,92,"21 de agosto de 1994"
25,2,11,2371,113,117,230,"21 de agosto de 1994"
25,2,11,2372,210,196,406,"21 de agosto de 1994"
25,2,11,2373,237,236,473,"21 de agosto de 1994"
25,2,11,2374,202,194,396,"21 de agosto de 1994"
25,2,11,2375,212,203,415,"21 de agosto de 1994"
25,2,11,2376,115,130,245,"21 de agosto de 1994"
25,2,11,2377,148,141,289,"21 de agosto de 1994"
25,2,11,2378,35,23,58,"21 de agosto de 1994"
25,2,11,2379,191,183,374,"21 de agosto de 1994"
25,2,11,2380,204,171,375,"21 de agosto de 1994"
25,2,11,2381,179,159,338,"21 de agosto de 1994"
25,2,11,2382,122,128,250,"21 de agosto de 1994"
25,2,11,2383,136,114,250,"21 de agosto de 1994"
25,2,11,2384,120,118,238,"21 de agosto de 1994"
25,2,11,2385,159,118,277,"21 de agosto de 1994"
25,2,11,2386,81,69,150,"21 de agosto de 1994"
25,2,11,2387,70,60,130,"21 de agosto de 1994"
25,2,11,2388,160,142,302,"21 de agosto de 1994"
25,2,11,2389,237,223,460,"21 de agosto de 1994"
25,2,11,2390,239,197,436,"21 de agosto de 1994"
25,2,11,2391,241,190,431,"21 de agosto de 1994"
25,2,11,2392,189,184,373,"21 de agosto de 1994"
25,2,11,2393,172,164,336,"21 de agosto de 1994"
25,2,11,2394,144,143,287,"21 de agosto de 1994"
25,2,11,2395,194,176,370,"21 de agosto de 1994"
25,2,11,2396,117,96,213,"21 de agosto de 1994"
25,2,11,2397,165,169,334,"21 de agosto de 1994"
25,2,11,2398,109,93,202,"21 de agosto de 1994"
25,2,11,2399,87,86,173,"21 de agosto de 1994"
25,2,11,2400,137,124,261,"21 de agosto de 1994"
25,2,11,2401,182,184,366,"21 de agosto de 1994"
25,2,11,2402,202,176,378,"21 de agosto de 1994"
25,2,11,2403,152,135,287,"21 de agosto de 1994"
25,2,11,2404,90,64,154,"21 de agosto de 1994"
25,2,11,2405,129,101,230,"21 de agosto de 1994"
25,2,11,2406,90,76,166,"21 de agosto de 1994"
25,2,11,2407,188,164,352,"21 de agosto de 1994"
25,2,11,2408,173,163,336,"21 de agosto de 1994"
25,2,11,2409,204,230,434,"21 de agosto de 1994"
25,2,11,2410,243,231,474,"21 de agosto de 1994"
25,2,11,2411,159,151,310,"21 de agosto de 1994"
25,2,11,2412,92,100,192,"21 de agosto de 1994"
25,2,11,2413,230,182,412,"21 de agosto de 1994"
25,2,11,2414,154,140,294,"21 de agosto de 1994"
25,2,11,2415,115,129,244,"21 de agosto de 1994"
25,2,11,2416,170,159,329,"21 de agosto de 1994"
25,2,11,2417,152,130,282,"21 de agosto de 1994"
25,2,11,2418,133,93,226,"21 de agosto de 1994"
25,2,11,2419,291,280,571,"21 de agosto de 1994"
25,2,11,2420,224,207,431,"21 de agosto de 1994"
25,2,11,2421,209,211,420,"21 de agosto de 1994"
25,2,11,2422,216,201,417,"21 de agosto de 1994"
25,2,11,2423,157,155,312,"21 de agosto de 1994"
25,2,11,2424,139,154,293,"21 de agosto de 1994"
25,2,11,2425,90,82,172,"21 de agosto de 1994"
25,2,11,2426,237,226,463,"21 de agosto de 1994"
25,2,11,2427,167,153,320,"21 de agosto de 1994"
25,2,11,2428,132,134,266,"21 de agosto de 1994"
25,2,11,2429,84,96,180,"21 de agosto de 1994"
25,2,11,2430,111,137,248,"21 de agosto de 1994"
25,2,11,2431,144,150,294,"21 de agosto de 1994"
25,2,11,2432,119,116,235,"21 de agosto de 1994"
25,2,11,2433,88,95,183,"21 de agosto de 1994"
25,2,11,2434,152,169,321,"21 de agosto de 1994"
25,2,11,2435,183,199,382,"21 de agosto de 1994"
25,2,11,2436,179,155,334,"21 de agosto de 1994"
25,2,11,2437,178,168,346,"21 de agosto de 1994"
25,2,11,2438,69,79,148,"21 de agosto de 1994"
25,2,11,2439,243,262,505,"21 de agosto de 1994"
25,2,11,2440,185,187,372,"21 de agosto de 1994"
25,2,11,2441,167,144,311,"21 de agosto de 1994"
25,2,11,2442,47,54,101,"21 de agosto de 1994"
25,2,11,2443,54,49,103,"21 de agosto de 1994"
25,2,11,2444,95,85,180,"21 de agosto de 1994"
25,2,11,2445,78,83,161,"21 de agosto de 1994"
25,2,11,2446,134,141,275,"21 de agosto de 1994"
25,2,11,2447,46,38,84,"21 de agosto de 1994"
25,2,11,2448,71,53,124,"21 de agosto de 1994"
25,2,11,2449,140,134,274,"21 de agosto de 1994"
25,2,11,2450,182,176,358,"21 de agosto de 1994"
25,2,11,2451,167,157,324,"21 de agosto de 1994"
25,2,11,2452,82,79,161,"21 de agosto de 1994"
25,2,11,2453,144,158,302,"21 de agosto de 1994"
25,2,11,2454,202,188,390,"21 de agosto de 1994"
25,2,11,2455,202,161,363,"21 de agosto de 1994"
25,2,11,2456,219,208,427,"21 de agosto de 1994"
25,2,11,2457,159,150,309,"21 de agosto de 1994"
25,2,11,2458,60,33,93,"21 de agosto de 1994"
25,2,11,2459,211,171,382,"21 de agosto de 1994"
25,2,11,2460,84,80,164,"21 de agosto de 1994"
25,2,11,2461,252,233,485,"21 de agosto de 1994"
25,2,11,2462,105,92,197,"21 de agosto de 1994"
25,2,11,2463,132,133,265,"21 de agosto de 1994"
25,2,11,2464,139,125,264,"21 de agosto de 1994"
25,2,11,2465,101,95,196,"21 de agosto de 1994"
25,2,11,2466,41,44,85,"21 de agosto de 1994"
25,2,11,2467,62,55,117,"21 de agosto de 1994"
25,2,11,2468,109,116,225,"21 de agosto de 1994"
25,2,11,2469,126,120,246,"21 de agosto de 1994"
25,2,11,2470,163,178,341,"21 de agosto de 1994"
25,2,11,2471,151,148,299,"21 de agosto de 1994"
25,2,11,2472,98,100,198,"21 de agosto de 1994"
25,2,11,2473,324,306,630,"21 de agosto de 1994"
25,2,11,2474,279,274,553,"21 de agosto de 1994"
25,2,11,2475,199,199,398,"21 de agosto de 1994"
25,2,11,2476,128,112,240,"21 de agosto de 1994"
25,2,11,2477,106,101,207,"21 de agosto de 1994"
25,2,11,2478,206,173,379,"21 de agosto de 1994"
25,2,11,2479,211,187,398,"21 de agosto de 1994"
25,2,11,2480,249,256,505,"21 de agosto de 1994"
25,2,11,2481,136,130,266,"21 de agosto de 1994"
25,2,11,2482,101,90,191,"21 de agosto de 1994"
25,2,11,2483,124,120,244,"21 de agosto de 1994"
25,2,11,2484,222,190,412,"21 de agosto de 1994"
25,2,11,2485,190,181,371,"21 de agosto de 1994"
25,2,11,2486,164,158,322,"21 de agosto de 1994"
25,2,11,2487,162,129,291,"21 de agosto de 1994"
25,2,11,2488,125,135,260,"21 de agosto de 1994"
25,2,11,2489,191,170,361,"21 de agosto de 1994"
25,2,11,2490,253,238,491,"21 de agosto de 1994"
25,2,11,2491,84,75,159,"21 de agosto de 1994"
25,2,11,2492,84,77,161,"21 de agosto de 1994"
25,2,11,2493,88,69,157,"21 de agosto de 1994"
25,2,11,2494,252,205,457,"21 de agosto de 1994"
25,2,11,2495,160,137,297,"21 de agosto de 1994"
25,2,11,2496,128,119,247,"21 de agosto de 1994"
25,2,11,2497,163,162,325,"21 de agosto de 1994"
25,2,11,2498,200,171,371,"21 de agosto de 1994"
25,2,11,2499,65,54,119,"21 de agosto de 1994"
25,2,11,2500,98,96,194,"21 de agosto de 1994"
25,2,11,2501,219,186,405,"21 de agosto de 1994"
25,2,11,2502,167,155,322,"21 de agosto de 1994"
25,2,11,2503,168,134,302,"21 de agosto de 1994"
25,2,11,2504,226,203,429,"21 de agosto de 1994"
25,2,11,2505,110,142,252,"21 de agosto de 1994"
25,2,11,2506,85,106,191,"21 de agosto de 1994"
25,2,11,2507,161,165,326,"21 de agosto de 1994"
25,2,11,2508,167,172,339,"21 de agosto de 1994"
25,2,11,2509,194,192,386,"21 de agosto de 1994"
25,2,11,2510,207,160,367,"21 de agosto de 1994"
25,2,11,2511,304,279,583,"21 de agosto de 1994"
25,2,11,2512,127,129,256,"21 de agosto de 1994"
25,2,11,2513,57,49,106,"21 de agosto de 1994"
25,2,11,2514,59,40,99,"21 de agosto de 1994"
25,2,11,2515,177,162,339,"21 de agosto de 1994"
25,2,11,2516,124,98,222,"21 de agosto de 1994"
25,2,11,2517,114,114,228,"21 de agosto de 1994"
25,2,11,2518,114,111,225,"21 de agosto de 1994"
25,2,11,2519,76,95,171,"21 de agosto de 1994"
25,2,11,2520,205,207,412,"21 de agosto de 1994"
25,2,11,2521,173,150,323,"21 de agosto de 1994"
25,2,11,2522,122,110,232,"21 de agosto de 1994"
25,2,11,2523,84,67,151,"21 de agosto de 1994"
25,2,11,2524,148,126,274,"21 de agosto de 1994"
25,2,11,2525,75,73,148,"21 de agosto de 1994"
25,2,11,2526,276,221,497,"21 de agosto de 1994"
25,2,11,2527,160,156,316,"21 de agosto de 1994"
25,2,11,2528,163,161,324,"21 de agosto de 1994"
25,2,11,2529,187,133,320,"21 de agosto de 1994"
25,2,11,2530,149,121,270,"21 de agosto de 1994"
25,2,11,2531,152,143,295,"21 de agosto de 1994"
25,2,11,2532,153,144,297,"21 de agosto de 1994"
25,2,11,2533,82,71,153,"21 de agosto de 1994"
25,2,11,2534,141,138,279,"21 de agosto de 1994"
25,2,11,2535,113,107,220,"21 de agosto de 1994"
25,2,11,2536,116,114,230,"21 de agosto de 1994"
25,2,11,2537,241,205,446,"21 de agosto de 1994"
25,2,11,2538,97,85,182,"21 de agosto de 1994"
25,2,11,2539,97,76,173,"21 de agosto de 1994"
25,3,6,710,182,207,389,"21 de agosto de 1994"
25,3,6,711,289,336,625,"21 de agosto de 1994"
25,3,6,712,223,235,458,"21 de agosto de 1994"
25,3,6,713,277,305,582,"21 de agosto de 1994"
25,3,6,714,131,149,280,"21 de agosto de 1994"
25,3,6,715,113,119,232,"21 de agosto de 1994"
25,3,6,716,119,132,251,"21 de agosto de 1994"
25,3,6,717,282,309,591,"21 de agosto de 1994"
25,3,6,718,272,320,592,"21 de agosto de 1994"
25,3,6,719,197,225,422,"21 de agosto de 1994"
25,3,6,720,173,167,340,"21 de agosto de 1994"
25,3,6,721,180,171,351,"21 de agosto de 1994"
25,3,6,722,175,200,375,"21 de agosto de 1994"
25,3,6,723,207,220,427,"21 de agosto de 1994"
25,3,6,724,135,176,311,"21 de agosto de 1994"
25,3,6,725,447,481,928,"21 de agosto de 1994"
25,3,6,726,251,294,545,"21 de agosto de 1994"
25,3,6,727,179,192,371,"21 de agosto de 1994"
25,3,6,728,167,195,362,"21 de agosto de 1994"
25,3,6,729,170,196,366,"21 de agosto de 1994"
25,3,6,730,226,258,484,"21 de agosto de 1994"
25,3,6,731,150,158,308,"21 de agosto de 1994"
25,3,6,732,115,142,257,"21 de agosto de 1994"
25,3,6,733,190,205,395,"21 de agosto de 1994"
25,3,6,734,131,173,304,"21 de agosto de 1994"
25,3,6,735,124,116,240,"21 de agosto de 1994"
25,3,6,736,227,243,470,"21 de agosto de 1994"
25,3,6,737,130,148,278,"21 de agosto de 1994"
25,3,6,738,129,142,271,"21 de agosto de 1994"
25,3,6,739,118,137,255,"21 de agosto de 1994"
25,3,6,740,132,179,311,"21 de agosto de 1994"
25,3,6,741,184,250,434,"21 de agosto de 1994"
25,3,6,742,143,197,340,"21 de agosto de 1994"
25,3,6,743,195,265,460,"21 de agosto de 1994"
25,3,6,744,119,119,238,"21 de agosto de 1994"
25,3,6,745,120,147,267,"21 de agosto de 1994"
25,3,6,746,139,161,300,"21 de agosto de 1994"
25,3,6,747,99,130,229,"21 de agosto de 1994"
25,3,6,748,206,251,457,"21 de agosto de 1994"
25,3,6,749,112,139,251,"21 de agosto de 1994"
25,3,6,750,157,175,332,"21 de agosto de 1994"
25,3,6,751,122,136,258,"21 de agosto de 1994"
25,3,6,752,142,187,329,"21 de agosto de 1994"
25,3,6,753,203,241,444,"21 de agosto de 1994"
25,3,6,754,150,204,354,"21 de agosto de 1994"
25,3,6,755,203,276,479,"21 de agosto de 1994"
25,3,6,756,140,164,304,"21 de agosto de 1994"
25,3,6,757,122,145,267,"21 de agosto de 1994"
25,3,6,758,175,193,368,"21 de agosto de 1994"
25,3,6,759,169,134,303,"21 de agosto de 1994"
25,3,6,760,148,174,322,"21 de agosto de 1994"
25,3,6,761,109,134,243,"21 de agosto de 1994"
25,3,6,762,107,122,229,"21 de agosto de 1994"
25,3,6,763,157,188,345,"21 de agosto de 1994"
25,3,6,764,220,255,475,"21 de agosto de 1994"
25,3,6,765,156,204,360,"21 de agosto de 1994"
25,3,6,766,100,109,209,"21 de agosto de 1994"
25,3,6,767,224,255,479,"21 de agosto de 1994"
25,3,6,768,98,101,199,"21 de agosto de 1994"
25,3,6,769,88,110,198,"21 de agosto de 1994"
25,3,6,770,111,137,248,"21 de agosto de 1994"
25,3,6,771,153,210,363,"21 de agosto de 1994"
25,3,6,772,186,222,408,"21 de agosto de 1994"
25,3,6,773,127,154,281,"21 de agosto de 1994"
25,3,6,774,294,334,628,"21 de agosto de 1994"
25,3,6,775,200,220,420,"21 de agosto de 1994"
25,3,6,776,183,227,410,"21 de agosto de 1994"
25,3,6,777,196,235,431,"21 de agosto de 1994"
25,3,6,778,141,159,300,"21 de agosto de 1994"
25,3,6,779,103,105,208,"21 de agosto de 1994"
25,3,6,780,117,136,253,"21 de agosto de 1994"
25,3,6,781,92,118,210,"21 de agosto de 1994"
25,3,6,782,141,186,327,"21 de agosto de 1994"
25,3,6,783,108,151,259,"21 de agosto de 1994"
25,3,6,784,139,174,313,"21 de agosto de 1994"
25,3,6,785,142,152,294,"21 de agosto de 1994"
25,3,6,786,197,216,413,"21 de agosto de 1994"
25,3,6,787,116,115,231,"21 de agosto de 1994"
25,3,6,788,150,192,342,"21 de agosto de 1994"
25,3,6,789,120,146,266,"21 de agosto de 1994"
25,3,6,790,112,129,241,"21 de agosto de 1994"
25,3,6,791,202,246,448,"21 de agosto de 1994"
25,3,6,792,213,245,458,"21 de agosto de 1994"
25,3,6,793,251,336,587,"21 de agosto de 1994"
25,3,6,794,169,187,356,"21 de agosto de 1994"
25,3,6,795,140,187,327,"21 de agosto de 1994"
25,3,6,796,184,236,420,"21 de agosto de 1994"
25,3,6,797,125,146,271,"21 de agosto de 1994"
25,3,6,798,123,156,279,"21 de agosto de 1994"
25,3,6,799,174,199,373,"21 de agosto de 1994"
25,3,6,800,125,152,277,"21 de agosto de 1994"
25,3,6,801,239,287,526,"21 de agosto de 1994"
25,3,6,802,192,229,421,"21 de agosto de 1994"
25,3,6,803,110,147,257,"21 de agosto de 1994"
25,3,6,804,109,137,246,"21 de agosto de 1994"
25,3,6,805,183,252,435,"21 de agosto de 1994"
25,3,6,806,200,240,440,"21 de agosto de 1994"
25,3,6,807,168,180,348,"21 de agosto de 1994"
25,3,6,808,73,98,171,"21 de agosto de 1994"
25,3,6,809,55,68,123,"21 de agosto de 1994"
25,3,6,810,166,210,376,"21 de agosto de 1994"
25,3,6,811,65,75,140,"21 de agosto de 1994"
25,3,6,812,78,100,178,"21 de agosto de 1994"
25,3,6,813,204,162,366,"21 de agosto de 1994"
25,3,6,814,90,94,184,"21 de agosto de 1994"
25,3,6,815,94,94,188,"21 de agosto de 1994"
25,3,6,816,80,114,194,"21 de agosto de 1994"
25,3,6,817,127,139,266,"21 de agosto de 1994"
25,3,6,818,138,174,312,"21 de agosto de 1994"
25,3,6,819,167,196,363,"21 de agosto de 1994"
25,3,6,820,177,197,374,"21 de agosto de 1994"
25,3,6,821,120,138,258,"21 de agosto de 1994"
25,3,6,822,118,160,278,"21 de agosto de 1994"
25,3,6,823,147,203,350,"21 de agosto de 1994"
25,3,6,824,194,232,426,"21 de agosto de 1994"
25,3,6,825,168,178,346,"21 de agosto de 1994"
25,3,6,826,201,263,464,"21 de agosto de 1994"
25,3,6,827,207,211,418,"21 de agosto de 1994"
25,3,6,828,158,155,313,"21 de agosto de 1994"
25,3,6,829,177,197,374,"21 de agosto de 1994"
25,3,6,830,141,178,319,"21 de agosto de 1994"
25,3,6,831,102,145,247,"21 de agosto de 1994"
25,3,6,832,177,222,399,"21 de agosto de 1994"
25,3,6,833,148,182,330,"21 de agosto de 1994"
25,3,6,834,159,192,351,"21 de agosto de 1994"
25,3,6,835,224,266,490,"21 de agosto de 1994"
25,3,6,836,143,179,322,"21 de agosto de 1994"
25,3,6,837,125,149,274,"21 de agosto de 1994"
25,3,6,838,134,142,276,"21 de agosto de 1994"
25,3,6,839,120,136,256,"21 de agosto de 1994"
25,3,6,840,230,234,464,"21 de agosto de 1994"
25,3,6,841,149,181,330,"21 de agosto de 1994"
25,3,6,842,159,180,339,"21 de agosto de 1994"
25,3,6,843,143,175,318,"21 de agosto de 1994"
25,3,6,844,181,208,389,"21 de agosto de 1994"
25,3,6,845,242,284,526,"21 de agosto de 1994"
25,3,6,846,172,217,389,"21 de agosto de 1994"
25,3,6,847,121,137,258,"21 de agosto de 1994"
25,3,6,848,141,160,301,"21 de agosto de 1994"
25,3,6,849,129,144,273,"21 de agosto de 1994"
25,3,6,850,197,228,425,"21 de agosto de 1994"
25,3,6,851,159,187,346,"21 de agosto de 1994"
25,3,6,852,126,131,257,"21 de agosto de 1994"
25,3,6,853,125,163,288,"21 de agosto de 1994"
25,3,6,854,107,82,189,"21 de agosto de 1994"
25,3,6,855,61,69,130,"21 de agosto de 1994"
25,3,6,856,79,113,192,"21 de agosto de 1994"
25,3,6,857,90,102,192,"21 de agosto de 1994"
25,3,6,858,112,130,242,"21 de agosto de 1994"
25,3,6,859,192,218,410,"21 de agosto de 1994"
25,3,6,860,186,221,407,"21 de agosto de 1994"
25,3,6,861,71,83,154,"21 de agosto de 1994"
25,3,6,862,111,129,240,"21 de agosto de 1994"
25,3,6,863,136,135,271,"21 de agosto de 1994"
25,3,6,864,91,133,224,"21 de agosto de 1994"
25,3,6,865,132,164,296,"21 de agosto de 1994"
25,3,6,866,159,177,336,"21 de agosto de 1994"
25,3,6,867,155,194,349,"21 de agosto de 1994"
25,3,6,868,129,148,277,"21 de agosto de 1994"
25,3,6,869,125,169,294,"21 de agosto de 1994"
25,3,6,870,111,134,245,"21 de agosto de 1994"
25,3,6,871,103,128,231,"21 de agosto de 1994"
25,3,6,872,164,200,364,"21 de agosto de 1994"
25,3,6,873,231,292,523,"21 de agosto de 1994"
25,3,6,874,118,143,261,"21 de agosto de 1994"
25,3,6,875,171,170,341,"21 de agosto de 1994"
25,3,6,876,64,98,162,"21 de agosto de 1994"
25,3,6,877,115,126,241,"21 de agosto de 1994"
25,3,6,878,105,116,221,"21 de agosto de 1994"
25,3,6,879,93,118,211,"21 de agosto de 1994"
25,3,6,880,110,130,240,"21 de agosto de 1994"
25,3,6,881,147,181,328,"21 de agosto de 1994"
25,3,6,882,89,90,179,"21 de agosto de 1994"
25,3,6,883,94,111,205,"21 de agosto de 1994"
25,3,6,884,180,204,384,"21 de agosto de 1994"
25,3,6,885,276,294,570,"21 de agosto de 1994"
25,3,6,886,178,226,404,"21 de agosto de 1994"
25,3,6,887,193,239,432,"21 de agosto de 1994"
25,3,6,888,201,250,451,"21 de agosto de 1994"
25,3,6,889,179,208,387,"21 de agosto de 1994"
25,3,6,890,165,188,353,"21 de agosto de 1994"
25,3,6,891,194,250,444,"21 de agosto de 1994"
25,3,6,892,198,219,417,"21 de agosto de 1994"
25,3,6,893,156,194,350,"21 de agosto de 1994"
25,3,6,894,162,198,360,"21 de agosto de 1994"
25,3,6,895,185,218,403,"21 de agosto de 1994"
25,3,6,896,138,165,303,"21 de agosto de 1994"
25,3,6,897,173,197,370,"21 de agosto de 1994"
25,3,6,898,152,190,342,"21 de agosto de 1994"
25,3,6,899,228,261,489,"21 de agosto de 1994"
25,3,6,900,104,138,242,"21 de agosto de 1994"
25,3,6,901,110,168,278,"21 de agosto de 1994"
25,3,6,902,107,135,242,"21 de agosto de 1994"
25,3,6,903,666,835,1501,"21 de agosto de 1994"
25,3,6,904,122,147,269,"21 de agosto de 1994"
25,3,6,905,155,184,339,"21 de agosto de 1994"
25,3,6,906,188,246,434,"21 de agosto de 1994"
25,3,6,907,93,132,225,"21 de agosto de 1994"
25,3,6,908,66,93,159,"21 de agosto de 1994"
25,3,6,909,185,208,393,"21 de agosto de 1994"
25,3,6,910,165,179,344,"21 de agosto de 1994"
25,3,6,911,95,112,207,"21 de agosto de 1994"
25,3,6,912,215,251,466,"21 de agosto de 1994"
25,3,6,913,199,247,446,"21 de agosto de 1994"
25,3,6,914,161,180,341,"21 de agosto de 1994"
25,3,6,915,261,274,535,"21 de agosto de 1994"
25,3,6,916,249,258,507,"21 de agosto de 1994"
25,3,6,917,213,249,462,"21 de agosto de 1994"
25,3,6,918,182,239,421,"21 de agosto de 1994"
25,3,6,919,173,186,359,"21 de agosto de 1994"
25,3,6,920,172,196,368,"21 de agosto de 1994"
25,3,6,921,140,171,311,"21 de agosto de 1994"
25,3,6,922,189,228,417,"21 de agosto de 1994"
25,3,6,923,110,144,254,"21 de agosto de 1994"
25,3,6,924,168,195,363,"21 de agosto de 1994"
25,3,6,925,167,179,346,"21 de agosto de 1994"
25,3,6,926,184,187,371,"21 de agosto de 1994"
25,3,6,927,127,152,279,"21 de agosto de 1994"
25,3,6,928,162,168,330,"21 de agosto de 1994"
25,3,6,929,113,133,246,"21 de agosto de 1994"
25,3,6,930,205,238,443,"21 de agosto de 1994"
25,3,6,931,186,212,398,"21 de agosto de 1994"
25,3,6,932,222,261,483,"21 de agosto de 1994"
25,3,6,933,255,279,534,"21 de agosto de 1994"
25,3,6,934,48,65,113,"21 de agosto de 1994"
25,3,6,935,240,254,494,"21 de agosto de 1994"
25,3,6,936,185,188,373,"21 de agosto de 1994"
25,3,6,937,137,153,290,"21 de agosto de 1994"
25,3,6,938,99,96,195,"21 de agosto de 1994"
25,3,6,939,170,193,363,"21 de agosto de 1994"
25,3,6,940,117,140,257,"21 de agosto de 1994"
25,3,6,941,244,174,418,"21 de agosto de 1994"
25,3,6,942,89,122,211,"21 de agosto de 1994"
25,3,6,943,63,52,115,"21 de agosto de 1994"
25,3,6,944,87,67,154,"21 de agosto de 1994"
25,3,6,945,95,124,219,"21 de agosto de 1994"
25,3,6,946,90,136,226,"21 de agosto de 1994"
25,3,6,947,151,149,300,"21 de agosto de 1994"
25,3,6,948,146,169,315,"21 de agosto de 1994"
25,3,6,949,134,133,267,"21 de agosto de 1994"
25,3,6,950,114,119,233,"21 de agosto de 1994"
25,3,6,951,172,161,333,"21 de agosto de 1994"
25,3,6,952,144,156,300,"21 de agosto de 1994"
25,3,6,953,127,151,278,"21 de agosto de 1994"
25,3,6,954,128,177,305,"21 de agosto de 1994"
25,3,6,955,84,106,190,"21 de agosto de 1994"
25,3,6,956,100,118,218,"21 de agosto de 1994"
25,3,6,957,85,91,176,"21 de agosto de 1994"
25,3,6,958,70,82,152,"21 de agosto de 1994"
25,3,6,959,79,89,168,"21 de agosto de 1994"
25,3,6,960,91,125,216,"21 de agosto de 1994"
25,3,6,961,115,142,257,"21 de agosto de 1994"
25,3,6,962,55,77,132,"21 de agosto de 1994"
25,3,6,963,70,78,148,"21 de agosto de 1994"
25,3,6,964,153,116,269,"21 de agosto de 1994"
25,3,6,965,69,81,150,"21 de agosto de 1994"
25,3,6,966,137,157,294,"21 de agosto de 1994"
25,3,6,967,90,135,225,"21 de agosto de 1994"
25,3,6,968,89,96,185,"21 de agosto de 1994"
25,3,6,969,59,50,109,"21 de agosto de 1994"
25,3,6,970,94,115,209,"21 de agosto de 1994"
25,3,6,971,62,95,157,"21 de agosto de 1994"
25,3,6,972,105,118,223,"21 de agosto de 1994"
25,3,6,973,79,86,165,"21 de agosto de 1994"
25,3,6,974,56,81,137,"21 de agosto de 1994"
25,3,6,975,138,158,296,"21 de agosto de 1994"
25,3,6,976,90,98,188,"21 de agosto de 1994"
25,3,6,977,118,112,230,"21 de agosto de 1994"
25,3,6,978,148,157,305,"21 de agosto de 1994"
25,3,6,979,80,112,192,"21 de agosto de 1994"
25,3,6,980,108,124,232,"21 de agosto de 1994"
25,3,6,981,66,89,155,"21 de agosto de 1994"
25,3,6,982,89,121,210,"21 de agosto de 1994"
25,3,6,983,100,127,227,"21 de agosto de 1994"
25,3,6,984,93,119,212,"21 de agosto de 1994"
25,3,6,985,150,164,314,"21 de agosto de 1994"
25,3,6,986,118,160,278,"21 de agosto de 1994"
25,3,6,987,106,132,238,"21 de agosto de 1994"
25,3,6,988,99,118,217,"21 de agosto de 1994"
25,3,6,989,155,218,373,"21 de agosto de 1994"
25,4,4,629,247,242,489,"21 de agosto de 1994"
25,4,4,630,156,144,300,"21 de agosto de 1994"
25,4,4,631,238,205,443,"21 de agosto de 1994"
25,4,4,632,339,334,673,"21 de agosto de 1994"
25,4,4,633,174,189,363,"21 de agosto de 1994"
25,4,4,634,150,161,311,"21 de agosto de 1994"
25,4,4,635,283,270,553,"21 de agosto de 1994"
25,4,4,636,156,171,327,"21 de agosto de 1994"
25,4,4,637,420,381,801,"21 de agosto de 1994"
25,4,4,638,139,106,245,"21 de agosto de 1994"
25,4,4,639,189,106,295,"21 de agosto de 1994"
25,4,4,640,92,55,147,"21 de agosto de 1994"
25,4,4,641,207,187,394,"21 de agosto de 1994"
25,4,4,642,153,154,307,"21 de agosto de 1994"
25,4,4,643,156,137,293,"21 de agosto de 1994"
25,4,4,644,81,81,162,"21 de agosto de 1994"
25,4,4,645,71,66,137,"21 de agosto de 1994"
25,4,4,646,216,181,397,"21 de agosto de 1994"
25,4,4,647,50,46,96,"21 de agosto de 1994"
25,4,4,648,43,34,77,"21 de agosto de 1994"
25,4,4,649,127,103,230,"21 de agosto de 1994"
25,4,4,650,55,52,107,"21 de agosto de 1994"
25,4,4,651,170,136,306,"21 de agosto de 1994"
25,4,4,652,123,112,235,"21 de agosto de 1994"
25,4,4,653,149,109,258,"21 de agosto de 1994"
25,4,4,654,191,178,369,"21 de agosto de 1994"
25,4,4,655,212,206,418,"21 de agosto de 1994"
25,4,4,656,82,74,156,"21 de agosto de 1994"
25,4,4,657,146,123,269,"21 de agosto de 1994"
25,4,4,658,124,103,227,"21 de agosto de 1994"
25,4,4,659,105,97,202,"21 de agosto de 1994"
25,4,4,660,179,164,343,"21 de agosto de 1994"
25,4,4,661,240,183,423,"21 de agosto de 1994"
25,4,4,662,75,63,138,"21 de agosto de 1994"
25,4,4,663,99,67,166,"21 de agosto de 1994"
25,4,4,664,155,153,308,"21 de agosto de 1994"
25,4,4,665,269,195,464,"21 de agosto de 1994"
25,4,4,666,96,92,188,"21 de agosto de 1994"
25,4,4,667,160,147,307,"21 de agosto de 1994"
25,4,4,668,85,92,177,"21 de agosto de 1994"
25,4,4,669,187,183,370,"21 de agosto de 1994"
25,4,4,670,244,236,480,"21 de agosto de 1994"
25,4,4,671,218,188,406,"21 de agosto de 1994"
25,4,4,672,168,138,306,"21 de agosto de 1994"
25,4,4,673,145,117,262,"21 de agosto de 1994"
25,4,4,674,33,21,54,"21 de agosto de 1994"
25,4,9,1860,65,65,130,"21 de agosto de 1994"
25,4,9,1861,251,242,493,"21 de agosto de 1994"
25,4,9,1862,149,149,298,"21 de agosto de 1994"
25,4,9,1863,166,163,329,"21 de agosto de 1994"
25,4,9,1864,248,230,478,"21 de agosto de 1994"
25,4,9,1865,152,139,291,"21 de agosto de 1994"
25,4,9,1866,186,182,368,"21 de agosto de 1994"
25,4,9,1867,189,175,364,"21 de agosto de 1994"
25,4,9,1868,253,237,490,"21 de agosto de 1994"
25,4,9,1869,198,210,408,"21 de agosto de 1994"
25,4,9,1870,124,154,278,"21 de agosto de 1994"
25,4,9,1871,219,206,425,"21 de agosto de 1994"
25,4,9,1872,199,212,411,"21 de agosto de 1994"
25,4,9,1873,163,170,333,"21 de agosto de 1994"
25,4,9,1874,197,217,414,"21 de agosto de 1994"
25,4,9,1875,172,214,386,"21 de agosto de 1994"
25,4,9,1876,317,335,652,"21 de agosto de 1994"
25,4,9,1877,134,138,272,"21 de agosto de 1994"
25,4,9,1878,155,167,322,"21 de agosto de 1994"
25,4,9,1879,151,178,329,"21 de agosto de 1994"
25,4,9,1880,178,185,363,"21 de agosto de 1994"
25,4,9,1881,122,134,256,"21 de agosto de 1994"
25,4,9,1882,188,205,393,"21 de agosto de 1994"
25,4,9,1883,288,300,588,"21 de agosto de 1994"
25,4,9,1884,275,275,550,"21 de agosto de 1994"
25,4,9,1885,317,326,643,"21 de agosto de 1994"
25,4,9,1886,233,252,485,"21 de agosto de 1994"
25,4,9,1887,111,122,233,"21 de agosto de 1994"
25,4,9,1888,90,132,222,"21 de agosto de 1994"
25,4,9,1889,154,144,298,"21 de agosto de 1994"
25,4,9,1890,228,244,472,"21 de agosto de 1994"
25,4,9,1891,301,327,628,"21 de agosto de 1994"
25,4,9,1892,260,237,497,"21 de agosto de 1994"
25,4,9,1893,340,359,699,"21 de agosto de 1994"
25,4,9,1894,264,235,499,"21 de agosto de 1994"
25,4,9,1895,132,138,270,"21 de agosto de 1994"
25,4,9,1896,88,86,174,"21 de agosto de 1994"
25,4,9,1897,76,60,136,"21 de agosto de 1994"
25,4,9,1898,26,19,45,"21 de agosto de 1994"
25,4,9,1899,35,21,56,"21 de agosto de 1994"
25,4,9,1900,38,17,55,"21 de agosto de 1994"
25,4,9,1901,292,215,507,"21 de agosto de 1994"
25,4,9,1902,273,220,493,"21 de agosto de 1994"
25,4,9,1903,343,324,667,"21 de agosto de 1994"
25,4,9,1904,460,409,869,"21 de agosto de 1994"
25,4,9,1905,75,61,136,"21 de agosto de 1994"
25,4,9,1906,350,290,640,"21 de agosto de 1994"
25,4,9,1907,107,71,178,"21 de agosto de 1994"
25,4,9,1908,255,196,451,"21 de agosto de 1994"
25,4,9,1909,261,235,496,"21 de agosto de 1994"
25,4,9,1910,246,215,461,"21 de agosto de 1994"
25,4,9,1911,234,182,416,"21 de agosto de 1994"
25,4,9,1912,230,209,439,"21 de agosto de 1994"
25,4,9,1913,413,397,810,"21 de agosto de 1994"
25,4,9,1914,131,143,274,"21 de agosto de 1994"
25,4,9,1915,142,128,270,"21 de agosto de 1994"
25,4,9,1916,147,158,305,"21 de agosto de 1994"
25,4,9,1917,195,182,377,"21 de agosto de 1994"
25,4,9,1918,153,155,308,"21 de agosto de 1994"
25,4,9,1919,224,186,410,"21 de agosto de 1994"
25,4,9,1920,131,151,282,"21 de agosto de 1994"
25,4,9,1921,143,152,295,"21 de agosto de 1994"
25,4,9,1922,174,155,329,"21 de agosto de 1994"
25,4,9,1923,156,132,288,"21 de agosto de 1994"
25,4,9,1924,148,149,297,"21 de agosto de 1994"
25,4,12,2540,131,148,279,"21 de agosto de 1994"
25,4,12,2541,148,197,345,"21 de agosto de 1994"
25,4,12,2542,151,174,325,"21 de agosto de 1994"
25,4,12,2543,207,240,447,"21 de agosto de 1994"
25,4,12,2544,182,191,373,"21 de agosto de 1994"
25,4,12,2545,228,232,460,"21 de agosto de 1994"
25,4,12,2546,550,215,765,"21 de agosto de 1994"
25,4,12,2547,132,146,278,"21 de agosto de 1994"
25,4,12,2548,230,234,464,"21 de agosto de 1994"
25,4,12,2549,135,153,288,"21 de agosto de 1994"
25,4,12,2550,158,188,346,"21 de agosto de 1994"
25,4,12,2551,199,271,470,"21 de agosto de 1994"
25,4,12,2552,148,171,319,"21 de agosto de 1994"
25,4,12,2553,96,117,213,"21 de agosto de 1994"
25,4,12,2554,181,236,417,"21 de agosto de 1994"
25,4,12,2555,174,202,376,"21 de agosto de 1994"
25,4,12,2556,245,252,497,"21 de agosto de 1994"
25,4,12,2557,127,148,275,"21 de agosto de 1994"
25,4,12,2558,125,145,270,"21 de agosto de 1994"
25,4,12,2559,162,170,332,"21 de agosto de 1994"
25,4,12,2560,303,278,581,"21 de agosto de 1994"
25,4,12,2561,111,123,234,"21 de agosto de 1994"
25,4,12,2562,243,232,475,"21 de agosto de 1994"
25,4,12,2563,205,233,438,"21 de agosto de 1994"
25,4,12,2564,215,262,477,"21 de agosto de 1994"
25,4,12,2565,143,163,306,"21 de agosto de 1994"
25,4,12,2566,55,82,137,"21 de agosto de 1994"
25,4,12,2567,181,215,396,"21 de agosto de 1994"
25,4,12,2568,92,132,224,"21 de agosto de 1994"
25,4,12,2569,143,160,303,"21 de agosto de 1994"
25,4,12,2570,135,143,278,"21 de agosto de 1994"
25,4,12,2571,222,246,468,"21 de agosto de 1994"
25,4,12,2572,115,120,235,"21 de agosto de 1994"
25,4,12,2573,139,151,290,"21 de agosto de 1994"
25,4,12,2574,91,141,232,"21 de agosto de 1994"
25,4,12,2575,77,105,182,"21 de agosto de 1994"
25,4,12,2576,207,188,395,"21 de agosto de 1994"
25,4,12,2577,126,161,287,"21 de agosto de 1994"
25,4,12,2578,77,97,174,"21 de agosto de 1994"
25,4,12,2579,96,107,203,"21 de agosto de 1994"
25,4,12,2580,113,102,215,"21 de agosto de 1994"
25,4,12,2581,84,97,181,"21 de agosto de 1994"
25,4,12,2582,125,179,304,"21 de agosto de 1994"
25,4,12,2583,159,222,381,"21 de agosto de 1994"
25,4,12,2584,79,124,203,"21 de agosto de 1994"
25,4,12,2585,123,150,273,"21 de agosto de 1994"
25,4,12,2586,161,206,367,"21 de agosto de 1994"
25,4,12,2587,192,215,407,"21 de agosto de 1994"
25,4,12,2588,156,192,348,"21 de agosto de 1994"
25,4,12,2589,137,156,293,"21 de agosto de 1994"
25,4,12,2590,179,180,359,"21 de agosto de 1994"
25,4,12,2591,213,205,418,"21 de agosto de 1994"
25,4,12,2592,143,162,305,"21 de agosto de 1994"
25,4,12,2593,170,170,340,"21 de agosto de 1994"
25,4,12,2594,229,238,467,"21 de agosto de 1994"
25,4,12,2595,170,201,371,"21 de agosto de 1994"
25,4,12,2596,275,269,544,"21 de agosto de 1994"
25,4,12,2597,216,236,452,"21 de agosto de 1994"
25,4,12,2598,90,101,191,"21 de agosto de 1994"
25,4,12,2599,99,122,221,"21 de agosto de 1994"
25,4,12,2600,139,139,278,"21 de agosto de 1994"
25,4,12,2601,175,171,346,"21 de agosto de 1994"
25,4,12,2602,205,222,427,"21 de agosto de 1994"
25,4,12,2603,165,155,320,"21 de agosto de 1994"
25,4,12,2604,77,80,157,"21 de agosto de 1994"
25,4,12,2605,204,213,417,"21 de agosto de 1994"
25,4,12,2606,205,175,380,"21 de agosto de 1994"
25,4,12,2607,199,205,404,"21 de agosto de 1994"
25,4,12,2608,221,210,431,"21 de agosto de 1994"
25,4,12,2609,187,177,364,"21 de agosto de 1994"
25,4,12,2610,341,332,673,"21 de agosto de 1994"
25,4,12,2611,308,316,624,"21 de agosto de 1994"
25,4,12,2612,201,207,408,"21 de agosto de 1994"
25,4,12,2613,161,157,318,"21 de agosto de 1994"
25,4,12,2614,201,213,414,"21 de agosto de 1994"
25,4,12,2615,132,131,263,"21 de agosto de 1994"
25,4,12,2616,365,355,720,"21 de agosto de 1994"
25,4,12,2617,171,148,319,"21 de agosto de 1994"
25,4,12,2618,352,369,721,"21 de agosto de 1994"
25,4,12,2619,169,163,332,"21 de agosto de 1994"
25,4,12,2620,127,100,227,"21 de agosto de 1994"
25,4,12,2621,164,164,328,"21 de agosto de 1994"
25,4,12,2622,174,168,342,"21 de agosto de 1994"
25,4,12,2623,206,196,402,"21 de agosto de 1994"
25,4,12,2624,91,74,165,"21 de agosto de 1994"
25,4,12,2625,145,119,264,"21 de agosto de 1994"
25,4,12,2626,127,122,249,"21 de agosto de 1994"
25,4,12,2627,252,248,500,"21 de agosto de 1994"
25,4,12,2628,188,171,359,"21 de agosto de 1994"
25,4,12,2629,122,124,246,"21 de agosto de 1994"
25,4,12,2630,126,122,248,"21 de agosto de 1994"
25,4,12,2631,162,153,315,"21 de agosto de 1994"
25,4,12,2632,120,112,232,"21 de agosto de 1994"
25,4,12,2633,99,90,189,"21 de agosto de 1994"
25,4,12,2634,84,75,159,"21 de agosto de 1994"
25,4,12,2635,51,46,97,"21 de agosto de 1994"
25,4,12,2636,327,264,591,"21 de agosto de 1994"
25,4,12,2637,148,124,272,"21 de agosto de 1994"
25,4,12,2638,246,246,492,"21 de agosto de 1994"
25,4,12,2639,119,127,246,"21 de agosto de 1994"
25,4,12,2640,290,254,544,"21 de agosto de 1994"
25,4,12,2641,219,222,441,"21 de agosto de 1994"
25,4,12,2642,72,89,161,"21 de agosto de 1994"
25,4,12,2643,141,134,275,"21 de agosto de 1994"
25,4,12,2644,278,241,519,"21 de agosto de 1994"
25,4,12,2645,130,144,274,"21 de agosto de 1994"
25,4,12,2646,106,105,211,"21 de agosto de 1994"
25,4,12,2647,241,246,487,"21 de agosto de 1994"
25,4,12,2648,253,255,508,"21 de agosto de 1994"
25,4,12,2649,106,132,238,"21 de agosto de 1994"
25,4,12,2650,43,46,89,"21 de agosto de 1994"
25,4,12,2651,158,173,331,"21 de agosto de 1994"
25,4,12,2652,166,161,327,"21 de agosto de 1994"
25,4,12,2653,162,191,353,"21 de agosto de 1994"
25,4,12,2654,184,159,343,"21 de agosto de 1994"
25,4,12,2655,234,203,437,"21 de agosto de 1994"
25,4,12,2656,171,188,359,"21 de agosto de 1994"
25,4,12,2657,149,138,287,"21 de agosto de 1994"
25,4,12,2658,34,26,60,"21 de agosto de 1994"
25,4,12,2659,31,26,57,"21 de agosto de 1994"
25,4,12,2660,102,80,182,"21 de agosto de 1994"
25,4,12,2661,188,168,356,"21 de agosto de 1994"
25,4,12,2662,227,211,438,"21 de agosto de 1994"
25,4,12,2663,182,160,342,"21 de agosto de 1994"
25,4,12,2664,160,147,307,"21 de agosto de 1994"
25,4,12,2665,180,137,317,"21 de agosto de 1994"
25,4,12,2666,222,189,411,"21 de agosto de 1994"
25,4,14,3131,191,191,382,"21 de agosto de 1994"
25,4,14,3132,213,214,427,"21 de agosto de 1994"
25,4,14,3133,254,271,525,"21 de agosto de 1994"
25,4,14,3134,228,231,459,"21 de agosto de 1994"
25,4,14,3135,146,153,299,"21 de agosto de 1994"
25,4,14,3136,177,159,336,"21 de agosto de 1994"
25,4,14,3137,198,230,428,"21 de agosto de 1994"
25,4,14,3138,292,273,565,"21 de agosto de 1994"
25,4,14,3139,298,290,588,"21 de agosto de 1994"
25,4,14,3140,198,220,418,"21 de agosto de 1994"
25,4,14,3141,109,124,233,"21 de agosto de 1994"
25,4,14,3142,152,197,349,"21 de agosto de 1994"
25,4,14,3143,295,250,545,"21 de agosto de 1994"
25,4,14,3144,191,215,406,"21 de agosto de 1994"
25,4,14,3145,91,108,199,"21 de agosto de 1994"
25,4,14,3146,87,97,184,"21 de agosto de 1994"
25,4,14,3147,290,232,522,"21 de agosto de 1994"
25,4,14,3148,120,111,231,"21 de agosto de 1994"
25,4,14,3149,124,137,261,"21 de agosto de 1994"
25,4,14,3150,141,138,279,"21 de agosto de 1994"
25,4,14,3151,204,133,337,"21 de agosto de 1994"
25,4,14,3152,77,52,129,"21 de agosto de 1994"
25,4,14,3153,81,28,109,"21 de agosto de 1994"
25,4,14,3154,103,71,174,"21 de agosto de 1994"
25,4,14,3155,246,189,435,"21 de agosto de 1994"
25,4,14,3156,140,93,233,"21 de agosto de 1994"
25,4,14,3157,80,48,128,"21 de agosto de 1994"
25,4,14,3158,163,97,260,"21 de agosto de 1994"
25,4,14,3159,73,46,119,"21 de agosto de 1994"
25,4,14,3160,45,20,65,"21 de agosto de 1994"
25,4,14,3161,139,109,248,"21 de agosto de 1994"
25,4,14,3162,136,102,238,"21 de agosto de 1994"
25,4,14,3163,139,119,258,"21 de agosto de 1994"
25,4,14,3164,176,162,338,"21 de agosto de 1994"
25,4,14,3165,63,42,105,"21 de agosto de 1994"
25,4,14,3166,161,137,298,"21 de agosto de 1994"
25,4,14,3167,124,92,216,"21 de agosto de 1994"
25,4,14,3168,64,75,139,"21 de agosto de 1994"
25,4,14,3169,106,83,189,"21 de agosto de 1994"
25,4,14,3170,32,29,61,"21 de agosto de 1994"
25,4,14,3171,44,20,64,"21 de agosto de 1994"
25,4,14,3172,143,126,269,"21 de agosto de 1994"
25,4,14,3173,258,215,473,"21 de agosto de 1994"
25,4,14,3174,101,81,182,"21 de agosto de 1994"
25,4,14,3175,202,168,370,"21 de agosto de 1994"
25,4,14,3176,54,42,96,"21 de agosto de 1994"
25,4,14,3177,247,202,449,"21 de agosto de 1994"
25,4,14,3178,151,163,314,"21 de agosto de 1994"
25,4,14,3179,153,127,280,"21 de agosto de 1994"
25,4,14,3180,259,184,443,"21 de agosto de 1994"
25,4,14,3181,44,38,82,"21 de agosto de 1994"
25,4,14,3182,258,186,444,"21 de agosto de 1994"
25,4,14,3183,58,34,92,"21 de agosto de 1994"
25,4,14,3184,95,69,164,"21 de agosto de 1994"
25,4,14,3185,55,29,84,"21 de agosto de 1994"
25,4,14,3186,119,110,229,"21 de agosto de 1994"
25,4,14,3187,77,67,144,"21 de agosto de 1994"
25,4,14,3188,154,111,265,"21 de agosto de 1994"
25,4,14,3189,121,111,232,"21 de agosto de 1994"
25,4,14,3190,298,235,533,"21 de agosto de 1994"
25,4,14,3191,165,137,302,"21 de agosto de 1994"
25,4,14,3192,128,97,225,"21 de agosto de 1994"
25,4,14,3193,214,158,372,"21 de agosto de 1994"
25,4,14,3194,142,109,251,"21 de agosto de 1994"
25,4,14,3195,158,124,282,"21 de agosto de 1994"
25,4,14,3196,202,169,371,"21 de agosto de 1994"
25,4,14,3197,64,42,106,"21 de agosto de 1994"
25,4,14,3198,60,48,108,"21 de agosto de 1994"
25,4,14,3199,163,141,304,"21 de agosto de 1994"
25,4,14,3200,88,65,153,"21 de agosto de 1994"
25,4,14,3201,231,228,459,"21 de agosto de 1994"
25,4,14,3202,107,102,209,"21 de agosto de 1994"
25,4,14,3203,85,69,154,"21 de agosto de 1994"
25,4,14,3204,224,176,400,"21 de agosto de 1994"
25,4,14,3205,300,280,580,"21 de agosto de 1994"
25,4,14,3206,241,176,417,"21 de agosto de 1994"
25,4,14,3207,283,219,502,"21 de agosto de 1994"
25,4,14,3208,133,100,233,"21 de agosto de 1994"
25,4,14,3209,277,233,510,"21 de agosto de 1994"
25,4,14,3210,219,205,424,"21 de agosto de 1994"
25,4,14,3211,142,136,278,"21 de agosto de 1994"
25,4,14,3212,181,164,345,"21 de agosto de 1994"
25,4,14,3213,156,139,295,"21 de agosto de 1994"
25,4,14,3214,127,114,241,"21 de agosto de 1994"
25,4,14,3215,185,197,382,"21 de agosto de 1994"
25,4,14,3216,125,96,221,"21 de agosto de 1994"
25,4,14,3217,199,197,396,"21 de agosto de 1994"
25,4,14,3218,98,90,188,"21 de agosto de 1994"
25,4,14,3219,354,302,656,"21 de agosto de 1994"
25,5,5,675,153,156,309,"21 de agosto de 1994"
25,5,5,676,128,146,274,"21 de agosto de 1994"
25,5,5,677,206,212,418,"21 de agosto de 1994"
25,5,5,678,107,124,231,"21 de agosto de 1994"
25,5,5,679,192,160,352,"21 de agosto de 1994"
25,5,5,680,221,237,458,"21 de agosto de 1994"
25,5,5,681,166,142,308,"21 de agosto de 1994"
25,5,5,682,182,167,349,"21 de agosto de 1994"
25,5,5,683,164,127,291,"21 de agosto de 1994"
25,5,5,684,43,23,66,"21 de agosto de 1994"
25,5,5,685,44,19,63,"21 de agosto de 1994"
25,5,5,686,147,130,277,"21 de agosto de 1994"
25,5,5,687,79,54,133,"21 de agosto de 1994"
25,5,5,688,36,29,65,"21 de agosto de 1994"
25,5,5,689,67,56,123,"21 de agosto de 1994"
25,5,5,690,148,91,239,"21 de agosto de 1994"
25,5,5,691,122,79,201,"21 de agosto de 1994"
25,5,5,692,112,63,175,"21 de agosto de 1994"
25,5,5,693,46,41,87,"21 de agosto de 1994"
25,5,5,694,153,109,262,"21 de agosto de 1994"
25,5,5,695,114,86,200,"21 de agosto de 1994"
25,5,5,696,115,82,197,"21 de agosto de 1994"
25,5,5,697,92,68,160,"21 de agosto de 1994"
25,5,5,698,168,135,303,"21 de agosto de 1994"
25,5,5,699,80,60,140,"21 de agosto de 1994"
25,5,5,700,125,90,215,"21 de agosto de 1994"
25,5,5,701,147,106,253,"21 de agosto de 1994"
25,5,5,702,111,89,200,"21 de agosto de 1994"
25,5,5,703,176,134,310,"21 de agosto de 1994"
25,5,5,704,125,76,201,"21 de agosto de 1994"
25,5,5,705,155,122,277,"21 de agosto de 1994"
25,5,5,706,70,46,116,"21 de agosto de 1994"
25,5,5,707,81,62,143,"21 de agosto de 1994"
25,5,5,708,61,48,109,"21 de agosto de 1994"
25,5,5,709,136,89,225,"21 de agosto de 1994"
25,5,8,1799,163,163,326,"21 de agosto de 1994"
25,5,8,1800,157,136,293,"21 de agosto de 1994"
25,5,8,1801,194,188,382,"21 de agosto de 1994"
25,5,8,1802,225,210,435,"21 de agosto de 1994"
25,5,8,1803,119,108,227,"21 de agosto de 1994"
25,5,8,1804,210,199,409,"21 de agosto de 1994"
25,5,8,1805,231,228,459,"21 de agosto de 1994"
25,5,8,1806,155,128,283,"21 de agosto de 1994"
25,5,8,1807,148,118,266,"21 de agosto de 1994"
25,5,8,1808,98,94,192,"21 de agosto de 1994"
25,5,8,1809,70,71,141,"21 de agosto de 1994"
25,5,8,1810,78,74,152,"21 de agosto de 1994"
25,5,8,1811,194,201,395,"21 de agosto de 1994"
25,5,8,1812,78,73,151,"21 de agosto de 1994"
25,5,8,1813,198,206,404,"21 de agosto de 1994"
25,5,8,1814,174,158,332,"21 de agosto de 1994"
25,5,8,1815,63,46,109,"21 de agosto de 1994"
25,5,8,1816,41,20,61,"21 de agosto de 1994"
25,5,8,1817,58,44,102,"21 de agosto de 1994"
25,5,8,1818,51,31,82,"21 de agosto de 1994"
25,5,8,1819,41,23,64,"21 de agosto de 1994"
25,5,8,1820,96,82,178,"21 de agosto de 1994"
25,5,8,1821,75,63,138,"21 de agosto de 1994"
25,5,8,1822,226,199,425,"21 de agosto de 1994"
25,5,8,1823,171,174,345,"21 de agosto de 1994"
25,5,8,1824,128,118,246,"21 de agosto de 1994"
25,5,8,1825,112,111,223,"21 de agosto de 1994"
25,5,8,1826,76,70,146,"21 de agosto de 1994"
25,5,8,1827,106,102,208,"21 de agosto de 1994"
25,5,8,1828,90,72,162,"21 de agosto de 1994"
25,5,8,1829,168,113,281,"21 de agosto de 1994"
25,5,8,1830,156,150,306,"21 de agosto de 1994"
25,5,8,1831,76,67,143,"21 de agosto de 1994"
25,5,8,1832,62,52,114,"21 de agosto de 1994"
25,5,8,1833,120,99,219,"21 de agosto de 1994"
25,5,8,1834,157,138,295,"21 de agosto de 1994"
25,5,8,1835,228,189,417,"21 de agosto de 1994"
25,5,8,1836,154,124,278,"21 de agosto de 1994"
25,5,8,1837,225,197,422,"21 de agosto de 1994"
25,5,8,1838,141,139,280,"21 de agosto de 1994"
25,5,8,1839,140,120,260,"21 de agosto de 1994"
25,5,8,1840,149,139,288,"21 de agosto de 1994"
25,5,8,1841,119,107,226,"21 de agosto de 1994"
25,5,8,1842,129,107,236,"21 de agosto de 1994"
25,5,8,1843,144,107,251,"21 de agosto de 1994"
25,5,8,1844,62,55,117,"21 de agosto de 1994"
25,5,8,1845,102,90,192,"21 de agosto de 1994"
25,5,8,1846,191,174,365,"21 de agosto de 1994"
25,5,8,1847,301,239,540,"21 de agosto de 1994"
25,5,8,1848,31,22,53,"21 de agosto de 1994"
25,5,8,1849,101,81,182,"21 de agosto de 1994"
25,5,8,1850,175,181,356,"21 de agosto de 1994"
25,5,8,1851,188,165,353,"21 de agosto de 1994"
25,5,8,1852,49,35,84,"21 de agosto de 1994"
25,5,8,1853,67,46,113,"21 de agosto de 1994"
25,5,8,1854,166,140,306,"21 de agosto de 1994"
25,5,8,1855,131,116,247,"21 de agosto de 1994"
25,5,8,1856,170,156,326,"21 de agosto de 1994"
25,5,8,1857,185,152,337,"21 de agosto de 1994"
25,5,8,1858,145,129,274,"21 de agosto de 1994"
25,5,8,1859,226,178,404,"21 de agosto de 1994"
25,5,12,2667,275,294,569,"21 de agosto de 1994"
25,5,12,2668,123,137,260,"21 de agosto de 1994"
25,5,12,2669,93,98,191,"21 de agosto de 1994"
25,5,12,2670,180,202,382,"21 de agosto de 1994"
25,5,12,2671,93,104,197,"21 de agosto de 1994"
25,5,12,2672,955,1122,2077,"21 de agosto de 1994"
25,5,12,2673,243,236,479,"21 de agosto de 1994"
25,5,12,2674,294,319,613,"21 de agosto de 1994"
25,5,12,2675,211,214,425,"21 de agosto de 1994"
25,5,12,2676,281,295,576,"21 de agosto de 1994"
25,5,12,2677,138,155,293,"21 de agosto de 1994"
25,5,12,2678,179,184,363,"21 de agosto de 1994"
25,5,12,2679,138,141,279,"21 de agosto de 1994"
25,5,12,2680,190,214,404,"21 de agosto de 1994"
25,5,12,2681,121,151,272,"21 de agosto de 1994"
25,5,12,2682,181,212,393,"21 de agosto de 1994"
25,5,12,2683,260,289,549,"21 de agosto de 1994"
25,5,12,2684,394,471,865,"21 de agosto de 1994"
25,5,12,2685,534,620,1154,"21 de agosto de 1994"
25,5,12,2686,378,373,751,"21 de agosto de 1994"
25,5,12,2687,274,278,552,"21 de agosto de 1994"
25,5,12,2688,425,421,846,"21 de agosto de 1994"
25,5,12,2689,307,323,630,"21 de agosto de 1994"
25,5,12,2690,142,166,308,"21 de agosto de 1994"
25,5,12,2691,265,291,556,"21 de agosto de 1994"
25,5,12,2692,170,188,358,"21 de agosto de 1994"
25,5,12,2693,139,171,310,"21 de agosto de 1994"
25,5,12,2694,561,701,1262,"21 de agosto de 1994"
25,5,12,2695,430,470,900,"21 de agosto de 1994"
25,5,12,2696,299,330,629,"21 de agosto de 1994"
25,5,12,2697,147,175,322,"21 de agosto de 1994"
25,5,12,2698,711,874,1585,"21 de agosto de 1994"
25,5,12,2699,159,184,343,"21 de agosto de 1994"
25,5,12,2700,229,263,492,"21 de agosto de 1994"
25,5,12,2701,166,198,364,"21 de agosto de 1994"
25,5,12,2702,313,334,647,"21 de agosto de 1994"
25,5,12,2703,267,304,571,"21 de agosto de 1994"
25,5,12,2704,274,285,559,"21 de agosto de 1994"
25,5,12,2705,185,204,389,"21 de agosto de 1994"
25,5,12,2706,216,262,478,"21 de agosto de 1994"
25,5,12,2707,216,272,488,"21 de agosto de 1994"
25,5,12,2708,468,559,1027,"21 de agosto de 1994"
25,5,12,2709,137,156,293,"21 de agosto de 1994"
25,5,12,2710,250,311,561,"21 de agosto de 1994"
25,5,12,2711,137,148,285,"21 de agosto de 1994"
25,5,12,2712,91,102,193,"21 de agosto de 1994"
25,5,12,2713,59,57,116,"21 de agosto de 1994"
25,5,12,2714,154,199,353,"21 de agosto de 1994"
25,5,12,2715,366,405,771,"21 de agosto de 1994"
25,5,12,2716,252,274,526,"21 de agosto de 1994"
25,5,12,2717,245,272,517,"21 de agosto de 1994"
25,5,12,2718,206,258,464,"21 de agosto de 1994"
25,5,12,2719,186,207,393,"21 de agosto de 1994"
25,5,12,2720,296,287,583,"21 de agosto de 1994"
25,5,12,2721,309,335,644,"21 de agosto de 1994"
25,5,12,2722,274,309,583,"21 de agosto de 1994"
25,5,12,2723,178,187,365,"21 de agosto de 1994"
25,5,12,2724,180,193,373,"21 de agosto de 1994"
25,5,12,2725,213,231,444,"21 de agosto de 1994"
25,5,12,2726,137,130,267,"21 de agosto de 1994"
25,5,12,2727,151,176,327,"21 de agosto de 1994"
25,5,12,2728,125,159,284,"21 de agosto de 1994"
25,5,12,2729,187,215,402,"21 de agosto de 1994"
25,5,12,2730,299,356,655,"21 de agosto de 1994"
25,5,12,2731,166,191,357,"21 de agosto de 1994"
25,5,12,2732,172,212,384,"21 de agosto de 1994"
25,5,12,2733,118,137,255,"21 de agosto de 1994"
25,5,12,2734,190,189,379,"21 de agosto de 1994"
25,5,12,2735,193,199,392,"21 de agosto de 1994"
25,5,12,2736,248,224,472,"21 de agosto de 1994"
25,5,12,2737,691,710,1401,"21 de agosto de 1994"
25,5,12,2738,275,309,584,"21 de agosto de 1994"
25,5,12,2739,165,174,339,"21 de agosto de 1994"
25,5,12,2740,188,221,409,"21 de agosto de 1994"
25,5,12,2741,220,210,430,"21 de agosto de 1994"
25,5,12,2742,295,290,585,"21 de agosto de 1994"
25,5,12,2743,315,362,677,"21 de agosto de 1994"
25,5,12,2744,169,163,332,"21 de agosto de 1994"
25,5,12,2745,329,397,726,"21 de agosto de 1994"
25,5,12,2746,140,168,308,"21 de agosto de 1994"
25,5,12,2747,43,59,102,"21 de agosto de 1994"
25,5,12,2748,68,91,159,"21 de agosto de 1994"
25,5,12,2749,229,270,499,"21 de agosto de 1994"
25,5,12,2750,112,131,243,"21 de agosto de 1994"
25,5,12,2751,282,311,593,"21 de agosto de 1994"
25,5,12,2752,262,232,494,"21 de agosto de 1994"
25,5,12,2753,240,257,497,"21 de agosto de 1994"
25,5,12,2754,260,278,538,"21 de agosto de 1994"
25,5,12,2755,247,275,522,"21 de agosto de 1994"
25,5,12,2756,129,134,263,"21 de agosto de 1994"
25,5,12,2757,123,154,277,"21 de agosto de 1994"
25,5,12,2758,121,152,273,"21 de agosto de 1994"
25,5,12,2759,144,164,308,"21 de agosto de 1994"
25,5,12,2760,134,172,306,"21 de agosto de 1994"
25,5,12,2761,181,200,381,"21 de agosto de 1994"
25,5,12,2762,274,276,550,"21 de agosto de 1994"
25,5,12,2763,253,267,520,"21 de agosto de 1994"
25,5,12,2764,99,123,222,"21 de agosto de 1994"
25,5,12,2765,202,249,451,"21 de agosto de 1994"
25,5,12,2766,123,148,271,"21 de agosto de 1994"
25,5,12,2767,159,184,343,"21 de agosto de 1994"
25,5,12,2768,157,176,333,"21 de agosto de 1994"
25,5,12,2769,217,270,487,"21 de agosto de 1994"
25,5,12,2770,255,283,538,"21 de agosto de 1994"
25,5,12,2771,194,195,389,"21 de agosto de 1994"
25,5,12,2772,139,178,317,"21 de agosto de 1994"
25,5,12,2773,175,216,391,"21 de agosto de 1994"
25,5,12,2774,278,317,595,"21 de agosto de 1994"
25,5,12,2775,251,291,542,"21 de agosto de 1994"
25,5,12,2776,179,197,376,"21 de agosto de 1994"
25,5,12,2777,229,276,505,"21 de agosto de 1994"
25,5,12,2778,144,156,300,"21 de agosto de 1994"
25,5,12,2779,143,179,322,"21 de agosto de 1994"
25,5,12,2780,181,246,427,"21 de agosto de 1994"
25,5,12,2781,258,310,568,"21 de agosto de 1994"
25,5,12,2782,199,254,453,"21 de agosto de 1994"
25,5,12,2783,302,330,632,"21 de agosto de 1994"
25,5,12,2784,269,302,571,"21 de agosto de 1994"
25,5,12,2785,201,236,437,"21 de agosto de 1994"
25,5,12,2786,214,242,456,"21 de agosto de 1994"
25,5,12,2787,174,202,376,"21 de agosto de 1994"
25,5,12,2788,212,295,507,"21 de agosto de 1994"
25,5,12,2789,237,260,497,"21 de agosto de 1994"
25,5,12,2790,215,244,459,"21 de agosto de 1994"
25,5,12,2791,333,385,718,"21 de agosto de 1994"
25,5,12,2792,158,188,346,"21 de agosto de 1994"
25,5,12,2793,181,163,344,"21 de agosto de 1994"
25,5,12,2794,123,146,269,"21 de agosto de 1994"
25,5,12,2795,150,170,320,"21 de agosto de 1994"
25,5,12,2796,278,293,571,"21 de agosto de 1994"
25,5,12,2797,220,247,467,"21 de agosto de 1994"
25,5,12,2798,253,248,501,"21 de agosto de 1994"
25,5,12,2799,355,354,709,"21 de agosto de 1994"
25,5,12,2800,259,316,575,"21 de agosto de 1994"
25,5,12,2801,199,218,417,"21 de agosto de 1994"
25,5,12,2802,110,114,224,"21 de agosto de 1994"
25,5,12,2803,66,74,140,"21 de agosto de 1994"
25,5,12,2804,130,153,283,"21 de agosto de 1994"
25,5,12,2805,193,191,384,"21 de agosto de 1994"
25,5,12,2806,155,165,320,"21 de agosto de 1994"
25,5,12,2807,193,211,404,"21 de agosto de 1994"
25,5,12,2808,253,284,537,"21 de agosto de 1994"
25,5,12,2809,324,355,679,"21 de agosto de 1994"
25,5,12,2810,188,225,413,"21 de agosto de 1994"
25,5,12,2811,115,131,246,"21 de agosto de 1994"
25,5,12,2812,193,187,380,"21 de agosto de 1994"
25,5,12,2813,254,287,541,"21 de agosto de 1994"
25,5,12,2814,275,289,564,"21 de agosto de 1994"
25,5,12,2815,247,261,508,"21 de agosto de 1994"
25,5,12,2816,326,338,664,"21 de agosto de 1994"
25,5,12,2817,183,164,347,"21 de agosto de 1994"
25,5,12,2818,218,248,466,"21 de agosto de 1994"
25,5,12,2819,118,152,270,"21 de agosto de 1994"
25,5,12,2820,229,227,456,"21 de agosto de 1994"
25,5,12,2821,218,245,463,"21 de agosto de 1994"
25,5,12,2822,265,306,571,"21 de agosto de 1994"
25,5,12,2823,230,237,467,"21 de agosto de 1994"
25,5,12,2824,196,214,410,"21 de agosto de 1994"
25,5,12,2825,188,200,388,"21 de agosto de 1994"
25,5,12,2826,197,190,387,"21 de agosto de 1994"
25,5,12,2827,287,282,569,"21 de agosto de 1994"
25,5,12,2828,206,234,440,"21 de agosto de 1994"
25,5,12,2829,154,174,328,"21 de agosto de 1994"
25,5,12,2830,356,360,716,"21 de agosto de 1994"
25,5,12,2831,311,339,650,"21 de agosto de 1994"
25,5,12,2832,238,256,494,"21 de agosto de 1994"
25,5,12,2833,272,292,564,"21 de agosto de 1994"
25,5,12,2834,209,241,450,"21 de agosto de 1994"
25,5,12,2835,332,374,706,"21 de agosto de 1994"
25,5,12,2836,286,340,626,"21 de agosto de 1994"
25,5,12,2837,266,308,574,"21 de agosto de 1994"
25,5,12,2838,117,145,262,"21 de agosto de 1994"
25,5,12,2839,224,258,482,"21 de agosto de 1994"
25,5,12,2840,98,129,227,"21 de agosto de 1994"
25,5,12,2841,123,132,255,"21 de agosto de 1994"
25,5,12,2842,213,247,460,"21 de agosto de 1994"
25,5,12,2843,235,219,454,"21 de agosto de 1994"
25,5,12,2844,223,239,462,"21 de agosto de 1994"
25,5,12,2845,124,145,269,"21 de agosto de 1994"
25,5,12,2846,241,271,512,"21 de agosto de 1994"
25,5,12,2847,366,357,723,"21 de agosto de 1994"
25,5,12,2848,255,265,520,"21 de agosto de 1994"
25,5,12,2849,281,301,582,"21 de agosto de 1994"
25,5,12,2850,193,187,380,"21 de agosto de 1994"
25,5,12,2851,153,179,332,"21 de agosto de 1994"
25,5,12,2852,131,124,255,"21 de agosto de 1994"
25,5,12,2853,304,303,607,"21 de agosto de 1994"
25,5,12,2854,313,325,638,"21 de agosto de 1994"
25,5,12,2855,265,299,564,"21 de agosto de 1994"
25,5,12,2856,268,274,542,"21 de agosto de 1994"
25,5,12,2857,127,143,270,"21 de agosto de 1994"
25,5,12,2858,101,128,229,"21 de agosto de 1994"
25,5,12,2859,178,201,379,"21 de agosto de 1994"
25,5,12,2860,239,248,487,"21 de agosto de 1994"
25,5,12,2861,261,302,563,"21 de agosto de 1994"
25,5,12,2862,134,151,285,"21 de agosto de 1994"
25,5,12,2863,332,353,685,"21 de agosto de 1994"
25,5,12,2864,168,177,345,"21 de agosto de 1994"
25,5,12,2865,168,192,360,"21 de agosto de 1994"
25,5,12,2866,174,202,376,"21 de agosto de 1994"
25,5,12,2867,126,150,276,"21 de agosto de 1994"
25,5,12,2868,269,281,550,"21 de agosto de 1994"
25,5,12,2869,186,178,364,"21 de agosto de 1994"
25,5,12,2870,220,238,458,"21 de agosto de 1994"
25,5,12,2871,285,333,618,"21 de agosto de 1994"
25,5,12,2872,354,375,729,"21 de agosto de 1994"
25,5,12,2873,134,164,298,"21 de agosto de 1994"
25,5,12,2874,132,146,278,"21 de agosto de 1994"
25,5,12,2875,168,185,353,"21 de agosto de 1994"
25,5,12,2876,142,154,296,"21 de agosto de 1994"
25,5,12,2877,181,233,414,"21 de agosto de 1994"
25,5,12,2878,155,157,312,"21 de agosto de 1994"
25,5,12,2879,393,508,901,"21 de agosto de 1994"
25,5,12,2880,165,192,357,"21 de agosto de 1994"
25,5,12,2881,179,178,357,"21 de agosto de 1994"
25,5,12,2882,158,161,319,"21 de agosto de 1994"
25,5,12,2883,141,135,276,"21 de agosto de 1994"
25,5,12,2884,82,93,175,"21 de agosto de 1994"
25,5,12,2885,277,262,539,"21 de agosto de 1994"
25,5,12,2886,155,162,317,"21 de agosto de 1994"
25,5,12,2887,162,157,319,"21 de agosto de 1994"
25,5,12,2888,195,214,409,"21 de agosto de 1994"
25,5,12,2889,804,239,1043,"21 de agosto de 1994"
25,5,12,2890,78,83,161,"21 de agosto de 1994"
25,5,12,2891,143,161,304,"21 de agosto de 1994"
25,5,12,2892,230,253,483,"21 de agosto de 1994"
25,5,12,2893,148,176,324,"21 de agosto de 1994"
25,5,12,2894,283,300,583,"21 de agosto de 1994"
25,5,12,2895,165,198,363,"21 de agosto de 1994"
25,5,12,2896,198,239,437,"21 de agosto de 1994"
25,5,12,2897,138,148,286,"21 de agosto de 1994"
25,5,12,2898,182,205,387,"21 de agosto de 1994"
25,5,12,2899,139,169,308,"21 de agosto de 1994"
25,5,12,2900,148,156,304,"21 de agosto de 1994"
25,5,12,2901,386,425,811,"21 de agosto de 1994"
25,5,12,2902,230,218,448,"21 de agosto de 1994"
25,5,12,2903,250,267,517,"21 de agosto de 1994"
25,5,12,2904,256,247,503,"21 de agosto de 1994"
25,5,12,2905,211,187,398,"21 de agosto de 1994"
25,5,12,2906,399,415,814,"21 de agosto de 1994"
25,5,12,2907,199,213,412,"21 de agosto de 1994"
25,5,12,2908,93,93,186,"21 de agosto de 1994"
25,5,12,2909,188,246,434,"21 de agosto de 1994"
25,5,12,2910,181,182,363,"21 de agosto de 1994"
25,5,12,2911,179,183,362,"21 de agosto de 1994"
25,5,12,2912,89,108,197,"21 de agosto de 1994"
25,5,12,2913,145,160,305,"21 de agosto de 1994"
25,5,12,2914,135,133,268,"21 de agosto de 1994"
25,5,12,2915,240,256,496,"21 de agosto de 1994"
25,5,12,2916,106,132,238,"21 de agosto de 1994"
25,5,12,2917,250,280,530,"21 de agosto de 1994"
25,5,12,2918,147,155,302,"21 de agosto de 1994"
25,5,12,2919,271,299,570,"21 de agosto de 1994"
25,5,12,2920,134,171,305,"21 de agosto de 1994"
25,5,12,2921,276,291,567,"21 de agosto de 1994"
25,5,12,2922,370,454,824,"21 de agosto de 1994"
25,5,12,2923,160,176,336,"21 de agosto de 1994"
25,5,12,2924,263,288,551,"21 de agosto de 1994"
25,5,12,2925,194,203,397,"21 de agosto de 1994"
25,5,12,2926,115,113,228,"21 de agosto de 1994"
25,5,12,2927,213,239,452,"21 de agosto de 1994"
25,5,12,2928,175,191,366,"21 de agosto de 1994"
25,5,12,2929,169,198,367,"21 de agosto de 1994"
25,5,12,2930,200,237,437,"21 de agosto de 1994"
25,5,12,2931,134,162,296,"21 de agosto de 1994"
25,5,12,2932,120,137,257,"21 de agosto de 1994"
25,5,12,2933,234,284,518,"21 de agosto de 1994"
25,5,12,2934,105,136,241,"21 de agosto de 1994"
25,5,12,2935,167,209,376,"21 de agosto de 1994"
25,5,12,2936,181,196,377,"21 de agosto de 1994"
25,5,12,2937,251,291,542,"21 de agosto de 1994"
25,5,12,2938,243,290,533,"21 de agosto de 1994"
25,5,12,2939,337,347,684,"21 de agosto de 1994"
25,5,12,2940,219,209,428,"21 de agosto de 1994"
25,5,12,2941,159,164,323,"21 de agosto de 1994"
25,5,12,2942,212,225,437,"21 de agosto de 1994"
25,5,12,2943,114,121,235,"21 de agosto de 1994"
25,5,12,2944,241,261,502,"21 de agosto de 1994"
25,5,12,2945,84,85,169,"21 de agosto de 1994"
25,5,12,2946,106,144,250,"21 de agosto de 1994"
25,5,12,2947,210,201,411,"21 de agosto de 1994"
25,5,12,2948,123,140,263,"21 de agosto de 1994"
25,5,12,2949,117,136,253,"21 de agosto de 1994"
25,5,12,2950,118,148,266,"21 de agosto de 1994"
25,5,12,2951,143,160,303,"21 de agosto de 1994"
25,5,12,2952,18,8,26,"21 de agosto de 1994"
25,5,12,2953,137,103,240,"21 de agosto de 1994"
25,5,12,2954,146,92,238,"21 de agosto de 1994"
25,5,12,2955,78,49,127,"21 de agosto de 1994"
25,5,12,2956,323,259,582,"21 de agosto de 1994"
25,5,12,2957,74,44,118,"21 de agosto de 1994"
25,5,12,2958,108,91,199,"21 de agosto de 1994"
25,5,12,2959,148,112,260,"21 de agosto de 1994"
25,5,12,2960,106,102,208,"21 de agosto de 1994"
25,5,12,2961,277,281,558,"21 de agosto de 1994"
25,5,12,2962,173,165,338,"21 de agosto de 1994"
25,5,12,2963,143,128,271,"21 de agosto de 1994"
25,5,12,2964,77,63,140,"21 de agosto de 1994"
25,5,12,2965,61,54,115,"21 de agosto de 1994"
25,5,12,2966,237,179,416,"21 de agosto de 1994"
25,5,12,2967,248,204,452,"21 de agosto de 1994"
25,5,12,2968,100,84,184,"21 de agosto de 1994"
25,5,12,2969,35,26,61,"21 de agosto de 1994"
25,5,12,2970,63,36,99,"21 de agosto de 1994"
25,5,12,2971,95,70,165,"21 de agosto de 1994"
25,5,12,2972,71,44,115,"21 de agosto de 1994"
25,5,12,2973,128,106,234,"21 de agosto de 1994"
25,5,12,2974,314,260,574,"21 de agosto de 1994"
25,5,12,2975,273,230,503,"21 de agosto de 1994"
25,5,12,2976,143,123,266,"21 de agosto de 1994"
25,5,12,2977,105,97,202,"21 de agosto de 1994"
25,5,12,2978,101,102,203,"21 de agosto de 1994"
25,5,12,2979,231,179,410,"21 de agosto de 1994"
25,5,12,2980,37,35,72,"21 de agosto de 1994"
25,5,12,2981,50,39,89,"21 de agosto de 1994"
25,5,12,2982,107,96,203,"21 de agosto de 1994"
25,5,12,2983,181,168,349,"21 de agosto de 1994"
25,5,12,2984,267,252,519,"21 de agosto de 1994"
25,5,12,2985,78,70,148,"21 de agosto de 1994"
25,5,12,2986,34,26,60,"21 de agosto de 1994"
25,5,12,2987,293,283,576,"21 de agosto de 1994"
25,5,12,2988,168,185,353,"21 de agosto de 1994"
25,5,12,2989,118,97,215,"21 de agosto de 1994"
25,5,12,2990,168,139,307,"21 de agosto de 1994"
25,5,12,2991,201,200,401,"21 de agosto de 1994"
25,5,12,2992,118,120,238,"21 de agosto de 1994"
25,5,12,2993,234,208,442,"21 de agosto de 1994"
25,5,12,2994,138,112,250,"21 de agosto de 1994"
25,5,12,2995,172,135,307,"21 de agosto de 1994"
25,5,12,2996,279,305,584,"21 de agosto de 1994"
25,5,16,3370,336,316,652,"21 de agosto de 1994"
25,5,16,3371,181,140,321,"21 de agosto de 1994"
25,5,16,3372,199,205,404,"21 de agosto de 1994"
25,5,16,3373,93,81,174,"21 de agosto de 1994"
25,5,16,3374,235,212,447,"21 de agosto de 1994"
25,5,16,3375,68,32,100,"21 de agosto de 1994"
25,5,16,3376,149,101,250,"21 de agosto de 1994"
25,5,16,3377,49,21,70,"21 de agosto de 1994"
25,5,16,3378,87,44,131,"21 de agosto de 1994"
25,5,16,3379,172,118,290,"21 de agosto de 1994"
25,5,16,3380,99,40,139,"21 de agosto de 1994"
25,5,16,3381,63,42,105,"21 de agosto de 1994"
25,5,16,3382,72,49,121,"21 de agosto de 1994"
25,5,16,3383,76,59,135,"21 de agosto de 1994"
25,5,16,3384,72,49,121,"21 de agosto de 1994"
25,5,16,3385,291,173,464,"21 de agosto de 1994"
25,5,16,3386,107,68,175,"21 de agosto de 1994"
25,5,16,3387,75,55,130,"21 de agosto de 1994"
25,5,16,3388,55,31,86,"21 de agosto de 1994"
25,5,16,3389,78,58,136,"21 de agosto de 1994"
25,5,16,3390,34,25,59,"21 de agosto de 1994"
25,5,16,3391,12,9,21,"21 de agosto de 1994"
25,5,16,3392,179,173,352,"21 de agosto de 1994"
25,5,16,3393,70,66,136,"21 de agosto de 1994"
25,5,16,3394,145,126,271,"21 de agosto de 1994"
25,5,16,3395,135,96,231,"21 de agosto de 1994"
25,5,16,3396,329,227,556,"21 de agosto de 1994"
25,5,16,3397,53,37,90,"21 de agosto de 1994"
25,5,16,3398,98,89,187,"21 de agosto de 1994"
25,5,16,3399,66,58,124,"21 de agosto de 1994"
25,5,16,3400,226,171,397,"21 de agosto de 1994"
25,5,16,3401,200,158,358,"21 de agosto de 1994"
25,5,16,3402,264,200,464,"21 de agosto de 1994"
25,5,16,3403,234,199,433,"21 de agosto de 1994"
25,5,16,3404,162,148,310,"21 de agosto de 1994"
25,5,16,3405,103,89,192,"21 de agosto de 1994"
25,5,16,3406,233,159,392,"21 de agosto de 1994"
25,5,16,3407,99,68,167,"21 de agosto de 1994"
25,5,16,3408,136,94,230,"21 de agosto de 1994"
25,5,16,3409,331,277,608,"21 de agosto de 1994"
25,5,16,3410,219,198,417,"21 de agosto de 1994"
25,5,16,3411,159,120,279,"21 de agosto de 1994"
25,5,16,3412,94,79,173,"21 de agosto de 1994"
25,5,16,3413,194,155,349,"21 de agosto de 1994"
25,5,16,3414,184,155,339,"21 de agosto de 1994"
25,5,16,3415,150,115,265,"21 de agosto de 1994"
25,5,16,3416,213,184,397,"21 de agosto de 1994"
25,5,16,3417,87,58,145,"21 de agosto de 1994"
25,5,16,3418,118,59,177,"21 de agosto de 1994"
25,5,16,3419,119,96,215,"21 de agosto de 1994"
25,6,1,368,169,172,341,"21 de agosto de 1994"
25,6,1,369,162,160,322,"21 de agosto de 1994"
25,6,1,370,187,209,396,"21 de agosto de 1994"
25,6,1,371,263,286,549,"21 de agosto de 1994"
25,6,1,372,69,91,160,"21 de agosto de 1994"
25,6,1,373,214,215,429,"21 de agosto de 1994"
25,6,1,374,193,171,364,"21 de agosto de 1994"
25,6,1,375,117,93,210,"21 de agosto de 1994"
25,6,1,376,48,31,79,"21 de agosto de 1994"
25,6,1,377,103,91,194,"21 de agosto de 1994"
25,6,1,378,170,167,337,"21 de agosto de 1994"
25,6,1,379,158,152,310,"21 de agosto de 1994"
25,6,1,380,198,197,395,"21 de agosto de 1994"
25,6,1,381,167,168,335,"21 de agosto de 1994"
25,6,1,382,172,162,334,"21 de agosto de 1994"
25,6,1,383,214,203,417,"21 de agosto de 1994"
25,6,1,384,97,95,192,"21 de agosto de 1994"
25,6,1,385,174,189,363,"21 de agosto de 1994"
25,6,1,386,136,149,285,"21 de agosto de 1994"
25,6,1,387,116,123,239,"21 de agosto de 1994"
25,6,1,388,236,211,447,"21 de agosto de 1994"
25,6,1,389,131,128,259,"21 de agosto de 1994"
25,6,1,390,318,300,618,"21 de agosto de 1994"
25,6,1,391,253,237,490,"21 de agosto de 1994"
25,6,1,392,118,109,227,"21 de agosto de 1994"
25,6,1,393,219,198,417,"21 de agosto de 1994"
25,6,1,394,160,143,303,"21 de agosto de 1994"
25,6,1,395,194,199,393,"21 de agosto de 1994"
25,6,1,396,261,252,513,"21 de agosto de 1994"
25,6,1,397,154,149,303,"21 de agosto de 1994"
25,6,1,398,289,284,573,"21 de agosto de 1994"
25,6,1,399,316,306,622,"21 de agosto de 1994"
25,6,1,400,181,190,371,"21 de agosto de 1994"
25,6,1,401,161,170,331,"21 de agosto de 1994"
25,6,1,402,174,166,340,"21 de agosto de 1994"
25,6,1,403,194,221,415,"21 de agosto de 1994"
25,6,1,404,168,183,351,"21 de agosto de 1994"
25,6,1,405,129,115,244,"21 de agosto de 1994"
25,6,1,406,298,285,583,"21 de agosto de 1994"
25,6,1,407,207,204,411,"21 de agosto de 1994"
25,6,1,408,281,250,531,"21 de agosto de 1994"
25,6,1,409,88,81,169,"21 de agosto de 1994"
25,6,1,410,253,219,472,"21 de agosto de 1994"
25,6,1,411,487,452,939,"21 de agosto de 1994"
25,6,1,412,232,206,438,"21 de agosto de 1994"
25,6,1,413,138,144,282,"21 de agosto de 1994"
25,6,1,414,112,117,229,"21 de agosto de 1994"
25,6,1,415,206,197,403,"21 de agosto de 1994"
25,6,1,416,253,210,463,"21 de agosto de 1994"
25,6,1,417,107,93,200,"21 de agosto de 1994"
25,6,1,418,178,173,351,"21 de agosto de 1994"
25,6,1,419,146,138,284,"21 de agosto de 1994"
25,6,1,420,152,155,307,"21 de agosto de 1994"
25,6,1,421,168,156,324,"21 de agosto de 1994"
25,6,1,422,67,69,136,"21 de agosto de 1994"
25,6,1,423,96,103,199,"21 de agosto de 1994"
25,6,1,424,90,65,155,"21 de agosto de 1994"
25,6,1,425,132,100,232,"21 de agosto de 1994"
25,6,1,426,128,102,230,"21 de agosto de 1994"
25,6,1,427,38,26,64,"21 de agosto de 1994"
25,6,1,428,155,121,276,"21 de agosto de 1994"
25,6,1,429,89,88,177,"21 de agosto de 1994"
25,6,1,430,185,154,339,"21 de agosto de 1994"
25,6,1,431,87,73,160,"21 de agosto de 1994"
25,6,1,432,68,61,129,"21 de agosto de 1994"
25,6,1,433,119,88,207,"21 de agosto de 1994"
25,6,1,434,227,219,446,"21 de agosto de 1994"
25,6,1,435,197,183,380,"21 de agosto de 1994"
25,6,1,436,90,89,179,"21 de agosto de 1994"
25,6,1,437,238,233,471,"21 de agosto de 1994"
25,6,1,438,164,119,283,"21 de agosto de 1994"
25,6,1,439,248,215,463,"21 de agosto de 1994"
25,6,1,440,346,360,706,"21 de agosto de 1994"
25,6,1,441,62,61,123,"21 de agosto de 1994"
25,6,1,442,278,264,542,"21 de agosto de 1994"
25,6,1,443,213,217,430,"21 de agosto de 1994"
25,6,1,444,192,195,387,"21 de agosto de 1994"
25,6,1,445,110,85,195,"21 de agosto de 1994"
25,6,1,446,156,138,294,"21 de agosto de 1994"
25,6,1,447,123,108,231,"21 de agosto de 1994"
25,6,1,448,247,266,513,"21 de agosto de 1994"
25,6,1,449,350,374,724,"21 de agosto de 1994"
25,6,1,450,297,237,534,"21 de agosto de 1994"
25,6,1,451,202,221,423,"21 de agosto de 1994"
25,6,1,452,70,89,159,"21 de agosto de 1994"
25,6,1,453,212,176,388,"21 de agosto de 1994"
25,6,1,454,189,146,335,"21 de agosto de 1994"
25,6,1,455,132,120,252,"21 de agosto de 1994"
25,6,7,1726,222,174,396,"21 de agosto de 1994"
25,6,7,1727,321,262,583,"21 de agosto de 1994"
25,6,7,1728,116,94,210,"21 de agosto de 1994"
25,6,7,1729,224,208,432,"21 de agosto de 1994"
25,6,7,1730,249,197,446,"21 de agosto de 1994"
25,6,7,1731,144,133,277,"21 de agosto de 1994"
25,6,7,1732,69,59,128,"21 de agosto de 1994"
25,6,7,1733,238,218,456,"21 de agosto de 1994"
25,6,7,1734,121,100,221,"21 de agosto de 1994"
25,6,7,1735,306,213,519,"21 de agosto de 1994"
25,6,7,1736,58,54,112,"21 de agosto de 1994"
25,6,7,1737,67,35,102,"21 de agosto de 1994"
25,6,7,1738,22,5,27,"21 de agosto de 1994"
25,6,7,1739,87,64,151,"21 de agosto de 1994"
25,6,7,1740,76,53,129,"21 de agosto de 1994"
25,6,7,1741,77,69,146,"21 de agosto de 1994"
25,6,7,1742,93,58,151,"21 de agosto de 1994"
25,6,7,1743,109,73,182,"21 de agosto de 1994"
25,6,7,1744,75,70,145,"21 de agosto de 1994"
25,6,7,1745,239,194,433,"21 de agosto de 1994"
25,6,7,1746,140,116,256,"21 de agosto de 1994"
25,6,7,1747,51,43,94,"21 de agosto de 1994"
25,6,7,1748,44,15,59,"21 de agosto de 1994"
25,6,7,1749,95,65,160,"21 de agosto de 1994"
25,6,7,1750,131,95,226,"21 de agosto de 1994"
25,6,7,1751,75,67,142,"21 de agosto de 1994"
25,6,7,1752,76,48,124,"21 de agosto de 1994"
25,6,7,1753,56,51,107,"21 de agosto de 1994"
25,6,7,1754,117,102,219,"21 de agosto de 1994"
25,6,7,1755,163,132,295,"21 de agosto de 1994"
25,6,7,1756,88,61,149,"21 de agosto de 1994"
25,6,7,1757,64,50,114,"21 de agosto de 1994"
25,6,7,1758,128,108,236,"21 de agosto de 1994"
25,6,7,1759,115,72,187,"21 de agosto de 1994"
25,6,7,1760,65,38,103,"21 de agosto de 1994"
25,6,7,1761,101,80,181,"21 de agosto de 1994"
25,6,7,1762,72,48,120,"21 de agosto de 1994"
25,6,7,1763,66,51,117,"21 de agosto de 1994"
25,6,7,1764,170,129,299,"21 de agosto de 1994"
25,6,7,1765,58,19,77,"21 de agosto de 1994"
25,6,7,1766,82,64,146,"21 de agosto de 1994"
25,6,7,1767,69,50,119,"21 de agosto de 1994"
25,6,7,1768,135,100,235,"21 de agosto de 1994"
25,6,7,1769,226,157,383,"21 de agosto de 1994"
25,6,7,1770,157,119,276,"21 de agosto de 1994"
25,6,7,1771,135,105,240,"21 de agosto de 1994"
25,6,7,1772,162,118,280,"21 de agosto de 1994"
25,6,7,1773,124,94,218,"21 de agosto de 1994"
25,6,7,1774,129,97,226,"21 de agosto de 1994"
25,6,7,1775,148,111,259,"21 de agosto de 1994"
25,6,7,1776,124,84,208,"21 de agosto de 1994"
25,6,7,1777,53,39,92,"21 de agosto de 1994"
25,6,7,1778,135,106,241,"21 de agosto de 1994"
25,6,7,1779,80,84,164,"21 de agosto de 1994"
25,6,7,1780,78,51,129,"21 de agosto de 1994"
25,6,7,1781,52,44,96,"21 de agosto de 1994"
25,6,7,1782,180,129,309,"21 de agosto de 1994"
25,6,7,1783,93,61,154,"21 de agosto de 1994"
25,6,7,1784,196,140,336,"21 de agosto de 1994"
25,6,7,1785,78,51,129,"21 de agosto de 1994"
25,6,7,1786,102,95,197,"21 de agosto de 1994"
25,6,7,1787,185,136,321,"21 de agosto de 1994"
25,6,7,1788,187,152,339,"21 de agosto de 1994"
25,6,7,1789,96,75,171,"21 de agosto de 1994"
25,6,7,1790,115,83,198,"21 de agosto de 1994"
25,6,7,1791,113,79,192,"21 de agosto de 1994"
25,6,7,1792,145,112,257,"21 de agosto de 1994"
25,6,7,1793,157,134,291,"21 de agosto de 1994"
25,6,7,1794,108,83,191,"21 de agosto de 1994"
25,6,7,1795,33,33,66,"21 de agosto de 1994"
25,6,7,1796,112,84,196,"21 de agosto de 1994"
25,6,7,1797,194,118,312,"21 de agosto de 1994"
25,6,7,1798,76,42,118,"21 de agosto de 1994"
25,6,10,1925,169,168,337,"21 de agosto de 1994"
25,6,10,1926,138,142,280,"21 de agosto de 1994"
25,6,10,1927,166,168,334,"21 de agosto de 1994"
25,6,10,1928,159,163,322,"21 de agosto de 1994"
25,6,10,1929,163,150,313,"21 de agosto de 1994"
25,6,10,1930,191,189,380,"21 de agosto de 1994"
25,6,10,1931,138,170,308,"21 de agosto de 1994"
25,6,10,1932,121,151,272,"21 de agosto de 1994"
25,6,10,1933,156,156,312,"21 de agosto de 1994"
25,6,10,1934,193,185,378,"21 de agosto de 1994"
25,6,10,1935,143,135,278,"21 de agosto de 1994"
25,6,10,1936,141,146,287,"21 de agosto de 1994"
25,6,10,1937,148,148,296,"21 de agosto de 1994"
25,6,10,1938,272,261,533,"21 de agosto de 1994"
25,6,10,1939,168,162,330,"21 de agosto de 1994"
25,6,10,1940,171,154,325,"21 de agosto de 1994"
25,6,10,1941,230,225,455,"21 de agosto de 1994"
25,6,10,1942,185,203,388,"21 de agosto de 1994"
25,6,10,1943,86,64,150,"21 de agosto de 1994"
25,6,10,1944,157,125,282,"21 de agosto de 1994"
25,6,10,1945,87,68,155,"21 de agosto de 1994"
25,6,10,1946,50,36,86,"21 de agosto de 1994"
25,6,10,1947,49,38,87,"21 de agosto de 1994"
25,6,10,1948,154,126,280,"21 de agosto de 1994"
25,6,10,1949,94,75,169,"21 de agosto de 1994"
25,6,10,1950,50,35,85,"21 de agosto de 1994"
25,6,10,1951,95,68,163,"21 de agosto de 1994"
25,6,10,1952,85,68,153,"21 de agosto de 1994"
25,6,10,1953,67,52,119,"21 de agosto de 1994"
25,6,10,1954,62,50,112,"21 de agosto de 1994"
25,6,10,1955,143,117,260,"21 de agosto de 1994"
25,6,10,1956,83,91,174,"21 de agosto de 1994"
25,6,10,1957,218,218,436,"21 de agosto de 1994"
25,6,10,1958,94,89,183,"21 de agosto de 1994"
25,6,10,1959,75,64,139,"21 de agosto de 1994"
25,6,10,1960,198,135,333,"21 de agosto de 1994"
25,6,10,1961,131,120,251,"21 de agosto de 1994"
25,6,10,1962,178,133,311,"21 de agosto de 1994"
25,6,10,1963,93,58,151,"21 de agosto de 1994"
25,6,10,1964,48,40,88,"21 de agosto de 1994"
25,6,10,1965,171,123,294,"21 de agosto de 1994"
25,6,10,1966,100,105,205,"21 de agosto de 1994"
25,6,10,1967,98,91,189,"21 de agosto de 1994"
25,6,10,1968,40,38,78,"21 de agosto de 1994"
25,6,10,1969,168,147,315,"21 de agosto de 1994"
25,6,10,1970,170,127,297,"21 de agosto de 1994"
25,6,10,1971,152,142,294,"21 de agosto de 1994"
25,6,10,1972,132,126,258,"21 de agosto de 1994"
25,6,10,1973,98,78,176,"21 de agosto de 1994"
25,6,10,1974,91,63,154,"21 de agosto de 1994"
25,6,10,1975,49,37,86,"21 de agosto de 1994"
25,6,10,1976,87,60,147,"21 de agosto de 1994"
25,6,10,1977,150,93,243,"21 de agosto de 1994"
25,6,10,1978,106,87,193,"21 de agosto de 1994"
25,6,10,1979,69,59,128,"21 de agosto de 1994"
25,6,10,1980,91,79,170,"21 de agosto de 1994"
25,6,10,1981,177,148,325,"21 de agosto de 1994"
25,6,10,1982,111,78,189,"21 de agosto de 1994"
25,6,10,1983,54,37,91,"21 de agosto de 1994"
25,6,10,1984,50,38,88,"21 de agosto de 1994"
25,6,10,1985,91,44,135,"21 de agosto de 1994"
25,6,10,1986,116,77,193,"21 de agosto de 1994"
25,6,10,1987,54,45,99,"21 de agosto de 1994"
25,6,10,1988,187,142,329,"21 de agosto de 1994"
25,6,10,1989,115,102,217,"21 de agosto de 1994"
25,6,10,1990,113,95,208,"21 de agosto de 1994"
25,6,10,1991,204,163,367,"21 de agosto de 1994"
25,6,10,1992,98,69,167,"21 de agosto de 1994"
25,6,10,1993,129,96,225,"21 de agosto de 1994"
25,6,10,1994,142,125,267,"21 de agosto de 1994"
25,6,10,1995,76,46,122,"21 de agosto de 1994"
25,6,10,1996,128,100,228,"21 de agosto de 1994"
25,6,10,1997,167,152,319,"21 de agosto de 1994"
25,6,10,1998,188,146,334,"21 de agosto de 1994"
25,6,10,1999,67,47,114,"21 de agosto de 1994"
25,6,10,2000,92,75,167,"21 de agosto de 1994"
25,6,10,2001,128,106,234,"21 de agosto de 1994"
25,6,10,2002,122,77,199,"21 de agosto de 1994"
25,6,10,2003,84,82,166,"21 de agosto de 1994"
25,6,10,2004,150,163,313,"21 de agosto de 1994"
25,6,10,2005,195,194,389,"21 de agosto de 1994"
25,6,10,2006,231,244,475,"21 de agosto de 1994"
25,6,10,2007,202,191,393,"21 de agosto de 1994"
25,6,10,2008,131,153,284,"21 de agosto de 1994"
25,6,10,2009,202,210,412,"21 de agosto de 1994"
25,6,10,2010,229,248,477,"21 de agosto de 1994"
25,6,10,2011,147,145,292,"21 de agosto de 1994"
25,6,10,2012,258,224,482,"21 de agosto de 1994"
25,6,10,2013,193,170,363,"21 de agosto de 1994"
25,6,10,2014,204,175,379,"21 de agosto de 1994"
25,6,10,2015,154,165,319,"21 de agosto de 1994"
25,6,10,2016,119,91,210,"21 de agosto de 1994"
25,6,10,2017,177,146,323,"21 de agosto de 1994"
25,6,10,2018,65,45,110,"21 de agosto de 1994"
25,6,10,2019,198,183,381,"21 de agosto de 1994"
25,6,10,2020,83,68,151,"21 de agosto de 1994"
25,6,10,2021,188,156,344,"21 de agosto de 1994"
25,6,10,2022,60,55,115,"21 de agosto de 1994"
25,6,10,2023,153,185,338,"21 de agosto de 1994"
25,6,10,2024,168,166,334,"21 de agosto de 1994"
25,6,10,2025,117,137,254,"21 de agosto de 1994"
25,6,10,2026,128,142,270,"21 de agosto de 1994"
25,6,10,2027,66,66,132,"21 de agosto de 1994"
25,6,10,2028,142,168,310,"21 de agosto de 1994"
25,6,10,2029,150,168,318,"21 de agosto de 1994"
25,6,10,2030,138,174,312,"21 de agosto de 1994"
25,6,10,2031,185,193,378,"21 de agosto de 1994"
25,6,10,2032,277,274,551,"21 de agosto de 1994"
25,6,10,2033,109,102,211,"21 de agosto de 1994"
25,6,10,2034,140,147,287,"21 de agosto de 1994"
25,6,10,2035,111,101,212,"21 de agosto de 1994"
25,6,10,2036,63,47,110,"21 de agosto de 1994"
25,6,10,2037,62,58,120,"21 de agosto de 1994"
25,6,10,2038,122,72,194,"21 de agosto de 1994"
25,6,10,2039,292,254,546,"21 de agosto de 1994"
25,6,10,2040,87,86,173,"21 de agosto de 1994"
25,6,10,2041,110,94,204,"21 de agosto de 1994"
25,6,10,2042,78,66,144,"21 de agosto de 1994"
25,6,10,2043,220,210,430,"21 de agosto de 1994"
25,6,10,2044,212,209,421,"21 de agosto de 1994"
25,6,10,2045,111,98,209,"21 de agosto de 1994"
25,6,10,2046,121,98,219,"21 de agosto de 1994"
25,6,10,2047,229,180,409,"21 de agosto de 1994"
25,6,10,2048,218,196,414,"21 de agosto de 1994"
25,6,10,2049,181,154,335,"21 de agosto de 1994"
25,6,10,2050,229,227,456,"21 de agosto de 1994"
25,6,10,2051,70,49,119,"21 de agosto de 1994"
25,6,10,2052,39,28,67,"21 de agosto de 1994"
25,6,10,2053,63,52,115,"21 de agosto de 1994"
25,6,10,2054,99,93,192,"21 de agosto de 1994"
25,6,10,2055,214,213,427,"21 de agosto de 1994"
25,6,10,2056,132,105,237,"21 de agosto de 1994"
25,6,10,2057,100,91,191,"21 de agosto de 1994"
25,6,10,2058,149,141,290,"21 de agosto de 1994"
25,6,10,2059,135,108,243,"21 de agosto de 1994"
25,6,10,2060,185,167,352,"21 de agosto de 1994"
25,6,10,2061,255,235,490,"21 de agosto de 1994"
25,6,10,2062,197,188,385,"21 de agosto de 1994"
25,6,10,2063,218,183,401,"21 de agosto de 1994"
25,6,10,2064,196,182,378,"21 de agosto de 1994"
25,6,10,2065,151,140,291,"21 de agosto de 1994"
25,6,10,2066,252,247,499,"21 de agosto de 1994"
25,6,10,2067,274,282,556,"21 de agosto de 1994"
25,6,10,2068,264,285,549,"21 de agosto de 1994"
25,6,10,2069,135,138,273,"21 de agosto de 1994"
25,6,10,2070,153,141,294,"21 de agosto de 1994"
25,6,10,2071,104,78,182,"21 de agosto de 1994"
25,6,10,2072,175,167,342,"21 de agosto de 1994"
25,6,10,2073,217,209,426,"21 de agosto de 1994"
25,6,10,2074,221,231,452,"21 de agosto de 1994"
25,6,10,2075,190,195,385,"21 de agosto de 1994"
25,6,10,2076,171,167,338,"21 de agosto de 1994"
25,6,10,2077,198,164,362,"21 de agosto de 1994"
25,6,10,2078,157,127,284,"21 de agosto de 1994"
25,6,10,2079,117,89,206,"21 de agosto de 1994"
25,6,10,2080,98,83,181,"21 de agosto de 1994"
25,6,10,2081,91,77,168,"21 de agosto de 1994"
25,6,10,2082,226,221,447,"21 de agosto de 1994"
25,6,10,2083,135,126,261,"21 de agosto de 1994"
25,6,10,2084,112,99,211,"21 de agosto de 1994"
25,6,10,2085,162,162,324,"21 de agosto de 1994"
25,6,10,2086,215,185,400,"21 de agosto de 1994"
25,6,10,2087,160,136,296,"21 de agosto de 1994"
25,6,10,2088,174,187,361,"21 de agosto de 1994"
25,6,10,2089,190,171,361,"21 de agosto de 1994"
25,6,10,2090,175,151,326,"21 de agosto de 1994"
25,6,10,2091,129,108,237,"21 de agosto de 1994"
25,6,10,2092,200,190,390,"21 de agosto de 1994"
25,6,10,2093,147,123,270,"21 de agosto de 1994"
25,6,10,2094,144,126,270,"21 de agosto de 1994"
25,6,10,2095,376,325,701,"21 de agosto de 1994"
25,6,10,2096,354,308,662,"21 de agosto de 1994"
25,6,10,2097,239,194,433,"21 de agosto de 1994"
25,6,10,2098,220,225,445,"21 de agosto de 1994"
25,6,10,2099,417,382,799,"21 de agosto de 1994"
25,6,10,2100,296,264,560,"21 de agosto de 1994"
25,6,17,3420,173,180,353,"21 de agosto de 1994"
25,6,17,3421,140,147,287,"21 de agosto de 1994"
25,6,17,3422,191,203,394,"21 de agosto de 1994"
25,6,17,3423,268,267,535,"21 de agosto de 1994"
25,6,17,3424,104,122,226,"21 de agosto de 1994"
25,6,17,3425,118,137,255,"21 de agosto de 1994"
25,6,17,3426,30,18,48,"21 de agosto de 1994"
25,6,17,3427,41,25,66,"21 de agosto de 1994"
25,6,17,3428,29,20,49,"21 de agosto de 1994"
25,6,17,3429,32,22,54,"21 de agosto de 1994"
25,6,17,3430,83,42,125,"21 de agosto de 1994"
25,6,17,3431,122,99,221,"21 de agosto de 1994"
25,6,17,3432,144,105,249,"21 de agosto de 1994"
25,6,17,3433,174,112,286,"21 de agosto de 1994"
25,6,17,3434,75,65,140,"21 de agosto de 1994"
25,6,17,3435,157,119,276,"21 de agosto de 1994"
25,6,17,3436,251,147,398,"21 de agosto de 1994"
25,6,17,3437,67,46,113,"21 de agosto de 1994"
25,6,17,3438,63,26,89,"21 de agosto de 1994"
25,6,17,3439,164,116,280,"21 de agosto de 1994"
25,6,17,3440,37,18,55,"21 de agosto de 1994"
25,6,17,3441,56,31,87,"21 de agosto de 1994"
25,6,17,3442,92,51,143,"21 de agosto de 1994"
25,6,17,3443,161,106,267,"21 de agosto de 1994"
25,6,17,3444,113,87,200,"21 de agosto de 1994"
25,6,17,3445,86,41,127,"21 de agosto de 1994"
25,6,17,3446,182,139,321,"21 de agosto de 1994"
25,6,17,3447,134,112,246,"21 de agosto de 1994"
25,6,17,3448,61,36,97,"21 de agosto de 1994"
25,6,17,3449,54,37,91,"21 de agosto de 1994"
25,6,17,3450,108,94,202,"21 de agosto de 1994"
25,6,17,3451,268,276,544,"21 de agosto de 1994"
25,6,17,3452,192,144,336,"21 de agosto de 1994"
25,6,17,3453,66,56,122,"21 de agosto de 1994"
25,6,17,3454,59,43,102,"21 de agosto de 1994"
25,6,17,3455,154,109,263,"21 de agosto de 1994"
25,6,17,3456,133,128,261,"21 de agosto de 1994"
25,6,17,3457,43,27,70,"21 de agosto de 1994"
25,6,17,3458,65,40,105,"21 de agosto de 1994"
25,6,17,3459,128,74,202,"21 de agosto de 1994"
25,6,17,3460,32,19,51,"21 de agosto de 1994"
25,6,17,3461,182,120,302,"21 de agosto de 1994"
25,6,17,3462,44,24,68,"21 de agosto de 1994"
25,6,17,3463,29,19,48,"21 de agosto de 1994"
25,6,17,3464,101,82,183,"21 de agosto de 1994"
25,6,17,3465,77,59,136,"21 de agosto de 1994"
25,6,17,3466,105,62,167,"21 de agosto de 1994"
25,6,17,3467,65,36,101,"21 de agosto de 1994"
25,6,17,3468,110,75,185,"21 de agosto de 1994"
25,6,17,3469,226,136,362,"21 de agosto de 1994"
25,6,17,3470,212,182,394,"21 de agosto de 1994"
25,6,17,3471,199,149,348,"21 de agosto de 1994"
25,6,17,3472,93,75,168,"21 de agosto de 1994"
25,6,17,3473,147,125,272,"21 de agosto de 1994"
25,6,17,3474,141,132,273,"21 de agosto de 1994"
25,6,17,3475,82,53,135,"21 de agosto de 1994"
25,6,17,3476,154,97,251,"21 de agosto de 1994"
25,6,17,3477,40,27,67,"21 de agosto de 1994"
25,6,17,3478,250,233,483,"21 de agosto de 1994"
25,6,17,3479,79,75,154,"21 de agosto de 1994"
25,6,17,3480,213,184,397,"21 de agosto de 1994"
25,6,17,3481,239,201,440,"21 de agosto de 1994"
25,6,17,3482,187,156,343,"21 de agosto de 1994"
25,6,17,3483,169,163,332,"21 de agosto de 1994"
25,6,17,3484,169,120,289,"21 de agosto de 1994"
25,6,17,3485,90,69,159,"21 de agosto de 1994"
25,6,17,3486,129,84,213,"21 de agosto de 1994"
25,6,17,3487,77,77,154,"21 de agosto de 1994"
25,6,17,3488,162,173,335,"21 de agosto de 1994"
25,6,17,3489,111,86,197,"21 de agosto de 1994"
25,6,17,3490,165,184,349,"21 de agosto de 1994"
25,6,17,3491,157,121,278,"21 de agosto de 1994"
25,6,17,3492,73,55,128,"21 de agosto de 1994"
25,6,17,3493,120,81,201,"21 de agosto de 1994"
25,6,17,3494,74,74,148,"21 de agosto de 1994"
25,6,17,3495,41,31,72,"21 de agosto de 1994"
25,6,17,3496,81,58,139,"21 de agosto de 1994"
25,6,17,3497,106,121,227,"21 de agosto de 1994"
25,6,17,3498,66,61,127,"21 de agosto de 1994"
25,6,17,3499,73,56,129,"21 de agosto de 1994"
25,6,17,3500,45,40,85,"21 de agosto de 1994"
25,6,17,3501,196,158,354,"21 de agosto de 1994"
25,6,17,3502,160,145,305,"21 de agosto de 1994"
25,6,17,3503,152,145,297,"21 de agosto de 1994"
25,6,17,3504,58,39,97,"21 de agosto de 1994"
25,6,17,3505,52,41,93,"21 de agosto de 1994"
25,6,17,3506,101,73,174,"21 de agosto de 1994"
25,6,17,3507,55,41,96,"21 de agosto de 1994"
25,6,17,3508,247,199,446,"21 de agosto de 1994"
25,6,17,3509,66,54,120,"21 de agosto de 1994"
25,6,17,3510,147,118,265,"21 de agosto de 1994"
25,6,17,3511,197,193,390,"21 de agosto de 1994"
25,6,17,3512,111,98,209,"21 de agosto de 1994"
25,6,17,3513,51,61,112,"21 de agosto de 1994"
25,6,17,3514,49,36,85,"21 de agosto de 1994"
25,6,17,3515,226,222,448,"21 de agosto de 1994"
25,6,17,3516,128,115,243,"21 de agosto de 1994"
25,6,17,3517,102,94,196,"21 de agosto de 1994"
25,6,17,3518,280,266,546,"21 de agosto de 1994"
25,6,17,3519,208,210,418,"21 de agosto de 1994"
25,6,17,3520,186,197,383,"21 de agosto de 1994"
25,6,17,3521,164,164,328,"21 de agosto de 1994"
25,6,17,3522,81,71,152,"21 de agosto de 1994"
25,6,17,3523,96,96,192,"21 de agosto de 1994"
25,6,17,3524,145,147,292,"21 de agosto de 1994"
25,6,17,3525,198,177,375,"21 de agosto de 1994"
25,6,17,3526,164,182,346,"21 de agosto de 1994"
25,6,17,3527,209,222,431,"21 de agosto de 1994"
25,6,17,3528,144,122,266,"21 de agosto de 1994"
25,6,17,3529,85,82,167,"21 de agosto de 1994"
25,6,17,3530,76,57,133,"21 de agosto de 1994"
25,6,17,3531,37,27,64,"21 de agosto de 1994"
25,6,17,3532,168,149,317,"21 de agosto de 1994"
25,6,17,3533,93,73,166,"21 de agosto de 1994"
25,6,17,3534,148,141,289,"21 de agosto de 1994"
25,6,17,3535,67,63,130,"21 de agosto de 1994"
25,6,17,3536,131,132,263,"21 de agosto de 1994"
25,6,17,3537,105,112,217,"21 de agosto de 1994"
25,6,17,3538,126,131,257,"21 de agosto de 1994"
25,6,17,3539,104,102,206,"21 de agosto de 1994"
25,6,17,3540,135,122,257,"21 de agosto de 1994"
25,6,17,3541,100,86,186,"21 de agosto de 1994"
25,6,17,3542,81,77,158,"21 de agosto de 1994"
25,6,17,3543,84,64,148,"21 de agosto de 1994"
25,6,17,3544,107,81,188,"21 de agosto de 1994"
25,6,17,3545,81,62,143,"21 de agosto de 1994"
25,6,17,3546,151,127,278,"21 de agosto de 1994"
25,6,17,3547,63,57,120,"21 de agosto de 1994"
25,6,17,3548,78,61,139,"21 de agosto de 1994"
25,6,17,3549,122,104,226,"21 de agosto de 1994"
25,6,17,3550,88,63,151,"21 de agosto de 1994"
25,6,17,3551,109,113,222,"21 de agosto de 1994"
25,6,17,3552,149,146,295,"21 de agosto de 1994"
25,6,17,3553,103,99,202,"21 de agosto de 1994"
25,6,17,3554,99,93,192,"21 de agosto de 1994"
25,6,17,3555,62,50,112,"21 de agosto de 1994"
25,6,17,3556,76,56,132,"21 de agosto de 1994"
25,6,17,3557,108,99,207,"21 de agosto de 1994"
25,6,17,3558,93,72,165,"21 de agosto de 1994"
25,6,17,3559,165,140,305,"21 de agosto de 1994"
25,6,17,3560,97,66,163,"21 de agosto de 1994"
25,6,17,3561,66,41,107,"21 de agosto de 1994"
25,6,17,3562,144,135,279,"21 de agosto de 1994"
25,6,17,3563,99,88,187,"21 de agosto de 1994"
25,6,17,3564,139,112,251,"21 de agosto de 1994"
25,6,17,3565,243,226,469,"21 de agosto de 1994"
25,6,17,3566,188,197,385,"21 de agosto de 1994"
25,6,17,3567,83,73,156,"21 de agosto de 1994"
25,6,17,3568,120,153,273,"21 de agosto de 1994"
25,6,17,3569,98,92,190,"21 de agosto de 1994"
25,6,17,3570,104,131,235,"21 de agosto de 1994"
25,6,17,3571,152,134,286,"21 de agosto de 1994"
25,6,17,3572,270,260,530,"21 de agosto de 1994"
25,6,17,3573,90,77,167,"21 de agosto de 1994"
25,6,17,3574,46,48,94,"21 de agosto de 1994"
25,6,17,3575,99,67,166,"21 de agosto de 1994"
25,6,17,3576,197,193,390,"21 de agosto de 1994"
25,6,17,3577,214,181,395,"21 de agosto de 1994"
25,6,17,3578,189,191,380,"21 de agosto de 1994"
25,6,17,3579,164,133,297,"21 de agosto de 1994"
25,6,17,3580,177,165,342,"21 de agosto de 1994"
25,6,17,3581,66,79,145,"21 de agosto de 1994"
25,6,17,3582,182,180,362,"21 de agosto de 1994"
25,6,17,3583,143,146,289,"21 de agosto de 1994"
25,6,17,3584,214,184,398,"21 de agosto de 1994"
25,6,17,3585,85,61,146,"21 de agosto de 1994"
25,6,17,3586,125,110,235,"21 de agosto de 1994"
25,6,17,3587,234,227,461,"21 de agosto de 1994"
25,6,17,3588,107,100,207,"21 de agosto de 1994"
25,6,17,3589,99,85,184,"21 de agosto de 1994"
25,6,17,3590,303,294,597,"21 de agosto de 1994"
25,6,17,3591,190,196,386,"21 de agosto de 1994"
25,6,17,3592,166,149,315,"21 de agosto de 1994"
25,6,17,3593,170,175,345,"21 de agosto de 1994"
25,6,17,3594,220,197,417,"21 de agosto de 1994"
25,6,17,3595,208,187,395,"21 de agosto de 1994"
25,6,17,3596,71,75,146,"21 de agosto de 1994"
25,6,17,3597,60,69,129,"21 de agosto de 1994"
25,6,17,3598,130,115,245,"21 de agosto de 1994"
25,6,17,3599,98,79,177,"21 de agosto de 1994"
25,6,17,3600,135,141,276,"21 de agosto de 1994"
25,6,17,3601,84,69,153,"21 de agosto de 1994"
25,6,17,3602,52,50,102,"21 de agosto de 1994"
25,6,17,3603,134,105,239,"21 de agosto de 1994"
25,6,17,3604,43,27,70,"21 de agosto de 1994"
25,6,17,3605,150,126,276,"21 de agosto de 1994"
25,6,17,3606,85,61,146,"21 de agosto de 1994"
25,6,17,3607,174,146,320,"21 de agosto de 1994"
25,6,17,3608,193,189,382,"21 de agosto de 1994"
25,6,17,3609,167,147,314,"21 de agosto de 1994"
25,6,17,3610,241,232,473,"21 de agosto de 1994"
25,6,17,3611,193,181,374,"21 de agosto de 1994"
25,6,17,3612,95,92,187,"21 de agosto de 1994"
25,6,17,3613,110,91,201,"21 de agosto de 1994"
25,7,2,456,219,203,422,"21 de agosto de 1994"
25,7,2,457,165,158,323,"21 de agosto de 1994"
25,7,2,458,99,111,210,"21 de agosto de 1994"
25,7,2,459,140,144,284,"21 de agosto de 1994"
25,7,2,460,95,122,217,"21 de agosto de 1994"
25,7,2,461,159,151,310,"21 de agosto de 1994"
25,7,2,462,147,141,288,"21 de agosto de 1994"
25,7,2,463,111,127,238,"21 de agosto de 1994"
25,7,2,464,168,198,366,"21 de agosto de 1994"
25,7,2,465,213,178,391,"21 de agosto de 1994"
25,7,2,466,67,58,125,"21 de agosto de 1994"
25,7,2,467,87,92,179,"21 de agosto de 1994"
25,7,2,468,194,207,401,"21 de agosto de 1994"
25,7,2,469,49,51,100,"21 de agosto de 1994"
25,7,2,470,138,147,285,"21 de agosto de 1994"
25,7,2,471,131,131,262,"21 de agosto de 1994"
25,7,2,472,136,145,281,"21 de agosto de 1994"
25,7,2,473,102,99,201,"21 de agosto de 1994"
25,7,2,474,128,148,276,"21 de agosto de 1994"
25,7,2,475,108,121,229,"21 de agosto de 1994"
25,7,2,476,123,117,240,"21 de agosto de 1994"
25,7,2,477,136,132,268,"21 de agosto de 1994"
25,7,2,478,118,108,226,"21 de agosto de 1994"
25,7,2,479,86,66,152,"21 de agosto de 1994"
25,7,2,480,82,106,188,"21 de agosto de 1994"
25,7,2,481,57,56,113,"21 de agosto de 1994"
25,7,2,482,116,106,222,"21 de agosto de 1994"
25,7,2,483,132,119,251,"21 de agosto de 1994"
25,7,2,484,112,100,212,"21 de agosto de 1994"
25,7,2,485,140,141,281,"21 de agosto de 1994"
25,7,2,486,179,168,347,"21 de agosto de 1994"
25,7,2,487,241,227,468,"21 de agosto de 1994"
25,7,2,488,101,92,193,"21 de agosto de 1994"
25,7,2,489,87,81,168,"21 de agosto de 1994"
25,7,2,490,109,118,227,"21 de agosto de 1994"
25,7,2,491,149,119,268,"21 de agosto de 1994"
25,7,2,492,218,214,432,"21 de agosto de 1994"
25,7,2,493,40,44,84,"21 de agosto de 1994"
25,7,2,494,94,75,169,"21 de agosto de 1994"
25,7,2,495,193,169,362,"21 de agosto de 1994"
25,7,2,496,75,89,164,"21 de agosto de 1994"
25,7,2,497,39,42,81,"21 de agosto de 1994"
25,7,2,498,61,44,105,"21 de agosto de 1994"
25,7,2,499,112,108,220,"21 de agosto de 1994"
25,7,2,500,181,157,338,"21 de agosto de 1994"
25,7,2,501,82,81,163,"21 de agosto de 1994"
25,7,2,502,161,155,316,"21 de agosto de 1994"
25,7,2,503,66,58,124,"21 de agosto de 1994"
25,7,2,504,134,138,272,"21 de agosto de 1994"
25,7,2,505,66,58,124,"21 de agosto de 1994"
25,7,2,506,112,109,221,"21 de agosto de 1994"
25,7,2,507,164,183,347,"21 de agosto de 1994"
25,7,2,508,59,59,118,"21 de agosto de 1994"
25,7,2,509,177,149,326,"21 de agosto de 1994"
25,7,2,510,109,92,201,"21 de agosto de 1994"
25,7,2,511,105,91,196,"21 de agosto de 1994"
25,7,2,512,84,58,142,"21 de agosto de 1994"
25,7,2,513,91,89,180,"21 de agosto de 1994"
25,7,2,514,91,88,179,"21 de agosto de 1994"
25,7,2,515,167,149,316,"21 de agosto de 1994"
25,7,2,516,27,15,42,"21 de agosto de 1994"
25,7,2,517,141,149,290,"21 de agosto de 1994"
25,7,2,518,122,129,251,"21 de agosto de 1994"
25,7,2,519,160,141,301,"21 de agosto de 1994"
25,7,2,520,172,169,341,"21 de agosto de 1994"
25,7,2,521,159,144,303,"21 de agosto de 1994"
25,7,2,522,137,130,267,"21 de agosto de 1994"
25,7,2,523,85,86,171,"21 de agosto de 1994"
25,7,2,524,118,101,219,"21 de agosto de 1994"
25,7,2,525,292,279,571,"21 de agosto de 1994"
25,7,2,526,255,214,469,"21 de agosto de 1994"
25,7,2,527,137,115,252,"21 de agosto de 1994"
25,7,2,528,38,38,76,"21 de agosto de 1994"
25,7,2,529,57,57,114,"21 de agosto de 1994"
25,7,2,530,169,157,326,"21 de agosto de 1994"
25,7,2,531,84,65,149,"21 de agosto de 1994"
25,7,2,532,178,144,322,"21 de agosto de 1994"
25,7,2,533,76,88,164,"21 de agosto de 1994"
25,7,2,534,62,66,128,"21 de agosto de 1994"
25,7,2,535,93,80,173,"21 de agosto de 1994"
25,7,2,536,87,79,166,"21 de agosto de 1994"
25,7,2,537,116,114,230,"21 de agosto de 1994"
25,7,2,538,98,90,188,"21 de agosto de 1994"
25,7,2,539,459,386,845,"21 de agosto de 1994"
25,7,2,540,216,217,433,"21 de agosto de 1994"
25,7,2,541,140,151,291,"21 de agosto de 1994"
25,7,2,542,198,188,386,"21 de agosto de 1994"
25,7,2,543,143,143,286,"21 de agosto de 1994"
25,7,2,544,119,130,249,"21 de agosto de 1994"
25,7,2,545,68,66,134,"21 de agosto de 1994"
25,7,2,546,90,78,168,"21 de agosto de 1994"
25,7,2,547,223,210,433,"21 de agosto de 1994"
25,7,2,548,112,110,222,"21 de agosto de 1994"
25,7,2,549,201,203,404,"21 de agosto de 1994"
25,7,2,550,167,167,334,"21 de agosto de 1994"
25,7,2,551,131,127,258,"21 de agosto de 1994"
25,7,2,552,120,123,243,"21 de agosto de 1994"
25,7,2,553,85,87,172,"21 de agosto de 1994"
25,7,2,554,94,101,195,"21 de agosto de 1994"
25,7,2,555,109,106,215,"21 de agosto de 1994"
25,7,2,556,88,94,182,"21 de agosto de 1994"
25,7,2,557,112,100,212,"21 de agosto de 1994"
25,7,2,558,120,110,230,"21 de agosto de 1994"
25,7,2,559,79,84,163,"21 de agosto de 1994"
25,7,2,560,82,62,144,"21 de agosto de 1994"
25,7,2,561,71,85,156,"21 de agosto de 1994"
25,7,2,562,110,115,225,"21 de agosto de 1994"
25,7,3,563,192,158,350,"21 de agosto de 1994"
25,7,3,564,158,135,293,"21 de agosto de 1994"
25,7,3,565,215,198,413,"21 de agosto de 1994"
25,7,3,566,132,142,274,"21 de agosto de 1994"
25,7,3,567,83,77,160,"21 de agosto de 1994"
25,7,3,568,294,257,551,"21 de agosto de 1994"
25,7,3,569,197,152,349,"21 de agosto de 1994"
25,7,3,570,154,115,269,"21 de agosto de 1994"
25,7,3,571,165,99,264,"21 de agosto de 1994"
25,7,3,572,325,227,552,"21 de agosto de 1994"
25,7,3,573,237,158,395,"21 de agosto de 1994"
25,7,3,574,387,301,688,"21 de agosto de 1994"
25,7,3,575,363,302,665,"21 de agosto de 1994"
25,7,3,576,149,109,258,"21 de agosto de 1994"
25,7,3,577,258,229,487,"21 de agosto de 1994"
25,7,3,578,43,48,91,"21 de agosto de 1994"
25,7,3,579,153,131,284,"21 de agosto de 1994"
25,7,3,580,84,75,159,"21 de agosto de 1994"
25,7,3,581,57,43,100,"21 de agosto de 1994"
25,7,3,582,103,85,188,"21 de agosto de 1994"
25,7,3,583,61,55,116,"21 de agosto de 1994"
25,7,3,584,89,69,158,"21 de agosto de 1994"
25,7,3,585,262,216,478,"21 de agosto de 1994"
25,7,3,586,81,66,147,"21 de agosto de 1994"
25,7,3,587,170,156,326,"21 de agosto de 1994"
25,7,3,588,88,51,139,"21 de agosto de 1994"
25,7,3,589,73,57,130,"21 de agosto de 1994"
25,7,3,590,252,203,455,"21 de agosto de 1994"
25,7,3,591,34,30,64,"21 de agosto de 1994"
25,7,3,592,87,76,163,"21 de agosto de 1994"
25,7,3,593,184,143,327,"21 de agosto de 1994"
25,7,3,594,185,168,353,"21 de agosto de 1994"
25,7,3,595,83,74,157,"21 de agosto de 1994"
25,7,3,596,75,72,147,"21 de agosto de 1994"
25,7,3,597,73,65,138,"21 de agosto de 1994"
25,7,3,598,125,87,212,"21 de agosto de 1994"
25,7,3,599,60,42,102,"21 de agosto de 1994"
25,7,3,600,105,73,178,"21 de agosto de 1994"
25,7,3,601,244,165,409,"21 de agosto de 1994"
25,7,3,602,40,27,67,"21 de agosto de 1994"
25,7,3,603,117,103,220,"21 de agosto de 1994"
25,7,3,604,109,105,214,"21 de agosto de 1994"
25,7,3,605,97,79,176,"21 de agosto de 1994"
25,7,3,606,35,30,65,"21 de agosto de 1994"
25,7,3,607,146,108,254,"21 de agosto de 1994"
25,7,3,608,69,47,116,"21 de agosto de 1994"
25,7,3,609,75,58,133,"21 de agosto de 1994"
25,7,3,610,74,61,135,"21 de agosto de 1994"
25,7,3,611,51,22,73,"21 de agosto de 1994"
25,7,3,612,61,50,111,"21 de agosto de 1994"
25,7,3,613,79,70,149,"21 de agosto de 1994"
25,7,3,614,118,103,221,"21 de agosto de 1994"
25,7,3,615,58,48,106,"21 de agosto de 1994"
25,7,3,616,106,100,206,"21 de agosto de 1994"
25,7,3,617,147,143,290,"21 de agosto de 1994"
25,7,3,618,129,74,203,"21 de agosto de 1994"
25,7,3,619,158,92,250,"21 de agosto de 1994"
25,7,3,620,132,89,221,"21 de agosto de 1994"
25,7,3,621,180,144,324,"21 de agosto de 1994"
25,7,3,622,113,81,194,"21 de agosto de 1994"
25,7,3,623,68,59,127,"21 de agosto de 1994"
25,7,3,624,42,42,84,"21 de agosto de 1994"
25,7,3,625,116,101,217,"21 de agosto de 1994"
25,7,3,626,40,39,79,"21 de agosto de 1994"
25,7,3,627,72,53,125,"21 de agosto de 1994"
25,7,3,628,116,107,223,"21 de agosto de 1994"
25,7,13,2997,164,164,328,"21 de agosto de 1994"
25,7,13,2998,53,55,108,"21 de agosto de 1994"
25,7,13,2999,128,116,244,"21 de agosto de 1994"
25,7,13,3000,72,92,164,"21 de agosto de 1994"
25,7,13,3001,65,83,148,"21 de agosto de 1994"
25,7,13,3002,79,80,159,"21 de agosto de 1994"
25,7,13,3003,61,77,138,"21 de agosto de 1994"
25,7,13,3004,79,93,172,"21 de agosto de 1994"
25,7,13,3005,165,215,380,"21 de agosto de 1994"
25,7,13,3006,124,133,257,"21 de agosto de 1994"
25,7,13,3007,160,183,343,"21 de agosto de 1994"
25,7,13,3008,148,138,286,"21 de agosto de 1994"
25,7,13,3009,108,122,230,"21 de agosto de 1994"
25,7,13,3010,74,57,131,"21 de agosto de 1994"
25,7,13,3011,45,33,78,"21 de agosto de 1994"
25,7,13,3012,52,40,92,"21 de agosto de 1994"
25,7,13,3013,42,27,69,"21 de agosto de 1994"
25,7,13,3014,201,173,374,"21 de agosto de 1994"
25,7,13,3015,187,151,338,"21 de agosto de 1994"
25,7,13,3016,64,41,105,"21 de agosto de 1994"
25,7,13,3017,95,77,172,"21 de agosto de 1994"
25,7,13,3018,86,49,135,"21 de agosto de 1994"
25,7,13,3019,40,27,67,"21 de agosto de 1994"
25,7,13,3020,59,44,103,"21 de agosto de 1994"
25,7,13,3021,62,44,106,"21 de agosto de 1994"
25,7,13,3022,96,77,173,"21 de agosto de 1994"
25,7,13,3023,66,59,125,"21 de agosto de 1994"
25,7,13,3024,93,68,161,"21 de agosto de 1994"
25,7,13,3025,96,77,173,"21 de agosto de 1994"
25,7,13,3026,93,89,182,"21 de agosto de 1994"
25,7,13,3027,199,171,370,"21 de agosto de 1994"
25,7,13,3028,87,78,165,"21 de agosto de 1994"
25,7,13,3029,117,109,226,"21 de agosto de 1994"
25,7,13,3030,38,31,69,"21 de agosto de 1994"
25,7,13,3031,100,85,185,"21 de agosto de 1994"
25,7,13,3032,103,56,159,"21 de agosto de 1994"
25,7,13,3033,38,24,62,"21 de agosto de 1994"
25,7,13,3034,96,62,158,"21 de agosto de 1994"
25,7,13,3035,151,114,265,"21 de agosto de 1994"
25,7,13,3036,109,68,177,"21 de agosto de 1994"
25,7,13,3037,44,36,80,"21 de agosto de 1994"
25,7,13,3038,39,17,56,"21 de agosto de 1994"
25,7,13,3039,79,56,135,"21 de agosto de 1994"
25,7,13,3040,74,64,138,"21 de agosto de 1994"
25,7,13,3041,83,68,151,"21 de agosto de 1994"
25,7,13,3042,211,193,404,"21 de agosto de 1994"
25,7,13,3043,80,72,152,"21 de agosto de 1994"
25,7,13,3044,28,21,49,"21 de agosto de 1994"
25,7,13,3045,68,40,108,"21 de agosto de 1994"
25,7,13,3046,322,211,533,"21 de agosto de 1994"
25,7,13,3047,115,97,212,"21 de agosto de 1994"
25,7,13,3048,53,45,98,"21 de agosto de 1994"
25,7,13,3049,40,31,71,"21 de agosto de 1994"
25,7,13,3050,54,40,94,"21 de agosto de 1994"
25,7,13,3051,152,112,264,"21 de agosto de 1994"
25,7,13,3052,153,169,322,"21 de agosto de 1994"
25,7,13,3053,147,134,281,"21 de agosto de 1994"
25,7,13,3054,110,104,214,"21 de agosto de 1994"
25,7,13,3055,176,154,330,"21 de agosto de 1994"
25,7,13,3056,38,41,79,"21 de agosto de 1994"
25,7,13,3057,68,55,123,"21 de agosto de 1994"
25,7,13,3058,77,77,154,"21 de agosto de 1994"
25,7,13,3059,81,75,156,"21 de agosto de 1994"
25,7,13,3060,123,98,221,"21 de agosto de 1994"
25,7,13,3061,150,103,253,"21 de agosto de 1994"
25,7,13,3062,35,17,52,"21 de agosto de 1994"
25,7,13,3063,71,57,128,"21 de agosto de 1994"
25,7,13,3064,30,31,61,"21 de agosto de 1994"
25,7,13,3065,166,152,318,"21 de agosto de 1994"
25,7,13,3066,105,103,208,"21 de agosto de 1994"
25,7,13,3067,110,103,213,"21 de agosto de 1994"
25,7,13,3068,77,73,150,"21 de agosto de 1994"
25,7,13,3069,68,64,132,"21 de agosto de 1994"
25,7,13,3070,87,88,175,"21 de agosto de 1994"
25,7,13,3071,57,55,112,"21 de agosto de 1994"
25,7,13,3072,94,111,205,"21 de agosto de 1994"
25,7,13,3073,52,67,119,"21 de agosto de 1994"
25,7,13,3074,70,68,138,"21 de agosto de 1994"
25,7,13,3075,135,105,240,"21 de agosto de 1994"
25,7,13,3076,66,63,129,"21 de agosto de 1994"
25,7,13,3077,59,35,94,"21 de agosto de 1994"
25,7,13,3078,31,36,67,"21 de agosto de 1994"
25,7,13,3079,83,78,161,"21 de agosto de 1994"
25,7,13,3080,50,48,98,"21 de agosto de 1994"
25,7,13,3081,66,49,115,"21 de agosto de 1994"
25,7,13,3082,107,63,170,"21 de agosto de 1994"
25,7,13,3083,87,81,168,"21 de agosto de 1994"
25,7,13,3084,120,104,224,"21 de agosto de 1994"
25,7,13,3085,90,57,147,"21 de agosto de 1994"
25,7,13,3086,176,144,320,"21 de agosto de 1994"
25,7,13,3087,248,207,455,"21 de agosto de 1994"
25,7,13,3088,72,56,128,"21 de agosto de 1994"
25,7,13,3089,81,72,153,"21 de agosto de 1994"
25,7,13,3090,142,135,277,"21 de agosto de 1994"
25,7,13,3091,135,103,238,"21 de agosto de 1994"
25,7,13,3092,248,203,451,"21 de agosto de 1994"
25,7,13,3093,88,57,145,"21 de agosto de 1994"
25,7,13,3094,130,78,208,"21 de agosto de 1994"
25,7,13,3095,85,72,157,"21 de agosto de 1994"
25,7,13,3096,345,340,685,"21 de agosto de 1994"
25,7,13,3097,168,163,331,"21 de agosto de 1994"
25,7,13,3098,158,172,330,"21 de agosto de 1994"
25,7,13,3099,59,58,117,"21 de agosto de 1994"
25,7,13,3100,84,100,184,"21 de agosto de 1994"
25,7,13,3101,204,175,379,"21 de agosto de 1994"
25,7,13,3102,102,122,224,"21 de agosto de 1994"
25,7,13,3103,106,91,197,"21 de agosto de 1994"
25,7,13,3104,87,95,182,"21 de agosto de 1994"
25,7,13,3105,172,183,355,"21 de agosto de 1994"
25,7,13,3106,150,143,293,"21 de agosto de 1994"
25,7,13,3107,121,96,217,"21 de agosto de 1994"
25,7,13,3108,104,96,200,"21 de agosto de 1994"
25,7,13,3109,118,90,208,"21 de agosto de 1994"
25,7,13,3110,80,50,130,"21 de agosto de 1994"
25,7,13,3111,173,158,331,"21 de agosto de 1994"
25,7,13,3112,46,36,82,"21 de agosto de 1994"
25,7,13,3113,145,126,271,"21 de agosto de 1994"
25,7,13,3114,178,182,360,"21 de agosto de 1994"
25,7,13,3115,281,271,552,"21 de agosto de 1994"
25,7,13,3116,106,73,179,"21 de agosto de 1994"
25,7,13,3117,55,39,94,"21 de agosto de 1994"
25,7,13,3118,92,74,166,"21 de agosto de 1994"
25,7,13,3119,75,57,132,"21 de agosto de 1994"
25,7,13,3120,158,108,266,"21 de agosto de 1994"
25,7,13,3121,157,126,283,"21 de agosto de 1994"
25,7,13,3122,188,177,365,"21 de agosto de 1994"
25,7,13,3123,123,112,235,"21 de agosto de 1994"
25,7,13,3124,144,141,285,"21 de agosto de 1994"
25,7,13,3125,109,92,201,"21 de agosto de 1994"
25,7,13,3126,261,246,507,"21 de agosto de 1994"
25,7,13,3127,96,92,188,"21 de agosto de 1994"
25,7,13,3128,215,195,410,"21 de agosto de 1994"
25,7,13,3129,134,121,255,"21 de agosto de 1994"
25,7,13,3130,141,106,247,"21 de agosto de 1994"
25,7,15,3220,242,250,492,"21 de agosto de 1994"
25,7,15,3221,188,186,374,"21 de agosto de 1994"
25,7,15,3222,247,246,493,"21 de agosto de 1994"
25,7,15,3223,102,125,227,"21 de agosto de 1994"
25,7,15,3224,253,305,558,"21 de agosto de 1994"
25,7,15,3225,113,135,248,"21 de agosto de 1994"
25,7,15,3226,183,173,356,"21 de agosto de 1994"
25,7,15,3227,165,195,360,"21 de agosto de 1994"
25,7,15,3228,184,193,377,"21 de agosto de 1994"
25,7,15,3229,125,154,279,"21 de agosto de 1994"
25,7,15,3230,81,94,175,"21 de agosto de 1994"
25,7,15,3231,63,69,132,"21 de agosto de 1994"
25,7,15,3232,49,64,113,"21 de agosto de 1994"
25,7,15,3233,163,166,329,"21 de agosto de 1994"
25,7,15,3234,138,146,284,"21 de agosto de 1994"
25,7,15,3235,179,160,339,"21 de agosto de 1994"
25,7,15,3236,82,111,193,"21 de agosto de 1994"
25,7,15,3237,484,69,553,"21 de agosto de 1994"
25,7,15,3238,149,172,321,"21 de agosto de 1994"
25,7,15,3239,115,130,245,"21 de agosto de 1994"
25,7,15,3240,81,93,174,"21 de agosto de 1994"
25,7,15,3241,152,135,287,"21 de agosto de 1994"
25,7,15,3242,141,139,280,"21 de agosto de 1994"
25,7,15,3243,65,72,137,"21 de agosto de 1994"
25,7,15,3244,69,75,144,"21 de agosto de 1994"
25,7,15,3245,121,118,239,"21 de agosto de 1994"
25,7,15,3246,114,128,242,"21 de agosto de 1994"
25,7,15,3247,166,179,345,"21 de agosto de 1994"
25,7,15,3248,107,122,229,"21 de agosto de 1994"
25,7,15,3249,119,129,248,"21 de agosto de 1994"
25,7,15,3250,117,143,260,"21 de agosto de 1994"
25,7,15,3251,47,63,110,"21 de agosto de 1994"
25,7,15,3252,93,98,191,"21 de agosto de 1994"
25,7,15,3253,112,134,246,"21 de agosto de 1994"
25,7,15,3254,92,111,203,"21 de agosto de 1994"
25,7,15,3255,77,90,167,"21 de agosto de 1994"
25,7,15,3256,83,78,161,"21 de agosto de 1994"
25,7,15,3257,104,116,220,"21 de agosto de 1994"
25,7,15,3258,144,168,312,"21 de agosto de 1994"
25,7,15,3259,79,91,170,"21 de agosto de 1994"
25,7,15,3260,56,64,120,"21 de agosto de 1994"
25,7,15,3261,40,57,97,"21 de agosto de 1994"
25,7,15,3262,62,76,138,"21 de agosto de 1994"
25,7,15,3263,72,71,143,"21 de agosto de 1994"
25,7,15,3264,51,48,99,"21 de agosto de 1994"
25,7,15,3265,83,80,163,"21 de agosto de 1994"
25,7,15,3266,36,56,92,"21 de agosto de 1994"
25,7,15,3267,57,83,140,"21 de agosto de 1994"
25,7,15,3268,151,180,331,"21 de agosto de 1994"
25,7,15,3269,98,124,222,"21 de agosto de 1994"
25,7,15,3270,81,101,182,"21 de agosto de 1994"
25,7,15,3271,102,117,219,"21 de agosto de 1994"
25,7,15,3272,154,176,330,"21 de agosto de 1994"
25,7,15,3273,253,296,549,"21 de agosto de 1994"
25,7,15,3274,177,187,364,"21 de agosto de 1994"
25,7,15,3275,208,260,468,"21 de agosto de 1994"
25,7,15,3276,154,174,328,"21 de agosto de 1994"
25,7,15,3277,158,182,340,"21 de agosto de 1994"
25,7,15,3278,112,125,237,"21 de agosto de 1994"
25,7,15,3279,153,177,330,"21 de agosto de 1994"
25,7,15,3280,150,166,316,"21 de agosto de 1994"
25,7,15,3281,174,192,366,"21 de agosto de 1994"
25,7,15,3282,111,166,277,"21 de agosto de 1994"
25,7,15,3283,143,159,302,"21 de agosto de 1994"
25,7,15,3284,234,270,504,"21 de agosto de 1994"
25,7,15,3285,194,211,405,"21 de agosto de 1994"
25,7,15,3286,144,159,303,"21 de agosto de 1994"
25,7,15,3287,88,97,185,"21 de agosto de 1994"
25,7,15,3288,123,134,257,"21 de agosto de 1994"
25,7,15,3289,69,88,157,"21 de agosto de 1994"
25,7,15,3290,79,95,174,"21 de agosto de 1994"
25,7,15,3291,92,111,203,"21 de agosto de 1994"
25,7,15,3292,105,100,205,"21 de agosto de 1994"
25,7,15,3293,101,125,226,"21 de agosto de 1994"
25,7,15,3294,103,118,221,"21 de agosto de 1994"
25,7,15,3295,118,124,242,"21 de agosto de 1994"
25,7,15,3296,83,84,167,"21 de agosto de 1994"
25,7,15,3297,98,105,203,"21 de agosto de 1994"
25,7,15,3298,150,142,292,"21 de agosto de 1994"
25,7,15,3299,119,127,246,"21 de agosto de 1994"
25,7,15,3300,96,114,210,"21 de agosto de 1994"
25,7,15,3301,108,123,231,"21 de agosto de 1994"
25,7,15,3302,109,139,248,"21 de agosto de 1994"
25,7,15,3303,82,102,184,"21 de agosto de 1994"
25,7,15,3304,177,221,398,"21 de agosto de 1994"
25,7,15,3305,128,152,280,"21 de agosto de 1994"
25,7,15,3306,209,249,458,"21 de agosto de 1994"
25,7,15,3307,143,153,296,"21 de agosto de 1994"
25,7,15,3308,139,154,293,"21 de agosto de 1994"
25,7,15,3309,153,152,305,"21 de agosto de 1994"
25,7,15,3310,109,145,254,"21 de agosto de 1994"
25,7,15,3311,137,145,282,"21 de agosto de 1994"
25,7,15,3312,89,89,178,"21 de agosto de 1994"
25,7,15,3313,131,141,272,"21 de agosto de 1994"
25,7,15,3314,130,129,259,"21 de agosto de 1994"
25,7,15,3315,129,135,264,"21 de agosto de 1994"
25,7,15,3316,155,166,321,"21 de agosto de 1994"
25,7,15,3317,112,140,252,"21 de agosto de 1994"
25,7,15,3318,125,138,263,"21 de agosto de 1994"
25,7,15,3319,103,150,253,"21 de agosto de 1994"
25,7,15,3320,248,285,533,"21 de agosto de 1994"
25,7,15,3321,147,175,322,"21 de agosto de 1994"
25,7,15,3322,144,149,293,"21 de agosto de 1994"
25,7,15,3323,143,205,348,"21 de agosto de 1994"
25,7,15,3324,48,68,116,"21 de agosto de 1994"
25,7,15,3325,77,71,148,"21 de agosto de 1994"
25,7,15,3326,58,53,111,"21 de agosto de 1994"
25,7,15,3327,125,106,231,"21 de agosto de 1994"
25,7,15,3328,113,90,203,"21 de agosto de 1994"
25,7,15,3329,112,89,201,"21 de agosto de 1994"
25,7,15,3330,77,63,140,"21 de agosto de 1994"
25,7,15,3331,83,67,150,"21 de agosto de 1994"
25,7,15,3332,91,79,170,"21 de agosto de 1994"
25,7,15,3333,72,93,165,"21 de agosto de 1994"
25,7,15,3334,93,76,169,"21 de agosto de 1994"
25,7,15,3335,63,77,140,"21 de agosto de 1994"
25,7,15,3336,189,205,394,"21 de agosto de 1994"
25,7,15,3337,204,215,419,"21 de agosto de 1994"
25,7,15,3338,105,100,205,"21 de agosto de 1994"
25,7,15,3339,82,98,180,"21 de agosto de 1994"
25,7,15,3340,125,130,255,"21 de agosto de 1994"
25,7,15,3341,103,113,216,"21 de agosto de 1994"
25,7,15,3342,86,99,185,"21 de agosto de 1994"
25,7,15,3343,89,102,191,"21 de agosto de 1994"
25,7,15,3344,75,82,157,"21 de agosto de 1994"
25,7,15,3345,107,96,203,"21 de agosto de 1994"
25,7,15,3346,93,89,182,"21 de agosto de 1994"
25,7,15,3347,86,75,161,"21 de agosto de 1994"
25,7,15,3348,102,95,197,"21 de agosto de 1994"
25,7,15,3349,144,151,295,"21 de agosto de 1994"
25,7,15,3350,229,211,440,"21 de agosto de 1994"
25,7,15,3351,83,88,171,"21 de agosto de 1994"
25,7,15,3352,164,135,299,"21 de agosto de 1994"
25,7,15,3353,143,118,261,"21 de agosto de 1994"
25,7,15,3354,105,84,189,"21 de agosto de 1994"
25,7,15,3355,152,163,315,"21 de agosto de 1994"
25,7,15,3356,129,122,251,"21 de agosto de 1994"
25,7,15,3357,146,125,271,"21 de agosto de 1994"
25,7,15,3358,189,167,356,"21 de agosto de 1994"
25,7,15,3359,94,80,174,"21 de agosto de 1994"
25,7,15,3360,142,108,250,"21 de agosto de 1994"
25,7,15,3361,63,58,121,"21 de agosto de 1994"
25,7,15,3362,108,97,205,"21 de agosto de 1994"
25,7,15,3363,71,68,139,"21 de agosto de 1994"
25,7,15,3364,48,51,99,"21 de agosto de 1994"
25,7,15,3365,77,63,140,"21 de agosto de 1994"
25,7,15,3366,89,73,162,"21 de agosto de 1994"
25,7,15,3367,108,86,194,"21 de agosto de 1994"
25,7,15,3368,71,57,128,"21 de agosto de 1994"
25,7,15,3369,40,42,82,"21 de agosto de 1994"
25,8,6,990,170,177,347,"21 de agosto de 1994"
25,8,6,991,152,168,320,"21 de agosto de 1994"
25,8,6,992,211,183,394,"21 de agosto de 1994"
25,8,6,993,229,262,491,"21 de agosto de 1994"
25,8,6,994,197,222,419,"21 de agosto de 1994"
25,8,6,995,189,201,390,"21 de agosto de 1994"
25,8,6,996,153,167,320,"21 de agosto de 1994"
25,8,6,997,165,178,343,"21 de agosto de 1994"
25,8,6,998,92,110,202,"21 de agosto de 1994"
25,8,6,999,174,147,321,"21 de agosto de 1994"
25,8,6,1000,189,209,398,"21 de agosto de 1994"
25,8,6,1001,170,175,345,"21 de agosto de 1994"
25,8,6,1002,153,186,339,"21 de agosto de 1994"
25,8,6,1003,165,184,349,"21 de agosto de 1994"
25,8,6,1004,183,218,401,"21 de agosto de 1994"
25,8,6,1005,105,116,221,"21 de agosto de 1994"
25,8,6,1006,213,217,430,"21 de agosto de 1994"
25,8,6,1007,134,176,310,"21 de agosto de 1994"
25,8,6,1008,152,182,334,"21 de agosto de 1994"
25,8,6,1009,147,200,347,"21 de agosto de 1994"
25,8,6,1010,187,251,438,"21 de agosto de 1994"
25,8,6,1011,148,161,309,"21 de agosto de 1994"
25,8,6,1012,156,199,355,"21 de agosto de 1994"
25,8,6,1013,163,171,334,"21 de agosto de 1994"
25,8,6,1014,95,101,196,"21 de agosto de 1994"
25,8,6,1015,112,151,263,"21 de agosto de 1994"
25,8,6,1016,108,132,240,"21 de agosto de 1994"
25,8,6,1017,196,242,438,"21 de agosto de 1994"
25,8,6,1018,88,90,178,"21 de agosto de 1994"
25,8,6,1019,171,199,370,"21 de agosto de 1994"
25,8,6,1020,130,162,292,"21 de agosto de 1994"
25,8,6,1021,80,89,169,"21 de agosto de 1994"
25,8,6,1022,121,125,246,"21 de agosto de 1994"
25,8,6,1023,107,126,233,"21 de agosto de 1994"
25,8,6,1024,126,168,294,"21 de agosto de 1994"
25,8,6,1025,142,195,337,"21 de agosto de 1994"
25,8,6,1026,122,157,279,"21 de agosto de 1994"
25,8,6,1027,117,147,264,"21 de agosto de 1994"
25,8,6,1028,99,108,207,"21 de agosto de 1994"
25,8,6,1029,90,94,184,"21 de agosto de 1994"
25,8,6,1030,222,274,496,"21 de agosto de 1994"
25,8,6,1031,105,110,215,"21 de agosto de 1994"
25,8,6,1032,134,173,307,"21 de agosto de 1994"
25,8,6,1033,111,108,219,"21 de agosto de 1994"
25,8,6,1034,182,190,372,"21 de agosto de 1994"
25,8,6,1035,163,189,352,"21 de agosto de 1994"
25,8,6,1036,77,101,178,"21 de agosto de 1994"
25,8,6,1037,141,171,312,"21 de agosto de 1994"
25,8,6,1038,152,185,337,"21 de agosto de 1994"
25,8,6,1039,178,208,386,"21 de agosto de 1994"
25,8,6,1040,157,188,345,"21 de agosto de 1994"
25,8,6,1041,171,217,388,"21 de agosto de 1994"
25,8,6,1042,249,268,517,"21 de agosto de 1994"
25,8,6,1043,241,316,557,"21 de agosto de 1994"
25,8,6,1044,74,109,183,"21 de agosto de 1994"
25,8,6,1045,195,227,422,"21 de agosto de 1994"
25,8,6,1046,181,223,404,"21 de agosto de 1994"
25,8,6,1047,120,131,251,"21 de agosto de 1994"
25,8,6,1048,131,145,276,"21 de agosto de 1994"
25,8,6,1049,235,294,529,"21 de agosto de 1994"
25,8,6,1050,133,171,304,"21 de agosto de 1994"
25,8,6,1051,137,151,288,"21 de agosto de 1994"
25,8,6,1052,165,199,364,"21 de agosto de 1994"
25,8,6,1053,141,203,344,"21 de agosto de 1994"
25,8,6,1054,117,116,233,"21 de agosto de 1994"
25,8,6,1055,145,173,318,"21 de agosto de 1994"
25,8,6,1056,141,162,303,"21 de agosto de 1994"
25,8,6,1057,163,177,340,"21 de agosto de 1994"
25,8,6,1058,221,265,486,"21 de agosto de 1994"
25,8,6,1059,148,164,312,"21 de agosto de 1994"
25,8,6,1060,102,136,238,"21 de agosto de 1994"
25,8,6,1061,121,153,274,"21 de agosto de 1994"
25,8,6,1062,181,203,384,"21 de agosto de 1994"
25,8,6,1063,109,115,224,"21 de agosto de 1994"
25,8,6,1064,178,202,380,"21 de agosto de 1994"
25,8,6,1065,134,133,267,"21 de agosto de 1994"
25,8,6,1066,141,168,309,"21 de agosto de 1994"
25,8,6,1067,155,147,302,"21 de agosto de 1994"
25,8,6,1068,110,128,238,"21 de agosto de 1994"
25,8,6,1069,140,174,314,"21 de agosto de 1994"
25,8,6,1070,150,173,323,"21 de agosto de 1994"
25,8,6,1071,105,119,224,"21 de agosto de 1994"
25,8,6,1072,151,160,311,"21 de agosto de 1994"
25,8,6,1073,217,232,449,"21 de agosto de 1994"
25,8,6,1074,118,150,268,"21 de agosto de 1994"
25,8,6,1075,106,150,256,"21 de agosto de 1994"
25,8,6,1076,246,310,556,"21 de agosto de 1994"
25,8,6,1077,136,162,298,"21 de agosto de 1994"
25,8,6,1078,222,265,487,"21 de agosto de 1994"
25,8,6,1079,207,248,455,"21 de agosto de 1994"
25,8,6,1080,108,119,227,"21 de agosto de 1994"
25,8,6,1081,209,245,454,"21 de agosto de 1994"
25,8,6,1082,147,179,326,"21 de agosto de 1994"
25,8,6,1083,108,165,273,"21 de agosto de 1994"
25,8,6,1084,148,180,328,"21 de agosto de 1994"
25,8,6,1085,201,218,419,"21 de agosto de 1994"
25,8,6,1086,151,158,309,"21 de agosto de 1994"
25,8,6,1087,591,757,1348,"21 de agosto de 1994"
25,8,6,1088,330,393,723,"21 de agosto de 1994"
25,8,6,1089,276,371,647,"21 de agosto de 1994"
25,8,6,1090,258,311,569,"21 de agosto de 1994"
25,8,6,1091,193,214,407,"21 de agosto de 1994"
25,8,6,1092,123,160,283,"21 de agosto de 1994"
25,8,6,1093,167,237,404,"21 de agosto de 1994"
25,8,6,1094,110,133,243,"21 de agosto de 1994"
25,8,6,1095,173,205,378,"21 de agosto de 1994"
25,8,6,1096,191,197,388,"21 de agosto de 1994"
25,8,6,1097,121,134,255,"21 de agosto de 1994"
25,8,6,1098,219,229,448,"21 de agosto de 1994"
25,8,6,1099,132,171,303,"21 de agosto de 1994"
25,8,6,1100,93,97,190,"21 de agosto de 1994"
25,8,6,1101,189,231,420,"21 de agosto de 1994"
25,8,6,1102,118,151,269,"21 de agosto de 1994"
25,8,6,1103,193,247,440,"21 de agosto de 1994"
25,8,6,1104,158,191,349,"21 de agosto de 1994"
25,8,6,1105,124,145,269,"21 de agosto de 1994"
25,8,6,1106,158,174,332,"21 de agosto de 1994"
25,8,6,1107,151,153,304,"21 de agosto de 1994"
25,8,6,1108,112,114,226,"21 de agosto de 1994"
25,8,6,1109,134,149,283,"21 de agosto de 1994"
25,8,6,1110,113,140,253,"21 de agosto de 1994"
25,8,6,1111,146,137,283,"21 de agosto de 1994"
25,8,6,1112,167,170,337,"21 de agosto de 1994"
25,8,6,1113,94,103,197,"21 de agosto de 1994"
25,8,6,1114,187,193,380,"21 de agosto de 1994"
25,8,6,1115,151,186,337,"21 de agosto de 1994"
25,8,6,1116,181,213,394,"21 de agosto de 1994"
25,8,6,1117,195,189,384,"21 de agosto de 1994"
25,8,6,1118,148,140,288,"21 de agosto de 1994"
25,8,6,1119,393,456,849,"21 de agosto de 1994"
25,8,6,1120,169,178,347,"21 de agosto de 1994"
25,8,6,1121,171,182,353,"21 de agosto de 1994"
25,8,6,1122,103,113,216,"21 de agosto de 1994"
25,8,6,1123,176,183,359,"21 de agosto de 1994"
25,8,6,1124,118,125,243,"21 de agosto de 1994"
25,8,6,1125,112,104,216,"21 de agosto de 1994"
25,8,6,1126,146,176,322,"21 de agosto de 1994"
25,8,6,1127,93,108,201,"21 de agosto de 1994"
25,8,6,1128,126,150,276,"21 de agosto de 1994"
25,8,6,1129,204,221,425,"21 de agosto de 1994"
25,8,6,1130,175,181,356,"21 de agosto de 1994"
25,8,6,1131,105,96,201,"21 de agosto de 1994"
25,8,6,1132,146,150,296,"21 de agosto de 1994"
25,8,6,1133,125,138,263,"21 de agosto de 1994"
25,8,6,1134,147,159,306,"21 de agosto de 1994"
25,8,6,1135,133,157,290,"21 de agosto de 1994"
25,8,6,1136,138,136,274,"21 de agosto de 1994"
25,8,6,1137,139,160,299,"21 de agosto de 1994"
25,8,6,1138,162,177,339,"21 de agosto de 1994"
25,8,6,1139,107,127,234,"21 de agosto de 1994"
25,8,6,1140,149,149,298,"21 de agosto de 1994"
25,8,6,1141,131,159,290,"21 de agosto de 1994"
25,8,6,1142,162,201,363,"21 de agosto de 1994"
25,8,6,1143,144,161,305,"21 de agosto de 1994"
25,8,6,1144,161,146,307,"21 de agosto de 1994"
25,8,6,1145,216,240,456,"21 de agosto de 1994"
25,8,6,1146,171,203,374,"21 de agosto de 1994"
25,8,6,1147,124,131,255,"21 de agosto de 1994"
25,8,6,1148,87,84,171,"21 de agosto de 1994"
25,8,6,1149,155,171,326,"21 de agosto de 1994"
25,8,6,1150,171,202,373,"21 de agosto de 1994"
25,8,6,1151,226,227,453,"21 de agosto de 1994"
25,8,6,1152,185,223,408,"21 de agosto de 1994"
25,8,6,1153,182,208,390,"21 de agosto de 1994"
25,8,6,1154,154,155,309,"21 de agosto de 1994"
25,8,6,1155,160,170,330,"21 de agosto de 1994"
25,8,6,1156,276,302,578,"21 de agosto de 1994"
25,8,6,1157,130,137,267,"21 de agosto de 1994"
25,8,6,1158,151,166,317,"21 de agosto de 1994"
25,8,6,1159,177,147,324,"21 de agosto de 1994"
25,8,6,1160,153,187,340,"21 de agosto de 1994"
25,8,6,1161,99,103,202,"21 de agosto de 1994"
25,8,6,1162,169,163,332,"21 de agosto de 1994"
25,8,6,1163,145,151,296,"21 de agosto de 1994"
25,8,6,1164,166,138,304,"21 de agosto de 1994"
25,8,6,1165,125,142,267,"21 de agosto de 1994"
25,8,6,1166,132,133,265,"21 de agosto de 1994"
25,8,6,1167,118,128,246,"21 de agosto de 1994"
25,8,6,1168,104,116,220,"21 de agosto de 1994"
25,8,6,1169,157,172,329,"21 de agosto de 1994"
25,8,6,1170,112,113,225,"21 de agosto de 1994"
25,8,6,1171,174,183,357,"21 de agosto de 1994"
25,8,6,1172,187,196,383,"21 de agosto de 1994"
25,8,6,1173,92,110,202,"21 de agosto de 1994"
25,8,6,1174,130,158,288,"21 de agosto de 1994"
25,8,6,1175,128,153,281,"21 de agosto de 1994"
25,8,6,1176,127,152,279,"21 de agosto de 1994"
25,8,6,1177,84,75,159,"21 de agosto de 1994"
25,8,6,1178,132,147,279,"21 de agosto de 1994"
25,8,6,1179,159,158,317,"21 de agosto de 1994"
25,8,6,1180,98,116,214,"21 de agosto de 1994"
25,8,6,1181,120,152,272,"21 de agosto de 1994"
25,8,6,1182,199,231,430,"21 de agosto de 1994"
25,8,6,1183,101,138,239,"21 de agosto de 1994"
25,8,6,1184,161,171,332,"21 de agosto de 1994"
25,8,6,1185,245,271,516,"21 de agosto de 1994"
25,8,6,1186,157,178,335,"21 de agosto de 1994"
25,8,6,1187,150,143,293,"21 de agosto de 1994"
25,8,6,1188,256,286,542,"21 de agosto de 1994"
25,8,6,1189,396,484,880,"21 de agosto de 1994"
25,8,6,1190,260,283,543,"21 de agosto de 1994"
25,8,6,1191,180,201,381,"21 de agosto de 1994"
25,8,6,1192,132,143,275,"21 de agosto de 1994"
25,8,6,1193,178,219,397,"21 de agosto de 1994"
25,8,6,1194,206,221,427,"21 de agosto de 1994"
25,8,6,1195,165,204,369,"21 de agosto de 1994"
25,8,6,1196,205,238,443,"21 de agosto de 1994"
25,8,6,1197,140,186,326,"21 de agosto de 1994"
25,8,6,1198,284,337,621,"21 de agosto de 1994"
25,8,6,1199,309,371,680,"21 de agosto de 1994"
25,8,6,1200,112,130,242,"21 de agosto de 1994"
25,8,6,1201,546,583,1129,"21 de agosto de 1994"
25,8,6,1202,168,202,370,"21 de agosto de 1994"
25,8,6,1203,141,171,312,"21 de agosto de 1994"
25,8,6,1204,115,119,234,"21 de agosto de 1994"
25,8,6,1205,103,123,226,"21 de agosto de 1994"
25,8,6,1206,302,288,590,"21 de agosto de 1994"
25,8,6,1207,246,270,516,"21 de agosto de 1994"
25,8,6,1208,108,133,241,"21 de agosto de 1994"
25,8,6,1209,90,111,201,"21 de agosto de 1994"
25,8,6,1210,399,416,815,"21 de agosto de 1994"
25,8,6,1211,118,143,261,"21 de agosto de 1994"
25,8,6,1212,119,165,284,"21 de agosto de 1994"
25,8,6,1213,115,122,237,"21 de agosto de 1994"
25,8,6,1214,78,87,165,"21 de agosto de 1994"
25,8,6,1215,95,112,207,"21 de agosto de 1994"
25,8,6,1216,169,166,335,"21 de agosto de 1994"
25,8,6,1217,146,130,276,"21 de agosto de 1994"
25,8,6,1218,173,170,343,"21 de agosto de 1994"
25,8,6,1219,120,136,256,"21 de agosto de 1994"
25,8,6,1220,268,272,540,"21 de agosto de 1994"
25,8,6,1221,36,16,52,"21 de agosto de 1994"
25,8,6,1222,174,165,339,"21 de agosto de 1994"
25,8,6,1223,165,138,303,"21 de agosto de 1994"
25,8,6,1224,137,93,230,"21 de agosto de 1994"
25,8,6,1225,48,21,69,"21 de agosto de 1994"
25,8,6,1226,83,53,136,"21 de agosto de 1994"
25,8,6,1227,129,64,193,"21 de agosto de 1994"
25,8,6,1228,95,73,168,"21 de agosto de 1994"
25,8,6,1229,66,35,101,"21 de agosto de 1994"
25,8,6,1230,98,66,164,"21 de agosto de 1994"
25,8,6,1231,120,113,233,"21 de agosto de 1994"
25,8,6,1232,44,25,69,"21 de agosto de 1994"
25,8,6,1233,75,36,111,"21 de agosto de 1994"
25,8,6,1234,62,48,110,"21 de agosto de 1994"
25,8,6,1235,208,183,391,"21 de agosto de 1994"
25,8,6,1236,97,57,154,"21 de agosto de 1994"
25,8,6,1237,131,105,236,"21 de agosto de 1994"
25,8,6,1238,55,39,94,"21 de agosto de 1994"
25,8,6,1239,220,185,405,"21 de agosto de 1994"
25,8,6,1240,102,73,175,"21 de agosto de 1994"
25,8,6,1241,174,168,342,"21 de agosto de 1994"
25,8,6,1242,86,44,130,"21 de agosto de 1994"
25,8,6,1243,74,56,130,"21 de agosto de 1994"
25,8,6,1244,306,265,571,"21 de agosto de 1994"
25,8,6,1245,239,202,441,"21 de agosto de 1994"
25,8,6,1246,121,108,229,"21 de agosto de 1994"
25,8,6,1247,188,180,368,"21 de agosto de 1994"
25,8,6,1248,292,299,591,"21 de agosto de 1994"
25,8,6,1249,162,162,324,"21 de agosto de 1994"
25,8,6,1250,176,184,360,"21 de agosto de 1994"
25,8,6,1251,126,128,254,"21 de agosto de 1994"
25,8,6,1252,173,157,330,"21 de agosto de 1994"
25,8,6,1253,139,150,289,"21 de agosto de 1994"
25,8,6,1254,353,373,726,"21 de agosto de 1994"
25,8,6,1255,262,222,484,"21 de agosto de 1994"
25,8,6,1256,62,42,104,"21 de agosto de 1994"
25,8,6,1257,128,110,238,"21 de agosto de 1994"
25,8,6,1258,59,58,117,"21 de agosto de 1994"
25,8,6,1259,63,41,104,"21 de agosto de 1994"
25,8,6,1260,178,186,364,"21 de agosto de 1994"
25,8,6,1261,250,236,486,"21 de agosto de 1994"
25,8,6,1262,243,240,483,"21 de agosto de 1994"
25,8,6,1263,57,57,114,"21 de agosto de 1994"
25,8,6,1264,111,99,210,"21 de agosto de 1994"
25,8,6,1265,165,149,314,"21 de agosto de 1994"
25,8,6,1266,136,138,274,"21 de agosto de 1994"
25,8,6,1267,66,68,134,"21 de agosto de 1994"
25,8,6,1268,88,85,173,"21 de agosto de 1994"
25,8,6,1269,285,293,578,"21 de agosto de 1994"
25,8,6,1270,163,167,330,"21 de agosto de 1994"
25,8,6,1271,275,264,539,"21 de agosto de 1994"
25,8,6,1272,261,282,543,"21 de agosto de 1994"
25,8,6,1273,224,211,435,"21 de agosto de 1994"
25,8,6,1274,123,112,235,"21 de agosto de 1994"
25,8,6,1275,328,341,669,"21 de agosto de 1994"
25,8,6,1276,101,120,221,"21 de agosto de 1994"
25,8,6,1277,131,149,280,"21 de agosto de 1994"
25,8,6,1278,91,85,176,"21 de agosto de 1994"
25,8,6,1279,167,166,333,"21 de agosto de 1994"
25,8,6,1280,110,112,222,"21 de agosto de 1994"
25,8,6,1281,161,161,322,"21 de agosto de 1994"
25,8,6,1282,200,188,388,"21 de agosto de 1994"
25,8,6,1283,125,121,246,"21 de agosto de 1994"
25,8,6,1284,170,208,378,"21 de agosto de 1994"
25,8,6,1285,136,123,259,"21 de agosto de 1994"
25,8,6,1286,169,149,318,"21 de agosto de 1994"
25,8,6,1287,202,238,440,"21 de agosto de 1994"
25,8,6,1288,297,319,616,"21 de agosto de 1994"
25,8,6,1289,197,179,376,"21 de agosto de 1994"
25,8,6,1290,91,117,208,"21 de agosto de 1994"
25,8,6,1291,160,172,332,"21 de agosto de 1994"
25,8,6,1292,198,176,374,"21 de agosto de 1994"
25,8,6,1293,82,66,148,"21 de agosto de 1994"
25,8,6,1294,95,71,166,"21 de agosto de 1994"
25,8,18,3614,108,127,235,"21 de agosto de 1994"
25,8,18,3615,166,173,339,"21 de agosto de 1994"
25,8,18,3616,97,110,207,"21 de agosto de 1994"
25,8,18,3617,89,94,183,"21 de agosto de 1994"
25,8,18,3618,95,91,186,"21 de agosto de 1994"
25,8,18,3619,178,162,340,"21 de agosto de 1994"
25,8,18,3620,183,196,379,"21 de agosto de 1994"
25,8,18,3621,244,253,497,"21 de agosto de 1994"
25,8,18,3622,323,325,648,"21 de agosto de 1994"
25,8,18,3623,180,191,371,"21 de agosto de 1994"
25,8,18,3624,79,98,177,"21 de agosto de 1994"
25,8,18,3625,161,167,328,"21 de agosto de 1994"
25,8,18,3626,196,221,417,"21 de agosto de 1994"
25,8,18,3627,170,204,374,"21 de agosto de 1994"
25,8,18,3628,98,121,219,"21 de agosto de 1994"
25,8,18,3629,194,173,367,"21 de agosto de 1994"
25,8,18,3630,61,57,118,"21 de agosto de 1994"
25,8,18,3631,268,287,555,"21 de agosto de 1994"
25,8,18,3632,125,124,249,"21 de agosto de 1994"
25,8,18,3633,107,130,237,"21 de agosto de 1994"
25,8,18,3634,273,296,569,"21 de agosto de 1994"
25,8,18,3635,149,183,332,"21 de agosto de 1994"
25,8,18,3636,314,335,649,"21 de agosto de 1994"
25,8,18,3637,93,91,184,"21 de agosto de 1994"
25,8,18,3638,161,139,300,"21 de agosto de 1994"
25,8,18,3639,141,156,297,"21 de agosto de 1994"
25,8,18,3640,162,175,337,"21 de agosto de 1994"
25,8,18,3641,294,303,597,"21 de agosto de 1994"
25,8,18,3642,227,215,442,"21 de agosto de 1994"
25,8,18,3643,231,242,473,"21 de agosto de 1994"
25,8,18,3644,266,248,514,"21 de agosto de 1994"
25,8,18,3645,215,248,463,"21 de agosto de 1994"
25,8,18,3646,223,204,427,"21 de agosto de 1994"
25,8,18,3647,165,197,362,"21 de agosto de 1994"
25,8,18,3648,188,163,351,"21 de agosto de 1994"
25,8,18,3649,233,212,445,"21 de agosto de 1994"
25,8,18,3650,82,65,147,"21 de agosto de 1994"
25,8,18,3651,328,300,628,"21 de agosto de 1994"
25,8,18,3652,111,87,198,"21 de agosto de 1994"
25,8,18,3653,219,194,413,"21 de agosto de 1994"
25,8,18,3654,276,273,549,"21 de agosto de 1994"
25,8,18,3655,217,174,391,"21 de agosto de 1994"
25,8,18,3656,114,98,212,"21 de agosto de 1994"
25,8,18,3657,126,102,228,"21 de agosto de 1994"
25,8,18,3658,187,177,364,"21 de agosto de 1994"
25,8,18,3659,254,229,483,"21 de agosto de 1994"
25,8,18,3660,135,90,225,"21 de agosto de 1994"
25,8,18,3661,149,128,277,"21 de agosto de 1994"
25,8,18,3662,228,212,440,"21 de agosto de 1994"
25,8,18,3663,191,198,389,"21 de agosto de 1994"
25,8,18,3664,135,139,274,"21 de agosto de 1994"
25,8,18,3665,172,180,352,"21 de agosto de 1994"
25,8,18,3666,260,238,498,"21 de agosto de 1994"
25,8,18,3667,222,224,446,"21 de agosto de 1994"
25,8,18,3668,161,162,323,"21 de agosto de 1994"
25,8,18,3669,176,179,355,"21 de agosto de 1994"
25,8,18,3670,180,164,344,"21 de agosto de 1994"
25,8,18,3671,181,185,366,"21 de agosto de 1994"
25,8,18,3672,253,247,500,"21 de agosto de 1994"
25,8,18,3673,147,131,278,"21 de agosto de 1994"
25,8,18,3674,163,162,325,"21 de agosto de 1994"
25,8,18,3675,223,197,420,"21 de agosto de 1994"
25,8,18,3676,89,94,183,"21 de agosto de 1994"
25,8,18,3677,157,127,284,"21 de agosto de 1994"
25,8,18,3678,111,118,229,"21 de agosto de 1994"
25,8,18,3679,252,212,464,"21 de agosto de 1994"
25,8,18,3680,104,87,191,"21 de agosto de 1994"
25,8,18,3681,244,213,457,"21 de agosto de 1994"
25,8,18,3682,209,164,373,"21 de agosto de 1994"
25,8,18,3683,171,146,317,"21 de agosto de 1994"
25,8,18,3684,104,104,208,"21 de agosto de 1994"
25,8,18,3685,236,240,476,"21 de agosto de 1994"
25,8,18,3686,143,133,276,"21 de agosto de 1994"
25,8,18,3687,47,44,91,"21 de agosto de 1994"
25,8,18,3688,155,139,294,"21 de agosto de 1994"
25,8,18,3689,163,142,305,"21 de agosto de 1994"
25,8,18,3690,129,128,257,"21 de agosto de 1994"
25,8,18,3691,197,188,385,"21 de agosto de 1994"
25,8,18,3692,157,153,310,"21 de agosto de 1994"
25,8,18,3693,220,238,458,"21 de agosto de 1994"
25,8,18,3694,176,181,357,"21 de agosto de 1994"
25,8,18,3695,175,190,365,"21 de agosto de 1994"
25,8,18,3696,203,193,396,"21 de agosto de 1994"
25,8,18,3697,162,159,321,"21 de agosto de 1994"
25,8,18,3698,146,147,293,"21 de agosto de 1994"
25,8,18,3699,306,266,572,"21 de agosto de 1994"
25,8,18,3700,240,220,460,"21 de agosto de 1994"
25,8,18,3701,105,99,204,"21 de agosto de 1994"
25,8,18,3702,169,165,334,"21 de agosto de 1994"
25,8,18,3703,154,130,284,"21 de agosto de 1994"
25,8,18,3704,160,155,315,"21 de agosto de 1994"
25,8,18,3705,169,161,330,"21 de agosto de 1994"
25,8,18,3706,161,125,286,"21 de agosto de 1994"
25,8,18,3707,142,137,279,"21 de agosto de 1994"
25,8,18,3708,228,213,441,"21 de agosto de 1994"
25,8,18,3709,259,194,453,"21 de agosto de 1994"
25,8,18,3710,170,130,300,"21 de agosto de 1994"
25,8,18,3711,300,250,550,"21 de agosto de 1994"
25,8,18,3712,135,117,252,"21 de agosto de 1994"
25,8,18,3713,150,114,264,"21 de agosto de 1994"
25,8,18,3714,161,157,318,"21 de agosto de 1994"
25,8,18,3715,130,144,274,"21 de agosto de 1994"
25,8,18,3716,213,194,407,"21 de agosto de 1994"
25,8,18,3717,201,170,371,"21 de agosto de 1994"
25,8,18,3718,107,108,215,"21 de agosto de 1994"
25,8,18,3719,134,99,233,"21 de agosto de 1994"
25,8,18,3720,239,217,456,"21 de agosto de 1994"
25,8,18,3721,183,204,387,"21 de agosto de 1994"
25,8,18,3722,99,118,217,"21 de agosto de 1994"
25,8,18,3723,77,64,141,"21 de agosto de 1994"
25,8,18,3724,203,219,422,"21 de agosto de 1994"
25,8,18,3725,238,219,457,"21 de agosto de 1994"
25,8,18,3726,244,226,470,"21 de agosto de 1994"
25,8,18,3727,235,241,476,"21 de agosto de 1994"
25,8,18,3728,99,84,183,"21 de agosto de 1994"
25,8,18,3729,128,105,233,"21 de agosto de 1994"
25,8,18,3730,102,96,198,"21 de agosto de 1994"
25,8,18,3731,221,200,421,"21 de agosto de 1994"
25,8,18,3732,169,134,303,"21 de agosto de 1994"
25,8,18,3733,137,119,256,"21 de agosto de 1994"
25,8,18,3734,151,143,294,"21 de agosto de 1994"
25,8,18,3735,172,135,307,"21 de agosto de 1994"
25,8,18,3736,144,152,296,"21 de agosto de 1994"
25,8,18,3737,141,143,284,"21 de agosto de 1994"
25,8,18,3738,125,110,235,"21 de agosto de 1994"
25,8,18,3739,214,196,410,"21 de agosto de 1994"
25,8,18,3740,90,95,185,"21 de agosto de 1994"
25,8,18,3741,259,237,496,"21 de agosto de 1994"
25,8,18,3742,181,157,338,"21 de agosto de 1994"
25,8,18,3743,222,201,423,"21 de agosto de 1994"
25,8,18,3744,194,156,350,"21 de agosto de 1994"
25,8,18,3745,78,54,132,"21 de agosto de 1994"
25,8,18,3746,249,209,458,"21 de agosto de 1994"
25,8,18,3747,223,194,417,"21 de agosto de 1994"
25,8,18,3748,84,67,151,"21 de agosto de 1994"
25,8,18,3749,89,79,168,"21 de agosto de 1994"
25,8,18,3750,251,230,481,"21 de agosto de 1994"
25,8,18,3751,180,123,303,"21 de agosto de 1994"
25,8,18,3752,200,179,379,"21 de agosto de 1994"
25,8,18,3753,115,99,214,"21 de agosto de 1994"
25,8,18,3754,138,102,240,"21 de agosto de 1994"
25,8,18,3755,31,38,69,"21 de agosto de 1994"
25,8,18,3756,298,253,551,"21 de agosto de 1994"
25,8,18,3757,304,297,601,"21 de agosto de 1994"
25,8,18,3758,316,302,618,"21 de agosto de 1994"
25,8,18,3759,209,193,402,"21 de agosto de 1994"
25,8,18,3760,121,128,249,"21 de agosto de 1994"
25,8,18,3761,261,250,511,"21 de agosto de 1994"
25,8,18,3762,285,265,550,"21 de agosto de 1994"
25,8,18,3763,245,205,450,"21 de agosto de 1994"
25,8,18,3764,301,302,603,"21 de agosto de 1994"
25,8,18,3765,144,109,253,"21 de agosto de 1994"
25,8,18,3766,113,122,235,"21 de agosto de 1994"
25,8,18,3767,120,121,241,"21 de agosto de 1994"
25,8,18,3768,192,144,336,"21 de agosto de 1994"
25,8,18,3769,141,95,236,"21 de agosto de 1994"
25,8,18,3770,171,125,296,"21 de agosto de 1994"
25,8,18,3771,142,131,273,"21 de agosto de 1994"
25,8,18,3772,99,69,168,"21 de agosto de 1994"
25,8,18,3773,123,104,227,"21 de agosto de 1994"
25,8,18,3774,105,84,189,"21 de agosto de 1994"
25,8,18,3775,75,49,124,"21 de agosto de 1994"
25,8,18,3776,193,156,349,"21 de agosto de 1994"
25,8,18,3777,61,58,119,"21 de agosto de 1994"
25,8,18,3778,225,192,417,"21 de agosto de 1994"
25,8,18,3779,257,218,475,"21 de agosto de 1994"
25,8,18,3780,270,223,493,"21 de agosto de 1994"
25,8,18,3781,235,196,431,"21 de agosto de 1994"
25,8,18,3782,65,47,112,"21 de agosto de 1994"
25,8,18,3783,91,74,165,"21 de agosto de 1994"
25,8,18,3784,123,94,217,"21 de agosto de 1994"
25,8,18,3785,277,221,498,"21 de agosto de 1994"
25,8,18,3786,280,249,529,"21 de agosto de 1994"
25,8,18,3787,135,149,284,"21 de agosto de 1994"
25,8,18,3788,244,208,452,"21 de agosto de 1994"
25,8,18,3789,273,238,511,"21 de agosto de 1994"
25,9,6,1295,209,268,477,"21 de agosto de 1994"
25,9,6,1296,192,264,456,"21 de agosto de 1994"
25,9,6,1297,150,173,323,"21 de agosto de 1994"
25,9,6,1298,181,233,414,"21 de agosto de 1994"
25,9,6,1299,120,140,260,"21 de agosto de 1994"
25,9,6,1300,186,254,440,"21 de agosto de 1994"
25,9,6,1301,131,152,283,"21 de agosto de 1994"
25,9,6,1302,149,170,319,"21 de agosto de 1994"
25,9,6,1303,155,179,334,"21 de agosto de 1994"
25,9,6,1304,117,162,279,"21 de agosto de 1994"
25,9,6,1305,122,154,276,"21 de agosto de 1994"
25,9,6,1306,197,188,385,"21 de agosto de 1994"
25,9,6,1307,166,155,321,"21 de agosto de 1994"
25,9,6,1308,139,162,301,"21 de agosto de 1994"
25,9,6,1309,78,75,153,"21 de agosto de 1994"
25,9,6,1310,155,162,317,"21 de agosto de 1994"
25,9,6,1311,69,73,142,"21 de agosto de 1994"
25,9,6,1312,185,190,375,"21 de agosto de 1994"
25,9,6,1313,207,250,457,"21 de agosto de 1994"
25,9,6,1314,133,155,288,"21 de agosto de 1994"
25,9,6,1315,113,129,242,"21 de agosto de 1994"
25,9,6,1316,194,213,407,"21 de agosto de 1994"
25,9,6,1317,221,239,460,"21 de agosto de 1994"
25,9,6,1318,196,251,447,"21 de agosto de 1994"
25,9,6,1319,108,120,228,"21 de agosto de 1994"
25,9,6,1320,150,177,327,"21 de agosto de 1994"
25,9,6,1321,116,153,269,"21 de agosto de 1994"
25,9,6,1322,318,372,690,"21 de agosto de 1994"
25,9,6,1323,158,183,341,"21 de agosto de 1994"
25,9,6,1324,170,191,361,"21 de agosto de 1994"
25,9,6,1325,115,137,252,"21 de agosto de 1994"
25,9,6,1326,137,156,293,"21 de agosto de 1994"
25,9,6,1327,148,167,315,"21 de agosto de 1994"
25,9,6,1328,146,164,310,"21 de agosto de 1994"
25,9,6,1329,138,175,313,"21 de agosto de 1994"
25,9,6,1330,76,82,158,"21 de agosto de 1994"
25,9,6,1331,988,30,1018,"21 de agosto de 1994"
25,9,6,1332,100,117,217,"21 de agosto de 1994"
25,9,6,1333,310,351,661,"21 de agosto de 1994"
25,9,6,1334,187,234,421,"21 de agosto de 1994"
25,9,6,1335,269,294,563,"21 de agosto de 1994"
25,9,6,1336,145,179,324,"21 de agosto de 1994"
25,9,6,1337,146,144,290,"21 de agosto de 1994"
25,9,6,1338,180,200,380,"21 de agosto de 1994"
25,9,6,1339,116,129,245,"21 de agosto de 1994"
25,9,6,1340,184,206,390,"21 de agosto de 1994"
25,9,6,1341,148,176,324,"21 de agosto de 1994"
25,9,6,1342,145,173,318,"21 de agosto de 1994"
25,9,6,1343,236,234,470,"21 de agosto de 1994"
25,9,6,1344,141,148,289,"21 de agosto de 1994"
25,9,6,1345,137,134,271,"21 de agosto de 1994"
25,9,6,1346,275,319,594,"21 de agosto de 1994"
25,9,6,1347,132,161,293,"21 de agosto de 1994"
25,9,6,1348,122,140,262,"21 de agosto de 1994"
25,9,6,1349,150,162,312,"21 de agosto de 1994"
25,9,6,1350,273,340,613,"21 de agosto de 1994"
25,9,6,1351,232,280,512,"21 de agosto de 1994"
25,9,6,1352,207,248,455,"21 de agosto de 1994"
25,9,6,1353,182,201,383,"21 de agosto de 1994"
25,9,6,1354,160,156,316,"21 de agosto de 1994"
25,9,6,1355,201,224,425,"21 de agosto de 1994"
25,9,6,1356,180,205,385,"21 de agosto de 1994"
25,9,6,1357,250,261,511,"21 de agosto de 1994"
25,9,6,1358,130,139,269,"21 de agosto de 1994"
25,9,6,1359,173,181,354,"21 de agosto de 1994"
25,9,6,1360,217,230,447,"21 de agosto de 1994"
25,9,6,1361,147,160,307,"21 de agosto de 1994"
25,9,6,1362,124,158,282,"21 de agosto de 1994"
25,9,6,1363,164,167,331,"21 de agosto de 1994"
25,9,6,1364,153,156,309,"21 de agosto de 1994"
25,9,6,1365,141,184,325,"21 de agosto de 1994"
25,9,6,1366,109,128,237,"21 de agosto de 1994"
25,9,6,1367,150,169,319,"21 de agosto de 1994"
25,9,6,1368,187,226,413,"21 de agosto de 1994"
25,9,6,1369,165,155,320,"21 de agosto de 1994"
25,9,6,1370,158,162,320,"21 de agosto de 1994"
25,9,6,1371,213,280,493,"21 de agosto de 1994"
25,9,6,1372,203,206,409,"21 de agosto de 1994"
25,9,6,1373,172,183,355,"21 de agosto de 1994"
25,9,6,1374,147,189,336,"21 de agosto de 1994"
25,9,6,1375,157,191,348,"21 de agosto de 1994"
25,9,6,1376,216,239,455,"21 de agosto de 1994"
25,9,6,1377,203,222,425,"21 de agosto de 1994"
25,9,6,1378,151,148,299,"21 de agosto de 1994"
25,9,6,1379,206,223,429,"21 de agosto de 1994"
25,9,6,1380,195,241,436,"21 de agosto de 1994"
25,9,6,1381,83,88,171,"21 de agosto de 1994"
25,9,6,1382,182,195,377,"21 de agosto de 1994"
25,9,6,1383,184,208,392,"21 de agosto de 1994"
25,9,6,1384,152,164,316,"21 de agosto de 1994"
25,9,6,1385,120,131,251,"21 de agosto de 1994"
25,9,6,1386,124,130,254,"21 de agosto de 1994"
25,9,6,1387,172,169,341,"21 de agosto de 1994"
25,9,6,1388,130,151,281,"21 de agosto de 1994"
25,9,6,1389,187,214,401,"21 de agosto de 1994"
25,9,6,1390,185,194,379,"21 de agosto de 1994"
25,9,6,1391,186,234,420,"21 de agosto de 1994"
25,9,6,1392,259,262,521,"21 de agosto de 1994"
25,9,6,1393,188,216,404,"21 de agosto de 1994"
25,9,6,1394,171,190,361,"21 de agosto de 1994"
25,9,6,1395,149,165,314,"21 de agosto de 1994"
25,9,6,1396,179,196,375,"21 de agosto de 1994"
25,9,6,1397,104,121,225,"21 de agosto de 1994"
25,9,6,1398,160,192,352,"21 de agosto de 1994"
25,9,6,1399,124,144,268,"21 de agosto de 1994"
25,9,6,1400,105,116,221,"21 de agosto de 1994"
25,9,6,1401,123,143,266,"21 de agosto de 1994"
25,9,6,1402,143,168,311,"21 de agosto de 1994"
25,9,6,1403,168,195,363,"21 de agosto de 1994"
25,9,6,1404,150,167,317,"21 de agosto de 1994"
25,9,6,1405,295,288,583,"21 de agosto de 1994"
25,9,6,1406,153,178,331,"21 de agosto de 1994"
25,9,6,1407,176,201,377,"21 de agosto de 1994"
25,9,6,1408,208,220,428,"21 de agosto de 1994"
25,9,6,1409,119,151,270,"21 de agosto de 1994"
25,9,6,1410,71,82,153,"21 de agosto de 1994"
25,9,6,1411,158,209,367,"21 de agosto de 1994"
25,9,6,1412,63,91,154,"21 de agosto de 1994"
25,9,6,1413,112,139,251,"21 de agosto de 1994"
25,9,6,1414,110,103,213,"21 de agosto de 1994"
25,9,6,1415,145,154,299,"21 de agosto de 1994"
25,9,6,1416,184,219,403,"21 de agosto de 1994"
25,9,6,1417,220,242,462,"21 de agosto de 1994"
25,9,6,1418,134,135,269,"21 de agosto de 1994"
25,9,6,1419,197,206,403,"21 de agosto de 1994"
25,9,6,1420,215,266,481,"21 de agosto de 1994"
25,9,6,1421,232,271,503,"21 de agosto de 1994"
25,9,6,1422,154,184,338,"21 de agosto de 1994"
25,9,6,1423,150,180,330,"21 de agosto de 1994"
25,9,6,1424,126,181,307,"21 de agosto de 1994"
25,9,6,1425,111,138,249,"21 de agosto de 1994"
25,9,6,1426,155,163,318,"21 de agosto de 1994"
25,9,6,1427,166,186,352,"21 de agosto de 1994"
25,9,6,1428,140,175,315,"21 de agosto de 1994"
25,9,6,1429,205,209,414,"21 de agosto de 1994"
25,9,6,1430,148,154,302,"21 de agosto de 1994"
25,9,6,1431,167,204,371,"21 de agosto de 1994"
25,9,6,1432,164,169,333,"21 de agosto de 1994"
25,9,6,1433,145,163,308,"21 de agosto de 1994"
25,9,6,1434,174,171,345,"21 de agosto de 1994"
25,9,6,1435,245,279,524,"21 de agosto de 1994"
25,9,6,1436,266,322,588,"21 de agosto de 1994"
25,9,6,1437,80,92,172,"21 de agosto de 1994"
25,9,6,1438,114,132,246,"21 de agosto de 1994"
25,9,6,1439,154,179,333,"21 de agosto de 1994"
25,9,6,1440,171,185,356,"21 de agosto de 1994"
25,9,6,1441,151,151,302,"21 de agosto de 1994"
25,9,6,1442,185,184,369,"21 de agosto de 1994"
25,9,6,1443,103,99,202,"21 de agosto de 1994"
25,9,6,1444,92,90,182,"21 de agosto de 1994"
25,9,6,1445,105,122,227,"21 de agosto de 1994"
25,9,6,1446,99,104,203,"21 de agosto de 1994"
25,9,6,1447,148,165,313,"21 de agosto de 1994"
25,9,6,1448,172,214,386,"21 de agosto de 1994"
25,9,6,1449,213,224,437,"21 de agosto de 1994"
25,9,6,1450,151,195,346,"21 de agosto de 1994"
25,9,6,1451,109,132,241,"21 de agosto de 1994"
25,9,6,1452,118,123,241,"21 de agosto de 1994"
25,9,6,1453,162,191,353,"21 de agosto de 1994"
25,9,6,1454,172,169,341,"21 de agosto de 1994"
25,9,6,1455,99,128,227,"21 de agosto de 1994"
25,9,6,1456,127,129,256,"21 de agosto de 1994"
25,9,6,1457,145,165,310,"21 de agosto de 1994"
25,9,6,1458,250,251,501,"21 de agosto de 1994"
25,9,6,1459,186,214,400,"21 de agosto de 1994"
25,9,6,1460,165,174,339,"21 de agosto de 1994"
25,9,6,1461,128,151,279,"21 de agosto de 1994"
25,9,6,1462,190,212,402,"21 de agosto de 1994"
25,9,6,1463,144,167,311,"21 de agosto de 1994"
25,9,6,1464,193,205,398,"21 de agosto de 1994"
25,9,6,1465,152,171,323,"21 de agosto de 1994"
25,9,6,1466,210,235,445,"21 de agosto de 1994"
25,9,6,1467,154,178,332,"21 de agosto de 1994"
25,9,6,1468,112,143,255,"21 de agosto de 1994"
25,9,6,1469,138,167,305,"21 de agosto de 1994"
25,9,6,1470,183,203,386,"21 de agosto de 1994"
25,9,6,1471,193,215,408,"21 de agosto de 1994"
25,9,6,1472,194,211,405,"21 de agosto de 1994"
25,9,6,1473,164,212,376,"21 de agosto de 1994"
25,9,6,1474,123,134,257,"21 de agosto de 1994"
25,9,6,1475,149,172,321,"21 de agosto de 1994"
25,9,6,1476,116,142,258,"21 de agosto de 1994"
25,9,6,1477,127,161,288,"21 de agosto de 1994"
25,9,6,1478,249,248,497,"21 de agosto de 1994"
25,9,6,1479,153,183,336,"21 de agosto de 1994"
25,9,6,1480,153,170,323,"21 de agosto de 1994"
25,9,6,1481,131,144,275,"21 de agosto de 1994"
25,9,6,1482,148,189,337,"21 de agosto de 1994"
25,9,6,1483,150,176,326,"21 de agosto de 1994"
25,9,6,1484,154,186,340,"21 de agosto de 1994"
25,9,6,1485,138,153,291,"21 de agosto de 1994"
25,9,6,1486,108,111,219,"21 de agosto de 1994"
25,9,6,1487,81,56,137,"21 de agosto de 1994"
25,9,6,1488,126,79,205,"21 de agosto de 1994"
25,9,6,1489,86,40,126,"21 de agosto de 1994"
25,9,6,1490,72,46,118,"21 de agosto de 1994"
25,9,6,1491,61,40,101,"21 de agosto de 1994"
25,9,6,1492,127,76,203,"21 de agosto de 1994"
25,9,6,1493,127,110,237,"21 de agosto de 1994"
25,9,6,1494,135,117,252,"21 de agosto de 1994"
25,9,6,1495,91,87,178,"21 de agosto de 1994"
25,9,6,1496,73,48,121,"21 de agosto de 1994"
25,9,6,1497,138,111,249,"21 de agosto de 1994"
25,9,6,1498,104,76,180,"21 de agosto de 1994"
25,9,6,1499,43,32,75,"21 de agosto de 1994"
25,9,6,1500,141,112,253,"21 de agosto de 1994"
25,9,6,1501,88,82,170,"21 de agosto de 1994"
25,9,6,1502,82,58,140,"21 de agosto de 1994"
25,9,6,1503,203,165,368,"21 de agosto de 1994"
25,9,6,1504,130,96,226,"21 de agosto de 1994"
25,9,6,1505,152,118,270,"21 de agosto de 1994"
25,9,6,1506,123,97,220,"21 de agosto de 1994"
25,9,6,1507,311,245,556,"21 de agosto de 1994"
25,9,6,1508,333,288,621,"21 de agosto de 1994"
25,9,6,1509,368,349,717,"21 de agosto de 1994"
25,9,6,1510,200,177,377,"21 de agosto de 1994"
25,9,6,1511,317,297,614,"21 de agosto de 1994"
25,9,6,1512,86,72,158,"21 de agosto de 1994"
25,9,6,1513,91,67,158,"21 de agosto de 1994"
25,9,6,1514,78,58,136,"21 de agosto de 1994"
25,9,6,1515,38,21,59,"21 de agosto de 1994"
25,9,6,1516,141,95,236,"21 de agosto de 1994"
25,9,6,1517,67,53,120,"21 de agosto de 1994"
25,9,6,1518,110,97,207,"21 de agosto de 1994"
25,9,6,1519,47,46,93,"21 de agosto de 1994"
25,9,6,1520,81,86,167,"21 de agosto de 1994"
25,9,6,1521,205,228,433,"21 de agosto de 1994"
25,9,6,1522,70,63,133,"21 de agosto de 1994"
25,9,6,1523,50,33,83,"21 de agosto de 1994"
25,9,6,1524,58,39,97,"21 de agosto de 1994"
25,9,6,1525,62,45,107,"21 de agosto de 1994"
25,9,6,1526,73,56,129,"21 de agosto de 1994"
25,9,6,1527,110,80,190,"21 de agosto de 1994"
25,9,6,1528,150,113,263,"21 de agosto de 1994"
25,9,6,1529,34,24,58,"21 de agosto de 1994"
25,9,6,1530,36,36,72,"21 de agosto de 1994"
25,9,6,1531,71,45,116,"21 de agosto de 1994"
25,9,6,1532,104,99,203,"21 de agosto de 1994"
25,9,6,1533,96,95,191,"21 de agosto de 1994"
25,9,6,1534,162,124,286,"21 de agosto de 1994"
25,9,6,1535,184,167,351,"21 de agosto de 1994"
25,9,6,1536,42,37,79,"21 de agosto de 1994"
25,9,6,1537,106,70,176,"21 de agosto de 1994"
25,9,6,1538,74,54,128,"21 de agosto de 1994"
25,9,6,1539,33,28,61,"21 de agosto de 1994"
25,9,6,1540,149,128,277,"21 de agosto de 1994"
25,9,6,1541,100,74,174,"21 de agosto de 1994"
25,9,6,1542,94,72,166,"21 de agosto de 1994"
25,9,6,1543,116,76,192,"21 de agosto de 1994"
25,9,6,1544,195,173,368,"21 de agosto de 1994"
25,9,6,1545,158,85,243,"21 de agosto de 1994"
25,9,6,1546,81,48,129,"21 de agosto de 1994"
25,9,6,1547,114,104,218,"21 de agosto de 1994"
25,9,6,1548,169,151,320,"21 de agosto de 1994"
25,9,6,1549,123,100,223,"21 de agosto de 1994"
25,9,6,1550,151,144,295,"21 de agosto de 1994"
25,9,6,1551,102,91,193,"21 de agosto de 1994"
25,9,6,1552,148,107,255,"21 de agosto de 1994"
25,9,6,1553,205,192,397,"21 de agosto de 1994"
25,9,6,1554,127,117,244,"21 de agosto de 1994"
25,9,6,1555,240,237,477,"21 de agosto de 1994"
25,9,6,1556,274,278,552,"21 de agosto de 1994"
25,9,6,1557,294,276,570,"21 de agosto de 1994"
25,9,6,1558,226,240,466,"21 de agosto de 1994"
25,9,6,1559,143,160,303,"21 de agosto de 1994"
25,9,6,1560,137,148,285,"21 de agosto de 1994"
25,9,6,1561,157,143,300,"21 de agosto de 1994"
25,9,6,1562,157,147,304,"21 de agosto de 1994"
25,9,6,1563,226,231,457,"21 de agosto de 1994"
25,9,6,1564,143,135,278,"21 de agosto de 1994"
25,9,6,1565,85,101,186,"21 de agosto de 1994"
25,9,6,1566,142,150,292,"21 de agosto de 1994"
25,9,6,1567,80,80,160,"21 de agosto de 1994"
25,9,6,1568,172,168,340,"21 de agosto de 1994"
25,9,6,1569,76,104,180,"21 de agosto de 1994"
25,9,6,1570,236,213,449,"21 de agosto de 1994"
25,9,6,1571,136,138,274,"21 de agosto de 1994"
25,9,6,1572,63,63,126,"21 de agosto de 1994"
25,9,6,1573,72,87,159,"21 de agosto de 1994"
25,9,6,1574,280,231,511,"21 de agosto de 1994"
25,9,6,1575,224,233,457,"21 de agosto de 1994"
25,9,6,1576,232,219,451,"21 de agosto de 1994"
25,9,6,1577,206,177,383,"21 de agosto de 1994"
25,9,6,1578,114,121,235,"21 de agosto de 1994"
25,9,6,1579,107,145,252,"21 de agosto de 1994"
25,9,6,1580,311,315,626,"21 de agosto de 1994"
25,9,6,1581,88,82,170,"21 de agosto de 1994"
25,9,6,1582,176,145,321,"21 de agosto de 1994"
25,9,6,1583,207,235,442,"21 de agosto de 1994"
25,9,6,1584,105,114,219,"21 de agosto de 1994"
25,9,6,1585,124,138,262,"21 de agosto de 1994"
25,9,6,1586,134,136,270,"21 de agosto de 1994"
25,9,6,1587,109,82,191,"21 de agosto de 1994"
25,9,6,1588,120,93,213,"21 de agosto de 1994"
25,9,6,1589,114,98,212,"21 de agosto de 1994"
25,9,6,1590,176,138,314,"21 de agosto de 1994"
25,9,6,1591,242,215,457,"21 de agosto de 1994"
25,9,6,1592,140,136,276,"21 de agosto de 1994"
25,9,6,1593,97,79,176,"21 de agosto de 1994"
25,9,6,1594,74,34,108,"21 de agosto de 1994"
25,9,6,1595,71,43,114,"21 de agosto de 1994"
25,9,6,1596,255,232,487,"21 de agosto de 1994"
25,9,6,1597,298,280,578,"21 de agosto de 1994"
25,9,6,1598,195,218,413,"21 de agosto de 1994"
25,9,6,1599,88,81,169,"21 de agosto de 1994"
25,9,6,1600,62,43,105,"21 de agosto de 1994"
25,9,6,1601,26,8,34,"21 de agosto de 1994"
25,9,6,1602,58,31,89,"21 de agosto de 1994"
25,9,6,1603,201,137,338,"21 de agosto de 1994"
25,9,6,1604,120,74,194,"21 de agosto de 1994"
25,9,6,1605,152,142,294,"21 de agosto de 1994"
25,9,6,1606,130,93,223,"21 de agosto de 1994"
25,9,6,1607,167,133,300,"21 de agosto de 1994"
25,9,6,1608,115,97,212,"21 de agosto de 1994"
25,9,6,1609,162,136,298,"21 de agosto de 1994"
25,9,6,1610,87,74,161,"21 de agosto de 1994"
25,9,6,1611,63,51,114,"21 de agosto de 1994"
25,9,6,1612,121,105,226,"21 de agosto de 1994"
25,9,6,1613,114,105,219,"21 de agosto de 1994"
25,9,6,1614,238,205,443,"21 de agosto de 1994"
25,9,6,1615,169,183,352,"21 de agosto de 1994"
25,9,6,1616,147,134,281,"21 de agosto de 1994"
25,9,6,1617,158,129,287,"21 de agosto de 1994"
25,9,6,1618,85,75,160,"21 de agosto de 1994"
25,9,6,1619,212,178,390,"21 de agosto de 1994"
25,9,6,1620,199,188,387,"21 de agosto de 1994"
25,9,6,1621,262,249,511,"21 de agosto de 1994"
25,9,6,1622,164,159,323,"21 de agosto de 1994"
25,9,6,1623,172,192,364,"21 de agosto de 1994"
25,9,6,1624,144,136,280,"21 de agosto de 1994"
25,9,6,1625,205,195,400,"21 de agosto de 1994"
25,9,6,1626,180,147,327,"21 de agosto de 1994"
25,9,6,1627,125,106,231,"21 de agosto de 1994"
25,9,6,1628,115,84,199,"21 de agosto de 1994"
25,9,6,1629,156,118,274,"21 de agosto de 1994"
25,9,6,1630,200,175,375,"21 de agosto de 1994"
25,9,6,1631,206,152,358,"21 de agosto de 1994"
25,9,6,1632,109,106,215,"21 de agosto de 1994"
25,9,6,1633,184,178,362,"21 de agosto de 1994"
25,9,6,1634,68,59,127,"21 de agosto de 1994"
25,9,6,1635,225,254,479,"21 de agosto de 1994"
25,9,6,1636,274,255,529,"21 de agosto de 1994"
25,9,6,1637,151,129,280,"21 de agosto de 1994"
25,9,6,1638,230,227,457,"21 de agosto de 1994"
25,9,6,1639,97,82,179,"21 de agosto de 1994"
25,9,6,1640,171,165,336,"21 de agosto de 1994"
25,9,6,1641,188,175,363,"21 de agosto de 1994"
25,9,6,1642,157,124,281,"21 de agosto de 1994"
25,9,6,1643,102,104,206,"21 de agosto de 1994"
25,9,6,1644,113,125,238,"21 de agosto de 1994"
25,9,6,1645,244,229,473,"21 de agosto de 1994"
25,9,6,1646,277,280,557,"21 de agosto de 1994"
25,9,6,1647,63,70,133,"21 de agosto de 1994"
25,9,6,1648,190,152,342,"21 de agosto de 1994"
25,9,6,1649,213,182,395,"21 de agosto de 1994"
25,9,6,1650,190,180,370,"21 de agosto de 1994"
25,9,6,1651,78,67,145,"21 de agosto de 1994"
25,9,6,1652,261,248,509,"21 de agosto de 1994"
25,9,6,1653,171,160,331,"21 de agosto de 1994"
25,9,6,1654,329,311,640,"21 de agosto de 1994"
25,9,6,1655,171,175,346,"21 de agosto de 1994"
25,9,6,1656,103,88,191,"21 de agosto de 1994"
25,9,6,1657,168,145,313,"21 de agosto de 1994"
25,9,6,1658,164,148,312,"21 de agosto de 1994"
25,9,6,1659,127,123,250,"21 de agosto de 1994"
25,9,6,1660,157,130,287,"21 de agosto de 1994"
25,9,6,1661,265,231,496,"21 de agosto de 1994"
25,9,6,1662,235,194,429,"21 de agosto de 1994"
25,9,6,1663,261,240,501,"21 de agosto de 1994"
25,9,6,1664,158,126,284,"21 de agosto de 1994"
25,9,6,1665,71,87,158,"21 de agosto de 1994"
25,9,6,1666,212,194,406,"21 de agosto de 1994"
25,9,6,1667,86,78,164,"21 de agosto de 1994"
25,9,6,1668,185,174,359,"21 de agosto de 1994"
25,9,6,1669,212,216,428,"21 de agosto de 1994"
25,9,6,1670,67,69,136,"21 de agosto de 1994"
25,9,6,1671,184,173,357,"21 de agosto de 1994"
25,9,6,1672,223,235,458,"21 de agosto de 1994"
25,9,6,1673,152,150,302,"21 de agosto de 1994"
25,9,6,1674,150,169,319,"21 de agosto de 1994"
25,9,6,1675,214,202,416,"21 de agosto de 1994"
25,9,6,1676,164,178,342,"21 de agosto de 1994"
25,9,6,1677,118,116,234,"21 de agosto de 1994"
25,9,6,1678,118,121,239,"21 de agosto de 1994"
25,9,6,1679,216,210,426,"21 de agosto de 1994"
25,9,6,1680,76,70,146,"21 de agosto de 1994"
25,9,6,1681,108,111,219,"21 de agosto de 1994"
25,9,6,1682,134,107,241,"21 de agosto de 1994"
25,9,6,1683,224,252,476,"21 de agosto de 1994"
25,9,6,1684,170,146,316,"21 de agosto de 1994"
25,9,6,1685,122,134,256,"21 de agosto de 1994"
25,9,6,1686,146,180,326,"21 de agosto de 1994"
25,9,6,1687,180,192,372,"21 de agosto de 1994"
25,9,6,1688,112,114,226,"21 de agosto de 1994"
25,9,6,1689,141,141,282,"21 de agosto de 1994"
25,9,6,1690,195,202,397,"21 de agosto de 1994"
25,9,6,1691,163,167,330,"21 de agosto de 1994"
25,9,6,1692,158,133,291,"21 de agosto de 1994"
25,9,6,1693,188,153,341,"21 de agosto de 1994"
25,9,6,1694,73,82,155,"21 de agosto de 1994"
25,9,6,1695,173,140,313,"21 de agosto de 1994"
25,9,6,1696,172,186,358,"21 de agosto de 1994"
25,9,6,1697,250,222,472,"21 de agosto de 1994"
25,9,6,1698,191,185,376,"21 de agosto de 1994"
25,9,6,1699,127,131,258,"21 de agosto de 1994"
25,9,6,1700,149,160,309,"21 de agosto de 1994"
25,9,6,1701,63,71,134,"21 de agosto de 1994"
25,9,6,1702,107,94,201,"21 de agosto de 1994"
25,9,6,1703,307,262,569,"21 de agosto de 1994"
25,9,6,1704,367,327,694,"21 de agosto de 1994"
25,9,6,1705,42,36,78,"21 de agosto de 1994"
25,9,6,1706,204,148,352,"21 de agosto de 1994"
25,9,6,1707,160,140,300,"21 de agosto de 1994"
25,9,6,1708,219,164,383,"21 de agosto de 1994"
25,9,6,1709,143,115,258,"21 de agosto de 1994"
25,9,6,1710,207,199,406,"21 de agosto de 1994"
25,9,6,1711,241,198,439,"21 de agosto de 1994"
25,9,6,1712,148,137,285,"21 de agosto de 1994"
25,9,6,1713,292,238,530,"21 de agosto de 1994"
25,9,6,1714,174,156,330,"21 de agosto de 1994"
25,9,6,1715,385,329,714,"21 de agosto de 1994"
25,9,6,1716,65,49,114,"21 de agosto de 1994"
25,9,6,1717,46,42,88,"21 de agosto de 1994"
25,9,6,1718,67,44,111,"21 de agosto de 1994"
25,9,6,1719,362,279,641,"21 de agosto de 1994"
25,9,6,1720,183,130,313,"21 de agosto de 1994"
25,9,6,1721,354,313,667,"21 de agosto de 1994"
25,9,6,1722,41,29,70,"21 de agosto de 1994"
25,9,6,1723,43,37,80,"21 de agosto de 1994"
25,9,6,1724,219,163,382,"21 de agosto de 1994"
25,9,6,1725,229,183,412,"21 de agosto de 1994"
26,1,1,1,531,451,982,"21 de agosto de 1994"
26,1,1,2,234,194,428,"21 de agosto de 1994"
26,1,2,3,573,555,1128,"21 de agosto de 1994"
26,1,2,4,268,214,482,"21 de agosto de 1994"
26,1,2,5,314,324,638,"21 de agosto de 1994"
26,1,2,6,639,650,1289,"21 de agosto de 1994"
26,1,2,7,687,595,1282,"21 de agosto de 1994"
26,1,2,8,647,688,1335,"21 de agosto de 1994"
26,1,2,9,668,686,1354,"21 de agosto de 1994"
26,1,2,10,758,781,1539,"21 de agosto de 1994"
26,1,2,11,534,616,1150,"21 de agosto de 1994"
26,1,2,12,537,574,1111,"21 de agosto de 1994"
26,1,2,13,609,592,1201,"21 de agosto de 1994"
26,1,2,14,646,697,1343,"21 de agosto de 1994"
26,1,2,15,466,485,951,"21 de agosto de 1994"
26,1,2,16,265,317,582,"21 de agosto de 1994"
26,1,2,17,171,146,317,"21 de agosto de 1994"
26,1,2,18,616,614,1230,"21 de agosto de 1994"
26,1,2,19,153,170,323,"21 de agosto de 1994"
26,1,2,20,729,675,1404,"21 de agosto de 1994"
26,1,2,21,544,539,1083,"21 de agosto de 1994"
26,1,2,22,832,832,1664,"21 de agosto de 1994"
26,1,2,23,515,428,943,"21 de agosto de 1994"
26,1,2,24,314,283,597,"21 de agosto de 1994"
26,1,2,25,915,889,1804,"21 de agosto de 1994"
26,1,2,26,105,115,220,"21 de agosto de 1994"
26,1,2,27,55,35,90,"21 de agosto de 1994"
26,1,2,28,67,43,110,"21 de agosto de 1994"
26,1,2,29,45,28,73,"21 de agosto de 1994"
26,1,2,30,121,99,220,"21 de agosto de 1994"
26,1,2,31,357,388,745,"21 de agosto de 1994"
26,1,2,32,92,93,185,"21 de agosto de 1994"
26,1,4,38,293,251,544,"21 de agosto de 1994"
26,1,4,39,131,106,237,"21 de agosto de 1994"
26,1,4,40,71,51,122,"21 de agosto de 1994"
26,1,5,41,245,242,487,"21 de agosto de 1994"
26,1,5,42,379,325,704,"21 de agosto de 1994"
26,1,5,43,138,138,276,"21 de agosto de 1994"
26,1,5,44,152,132,284,"21 de agosto de 1994"
26,1,5,45,145,97,242,"21 de agosto de 1994"
26,1,7,47,386,329,715,"21 de agosto de 1994"
26,1,8,48,236,188,424,"21 de agosto de 1994"
26,1,8,49,73,51,124,"21 de agosto de 1994"
26,1,8,50,39,32,71,"21 de agosto de 1994"
26,1,8,51,55,46,101,"21 de agosto de 1994"
26,1,9,52,364,352,716,"21 de agosto de 1994"
26,1,9,53,60,41,101,"21 de agosto de 1994"
26,1,10,54,403,364,767,"21 de agosto de 1994"
26,1,10,55,151,121,272,"21 de agosto de 1994"
26,1,11,56,364,309,673,"21 de agosto de 1994"
26,1,11,57,173,159,332,"21 de agosto de 1994"
26,1,12,58,379,346,725,"21 de agosto de 1994"
26,1,12,59,269,247,516,"21 de agosto de 1994"
26,1,12,60,137,106,243,"21 de agosto de 1994"
26,1,12,61,66,61,127,"21 de agosto de 1994"
26,1,12,62,106,95,201,"21 de agosto de 1994"
26,1,12,63,284,230,514,"21 de agosto de 1994"
26,1,13,64,245,217,462,"21 de agosto de 1994"
26,1,13,65,144,123,267,"21 de agosto de 1994"
26,1,15,70,641,638,1279,"21 de agosto de 1994"
26,1,15,71,618,600,1218,"21 de agosto de 1994"
26,1,15,72,604,670,1274,"21 de agosto de 1994"
26,1,15,73,827,714,1541,"21 de agosto de 1994"
26,1,15,74,639,643,1282,"21 de agosto de 1994"
26,1,15,75,442,419,861,"21 de agosto de 1994"
26,1,15,76,501,519,1020,"21 de agosto de 1994"
26,1,15,77,445,468,913,"21 de agosto de 1994"
26,1,15,78,538,519,1057,"21 de agosto de 1994"
26,1,15,79,344,398,742,"21 de agosto de 1994"
26,1,15,80,318,294,612,"21 de agosto de 1994"
26,1,15,81,448,461,909,"21 de agosto de 1994"
26,1,15,82,694,696,1390,"21 de agosto de 1994"
26,1,15,83,424,418,842,"21 de agosto de 1994"
26,1,15,84,696,621,1317,"21 de agosto de 1994"
26,1,15,85,321,295,616,"21 de agosto de 1994"
26,1,15,86,250,202,452,"21 de agosto de 1994"
26,1,15,87,99,90,189,"21 de agosto de 1994"
26,1,15,88,232,212,444,"21 de agosto de 1994"
26,1,16,89,268,221,489,"21 de agosto de 1994"
26,1,16,90,67,37,104,"21 de agosto de 1994"
26,1,16,91,44,27,71,"21 de agosto de 1994"
26,1,17,92,173,193,366,"21 de agosto de 1994"
26,1,17,93,364,376,740,"21 de agosto de 1994"
26,1,17,94,472,442,914,"21 de agosto de 1994"
26,1,17,95,78,65,143,"21 de agosto de 1994"
26,1,17,96,365,312,677,"21 de agosto de 1994"
26,1,17,97,321,278,599,"21 de agosto de 1994"
26,1,17,98,167,143,310,"21 de agosto de 1994"
26,1,17,99,243,210,453,"21 de agosto de 1994"
26,1,18,100,306,271,577,"21 de agosto de 1994"
26,1,19,101,480,386,866,"21 de agosto de 1994"
26,1,19,102,119,87,206,"21 de agosto de 1994"
26,1,19,103,383,320,703,"21 de agosto de 1994"
26,1,19,104,517,502,1019,"21 de agosto de 1994"
26,1,19,105,455,396,851,"21 de agosto de 1994"
26,1,20,106,420,363,783,"21 de agosto de 1994"
26,1,21,107,310,248,558,"21 de agosto de 1994"
26,1,21,108,111,96,207,"21 de agosto de 1994"
26,1,22,109,318,290,608,"21 de agosto de 1994"
26,1,23,110,320,303,623,"21 de agosto de 1994"
26,1,23,111,82,63,145,"21 de agosto de 1994"
26,1,24,112,185,212,397,"21 de agosto de 1994"
26,1,24,113,675,687,1362,"21 de agosto de 1994"
26,1,24,114,316,341,657,"21 de agosto de 1994"
26,1,24,115,421,398,819,"21 de agosto de 1994"
26,1,24,116,432,407,839,"21 de agosto de 1994"
26,1,24,117,107,86,193,"21 de agosto de 1994"
26,1,24,118,38,17,55,"21 de agosto de 1994"
26,1,24,119,23,17,40,"21 de agosto de 1994"
26,1,24,120,30,21,51,"21 de agosto de 1994"
26,1,24,121,112,102,214,"21 de agosto de 1994"
26,1,24,122,163,181,344,"21 de agosto de 1994"
26,1,25,123,340,378,718,"21 de agosto de 1994"
26,1,25,124,272,305,577,"21 de agosto de 1994"
26,1,25,125,501,498,999,"21 de agosto de 1994"
26,1,25,126,706,729,1435,"21 de agosto de 1994"
26,1,25,127,469,523,992,"21 de agosto de 1994"
26,1,25,128,645,634,1279,"21 de agosto de 1994"
26,1,25,129,615,679,1294,"21 de agosto de 1994"
26,1,25,130,533,518,1051,"21 de agosto de 1994"
26,1,25,131,741,715,1456,"21 de agosto de 1994"
26,1,25,132,416,473,889,"21 de agosto de 1994"
26,1,25,133,526,508,1034,"21 de agosto de 1994"
26,1,25,134,189,135,324,"21 de agosto de 1994"
26,1,25,135,127,115,242,"21 de agosto de 1994"
26,1,25,136,502,451,953,"21 de agosto de 1994"
26,1,25,137,77,51,128,"21 de agosto de 1994"
26,1,26,138,568,569,1137,"21 de agosto de 1994"
26,1,26,139,275,272,547,"21 de agosto de 1994"
26,1,26,140,429,412,841,"21 de agosto de 1994"
26,1,26,141,74,55,129,"21 de agosto de 1994"
26,1,27,142,282,305,587,"21 de agosto de 1994"
26,1,27,143,288,270,558,"21 de agosto de 1994"
26,1,27,144,367,340,707,"21 de agosto de 1994"
26,1,27,145,330,334,664,"21 de agosto de 1994"
26,1,28,146,434,367,801,"21 de agosto de 1994"
26,1,28,147,190,164,354,"21 de agosto de 1994"
26,1,28,148,38,49,87,"21 de agosto de 1994"
26,1,29,149,327,314,641,"21 de agosto de 1994"
26,1,29,150,473,298,771,"21 de agosto de 1994"
26,1,29,151,460,393,853,"21 de agosto de 1994"
26,1,29,152,484,436,920,"21 de agosto de 1994"
26,1,29,153,398,273,671,"21 de agosto de 1994"
26,1,29,154,198,169,367,"21 de agosto de 1994"
26,1,29,155,287,275,562,"21 de agosto de 1994"
26,1,29,156,414,329,743,"21 de agosto de 1994"
26,1,29,157,516,446,962,"21 de agosto de 1994"
26,1,29,158,518,268,786,"21 de agosto de 1994"
26,1,30,159,474,489,963,"21 de agosto de 1994"
26,1,30,160,185,167,352,"21 de agosto de 1994"
26,1,30,161,394,394,788,"21 de agosto de 1994"
26,1,30,162,667,702,1369,"21 de agosto de 1994"
26,1,30,163,613,623,1236,"21 de agosto de 1994"
26,1,30,164,354,342,696,"21 de agosto de 1994"
26,1,30,165,577,580,1157,"21 de agosto de 1994"
26,1,30,166,297,294,591,"21 de agosto de 1994"
26,1,30,167,438,434,872,"21 de agosto de 1994"
26,1,30,168,312,331,643,"21 de agosto de 1994"
26,1,30,169,332,293,625,"21 de agosto de 1994"
26,1,30,170,487,479,966,"21 de agosto de 1994"
26,1,30,171,656,706,1362,"21 de agosto de 1994"
26,1,30,172,390,413,803,"21 de agosto de 1994"
26,1,30,173,361,439,800,"21 de agosto de 1994"
26,1,30,174,391,443,834,"21 de agosto de 1994"
26,1,30,175,655,622,1277,"21 de agosto de 1994"
26,1,30,176,295,332,627,"21 de agosto de 1994"
26,1,30,177,295,285,580,"21 de agosto de 1994"
26,1,30,178,580,670,1250,"21 de agosto de 1994"
26,1,30,179,382,412,794,"21 de agosto de 1994"
26,1,30,180,241,235,476,"21 de agosto de 1994"
26,1,30,181,291,289,580,"21 de agosto de 1994"
26,1,30,182,463,483,946,"21 de agosto de 1994"
26,1,30,183,360,420,780,"21 de agosto de 1994"
26,1,30,184,412,443,855,"21 de agosto de 1994"
26,1,30,185,474,456,930,"21 de agosto de 1994"
26,1,30,186,227,173,400,"21 de agosto de 1994"
26,1,30,187,68,51,119,"21 de agosto de 1994"
26,1,30,188,747,765,1512,"21 de agosto de 1994"
26,1,30,189,440,420,860,"21 de agosto de 1994"
26,1,30,190,315,325,640,"21 de agosto de 1994"
26,1,30,191,427,429,856,"21 de agosto de 1994"
26,1,30,192,623,662,1285,"21 de agosto de 1994"
26,1,30,193,253,256,509,"21 de agosto de 1994"
26,1,30,194,382,378,760,"21 de agosto de 1994"
26,1,30,195,437,460,897,"21 de agosto de 1994"
26,1,30,196,516,536,1052,"21 de agosto de 1994"
26,1,30,197,296,313,609,"21 de agosto de 1994"
26,1,30,198,425,410,835,"21 de agosto de 1994"
26,1,30,199,831,737,1568,"21 de agosto de 1994"
26,1,30,200,486,507,993,"21 de agosto de 1994"
26,1,30,201,749,749,1498,"21 de agosto de 1994"
26,1,30,202,485,496,981,"21 de agosto de 1994"
26,1,30,203,281,370,651,"21 de agosto de 1994"
26,1,30,204,449,453,902,"21 de agosto de 1994"
26,1,30,205,647,593,1240,"21 de agosto de 1994"
26,1,30,206,452,414,866,"21 de agosto de 1994"
26,1,30,207,559,547,1106,"21 de agosto de 1994"
26,1,30,208,541,486,1027,"21 de agosto de 1994"
26,1,30,209,445,475,920,"21 de agosto de 1994"
26,1,30,210,793,804,1597,"21 de agosto de 1994"
26,1,30,211,831,807,1638,"21 de agosto de 1994"
26,1,30,212,417,439,856,"21 de agosto de 1994"
26,1,30,213,455,392,847,"21 de agosto de 1994"
26,1,30,214,517,476,993,"21 de agosto de 1994"
26,1,30,215,684,670,1354,"21 de agosto de 1994"
26,1,30,216,536,543,1079,"21 de agosto de 1994"
26,1,30,217,604,616,1220,"21 de agosto de 1994"
26,1,30,218,455,477,932,"21 de agosto de 1994"
26,1,30,219,785,277,1062,"21 de agosto de 1994"
26,1,30,220,502,530,1032,"21 de agosto de 1994"
26,1,30,221,624,614,1238,"21 de agosto de 1994"
26,1,30,222,447,438,885,"21 de agosto de 1994"
26,1,30,223,627,427,1054,"21 de agosto de 1994"
26,1,30,224,659,695,1354,"21 de agosto de 1994"
26,1,30,225,623,662,1285,"21 de agosto de 1994"
26,1,30,226,359,405,764,"21 de agosto de 1994"
26,1,30,227,917,951,1868,"21 de agosto de 1994"
26,1,30,228,164,120,284,"21 de agosto de 1994"
26,1,30,229,309,285,594,"21 de agosto de 1994"
26,1,30,230,54,35,89,"21 de agosto de 1994"
26,1,30,231,668,683,1351,"21 de agosto de 1994"
26,1,32,233,321,316,637,"21 de agosto de 1994"
26,1,32,234,361,335,696,"21 de agosto de 1994"
26,1,32,235,570,537,1107,"21 de agosto de 1994"
26,1,32,236,74,64,138,"21 de agosto de 1994"
26,1,32,237,77,57,134,"21 de agosto de 1994"
26,1,32,238,74,53,127,"21 de agosto de 1994"
26,1,32,239,68,62,130,"21 de agosto de 1994"
26,1,32,240,146,129,275,"21 de agosto de 1994"
26,1,32,241,48,46,94,"21 de agosto de 1994"
26,1,32,242,34,26,60,"21 de agosto de 1994"
26,1,32,243,87,67,154,"21 de agosto de 1994"
26,1,32,244,40,32,72,"21 de agosto de 1994"
26,1,32,245,54,40,94,"21 de agosto de 1994"
26,1,32,246,95,96,191,"21 de agosto de 1994"
26,1,33,247,166,141,307,"21 de agosto de 1994"
26,1,35,249,431,381,812,"21 de agosto de 1994"
26,1,35,250,52,24,76,"21 de agosto de 1994"
26,1,35,251,157,121,278,"21 de agosto de 1994"
26,1,37,264,454,373,827,"21 de agosto de 1994"
26,1,41,274,248,268,516,"21 de agosto de 1994"
26,1,41,275,210,227,437,"21 de agosto de 1994"
26,1,41,276,33,25,58,"21 de agosto de 1994"
26,1,41,277,7,6,13,"21 de agosto de 1994"
26,1,44,286,253,213,466,"21 de agosto de 1994"
26,1,44,287,286,256,542,"21 de agosto de 1994"
26,1,44,288,117,92,209,"21 de agosto de 1994"
26,1,45,289,329,279,608,"21 de agosto de 1994"
26,1,45,290,138,107,245,"21 de agosto de 1994"
26,1,45,291,168,136,304,"21 de agosto de 1994"
26,2,49,336,798,833,1631,"21 de agosto de 1994"
26,2,49,337,836,874,1710,"21 de agosto de 1994"
26,2,49,338,562,625,1187,"21 de agosto de 1994"
26,2,49,339,484,482,966,"21 de agosto de 1994"
26,2,49,340,633,623,1256,"21 de agosto de 1994"
26,2,49,341,982,1026,2008,"21 de agosto de 1994"
26,2,49,342,745,791,1536,"21 de agosto de 1994"
26,2,49,343,810,865,1675,"21 de agosto de 1994"
26,2,49,344,509,552,1061,"21 de agosto de 1994"
26,2,49,345,752,819,1571,"21 de agosto de 1994"
26,2,49,346,350,374,724,"21 de agosto de 1994"
26,2,49,347,623,615,1238,"21 de agosto de 1994"
26,2,49,348,465,487,952,"21 de agosto de 1994"
26,2,49,349,386,390,776,"21 de agosto de 1994"
26,2,49,350,645,703,1348,"21 de agosto de 1994"
26,2,49,351,679,740,1419,"21 de agosto de 1994"
26,2,49,352,608,658,1266,"21 de agosto de 1994"
26,2,49,353,401,404,805,"21 de agosto de 1994"
26,2,49,354,441,461,902,"21 de agosto de 1994"
26,2,49,355,456,528,984,"21 de agosto de 1994"
26,2,49,356,458,509,967,"21 de agosto de 1994"
26,2,49,357,569,598,1167,"21 de agosto de 1994"
26,2,49,358,511,534,1045,"21 de agosto de 1994"
26,2,49,359,768,875,1643,"21 de agosto de 1994"
26,2,49,360,492,531,1023,"21 de agosto de 1994"
26,2,49,361,378,381,759,"21 de agosto de 1994"
26,2,49,362,597,592,1189,"21 de agosto de 1994"
26,2,49,363,293,314,607,"21 de agosto de 1994"
26,2,49,364,513,534,1047,"21 de agosto de 1994"
26,2,49,365,688,693,1381,"21 de agosto de 1994"
26,2,49,366,507,580,1087,"21 de agosto de 1994"
26,2,49,367,541,616,1157,"21 de agosto de 1994"
26,2,49,368,372,388,760,"21 de agosto de 1994"
26,2,49,369,462,488,950,"21 de agosto de 1994"
26,2,49,370,436,479,915,"21 de agosto de 1994"
26,2,49,371,361,372,733,"21 de agosto de 1994"
26,2,49,372,466,518,984,"21 de agosto de 1994"
26,2,49,373,532,545,1077,"21 de agosto de 1994"
26,2,49,374,502,507,1009,"21 de agosto de 1994"
26,2,49,375,364,407,771,"21 de agosto de 1994"
26,2,49,376,746,761,1507,"21 de agosto de 1994"
26,2,49,377,685,716,1401,"21 de agosto de 1994"
26,2,49,378,542,584,1126,"21 de agosto de 1994"
26,2,49,379,486,483,969,"21 de agosto de 1994"
26,2,49,380,478,476,954,"21 de agosto de 1994"
26,2,49,381,552,580,1132,"21 de agosto de 1994"
26,2,49,382,747,804,1551,"21 de agosto de 1994"
26,2,49,383,278,322,600,"21 de agosto de 1994"
26,2,49,384,339,395,734,"21 de agosto de 1994"
26,2,49,385,496,536,1032,"21 de agosto de 1994"
26,2,49,386,478,542,1020,"21 de agosto de 1994"
26,2,49,387,544,609,1153,"21 de agosto de 1994"
26,2,49,388,370,411,781,"21 de agosto de 1994"
26,2,49,389,532,536,1068,"21 de agosto de 1994"
26,2,49,390,856,880,1736,"21 de agosto de 1994"
26,2,49,391,1002,55,1057,"21 de agosto de 1994"
26,2,49,392,587,708,1295,"21 de agosto de 1994"
26,2,49,393,497,583,1080,"21 de agosto de 1994"
26,2,49,394,797,858,1655,"21 de agosto de 1994"
26,2,49,395,476,483,959,"21 de agosto de 1994"
26,2,49,396,601,600,1201,"21 de agosto de 1994"
26,2,49,397,514,605,1119,"21 de agosto de 1994"
26,2,49,398,686,708,1394,"21 de agosto de 1994"
26,2,49,399,401,505,906,"21 de agosto de 1994"
26,2,49,400,351,326,677,"21 de agosto de 1994"
26,2,49,401,617,654,1271,"21 de agosto de 1994"
26,2,49,402,601,619,1220,"21 de agosto de 1994"
26,2,49,403,283,320,603,"21 de agosto de 1994"
26,2,49,404,475,465,940,"21 de agosto de 1994"
26,2,49,405,457,485,942,"21 de agosto de 1994"
26,2,49,406,619,677,1296,"21 de agosto de 1994"
26,2,49,407,517,533,1050,"21 de agosto de 1994"
26,2,49,408,547,577,1124,"21 de agosto de 1994"
26,2,49,409,602,644,1246,"21 de agosto de 1994"
26,2,49,410,593,631,1224,"21 de agosto de 1994"
26,2,49,411,646,718,1364,"21 de agosto de 1994"
26,2,49,412,454,480,934,"21 de agosto de 1994"
26,2,49,413,553,609,1162,"21 de agosto de 1994"
26,2,49,414,693,753,1446,"21 de agosto de 1994"
26,2,49,415,520,519,1039,"21 de agosto de 1994"
26,2,49,416,482,482,964,"21 de agosto de 1994"
26,2,49,417,333,338,671,"21 de agosto de 1994"
26,2,49,418,648,710,1358,"21 de agosto de 1994"
26,2,49,419,624,775,1399,"21 de agosto de 1994"
26,2,49,420,535,586,1121,"21 de agosto de 1994"
26,2,49,421,659,710,1369,"21 de agosto de 1994"
26,2,49,422,397,425,822,"21 de agosto de 1994"
26,2,49,423,569,637,1206,"21 de agosto de 1994"
26,2,49,424,656,747,1403,"21 de agosto de 1994"
26,2,49,425,527,555,1082,"21 de agosto de 1994"
26,2,49,426,438,423,861,"21 de agosto de 1994"
26,2,49,427,649,634,1283,"21 de agosto de 1994"
26,2,49,428,339,368,707,"21 de agosto de 1994"
26,2,49,429,258,283,541,"21 de agosto de 1994"
26,2,49,430,591,568,1159,"21 de agosto de 1994"
26,2,49,431,665,657,1322,"21 de agosto de 1994"
26,2,49,432,315,340,655,"21 de agosto de 1994"
26,2,49,433,693,737,1430,"21 de agosto de 1994"
26,2,49,434,770,785,1555,"21 de agosto de 1994"
26,2,49,435,494,497,991,"21 de agosto de 1994"
26,2,49,436,372,388,760,"21 de agosto de 1994"
26,2,49,437,434,476,910,"21 de agosto de 1994"
26,2,49,438,650,692,1342,"21 de agosto de 1994"
26,2,49,439,658,732,1390,"21 de agosto de 1994"
26,2,49,440,461,565,1026,"21 de agosto de 1994"
26,2,49,441,428,554,982,"21 de agosto de 1994"
26,2,49,442,680,742,1422,"21 de agosto de 1994"
26,2,49,443,601,628,1229,"21 de agosto de 1994"
26,2,49,444,568,585,1153,"21 de agosto de 1994"
26,2,49,445,372,421,793,"21 de agosto de 1994"
26,2,49,446,372,400,772,"21 de agosto de 1994"
26,2,49,447,353,417,770,"21 de agosto de 1994"
26,2,49,448,643,673,1316,"21 de agosto de 1994"
26,2,49,449,652,691,1343,"21 de agosto de 1994"
26,2,49,450,494,489,983,"21 de agosto de 1994"
26,2,49,451,557,584,1141,"21 de agosto de 1994"
26,2,49,452,760,794,1554,"21 de agosto de 1994"
26,2,49,453,397,447,844,"21 de agosto de 1994"
26,2,49,454,524,606,1130,"21 de agosto de 1994"
26,2,49,455,296,350,646,"21 de agosto de 1994"
26,2,49,456,627,695,1322,"21 de agosto de 1994"
26,2,49,457,352,366,718,"21 de agosto de 1994"
26,2,49,458,363,467,830,"21 de agosto de 1994"
26,2,49,459,495,577,1072,"21 de agosto de 1994"
26,2,49,460,543,609,1152,"21 de agosto de 1994"
26,2,49,461,497,562,1059,"21 de agosto de 1994"
26,2,49,462,405,463,868,"21 de agosto de 1994"
26,2,49,463,832,782,1614,"21 de agosto de 1994"
26,2,49,464,559,541,1100,"21 de agosto de 1994"
26,2,49,465,675,683,1358,"21 de agosto de 1994"
26,2,49,466,350,419,769,"21 de agosto de 1994"
26,2,49,467,469,464,933,"21 de agosto de 1994"
26,2,49,468,754,770,1524,"21 de agosto de 1994"
26,2,49,469,262,320,582,"21 de agosto de 1994"
26,2,49,470,357,386,743,"21 de agosto de 1994"
26,2,49,471,685,729,1414,"21 de agosto de 1994"
26,2,49,472,548,610,1158,"21 de agosto de 1994"
26,2,49,473,466,528,994,"21 de agosto de 1994"
26,2,49,474,555,621,1176,"21 de agosto de 1994"
26,2,49,475,513,531,1044,"21 de agosto de 1994"
26,2,49,476,422,479,901,"21 de agosto de 1994"
26,2,49,477,511,566,1077,"21 de agosto de 1994"
26,2,49,478,412,394,806,"21 de agosto de 1994"
26,2,49,479,351,405,756,"21 de agosto de 1994"
26,2,49,480,353,350,703,"21 de agosto de 1994"
26,2,49,481,312,391,703,"21 de agosto de 1994"
26,2,49,482,453,466,919,"21 de agosto de 1994"
26,2,49,483,395,439,834,"21 de agosto de 1994"
26,2,49,484,858,860,1718,"21 de agosto de 1994"
26,2,49,485,448,472,920,"21 de agosto de 1994"
26,2,49,486,609,612,1221,"21 de agosto de 1994"
26,2,49,487,581,564,1145,"21 de agosto de 1994"
26,2,49,488,578,534,1112,"21 de agosto de 1994"
26,2,49,489,401,383,784,"21 de agosto de 1994"
26,2,49,490,593,630,1223,"21 de agosto de 1994"
26,2,49,491,429,418,847,"21 de agosto de 1994"
26,2,49,492,502,476,978,"21 de agosto de 1994"
26,2,49,493,365,420,785,"21 de agosto de 1994"
26,2,49,494,354,392,746,"21 de agosto de 1994"
26,2,49,495,601,565,1166,"21 de agosto de 1994"
26,2,49,496,729,730,1459,"21 de agosto de 1994"
26,2,49,497,268,235,503,"21 de agosto de 1994"
26,2,49,498,491,566,1057,"21 de agosto de 1994"
26,3,58,760,620,630,1250,"21 de agosto de 1994"
26,3,58,761,559,538,1097,"21 de agosto de 1994"
26,3,58,762,549,493,1042,"21 de agosto de 1994"
26,3,58,763,182,179,361,"21 de agosto de 1994"
26,3,58,764,274,292,566,"21 de agosto de 1994"
26,3,58,765,662,610,1272,"21 de agosto de 1994"
26,3,58,766,639,643,1282,"21 de agosto de 1994"
26,3,58,767,604,576,1180,"21 de agosto de 1994"
26,3,58,768,520,499,1019,"21 de agosto de 1994"
26,3,58,769,433,441,874,"21 de agosto de 1994"
26,3,58,770,365,334,699,"21 de agosto de 1994"
26,3,58,771,541,506,1047,"21 de agosto de 1994"
26,3,58,772,370,330,700,"21 de agosto de 1994"
26,3,60,992,347,373,720,"21 de agosto de 1994"
26,3,60,993,402,402,804,"21 de agosto de 1994"
26,3,60,994,456,505,961,"21 de agosto de 1994"
26,3,60,995,457,477,934,"21 de agosto de 1994"
26,3,60,996,511,515,1026,"21 de agosto de 1994"
26,3,60,997,297,290,587,"21 de agosto de 1994"
26,3,60,998,578,586,1164,"21 de agosto de 1994"
26,3,60,999,456,475,931,"21 de agosto de 1994"
26,3,60,1000,614,622,1236,"21 de agosto de 1994"
26,3,60,1001,565,571,1136,"21 de agosto de 1994"
26,3,60,1002,417,416,833,"21 de agosto de 1994"
26,3,60,1003,439,440,879,"21 de agosto de 1994"
26,3,60,1004,603,583,1186,"21 de agosto de 1994"
26,3,60,1005,195,251,446,"21 de agosto de 1994"
26,3,60,1006,501,457,958,"21 de agosto de 1994"
26,3,60,1007,498,537,1035,"21 de agosto de 1994"
26,3,60,1008,371,404,775,"21 de agosto de 1994"
26,3,60,1009,464,513,977,"21 de agosto de 1994"
26,3,60,1010,558,594,1152,"21 de agosto de 1994"
26,3,60,1011,510,517,1027,"21 de agosto de 1994"
26,3,60,1012,375,365,740,"21 de agosto de 1994"
26,3,60,1013,559,558,1117,"21 de agosto de 1994"
26,3,60,1014,584,619,1203,"21 de agosto de 1994"
26,3,60,1015,647,573,1220,"21 de agosto de 1994"
26,3,60,1016,338,282,620,"21 de agosto de 1994"
26,3,60,1017,619,598,1217,"21 de agosto de 1994"
26,3,60,1018,275,261,536,"21 de agosto de 1994"
26,3,60,1019,232,183,415,"21 de agosto de 1994"
26,3,60,1020,406,355,761,"21 de agosto de 1994"
26,3,60,1021,324,298,622,"21 de agosto de 1994"
26,3,61,1022,576,619,1195,"21 de agosto de 1994"
26,3,61,1023,443,474,917,"21 de agosto de 1994"
26,3,61,1024,413,477,890,"21 de agosto de 1994"
26,3,61,1025,284,303,587,"21 de agosto de 1994"
26,3,61,1026,431,456,887,"21 de agosto de 1994"
26,3,61,1027,502,545,1047,"21 de agosto de 1994"
26,3,61,1028,757,855,1612,"21 de agosto de 1994"
26,3,61,1029,655,585,1240,"21 de agosto de 1994"
26,3,61,1030,152,168,320,"21 de agosto de 1994"
26,3,61,1031,675,387,1062,"21 de agosto de 1994"
26,3,61,1032,456,474,930,"21 de agosto de 1994"
26,3,61,1033,101,106,207,"21 de agosto de 1994"
26,3,61,1034,608,654,1262,"21 de agosto de 1994"
26,3,61,1035,633,594,1227,"21 de agosto de 1994"
26,3,61,1036,485,494,979,"21 de agosto de 1994"
26,3,61,1037,387,405,792,"21 de agosto de 1994"
26,3,61,1038,474,464,938,"21 de agosto de 1994"
26,3,61,1039,605,617,1222,"21 de agosto de 1994"
26,3,61,1040,512,539,1051,"21 de agosto de 1994"
26,3,61,1041,311,338,649,"21 de agosto de 1994"
26,3,61,1042,117,127,244,"21 de agosto de 1994"
26,3,61,1043,421,438,859,"21 de agosto de 1994"
26,3,61,1044,529,561,1090,"21 de agosto de 1994"
26,3,61,1045,535,561,1096,"21 de agosto de 1994"
26,3,61,1046,410,418,828,"21 de agosto de 1994"
26,3,61,1047,738,743,1481,"21 de agosto de 1994"
26,3,61,1048,718,763,1481,"21 de agosto de 1994"
26,3,61,1049,395,408,803,"21 de agosto de 1994"
26,3,61,1050,382,354,736,"21 de agosto de 1994"
26,3,61,1051,778,772,1550,"21 de agosto de 1994"
26,3,61,1052,259,287,546,"21 de agosto de 1994"
26,3,61,1053,420,382,802,"21 de agosto de 1994"
26,3,61,1054,538,547,1085,"21 de agosto de 1994"
26,3,61,1055,326,354,680,"21 de agosto de 1994"
26,3,61,1056,607,652,1259,"21 de agosto de 1994"
26,3,61,1057,310,319,629,"21 de agosto de 1994"
26,3,61,1058,218,220,438,"21 de agosto de 1994"
26,3,61,1059,403,482,885,"21 de agosto de 1994"
26,3,61,1060,340,362,702,"21 de agosto de 1994"
26,3,61,1061,433,463,896,"21 de agosto de 1994"
26,3,61,1062,506,540,1046,"21 de agosto de 1994"
26,3,61,1063,279,302,581,"21 de agosto de 1994"
26,3,61,1064,546,568,1114,"21 de agosto de 1994"
26,3,61,1065,453,476,929,"21 de agosto de 1994"
26,3,61,1066,608,618,1226,"21 de agosto de 1994"
26,3,61,1067,605,612,1217,"21 de agosto de 1994"
26,3,61,1068,597,609,1206,"21 de agosto de 1994"
26,3,61,1069,576,629,1205,"21 de agosto de 1994"
26,3,61,1070,541,544,1085,"21 de agosto de 1994"
26,3,61,1071,582,575,1157,"21 de agosto de 1994"
26,3,61,1072,528,543,1071,"21 de agosto de 1994"
26,3,61,1073,581,616,1197,"21 de agosto de 1994"
26,3,61,1074,186,190,376,"21 de agosto de 1994"
26,3,61,1075,410,470,880,"21 de agosto de 1994"
26,3,61,1076,489,567,1056,"21 de agosto de 1994"
26,3,61,1077,31,40,71,"21 de agosto de 1994"
26,3,61,1078,251,246,497,"21 de agosto de 1994"
26,3,61,1079,168,175,343,"21 de agosto de 1994"
26,3,61,1080,366,433,799,"21 de agosto de 1994"
26,3,61,1081,375,391,766,"21 de agosto de 1994"
26,3,61,1082,452,409,861,"21 de agosto de 1994"
26,3,61,1083,451,389,840,"21 de agosto de 1994"
26,3,61,1084,503,385,888,"21 de agosto de 1994"
26,3,61,1085,326,243,569,"21 de agosto de 1994"
26,3,61,1086,54,40,94,"21 de agosto de 1994"
26,3,61,1087,176,135,311,"21 de agosto de 1994"
26,3,61,1088,202,181,383,"21 de agosto de 1994"
26,3,61,1089,529,452,981,"21 de agosto de 1994"
26,3,61,1090,518,505,1023,"21 de agosto de 1994"
26,3,61,1091,355,324,679,"21 de agosto de 1994"
26,3,61,1092,282,270,552,"21 de agosto de 1994"
26,3,61,1093,383,388,771,"21 de agosto de 1994"
26,3,61,1094,618,608,1226,"21 de agosto de 1994"
26,3,61,1095,457,485,942,"21 de agosto de 1994"
26,3,61,1096,398,369,767,"21 de agosto de 1994"
26,3,61,1097,598,568,1166,"21 de agosto de 1994"
26,3,61,1098,751,702,1453,"21 de agosto de 1994"
26,3,61,1099,200,170,370,"21 de agosto de 1994"
26,3,61,1100,353,342,695,"21 de agosto de 1994"
26,3,61,1101,206,192,398,"21 de agosto de 1994"
26,3,61,1102,530,526,1056,"21 de agosto de 1994"
26,3,61,1103,416,392,808,"21 de agosto de 1994"
26,3,61,1104,413,424,837,"21 de agosto de 1994"
26,3,61,1105,591,578,1169,"21 de agosto de 1994"
26,3,61,1106,539,477,1016,"21 de agosto de 1994"
26,3,61,1107,663,597,1260,"21 de agosto de 1994"
26,3,61,1108,296,233,529,"21 de agosto de 1994"
26,4,63,1138,420,412,832,"21 de agosto de 1994"
26,4,63,1139,387,395,782,"21 de agosto de 1994"
26,4,63,1140,609,604,1213,"21 de agosto de 1994"
26,4,63,1141,388,395,783,"21 de agosto de 1994"
26,4,63,1142,421,443,864,"21 de agosto de 1994"
26,4,63,1143,170,166,336,"21 de agosto de 1994"
26,4,63,1144,91,78,169,"21 de agosto de 1994"
26,4,63,1145,520,373,893,"21 de agosto de 1994"
26,4,63,1146,489,480,969,"21 de agosto de 1994"
26,4,63,1147,579,534,1113,"21 de agosto de 1994"
26,4,63,1148,629,633,1262,"21 de agosto de 1994"
26,4,63,1149,582,599,1181,"21 de agosto de 1994"
26,4,63,1150,770,839,1609,"21 de agosto de 1994"
26,4,63,1151,618,625,1243,"21 de agosto de 1994"
26,4,63,1152,491,535,1026,"21 de agosto de 1994"
26,4,63,1153,283,237,520,"21 de agosto de 1994"
26,4,63,1154,372,346,718,"21 de agosto de 1994"
26,4,63,1155,455,429,884,"21 de agosto de 1994"
26,4,63,1156,500,504,1004,"21 de agosto de 1994"
26,4,63,1157,211,181,392,"21 de agosto de 1994"
26,4,63,1158,513,478,991,"21 de agosto de 1994"
26,4,63,1159,563,413,976,"21 de agosto de 1994"
26,4,63,1160,339,319,658,"21 de agosto de 1994"
26,4,63,1161,341,286,627,"21 de agosto de 1994"
26,4,63,1162,342,303,645,"21 de agosto de 1994"
26,4,63,1163,443,375,818,"21 de agosto de 1994"
26,4,63,1164,188,151,339,"21 de agosto de 1994"
26,4,63,1165,464,487,951,"21 de agosto de 1994"
26,4,63,1166,435,391,826,"21 de agosto de 1994"
26,4,63,1167,387,387,774,"21 de agosto de 1994"
26,4,63,1168,632,609,1241,"21 de agosto de 1994"
26,4,63,1169,205,197,402,"21 de agosto de 1994"
26,4,63,1170,539,574,1113,"21 de agosto de 1994"
26,4,63,1171,431,442,873,"21 de agosto de 1994"
26,4,63,1172,274,294,568,"21 de agosto de 1994"
26,4,63,1173,248,266,514,"21 de agosto de 1994"
26,4,63,1174,750,705,1455,"21 de agosto de 1994"
26,4,63,1175,157,125,282,"21 de agosto de 1994"
26,4,63,1176,352,320,672,"21 de agosto de 1994"
26,4,63,1177,72,57,129,"21 de agosto de 1994"
26,4,63,1178,800,820,1620,"21 de agosto de 1994"
26,4,63,1179,288,226,514,"21 de agosto de 1994"
26,4,63,1180,326,288,614,"21 de agosto de 1994"
26,4,63,1181,648,602,1250,"21 de agosto de 1994"
26,4,63,1182,480,412,892,"21 de agosto de 1994"
26,4,63,1183,649,590,1239,"21 de agosto de 1994"
26,4,63,1184,768,659,1427,"21 de agosto de 1994"
26,4,63,1185,319,288,607,"21 de agosto de 1994"
26,4,63,1186,430,432,862,"21 de agosto de 1994"
26,4,63,1187,366,553,919,"21 de agosto de 1994"
26,4,63,1188,385,466,851,"21 de agosto de 1994"
26,4,64,1189,503,504,1007,"21 de agosto de 1994"
26,4,64,1190,743,815,1558,"21 de agosto de 1994"
26,4,64,1191,506,542,1048,"21 de agosto de 1994"
26,4,64,1192,642,661,1303,"21 de agosto de 1994"
26,4,64,1193,527,553,1080,"21 de agosto de 1994"
26,4,64,1194,498,569,1067,"21 de agosto de 1994"
26,4,64,1195,557,592,1149,"21 de agosto de 1994"
26,4,64,1196,231,236,467,"21 de agosto de 1994"
26,4,64,1197,656,654,1310,"21 de agosto de 1994"
26,4,64,1198,413,421,834,"21 de agosto de 1994"
26,4,64,1199,720,840,1560,"21 de agosto de 1994"
26,4,64,1200,240,270,510,"21 de agosto de 1994"
26,4,64,1201,646,658,1304,"21 de agosto de 1994"
26,4,64,1202,438,485,923,"21 de agosto de 1994"
26,4,64,1203,685,718,1403,"21 de agosto de 1994"
26,4,64,1204,353,302,655,"21 de agosto de 1994"
26,4,64,1205,508,484,992,"21 de agosto de 1994"
26,4,64,1206,369,369,738,"21 de agosto de 1994"
26,4,64,1207,427,415,842,"21 de agosto de 1994"
26,4,64,1208,459,380,839,"21 de agosto de 1994"
26,4,64,1209,599,545,1144,"21 de agosto de 1994"
26,4,64,1210,435,388,823,"21 de agosto de 1994"
26,4,64,1211,653,661,1314,"21 de agosto de 1994"
26,4,64,1212,694,700,1394,"21 de agosto de 1994"
26,4,64,1213,751,716,1467,"21 de agosto de 1994"
26,4,64,1214,206,165,371,"21 de agosto de 1994"
26,4,64,1215,682,633,1315,"21 de agosto de 1994"
26,4,64,1216,716,678,1394,"21 de agosto de 1994"
26,4,64,1217,757,667,1424,"21 de agosto de 1994"
26,4,64,1218,773,722,1495,"21 de agosto de 1994"
26,4,64,1219,350,319,669,"21 de agosto de 1994"
26,4,64,1220,554,503,1057,"21 de agosto de 1994"
26,4,64,1221,501,476,977,"21 de agosto de 1994"
26,4,64,1222,371,268,639,"21 de agosto de 1994"
26,4,64,1223,189,160,349,"21 de agosto de 1994"
26,4,64,1224,487,486,973,"21 de agosto de 1994"
26,4,64,1225,534,496,1030,"21 de agosto de 1994"
26,4,64,1226,530,518,1048,"21 de agosto de 1994"
26,4,64,1227,190,159,349,"21 de agosto de 1994"
26,4,64,1228,677,612,1289,"21 de agosto de 1994"
26,4,64,1229,376,394,770,"21 de agosto de 1994"
26,4,65,1230,616,612,1228,"21 de agosto de 1994"
26,4,65,1231,352,409,761,"21 de agosto de 1994"
26,4,65,1232,654,699,1353,"21 de agosto de 1994"
26,4,65,1233,433,493,926,"21 de agosto de 1994"
26,4,65,1234,666,641,1307,"21 de agosto de 1994"
26,4,65,1235,429,472,901,"21 de agosto de 1994"
26,4,65,1236,676,741,1417,"21 de agosto de 1994"
26,4,65,1237,437,491,928,"21 de agosto de 1994"
26,4,65,1238,420,429,849,"21 de agosto de 1994"
26,4,65,1239,780,832,1612,"21 de agosto de 1994"
26,4,65,1240,140,144,284,"21 de agosto de 1994"
26,4,65,1241,214,205,419,"21 de agosto de 1994"
26,4,65,1242,250,273,523,"21 de agosto de 1994"
26,4,65,1243,596,661,1257,"21 de agosto de 1994"
26,4,65,1244,638,685,1323,"21 de agosto de 1994"
26,4,65,1245,447,477,924,"21 de agosto de 1994"
26,4,65,1246,621,673,1294,"21 de agosto de 1994"
26,4,65,1247,723,772,1495,"21 de agosto de 1994"
26,4,65,1248,302,300,602,"21 de agosto de 1994"
26,4,65,1249,541,635,1176,"21 de agosto de 1994"
26,4,65,1250,472,522,994,"21 de agosto de 1994"
26,4,65,1251,576,633,1209,"21 de agosto de 1994"
26,4,65,1252,916,970,1886,"21 de agosto de 1994"
26,4,65,1253,718,719,1437,"21 de agosto de 1994"
26,4,65,1254,648,643,1291,"21 de agosto de 1994"
26,4,65,1255,404,475,879,"21 de agosto de 1994"
26,4,65,1256,500,502,1002,"21 de agosto de 1994"
26,4,65,1257,698,815,1513,"21 de agosto de 1994"
26,4,65,1258,573,579,1152,"21 de agosto de 1994"
26,4,65,1259,370,378,748,"21 de agosto de 1994"
26,4,65,1260,801,863,1664,"21 de agosto de 1994"
26,4,65,1261,466,502,968,"21 de agosto de 1994"
26,4,65,1262,346,377,723,"21 de agosto de 1994"
26,4,65,1263,890,920,1810,"21 de agosto de 1994"
26,4,65,1264,617,708,1325,"21 de agosto de 1994"
26,4,65,1265,722,798,1520,"21 de agosto de 1994"
26,4,65,1266,509,608,1117,"21 de agosto de 1994"
26,4,65,1267,309,304,613,"21 de agosto de 1994"
26,4,65,1268,594,573,1167,"21 de agosto de 1994"
26,4,65,1269,601,659,1260,"21 de agosto de 1994"
26,4,65,1270,604,546,1150,"21 de agosto de 1994"
26,4,65,1271,411,354,765,"21 de agosto de 1994"
26,4,65,1272,282,231,513,"21 de agosto de 1994"
26,4,65,1273,238,194,432,"21 de agosto de 1994"
26,4,65,1274,136,111,247,"21 de agosto de 1994"
26,4,65,1275,325,274,599,"21 de agosto de 1994"
26,4,65,1276,491,411,902,"21 de agosto de 1994"
26,4,65,1277,488,482,970,"21 de agosto de 1994"
26,4,65,1278,719,690,1409,"21 de agosto de 1994"
26,4,65,1279,428,444,872,"21 de agosto de 1994"
26,4,65,1280,476,391,867,"21 de agosto de 1994"
26,4,65,1281,235,198,433,"21 de agosto de 1994"
26,4,65,1282,451,409,860,"21 de agosto de 1994"
26,4,65,1283,370,356,726,"21 de agosto de 1994"
26,4,65,1284,582,529,1111,"21 de agosto de 1994"
26,4,65,1285,265,267,532,"21 de agosto de 1994"
26,4,65,1286,500,448,948,"21 de agosto de 1994"
26,4,65,1287,424,350,774,"21 de agosto de 1994"
26,4,65,1288,429,425,854,"21 de agosto de 1994"
26,4,65,1289,709,671,1380,"21 de agosto de 1994"
26,4,65,1290,601,584,1185,"21 de agosto de 1994"
26,4,65,1291,918,865,1783,"21 de agosto de 1994"
26,4,65,1292,580,562,1142,"21 de agosto de 1994"
26,4,65,1293,553,531,1084,"21 de agosto de 1994"
26,4,65,1294,402,348,750,"21 de agosto de 1994"
26,4,65,1295,425,396,821,"21 de agosto de 1994"
26,4,65,1296,356,335,691,"21 de agosto de 1994"
26,4,65,1297,686,617,1303,"21 de agosto de 1994"
26,4,65,1298,426,312,738,"21 de agosto de 1994"
26,4,65,1299,179,177,356,"21 de agosto de 1994"
26,4,65,1300,741,643,1384,"21 de agosto de 1994"
26,4,65,1301,208,181,389,"21 de agosto de 1994"
26,4,65,1302,361,418,779,"21 de agosto de 1994"
26,4,65,1303,390,390,780,"21 de agosto de 1994"
26,4,65,1304,463,500,963,"21 de agosto de 1994"
26,4,65,1305,332,373,705,"21 de agosto de 1994"
26,5,3,33,515,460,975,"21 de agosto de 1994"
26,5,3,34,430,476,906,"21 de agosto de 1994"
26,5,3,35,645,635,1280,"21 de agosto de 1994"
26,5,3,36,27,13,40,"21 de agosto de 1994"
26,5,3,37,158,118,276,"21 de agosto de 1994"
26,5,6,46,252,238,490,"21 de agosto de 1994"
26,5,14,66,510,451,961,"21 de agosto de 1994"
26,5,14,67,453,412,865,"21 de agosto de 1994"
26,5,14,68,460,460,920,"21 de agosto de 1994"
26,5,14,69,463,440,903,"21 de agosto de 1994"
26,5,31,232,161,137,298,"21 de agosto de 1994"
26,5,36,252,337,338,675,"21 de agosto de 1994"
26,5,36,253,413,443,856,"21 de agosto de 1994"
26,5,36,254,328,329,657,"21 de agosto de 1994"
26,5,36,255,489,515,1004,"21 de agosto de 1994"
26,5,36,256,468,523,991,"21 de agosto de 1994"
26,5,36,257,224,268,492,"21 de agosto de 1994"
26,5,36,258,100,74,174,"21 de agosto de 1994"
26,5,36,259,180,156,336,"21 de agosto de 1994"
26,5,36,260,208,200,408,"21 de agosto de 1994"
26,5,36,261,278,283,561,"21 de agosto de 1994"
26,5,36,262,292,247,539,"21 de agosto de 1994"
26,5,36,263,436,449,885,"21 de agosto de 1994"
26,5,38,265,355,303,658,"21 de agosto de 1994"
26,5,38,266,250,219,469,"21 de agosto de 1994"
26,5,42,278,423,331,754,"21 de agosto de 1994"
26,5,42,279,96,83,179,"21 de agosto de 1994"
26,5,42,280,64,45,109,"21 de agosto de 1994"
26,5,43,281,132,130,262,"21 de agosto de 1994"
26,5,43,282,25,31,56,"21 de agosto de 1994"
26,5,43,283,62,40,102,"21 de agosto de 1994"
26,5,43,284,74,70,144,"21 de agosto de 1994"
26,5,43,285,207,179,386,"21 de agosto de 1994"
26,5,46,292,491,518,1009,"21 de agosto de 1994"
26,5,46,293,516,497,1013,"21 de agosto de 1994"
26,5,46,294,645,647,1292,"21 de agosto de 1994"
26,5,46,295,479,514,993,"21 de agosto de 1994"
26,5,46,296,687,704,1391,"21 de agosto de 1994"
26,5,46,297,638,588,1226,"21 de agosto de 1994"
26,5,46,298,621,613,1234,"21 de agosto de 1994"
26,5,46,299,522,572,1094,"21 de agosto de 1994"
26,5,46,300,387,403,790,"21 de agosto de 1994"
26,5,46,301,354,384,738,"21 de agosto de 1994"
26,5,46,302,448,498,946,"21 de agosto de 1994"
26,5,46,303,444,466,910,"21 de agosto de 1994"
26,5,46,304,667,651,1318,"21 de agosto de 1994"
26,5,46,305,697,725,1422,"21 de agosto de 1994"
26,5,46,306,643,668,1311,"21 de agosto de 1994"
26,5,46,307,244,256,500,"21 de agosto de 1994"
26,5,46,308,699,677,1376,"21 de agosto de 1994"
26,5,46,309,450,489,939,"21 de agosto de 1994"
26,5,46,310,595,619,1214,"21 de agosto de 1994"
26,5,46,311,387,393,780,"21 de agosto de 1994"
26,5,46,312,488,528,1016,"21 de agosto de 1994"
26,5,46,313,343,345,688,"21 de agosto de 1994"
26,5,46,314,503,475,978,"21 de agosto de 1994"
26,5,46,315,326,339,665,"21 de agosto de 1994"
26,5,46,316,468,499,967,"21 de agosto de 1994"
26,5,46,317,390,391,781,"21 de agosto de 1994"
26,5,46,318,142,72,214,"21 de agosto de 1994"
26,5,46,319,798,680,1478,"21 de agosto de 1994"
26,5,46,320,530,477,1007,"21 de agosto de 1994"
26,5,46,321,312,272,584,"21 de agosto de 1994"
26,5,46,322,505,435,940,"21 de agosto de 1994"
26,5,46,323,395,298,693,"21 de agosto de 1994"
26,5,46,324,493,374,867,"21 de agosto de 1994"
26,5,46,325,335,215,550,"21 de agosto de 1994"
26,5,46,326,332,244,576,"21 de agosto de 1994"
26,5,46,327,226,148,374,"21 de agosto de 1994"
26,5,46,328,503,367,870,"21 de agosto de 1994"
26,5,47,329,851,735,1586,"21 de agosto de 1994"
26,5,47,330,400,360,760,"21 de agosto de 1994"
26,5,51,620,217,174,391,"21 de agosto de 1994"
26,5,51,621,402,373,775,"21 de agosto de 1994"
26,5,51,622,196,150,346,"21 de agosto de 1994"
26,5,51,623,76,48,124,"21 de agosto de 1994"
26,5,51,624,114,69,183,"21 de agosto de 1994"
26,5,52,625,451,445,896,"21 de agosto de 1994"
26,5,52,626,495,451,946,"21 de agosto de 1994"
26,5,52,627,683,568,1251,"21 de agosto de 1994"
26,5,52,628,36,23,59,"21 de agosto de 1994"
26,5,52,629,607,517,1124,"21 de agosto de 1994"
26,5,52,630,130,126,256,"21 de agosto de 1994"
26,5,53,631,595,541,1136,"21 de agosto de 1994"
26,5,53,632,307,308,615,"21 de agosto de 1994"
26,5,53,633,214,219,433,"21 de agosto de 1994"
26,5,53,634,266,268,534,"21 de agosto de 1994"
26,5,53,635,386,379,765,"21 de agosto de 1994"
26,5,53,636,559,624,1183,"21 de agosto de 1994"
26,5,53,637,371,399,770,"21 de agosto de 1994"
26,5,53,638,375,393,768,"21 de agosto de 1994"
26,5,53,639,446,505,951,"21 de agosto de 1994"
26,5,53,640,523,437,960,"21 de agosto de 1994"
26,5,53,641,495,500,995,"21 de agosto de 1994"
26,5,53,642,540,508,1048,"21 de agosto de 1994"
26,5,53,643,419,435,854,"21 de agosto de 1994"
26,5,53,644,153,175,328,"21 de agosto de 1994"
26,5,53,645,432,438,870,"21 de agosto de 1994"
26,5,53,646,473,495,968,"21 de agosto de 1994"
26,5,53,647,165,149,314,"21 de agosto de 1994"
26,5,53,648,413,353,766,"21 de agosto de 1994"
26,5,55,652,360,351,711,"21 de agosto de 1994"
26,5,55,653,140,128,268,"21 de agosto de 1994"
26,5,55,654,191,182,373,"21 de agosto de 1994"
26,5,55,655,246,268,514,"21 de agosto de 1994"
26,5,55,656,351,351,702,"21 de agosto de 1994"
26,5,55,657,363,402,765,"21 de agosto de 1994"
26,5,55,658,330,376,706,"21 de agosto de 1994"
26,5,55,659,276,302,578,"21 de agosto de 1994"
26,5,55,660,340,375,715,"21 de agosto de 1994"
26,5,55,661,416,438,854,"21 de agosto de 1994"
26,5,55,662,336,356,692,"21 de agosto de 1994"
26,5,55,663,129,120,249,"21 de agosto de 1994"
26,5,55,664,298,310,608,"21 de agosto de 1994"
26,5,55,665,319,366,685,"21 de agosto de 1994"
26,5,55,666,490,535,1025,"21 de agosto de 1994"
26,5,55,667,548,594,1142,"21 de agosto de 1994"
26,5,55,668,629,682,1311,"21 de agosto de 1994"
26,5,55,669,462,504,966,"21 de agosto de 1994"
26,5,55,670,736,819,1555,"21 de agosto de 1994"
26,5,55,671,168,184,352,"21 de agosto de 1994"
26,5,55,672,294,297,591,"21 de agosto de 1994"
26,5,55,673,393,367,760,"21 de agosto de 1994"
26,5,55,674,316,309,625,"21 de agosto de 1994"
26,5,55,675,253,275,528,"21 de agosto de 1994"
26,5,55,676,375,414,789,"21 de agosto de 1994"
26,5,55,677,503,555,1058,"21 de agosto de 1994"
26,5,55,678,438,543,981,"21 de agosto de 1994"
26,5,55,679,361,432,793,"21 de agosto de 1994"
26,5,55,680,511,542,1053,"21 de agosto de 1994"
26,5,55,681,495,528,1023,"21 de agosto de 1994"
26,5,55,682,227,220,447,"21 de agosto de 1994"
26,5,55,683,253,286,539,"21 de agosto de 1994"
26,5,55,684,390,387,777,"21 de agosto de 1994"
26,5,55,685,518,577,1095,"21 de agosto de 1994"
26,5,55,686,267,290,557,"21 de agosto de 1994"
26,5,55,687,366,374,740,"21 de agosto de 1994"
26,5,55,688,348,394,742,"21 de agosto de 1994"
26,5,55,689,310,333,643,"21 de agosto de 1994"
26,5,55,690,464,488,952,"21 de agosto de 1994"
26,5,55,691,242,255,497,"21 de agosto de 1994"
26,5,55,692,319,361,680,"21 de agosto de 1994"
26,5,55,693,209,218,427,"21 de agosto de 1994"
26,5,55,694,293,287,580,"21 de agosto de 1994"
26,5,55,695,265,285,550,"21 de agosto de 1994"
26,5,55,696,260,249,509,"21 de agosto de 1994"
26,5,55,697,328,374,702,"21 de agosto de 1994"
26,5,55,698,326,386,712,"21 de agosto de 1994"
26,5,55,699,292,331,623,"21 de agosto de 1994"
26,5,55,700,301,355,656,"21 de agosto de 1994"
26,5,55,701,693,760,1453,"21 de agosto de 1994"
26,5,55,702,222,243,465,"21 de agosto de 1994"
26,5,55,703,490,574,1064,"21 de agosto de 1994"
26,5,55,704,414,474,888,"21 de agosto de 1994"
26,5,55,705,560,636,1196,"21 de agosto de 1994"
26,5,55,706,647,745,1392,"21 de agosto de 1994"
26,5,55,707,479,528,1007,"21 de agosto de 1994"
26,5,55,708,368,386,754,"21 de agosto de 1994"
26,5,55,709,406,403,809,"21 de agosto de 1994"
26,5,55,710,328,399,727,"21 de agosto de 1994"
26,5,55,711,224,254,478,"21 de agosto de 1994"
26,5,55,712,224,248,472,"21 de agosto de 1994"
26,5,55,713,608,695,1303,"21 de agosto de 1994"
26,5,55,714,525,569,1094,"21 de agosto de 1994"
26,5,55,715,402,426,828,"21 de agosto de 1994"
26,5,55,716,381,379,760,"21 de agosto de 1994"
26,5,55,717,300,325,625,"21 de agosto de 1994"
26,5,55,718,238,261,499,"21 de agosto de 1994"
26,5,55,719,443,436,879,"21 de agosto de 1994"
26,5,55,720,295,325,620,"21 de agosto de 1994"
26,5,55,721,428,447,875,"21 de agosto de 1994"
26,5,55,722,488,551,1039,"21 de agosto de 1994"
26,5,55,723,275,269,544,"21 de agosto de 1994"
26,5,55,724,383,399,782,"21 de agosto de 1994"
26,5,55,725,318,341,659,"21 de agosto de 1994"
26,5,55,726,345,362,707,"21 de agosto de 1994"
26,5,55,727,412,483,895,"21 de agosto de 1994"
26,5,55,728,249,247,496,"21 de agosto de 1994"
26,5,55,729,228,236,464,"21 de agosto de 1994"
26,5,55,730,327,336,663,"21 de agosto de 1994"
26,5,55,731,418,416,834,"21 de agosto de 1994"
26,5,55,732,486,459,945,"21 de agosto de 1994"
26,5,55,733,249,251,500,"21 de agosto de 1994"
26,5,55,734,183,176,359,"21 de agosto de 1994"
26,5,55,735,133,128,261,"21 de agosto de 1994"
26,5,55,736,199,151,350,"21 de agosto de 1994"
26,5,55,737,567,513,1080,"21 de agosto de 1994"
26,5,55,738,501,468,969,"21 de agosto de 1994"
26,5,55,739,199,188,387,"21 de agosto de 1994"
26,5,55,740,641,553,1194,"21 de agosto de 1994"
26,5,55,741,788,686,1474,"21 de agosto de 1994"
26,5,55,742,428,354,782,"21 de agosto de 1994"
26,5,70,1323,299,293,592,"21 de agosto de 1994"
26,5,70,1324,762,611,1373,"21 de agosto de 1994"
26,5,70,1325,350,347,697,"21 de agosto de 1994"
26,5,70,1326,374,367,741,"21 de agosto de 1994"
26,5,70,1327,290,309,599,"21 de agosto de 1994"
26,5,70,1328,169,187,356,"21 de agosto de 1994"
26,5,70,1329,360,351,711,"21 de agosto de 1994"
26,5,70,1330,193,203,396,"21 de agosto de 1994"
26,6,34,248,138,113,251,"21 de agosto de 1994"
26,6,39,267,108,82,190,"21 de agosto de 1994"
26,6,39,268,130,118,248,"21 de agosto de 1994"
26,6,39,269,85,73,158,"21 de agosto de 1994"
26,6,39,270,144,123,267,"21 de agosto de 1994"
26,6,39,271,44,40,84,"21 de agosto de 1994"
26,6,39,272,158,122,280,"21 de agosto de 1994"
26,6,40,273,527,426,953,"21 de agosto de 1994"
26,6,48,331,237,158,395,"21 de agosto de 1994"
26,6,48,332,193,141,334,"21 de agosto de 1994"
26,6,48,333,99,70,169,"21 de agosto de 1994"
26,6,48,334,192,130,322,"21 de agosto de 1994"
26,6,48,335,162,123,285,"21 de agosto de 1994"
26,6,49,499,354,398,752,"21 de agosto de 1994"
26,6,49,500,324,338,662,"21 de agosto de 1994"
26,6,49,501,625,691,1316,"21 de agosto de 1994"
26,6,49,502,318,365,683,"21 de agosto de 1994"
26,6,49,503,345,386,731,"21 de agosto de 1994"
26,6,49,504,480,527,1007,"21 de agosto de 1994"
26,6,49,505,652,733,1385,"21 de agosto de 1994"
26,6,49,506,493,637,1130,"21 de agosto de 1994"
26,6,49,507,366,344,710,"21 de agosto de 1994"
26,6,49,508,568,640,1208,"21 de agosto de 1994"
26,6,49,509,719,764,1483,"21 de agosto de 1994"
26,6,49,510,507,526,1033,"21 de agosto de 1994"
26,6,49,511,407,445,852,"21 de agosto de 1994"
26,6,49,512,875,864,1739,"21 de agosto de 1994"
26,6,49,513,395,402,797,"21 de agosto de 1994"
26,6,49,514,558,566,1124,"21 de agosto de 1994"
26,6,49,515,215,191,406,"21 de agosto de 1994"
26,6,49,516,237,249,486,"21 de agosto de 1994"
26,6,49,517,524,573,1097,"21 de agosto de 1994"
26,6,49,518,315,354,669,"21 de agosto de 1994"
26,6,49,519,364,474,838,"21 de agosto de 1994"
26,6,49,520,451,487,938,"21 de agosto de 1994"
26,6,49,521,396,453,849,"21 de agosto de 1994"
26,6,49,522,470,533,1003,"21 de agosto de 1994"
26,6,49,523,278,284,562,"21 de agosto de 1994"
26,6,49,524,556,610,1166,"21 de agosto de 1994"
26,6,49,525,490,516,1006,"21 de agosto de 1994"
26,6,49,526,243,270,513,"21 de agosto de 1994"
26,6,49,527,490,520,1010,"21 de agosto de 1994"
26,6,49,528,536,528,1064,"21 de agosto de 1994"
26,6,49,529,538,525,1063,"21 de agosto de 1994"
26,6,49,530,419,416,835,"21 de agosto de 1994"
26,6,49,531,451,485,936,"21 de agosto de 1994"
26,6,49,532,720,730,1450,"21 de agosto de 1994"
26,6,49,533,328,313,641,"21 de agosto de 1994"
26,6,49,534,403,391,794,"21 de agosto de 1994"
26,6,49,535,352,375,727,"21 de agosto de 1994"
26,6,49,536,453,450,903,"21 de agosto de 1994"
26,6,49,537,481,543,1024,"21 de agosto de 1994"
26,6,49,538,565,594,1159,"21 de agosto de 1994"
26,6,49,539,438,507,945,"21 de agosto de 1994"
26,6,49,540,296,330,626,"21 de agosto de 1994"
26,6,49,541,599,601,1200,"21 de agosto de 1994"
26,6,49,542,430,429,859,"21 de agosto de 1994"
26,6,49,543,300,288,588,"21 de agosto de 1994"
26,6,49,544,569,655,1224,"21 de agosto de 1994"
26,6,49,545,639,655,1294,"21 de agosto de 1994"
26,6,49,546,387,417,804,"21 de agosto de 1994"
26,6,49,547,409,401,810,"21 de agosto de 1994"
26,6,49,548,473,499,972,"21 de agosto de 1994"
26,6,49,549,445,510,955,"21 de agosto de 1994"
26,6,49,550,325,367,692,"21 de agosto de 1994"
26,6,49,551,446,484,930,"21 de agosto de 1994"
26,6,49,552,438,462,900,"21 de agosto de 1994"
26,6,49,553,387,414,801,"21 de agosto de 1994"
26,6,49,554,350,361,711,"21 de agosto de 1994"
26,6,49,555,577,600,1177,"21 de agosto de 1994"
26,6,49,556,615,620,1235,"21 de agosto de 1994"
26,6,49,557,369,400,769,"21 de agosto de 1994"
26,6,49,558,812,782,1594,"21 de agosto de 1994"
26,6,49,559,587,610,1197,"21 de agosto de 1994"
26,6,49,560,460,469,929,"21 de agosto de 1994"
26,6,49,561,434,401,835,"21 de agosto de 1994"
26,6,49,562,333,350,683,"21 de agosto de 1994"
26,6,49,563,526,510,1036,"21 de agosto de 1994"
26,6,49,564,502,490,992,"21 de agosto de 1994"
26,6,49,565,700,678,1378,"21 de agosto de 1994"
26,6,49,566,437,466,903,"21 de agosto de 1994"
26,6,49,567,559,538,1097,"21 de agosto de 1994"
26,6,49,568,542,582,1124,"21 de agosto de 1994"
26,6,49,569,652,644,1296,"21 de agosto de 1994"
26,6,49,570,470,460,930,"21 de agosto de 1994"
26,6,49,571,429,380,809,"21 de agosto de 1994"
26,6,49,572,379,391,770,"21 de agosto de 1994"
26,6,49,573,398,384,782,"21 de agosto de 1994"
26,6,49,574,359,403,762,"21 de agosto de 1994"
26,6,49,575,336,397,733,"21 de agosto de 1994"
26,6,49,576,305,369,674,"21 de agosto de 1994"
26,6,49,577,302,299,601,"21 de agosto de 1994"
26,6,49,578,296,318,614,"21 de agosto de 1994"
26,6,49,579,395,447,842,"21 de agosto de 1994"
26,6,49,580,421,482,903,"21 de agosto de 1994"
26,6,49,581,514,549,1063,"21 de agosto de 1994"
26,6,49,582,473,573,1046,"21 de agosto de 1994"
26,6,49,583,1943,2305,4248,"21 de agosto de 1994"
26,6,49,584,500,473,973,"21 de agosto de 1994"
26,6,49,585,332,312,644,"21 de agosto de 1994"
26,6,49,586,438,337,775,"21 de agosto de 1994"
26,6,49,587,483,413,896,"21 de agosto de 1994"
26,6,49,588,168,131,299,"21 de agosto de 1994"
26,6,49,589,880,796,1676,"21 de agosto de 1994"
26,6,49,590,768,713,1481,"21 de agosto de 1994"
26,6,49,591,211,144,355,"21 de agosto de 1994"
26,6,49,592,975,863,1838,"21 de agosto de 1994"
26,6,49,593,338,307,645,"21 de agosto de 1994"
26,6,49,594,66,51,117,"21 de agosto de 1994"
26,6,49,595,135,125,260,"21 de agosto de 1994"
26,6,49,596,82,48,130,"21 de agosto de 1994"
26,6,49,597,251,150,401,"21 de agosto de 1994"
26,6,49,598,995,791,1786,"21 de agosto de 1994"
26,6,49,599,182,154,336,"21 de agosto de 1994"
26,6,49,600,261,244,505,"21 de agosto de 1994"
26,6,49,601,1418,1253,2671,"21 de agosto de 1994"
26,6,49,602,695,579,1274,"21 de agosto de 1994"
26,6,49,603,955,851,1806,"21 de agosto de 1994"
26,6,49,604,811,497,1308,"21 de agosto de 1994"
26,6,49,605,820,827,1647,"21 de agosto de 1994"
26,6,49,606,469,354,823,"21 de agosto de 1994"
26,6,49,607,23,14,37,"21 de agosto de 1994"
26,6,49,608,305,226,531,"21 de agosto de 1994"
26,6,49,609,258,197,455,"21 de agosto de 1994"
26,6,49,610,281,191,472,"21 de agosto de 1994"
26,6,49,611,269,209,478,"21 de agosto de 1994"
26,6,49,612,158,99,257,"21 de agosto de 1994"
26,6,49,613,82,57,139,"21 de agosto de 1994"
26,6,49,614,145,101,246,"21 de agosto de 1994"
26,6,49,615,363,226,589,"21 de agosto de 1994"
26,6,49,616,105,84,189,"21 de agosto de 1994"
26,6,49,617,39,28,67,"21 de agosto de 1994"
26,6,49,618,117,110,227,"21 de agosto de 1994"
26,6,50,619,592,506,1098,"21 de agosto de 1994"
26,6,54,649,213,178,391,"21 de agosto de 1994"
26,6,54,650,425,329,754,"21 de agosto de 1994"
26,6,54,651,36,24,60,"21 de agosto de 1994"
26,6,56,743,218,184,402,"21 de agosto de 1994"
26,6,56,744,133,104,237,"21 de agosto de 1994"
26,6,56,745,148,115,263,"21 de agosto de 1994"
26,6,56,746,692,495,1187,"21 de agosto de 1994"
26,6,57,747,569,517,1086,"21 de agosto de 1994"
26,6,57,748,491,509,1000,"21 de agosto de 1994"
26,6,57,749,324,318,642,"21 de agosto de 1994"
26,6,57,750,397,363,760,"21 de agosto de 1994"
26,6,57,751,81,59,140,"21 de agosto de 1994"
26,6,57,752,135,121,256,"21 de agosto de 1994"
26,6,57,753,452,412,864,"21 de agosto de 1994"
26,6,57,754,177,169,346,"21 de agosto de 1994"
26,6,57,755,133,113,246,"21 de agosto de 1994"
26,6,57,756,273,219,492,"21 de agosto de 1994"
26,6,57,757,158,112,270,"21 de agosto de 1994"
26,6,57,758,75,52,127,"21 de agosto de 1994"
26,6,57,759,91,76,167,"21 de agosto de 1994"
26,6,62,1109,806,803,1609,"21 de agosto de 1994"
26,6,62,1110,513,541,1054,"21 de agosto de 1994"
26,6,62,1111,441,455,896,"21 de agosto de 1994"
26,6,62,1112,449,454,903,"21 de agosto de 1994"
26,6,62,1113,318,219,537,"21 de agosto de 1994"
26,6,62,1114,79,60,139,"21 de agosto de 1994"
26,6,62,1115,324,294,618,"21 de agosto de 1994"
26,6,62,1116,151,98,249,"21 de agosto de 1994"
26,6,62,1117,142,125,267,"21 de agosto de 1994"
26,6,62,1118,227,179,406,"21 de agosto de 1994"
26,6,62,1119,56,31,87,"21 de agosto de 1994"
26,6,62,1120,121,79,200,"21 de agosto de 1994"
26,6,62,1121,169,127,296,"21 de agosto de 1994"
26,6,62,1122,247,198,445,"21 de agosto de 1994"
26,6,62,1123,249,197,446,"21 de agosto de 1994"
26,6,62,1124,490,391,881,"21 de agosto de 1994"
26,6,62,1125,250,201,451,"21 de agosto de 1994"
26,6,62,1126,67,39,106,"21 de agosto de 1994"
26,6,62,1127,73,48,121,"21 de agosto de 1994"
26,6,62,1128,134,88,222,"21 de agosto de 1994"
26,6,62,1129,59,45,104,"21 de agosto de 1994"
26,6,62,1130,459,376,835,"21 de agosto de 1994"
26,6,62,1131,325,252,577,"21 de agosto de 1994"
26,6,62,1132,165,108,273,"21 de agosto de 1994"
26,6,62,1133,309,234,543,"21 de agosto de 1994"
26,6,62,1134,260,195,455,"21 de agosto de 1994"
26,6,62,1135,275,192,467,"21 de agosto de 1994"
26,6,62,1136,130,116,246,"21 de agosto de 1994"
26,6,62,1137,305,237,542,"21 de agosto de 1994"
26,6,66,1306,178,124,302,"21 de agosto de 1994"
26,6,67,1307,440,390,830,"21 de agosto de 1994"
26,6,67,1308,351,265,616,"21 de agosto de 1994"
26,6,67,1309,182,151,333,"21 de agosto de 1994"
26,6,68,1310,440,412,852,"21 de agosto de 1994"
26,6,68,1311,776,622,1398,"21 de agosto de 1994"
26,6,68,1312,44,22,66,"21 de agosto de 1994"
26,6,68,1313,91,60,151,"21 de agosto de 1994"
26,6,68,1314,372,287,659,"21 de agosto de 1994"
26,6,68,1315,140,113,253,"21 de agosto de 1994"
26,6,69,1316,375,349,724,"21 de agosto de 1994"
26,6,69,1317,337,289,626,"21 de agosto de 1994"
26,6,69,1318,171,136,307,"21 de agosto de 1994"
26,6,69,1319,253,202,455,"21 de agosto de 1994"
26,6,69,1320,239,213,452,"21 de agosto de 1994"
26,6,69,1321,81,68,149,"21 de agosto de 1994"
26,6,69,1322,102,92,194,"21 de agosto de 1994"
26,7,59,773,474,508,982,"21 de agosto de 1994"
26,7,59,774,240,260,500,"21 de agosto de 1994"
26,7,59,775,95,104,199,"21 de agosto de 1994"
26,7,59,776,505,540,1045,"21 de agosto de 1994"
26,7,59,777,487,505,992,"21 de agosto de 1994"
26,7,59,778,427,473,900,"21 de agosto de 1994"
26,7,59,779,454,474,928,"21 de agosto de 1994"
26,7,59,780,412,458,870,"21 de agosto de 1994"
26,7,59,781,311,336,647,"21 de agosto de 1994"
26,7,59,782,353,382,735,"21 de agosto de 1994"
26,7,59,783,467,539,1006,"21 de agosto de 1994"
26,7,59,784,491,512,1003,"21 de agosto de 1994"
26,7,59,785,440,439,879,"21 de agosto de 1994"
26,7,59,786,706,704,1410,"21 de agosto de 1994"
26,7,59,787,419,405,824,"21 de agosto de 1994"
26,7,59,788,445,512,957,"21 de agosto de 1994"
26,7,59,789,693,679,1372,"21 de agosto de 1994"
26,7,59,790,566,620,1186,"21 de agosto de 1994"
26,7,59,791,350,386,736,"21 de agosto de 1994"
26,7,59,792,528,575,1103,"21 de agosto de 1994"
26,7,59,793,562,643,1205,"21 de agosto de 1994"
26,7,59,794,419,409,828,"21 de agosto de 1994"
26,7,59,795,709,792,1501,"21 de agosto de 1994"
26,7,59,796,684,692,1376,"21 de agosto de 1994"
26,7,59,797,393,423,816,"21 de agosto de 1994"
26,7,59,798,224,238,462,"21 de agosto de 1994"
26,7,59,799,337,388,725,"21 de agosto de 1994"
26,7,59,800,445,503,948,"21 de agosto de 1994"
26,7,59,801,301,301,602,"21 de agosto de 1994"
26,7,59,802,386,491,877,"21 de agosto de 1994"
26,7,59,803,441,505,946,"21 de agosto de 1994"
26,7,59,804,488,536,1024,"21 de agosto de 1994"
26,7,59,805,322,342,664,"21 de agosto de 1994"
26,7,59,806,358,384,742,"21 de agosto de 1994"
26,7,59,807,418,471,889,"21 de agosto de 1994"
26,7,59,808,604,611,1215,"21 de agosto de 1994"
26,7,59,809,527,579,1106,"21 de agosto de 1994"
26,7,59,810,484,559,1043,"21 de agosto de 1994"
26,7,59,811,525,581,1106,"21 de agosto de 1994"
26,7,59,812,567,672,1239,"21 de agosto de 1994"
26,7,59,813,406,465,871,"21 de agosto de 1994"
26,7,59,814,755,814,1569,"21 de agosto de 1994"
26,7,59,815,396,433,829,"21 de agosto de 1994"
26,7,59,816,435,497,932,"21 de agosto de 1994"
26,7,59,817,331,386,717,"21 de agosto de 1994"
26,7,59,818,215,233,448,"21 de agosto de 1994"
26,7,59,819,166,167,333,"21 de agosto de 1994"
26,7,59,820,557,568,1125,"21 de agosto de 1994"
26,7,59,821,129,155,284,"21 de agosto de 1994"
26,7,59,822,483,583,1066,"21 de agosto de 1994"
26,7,59,823,317,346,663,"21 de agosto de 1994"
26,7,59,824,340,380,720,"21 de agosto de 1994"
26,7,59,825,233,234,467,"21 de agosto de 1994"
26,7,59,826,364,399,763,"21 de agosto de 1994"
26,7,59,827,368,413,781,"21 de agosto de 1994"
26,7,59,828,342,349,691,"21 de agosto de 1994"
26,7,59,829,141,158,299,"21 de agosto de 1994"
26,7,59,830,669,725,1394,"21 de agosto de 1994"
26,7,59,831,187,201,388,"21 de agosto de 1994"
26,7,59,832,428,426,854,"21 de agosto de 1994"
26,7,59,833,524,589,1113,"21 de agosto de 1994"
26,7,59,834,272,328,600,"21 de agosto de 1994"
26,7,59,835,240,272,512,"21 de agosto de 1994"
26,7,59,836,287,305,592,"21 de agosto de 1994"
26,7,59,837,581,578,1159,"21 de agosto de 1994"
26,7,59,838,455,469,924,"21 de agosto de 1994"
26,7,59,839,292,331,623,"21 de agosto de 1994"
26,7,59,840,210,238,448,"21 de agosto de 1994"
26,7,59,841,312,347,659,"21 de agosto de 1994"
26,7,59,842,419,474,893,"21 de agosto de 1994"
26,7,59,843,249,283,532,"21 de agosto de 1994"
26,7,59,844,336,393,729,"21 de agosto de 1994"
26,7,59,845,365,413,778,"21 de agosto de 1994"
26,7,59,846,429,562,991,"21 de agosto de 1994"
26,7,59,847,263,317,580,"21 de agosto de 1994"
26,7,59,848,286,339,625,"21 de agosto de 1994"
26,7,59,849,663,755,1418,"21 de agosto de 1994"
26,7,59,850,283,289,572,"21 de agosto de 1994"
26,7,59,851,350,424,774,"21 de agosto de 1994"
26,7,59,852,299,341,640,"21 de agosto de 1994"
26,7,59,853,383,486,869,"21 de agosto de 1994"
26,7,59,854,336,382,718,"21 de agosto de 1994"
26,7,59,855,479,570,1049,"21 de agosto de 1994"
26,7,59,856,595,630,1225,"21 de agosto de 1994"
26,7,59,857,324,332,656,"21 de agosto de 1994"
26,7,59,858,279,286,565,"21 de agosto de 1994"
26,7,59,859,385,429,814,"21 de agosto de 1994"
26,7,59,860,403,450,853,"21 de agosto de 1994"
26,7,59,861,521,588,1109,"21 de agosto de 1994"
26,7,59,862,487,512,999,"21 de agosto de 1994"
26,7,59,863,479,495,974,"21 de agosto de 1994"
26,7,59,864,478,524,1002,"21 de agosto de 1994"
26,7,59,865,522,566,1088,"21 de agosto de 1994"
26,7,59,866,436,473,909,"21 de agosto de 1994"
26,7,59,867,657,733,1390,"21 de agosto de 1994"
26,7,59,868,405,423,828,"21 de agosto de 1994"
26,7,59,869,375,408,783,"21 de agosto de 1994"
26,7,59,870,359,393,752,"21 de agosto de 1994"
26,7,59,871,555,562,1117,"21 de agosto de 1994"
26,7,59,872,413,486,899,"21 de agosto de 1994"
26,7,59,873,442,475,917,"21 de agosto de 1994"
26,7,59,874,327,374,701,"21 de agosto de 1994"
26,7,59,875,612,698,1310,"21 de agosto de 1994"
26,7,59,876,221,220,441,"21 de agosto de 1994"
26,7,59,877,224,241,465,"21 de agosto de 1994"
26,7,59,878,418,446,864,"21 de agosto de 1994"
26,7,59,879,406,454,860,"21 de agosto de 1994"
26,7,59,880,527,557,1084,"21 de agosto de 1994"
26,7,59,881,475,501,976,"21 de agosto de 1994"
26,7,59,882,410,483,893,"21 de agosto de 1994"
26,7,59,883,338,383,721,"21 de agosto de 1994"
26,7,59,884,297,321,618,"21 de agosto de 1994"
26,7,59,885,623,651,1274,"21 de agosto de 1994"
26,7,59,886,462,543,1005,"21 de agosto de 1994"
26,7,59,887,323,371,694,"21 de agosto de 1994"
26,7,59,888,716,675,1391,"21 de agosto de 1994"
26,7,59,889,521,478,999,"21 de agosto de 1994"
26,7,59,890,666,685,1351,"21 de agosto de 1994"
26,7,59,891,379,389,768,"21 de agosto de 1994"
26,7,59,892,352,380,732,"21 de agosto de 1994"
26,7,59,893,439,449,888,"21 de agosto de 1994"
26,7,59,894,279,318,597,"21 de agosto de 1994"
26,7,59,895,211,242,453,"21 de agosto de 1994"
26,7,59,896,273,325,598,"21 de agosto de 1994"
26,7,59,897,407,469,876,"21 de agosto de 1994"
26,7,59,898,349,438,787,"21 de agosto de 1994"
26,7,59,899,368,415,783,"21 de agosto de 1994"
26,7,59,900,372,382,754,"21 de agosto de 1994"
26,7,59,901,508,545,1053,"21 de agosto de 1994"
26,7,59,902,392,422,814,"21 de agosto de 1994"
26,7,59,903,331,375,706,"21 de agosto de 1994"
26,7,59,904,292,322,614,"21 de agosto de 1994"
26,7,59,905,342,373,715,"21 de agosto de 1994"
26,7,59,906,541,559,1100,"21 de agosto de 1994"
26,7,59,907,561,621,1182,"21 de agosto de 1994"
26,7,59,908,385,432,817,"21 de agosto de 1994"
26,7,59,909,354,369,723,"21 de agosto de 1994"
26,7,59,910,336,392,728,"21 de agosto de 1994"
26,7,59,911,455,487,942,"21 de agosto de 1994"
26,7,59,912,429,460,889,"21 de agosto de 1994"
26,7,59,913,380,456,836,"21 de agosto de 1994"
26,7,59,914,376,360,736,"21 de agosto de 1994"
26,7,59,915,295,348,643,"21 de agosto de 1994"
26,7,59,916,538,622,1160,"21 de agosto de 1994"
26,7,59,917,282,343,625,"21 de agosto de 1994"
26,7,59,918,346,370,716,"21 de agosto de 1994"
26,7,59,919,366,408,774,"21 de agosto de 1994"
26,7,59,920,427,453,880,"21 de agosto de 1994"
26,7,59,921,496,548,1044,"21 de agosto de 1994"
26,7,59,922,386,474,860,"21 de agosto de 1994"
26,7,59,923,287,335,622,"21 de agosto de 1994"
26,7,59,924,324,384,708,"21 de agosto de 1994"
26,7,59,925,363,431,794,"21 de agosto de 1994"
26,7,59,926,369,409,778,"21 de agosto de 1994"
26,7,59,927,389,374,763,"21 de agosto de 1994"
26,7,59,928,381,429,810,"21 de agosto de 1994"
26,7,59,929,405,487,892,"21 de agosto de 1994"
26,7,59,930,427,525,952,"21 de agosto de 1994"
26,7,59,931,346,381,727,"21 de agosto de 1994"
26,7,59,932,385,473,858,"21 de agosto de 1994"
26,7,59,933,167,91,258,"21 de agosto de 1994"
26,7,59,934,209,159,368,"21 de agosto de 1994"
26,7,59,935,310,260,570,"21 de agosto de 1994"
26,7,59,936,582,616,1198,"21 de agosto de 1994"
26,7,59,937,635,666,1301,"21 de agosto de 1994"
26,7,59,938,338,312,650,"21 de agosto de 1994"
26,7,59,939,547,580,1127,"21 de agosto de 1994"
26,7,59,940,765,772,1537,"21 de agosto de 1994"
26,7,59,941,333,341,674,"21 de agosto de 1994"
26,7,59,942,558,525,1083,"21 de agosto de 1994"
26,7,59,943,711,763,1474,"21 de agosto de 1994"
26,7,59,944,408,389,797,"21 de agosto de 1994"
26,7,59,945,429,464,893,"21 de agosto de 1994"
26,7,59,946,491,556,1047,"21 de agosto de 1994"
26,7,59,947,739,758,1497,"21 de agosto de 1994"
26,7,59,948,620,581,1201,"21 de agosto de 1994"
26,7,59,949,760,820,1580,"21 de agosto de 1994"
26,7,59,950,435,498,933,"21 de agosto de 1994"
26,7,59,951,856,708,1564,"21 de agosto de 1994"
26,7,59,952,304,272,576,"21 de agosto de 1994"
26,7,59,953,195,196,391,"21 de agosto de 1994"
26,7,59,954,355,312,667,"21 de agosto de 1994"
26,7,59,955,218,174,392,"21 de agosto de 1994"
26,7,59,956,410,416,826,"21 de agosto de 1994"
26,7,59,957,404,419,823,"21 de agosto de 1994"
26,7,59,958,457,459,916,"21 de agosto de 1994"
26,7,59,959,460,469,929,"21 de agosto de 1994"
26,7,59,960,402,375,777,"21 de agosto de 1994"
26,7,59,961,407,436,843,"21 de agosto de 1994"
26,7,59,962,239,238,477,"21 de agosto de 1994"
26,7,59,963,164,150,314,"21 de agosto de 1994"
26,7,59,964,625,624,1249,"21 de agosto de 1994"
26,7,59,965,374,348,722,"21 de agosto de 1994"
26,7,59,966,897,802,1699,"21 de agosto de 1994"
26,7,59,967,374,384,758,"21 de agosto de 1994"
26,7,59,968,485,467,952,"21 de agosto de 1994"
26,7,59,969,424,423,847,"21 de agosto de 1994"
26,7,59,970,378,399,777,"21 de agosto de 1994"
26,7,59,971,578,536,1114,"21 de agosto de 1994"
26,7,59,972,378,336,714,"21 de agosto de 1994"
26,7,59,973,549,578,1127,"21 de agosto de 1994"
26,7,59,974,465,443,908,"21 de agosto de 1994"
26,7,59,975,592,613,1205,"21 de agosto de 1994"
26,7,59,976,614,605,1219,"21 de agosto de 1994"
26,7,59,977,628,643,1271,"21 de agosto de 1994"
26,7,59,978,594,626,1220,"21 de agosto de 1994"
26,7,59,979,466,470,936,"21 de agosto de 1994"
26,7,59,980,550,508,1058,"21 de agosto de 1994"
26,7,59,981,347,335,682,"21 de agosto de 1994"
26,7,59,982,208,227,435,"21 de agosto de 1994"
26,7,59,983,642,577,1219,"21 de agosto de 1994"
26,7,59,984,281,226,507,"21 de agosto de 1994"
26,7,59,985,278,268,546,"21 de agosto de 1994"
26,7,59,986,466,419,885,"21 de agosto de 1994"
26,7,59,987,450,451,901,"21 de agosto de 1994"
26,7,59,988,117,108,225,"21 de agosto de 1994"
26,7,59,989,247,230,477,"21 de agosto de 1994"
26,7,59,990,194,149,343,"21 de agosto de 1994"
26,7,59,991,860,851,1711,"21 de agosto de 1994"
27,1,4,232,414,397,811,"21 de agosto de 1994"
27,1,4,233,286,344,630,"21 de agosto de 1994"
27,1,4,234,748,753,1501,"21 de agosto de 1994"
27,1,4,235,329,385,714,"21 de agosto de 1994"
27,1,4,236,337,393,730,"21 de agosto de 1994"
27,1,4,237,385,428,813,"21 de agosto de 1994"
27,1,4,238,585,588,1173,"21 de agosto de 1994"
27,1,4,239,282,330,612,"21 de agosto de 1994"
27,1,4,240,295,332,627,"21 de agosto de 1994"
27,1,4,241,364,399,763,"21 de agosto de 1994"
27,1,4,242,656,705,1361,"21 de agosto de 1994"
27,1,4,243,379,426,805,"21 de agosto de 1994"
27,1,4,244,317,326,643,"21 de agosto de 1994"
27,1,4,245,474,589,1063,"21 de agosto de 1994"
27,1,4,246,407,411,818,"21 de agosto de 1994"
27,1,4,247,352,403,755,"21 de agosto de 1994"
27,1,4,248,479,534,1013,"21 de agosto de 1994"
27,1,4,249,352,419,771,"21 de agosto de 1994"
27,1,4,250,423,542,965,"21 de agosto de 1994"
27,1,4,251,497,530,1027,"21 de agosto de 1994"
27,1,4,252,381,390,771,"21 de agosto de 1994"
27,1,4,253,506,575,1081,"21 de agosto de 1994"
27,1,4,254,373,396,769,"21 de agosto de 1994"
27,1,4,255,438,496,934,"21 de agosto de 1994"
27,1,4,256,451,537,988,"21 de agosto de 1994"
27,1,4,257,316,398,714,"21 de agosto de 1994"
27,1,4,258,314,377,691,"21 de agosto de 1994"
27,1,4,259,394,485,879,"21 de agosto de 1994"
27,1,4,260,486,503,989,"21 de agosto de 1994"
27,1,4,261,492,571,1063,"21 de agosto de 1994"
27,1,4,262,478,507,985,"21 de agosto de 1994"
27,1,4,263,289,317,606,"21 de agosto de 1994"
27,1,4,264,427,438,865,"21 de agosto de 1994"
27,1,4,265,299,380,679,"21 de agosto de 1994"
27,1,4,266,308,351,659,"21 de agosto de 1994"
27,1,4,267,576,623,1199,"21 de agosto de 1994"
27,1,4,268,225,264,489,"21 de agosto de 1994"
27,1,4,269,427,420,847,"21 de agosto de 1994"
27,1,4,270,418,430,848,"21 de agosto de 1994"
27,1,4,271,301,321,622,"21 de agosto de 1994"
27,1,4,272,348,325,673,"21 de agosto de 1994"
27,1,4,273,542,651,1193,"21 de agosto de 1994"
27,1,4,274,398,441,839,"21 de agosto de 1994"
27,1,4,275,324,408,732,"21 de agosto de 1994"
27,1,4,276,293,365,658,"21 de agosto de 1994"
27,1,4,277,411,501,912,"21 de agosto de 1994"
27,1,4,278,348,416,764,"21 de agosto de 1994"
27,1,4,279,203,236,439,"21 de agosto de 1994"
27,1,4,280,453,442,895,"21 de agosto de 1994"
27,1,4,281,396,427,823,"21 de agosto de 1994"
27,1,4,282,379,398,777,"21 de agosto de 1994"
27,1,4,283,461,459,920,"21 de agosto de 1994"
27,1,4,284,472,455,927,"21 de agosto de 1994"
27,1,4,285,268,334,602,"21 de agosto de 1994"
27,1,4,286,411,443,854,"21 de agosto de 1994"
27,1,4,287,314,354,668,"21 de agosto de 1994"
27,1,4,288,365,462,827,"21 de agosto de 1994"
27,1,4,289,293,353,646,"21 de agosto de 1994"
27,1,4,290,408,425,833,"21 de agosto de 1994"
27,1,4,291,390,381,771,"21 de agosto de 1994"
27,1,4,292,416,468,884,"21 de agosto de 1994"
27,1,4,293,242,281,523,"21 de agosto de 1994"
27,1,4,294,290,356,646,"21 de agosto de 1994"
27,1,4,295,252,286,538,"21 de agosto de 1994"
27,1,4,296,404,425,829,"21 de agosto de 1994"
27,1,4,297,317,408,725,"21 de agosto de 1994"
27,1,4,298,131,165,296,"21 de agosto de 1994"
27,1,4,299,372,440,812,"21 de agosto de 1994"
27,1,4,300,347,382,729,"21 de agosto de 1994"
27,1,4,301,282,318,600,"21 de agosto de 1994"
27,1,4,302,398,387,785,"21 de agosto de 1994"
27,1,4,303,367,378,745,"21 de agosto de 1994"
27,1,4,304,445,477,922,"21 de agosto de 1994"
27,1,4,305,378,459,837,"21 de agosto de 1994"
27,1,4,306,308,405,713,"21 de agosto de 1994"
27,1,4,307,435,518,953,"21 de agosto de 1994"
27,1,4,308,273,290,563,"21 de agosto de 1994"
27,1,4,309,344,424,768,"21 de agosto de 1994"
27,1,4,310,361,441,802,"21 de agosto de 1994"
27,1,4,311,335,340,675,"21 de agosto de 1994"
27,1,4,312,360,427,787,"21 de agosto de 1994"
27,1,4,313,281,306,587,"21 de agosto de 1994"
27,1,4,314,776,847,1623,"21 de agosto de 1994"
27,1,4,315,413,429,842,"21 de agosto de 1994"
27,1,4,316,392,418,810,"21 de agosto de 1994"
27,1,4,317,301,337,638,"21 de agosto de 1994"
27,1,4,318,153,210,363,"21 de agosto de 1994"
27,1,4,319,367,404,771,"21 de agosto de 1994"
27,1,4,320,471,480,951,"21 de agosto de 1994"
27,1,4,321,340,445,785,"21 de agosto de 1994"
27,1,4,322,316,365,681,"21 de agosto de 1994"
27,1,4,323,420,473,893,"21 de agosto de 1994"
27,1,4,324,420,489,909,"21 de agosto de 1994"
27,1,4,325,364,412,776,"21 de agosto de 1994"
27,1,4,326,346,380,726,"21 de agosto de 1994"
27,1,4,327,452,490,942,"21 de agosto de 1994"
27,1,4,328,457,518,975,"21 de agosto de 1994"
27,1,4,329,369,421,790,"21 de agosto de 1994"
27,1,4,330,362,401,763,"21 de agosto de 1994"
27,1,4,331,210,258,468,"21 de agosto de 1994"
27,1,4,332,430,438,868,"21 de agosto de 1994"
27,1,4,333,314,390,704,"21 de agosto de 1994"
27,1,4,334,443,472,915,"21 de agosto de 1994"
27,1,4,335,377,439,816,"21 de agosto de 1994"
27,1,4,336,279,292,571,"21 de agosto de 1994"
27,1,4,337,391,436,827,"21 de agosto de 1994"
27,1,4,338,289,365,654,"21 de agosto de 1994"
27,1,4,339,204,213,417,"21 de agosto de 1994"
27,1,4,340,386,443,829,"21 de agosto de 1994"
27,1,4,341,283,322,605,"21 de agosto de 1994"
27,1,4,342,343,394,737,"21 de agosto de 1994"
27,1,4,343,407,410,817,"21 de agosto de 1994"
27,1,4,344,538,561,1099,"21 de agosto de 1994"
27,1,4,345,382,434,816,"21 de agosto de 1994"
27,1,4,346,408,440,848,"21 de agosto de 1994"
27,1,4,347,341,375,716,"21 de agosto de 1994"
27,1,4,348,422,499,921,"21 de agosto de 1994"
27,1,4,349,303,360,663,"21 de agosto de 1994"
27,1,4,350,398,452,850,"21 de agosto de 1994"
27,1,4,351,266,293,559,"21 de agosto de 1994"
27,1,4,352,281,311,592,"21 de agosto de 1994"
27,1,4,353,394,419,813,"21 de agosto de 1994"
27,1,4,354,405,464,869,"21 de agosto de 1994"
27,1,4,355,368,386,754,"21 de agosto de 1994"
27,1,4,356,557,634,1191,"21 de agosto de 1994"
27,1,4,357,439,452,891,"21 de agosto de 1994"
27,1,4,358,342,363,705,"21 de agosto de 1994"
27,1,4,359,416,461,877,"21 de agosto de 1994"
27,1,4,360,458,482,940,"21 de agosto de 1994"
27,1,4,361,485,495,980,"21 de agosto de 1994"
27,1,4,362,303,323,626,"21 de agosto de 1994"
27,1,4,363,313,366,679,"21 de agosto de 1994"
27,1,4,364,294,342,636,"21 de agosto de 1994"
27,1,4,365,280,320,600,"21 de agosto de 1994"
27,1,4,366,321,414,735,"21 de agosto de 1994"
27,1,4,367,393,470,863,"21 de agosto de 1994"
27,1,4,368,420,499,919,"21 de agosto de 1994"
27,1,4,369,358,429,787,"21 de agosto de 1994"
27,1,4,370,328,344,672,"21 de agosto de 1994"
27,1,4,371,378,409,787,"21 de agosto de 1994"
27,1,4,372,692,701,1393,"21 de agosto de 1994"
27,1,4,373,466,480,946,"21 de agosto de 1994"
27,1,4,374,406,433,839,"21 de agosto de 1994"
27,1,4,375,395,428,823,"21 de agosto de 1994"
27,1,4,376,270,305,575,"21 de agosto de 1994"
27,1,4,377,317,380,697,"21 de agosto de 1994"
27,1,4,378,234,273,507,"21 de agosto de 1994"
27,1,4,379,417,452,869,"21 de agosto de 1994"
27,1,4,380,296,323,619,"21 de agosto de 1994"
27,1,4,381,336,360,696,"21 de agosto de 1994"
27,1,4,382,505,562,1067,"21 de agosto de 1994"
27,1,4,383,514,589,1103,"21 de agosto de 1994"
27,1,4,384,339,359,698,"21 de agosto de 1994"
27,1,4,385,332,343,675,"21 de agosto de 1994"
27,1,4,386,323,360,683,"21 de agosto de 1994"
27,1,4,387,371,439,810,"21 de agosto de 1994"
27,1,4,388,394,428,822,"21 de agosto de 1994"
27,1,4,389,283,376,659,"21 de agosto de 1994"
27,1,4,390,272,312,584,"21 de agosto de 1994"
27,1,4,391,453,552,1005,"21 de agosto de 1994"
27,1,4,392,402,424,826,"21 de agosto de 1994"
27,1,4,393,503,545,1048,"21 de agosto de 1994"
27,1,4,394,331,412,743,"21 de agosto de 1994"
27,1,4,395,424,491,915,"21 de agosto de 1994"
27,1,4,396,262,300,562,"21 de agosto de 1994"
27,1,4,397,538,568,1106,"21 de agosto de 1994"
27,1,4,398,227,242,469,"21 de agosto de 1994"
27,1,4,399,475,538,1013,"21 de agosto de 1994"
27,1,4,400,454,482,936,"21 de agosto de 1994"
27,1,4,401,781,876,1657,"21 de agosto de 1994"
27,1,4,402,364,457,821,"21 de agosto de 1994"
27,1,4,403,373,433,806,"21 de agosto de 1994"
27,1,4,404,527,519,1046,"21 de agosto de 1994"
27,1,4,405,485,507,992,"21 de agosto de 1994"
27,1,4,406,422,420,842,"21 de agosto de 1994"
27,1,4,407,373,410,783,"21 de agosto de 1994"
27,1,4,408,446,483,929,"21 de agosto de 1994"
27,1,4,409,428,453,881,"21 de agosto de 1994"
27,1,4,410,236,234,470,"21 de agosto de 1994"
27,1,4,411,462,487,949,"21 de agosto de 1994"
27,1,4,412,432,486,918,"21 de agosto de 1994"
27,1,4,413,386,396,782,"21 de agosto de 1994"
27,1,4,414,383,430,813,"21 de agosto de 1994"
27,1,4,415,777,835,1612,"21 de agosto de 1994"
27,1,4,416,399,472,871,"21 de agosto de 1994"
27,1,4,417,307,377,684,"21 de agosto de 1994"
27,1,4,418,328,329,657,"21 de agosto de 1994"
27,1,4,419,139,106,245,"21 de agosto de 1994"
27,1,4,420,291,258,549,"21 de agosto de 1994"
27,1,4,421,603,532,1135,"21 de agosto de 1994"
27,1,4,422,656,580,1236,"21 de agosto de 1994"
27,1,4,423,600,490,1090,"21 de agosto de 1994"
27,1,4,424,44,32,76,"21 de agosto de 1994"
27,1,4,425,401,349,750,"21 de agosto de 1994"
27,1,4,426,462,389,851,"21 de agosto de 1994"
27,1,4,427,493,464,957,"21 de agosto de 1994"
27,1,4,428,488,522,1010,"21 de agosto de 1994"
27,1,4,429,495,488,983,"21 de agosto de 1994"
27,1,4,430,404,412,816,"21 de agosto de 1994"
27,1,4,431,455,422,877,"21 de agosto de 1994"
27,1,4,432,430,379,809,"21 de agosto de 1994"
27,1,4,433,554,494,1048,"21 de agosto de 1994"
27,1,4,434,284,319,603,"21 de agosto de 1994"
27,1,4,435,443,472,915,"21 de agosto de 1994"
27,1,4,436,385,277,662,"21 de agosto de 1994"
27,1,4,437,281,214,495,"21 de agosto de 1994"
27,1,4,438,449,407,856,"21 de agosto de 1994"
27,1,4,439,147,118,265,"21 de agosto de 1994"
27,1,4,440,636,612,1248,"21 de agosto de 1994"
27,1,4,441,454,392,846,"21 de agosto de 1994"
27,1,4,442,158,144,302,"21 de agosto de 1994"
27,1,4,443,472,482,954,"21 de agosto de 1994"
27,1,4,444,130,111,241,"21 de agosto de 1994"
27,1,4,445,348,320,668,"21 de agosto de 1994"
27,1,4,446,558,573,1131,"21 de agosto de 1994"
27,1,4,447,295,247,542,"21 de agosto de 1994"
27,1,4,448,301,247,548,"21 de agosto de 1994"
27,1,4,449,35,32,67,"21 de agosto de 1994"
27,1,4,450,434,354,788,"21 de agosto de 1994"
27,1,4,451,283,223,506,"21 de agosto de 1994"
27,1,4,452,381,329,710,"21 de agosto de 1994"
27,1,4,453,362,354,716,"21 de agosto de 1994"
27,1,4,454,264,217,481,"21 de agosto de 1994"
27,1,4,455,263,232,495,"21 de agosto de 1994"
27,1,4,456,313,257,570,"21 de agosto de 1994"
27,1,4,457,374,355,729,"21 de agosto de 1994"
27,1,4,458,496,460,956,"21 de agosto de 1994"
27,1,4,459,49,33,82,"21 de agosto de 1994"
27,1,4,460,505,465,970,"21 de agosto de 1994"
27,1,4,461,268,234,502,"21 de agosto de 1994"
27,1,4,462,425,393,818,"21 de agosto de 1994"
27,1,4,463,559,528,1087,"21 de agosto de 1994"
27,1,4,464,484,447,931,"21 de agosto de 1994"
27,1,4,465,321,315,636,"21 de agosto de 1994"
27,1,4,466,283,271,554,"21 de agosto de 1994"
27,1,4,467,633,594,1227,"21 de agosto de 1994"
27,1,4,468,368,373,741,"21 de agosto de 1994"
27,1,4,469,475,426,901,"21 de agosto de 1994"
27,1,4,470,450,452,902,"21 de agosto de 1994"
27,1,4,471,203,186,389,"21 de agosto de 1994"
27,1,4,472,391,377,768,"21 de agosto de 1994"
27,1,4,473,204,144,348,"21 de agosto de 1994"
27,1,4,474,465,443,908,"21 de agosto de 1994"
27,1,4,475,356,328,684,"21 de agosto de 1994"
27,1,4,476,360,333,693,"21 de agosto de 1994"
27,1,4,477,489,409,898,"21 de agosto de 1994"
27,1,4,478,370,348,718,"21 de agosto de 1994"
27,1,4,479,293,272,565,"21 de agosto de 1994"
27,1,4,480,735,693,1428,"21 de agosto de 1994"
27,1,4,481,528,464,992,"21 de agosto de 1994"
27,1,4,482,334,313,647,"21 de agosto de 1994"
27,1,4,483,254,288,542,"21 de agosto de 1994"
27,1,4,484,513,454,967,"21 de agosto de 1994"
27,1,4,485,490,505,995,"21 de agosto de 1994"
27,1,4,486,368,360,728,"21 de agosto de 1994"
27,1,4,487,181,193,374,"21 de agosto de 1994"
27,1,4,488,194,238,432,"21 de agosto de 1994"
27,1,4,489,377,360,737,"21 de agosto de 1994"
27,1,4,490,408,370,778,"21 de agosto de 1994"
27,1,4,491,436,394,830,"21 de agosto de 1994"
27,1,4,492,258,216,474,"21 de agosto de 1994"
27,1,4,493,255,240,495,"21 de agosto de 1994"
27,1,4,494,406,352,758,"21 de agosto de 1994"
27,1,4,495,490,428,918,"21 de agosto de 1994"
27,1,4,496,216,180,396,"21 de agosto de 1994"
27,1,4,497,570,501,1071,"21 de agosto de 1994"
27,1,4,498,519,433,952,"21 de agosto de 1994"
27,1,4,499,125,127,252,"21 de agosto de 1994"
27,1,4,500,532,556,1088,"21 de agosto de 1994"
27,1,4,501,531,528,1059,"21 de agosto de 1994"
27,1,4,502,737,700,1437,"21 de agosto de 1994"
27,1,4,503,540,530,1070,"21 de agosto de 1994"
27,1,4,504,435,379,814,"21 de agosto de 1994"
27,1,4,505,351,338,689,"21 de agosto de 1994"
27,1,4,506,245,241,486,"21 de agosto de 1994"
27,1,4,507,306,264,570,"21 de agosto de 1994"
27,1,4,508,448,443,891,"21 de agosto de 1994"
27,1,4,509,140,120,260,"21 de agosto de 1994"
27,1,4,510,129,99,228,"21 de agosto de 1994"
27,1,4,511,430,62,492,"21 de agosto de 1994"
27,2,1,1,427,409,836,"21 de agosto de 1994"
27,2,1,2,381,373,754,"21 de agosto de 1994"
27,2,1,3,390,416,806,"21 de agosto de 1994"
27,2,1,4,415,409,824,"21 de agosto de 1994"
27,2,1,5,455,472,927,"21 de agosto de 1994"
27,2,1,6,280,307,587,"21 de agosto de 1994"
27,2,1,7,405,381,786,"21 de agosto de 1994"
27,2,1,8,290,214,504,"21 de agosto de 1994"
27,2,1,9,411,306,717,"21 de agosto de 1994"
27,2,1,10,54,41,95,"21 de agosto de 1994"
27,2,1,11,153,121,274,"21 de agosto de 1994"
27,2,1,12,208,161,369,"21 de agosto de 1994"
27,2,1,13,368,337,705,"21 de agosto de 1994"
27,2,1,14,271,306,577,"21 de agosto de 1994"
27,2,1,15,388,349,737,"21 de agosto de 1994"
27,2,1,16,287,291,578,"21 de agosto de 1994"
27,2,1,17,336,305,641,"21 de agosto de 1994"
27,2,1,18,401,306,707,"21 de agosto de 1994"
27,2,1,19,97,59,156,"21 de agosto de 1994"
27,2,1,20,239,207,446,"21 de agosto de 1994"
27,2,1,21,104,82,186,"21 de agosto de 1994"
27,2,1,22,309,260,569,"21 de agosto de 1994"
27,2,1,23,365,293,658,"21 de agosto de 1994"
27,2,1,24,539,441,980,"21 de agosto de 1994"
27,2,1,25,272,209,481,"21 de agosto de 1994"
27,2,1,26,30,23,53,"21 de agosto de 1994"
27,2,1,27,259,239,498,"21 de agosto de 1994"
27,2,1,28,279,300,579,"21 de agosto de 1994"
27,2,1,29,199,162,361,"21 de agosto de 1994"
27,2,1,30,309,221,530,"21 de agosto de 1994"
27,2,1,31,75,55,130,"21 de agosto de 1994"
27,2,1,32,102,57,159,"21 de agosto de 1994"
27,2,1,33,170,141,311,"21 de agosto de 1994"
27,2,1,34,146,125,271,"21 de agosto de 1994"
27,2,1,35,466,428,894,"21 de agosto de 1994"
27,2,1,36,233,214,447,"21 de agosto de 1994"
27,2,1,37,483,389,872,"21 de agosto de 1994"
27,2,1,38,305,236,541,"21 de agosto de 1994"
27,2,1,39,331,281,612,"21 de agosto de 1994"
27,2,1,40,315,252,567,"21 de agosto de 1994"
27,2,1,41,323,267,590,"21 de agosto de 1994"
27,2,1,42,467,377,844,"21 de agosto de 1994"
27,2,1,43,433,434,867,"21 de agosto de 1994"
27,2,1,44,445,360,805,"21 de agosto de 1994"
27,2,1,45,351,274,625,"21 de agosto de 1994"
27,2,3,168,342,316,658,"21 de agosto de 1994"
27,2,3,169,383,388,771,"21 de agosto de 1994"
27,2,3,170,350,348,698,"21 de agosto de 1994"
27,2,3,171,448,460,908,"21 de agosto de 1994"
27,2,3,172,292,303,595,"21 de agosto de 1994"
27,2,3,173,300,316,616,"21 de agosto de 1994"
27,2,3,174,307,336,643,"21 de agosto de 1994"
27,2,3,175,362,370,732,"21 de agosto de 1994"
27,2,3,176,384,421,805,"21 de agosto de 1994"
27,2,3,177,447,443,890,"21 de agosto de 1994"
27,2,3,178,341,348,689,"21 de agosto de 1994"
27,2,3,179,540,368,908,"21 de agosto de 1994"
27,2,3,180,320,329,649,"21 de agosto de 1994"
27,2,3,181,198,166,364,"21 de agosto de 1994"
27,2,3,182,143,126,269,"21 de agosto de 1994"
27,2,3,183,236,184,420,"21 de agosto de 1994"
27,2,3,184,276,225,501,"21 de agosto de 1994"
27,2,3,185,118,85,203,"21 de agosto de 1994"
27,2,3,186,175,164,339,"21 de agosto de 1994"
27,2,3,187,74,71,145,"21 de agosto de 1994"
27,2,3,188,55,44,99,"21 de agosto de 1994"
27,2,3,189,383,332,715,"21 de agosto de 1994"
27,2,3,190,258,223,481,"21 de agosto de 1994"
27,2,3,191,135,128,263,"21 de agosto de 1994"
27,2,3,192,526,468,994,"21 de agosto de 1994"
27,2,3,193,132,80,212,"21 de agosto de 1994"
27,2,3,194,135,93,228,"21 de agosto de 1994"
27,2,3,195,163,150,313,"21 de agosto de 1994"
27,2,3,196,604,583,1187,"21 de agosto de 1994"
27,2,3,197,306,247,553,"21 de agosto de 1994"
27,2,3,198,260,218,478,"21 de agosto de 1994"
27,2,3,199,164,175,339,"21 de agosto de 1994"
27,2,3,200,407,311,718,"21 de agosto de 1994"
27,2,3,201,419,346,765,"21 de agosto de 1994"
27,2,3,202,428,312,740,"21 de agosto de 1994"
27,2,3,203,423,364,787,"21 de agosto de 1994"
27,2,3,204,523,451,974,"21 de agosto de 1994"
27,2,3,205,362,325,687,"21 de agosto de 1994"
27,2,3,206,406,376,782,"21 de agosto de 1994"
27,2,3,207,519,457,976,"21 de agosto de 1994"
27,2,3,208,314,286,600,"21 de agosto de 1994"
27,2,3,209,504,445,949,"21 de agosto de 1994"
27,2,3,210,478,400,878,"21 de agosto de 1994"
27,2,3,211,453,387,840,"21 de agosto de 1994"
27,2,3,212,294,269,563,"21 de agosto de 1994"
27,2,3,213,379,346,725,"21 de agosto de 1994"
27,2,3,214,384,361,745,"21 de agosto de 1994"
27,2,3,215,64,49,113,"21 de agosto de 1994"
27,2,3,216,376,322,698,"21 de agosto de 1994"
27,2,3,217,175,118,293,"21 de agosto de 1994"
27,2,3,218,61,43,104,"21 de agosto de 1994"
27,2,3,219,103,71,174,"21 de agosto de 1994"
27,2,3,220,263,193,456,"21 de agosto de 1994"
27,2,3,221,181,123,304,"21 de agosto de 1994"
27,2,3,222,426,360,786,"21 de agosto de 1994"
27,2,3,223,511,430,941,"21 de agosto de 1994"
27,2,3,224,404,320,724,"21 de agosto de 1994"
27,2,3,225,193,168,361,"21 de agosto de 1994"
27,2,3,226,104,64,168,"21 de agosto de 1994"
27,2,3,227,309,253,562,"21 de agosto de 1994"
27,2,3,228,261,208,469,"21 de agosto de 1994"
27,2,3,229,22,15,37,"21 de agosto de 1994"
27,2,3,230,33,21,54,"21 de agosto de 1994"
27,2,3,231,101,77,178,"21 de agosto de 1994"
27,2,7,668,430,457,887,"21 de agosto de 1994"
27,2,7,669,465,451,916,"21 de agosto de 1994"
27,2,7,670,395,392,787,"21 de agosto de 1994"
27,2,7,671,480,494,974,"21 de agosto de 1994"
27,2,7,672,430,493,923,"21 de agosto de 1994"
27,2,7,673,482,490,972,"21 de agosto de 1994"
27,2,7,674,592,541,1133,"21 de agosto de 1994"
27,2,7,675,294,354,648,"21 de agosto de 1994"
27,2,7,676,469,484,953,"21 de agosto de 1994"
27,2,7,677,503,581,1084,"21 de agosto de 1994"
27,2,7,678,812,704,1516,"21 de agosto de 1994"
27,2,7,679,245,200,445,"21 de agosto de 1994"
27,2,7,680,103,85,188,"21 de agosto de 1994"
27,2,7,681,221,188,409,"21 de agosto de 1994"
27,2,7,682,263,217,480,"21 de agosto de 1994"
27,2,7,683,407,405,812,"21 de agosto de 1994"
27,2,10,809,369,364,733,"21 de agosto de 1994"
27,2,10,810,626,592,1218,"21 de agosto de 1994"
27,2,10,811,475,528,1003,"21 de agosto de 1994"
27,2,10,812,378,401,779,"21 de agosto de 1994"
27,2,10,813,441,420,861,"21 de agosto de 1994"
27,2,10,814,375,394,769,"21 de agosto de 1994"
27,2,10,815,378,364,742,"21 de agosto de 1994"
27,2,10,816,413,404,817,"21 de agosto de 1994"
27,2,10,817,347,366,713,"21 de agosto de 1994"
27,2,10,818,217,197,414,"21 de agosto de 1994"
27,2,10,819,348,340,688,"21 de agosto de 1994"
27,2,10,820,192,202,394,"21 de agosto de 1994"
27,2,10,821,489,439,928,"21 de agosto de 1994"
27,2,10,822,417,372,789,"21 de agosto de 1994"
27,2,10,823,665,555,1220,"21 de agosto de 1994"
27,2,10,824,332,300,632,"21 de agosto de 1994"
27,2,10,825,526,521,1047,"21 de agosto de 1994"
27,2,10,826,497,472,969,"21 de agosto de 1994"
27,2,10,827,682,588,1270,"21 de agosto de 1994"
27,2,10,828,366,324,690,"21 de agosto de 1994"
27,2,10,829,824,782,1606,"21 de agosto de 1994"
27,2,10,830,57,61,118,"21 de agosto de 1994"
27,2,10,831,295,279,574,"21 de agosto de 1994"
27,2,10,832,583,523,1106,"21 de agosto de 1994"
27,2,10,833,361,340,701,"21 de agosto de 1994"
27,2,10,834,470,473,943,"21 de agosto de 1994"
27,2,10,835,235,251,486,"21 de agosto de 1994"
27,2,10,836,480,447,927,"21 de agosto de 1994"
27,2,10,837,125,102,227,"21 de agosto de 1994"
27,2,10,838,516,520,1036,"21 de agosto de 1994"
27,2,10,839,544,497,1041,"21 de agosto de 1994"
27,2,10,840,389,387,776,"21 de agosto de 1994"
27,2,10,841,525,472,997,"21 de agosto de 1994"
27,2,10,842,604,491,1095,"21 de agosto de 1994"
27,2,10,843,314,263,577,"21 de agosto de 1994"
27,2,10,844,311,302,613,"21 de agosto de 1994"
27,2,10,845,471,413,884,"21 de agosto de 1994"
27,2,11,846,345,356,701,"21 de agosto de 1994"
27,2,11,847,325,307,632,"21 de agosto de 1994"
27,2,11,848,356,335,691,"21 de agosto de 1994"
27,2,11,849,329,301,630,"21 de agosto de 1994"
27,2,11,850,141,112,253,"21 de agosto de 1994"
27,2,11,851,211,196,407,"21 de agosto de 1994"
27,2,11,852,170,135,305,"21 de agosto de 1994"
27,2,11,853,137,114,251,"21 de agosto de 1994"
27,2,11,854,65,58,123,"21 de agosto de 1994"
27,2,11,855,102,84,186,"21 de agosto de 1994"
27,2,11,856,109,89,198,"21 de agosto de 1994"
27,2,11,857,153,109,262,"21 de agosto de 1994"
27,2,11,858,339,296,635,"21 de agosto de 1994"
27,2,11,859,310,224,534,"21 de agosto de 1994"
27,2,11,860,200,180,380,"21 de agosto de 1994"
27,2,11,861,344,295,639,"21 de agosto de 1994"
27,2,11,862,187,133,320,"21 de agosto de 1994"
27,2,11,863,400,331,731,"21 de agosto de 1994"
27,2,11,864,83,64,147,"21 de agosto de 1994"
27,2,11,865,237,216,453,"21 de agosto de 1994"
27,2,11,866,147,123,270,"21 de agosto de 1994"
27,2,11,867,128,117,245,"21 de agosto de 1994"
27,2,11,868,336,274,610,"21 de agosto de 1994"
27,2,11,869,301,255,556,"21 de agosto de 1994"
27,2,11,870,307,233,540,"21 de agosto de 1994"
27,2,11,871,213,183,396,"21 de agosto de 1994"
27,2,13,954,265,296,561,"21 de agosto de 1994"
27,2,13,955,349,364,713,"21 de agosto de 1994"
27,2,13,956,445,419,864,"21 de agosto de 1994"
27,2,13,957,338,385,723,"21 de agosto de 1994"
27,2,13,958,476,476,952,"21 de agosto de 1994"
27,2,13,959,349,325,674,"21 de agosto de 1994"
27,2,13,960,574,517,1091,"21 de agosto de 1994"
27,2,13,961,103,77,180,"21 de agosto de 1994"
27,2,13,962,516,479,995,"21 de agosto de 1994"
27,2,13,963,439,415,854,"21 de agosto de 1994"
27,2,13,964,538,514,1052,"21 de agosto de 1994"
27,2,13,965,602,470,1072,"21 de agosto de 1994"
27,2,13,966,163,137,300,"21 de agosto de 1994"
27,2,13,967,436,396,832,"21 de agosto de 1994"
27,2,13,968,359,313,672,"21 de agosto de 1994"
27,2,13,969,477,430,907,"21 de agosto de 1994"
27,2,13,970,357,321,678,"21 de agosto de 1994"
27,2,13,971,631,571,1202,"21 de agosto de 1994"
27,2,13,972,459,412,871,"21 de agosto de 1994"
27,2,13,973,158,149,307,"21 de agosto de 1994"
27,2,13,974,653,565,1218,"21 de agosto de 1994"
27,2,13,975,232,242,474,"21 de agosto de 1994"
27,2,13,976,427,410,837,"21 de agosto de 1994"
27,2,13,977,285,250,535,"21 de agosto de 1994"
27,2,13,978,283,304,587,"21 de agosto de 1994"
27,2,13,979,369,335,704,"21 de agosto de 1994"
27,2,13,980,518,509,1027,"21 de agosto de 1994"
27,2,13,981,244,197,441,"21 de agosto de 1994"
27,2,13,982,752,712,1464,"21 de agosto de 1994"
27,2,13,983,298,299,597,"21 de agosto de 1994"
27,2,13,984,350,319,669,"21 de agosto de 1994"
27,2,13,985,407,391,798,"21 de agosto de 1994"
27,2,13,986,730,857,1587,"21 de agosto de 1994"
27,2,13,987,375,416,791,"21 de agosto de 1994"
27,2,13,988,310,321,631,"21 de agosto de 1994"
27,2,13,989,264,334,598,"21 de agosto de 1994"
27,2,13,990,377,398,775,"21 de agosto de 1994"
27,2,17,1089,221,203,424,"21 de agosto de 1994"
27,2,17,1090,339,382,721,"21 de agosto de 1994"
27,2,17,1091,333,388,721,"21 de agosto de 1994"
27,2,17,1092,360,412,772,"21 de agosto de 1994"
27,2,17,1093,304,353,657,"21 de agosto de 1994"
27,2,17,1094,370,428,798,"21 de agosto de 1994"
27,2,17,1095,175,210,385,"21 de agosto de 1994"
27,2,17,1096,447,527,974,"21 de agosto de 1994"
27,2,17,1097,472,494,966,"21 de agosto de 1994"
27,2,17,1098,337,424,761,"21 de agosto de 1994"
27,2,17,1099,396,466,862,"21 de agosto de 1994"
27,2,17,1100,329,365,694,"21 de agosto de 1994"
27,2,17,1101,395,410,805,"21 de agosto de 1994"
27,2,17,1102,359,379,738,"21 de agosto de 1994"
27,2,17,1103,340,390,730,"21 de agosto de 1994"
27,2,17,1104,487,477,964,"21 de agosto de 1994"
27,2,17,1105,345,394,739,"21 de agosto de 1994"
27,2,17,1106,197,215,412,"21 de agosto de 1994"
27,2,17,1107,310,287,597,"21 de agosto de 1994"
27,2,17,1108,372,290,662,"21 de agosto de 1994"
27,2,17,1109,240,205,445,"21 de agosto de 1994"
27,2,17,1110,127,107,234,"21 de agosto de 1994"
27,2,17,1111,336,264,600,"21 de agosto de 1994"
27,2,17,1112,159,130,289,"21 de agosto de 1994"
27,2,17,1113,363,316,679,"21 de agosto de 1994"
27,2,17,1114,374,357,731,"21 de agosto de 1994"
27,2,17,1115,234,212,446,"21 de agosto de 1994"
27,2,17,1116,248,219,467,"21 de agosto de 1994"
27,2,17,1117,263,223,486,"21 de agosto de 1994"
27,2,17,1118,363,320,683,"21 de agosto de 1994"
27,2,17,1119,339,276,615,"21 de agosto de 1994"
27,2,17,1120,117,93,210,"21 de agosto de 1994"
27,2,17,1121,417,456,873,"21 de agosto de 1994"
27,2,17,1122,296,268,564,"21 de agosto de 1994"
27,2,17,1123,270,210,480,"21 de agosto de 1994"
27,2,17,1124,72,63,135,"21 de agosto de 1994"
27,2,17,1125,232,192,424,"21 de agosto de 1994"
27,2,17,1126,231,186,417,"21 de agosto de 1994"
27,2,17,1127,340,303,643,"21 de agosto de 1994"
27,2,17,1128,384,341,725,"21 de agosto de 1994"
27,2,17,1129,90,68,158,"21 de agosto de 1994"
27,2,17,1130,356,310,666,"21 de agosto de 1994"
27,2,17,1131,213,183,396,"21 de agosto de 1994"
27,2,17,1132,118,99,217,"21 de agosto de 1994"
27,2,17,1133,500,19,519,"21 de agosto de 1994"
27,3,2,46,425,483,908,"21 de agosto de 1994"
27,3,2,47,362,370,732,"21 de agosto de 1994"
27,3,2,48,305,315,620,"21 de agosto de 1994"
27,3,2,49,217,229,446,"21 de agosto de 1994"
27,3,2,50,455,447,902,"21 de agosto de 1994"
27,3,2,51,382,362,744,"21 de agosto de 1994"
27,3,2,52,312,335,647,"21 de agosto de 1994"
27,3,2,53,404,385,789,"21 de agosto de 1994"
27,3,2,54,446,444,890,"21 de agosto de 1994"
27,3,2,55,399,403,802,"21 de agosto de 1994"
27,3,2,56,370,385,755,"21 de agosto de 1994"
27,3,2,57,340,321,661,"21 de agosto de 1994"
27,3,2,58,343,394,737,"21 de agosto de 1994"
27,3,2,59,413,405,818,"21 de agosto de 1994"
27,3,2,60,370,399,769,"21 de agosto de 1994"
27,3,2,61,332,340,672,"21 de agosto de 1994"
27,3,2,62,346,394,740,"21 de agosto de 1994"
27,3,2,63,314,326,640,"21 de agosto de 1994"
27,3,2,64,431,483,914,"21 de agosto de 1994"
27,3,2,65,465,530,995,"21 de agosto de 1994"
27,3,2,66,392,406,798,"21 de agosto de 1994"
27,3,2,67,328,361,689,"21 de agosto de 1994"
27,3,2,68,318,339,657,"21 de agosto de 1994"
27,3,2,69,268,328,596,"21 de agosto de 1994"
27,3,2,70,368,380,748,"21 de agosto de 1994"
27,3,2,71,340,337,677,"21 de agosto de 1994"
27,3,2,72,439,485,924,"21 de agosto de 1994"
27,3,2,73,421,410,831,"21 de agosto de 1994"
27,3,2,74,377,362,739,"21 de agosto de 1994"
27,3,2,75,465,543,1008,"21 de agosto de 1994"
27,3,2,76,305,333,638,"21 de agosto de 1994"
27,3,2,77,394,444,838,"21 de agosto de 1994"
27,3,2,78,404,454,858,"21 de agosto de 1994"
27,3,2,79,430,436,866,"21 de agosto de 1994"
27,3,2,80,331,339,670,"21 de agosto de 1994"
27,3,2,81,513,481,994,"21 de agosto de 1994"
27,3,2,82,415,441,856,"21 de agosto de 1994"
27,3,2,83,433,442,875,"21 de agosto de 1994"
27,3,2,84,441,443,884,"21 de agosto de 1994"
27,3,2,85,496,472,968,"21 de agosto de 1994"
27,3,2,86,466,537,1003,"21 de agosto de 1994"
27,3,2,87,492,486,978,"21 de agosto de 1994"
27,3,2,88,395,441,836,"21 de agosto de 1994"
27,3,2,89,511,501,1012,"21 de agosto de 1994"
27,3,2,90,348,284,632,"21 de agosto de 1994"
27,3,2,91,366,301,667,"21 de agosto de 1994"
27,3,2,92,580,532,1112,"21 de agosto de 1994"
27,3,2,93,582,568,1150,"21 de agosto de 1994"
27,3,2,94,467,444,911,"21 de agosto de 1994"
27,3,2,95,475,466,941,"21 de agosto de 1994"
27,3,2,96,193,165,358,"21 de agosto de 1994"
27,3,2,97,257,222,479,"21 de agosto de 1994"
27,3,2,98,380,328,708,"21 de agosto de 1994"
27,3,2,99,344,311,655,"21 de agosto de 1994"
27,3,2,100,484,461,945,"21 de agosto de 1994"
27,3,2,101,380,375,755,"21 de agosto de 1994"
27,3,2,102,337,285,622,"21 de agosto de 1994"
27,3,2,103,327,289,616,"21 de agosto de 1994"
27,3,2,104,242,212,454,"21 de agosto de 1994"
27,3,2,105,440,417,857,"21 de agosto de 1994"
27,3,2,106,350,301,651,"21 de agosto de 1994"
27,3,2,107,464,456,920,"21 de agosto de 1994"
27,3,2,108,221,201,422,"21 de agosto de 1994"
27,3,2,109,335,318,653,"21 de agosto de 1994"
27,3,2,110,631,589,1220,"21 de agosto de 1994"
27,3,2,111,165,149,314,"21 de agosto de 1994"
27,3,2,112,401,388,789,"21 de agosto de 1994"
27,3,2,113,300,317,617,"21 de agosto de 1994"
27,3,2,114,367,359,726,"21 de agosto de 1994"
27,3,2,115,250,282,532,"21 de agosto de 1994"
27,3,2,116,336,330,666,"21 de agosto de 1994"
27,3,2,117,145,145,290,"21 de agosto de 1994"
27,3,2,118,255,235,490,"21 de agosto de 1994"
27,3,2,119,420,318,738,"21 de agosto de 1994"
27,3,2,120,462,410,872,"21 de agosto de 1994"
27,3,2,121,504,468,972,"21 de agosto de 1994"
27,3,2,122,496,436,932,"21 de agosto de 1994"
27,3,2,123,351,357,708,"21 de agosto de 1994"
27,3,2,124,251,240,491,"21 de agosto de 1994"
27,3,2,125,439,439,878,"21 de agosto de 1994"
27,3,2,126,278,237,515,"21 de agosto de 1994"
27,3,2,127,340,309,649,"21 de agosto de 1994"
27,3,2,128,284,245,529,"21 de agosto de 1994"
27,3,2,129,433,397,830,"21 de agosto de 1994"
27,3,2,130,526,512,1038,"21 de agosto de 1994"
27,3,2,131,443,410,853,"21 de agosto de 1994"
27,3,2,132,402,396,798,"21 de agosto de 1994"
27,3,2,133,449,420,869,"21 de agosto de 1994"
27,3,2,134,536,491,1027,"21 de agosto de 1994"
27,3,2,135,160,142,302,"21 de agosto de 1994"
27,3,2,136,262,224,486,"21 de agosto de 1994"
27,3,2,137,539,553,1092,"21 de agosto de 1994"
27,3,2,138,509,490,999,"21 de agosto de 1994"
27,3,2,139,314,307,621,"21 de agosto de 1994"
27,3,2,140,259,254,513,"21 de agosto de 1994"
27,3,2,141,322,300,622,"21 de agosto de 1994"
27,3,2,142,322,306,628,"21 de agosto de 1994"
27,3,2,143,476,431,907,"21 de agosto de 1994"
27,3,2,144,542,496,1038,"21 de agosto de 1994"
27,3,2,145,430,389,819,"21 de agosto de 1994"
27,3,2,146,559,548,1107,"21 de agosto de 1994"
27,3,2,147,410,415,825,"21 de agosto de 1994"
27,3,2,148,615,558,1173,"21 de agosto de 1994"
27,3,2,149,437,407,844,"21 de agosto de 1994"
27,3,2,150,287,292,579,"21 de agosto de 1994"
27,3,2,151,363,341,704,"21 de agosto de 1994"
27,3,2,152,652,604,1256,"21 de agosto de 1994"
27,3,2,153,171,116,287,"21 de agosto de 1994"
27,3,2,154,489,459,948,"21 de agosto de 1994"
27,3,2,155,583,552,1135,"21 de agosto de 1994"
27,3,2,156,388,341,729,"21 de agosto de 1994"
27,3,2,157,555,489,1044,"21 de agosto de 1994"
27,3,2,158,338,334,672,"21 de agosto de 1994"
27,3,2,159,317,302,619,"21 de agosto de 1994"
27,3,2,160,517,449,966,"21 de agosto de 1994"
27,3,2,161,176,168,344,"21 de agosto de 1994"
27,3,2,162,358,303,661,"21 de agosto de 1994"
27,3,2,163,532,505,1037,"21 de agosto de 1994"
27,3,2,164,365,325,690,"21 de agosto de 1994"
27,3,2,165,502,426,928,"21 de agosto de 1994"
27,3,2,166,323,327,650,"21 de agosto de 1994"
27,3,2,167,286,140,426,"21 de agosto de 1994"
27,3,8,684,397,421,818,"21 de agosto de 1994"
27,3,8,685,360,353,713,"21 de agosto de 1994"
27,3,8,686,408,410,818,"21 de agosto de 1994"
27,3,8,687,434,438,872,"21 de agosto de 1994"
27,3,8,688,401,400,801,"21 de agosto de 1994"
27,3,8,689,322,346,668,"21 de agosto de 1994"
27,3,8,690,297,318,615,"21 de agosto de 1994"
27,3,8,691,341,359,700,"21 de agosto de 1994"
27,3,8,692,457,471,928,"21 de agosto de 1994"
27,3,8,693,420,442,862,"21 de agosto de 1994"
27,3,8,694,517,528,1045,"21 de agosto de 1994"
27,3,8,695,528,486,1014,"21 de agosto de 1994"
27,3,8,696,441,492,933,"21 de agosto de 1994"
27,3,8,697,421,427,848,"21 de agosto de 1994"
27,3,8,698,315,301,616,"21 de agosto de 1994"
27,3,8,699,653,602,1255,"21 de agosto de 1994"
27,3,8,700,466,473,939,"21 de agosto de 1994"
27,3,8,701,368,360,728,"21 de agosto de 1994"
27,3,8,702,352,341,693,"21 de agosto de 1994"
27,3,8,703,614,587,1201,"21 de agosto de 1994"
27,3,8,704,476,472,948,"21 de agosto de 1994"
27,3,8,705,312,281,593,"21 de agosto de 1994"
27,3,8,706,515,445,960,"21 de agosto de 1994"
27,3,8,707,530,458,988,"21 de agosto de 1994"
27,3,8,708,533,477,1010,"21 de agosto de 1994"
27,3,8,709,179,166,345,"21 de agosto de 1994"
27,3,8,710,486,448,934,"21 de agosto de 1994"
27,3,8,711,480,439,919,"21 de agosto de 1994"
27,3,8,712,493,431,924,"21 de agosto de 1994"
27,3,8,713,424,361,785,"21 de agosto de 1994"
27,3,8,714,521,468,989,"21 de agosto de 1994"
27,3,8,715,41,28,69,"21 de agosto de 1994"
27,3,8,716,457,407,864,"21 de agosto de 1994"
27,3,8,717,253,240,493,"21 de agosto de 1994"
27,3,8,718,414,403,817,"21 de agosto de 1994"
27,3,8,719,390,380,770,"21 de agosto de 1994"
27,3,8,720,346,285,631,"21 de agosto de 1994"
27,3,8,721,345,334,679,"21 de agosto de 1994"
27,3,8,722,602,591,1193,"21 de agosto de 1994"
27,3,8,723,529,451,980,"21 de agosto de 1994"
27,3,8,724,420,389,809,"21 de agosto de 1994"
27,3,8,725,466,431,897,"21 de agosto de 1994"
27,3,8,726,426,375,801,"21 de agosto de 1994"
27,3,8,727,610,552,1162,"21 de agosto de 1994"
27,3,8,728,457,415,872,"21 de agosto de 1994"
27,3,8,729,717,676,1393,"21 de agosto de 1994"
27,3,8,730,403,367,770,"21 de agosto de 1994"
27,3,8,731,462,443,905,"21 de agosto de 1994"
27,3,8,732,230,202,432,"21 de agosto de 1994"
27,3,8,733,599,478,1077,"21 de agosto de 1994"
27,3,8,734,89,78,167,"21 de agosto de 1994"
27,3,8,735,415,357,772,"21 de agosto de 1994"
27,3,8,736,357,301,658,"21 de agosto de 1994"
27,3,8,737,194,157,351,"21 de agosto de 1994"
27,3,8,738,498,477,975,"21 de agosto de 1994"
27,3,8,739,184,154,338,"21 de agosto de 1994"
27,3,8,740,47,36,83,"21 de agosto de 1994"
27,3,8,741,533,472,1005,"21 de agosto de 1994"
27,3,8,742,375,312,687,"21 de agosto de 1994"
27,3,8,743,578,499,1077,"21 de agosto de 1994"
27,3,8,744,415,389,804,"21 de agosto de 1994"
27,3,8,745,145,125,270,"21 de agosto de 1994"
27,3,8,746,349,344,693,"21 de agosto de 1994"
27,3,8,747,526,437,963,"21 de agosto de 1994"
27,3,8,748,502,419,921,"21 de agosto de 1994"
27,3,8,749,241,188,429,"21 de agosto de 1994"
27,3,8,750,211,159,370,"21 de agosto de 1994"
27,3,8,751,142,120,262,"21 de agosto de 1994"
27,3,8,752,220,209,429,"21 de agosto de 1994"
27,3,8,753,167,132,299,"21 de agosto de 1994"
27,3,8,754,192,164,356,"21 de agosto de 1994"
27,3,8,755,137,105,242,"21 de agosto de 1994"
27,3,8,756,345,284,629,"21 de agosto de 1994"
27,3,8,757,493,460,953,"21 de agosto de 1994"
27,3,8,758,265,220,485,"21 de agosto de 1994"
27,3,8,759,441,364,805,"21 de agosto de 1994"
27,3,8,760,391,296,687,"21 de agosto de 1994"
27,3,8,761,90,89,179,"21 de agosto de 1994"
27,3,8,762,236,171,407,"21 de agosto de 1994"
27,3,8,763,412,347,759,"21 de agosto de 1994"
27,3,8,764,266,201,467,"21 de agosto de 1994"
27,3,8,765,383,363,746,"21 de agosto de 1994"
27,3,8,766,305,285,590,"21 de agosto de 1994"
27,3,8,767,322,305,627,"21 de agosto de 1994"
27,3,8,768,293,274,567,"21 de agosto de 1994"
27,3,8,769,260,208,468,"21 de agosto de 1994"
27,3,8,770,379,354,733,"21 de agosto de 1994"
27,3,8,771,288,256,544,"21 de agosto de 1994"
27,3,8,772,134,121,255,"21 de agosto de 1994"
27,3,8,773,358,303,661,"21 de agosto de 1994"
27,3,8,774,295,252,547,"21 de agosto de 1994"
27,3,8,775,164,140,304,"21 de agosto de 1994"
27,3,8,776,255,210,465,"21 de agosto de 1994"
27,3,8,777,363,310,673,"21 de agosto de 1994"
27,3,8,778,306,259,565,"21 de agosto de 1994"
27,3,8,779,306,257,563,"21 de agosto de 1994"
27,3,8,780,269,210,479,"21 de agosto de 1994"
27,4,5,512,443,459,902,"21 de agosto de 1994"
27,4,5,513,336,359,695,"21 de agosto de 1994"
27,4,5,514,265,288,553,"21 de agosto de 1994"
27,4,5,515,520,559,1079,"21 de agosto de 1994"
27,4,5,516,486,537,1023,"21 de agosto de 1994"
27,4,5,517,414,410,824,"21 de agosto de 1994"
27,4,5,518,225,268,493,"21 de agosto de 1994"
27,4,5,519,370,378,748,"21 de agosto de 1994"
27,4,5,520,282,335,617,"21 de agosto de 1994"
27,4,5,521,293,315,608,"21 de agosto de 1994"
27,4,5,522,315,297,612,"21 de agosto de 1994"
27,4,5,523,343,357,700,"21 de agosto de 1994"
27,4,5,524,324,343,667,"21 de agosto de 1994"
27,4,5,525,323,326,649,"21 de agosto de 1994"
27,4,5,526,279,306,585,"21 de agosto de 1994"
27,4,5,527,334,364,698,"21 de agosto de 1994"
27,4,5,528,443,492,935,"21 de agosto de 1994"
27,4,5,529,366,385,751,"21 de agosto de 1994"
27,4,5,530,353,388,741,"21 de agosto de 1994"
27,4,5,531,279,326,605,"21 de agosto de 1994"
27,4,5,532,273,309,582,"21 de agosto de 1994"
27,4,5,533,438,446,884,"21 de agosto de 1994"
27,4,5,534,406,432,838,"21 de agosto de 1994"
27,4,5,535,312,353,665,"21 de agosto de 1994"
27,4,5,536,395,369,764,"21 de agosto de 1994"
27,4,5,537,369,347,716,"21 de agosto de 1994"
27,4,5,538,656,633,1289,"21 de agosto de 1994"
27,4,5,539,237,231,468,"21 de agosto de 1994"
27,4,5,540,304,284,588,"21 de agosto de 1994"
27,4,5,541,248,235,483,"21 de agosto de 1994"
27,4,5,542,486,443,929,"21 de agosto de 1994"
27,4,5,543,376,321,697,"21 de agosto de 1994"
27,4,5,544,277,252,529,"21 de agosto de 1994"
27,4,5,545,496,464,960,"21 de agosto de 1994"
27,4,5,546,363,320,683,"21 de agosto de 1994"
27,4,5,547,290,259,549,"21 de agosto de 1994"
27,4,5,548,381,382,763,"21 de agosto de 1994"
27,4,5,549,315,309,624,"21 de agosto de 1994"
27,4,5,550,447,451,898,"21 de agosto de 1994"
27,4,5,551,354,323,677,"21 de agosto de 1994"
27,4,5,552,421,406,827,"21 de agosto de 1994"
27,4,5,553,356,346,702,"21 de agosto de 1994"
27,4,5,554,464,431,895,"21 de agosto de 1994"
27,4,5,555,565,548,1113,"21 de agosto de 1994"
27,4,5,556,366,350,716,"21 de agosto de 1994"
27,4,5,557,392,330,722,"21 de agosto de 1994"
27,4,5,558,447,442,889,"21 de agosto de 1994"
27,4,5,559,360,353,713,"21 de agosto de 1994"
27,4,5,560,475,451,926,"21 de agosto de 1994"
27,4,5,561,400,370,770,"21 de agosto de 1994"
27,4,5,562,409,405,814,"21 de agosto de 1994"
27,4,5,563,410,394,804,"21 de agosto de 1994"
27,4,5,564,380,383,763,"21 de agosto de 1994"
27,4,5,565,405,397,802,"21 de agosto de 1994"
27,4,5,566,275,262,537,"21 de agosto de 1994"
27,4,5,567,327,336,663,"21 de agosto de 1994"
27,4,5,568,562,568,1130,"21 de agosto de 1994"
27,4,5,569,348,333,681,"21 de agosto de 1994"
27,4,5,570,544,433,977,"21 de agosto de 1994"
27,4,5,571,396,356,752,"21 de agosto de 1994"
27,4,5,572,455,423,878,"21 de agosto de 1994"
27,4,5,573,450,417,867,"21 de agosto de 1994"
27,4,5,574,523,489,1012,"21 de agosto de 1994"
27,4,5,575,489,443,932,"21 de agosto de 1994"
27,4,5,576,571,520,1091,"21 de agosto de 1994"
27,4,5,577,421,388,809,"21 de agosto de 1994"
27,4,5,578,374,329,703,"21 de agosto de 1994"
27,4,5,579,324,313,637,"21 de agosto de 1994"
27,4,5,580,249,223,472,"21 de agosto de 1994"
27,4,5,581,410,410,820,"21 de agosto de 1994"
27,4,5,582,354,371,725,"21 de agosto de 1994"
27,4,5,583,461,437,898,"21 de agosto de 1994"
27,4,5,584,394,360,754,"21 de agosto de 1994"
27,4,5,585,410,433,843,"21 de agosto de 1994"
27,4,5,586,407,418,825,"21 de agosto de 1994"
27,4,5,587,616,606,1222,"21 de agosto de 1994"
27,4,5,588,386,356,742,"21 de agosto de 1994"
27,4,5,589,355,301,656,"21 de agosto de 1994"
27,4,5,590,594,577,1171,"21 de agosto de 1994"
27,4,5,591,600,573,1173,"21 de agosto de 1994"
27,4,5,592,502,452,954,"21 de agosto de 1994"
27,4,5,593,414,400,814,"21 de agosto de 1994"
27,4,5,594,404,356,760,"21 de agosto de 1994"
27,4,5,595,340,346,686,"21 de agosto de 1994"
27,4,5,596,362,321,683,"21 de agosto de 1994"
27,4,5,597,269,259,528,"21 de agosto de 1994"
27,4,5,598,460,438,898,"21 de agosto de 1994"
27,4,5,599,240,235,475,"21 de agosto de 1994"
27,4,5,600,457,421,878,"21 de agosto de 1994"
27,4,5,601,498,460,958,"21 de agosto de 1994"
27,4,5,602,448,383,831,"21 de agosto de 1994"
27,4,5,603,407,386,793,"21 de agosto de 1994"
27,4,5,604,460,414,874,"21 de agosto de 1994"
27,4,5,605,217,196,413,"21 de agosto de 1994"
27,4,5,606,539,492,1031,"21 de agosto de 1994"
27,4,5,607,474,431,905,"21 de agosto de 1994"
27,4,5,608,491,461,952,"21 de agosto de 1994"
27,4,6,609,402,359,761,"21 de agosto de 1994"
27,4,6,610,432,448,880,"21 de agosto de 1994"
27,4,6,611,445,439,884,"21 de agosto de 1994"
27,4,6,612,412,448,860,"21 de agosto de 1994"
27,4,6,613,481,510,991,"21 de agosto de 1994"
27,4,6,614,403,384,787,"21 de agosto de 1994"
27,4,6,615,436,425,861,"21 de agosto de 1994"
27,4,6,616,329,347,676,"21 de agosto de 1994"
27,4,6,617,469,462,931,"21 de agosto de 1994"
27,4,6,618,427,386,813,"21 de agosto de 1994"
27,4,6,619,366,319,685,"21 de agosto de 1994"
27,4,6,620,549,539,1088,"21 de agosto de 1994"
27,4,6,621,430,398,828,"21 de agosto de 1994"
27,4,6,622,256,191,447,"21 de agosto de 1994"
27,4,6,623,284,216,500,"21 de agosto de 1994"
27,4,6,624,371,324,695,"21 de agosto de 1994"
27,4,6,625,385,358,743,"21 de agosto de 1994"
27,4,6,626,294,279,573,"21 de agosto de 1994"
27,4,6,627,262,272,534,"21 de agosto de 1994"
27,4,6,628,411,389,800,"21 de agosto de 1994"
27,4,6,629,362,326,688,"21 de agosto de 1994"
27,4,6,630,371,361,732,"21 de agosto de 1994"
27,4,6,631,490,462,952,"21 de agosto de 1994"
27,4,6,632,254,235,489,"21 de agosto de 1994"
27,4,6,633,369,329,698,"21 de agosto de 1994"
27,4,6,634,517,490,1007,"21 de agosto de 1994"
27,4,6,635,485,475,960,"21 de agosto de 1994"
27,4,6,636,455,377,832,"21 de agosto de 1994"
27,4,6,637,323,319,642,"21 de agosto de 1994"
27,4,6,638,495,456,951,"21 de agosto de 1994"
27,4,6,639,397,374,771,"21 de agosto de 1994"
27,4,6,640,268,229,497,"21 de agosto de 1994"
27,4,6,641,687,617,1304,"21 de agosto de 1994"
27,4,6,642,702,683,1385,"21 de agosto de 1994"
27,4,6,643,348,350,698,"21 de agosto de 1994"
27,4,6,644,303,302,605,"21 de agosto de 1994"
27,4,6,645,614,607,1221,"21 de agosto de 1994"
27,4,6,646,329,316,645,"21 de agosto de 1994"
27,4,6,647,454,392,846,"21 de agosto de 1994"
27,4,6,648,365,349,714,"21 de agosto de 1994"
27,4,6,649,373,347,720,"21 de agosto de 1994"
27,4,6,650,328,322,650,"21 de agosto de 1994"
27,4,6,651,366,349,715,"21 de agosto de 1994"
27,4,6,652,426,364,790,"21 de agosto de 1994"
27,4,6,653,397,371,768,"21 de agosto de 1994"
27,4,6,654,547,494,1041,"21 de agosto de 1994"
27,4,6,655,342,312,654,"21 de agosto de 1994"
27,4,6,656,542,513,1055,"21 de agosto de 1994"
27,4,6,657,242,249,491,"21 de agosto de 1994"
27,4,6,658,362,330,692,"21 de agosto de 1994"
27,4,6,659,499,403,902,"21 de agosto de 1994"
27,4,6,660,186,176,362,"21 de agosto de 1994"
27,4,6,661,294,241,535,"21 de agosto de 1994"
27,4,6,662,341,299,640,"21 de agosto de 1994"
27,4,6,663,876,793,1669,"21 de agosto de 1994"
27,4,6,664,254,193,447,"21 de agosto de 1994"
27,4,6,665,460,429,889,"21 de agosto de 1994"
27,4,6,666,255,208,463,"21 de agosto de 1994"
27,4,6,667,293,233,526,"21 de agosto de 1994"
27,4,14,991,394,404,798,"21 de agosto de 1994"
27,4,14,992,267,292,559,"21 de agosto de 1994"
27,4,14,993,366,330,696,"21 de agosto de 1994"
27,4,14,994,404,393,797,"21 de agosto de 1994"
27,4,14,995,371,373,744,"21 de agosto de 1994"
27,4,14,996,312,316,628,"21 de agosto de 1994"
27,4,14,997,392,384,776,"21 de agosto de 1994"
27,4,14,998,337,350,687,"21 de agosto de 1994"
27,4,14,999,396,397,793,"21 de agosto de 1994"
27,4,14,1000,412,466,878,"21 de agosto de 1994"
27,4,14,1001,401,427,828,"21 de agosto de 1994"
27,4,14,1002,306,329,635,"21 de agosto de 1994"
27,4,14,1003,343,347,690,"21 de agosto de 1994"
27,4,14,1004,386,390,776,"21 de agosto de 1994"
27,4,14,1005,382,370,752,"21 de agosto de 1994"
27,4,14,1006,278,245,523,"21 de agosto de 1994"
27,4,14,1007,395,353,748,"21 de agosto de 1994"
27,4,14,1008,339,340,679,"21 de agosto de 1994"
27,4,14,1009,242,230,472,"21 de agosto de 1994"
27,4,14,1010,237,220,457,"21 de agosto de 1994"
27,4,14,1011,360,340,700,"21 de agosto de 1994"
27,4,14,1012,439,454,893,"21 de agosto de 1994"
27,4,14,1013,406,366,772,"21 de agosto de 1994"
27,4,14,1014,607,550,1157,"21 de agosto de 1994"
27,4,14,1015,259,272,531,"21 de agosto de 1994"
27,4,14,1016,491,507,998,"21 de agosto de 1994"
27,4,14,1017,345,335,680,"21 de agosto de 1994"
27,4,14,1018,394,369,763,"21 de agosto de 1994"
27,4,14,1019,383,325,708,"21 de agosto de 1994"
27,4,14,1020,309,299,608,"21 de agosto de 1994"
27,4,14,1021,444,401,845,"21 de agosto de 1994"
27,4,14,1022,716,677,1393,"21 de agosto de 1994"
27,4,14,1023,481,443,924,"21 de agosto de 1994"
27,4,14,1024,346,342,688,"21 de agosto de 1994"
27,4,14,1025,369,360,729,"21 de agosto de 1994"
27,4,14,1026,281,251,532,"21 de agosto de 1994"
27,4,14,1027,584,584,1168,"21 de agosto de 1994"
27,4,14,1028,472,433,905,"21 de agosto de 1994"
27,4,14,1029,449,405,854,"21 de agosto de 1994"
27,4,14,1030,308,301,609,"21 de agosto de 1994"
27,4,14,1031,166,157,323,"21 de agosto de 1994"
27,4,14,1032,421,436,857,"21 de agosto de 1994"
27,4,14,1033,456,413,869,"21 de agosto de 1994"
27,4,14,1034,325,291,616,"21 de agosto de 1994"
27,4,14,1035,396,395,791,"21 de agosto de 1994"
27,5,9,781,465,447,912,"21 de agosto de 1994"
27,5,9,782,394,394,788,"21 de agosto de 1994"
27,5,9,783,401,408,809,"21 de agosto de 1994"
27,5,9,784,136,140,276,"21 de agosto de 1994"
27,5,9,785,305,304,609,"21 de agosto de 1994"
27,5,9,786,435,368,803,"21 de agosto de 1994"
27,5,9,787,198,166,364,"21 de agosto de 1994"
27,5,9,788,271,257,528,"21 de agosto de 1994"
27,5,9,789,437,434,871,"21 de agosto de 1994"
27,5,9,790,72,72,144,"21 de agosto de 1994"
27,5,9,791,111,114,225,"21 de agosto de 1994"
27,5,9,792,456,443,899,"21 de agosto de 1994"
27,5,9,793,322,292,614,"21 de agosto de 1994"
27,5,9,794,413,375,788,"21 de agosto de 1994"
27,5,9,795,387,366,753,"21 de agosto de 1994"
27,5,9,796,190,167,357,"21 de agosto de 1994"
27,5,9,797,56,48,104,"21 de agosto de 1994"
27,5,9,798,420,351,771,"21 de agosto de 1994"
27,5,9,799,260,220,480,"21 de agosto de 1994"
27,5,9,800,433,383,816,"21 de agosto de 1994"
27,5,9,801,362,294,656,"21 de agosto de 1994"
27,5,9,802,263,260,523,"21 de agosto de 1994"
27,5,9,803,372,289,661,"21 de agosto de 1994"
27,5,9,804,291,271,562,"21 de agosto de 1994"
27,5,9,805,81,79,160,"21 de agosto de 1994"
27,5,9,806,296,297,593,"21 de agosto de 1994"
27,5,9,807,227,194,421,"21 de agosto de 1994"
27,5,9,808,364,292,656,"21 de agosto de 1994"
27,5,12,872,625,656,1281,"21 de agosto de 1994"
27,5,12,873,444,472,916,"21 de agosto de 1994"
27,5,12,874,471,479,950,"21 de agosto de 1994"
27,5,12,875,467,525,992,"21 de agosto de 1994"
27,5,12,876,419,483,902,"21 de agosto de 1994"
27,5,12,877,467,449,916,"21 de agosto de 1994"
27,5,12,878,566,581,1147,"21 de agosto de 1994"
27,5,12,879,426,420,846,"21 de agosto de 1994"
27,5,12,880,514,558,1072,"21 de agosto de 1994"
27,5,12,881,752,753,1505,"21 de agosto de 1994"
27,5,12,882,530,590,1120,"21 de agosto de 1994"
27,5,12,883,385,399,784,"21 de agosto de 1994"
27,5,12,884,423,416,839,"21 de agosto de 1994"
27,5,12,885,765,725,1490,"21 de agosto de 1994"
27,5,12,886,393,296,689,"21 de agosto de 1994"
27,5,12,887,176,148,324,"21 de agosto de 1994"
27,5,12,888,89,81,170,"21 de agosto de 1994"
27,5,12,889,384,379,763,"21 de agosto de 1994"
27,5,12,890,635,595,1230,"21 de agosto de 1994"
27,5,12,891,187,174,361,"21 de agosto de 1994"
27,5,12,892,556,485,1041,"21 de agosto de 1994"
27,5,12,893,426,431,857,"21 de agosto de 1994"
27,5,12,894,180,166,346,"21 de agosto de 1994"
27,5,12,895,481,472,953,"21 de agosto de 1994"
27,5,12,896,320,324,644,"21 de agosto de 1994"
27,5,12,897,471,471,942,"21 de agosto de 1994"
27,5,12,898,427,450,877,"21 de agosto de 1994"
27,5,12,899,270,237,507,"21 de agosto de 1994"
27,5,12,900,423,389,812,"21 de agosto de 1994"
27,5,12,901,461,424,885,"21 de agosto de 1994"
27,5,12,902,387,374,761,"21 de agosto de 1994"
27,5,12,903,459,444,903,"21 de agosto de 1994"
27,5,12,904,105,82,187,"21 de agosto de 1994"
27,5,12,905,343,338,681,"21 de agosto de 1994"
27,5,12,906,226,246,472,"21 de agosto de 1994"
27,5,12,907,302,297,599,"21 de agosto de 1994"
27,5,12,908,226,212,438,"21 de agosto de 1994"
27,5,12,909,242,211,453,"21 de agosto de 1994"
27,5,12,910,279,266,545,"21 de agosto de 1994"
27,5,12,911,381,385,766,"21 de agosto de 1994"
27,5,12,912,366,405,771,"21 de agosto de 1994"
27,5,12,913,481,469,950,"21 de agosto de 1994"
27,5,12,914,433,412,845,"21 de agosto de 1994"
27,5,12,915,493,499,992,"21 de agosto de 1994"
27,5,12,916,320,306,626,"21 de agosto de 1994"
27,5,12,917,332,310,642,"21 de agosto de 1994"
27,5,12,918,348,325,673,"21 de agosto de 1994"
27,5,12,919,343,289,632,"21 de agosto de 1994"
27,5,12,920,115,104,219,"21 de agosto de 1994"
27,5,12,921,63,45,108,"21 de agosto de 1994"
27,5,12,922,531,502,1033,"21 de agosto de 1994"
27,5,12,923,559,494,1053,"21 de agosto de 1994"
27,5,12,924,538,504,1042,"21 de agosto de 1994"
27,5,12,925,444,368,812,"21 de agosto de 1994"
27,5,12,926,119,91,210,"21 de agosto de 1994"
27,5,12,927,236,210,446,"21 de agosto de 1994"
27,5,12,928,431,373,804,"21 de agosto de 1994"
27,5,12,929,435,384,819,"21 de agosto de 1994"
27,5,12,930,368,379,747,"21 de agosto de 1994"
27,5,12,931,399,426,825,"21 de agosto de 1994"
27,5,12,932,185,167,352,"21 de agosto de 1994"
27,5,12,933,410,405,815,"21 de agosto de 1994"
27,5,12,934,621,651,1272,"21 de agosto de 1994"
27,5,12,935,483,440,923,"21 de agosto de 1994"
27,5,12,936,143,145,288,"21 de agosto de 1994"
27,5,12,937,188,142,330,"21 de agosto de 1994"
27,5,12,938,405,382,787,"21 de agosto de 1994"
27,5,12,939,528,468,996,"21 de agosto de 1994"
27,5,12,940,219,192,411,"21 de agosto de 1994"
27,5,12,941,159,148,307,"21 de agosto de 1994"
27,5,12,942,368,349,717,"21 de agosto de 1994"
27,5,12,943,470,440,910,"21 de agosto de 1994"
27,5,12,944,339,301,640,"21 de agosto de 1994"
27,5,12,945,641,561,1202,"21 de agosto de 1994"
27,5,12,946,390,336,726,"21 de agosto de 1994"
27,5,12,947,569,473,1042,"21 de agosto de 1994"
27,5,12,948,398,345,743,"21 de agosto de 1994"
27,5,12,949,274,226,500,"21 de agosto de 1994"
27,5,12,950,269,229,498,"21 de agosto de 1994"
27,5,12,951,287,274,561,"21 de agosto de 1994"
27,5,12,952,335,280,615,"21 de agosto de 1994"
27,5,12,953,244,210,454,"21 de agosto de 1994"
27,5,15,1036,389,354,743,"21 de agosto de 1994"
27,5,15,1037,344,322,666,"21 de agosto de 1994"
27,5,15,1038,554,549,1103,"21 de agosto de 1994"
27,5,15,1039,396,416,812,"21 de agosto de 1994"
27,5,15,1040,412,388,800,"21 de agosto de 1994"
27,5,15,1041,198,171,369,"21 de agosto de 1994"
27,5,15,1042,375,332,707,"21 de agosto de 1994"
27,5,15,1043,119,88,207,"21 de agosto de 1994"
27,5,15,1044,510,431,941,"21 de agosto de 1994"
27,5,15,1045,176,170,346,"21 de agosto de 1994"
27,5,15,1046,218,184,402,"21 de agosto de 1994"
27,5,15,1047,89,83,172,"21 de agosto de 1994"
27,5,15,1048,71,50,121,"21 de agosto de 1994"
27,5,15,1049,456,356,812,"21 de agosto de 1994"
27,5,15,1050,527,450,977,"21 de agosto de 1994"
27,5,15,1051,533,458,991,"21 de agosto de 1994"
27,5,15,1052,396,341,737,"21 de agosto de 1994"
27,5,15,1053,559,465,1024,"21 de agosto de 1994"
27,5,15,1054,262,217,479,"21 de agosto de 1994"
27,5,15,1055,391,328,719,"21 de agosto de 1994"
27,5,15,1056,445,370,815,"21 de agosto de 1994"
27,5,15,1057,194,201,395,"21 de agosto de 1994"
27,5,15,1058,258,202,460,"21 de agosto de 1994"
27,5,15,1059,184,169,353,"21 de agosto de 1994"
27,5,15,1060,386,343,729,"21 de agosto de 1994"
27,5,15,1061,413,335,748,"21 de agosto de 1994"
27,5,15,1062,210,180,390,"21 de agosto de 1994"
27,5,16,1063,485,485,970,"21 de agosto de 1994"
27,5,16,1064,524,566,1090,"21 de agosto de 1994"
27,5,16,1065,400,378,778,"21 de agosto de 1994"
27,5,16,1066,486,510,996,"21 de agosto de 1994"
27,5,16,1067,460,365,825,"21 de agosto de 1994"
27,5,16,1068,498,499,997,"21 de agosto de 1994"
27,5,16,1069,444,448,892,"21 de agosto de 1994"
27,5,16,1070,533,525,1058,"21 de agosto de 1994"
27,5,16,1071,491,531,1022,"21 de agosto de 1994"
27,5,16,1072,649,611,1260,"21 de agosto de 1994"
27,5,16,1073,572,551,1123,"21 de agosto de 1994"
27,5,16,1074,502,528,1030,"21 de agosto de 1994"
27,5,16,1075,233,180,413,"21 de agosto de 1994"
27,5,16,1076,238,206,444,"21 de agosto de 1994"
27,5,16,1077,342,271,613,"21 de agosto de 1994"
27,5,16,1078,279,256,535,"21 de agosto de 1994"
27,5,16,1079,445,304,749,"21 de agosto de 1994"
27,5,16,1080,292,199,491,"21 de agosto de 1994"
27,5,16,1081,446,339,785,"21 de agosto de 1994"
27,5,16,1082,733,644,1377,"21 de agosto de 1994"
27,5,16,1083,488,462,950,"21 de agosto de 1994"
27,5,16,1084,177,111,288,"21 de agosto de 1994"
27,5,16,1085,127,105,232,"21 de agosto de 1994"
27,5,16,1086,203,175,378,"21 de agosto de 1994"
27,5,16,1087,181,163,344,"21 de agosto de 1994"
27,5,16,1088,563,453,1016,"21 de agosto de 1994"
28,1,27,749,308,318,626,"21 de agosto de 1994"
28,1,27,750,316,340,656,"21 de agosto de 1994"
28,1,27,751,106,118,224,"21 de agosto de 1994"
28,1,27,752,375,394,769,"21 de agosto de 1994"
28,1,27,753,220,229,449,"21 de agosto de 1994"
28,1,27,754,609,622,1231,"21 de agosto de 1994"
28,1,27,755,403,440,843,"21 de agosto de 1994"
28,1,27,756,587,673,1260,"21 de agosto de 1994"
28,1,27,757,461,510,971,"21 de agosto de 1994"
28,1,27,758,427,524,951,"21 de agosto de 1994"
28,1,27,759,470,505,975,"21 de agosto de 1994"
28,1,27,760,475,550,1025,"21 de agosto de 1994"
28,1,27,761,507,557,1064,"21 de agosto de 1994"
28,1,27,762,513,513,1026,"21 de agosto de 1994"
28,1,27,763,439,474,913,"21 de agosto de 1994"
28,1,27,764,297,335,632,"21 de agosto de 1994"
28,1,27,765,409,427,836,"21 de agosto de 1994"
28,1,27,766,456,451,907,"21 de agosto de 1994"
28,1,27,767,419,475,894,"21 de agosto de 1994"
28,1,27,768,235,267,502,"21 de agosto de 1994"
28,1,27,769,309,396,705,"21 de agosto de 1994"
28,1,27,770,414,443,857,"21 de agosto de 1994"
28,1,27,771,235,197,432,"21 de agosto de 1994"
28,1,27,772,251,251,502,"21 de agosto de 1994"
28,1,27,773,229,266,495,"21 de agosto de 1994"
28,1,27,774,441,486,927,"21 de agosto de 1994"
28,1,27,775,460,489,949,"21 de agosto de 1994"
28,1,27,776,300,272,572,"21 de agosto de 1994"
28,1,27,777,214,234,448,"21 de agosto de 1994"
28,1,27,778,456,507,963,"21 de agosto de 1994"
28,1,27,779,447,494,941,"21 de agosto de 1994"
28,1,27,780,552,593,1145,"21 de agosto de 1994"
28,1,27,781,423,444,867,"21 de agosto de 1994"
28,1,27,782,493,513,1006,"21 de agosto de 1994"
28,1,27,783,360,412,772,"21 de agosto de 1994"
28,1,27,784,542,639,1181,"21 de agosto de 1994"
28,1,27,785,499,44,543,"21 de agosto de 1994"
28,1,27,786,240,287,527,"21 de agosto de 1994"
28,1,27,787,314,305,619,"21 de agosto de 1994"
28,1,27,788,475,456,931,"21 de agosto de 1994"
28,1,27,789,266,250,516,"21 de agosto de 1994"
28,1,27,790,256,307,563,"21 de agosto de 1994"
28,1,27,791,419,499,918,"21 de agosto de 1994"
28,1,27,792,349,351,700,"21 de agosto de 1994"
28,1,27,793,282,293,575,"21 de agosto de 1994"
28,1,27,794,332,354,686,"21 de agosto de 1994"
28,1,27,795,232,261,493,"21 de agosto de 1994"
28,1,27,796,424,484,908,"21 de agosto de 1994"
28,1,27,797,330,345,675,"21 de agosto de 1994"
28,1,27,798,507,576,1083,"21 de agosto de 1994"
28,1,27,799,340,390,730,"21 de agosto de 1994"
28,1,27,800,341,367,708,"21 de agosto de 1994"
28,1,27,801,243,270,513,"21 de agosto de 1994"
28,1,27,802,291,317,608,"21 de agosto de 1994"
28,1,27,803,332,327,659,"21 de agosto de 1994"
28,1,27,804,246,271,517,"21 de agosto de 1994"
28,1,27,805,249,318,567,"21 de agosto de 1994"
28,1,27,806,344,388,732,"21 de agosto de 1994"
28,1,27,807,416,462,878,"21 de agosto de 1994"
28,1,27,808,474,540,1014,"21 de agosto de 1994"
28,1,27,809,497,464,961,"21 de agosto de 1994"
28,1,27,810,653,667,1320,"21 de agosto de 1994"
28,1,27,811,634,685,1319,"21 de agosto de 1994"
28,1,27,812,468,440,908,"21 de agosto de 1994"
28,1,27,813,816,865,1681,"21 de agosto de 1994"
28,1,27,814,777,843,1620,"21 de agosto de 1994"
28,1,27,815,955,1008,1963,"21 de agosto de 1994"
28,1,27,816,824,886,1710,"21 de agosto de 1994"
28,1,27,817,544,599,1143,"21 de agosto de 1994"
28,1,27,818,300,318,618,"21 de agosto de 1994"
28,1,27,819,405,450,855,"21 de agosto de 1994"
28,1,27,820,469,537,1006,"21 de agosto de 1994"
28,1,27,821,290,295,585,"21 de agosto de 1994"
28,1,27,822,258,313,571,"21 de agosto de 1994"
28,1,27,823,499,562,1061,"21 de agosto de 1994"
28,1,27,824,477,594,1071,"21 de agosto de 1994"
28,1,27,825,480,548,1028,"21 de agosto de 1994"
28,1,27,826,474,540,1014,"21 de agosto de 1994"
28,1,27,827,568,601,1169,"21 de agosto de 1994"
28,1,27,828,560,619,1179,"21 de agosto de 1994"
28,1,27,829,451,505,956,"21 de agosto de 1994"
28,1,27,830,344,421,765,"21 de agosto de 1994"
28,1,27,831,165,201,366,"21 de agosto de 1994"
28,1,27,832,370,405,775,"21 de agosto de 1994"
28,1,27,833,226,263,489,"21 de agosto de 1994"
28,1,27,834,245,304,549,"21 de agosto de 1994"
28,1,27,835,399,448,847,"21 de agosto de 1994"
28,1,27,836,327,379,706,"21 de agosto de 1994"
28,1,27,837,478,571,1049,"21 de agosto de 1994"
28,1,27,838,346,356,702,"21 de agosto de 1994"
28,1,27,839,433,440,873,"21 de agosto de 1994"
28,1,27,840,381,422,803,"21 de agosto de 1994"
28,1,27,841,372,422,794,"21 de agosto de 1994"
28,1,27,842,364,392,756,"21 de agosto de 1994"
28,1,27,843,296,341,637,"21 de agosto de 1994"
28,1,27,844,452,495,947,"21 de agosto de 1994"
28,1,27,845,370,471,841,"21 de agosto de 1994"
28,1,27,846,287,328,615,"21 de agosto de 1994"
28,1,27,847,434,471,905,"21 de agosto de 1994"
28,1,27,848,508,557,1065,"21 de agosto de 1994"
28,1,27,849,332,414,746,"21 de agosto de 1994"
28,1,27,850,309,322,631,"21 de agosto de 1994"
28,1,27,851,92,123,215,"21 de agosto de 1994"
28,1,27,852,405,422,827,"21 de agosto de 1994"
28,1,27,853,396,473,869,"21 de agosto de 1994"
28,1,27,854,589,700,1289,"21 de agosto de 1994"
28,1,27,855,376,384,760,"21 de agosto de 1994"
28,1,27,856,355,391,746,"21 de agosto de 1994"
28,1,27,857,355,449,804,"21 de agosto de 1994"
28,1,27,858,252,278,530,"21 de agosto de 1994"
28,1,27,859,656,679,1335,"21 de agosto de 1994"
28,1,27,860,577,665,1242,"21 de agosto de 1994"
28,1,27,861,322,324,646,"21 de agosto de 1994"
28,1,27,862,368,362,730,"21 de agosto de 1994"
28,1,27,863,491,471,962,"21 de agosto de 1994"
28,1,27,864,326,341,667,"21 de agosto de 1994"
28,1,27,865,437,478,915,"21 de agosto de 1994"
28,1,27,866,577,640,1217,"21 de agosto de 1994"
28,1,27,867,502,522,1024,"21 de agosto de 1994"
28,1,27,868,551,574,1125,"21 de agosto de 1994"
28,1,27,869,418,476,894,"21 de agosto de 1994"
28,1,27,870,372,423,795,"21 de agosto de 1994"
28,1,27,871,471,499,970,"21 de agosto de 1994"
28,1,27,872,472,489,961,"21 de agosto de 1994"
28,1,27,873,651,682,1333,"21 de agosto de 1994"
28,1,27,874,444,432,876,"21 de agosto de 1994"
28,1,27,875,399,381,780,"21 de agosto de 1994"
28,1,27,876,447,483,930,"21 de agosto de 1994"
28,1,27,877,366,394,760,"21 de agosto de 1994"
28,1,27,878,458,462,920,"21 de agosto de 1994"
28,1,27,879,531,545,1076,"21 de agosto de 1994"
28,1,27,880,234,287,521,"21 de agosto de 1994"
28,1,27,881,431,427,858,"21 de agosto de 1994"
28,1,27,882,344,334,678,"21 de agosto de 1994"
28,1,27,883,419,464,883,"21 de agosto de 1994"
28,1,27,884,366,424,790,"21 de agosto de 1994"
28,1,27,885,439,504,943,"21 de agosto de 1994"
28,1,27,886,495,526,1021,"21 de agosto de 1994"
28,1,27,887,473,515,988,"21 de agosto de 1994"
28,1,27,888,487,567,1054,"21 de agosto de 1994"
28,1,27,889,421,435,856,"21 de agosto de 1994"
28,1,27,890,683,816,1499,"21 de agosto de 1994"
28,1,27,891,445,488,933,"21 de agosto de 1994"
28,1,27,892,357,414,771,"21 de agosto de 1994"
28,1,27,893,293,347,640,"21 de agosto de 1994"
28,1,27,894,297,344,641,"21 de agosto de 1994"
28,1,27,895,437,470,907,"21 de agosto de 1994"
28,1,27,896,328,364,692,"21 de agosto de 1994"
28,1,27,897,212,229,441,"21 de agosto de 1994"
28,1,27,898,502,553,1055,"21 de agosto de 1994"
28,1,27,899,235,259,494,"21 de agosto de 1994"
28,1,27,900,275,285,560,"21 de agosto de 1994"
28,1,27,901,135,133,268,"21 de agosto de 1994"
28,1,27,902,104,103,207,"21 de agosto de 1994"
28,1,27,903,103,68,171,"21 de agosto de 1994"
28,1,27,904,126,98,224,"21 de agosto de 1994"
28,2,7,125,238,245,483,"21 de agosto de 1994"
28,2,7,126,373,407,780,"21 de agosto de 1994"
28,2,7,127,455,473,928,"21 de agosto de 1994"
28,2,7,128,287,300,587,"21 de agosto de 1994"
28,2,7,129,270,286,556,"21 de agosto de 1994"
28,2,7,130,251,278,529,"21 de agosto de 1994"
28,2,7,131,409,444,853,"21 de agosto de 1994"
28,2,7,132,274,261,535,"21 de agosto de 1994"
28,2,7,133,238,244,482,"21 de agosto de 1994"
28,2,7,134,250,249,499,"21 de agosto de 1994"
28,2,7,135,153,136,289,"21 de agosto de 1994"
28,2,7,136,91,96,187,"21 de agosto de 1994"
28,2,7,137,260,291,551,"21 de agosto de 1994"
28,2,7,138,160,166,326,"21 de agosto de 1994"
28,2,7,139,187,175,362,"21 de agosto de 1994"
28,2,7,140,69,47,116,"21 de agosto de 1994"
28,2,7,141,62,56,118,"21 de agosto de 1994"
28,2,7,142,232,164,396,"21 de agosto de 1994"
28,2,14,327,393,384,777,"21 de agosto de 1994"
28,2,14,328,326,319,645,"21 de agosto de 1994"
28,2,14,329,263,237,500,"21 de agosto de 1994"
28,2,14,330,55,35,90,"21 de agosto de 1994"
28,2,14,331,4,1,5,"21 de agosto de 1994"
28,2,15,332,350,390,740,"21 de agosto de 1994"
28,2,15,333,439,455,894,"21 de agosto de 1994"
28,2,15,334,403,408,811,"21 de agosto de 1994"
28,2,15,335,453,484,937,"21 de agosto de 1994"
28,2,15,336,451,492,943,"21 de agosto de 1994"
28,2,15,337,387,481,868,"21 de agosto de 1994"
28,2,15,338,406,432,838,"21 de agosto de 1994"
28,2,15,339,443,421,864,"21 de agosto de 1994"
28,2,15,340,418,445,863,"21 de agosto de 1994"
28,2,15,341,102,95,197,"21 de agosto de 1994"
28,2,15,342,276,263,539,"21 de agosto de 1994"
28,2,15,343,177,152,329,"21 de agosto de 1994"
28,2,15,344,336,333,669,"21 de agosto de 1994"
28,2,15,345,284,240,524,"21 de agosto de 1994"
28,2,24,716,264,251,515,"21 de agosto de 1994"
28,2,24,717,369,367,736,"21 de agosto de 1994"
28,2,24,718,234,248,482,"21 de agosto de 1994"
28,2,24,719,301,316,617,"21 de agosto de 1994"
28,2,24,720,305,317,622,"21 de agosto de 1994"
28,2,24,721,279,258,537,"21 de agosto de 1994"
28,2,25,722,249,283,532,"21 de agosto de 1994"
28,2,25,723,425,473,898,"21 de agosto de 1994"
28,2,25,724,281,284,565,"21 de agosto de 1994"
28,2,25,725,358,363,721,"21 de agosto de 1994"
28,2,25,726,320,273,593,"21 de agosto de 1994"
28,2,25,727,351,413,764,"21 de agosto de 1994"
28,2,25,728,404,427,831,"21 de agosto de 1994"
28,2,25,729,196,213,409,"21 de agosto de 1994"
28,2,25,730,334,365,699,"21 de agosto de 1994"
28,2,25,731,237,234,471,"21 de agosto de 1994"
28,2,25,732,245,297,542,"21 de agosto de 1994"
28,2,25,733,469,454,923,"21 de agosto de 1994"
28,2,25,734,298,323,621,"21 de agosto de 1994"
28,2,25,735,367,417,784,"21 de agosto de 1994"
28,2,25,736,252,261,513,"21 de agosto de 1994"
28,2,25,737,89,75,164,"21 de agosto de 1994"
28,2,25,738,191,212,403,"21 de agosto de 1994"
28,2,25,739,231,233,464,"21 de agosto de 1994"
28,2,25,740,138,141,279,"21 de agosto de 1994"
28,2,25,741,33,26,59,"21 de agosto de 1994"
28,2,25,742,55,36,91,"21 de agosto de 1994"
28,2,25,743,150,129,279,"21 de agosto de 1994"
28,2,25,744,149,122,271,"21 de agosto de 1994"
28,2,32,935,354,375,729,"21 de agosto de 1994"
28,2,32,936,361,416,777,"21 de agosto de 1994"
28,2,32,937,403,420,823,"21 de agosto de 1994"
28,2,32,938,244,248,492,"21 de agosto de 1994"
28,2,32,939,301,366,667,"21 de agosto de 1994"
28,2,32,940,320,405,725,"21 de agosto de 1994"
28,2,32,941,584,630,1214,"21 de agosto de 1994"
28,2,32,942,288,307,595,"21 de agosto de 1994"
28,2,32,943,497,535,1032,"21 de agosto de 1994"
28,2,32,944,426,444,870,"21 de agosto de 1994"
28,2,32,945,359,374,733,"21 de agosto de 1994"
28,2,32,946,539,583,1122,"21 de agosto de 1994"
28,2,32,947,521,590,1111,"21 de agosto de 1994"
28,2,32,948,496,554,1050,"21 de agosto de 1994"
28,2,32,949,386,421,807,"21 de agosto de 1994"
28,2,32,950,418,473,891,"21 de agosto de 1994"
28,2,32,951,466,546,1012,"21 de agosto de 1994"
28,2,32,952,526,581,1107,"21 de agosto de 1994"
28,2,32,953,500,505,1005,"21 de agosto de 1994"
28,2,32,954,243,252,495,"21 de agosto de 1994"
28,2,32,955,409,422,831,"21 de agosto de 1994"
28,2,32,956,359,433,792,"21 de agosto de 1994"
28,2,32,957,509,537,1046,"21 de agosto de 1994"
28,2,32,958,338,353,691,"21 de agosto de 1994"
28,2,32,959,402,434,836,"21 de agosto de 1994"
28,2,32,960,454,492,946,"21 de agosto de 1994"
28,2,32,961,323,385,708,"21 de agosto de 1994"
28,2,32,962,290,333,623,"21 de agosto de 1994"
28,2,32,963,420,520,940,"21 de agosto de 1994"
28,2,32,964,546,610,1156,"21 de agosto de 1994"
28,2,32,965,525,589,1114,"21 de agosto de 1994"
28,2,32,966,468,505,973,"21 de agosto de 1994"
28,2,32,967,492,545,1037,"21 de agosto de 1994"
28,2,32,968,361,372,733,"21 de agosto de 1994"
28,2,32,969,257,289,546,"21 de agosto de 1994"
28,2,32,970,512,533,1045,"21 de agosto de 1994"
28,2,32,971,393,413,806,"21 de agosto de 1994"
28,2,32,972,387,404,791,"21 de agosto de 1994"
28,2,32,973,580,650,1230,"21 de agosto de 1994"
28,2,32,974,422,430,852,"21 de agosto de 1994"
28,2,32,975,462,479,941,"21 de agosto de 1994"
28,2,32,976,281,284,565,"21 de agosto de 1994"
28,2,32,977,399,430,829,"21 de agosto de 1994"
28,2,32,978,524,616,1140,"21 de agosto de 1994"
28,2,32,979,383,443,826,"21 de agosto de 1994"
28,2,32,980,444,491,935,"21 de agosto de 1994"
28,2,32,981,258,258,516,"21 de agosto de 1994"
28,2,32,982,357,430,787,"21 de agosto de 1994"
28,2,32,983,373,428,801,"21 de agosto de 1994"
28,2,32,984,365,420,785,"21 de agosto de 1994"
28,2,32,985,511,535,1046,"21 de agosto de 1994"
28,2,32,986,92,109,201,"21 de agosto de 1994"
28,2,32,987,305,354,659,"21 de agosto de 1994"
28,2,32,988,345,371,716,"21 de agosto de 1994"
28,2,32,989,256,282,538,"21 de agosto de 1994"
28,2,32,990,529,542,1071,"21 de agosto de 1994"
28,2,32,991,517,520,1037,"21 de agosto de 1994"
28,2,32,992,141,117,258,"21 de agosto de 1994"
28,2,32,993,241,190,431,"21 de agosto de 1994"
28,2,32,994,48,40,88,"21 de agosto de 1994"
28,3,22,498,322,343,665,"21 de agosto de 1994"
28,3,22,499,421,432,853,"21 de agosto de 1994"
28,3,22,500,455,456,911,"21 de agosto de 1994"
28,3,22,501,302,343,645,"21 de agosto de 1994"
28,3,22,502,570,595,1165,"21 de agosto de 1994"
28,3,22,503,472,529,1001,"21 de agosto de 1994"
28,3,22,504,278,312,590,"21 de agosto de 1994"
28,3,22,505,335,384,719,"21 de agosto de 1994"
28,3,22,506,524,578,1102,"21 de agosto de 1994"
28,3,22,507,505,606,1111,"21 de agosto de 1994"
28,3,22,508,227,255,482,"21 de agosto de 1994"
28,3,22,509,245,268,513,"21 de agosto de 1994"
28,3,22,510,403,426,829,"21 de agosto de 1994"
28,3,22,511,460,633,1093,"21 de agosto de 1994"
28,3,22,512,442,497,939,"21 de agosto de 1994"
28,3,22,513,437,458,895,"21 de agosto de 1994"
28,3,22,514,438,491,929,"21 de agosto de 1994"
28,3,22,515,509,516,1025,"21 de agosto de 1994"
28,3,22,516,617,705,1322,"21 de agosto de 1994"
28,3,22,517,416,419,835,"21 de agosto de 1994"
28,3,22,518,499,568,1067,"21 de agosto de 1994"
28,3,22,519,344,421,765,"21 de agosto de 1994"
28,3,22,520,384,437,821,"21 de agosto de 1994"
28,3,22,521,294,311,605,"21 de agosto de 1994"
28,3,22,522,425,477,902,"21 de agosto de 1994"
28,3,22,523,451,459,910,"21 de agosto de 1994"
28,3,22,524,306,333,639,"21 de agosto de 1994"
28,3,22,525,290,352,642,"21 de agosto de 1994"
28,3,22,526,339,396,735,"21 de agosto de 1994"
28,3,22,527,462,477,939,"21 de agosto de 1994"
28,3,22,528,386,383,769,"21 de agosto de 1994"
28,3,22,529,464,449,913,"21 de agosto de 1994"
28,3,22,530,272,309,581,"21 de agosto de 1994"
28,3,22,531,326,338,664,"21 de agosto de 1994"
28,3,22,532,351,422,773,"21 de agosto de 1994"
28,3,22,533,390,455,845,"21 de agosto de 1994"
28,3,22,534,551,582,1133,"21 de agosto de 1994"
28,3,22,535,642,761,1403,"21 de agosto de 1994"
28,3,22,536,452,526,978,"21 de agosto de 1994"
28,3,22,537,441,508,949,"21 de agosto de 1994"
28,3,22,538,461,566,1027,"21 de agosto de 1994"
28,3,22,539,610,737,1347,"21 de agosto de 1994"
28,3,22,540,595,654,1249,"21 de agosto de 1994"
28,3,22,541,481,531,1012,"21 de agosto de 1994"
28,3,22,542,530,566,1096,"21 de agosto de 1994"
28,3,22,543,894,969,1863,"21 de agosto de 1994"
28,3,22,544,465,470,935,"21 de agosto de 1994"
28,3,22,545,510,561,1071,"21 de agosto de 1994"
28,3,22,546,370,406,776,"21 de agosto de 1994"
28,3,22,547,390,402,792,"21 de agosto de 1994"
28,3,22,548,480,591,1071,"21 de agosto de 1994"
28,3,22,549,439,514,953,"21 de agosto de 1994"
28,3,22,550,350,422,772,"21 de agosto de 1994"
28,3,22,551,298,327,625,"21 de agosto de 1994"
28,3,22,552,785,937,1722,"21 de agosto de 1994"
28,3,22,553,491,547,1038,"21 de agosto de 1994"
28,3,22,554,399,451,850,"21 de agosto de 1994"
28,3,22,555,435,499,934,"21 de agosto de 1994"
28,3,22,556,383,437,820,"21 de agosto de 1994"
28,3,22,557,550,618,1168,"21 de agosto de 1994"
28,3,22,558,555,633,1188,"21 de agosto de 1994"
28,3,22,559,373,458,831,"21 de agosto de 1994"
28,3,22,560,278,328,606,"21 de agosto de 1994"
28,3,22,561,325,346,671,"21 de agosto de 1994"
28,3,22,562,316,279,595,"21 de agosto de 1994"
28,3,22,563,191,218,409,"21 de agosto de 1994"
28,3,22,564,267,325,592,"21 de agosto de 1994"
28,3,22,565,457,498,955,"21 de agosto de 1994"
28,3,22,566,413,434,847,"21 de agosto de 1994"
28,3,22,567,324,400,724,"21 de agosto de 1994"
28,3,22,568,442,503,945,"21 de agosto de 1994"
28,3,22,569,374,415,789,"21 de agosto de 1994"
28,3,22,570,338,413,751,"21 de agosto de 1994"
28,3,22,571,317,344,661,"21 de agosto de 1994"
28,3,22,572,467,546,1013,"21 de agosto de 1994"
28,3,22,573,321,350,671,"21 de agosto de 1994"
28,3,22,574,267,264,531,"21 de agosto de 1994"
28,3,22,575,486,505,991,"21 de agosto de 1994"
28,3,22,576,269,316,585,"21 de agosto de 1994"
28,3,22,577,381,409,790,"21 de agosto de 1994"
28,3,22,578,371,438,809,"21 de agosto de 1994"
28,3,22,579,366,395,761,"21 de agosto de 1994"
28,3,22,580,288,352,640,"21 de agosto de 1994"
28,3,22,581,465,534,999,"21 de agosto de 1994"
28,3,22,582,215,271,486,"21 de agosto de 1994"
28,3,22,583,349,388,737,"21 de agosto de 1994"
28,3,22,584,366,443,809,"21 de agosto de 1994"
28,3,22,585,350,438,788,"21 de agosto de 1994"
28,3,22,586,272,341,613,"21 de agosto de 1994"
28,3,22,587,332,416,748,"21 de agosto de 1994"
28,3,22,588,379,470,849,"21 de agosto de 1994"
28,3,22,589,558,640,1198,"21 de agosto de 1994"
28,3,22,590,558,684,1242,"21 de agosto de 1994"
28,3,22,591,330,358,688,"21 de agosto de 1994"
28,3,22,592,390,472,862,"21 de agosto de 1994"
28,3,22,593,382,470,852,"21 de agosto de 1994"
28,3,22,594,576,644,1220,"21 de agosto de 1994"
28,3,22,595,226,238,464,"21 de agosto de 1994"
28,3,22,596,446,548,994,"21 de agosto de 1994"
28,3,22,597,349,418,767,"21 de agosto de 1994"
28,3,22,598,442,477,919,"21 de agosto de 1994"
28,3,22,599,283,323,606,"21 de agosto de 1994"
28,3,22,600,257,292,549,"21 de agosto de 1994"
28,3,22,601,600,744,1344,"21 de agosto de 1994"
28,3,22,602,440,525,965,"21 de agosto de 1994"
28,3,22,603,448,520,968,"21 de agosto de 1994"
28,3,22,604,434,468,902,"21 de agosto de 1994"
28,3,22,605,561,628,1189,"21 de agosto de 1994"
28,3,22,606,490,595,1085,"21 de agosto de 1994"
28,3,22,607,506,607,1113,"21 de agosto de 1994"
28,3,22,608,423,485,908,"21 de agosto de 1994"
28,3,22,609,286,301,587,"21 de agosto de 1994"
28,3,22,610,561,604,1165,"21 de agosto de 1994"
28,3,22,611,447,508,955,"21 de agosto de 1994"
28,3,22,612,308,349,657,"21 de agosto de 1994"
28,3,22,613,334,337,671,"21 de agosto de 1994"
28,3,22,614,493,611,1104,"21 de agosto de 1994"
28,3,22,615,408,472,880,"21 de agosto de 1994"
28,3,22,616,651,718,1369,"21 de agosto de 1994"
28,3,22,617,415,488,903,"21 de agosto de 1994"
28,3,22,618,431,534,965,"21 de agosto de 1994"
28,3,22,619,379,382,761,"21 de agosto de 1994"
28,3,22,620,1004,1070,2074,"21 de agosto de 1994"
28,3,22,621,455,507,962,"21 de agosto de 1994"
28,3,22,622,294,319,613,"21 de agosto de 1994"
28,3,22,623,452,527,979,"21 de agosto de 1994"
28,3,22,624,482,526,1008,"21 de agosto de 1994"
28,3,22,625,506,524,1030,"21 de agosto de 1994"
28,3,22,626,500,686,1186,"21 de agosto de 1994"
28,3,22,627,599,677,1276,"21 de agosto de 1994"
28,3,22,628,602,626,1228,"21 de agosto de 1994"
28,3,22,629,456,548,1004,"21 de agosto de 1994"
28,3,22,630,386,401,787,"21 de agosto de 1994"
28,3,22,631,426,470,896,"21 de agosto de 1994"
28,3,22,632,353,409,762,"21 de agosto de 1994"
28,3,22,633,600,648,1248,"21 de agosto de 1994"
28,3,22,634,484,562,1046,"21 de agosto de 1994"
28,3,22,635,466,504,970,"21 de agosto de 1994"
28,3,22,636,331,391,722,"21 de agosto de 1994"
28,3,22,637,467,511,978,"21 de agosto de 1994"
28,3,22,638,423,466,889,"21 de agosto de 1994"
28,3,22,639,1063,1175,2238,"21 de agosto de 1994"
28,3,22,640,695,669,1364,"21 de agosto de 1994"
28,3,22,641,455,535,990,"21 de agosto de 1994"
28,3,22,642,463,536,999,"21 de agosto de 1994"
28,3,22,643,534,539,1073,"21 de agosto de 1994"
28,3,22,644,413,463,876,"21 de agosto de 1994"
28,3,22,645,232,233,465,"21 de agosto de 1994"
28,3,22,646,355,409,764,"21 de agosto de 1994"
28,3,22,647,490,525,1015,"21 de agosto de 1994"
28,3,22,648,160,191,351,"21 de agosto de 1994"
28,3,22,649,367,397,764,"21 de agosto de 1994"
28,3,22,650,492,578,1070,"21 de agosto de 1994"
28,3,22,651,497,574,1071,"21 de agosto de 1994"
28,3,22,652,442,490,932,"21 de agosto de 1994"
28,3,22,653,712,731,1443,"21 de agosto de 1994"
28,3,22,654,526,611,1137,"21 de agosto de 1994"
28,3,22,655,456,560,1016,"21 de agosto de 1994"
28,3,22,656,471,563,1034,"21 de agosto de 1994"
28,3,22,657,423,451,874,"21 de agosto de 1994"
28,3,22,658,418,468,886,"21 de agosto de 1994"
28,3,22,659,504,622,1126,"21 de agosto de 1994"
28,3,22,660,435,549,984,"21 de agosto de 1994"
28,3,22,661,470,552,1022,"21 de agosto de 1994"
28,3,22,662,529,615,1144,"21 de agosto de 1994"
28,3,22,663,420,464,884,"21 de agosto de 1994"
28,3,22,664,448,523,971,"21 de agosto de 1994"
28,3,22,665,343,418,761,"21 de agosto de 1994"
28,3,22,666,485,561,1046,"21 de agosto de 1994"
28,3,22,667,416,542,958,"21 de agosto de 1994"
28,3,22,668,438,486,924,"21 de agosto de 1994"
28,3,22,669,357,351,708,"21 de agosto de 1994"
28,3,22,670,631,664,1295,"21 de agosto de 1994"
28,3,22,671,496,530,1026,"21 de agosto de 1994"
28,3,22,672,420,422,842,"21 de agosto de 1994"
28,3,22,673,364,419,783,"21 de agosto de 1994"
28,3,22,674,319,377,696,"21 de agosto de 1994"
28,3,22,675,271,340,611,"21 de agosto de 1994"
28,3,22,676,438,442,880,"21 de agosto de 1994"
28,3,22,677,466,461,927,"21 de agosto de 1994"
28,3,22,678,398,368,766,"21 de agosto de 1994"
28,3,22,679,255,271,526,"21 de agosto de 1994"
28,3,22,680,256,259,515,"21 de agosto de 1994"
28,3,22,681,172,174,346,"21 de agosto de 1994"
28,3,22,682,317,323,640,"21 de agosto de 1994"
28,3,22,683,492,482,974,"21 de agosto de 1994"
28,3,22,684,429,404,833,"21 de agosto de 1994"
28,3,22,685,492,478,970,"21 de agosto de 1994"
28,3,22,686,524,529,1053,"21 de agosto de 1994"
28,3,22,687,570,578,1148,"21 de agosto de 1994"
28,3,22,688,398,362,760,"21 de agosto de 1994"
28,3,22,689,226,241,467,"21 de agosto de 1994"
28,3,22,690,407,417,824,"21 de agosto de 1994"
28,3,22,691,233,259,492,"21 de agosto de 1994"
28,3,22,692,321,202,523,"21 de agosto de 1994"
28,3,22,693,433,389,822,"21 de agosto de 1994"
28,3,22,694,396,354,750,"21 de agosto de 1994"
28,3,22,695,343,382,725,"21 de agosto de 1994"
28,3,22,696,274,248,522,"21 de agosto de 1994"
28,3,22,697,397,353,750,"21 de agosto de 1994"
28,3,22,698,523,483,1006,"21 de agosto de 1994"
28,3,22,699,581,552,1133,"21 de agosto de 1994"
28,3,22,700,67,1,68,"21 de agosto de 1994"
28,3,22,701,277,250,527,"21 de agosto de 1994"
28,3,22,702,208,201,409,"21 de agosto de 1994"
28,3,22,703,370,315,685,"21 de agosto de 1994"
28,3,22,704,131,85,216,"21 de agosto de 1994"
28,3,22,705,238,191,429,"21 de agosto de 1994"
28,3,22,706,326,263,589,"21 de agosto de 1994"
28,3,22,707,98,85,183,"21 de agosto de 1994"
28,3,22,708,130,122,252,"21 de agosto de 1994"
28,3,22,709,565,355,920,"21 de agosto de 1994"
28,4,6,116,267,231,498,"21 de agosto de 1994"
28,4,6,117,257,226,483,"21 de agosto de 1994"
28,4,6,118,316,276,592,"21 de agosto de 1994"
28,4,6,119,103,87,190,"21 de agosto de 1994"
28,4,6,120,134,105,239,"21 de agosto de 1994"
28,4,6,121,323,295,618,"21 de agosto de 1994"
28,4,6,122,191,177,368,"21 de agosto de 1994"
28,4,6,123,148,119,267,"21 de agosto de 1994"
28,4,6,124,307,292,599,"21 de agosto de 1994"
28,4,17,368,402,387,789,"21 de agosto de 1994"
28,4,17,369,486,540,1026,"21 de agosto de 1994"
28,4,17,370,364,411,775,"21 de agosto de 1994"
28,4,17,371,206,147,353,"21 de agosto de 1994"
28,4,17,372,440,375,815,"21 de agosto de 1994"
28,4,17,373,156,124,280,"21 de agosto de 1994"
28,4,17,374,124,92,216,"21 de agosto de 1994"
28,4,17,375,368,319,687,"21 de agosto de 1994"
28,4,17,376,363,289,652,"21 de agosto de 1994"
28,4,17,377,404,362,766,"21 de agosto de 1994"
28,4,17,378,233,180,413,"21 de agosto de 1994"
28,4,17,379,24,17,41,"21 de agosto de 1994"
28,4,17,380,82,47,129,"21 de agosto de 1994"
28,4,26,745,363,343,706,"21 de agosto de 1994"
28,4,26,746,177,162,339,"21 de agosto de 1994"
28,4,26,747,308,271,579,"21 de agosto de 1994"
28,4,26,748,85,57,142,"21 de agosto de 1994"
28,4,31,931,90,87,177,"21 de agosto de 1994"
28,4,31,932,98,115,213,"21 de agosto de 1994"
28,4,31,933,86,91,177,"21 de agosto de 1994"
28,4,31,934,230,192,422,"21 de agosto de 1994"
28,4,39,1497,259,276,535,"21 de agosto de 1994"
28,4,39,1498,437,474,911,"21 de agosto de 1994"
28,4,39,1499,576,682,1258,"21 de agosto de 1994"
28,4,39,1500,331,372,703,"21 de agosto de 1994"
28,4,39,1501,411,446,857,"21 de agosto de 1994"
28,4,39,1502,304,291,595,"21 de agosto de 1994"
28,4,39,1503,211,213,424,"21 de agosto de 1994"
28,4,39,1504,454,399,853,"21 de agosto de 1994"
28,4,39,1505,258,210,468,"21 de agosto de 1994"
28,4,39,1506,339,283,622,"21 de agosto de 1994"
28,4,39,1507,213,243,456,"21 de agosto de 1994"
28,4,39,1508,321,287,608,"21 de agosto de 1994"
28,4,39,1509,336,312,648,"21 de agosto de 1994"
28,4,39,1510,307,330,637,"21 de agosto de 1994"
28,4,39,1511,430,405,835,"21 de agosto de 1994"
28,4,39,1512,376,309,685,"21 de agosto de 1994"
28,4,39,1513,197,183,380,"21 de agosto de 1994"
28,4,39,1514,392,364,756,"21 de agosto de 1994"
28,4,39,1515,352,275,627,"21 de agosto de 1994"
28,4,41,1562,278,305,583,"21 de agosto de 1994"
28,4,41,1563,354,436,790,"21 de agosto de 1994"
28,4,41,1564,309,371,680,"21 de agosto de 1994"
28,4,41,1565,408,445,853,"21 de agosto de 1994"
28,4,41,1566,444,512,956,"21 de agosto de 1994"
28,4,41,1567,315,319,634,"21 de agosto de 1994"
28,4,41,1568,230,230,460,"21 de agosto de 1994"
28,4,41,1569,567,656,1223,"21 de agosto de 1994"
28,4,41,1570,392,462,854,"21 de agosto de 1994"
28,4,41,1571,394,433,827,"21 de agosto de 1994"
28,4,41,1572,359,371,730,"21 de agosto de 1994"
28,4,41,1573,650,709,1359,"21 de agosto de 1994"
28,4,41,1574,314,360,674,"21 de agosto de 1994"
28,4,41,1575,419,493,912,"21 de agosto de 1994"
28,4,41,1576,317,376,693,"21 de agosto de 1994"
28,4,41,1577,664,813,1477,"21 de agosto de 1994"
28,4,41,1578,495,5,500,"21 de agosto de 1994"
28,4,41,1579,483,510,993,"21 de agosto de 1994"
28,4,41,1580,504,576,1080,"21 de agosto de 1994"
28,4,41,1581,434,499,933,"21 de agosto de 1994"
28,4,41,1582,487,546,1033,"21 de agosto de 1994"
28,4,41,1583,423,503,926,"21 de agosto de 1994"
28,4,41,1584,301,351,652,"21 de agosto de 1994"
28,4,41,1585,343,441,784,"21 de agosto de 1994"
28,4,41,1586,412,454,866,"21 de agosto de 1994"
28,4,41,1587,425,496,921,"21 de agosto de 1994"
28,4,41,1588,578,657,1235,"21 de agosto de 1994"
28,4,41,1589,231,266,497,"21 de agosto de 1994"
28,4,41,1590,293,301,594,"21 de agosto de 1994"
28,4,41,1591,410,486,896,"21 de agosto de 1994"
28,4,41,1592,559,567,1126,"21 de agosto de 1994"
28,4,41,1593,419,473,892,"21 de agosto de 1994"
28,4,41,1594,497,537,1034,"21 de agosto de 1994"
28,4,41,1595,352,454,806,"21 de agosto de 1994"
28,4,41,1596,273,362,635,"21 de agosto de 1994"
28,4,41,1597,351,444,795,"21 de agosto de 1994"
28,4,41,1598,267,338,605,"21 de agosto de 1994"
28,4,41,1599,273,336,609,"21 de agosto de 1994"
28,4,41,1600,568,621,1189,"21 de agosto de 1994"
28,4,41,1601,345,422,767,"21 de agosto de 1994"
28,4,41,1602,547,623,1170,"21 de agosto de 1994"
28,4,41,1603,564,652,1216,"21 de agosto de 1994"
28,4,41,1604,337,424,761,"21 de agosto de 1994"
28,4,41,1605,331,372,703,"21 de agosto de 1994"
28,4,41,1606,560,648,1208,"21 de agosto de 1994"
28,4,41,1607,783,860,1643,"21 de agosto de 1994"
28,4,41,1608,361,429,790,"21 de agosto de 1994"
28,4,41,1609,355,429,784,"21 de agosto de 1994"
28,4,41,1610,374,385,759,"21 de agosto de 1994"
28,4,41,1611,428,449,877,"21 de agosto de 1994"
28,4,41,1612,404,445,849,"21 de agosto de 1994"
28,4,41,1613,411,466,877,"21 de agosto de 1994"
28,4,41,1614,453,542,995,"21 de agosto de 1994"
28,4,41,1615,471,571,1042,"21 de agosto de 1994"
28,4,41,1616,440,550,990,"21 de agosto de 1994"
28,4,41,1617,404,457,861,"21 de agosto de 1994"
28,4,41,1618,445,502,947,"21 de agosto de 1994"
28,4,41,1619,479,543,1022,"21 de agosto de 1994"
28,4,41,1620,566,612,1178,"21 de agosto de 1994"
28,4,41,1621,208,238,446,"21 de agosto de 1994"
28,4,41,1622,384,460,844,"21 de agosto de 1994"
28,4,41,1623,345,437,782,"21 de agosto de 1994"
28,4,41,1624,396,484,880,"21 de agosto de 1994"
28,4,41,1625,535,634,1169,"21 de agosto de 1994"
28,4,41,1626,402,462,864,"21 de agosto de 1994"
28,4,41,1627,385,496,881,"21 de agosto de 1994"
28,4,41,1628,421,461,882,"21 de agosto de 1994"
28,4,41,1629,432,579,1011,"21 de agosto de 1994"
28,4,41,1630,195,277,472,"21 de agosto de 1994"
28,4,41,1631,421,522,943,"21 de agosto de 1994"
28,4,41,1632,497,559,1056,"21 de agosto de 1994"
28,4,41,1633,444,511,955,"21 de agosto de 1994"
28,4,41,1634,470,514,984,"21 de agosto de 1994"
28,4,41,1635,379,436,815,"21 de agosto de 1994"
28,4,41,1636,757,884,1641,"21 de agosto de 1994"
28,4,41,1637,397,422,819,"21 de agosto de 1994"
28,4,41,1638,360,403,763,"21 de agosto de 1994"
28,4,41,1639,437,464,901,"21 de agosto de 1994"
28,4,41,1640,414,468,882,"21 de agosto de 1994"
28,4,41,1641,413,453,866,"21 de agosto de 1994"
28,4,41,1642,305,409,714,"21 de agosto de 1994"
28,4,41,1643,323,365,688,"21 de agosto de 1994"
28,4,41,1644,296,322,618,"21 de agosto de 1994"
28,4,41,1645,358,444,802,"21 de agosto de 1994"
28,4,41,1646,565,613,1178,"21 de agosto de 1994"
28,4,41,1647,473,515,988,"21 de agosto de 1994"
28,4,41,1648,283,316,599,"21 de agosto de 1994"
28,4,41,1649,280,286,566,"21 de agosto de 1994"
28,4,41,1650,546,659,1205,"21 de agosto de 1994"
28,4,41,1651,566,634,1200,"21 de agosto de 1994"
28,4,41,1652,455,574,1029,"21 de agosto de 1994"
28,4,41,1653,317,356,673,"21 de agosto de 1994"
28,4,41,1654,134,153,287,"21 de agosto de 1994"
28,4,41,1655,487,554,1041,"21 de agosto de 1994"
28,4,41,1656,346,409,755,"21 de agosto de 1994"
28,4,41,1657,364,414,778,"21 de agosto de 1994"
28,4,41,1658,333,372,705,"21 de agosto de 1994"
28,4,41,1659,207,227,434,"21 de agosto de 1994"
28,4,41,1660,350,383,733,"21 de agosto de 1994"
28,4,41,1661,215,259,474,"21 de agosto de 1994"
28,4,41,1662,556,651,1207,"21 de agosto de 1994"
28,4,41,1663,431,467,898,"21 de agosto de 1994"
28,4,41,1664,408,409,817,"21 de agosto de 1994"
28,4,41,1665,357,427,784,"21 de agosto de 1994"
28,4,41,1666,375,420,795,"21 de agosto de 1994"
28,4,41,1667,620,709,1329,"21 de agosto de 1994"
28,4,41,1668,495,518,1013,"21 de agosto de 1994"
28,4,41,1669,484,507,991,"21 de agosto de 1994"
28,4,41,1670,425,494,919,"21 de agosto de 1994"
28,4,41,1671,592,635,1227,"21 de agosto de 1994"
28,4,41,1672,382,432,814,"21 de agosto de 1994"
28,4,41,1673,351,422,773,"21 de agosto de 1994"
28,4,41,1674,393,449,842,"21 de agosto de 1994"
28,4,41,1675,496,548,1044,"21 de agosto de 1994"
28,4,41,1676,412,472,884,"21 de agosto de 1994"
28,4,41,1677,352,415,767,"21 de agosto de 1994"
28,4,41,1678,314,349,663,"21 de agosto de 1994"
28,4,41,1679,384,439,823,"21 de agosto de 1994"
28,4,41,1680,396,442,838,"21 de agosto de 1994"
28,4,41,1681,352,388,740,"21 de agosto de 1994"
28,4,41,1682,375,374,749,"21 de agosto de 1994"
28,4,41,1683,549,602,1151,"21 de agosto de 1994"
28,4,41,1684,305,320,625,"21 de agosto de 1994"
28,4,41,1685,114,113,227,"21 de agosto de 1994"
28,4,41,1686,345,394,739,"21 de agosto de 1994"
28,4,41,1687,480,532,1012,"21 de agosto de 1994"
28,4,41,1688,451,495,946,"21 de agosto de 1994"
28,4,41,1689,413,444,857,"21 de agosto de 1994"
28,4,41,1690,418,420,838,"21 de agosto de 1994"
28,4,41,1691,328,354,682,"21 de agosto de 1994"
28,4,41,1692,223,243,466,"21 de agosto de 1994"
28,4,41,1693,487,584,1071,"21 de agosto de 1994"
28,4,41,1694,663,694,1357,"21 de agosto de 1994"
28,4,41,1695,243,254,497,"21 de agosto de 1994"
28,4,41,1696,449,458,907,"21 de agosto de 1994"
28,4,41,1697,388,381,769,"21 de agosto de 1994"
28,4,41,1698,411,448,859,"21 de agosto de 1994"
28,4,41,1699,300,327,627,"21 de agosto de 1994"
28,4,41,1700,222,250,472,"21 de agosto de 1994"
28,4,41,1701,449,383,832,"21 de agosto de 1994"
28,4,41,1702,264,230,494,"21 de agosto de 1994"
28,4,41,1703,331,263,594,"21 de agosto de 1994"
28,4,41,1704,342,267,609,"21 de agosto de 1994"
28,4,41,1705,388,355,743,"21 de agosto de 1994"
28,4,41,1706,354,331,685,"21 de agosto de 1994"
28,4,41,1707,305,270,575,"21 de agosto de 1994"
28,4,41,1708,348,290,638,"21 de agosto de 1994"
28,4,41,1709,312,243,555,"21 de agosto de 1994"
28,4,41,1710,280,242,522,"21 de agosto de 1994"
28,4,41,1711,66,28,94,"21 de agosto de 1994"
28,5,38,1304,434,450,884,"21 de agosto de 1994"
28,5,38,1305,503,557,1060,"21 de agosto de 1994"
28,5,38,1306,384,399,783,"21 de agosto de 1994"
28,5,38,1307,473,510,983,"21 de agosto de 1994"
28,5,38,1308,354,394,748,"21 de agosto de 1994"
28,5,38,1309,334,347,681,"21 de agosto de 1994"
28,5,38,1310,492,561,1053,"21 de agosto de 1994"
28,5,38,1311,291,333,624,"21 de agosto de 1994"
28,5,38,1312,356,373,729,"21 de agosto de 1994"
28,5,38,1313,474,479,953,"21 de agosto de 1994"
28,5,38,1314,590,680,1270,"21 de agosto de 1994"
28,5,38,1315,431,442,873,"21 de agosto de 1994"
28,5,38,1316,428,465,893,"21 de agosto de 1994"
28,5,38,1317,434,470,904,"21 de agosto de 1994"
28,5,38,1318,576,629,1205,"21 de agosto de 1994"
28,5,38,1319,490,524,1014,"21 de agosto de 1994"
28,5,38,1320,479,530,1009,"21 de agosto de 1994"
28,5,38,1321,353,392,745,"21 de agosto de 1994"
28,5,38,1322,359,425,784,"21 de agosto de 1994"
28,5,38,1323,472,539,1011,"21 de agosto de 1994"
28,5,38,1324,332,355,687,"21 de agosto de 1994"
28,5,38,1325,405,459,864,"21 de agosto de 1994"
28,5,38,1326,501,575,1076,"21 de agosto de 1994"
28,5,38,1327,583,640,1223,"21 de agosto de 1994"
28,5,38,1328,542,569,1111,"21 de agosto de 1994"
28,5,38,1329,567,658,1225,"21 de agosto de 1994"
28,5,38,1330,569,610,1179,"21 de agosto de 1994"
28,5,38,1331,584,611,1195,"21 de agosto de 1994"
28,5,38,1332,504,541,1045,"21 de agosto de 1994"
28,5,38,1333,630,720,1350,"21 de agosto de 1994"
28,5,38,1334,672,732,1404,"21 de agosto de 1994"
28,5,38,1335,436,459,895,"21 de agosto de 1994"
28,5,38,1336,569,612,1181,"21 de agosto de 1994"
28,5,38,1337,448,456,904,"21 de agosto de 1994"
28,5,38,1338,385,420,805,"21 de agosto de 1994"
28,5,38,1339,428,458,886,"21 de agosto de 1994"
28,5,38,1340,595,640,1235,"21 de agosto de 1994"
28,5,38,1341,401,477,878,"21 de agosto de 1994"
28,5,38,1342,409,463,872,"21 de agosto de 1994"
28,5,38,1343,283,328,611,"21 de agosto de 1994"
28,5,38,1344,563,592,1155,"21 de agosto de 1994"
28,5,38,1345,515,522,1037,"21 de agosto de 1994"
28,5,38,1346,373,473,846,"21 de agosto de 1994"
28,5,38,1347,449,518,967,"21 de agosto de 1994"
28,5,38,1348,414,481,895,"21 de agosto de 1994"
28,5,38,1349,270,334,604,"21 de agosto de 1994"
28,5,38,1350,555,661,1216,"21 de agosto de 1994"
28,5,38,1351,583,633,1216,"21 de agosto de 1994"
28,5,38,1352,507,560,1067,"21 de agosto de 1994"
28,5,38,1353,399,437,836,"21 de agosto de 1994"
28,5,38,1354,529,562,1091,"21 de agosto de 1994"
28,5,38,1355,395,411,806,"21 de agosto de 1994"
28,5,38,1356,456,510,966,"21 de agosto de 1994"
28,5,38,1357,372,3,375,"21 de agosto de 1994"
28,5,38,1358,512,554,1066,"21 de agosto de 1994"
28,5,38,1359,283,309,592,"21 de agosto de 1994"
28,5,38,1360,444,488,932,"21 de agosto de 1994"
28,5,38,1361,354,401,755,"21 de agosto de 1994"
28,5,38,1362,629,759,1388,"21 de agosto de 1994"
28,5,38,1363,426,524,950,"21 de agosto de 1994"
28,5,38,1364,406,486,892,"21 de agosto de 1994"
28,5,38,1365,501,514,1015,"21 de agosto de 1994"
28,5,38,1366,401,444,845,"21 de agosto de 1994"
28,5,38,1367,550,687,1237,"21 de agosto de 1994"
28,5,38,1368,522,575,1097,"21 de agosto de 1994"
28,5,38,1369,394,482,876,"21 de agosto de 1994"
28,5,38,1370,398,465,863,"21 de agosto de 1994"
28,5,38,1371,493,581,1074,"21 de agosto de 1994"
28,5,38,1372,435,541,976,"21 de agosto de 1994"
28,5,38,1373,230,228,458,"21 de agosto de 1994"
28,5,38,1374,375,425,800,"21 de agosto de 1994"
28,5,38,1375,383,393,776,"21 de agosto de 1994"
28,5,38,1376,385,449,834,"21 de agosto de 1994"
28,5,38,1377,656,736,1392,"21 de agosto de 1994"
28,5,38,1378,526,561,1087,"21 de agosto de 1994"
28,5,38,1379,482,563,1045,"21 de agosto de 1994"
28,5,38,1380,547,628,1175,"21 de agosto de 1994"
28,5,38,1381,253,282,535,"21 de agosto de 1994"
28,5,38,1382,365,454,819,"21 de agosto de 1994"
28,5,38,1383,399,489,888,"21 de agosto de 1994"
28,5,38,1384,389,415,804,"21 de agosto de 1994"
28,5,38,1385,485,561,1046,"21 de agosto de 1994"
28,5,38,1386,538,600,1138,"21 de agosto de 1994"
28,5,38,1387,580,672,1252,"21 de agosto de 1994"
28,5,38,1388,358,453,811,"21 de agosto de 1994"
28,5,38,1389,383,477,860,"21 de agosto de 1994"
28,5,38,1390,264,333,597,"21 de agosto de 1994"
28,5,38,1391,398,509,907,"21 de agosto de 1994"
28,5,38,1392,615,731,1346,"21 de agosto de 1994"
28,5,38,1393,573,720,1293,"21 de agosto de 1994"
28,5,38,1394,200,300,500,"21 de agosto de 1994"
28,5,38,1395,295,393,688,"21 de agosto de 1994"
28,5,38,1396,392,523,915,"21 de agosto de 1994"
28,5,38,1397,476,609,1085,"21 de agosto de 1994"
28,5,38,1398,356,478,834,"21 de agosto de 1994"
28,5,38,1399,298,360,658,"21 de agosto de 1994"
28,5,38,1400,466,616,1082,"21 de agosto de 1994"
28,5,38,1401,562,605,1167,"21 de agosto de 1994"
28,5,38,1402,486,617,1103,"21 de agosto de 1994"
28,5,38,1403,411,491,902,"21 de agosto de 1994"
28,5,38,1404,333,408,741,"21 de agosto de 1994"
28,5,38,1405,330,423,753,"21 de agosto de 1994"
28,5,38,1406,327,411,738,"21 de agosto de 1994"
28,5,38,1407,288,337,625,"21 de agosto de 1994"
28,5,38,1408,485,588,1073,"21 de agosto de 1994"
28,5,38,1409,468,603,1071,"21 de agosto de 1994"
28,5,38,1410,514,593,1107,"21 de agosto de 1994"
28,5,38,1411,325,372,697,"21 de agosto de 1994"
28,5,38,1412,295,345,640,"21 de agosto de 1994"
28,5,38,1413,521,581,1102,"21 de agosto de 1994"
28,5,38,1414,495,564,1059,"21 de agosto de 1994"
28,5,38,1415,419,484,903,"21 de agosto de 1994"
28,5,38,1416,506,656,1162,"21 de agosto de 1994"
28,5,38,1417,569,662,1231,"21 de agosto de 1994"
28,5,38,1418,478,536,1014,"21 de agosto de 1994"
28,5,38,1419,560,632,1192,"21 de agosto de 1994"
28,5,38,1420,456,621,1077,"21 de agosto de 1994"
28,5,38,1421,486,582,1068,"21 de agosto de 1994"
28,5,38,1422,337,417,754,"21 de agosto de 1994"
28,5,38,1423,365,464,829,"21 de agosto de 1994"
28,5,38,1424,467,514,981,"21 de agosto de 1994"
28,5,38,1425,265,347,612,"21 de agosto de 1994"
28,5,38,1426,472,541,1013,"21 de agosto de 1994"
28,5,38,1427,475,502,977,"21 de agosto de 1994"
28,5,38,1428,483,493,976,"21 de agosto de 1994"
28,5,38,1429,385,503,888,"21 de agosto de 1994"
28,5,38,1430,261,314,575,"21 de agosto de 1994"
28,5,38,1431,241,318,559,"21 de agosto de 1994"
28,5,38,1432,533,604,1137,"21 de agosto de 1994"
28,5,38,1433,271,330,601,"21 de agosto de 1994"
28,5,38,1434,300,392,692,"21 de agosto de 1994"
28,5,38,1435,343,390,733,"21 de agosto de 1994"
28,5,38,1436,336,351,687,"21 de agosto de 1994"
28,5,38,1437,416,468,884,"21 de agosto de 1994"
28,5,38,1438,369,414,783,"21 de agosto de 1994"
28,5,38,1439,353,405,758,"21 de agosto de 1994"
28,5,38,1440,380,471,851,"21 de agosto de 1994"
28,5,38,1441,543,624,1167,"21 de agosto de 1994"
28,5,38,1442,723,698,1421,"21 de agosto de 1994"
28,5,38,1443,497,573,1070,"21 de agosto de 1994"
28,5,38,1444,456,540,996,"21 de agosto de 1994"
28,5,38,1445,359,381,740,"21 de agosto de 1994"
28,5,38,1446,441,442,883,"21 de agosto de 1994"
28,5,38,1447,415,433,848,"21 de agosto de 1994"
28,5,38,1448,294,363,657,"21 de agosto de 1994"
28,5,38,1449,589,651,1240,"21 de agosto de 1994"
28,5,38,1450,476,491,967,"21 de agosto de 1994"
28,5,38,1451,522,599,1121,"21 de agosto de 1994"
28,5,38,1452,522,534,1056,"21 de agosto de 1994"
28,5,38,1453,515,563,1078,"21 de agosto de 1994"
28,5,38,1454,411,424,835,"21 de agosto de 1994"
28,5,38,1455,333,409,742,"21 de agosto de 1994"
28,5,38,1456,415,494,909,"21 de agosto de 1994"
28,5,38,1457,366,409,775,"21 de agosto de 1994"
28,5,38,1458,446,498,944,"21 de agosto de 1994"
28,5,38,1459,372,419,791,"21 de agosto de 1994"
28,5,38,1460,411,456,867,"21 de agosto de 1994"
28,5,38,1461,431,481,912,"21 de agosto de 1994"
28,5,38,1462,438,509,947,"21 de agosto de 1994"
28,5,38,1463,578,619,1197,"21 de agosto de 1994"
28,5,38,1464,448,532,980,"21 de agosto de 1994"
28,5,38,1465,459,518,977,"21 de agosto de 1994"
28,5,38,1466,506,586,1092,"21 de agosto de 1994"
28,5,38,1467,334,375,709,"21 de agosto de 1994"
28,5,38,1468,278,285,563,"21 de agosto de 1994"
28,5,38,1469,258,312,570,"21 de agosto de 1994"
28,5,38,1470,251,288,539,"21 de agosto de 1994"
28,5,38,1471,534,582,1116,"21 de agosto de 1994"
28,5,38,1472,265,327,592,"21 de agosto de 1994"
28,5,38,1473,434,469,903,"21 de agosto de 1994"
28,5,38,1474,430,492,922,"21 de agosto de 1994"
28,5,38,1475,350,392,742,"21 de agosto de 1994"
28,5,38,1476,805,221,1026,"21 de agosto de 1994"
28,5,38,1477,506,532,1038,"21 de agosto de 1994"
28,5,38,1478,274,302,576,"21 de agosto de 1994"
28,5,38,1479,486,539,1025,"21 de agosto de 1994"
28,5,38,1480,325,350,675,"21 de agosto de 1994"
28,5,38,1481,341,419,760,"21 de agosto de 1994"
28,5,38,1482,311,381,692,"21 de agosto de 1994"
28,5,38,1483,371,375,746,"21 de agosto de 1994"
28,5,38,1484,287,285,572,"21 de agosto de 1994"
28,5,38,1485,206,208,414,"21 de agosto de 1994"
28,5,38,1486,302,336,638,"21 de agosto de 1994"
28,5,38,1487,426,482,908,"21 de agosto de 1994"
28,5,38,1488,529,597,1126,"21 de agosto de 1994"
28,5,38,1489,326,320,646,"21 de agosto de 1994"
28,5,38,1490,249,250,499,"21 de agosto de 1994"
28,5,38,1491,183,193,376,"21 de agosto de 1994"
28,5,38,1492,231,296,527,"21 de agosto de 1994"
28,5,38,1493,231,281,512,"21 de agosto de 1994"
28,5,38,1494,253,276,529,"21 de agosto de 1994"
28,5,38,1495,248,281,529,"21 de agosto de 1994"
28,5,38,1496,348,340,688,"21 de agosto de 1994"
28,6,3,34,361,394,755,"21 de agosto de 1994"
28,6,3,35,185,173,358,"21 de agosto de 1994"
28,6,3,36,305,276,581,"21 de agosto de 1994"
28,6,3,37,154,165,319,"21 de agosto de 1994"
28,6,3,38,212,213,425,"21 de agosto de 1994"
28,6,3,39,373,366,739,"21 de agosto de 1994"
28,6,3,40,604,563,1167,"21 de agosto de 1994"
28,6,3,41,603,588,1191,"21 de agosto de 1994"
28,6,3,42,335,314,649,"21 de agosto de 1994"
28,6,3,43,462,462,924,"21 de agosto de 1994"
28,6,3,44,275,279,554,"21 de agosto de 1994"
28,6,3,45,187,179,366,"21 de agosto de 1994"
28,6,3,46,413,419,832,"21 de agosto de 1994"
28,6,3,47,88,93,181,"21 de agosto de 1994"
28,6,3,48,677,726,1403,"21 de agosto de 1994"
28,6,3,49,303,327,630,"21 de agosto de 1994"
28,6,3,50,477,488,965,"21 de agosto de 1994"
28,6,3,51,751,753,1504,"21 de agosto de 1994"
28,6,3,52,603,620,1223,"21 de agosto de 1994"
28,6,3,53,445,447,892,"21 de agosto de 1994"
28,6,3,54,323,354,677,"21 de agosto de 1994"
28,6,3,55,325,249,574,"21 de agosto de 1994"
28,6,3,56,267,243,510,"21 de agosto de 1994"
28,6,3,57,525,512,1037,"21 de agosto de 1994"
28,6,3,58,344,359,703,"21 de agosto de 1994"
28,6,3,59,345,361,706,"21 de agosto de 1994"
28,6,3,60,412,376,788,"21 de agosto de 1994"
28,6,3,61,615,494,1109,"21 de agosto de 1994"
28,6,3,62,667,607,1274,"21 de agosto de 1994"
28,6,3,63,508,502,1010,"21 de agosto de 1994"
28,6,3,64,565,539,1104,"21 de agosto de 1994"
28,6,3,65,222,214,436,"21 de agosto de 1994"
28,6,3,66,194,136,330,"21 de agosto de 1994"
28,6,3,67,479,440,919,"21 de agosto de 1994"
28,6,3,68,435,394,829,"21 de agosto de 1994"
28,6,3,69,697,670,1367,"21 de agosto de 1994"
28,6,3,70,397,364,761,"21 de agosto de 1994"
28,6,3,71,643,681,1324,"21 de agosto de 1994"
28,6,3,72,397,463,860,"21 de agosto de 1994"
28,6,3,73,246,285,531,"21 de agosto de 1994"
28,6,3,74,190,193,383,"21 de agosto de 1994"
28,6,3,75,144,186,330,"21 de agosto de 1994"
28,6,3,76,326,343,669,"21 de agosto de 1994"
28,6,3,77,306,310,616,"21 de agosto de 1994"
28,6,3,78,334,335,669,"21 de agosto de 1994"
28,6,3,79,298,314,612,"21 de agosto de 1994"
28,6,3,80,350,322,672,"21 de agosto de 1994"
28,6,3,81,309,326,635,"21 de agosto de 1994"
28,6,3,82,171,199,370,"21 de agosto de 1994"
28,6,3,83,218,213,431,"21 de agosto de 1994"
28,6,3,84,444,458,902,"21 de agosto de 1994"
28,6,3,85,411,453,864,"21 de agosto de 1994"
28,6,3,86,387,432,819,"21 de agosto de 1994"
28,6,3,87,235,277,512,"21 de agosto de 1994"
28,6,3,88,235,277,512,"21 de agosto de 1994"
28,6,3,89,421,445,866,"21 de agosto de 1994"
28,6,3,90,428,467,895,"21 de agosto de 1994"
28,6,3,91,493,503,996,"21 de agosto de 1994"
28,6,3,92,551,620,1171,"21 de agosto de 1994"
28,6,3,93,438,450,888,"21 de agosto de 1994"
28,6,3,94,377,415,792,"21 de agosto de 1994"
28,6,3,95,477,517,994,"21 de agosto de 1994"
28,6,3,96,276,323,599,"21 de agosto de 1994"
28,6,3,97,427,496,923,"21 de agosto de 1994"
28,6,3,98,424,461,885,"21 de agosto de 1994"
28,6,3,99,415,387,802,"21 de agosto de 1994"
28,6,3,100,105,100,205,"21 de agosto de 1994"
28,6,9,151,475,517,992,"21 de agosto de 1994"
28,6,9,152,297,332,629,"21 de agosto de 1994"
28,6,9,153,344,383,727,"21 de agosto de 1994"
28,6,9,154,462,520,982,"21 de agosto de 1994"
28,6,9,155,390,453,843,"21 de agosto de 1994"
28,6,9,156,464,530,994,"21 de agosto de 1994"
28,6,9,157,635,701,1336,"21 de agosto de 1994"
28,6,9,158,424,452,876,"21 de agosto de 1994"
28,6,9,159,474,557,1031,"21 de agosto de 1994"
28,6,9,160,387,419,806,"21 de agosto de 1994"
28,6,9,161,314,303,617,"21 de agosto de 1994"
28,6,9,162,525,554,1079,"21 de agosto de 1994"
28,6,9,163,149,132,281,"21 de agosto de 1994"
28,6,9,164,276,327,603,"21 de agosto de 1994"
28,6,9,165,397,415,812,"21 de agosto de 1994"
28,6,9,166,562,591,1153,"21 de agosto de 1994"
28,6,9,167,461,510,971,"21 de agosto de 1994"
28,6,9,168,511,558,1069,"21 de agosto de 1994"
28,6,9,169,418,520,938,"21 de agosto de 1994"
28,6,9,170,387,462,849,"21 de agosto de 1994"
28,6,9,171,407,485,892,"21 de agosto de 1994"
28,6,9,172,481,577,1058,"21 de agosto de 1994"
28,6,9,173,497,538,1035,"21 de agosto de 1994"
28,6,9,174,226,231,457,"21 de agosto de 1994"
28,6,9,175,343,348,691,"21 de agosto de 1994"
28,6,9,176,182,37,219,"21 de agosto de 1994"
28,6,9,177,566,549,1115,"21 de agosto de 1994"
28,6,9,178,490,498,988,"21 de agosto de 1994"
28,6,9,179,455,501,956,"21 de agosto de 1994"
28,6,9,180,408,525,933,"21 de agosto de 1994"
28,6,9,181,380,434,814,"21 de agosto de 1994"
28,6,9,182,360,397,757,"21 de agosto de 1994"
28,6,9,183,347,445,792,"21 de agosto de 1994"
28,6,9,184,507,602,1109,"21 de agosto de 1994"
28,6,9,185,417,507,924,"21 de agosto de 1994"
28,6,9,186,444,554,998,"21 de agosto de 1994"
28,6,9,187,504,533,1037,"21 de agosto de 1994"
28,6,9,188,421,500,921,"21 de agosto de 1994"
28,6,9,189,288,367,655,"21 de agosto de 1994"
28,6,9,190,601,617,1218,"21 de agosto de 1994"
28,6,9,191,494,511,1005,"21 de agosto de 1994"
28,6,9,192,532,525,1057,"21 de agosto de 1994"
28,6,9,193,556,574,1130,"21 de agosto de 1994"
28,6,9,194,584,612,1196,"21 de agosto de 1994"
28,6,9,195,320,373,693,"21 de agosto de 1994"
28,6,9,196,372,438,810,"21 de agosto de 1994"
28,6,9,197,520,639,1159,"21 de agosto de 1994"
28,6,9,198,537,601,1138,"21 de agosto de 1994"
28,6,9,199,422,537,959,"21 de agosto de 1994"
28,6,9,200,450,568,1018,"21 de agosto de 1994"
28,6,9,201,355,415,770,"21 de agosto de 1994"
28,6,9,202,373,442,815,"21 de agosto de 1994"
28,6,9,203,373,405,778,"21 de agosto de 1994"
28,6,9,204,585,568,1153,"21 de agosto de 1994"
28,6,9,205,543,530,1073,"21 de agosto de 1994"
28,6,9,206,643,672,1315,"21 de agosto de 1994"
28,6,9,207,422,417,839,"21 de agosto de 1994"
28,6,9,208,581,627,1208,"21 de agosto de 1994"
28,6,9,209,469,544,1013,"21 de agosto de 1994"
28,6,9,210,484,515,999,"21 de agosto de 1994"
28,6,9,211,576,662,1238,"21 de agosto de 1994"
28,6,9,212,564,634,1198,"21 de agosto de 1994"
28,6,9,213,389,506,895,"21 de agosto de 1994"
28,6,9,214,446,555,1001,"21 de agosto de 1994"
28,6,9,215,527,590,1117,"21 de agosto de 1994"
28,6,9,216,412,460,872,"21 de agosto de 1994"
28,6,9,217,370,432,802,"21 de agosto de 1994"
28,6,9,218,472,574,1046,"21 de agosto de 1994"
28,6,9,219,423,529,952,"21 de agosto de 1994"
28,6,9,220,503,553,1056,"21 de agosto de 1994"
28,6,9,221,464,531,995,"21 de agosto de 1994"
28,6,9,222,457,507,964,"21 de agosto de 1994"
28,6,9,223,433,526,959,"21 de agosto de 1994"
28,6,9,224,545,659,1204,"21 de agosto de 1994"
28,6,9,225,386,507,893,"21 de agosto de 1994"
28,6,9,226,423,503,926,"21 de agosto de 1994"
28,6,9,227,524,596,1120,"21 de agosto de 1994"
28,6,9,228,460,580,1040,"21 de agosto de 1994"
28,6,9,229,460,540,1000,"21 de agosto de 1994"
28,6,9,230,501,615,1116,"21 de agosto de 1994"
28,6,9,231,456,551,1007,"21 de agosto de 1994"
28,6,9,232,539,711,1250,"21 de agosto de 1994"
28,6,9,233,529,565,1094,"21 de agosto de 1994"
28,6,9,234,361,447,808,"21 de agosto de 1994"
28,6,9,235,286,390,676,"21 de agosto de 1994"
28,6,9,236,225,261,486,"21 de agosto de 1994"
28,6,9,237,366,429,795,"21 de agosto de 1994"
28,6,9,238,512,613,1125,"21 de agosto de 1994"
28,6,9,239,413,472,885,"21 de agosto de 1994"
28,6,9,240,477,501,978,"21 de agosto de 1994"
28,6,9,241,463,546,1009,"21 de agosto de 1994"
28,6,9,242,589,715,1304,"21 de agosto de 1994"
28,6,9,243,339,425,764,"21 de agosto de 1994"
28,6,9,244,529,601,1130,"21 de agosto de 1994"
28,6,9,245,395,425,820,"21 de agosto de 1994"
28,6,9,246,470,533,1003,"21 de agosto de 1994"
28,6,9,247,462,477,939,"21 de agosto de 1994"
28,6,9,248,344,379,723,"21 de agosto de 1994"
28,6,9,249,329,390,719,"21 de agosto de 1994"
28,6,9,250,440,518,958,"21 de agosto de 1994"
28,6,9,251,351,397,748,"21 de agosto de 1994"
28,6,9,252,288,362,650,"21 de agosto de 1994"
28,6,9,253,540,620,1160,"21 de agosto de 1994"
28,6,9,254,361,417,778,"21 de agosto de 1994"
28,6,9,255,338,371,709,"21 de agosto de 1994"
28,6,9,256,432,541,973,"21 de agosto de 1994"
28,6,9,257,385,468,853,"21 de agosto de 1994"
28,6,9,258,354,400,754,"21 de agosto de 1994"
28,6,12,273,121,98,219,"21 de agosto de 1994"
28,6,12,274,163,153,316,"21 de agosto de 1994"
28,6,12,275,330,340,670,"21 de agosto de 1994"
28,6,12,276,351,353,704,"21 de agosto de 1994"
28,6,12,277,418,412,830,"21 de agosto de 1994"
28,6,12,278,285,286,571,"21 de agosto de 1994"
28,6,12,279,335,361,696,"21 de agosto de 1994"
28,6,12,280,491,533,1024,"21 de agosto de 1994"
28,6,12,281,320,386,706,"21 de agosto de 1994"
28,6,12,282,210,188,398,"21 de agosto de 1994"
28,6,12,283,165,114,279,"21 de agosto de 1994"
28,6,12,284,141,103,244,"21 de agosto de 1994"
28,6,12,285,180,159,339,"21 de agosto de 1994"
28,6,12,286,300,246,546,"21 de agosto de 1994"
28,6,12,287,407,350,757,"21 de agosto de 1994"
28,6,12,288,440,449,889,"21 de agosto de 1994"
28,6,12,289,295,294,589,"21 de agosto de 1994"
28,6,12,290,282,298,580,"21 de agosto de 1994"
28,6,12,291,303,334,637,"21 de agosto de 1994"
28,6,12,292,338,369,707,"21 de agosto de 1994"
28,6,12,293,370,357,727,"21 de agosto de 1994"
28,6,12,294,480,483,963,"21 de agosto de 1994"
28,6,12,295,349,383,732,"21 de agosto de 1994"
28,6,12,296,298,311,609,"21 de agosto de 1994"
28,6,12,297,223,220,443,"21 de agosto de 1994"
28,6,12,298,351,347,698,"21 de agosto de 1994"
28,6,12,299,228,164,392,"21 de agosto de 1994"
28,6,12,300,297,255,552,"21 de agosto de 1994"
28,6,12,301,347,301,648,"21 de agosto de 1994"
28,6,12,302,331,327,658,"21 de agosto de 1994"
28,6,12,303,272,208,480,"21 de agosto de 1994"
28,6,12,304,136,106,242,"21 de agosto de 1994"
28,6,12,305,136,118,254,"21 de agosto de 1994"
28,6,12,306,429,344,773,"21 de agosto de 1994"
28,6,12,307,37,34,71,"21 de agosto de 1994"
28,6,12,308,112,89,201,"21 de agosto de 1994"
28,6,12,309,477,399,876,"21 de agosto de 1994"
28,6,12,310,394,413,807,"21 de agosto de 1994"
28,7,32,995,434,466,900,"21 de agosto de 1994"
28,7,32,996,540,576,1116,"21 de agosto de 1994"
28,7,32,997,480,535,1015,"21 de agosto de 1994"
28,7,32,998,489,549,1038,"21 de agosto de 1994"
28,7,32,999,487,527,1014,"21 de agosto de 1994"
28,7,32,1000,519,619,1138,"21 de agosto de 1994"
28,7,32,1001,422,480,902,"21 de agosto de 1994"
28,7,32,1002,316,361,677,"21 de agosto de 1994"
28,7,32,1003,414,492,906,"21 de agosto de 1994"
28,7,32,1004,291,320,611,"21 de agosto de 1994"
28,7,32,1005,381,477,858,"21 de agosto de 1994"
28,7,32,1006,245,305,550,"21 de agosto de 1994"
28,7,32,1007,464,531,995,"21 de agosto de 1994"
28,7,32,1008,362,387,749,"21 de agosto de 1994"
28,7,32,1009,322,350,672,"21 de agosto de 1994"
28,7,32,1010,255,320,575,"21 de agosto de 1994"
28,7,32,1011,450,563,1013,"21 de agosto de 1994"
28,7,32,1012,313,362,675,"21 de agosto de 1994"
28,7,32,1013,464,561,1025,"21 de agosto de 1994"
28,7,32,1014,406,439,845,"21 de agosto de 1994"
28,7,32,1015,444,527,971,"21 de agosto de 1994"
28,7,32,1016,461,501,962,"21 de agosto de 1994"
28,7,32,1017,425,493,918,"21 de agosto de 1994"
28,7,32,1018,334,358,692,"21 de agosto de 1994"
28,7,32,1019,211,226,437,"21 de agosto de 1994"
28,7,32,1020,399,441,840,"21 de agosto de 1994"
28,7,32,1021,231,270,501,"21 de agosto de 1994"
28,7,32,1022,461,512,973,"21 de agosto de 1994"
28,7,32,1023,396,464,860,"21 de agosto de 1994"
28,7,32,1024,474,548,1022,"21 de agosto de 1994"
28,7,32,1025,469,546,1015,"21 de agosto de 1994"
28,7,32,1026,648,746,1394,"21 de agosto de 1994"
28,7,32,1027,483,526,1009,"21 de agosto de 1994"
28,7,32,1028,363,423,786,"21 de agosto de 1994"
28,7,32,1029,402,474,876,"21 de agosto de 1994"
28,7,32,1030,373,465,838,"21 de agosto de 1994"
28,7,32,1031,408,497,905,"21 de agosto de 1994"
28,7,32,1032,279,342,621,"21 de agosto de 1994"
28,7,32,1033,316,378,694,"21 de agosto de 1994"
28,7,32,1034,275,312,587,"21 de agosto de 1994"
28,7,32,1035,411,446,857,"21 de agosto de 1994"
28,7,32,1036,404,423,827,"21 de agosto de 1994"
28,7,32,1037,495,562,1057,"21 de agosto de 1994"
28,7,32,1038,488,588,1076,"21 de agosto de 1994"
28,7,32,1039,369,414,783,"21 de agosto de 1994"
28,7,32,1040,581,634,1215,"21 de agosto de 1994"
28,7,32,1041,439,490,929,"21 de agosto de 1994"
28,7,32,1042,493,504,997,"21 de agosto de 1994"
28,7,32,1043,491,586,1077,"21 de agosto de 1994"
28,7,32,1044,322,367,689,"21 de agosto de 1994"
28,7,32,1045,411,499,910,"21 de agosto de 1994"
28,7,32,1046,459,543,1002,"21 de agosto de 1994"
28,7,32,1047,460,525,985,"21 de agosto de 1994"
28,7,32,1048,473,519,992,"21 de agosto de 1994"
28,7,32,1049,426,427,853,"21 de agosto de 1994"
28,7,32,1050,399,471,870,"21 de agosto de 1994"
28,7,32,1051,355,413,768,"21 de agosto de 1994"
28,7,32,1052,487,556,1043,"21 de agosto de 1994"
28,7,32,1053,387,480,867,"21 de agosto de 1994"
28,7,32,1054,230,278,508,"21 de agosto de 1994"
28,7,32,1055,369,411,780,"21 de agosto de 1994"
28,7,32,1056,646,770,1416,"21 de agosto de 1994"
28,7,32,1057,490,538,1028,"21 de agosto de 1994"
28,7,32,1058,537,590,1127,"21 de agosto de 1994"
28,7,32,1059,332,363,695,"21 de agosto de 1994"
28,7,32,1060,448,473,921,"21 de agosto de 1994"
28,7,32,1061,457,519,976,"21 de agosto de 1994"
28,7,32,1062,537,548,1085,"21 de agosto de 1994"
28,7,32,1063,444,528,972,"21 de agosto de 1994"
28,7,32,1064,418,479,897,"21 de agosto de 1994"
28,7,32,1065,249,302,551,"21 de agosto de 1994"
28,7,32,1066,459,531,990,"21 de agosto de 1994"
28,7,32,1067,281,292,573,"21 de agosto de 1994"
28,7,32,1068,415,437,852,"21 de agosto de 1994"
28,7,32,1069,436,492,928,"21 de agosto de 1994"
28,7,32,1070,411,438,849,"21 de agosto de 1994"
28,7,32,1071,403,414,817,"21 de agosto de 1994"
28,7,32,1072,183,186,369,"21 de agosto de 1994"
28,7,32,1073,852,1032,1884,"21 de agosto de 1994"
28,7,32,1074,573,657,1230,"21 de agosto de 1994"
28,7,32,1075,488,556,1044,"21 de agosto de 1994"
28,7,32,1076,464,501,965,"21 de agosto de 1994"
28,7,32,1077,268,265,533,"21 de agosto de 1994"
28,7,32,1078,491,513,1004,"21 de agosto de 1994"
28,7,32,1079,433,454,887,"21 de agosto de 1994"
28,7,32,1080,524,580,1104,"21 de agosto de 1994"
28,7,32,1081,438,525,963,"21 de agosto de 1994"
28,7,32,1082,394,454,848,"21 de agosto de 1994"
28,7,32,1083,257,289,546,"21 de agosto de 1994"
28,7,32,1084,542,553,1095,"21 de agosto de 1994"
28,7,32,1085,557,627,1184,"21 de agosto de 1994"
28,7,32,1086,474,514,988,"21 de agosto de 1994"
28,7,32,1087,259,307,566,"21 de agosto de 1994"
28,7,32,1088,523,520,1043,"21 de agosto de 1994"
28,7,32,1089,565,628,1193,"21 de agosto de 1994"
28,7,32,1090,569,646,1215,"21 de agosto de 1994"
28,7,32,1091,347,374,721,"21 de agosto de 1994"
28,7,32,1092,181,199,380,"21 de agosto de 1994"
28,7,32,1093,416,45,461,"21 de agosto de 1994"
28,7,32,1094,773,847,1620,"21 de agosto de 1994"
28,7,32,1095,466,469,935,"21 de agosto de 1994"
28,7,32,1096,527,593,1120,"21 de agosto de 1994"
28,7,32,1097,547,576,1123,"21 de agosto de 1994"
28,7,32,1098,487,538,1025,"21 de agosto de 1994"
28,7,32,1099,490,512,1002,"21 de agosto de 1994"
28,7,32,1100,478,527,1005,"21 de agosto de 1994"
28,7,32,1101,253,282,535,"21 de agosto de 1994"
28,7,32,1102,430,522,952,"21 de agosto de 1994"
28,7,32,1103,531,617,1148,"21 de agosto de 1994"
28,7,32,1104,486,551,1037,"21 de agosto de 1994"
28,7,32,1105,494,583,1077,"21 de agosto de 1994"
28,7,32,1106,447,461,908,"21 de agosto de 1994"
28,7,32,1107,335,369,704,"21 de agosto de 1994"
28,7,32,1108,435,498,933,"21 de agosto de 1994"
28,7,32,1109,579,632,1211,"21 de agosto de 1994"
28,7,32,1110,320,283,603,"21 de agosto de 1994"
28,7,32,1111,150,161,311,"21 de agosto de 1994"
28,7,32,1112,400,447,847,"21 de agosto de 1994"
28,7,32,1113,358,354,712,"21 de agosto de 1994"
28,7,32,1114,387,458,845,"21 de agosto de 1994"
28,7,32,1115,412,477,889,"21 de agosto de 1994"
28,7,32,1116,488,591,1079,"21 de agosto de 1994"
28,7,32,1117,408,477,885,"21 de agosto de 1994"
28,7,32,1118,490,506,996,"21 de agosto de 1994"
28,7,32,1119,574,682,1256,"21 de agosto de 1994"
28,7,32,1120,408,459,867,"21 de agosto de 1994"
28,7,32,1121,326,382,708,"21 de agosto de 1994"
28,7,32,1122,382,397,779,"21 de agosto de 1994"
28,7,32,1123,302,325,627,"21 de agosto de 1994"
28,7,32,1124,419,374,793,"21 de agosto de 1994"
28,7,32,1125,129,126,255,"21 de agosto de 1994"
28,7,32,1126,65,53,118,"21 de agosto de 1994"
28,7,32,1127,285,188,473,"21 de agosto de 1994"
28,7,32,1128,74,47,121,"21 de agosto de 1994"
28,7,32,1129,90,66,156,"21 de agosto de 1994"
28,7,32,1130,327,223,550,"21 de agosto de 1994"
28,7,32,1131,215,122,337,"21 de agosto de 1994"
28,7,32,1132,110,70,180,"21 de agosto de 1994"
28,7,32,1133,131,84,215,"21 de agosto de 1994"
28,7,32,1134,263,183,446,"21 de agosto de 1994"
28,7,32,1135,282,260,542,"21 de agosto de 1994"
28,7,32,1136,352,327,679,"21 de agosto de 1994"
28,7,32,1137,289,265,554,"21 de agosto de 1994"
28,7,32,1138,37,26,63,"21 de agosto de 1994"
28,7,33,1139,214,219,433,"21 de agosto de 1994"
28,7,33,1140,224,248,472,"21 de agosto de 1994"
28,7,33,1141,328,335,663,"21 de agosto de 1994"
28,7,33,1142,255,284,539,"21 de agosto de 1994"
28,7,33,1143,260,261,521,"21 de agosto de 1994"
28,7,33,1144,254,297,551,"21 de agosto de 1994"
28,7,33,1145,466,473,939,"21 de agosto de 1994"
28,7,33,1146,273,288,561,"21 de agosto de 1994"
28,7,33,1147,442,473,915,"21 de agosto de 1994"
28,7,33,1148,539,593,1132,"21 de agosto de 1994"
28,7,33,1149,512,592,1104,"21 de agosto de 1994"
28,7,33,1150,399,416,815,"21 de agosto de 1994"
28,7,33,1151,445,542,987,"21 de agosto de 1994"
28,7,33,1152,550,573,1123,"21 de agosto de 1994"
28,7,33,1153,305,358,663,"21 de agosto de 1994"
28,7,33,1154,378,438,816,"21 de agosto de 1994"
28,7,33,1155,432,538,970,"21 de agosto de 1994"
28,7,33,1156,466,514,980,"21 de agosto de 1994"
28,7,33,1157,523,598,1121,"21 de agosto de 1994"
28,7,33,1158,534,556,1090,"21 de agosto de 1994"
28,7,33,1159,621,703,1324,"21 de agosto de 1994"
28,7,33,1160,134,114,248,"21 de agosto de 1994"
28,7,33,1161,309,349,658,"21 de agosto de 1994"
28,7,33,1162,364,377,741,"21 de agosto de 1994"
28,7,33,1163,456,512,968,"21 de agosto de 1994"
28,7,33,1164,480,569,1049,"21 de agosto de 1994"
28,7,33,1165,267,309,576,"21 de agosto de 1994"
28,7,33,1166,434,474,908,"21 de agosto de 1994"
28,7,33,1167,325,312,637,"21 de agosto de 1994"
28,7,33,1168,367,411,778,"21 de agosto de 1994"
28,7,33,1169,517,577,1094,"21 de agosto de 1994"
28,7,33,1170,472,564,1036,"21 de agosto de 1994"
28,7,33,1171,528,598,1126,"21 de agosto de 1994"
28,7,33,1172,475,508,983,"21 de agosto de 1994"
28,7,33,1173,359,395,754,"21 de agosto de 1994"
28,7,33,1174,599,710,1309,"21 de agosto de 1994"
28,7,33,1175,271,303,574,"21 de agosto de 1994"
28,7,33,1176,360,398,758,"21 de agosto de 1994"
28,7,33,1177,398,426,824,"21 de agosto de 1994"
28,7,33,1178,507,522,1029,"21 de agosto de 1994"
28,7,33,1179,163,187,350,"21 de agosto de 1994"
28,7,33,1180,260,314,574,"21 de agosto de 1994"
28,7,33,1181,297,339,636,"21 de agosto de 1994"
28,7,33,1182,257,294,551,"21 de agosto de 1994"
28,7,33,1183,266,327,593,"21 de agosto de 1994"
28,7,33,1184,438,472,910,"21 de agosto de 1994"
28,7,33,1185,350,385,735,"21 de agosto de 1994"
28,7,33,1186,191,242,433,"21 de agosto de 1994"
28,7,33,1187,159,177,336,"21 de agosto de 1994"
28,7,33,1188,93,85,178,"21 de agosto de 1994"
28,7,33,1189,264,263,527,"21 de agosto de 1994"
28,7,33,1190,213,231,444,"21 de agosto de 1994"
28,7,33,1191,387,423,810,"21 de agosto de 1994"
28,7,33,1192,495,508,1003,"21 de agosto de 1994"
28,7,33,1193,472,540,1012,"21 de agosto de 1994"
28,7,33,1194,442,448,890,"21 de agosto de 1994"
28,7,33,1195,430,421,851,"21 de agosto de 1994"
28,7,33,1196,443,439,882,"21 de agosto de 1994"
28,7,33,1197,384,301,685,"21 de agosto de 1994"
28,7,33,1198,156,108,264,"21 de agosto de 1994"
28,7,33,1199,131,129,260,"21 de agosto de 1994"
28,7,33,1200,438,379,817,"21 de agosto de 1994"
28,7,33,1201,169,130,299,"21 de agosto de 1994"
28,7,33,1202,129,103,232,"21 de agosto de 1994"
28,7,33,1203,232,200,432,"21 de agosto de 1994"
28,7,33,1204,349,334,683,"21 de agosto de 1994"
28,7,33,1205,289,341,630,"21 de agosto de 1994"
28,7,33,1206,456,417,873,"21 de agosto de 1994"
28,7,33,1207,220,214,434,"21 de agosto de 1994"
28,7,33,1208,147,139,286,"21 de agosto de 1994"
28,7,33,1209,429,353,782,"21 de agosto de 1994"
28,7,33,1210,245,228,473,"21 de agosto de 1994"
28,7,40,1516,222,242,464,"21 de agosto de 1994"
28,7,40,1517,292,314,606,"21 de agosto de 1994"
28,7,40,1518,255,295,550,"21 de agosto de 1994"
28,7,40,1519,255,272,527,"21 de agosto de 1994"
28,7,40,1520,607,708,1315,"21 de agosto de 1994"
28,7,40,1521,218,230,448,"21 de agosto de 1994"
28,7,40,1522,375,432,807,"21 de agosto de 1994"
28,7,40,1523,455,516,971,"21 de agosto de 1994"
28,7,40,1524,510,567,1077,"21 de agosto de 1994"
28,7,40,1525,324,367,691,"21 de agosto de 1994"
28,7,40,1526,327,374,701,"21 de agosto de 1994"
28,7,40,1527,432,458,890,"21 de agosto de 1994"
28,7,40,1528,179,179,358,"21 de agosto de 1994"
28,7,40,1529,283,309,592,"21 de agosto de 1994"
28,7,40,1530,427,452,879,"21 de agosto de 1994"
28,7,40,1531,444,512,956,"21 de agosto de 1994"
28,7,40,1532,377,444,821,"21 de agosto de 1994"
28,7,40,1533,328,365,693,"21 de agosto de 1994"
28,7,40,1534,378,426,804,"21 de agosto de 1994"
28,7,40,1535,195,218,413,"21 de agosto de 1994"
28,7,40,1536,412,447,859,"21 de agosto de 1994"
28,7,40,1537,290,310,600,"21 de agosto de 1994"
28,7,40,1538,194,202,396,"21 de agosto de 1994"
28,7,40,1539,107,110,217,"21 de agosto de 1994"
28,7,40,1540,388,439,827,"21 de agosto de 1994"
28,7,40,1541,326,405,731,"21 de agosto de 1994"
28,7,40,1542,181,208,389,"21 de agosto de 1994"
28,7,40,1543,159,212,371,"21 de agosto de 1994"
28,7,40,1544,98,88,186,"21 de agosto de 1994"
28,7,40,1545,318,288,606,"21 de agosto de 1994"
28,7,40,1546,302,328,630,"21 de agosto de 1994"
28,7,40,1547,171,157,328,"21 de agosto de 1994"
28,7,40,1548,425,351,776,"21 de agosto de 1994"
28,7,40,1549,197,127,324,"21 de agosto de 1994"
28,7,40,1550,442,430,872,"21 de agosto de 1994"
28,7,40,1551,666,705,1371,"21 de agosto de 1994"
28,7,40,1552,318,300,618,"21 de agosto de 1994"
28,7,40,1553,138,139,277,"21 de agosto de 1994"
28,7,40,1554,186,163,349,"21 de agosto de 1994"
28,7,40,1555,439,461,900,"21 de agosto de 1994"
28,7,40,1556,367,426,793,"21 de agosto de 1994"
28,7,40,1557,138,145,283,"21 de agosto de 1994"
28,7,40,1558,127,126,253,"21 de agosto de 1994"
28,7,40,1559,165,123,288,"21 de agosto de 1994"
28,7,40,1560,263,209,472,"21 de agosto de 1994"
28,7,40,1561,127,79,206,"21 de agosto de 1994"
28,8,1,1,290,263,553,"21 de agosto de 1994"
28,8,1,2,472,460,932,"21 de agosto de 1994"
28,8,1,3,285,290,575,"21 de agosto de 1994"
28,8,1,4,303,303,606,"21 de agosto de 1994"
28,8,1,5,314,300,614,"21 de agosto de 1994"
28,8,1,6,220,202,422,"21 de agosto de 1994"
28,8,1,7,30,16,46,"21 de agosto de 1994"
28,8,1,8,406,363,769,"21 de agosto de 1994"
28,8,1,9,391,333,724,"21 de agosto de 1994"
28,8,1,10,508,473,981,"21 de agosto de 1994"
28,8,1,11,275,228,503,"21 de agosto de 1994"
28,8,1,12,300,220,520,"21 de agosto de 1994"
28,8,2,13,463,458,921,"21 de agosto de 1994"
28,8,2,14,494,500,994,"21 de agosto de 1994"
28,8,2,15,370,367,737,"21 de agosto de 1994"
28,8,2,16,387,399,786,"21 de agosto de 1994"
28,8,2,17,328,394,722,"21 de agosto de 1994"
28,8,2,18,509,461,970,"21 de agosto de 1994"
28,8,2,19,577,614,1191,"21 de agosto de 1994"
28,8,2,20,251,181,432,"21 de agosto de 1994"
28,8,2,21,172,117,289,"21 de agosto de 1994"
28,8,2,22,193,142,335,"21 de agosto de 1994"
28,8,2,23,398,314,712,"21 de agosto de 1994"
28,8,2,24,313,221,534,"21 de agosto de 1994"
28,8,2,25,293,189,482,"21 de agosto de 1994"
28,8,2,26,145,105,250,"21 de agosto de 1994"
28,8,2,27,406,274,680,"21 de agosto de 1994"
28,8,2,28,245,187,432,"21 de agosto de 1994"
28,8,2,29,137,107,244,"21 de agosto de 1994"
28,8,2,30,512,411,923,"21 de agosto de 1994"
28,8,2,31,228,164,392,"21 de agosto de 1994"
28,8,2,32,271,186,457,"21 de agosto de 1994"
28,8,2,33,476,366,842,"21 de agosto de 1994"
28,8,5,108,260,244,504,"21 de agosto de 1994"
28,8,5,109,286,231,517,"21 de agosto de 1994"
28,8,5,110,295,256,551,"21 de agosto de 1994"
28,8,5,111,113,101,214,"21 de agosto de 1994"
28,8,5,112,204,199,403,"21 de agosto de 1994"
28,8,5,113,80,71,151,"21 de agosto de 1994"
28,8,5,114,382,339,721,"21 de agosto de 1994"
28,8,5,115,92,74,166,"21 de agosto de 1994"
28,8,8,143,306,248,554,"21 de agosto de 1994"
28,8,8,144,155,125,280,"21 de agosto de 1994"
28,8,8,145,146,77,223,"21 de agosto de 1994"
28,8,8,146,74,59,133,"21 de agosto de 1994"
28,8,8,147,252,199,451,"21 de agosto de 1994"
28,8,8,148,167,129,296,"21 de agosto de 1994"
28,8,8,149,222,167,389,"21 de agosto de 1994"
28,8,8,150,76,50,126,"21 de agosto de 1994"
28,8,10,259,161,149,310,"21 de agosto de 1994"
28,8,10,260,52,51,103,"21 de agosto de 1994"
28,8,10,261,73,55,128,"21 de agosto de 1994"
28,8,10,262,87,83,170,"21 de agosto de 1994"
28,8,10,263,39,23,62,"21 de agosto de 1994"
28,8,10,264,163,140,303,"21 de agosto de 1994"
28,8,10,265,187,148,335,"21 de agosto de 1994"
28,8,13,311,299,252,551,"21 de agosto de 1994"
28,8,13,312,271,245,516,"21 de agosto de 1994"
28,8,13,313,250,210,460,"21 de agosto de 1994"
28,8,13,314,291,292,583,"21 de agosto de 1994"
28,8,13,315,227,225,452,"21 de agosto de 1994"
28,8,13,316,503,433,936,"21 de agosto de 1994"
28,8,13,317,508,429,937,"21 de agosto de 1994"
28,8,13,318,292,274,566,"21 de agosto de 1994"
28,8,13,319,263,228,491,"21 de agosto de 1994"
28,8,13,320,267,224,491,"21 de agosto de 1994"
28,8,13,321,281,230,511,"21 de agosto de 1994"
28,8,13,322,210,195,405,"21 de agosto de 1994"
28,8,13,323,96,56,152,"21 de agosto de 1994"
28,8,13,324,291,250,541,"21 de agosto de 1994"
28,8,13,325,211,146,357,"21 de agosto de 1994"
28,8,13,326,95,78,173,"21 de agosto de 1994"
28,8,16,346,526,537,1063,"21 de agosto de 1994"
28,8,16,347,389,352,741,"21 de agosto de 1994"
28,8,16,348,388,393,781,"21 de agosto de 1994"
28,8,16,349,425,374,799,"21 de agosto de 1994"
28,8,16,350,332,264,596,"21 de agosto de 1994"
28,8,16,351,172,138,310,"21 de agosto de 1994"
28,8,16,352,98,74,172,"21 de agosto de 1994"
28,8,16,353,398,290,688,"21 de agosto de 1994"
28,8,16,354,461,380,841,"21 de agosto de 1994"
28,8,16,355,380,307,687,"21 de agosto de 1994"
28,8,16,356,374,308,682,"21 de agosto de 1994"
28,8,16,357,204,181,385,"21 de agosto de 1994"
28,8,16,358,302,265,567,"21 de agosto de 1994"
28,8,16,359,488,409,897,"21 de agosto de 1994"
28,8,16,360,412,343,755,"21 de agosto de 1994"
28,8,16,361,25,25,50,"21 de agosto de 1994"
28,8,16,362,109,84,193,"21 de agosto de 1994"
28,8,16,363,394,376,770,"21 de agosto de 1994"
28,8,16,364,496,455,951,"21 de agosto de 1994"
28,8,16,365,336,330,666,"21 de agosto de 1994"
28,8,16,366,366,337,703,"21 de agosto de 1994"
28,8,16,367,403,389,792,"21 de agosto de 1994"
28,8,18,381,518,438,956,"21 de agosto de 1994"
28,8,18,382,397,410,807,"21 de agosto de 1994"
28,8,18,383,241,222,463,"21 de agosto de 1994"
28,8,18,384,398,363,761,"21 de agosto de 1994"
28,8,18,385,346,352,698,"21 de agosto de 1994"
28,8,18,386,201,159,360,"21 de agosto de 1994"
28,8,18,387,180,142,322,"21 de agosto de 1994"
28,8,18,388,359,312,671,"21 de agosto de 1994"
28,8,19,389,386,333,719,"21 de agosto de 1994"
28,8,19,390,391,420,811,"21 de agosto de 1994"
28,8,19,391,489,488,977,"21 de agosto de 1994"
28,8,19,392,93,49,142,"21 de agosto de 1994"
28,8,19,393,259,218,477,"21 de agosto de 1994"
28,8,19,394,385,312,697,"21 de agosto de 1994"
28,8,19,395,269,241,510,"21 de agosto de 1994"
28,8,19,396,394,338,732,"21 de agosto de 1994"
28,8,19,397,420,377,797,"21 de agosto de 1994"
28,8,19,398,234,201,435,"21 de agosto de 1994"
28,8,19,399,260,185,445,"21 de agosto de 1994"
28,8,19,400,352,259,611,"21 de agosto de 1994"
28,8,19,401,336,282,618,"21 de agosto de 1994"
28,8,19,402,294,229,523,"21 de agosto de 1994"
28,8,19,403,177,108,285,"21 de agosto de 1994"
28,8,19,404,416,357,773,"21 de agosto de 1994"
28,8,19,405,327,277,604,"21 de agosto de 1994"
28,8,19,406,192,183,375,"21 de agosto de 1994"
28,8,19,407,292,246,538,"21 de agosto de 1994"
28,8,20,408,244,187,431,"21 de agosto de 1994"
28,8,20,409,195,188,383,"21 de agosto de 1994"
28,8,20,410,299,255,554,"21 de agosto de 1994"
28,8,20,411,199,188,387,"21 de agosto de 1994"
28,8,23,710,324,269,593,"21 de agosto de 1994"
28,8,23,711,237,231,468,"21 de agosto de 1994"
28,8,23,712,464,426,890,"21 de agosto de 1994"
28,8,23,713,304,286,590,"21 de agosto de 1994"
28,8,23,714,262,203,465,"21 de agosto de 1994"
28,8,23,715,124,100,224,"21 de agosto de 1994"
28,8,30,922,442,410,852,"21 de agosto de 1994"
28,8,30,923,397,376,773,"21 de agosto de 1994"
28,8,30,924,497,437,934,"21 de agosto de 1994"
28,8,30,925,349,357,706,"21 de agosto de 1994"
28,8,30,926,632,600,1232,"21 de agosto de 1994"
28,8,30,927,362,364,726,"21 de agosto de 1994"
28,8,30,928,547,477,1024,"21 de agosto de 1994"
28,8,30,929,357,293,650,"21 de agosto de 1994"
28,8,30,930,493,435,928,"21 de agosto de 1994"
28,8,34,1211,181,185,366,"21 de agosto de 1994"
28,8,34,1212,200,205,405,"21 de agosto de 1994"
28,8,34,1213,77,55,132,"21 de agosto de 1994"
28,8,34,1214,169,143,312,"21 de agosto de 1994"
28,8,34,1215,212,187,399,"21 de agosto de 1994"
28,8,34,1216,234,194,428,"21 de agosto de 1994"
28,8,34,1217,236,171,407,"21 de agosto de 1994"
28,8,34,1218,206,141,347,"21 de agosto de 1994"
28,8,34,1219,265,171,436,"21 de agosto de 1994"
28,8,34,1220,347,278,625,"21 de agosto de 1994"
28,8,34,1221,455,402,857,"21 de agosto de 1994"
28,8,34,1222,482,434,916,"21 de agosto de 1994"
28,8,35,1223,266,245,511,"21 de agosto de 1994"
28,8,35,1224,107,107,214,"21 de agosto de 1994"
28,8,35,1225,434,477,911,"21 de agosto de 1994"
28,8,35,1226,474,456,930,"21 de agosto de 1994"
28,8,35,1227,223,236,459,"21 de agosto de 1994"
28,8,35,1228,74,83,157,"21 de agosto de 1994"
28,8,35,1229,273,249,522,"21 de agosto de 1994"
28,8,35,1230,310,306,616,"21 de agosto de 1994"
28,8,35,1231,231,257,488,"21 de agosto de 1994"
28,8,35,1232,566,590,1156,"21 de agosto de 1994"
28,8,35,1233,346,373,719,"21 de agosto de 1994"
28,8,35,1234,321,357,678,"21 de agosto de 1994"
28,8,35,1235,379,400,779,"21 de agosto de 1994"
28,8,35,1236,340,389,729,"21 de agosto de 1994"
28,8,35,1237,487,499,986,"21 de agosto de 1994"
28,8,35,1238,538,591,1129,"21 de agosto de 1994"
28,8,35,1239,130,131,261,"21 de agosto de 1994"
28,8,35,1240,88,103,191,"21 de agosto de 1994"
28,8,35,1241,87,107,194,"21 de agosto de 1994"
28,8,35,1242,193,195,388,"21 de agosto de 1994"
28,8,35,1243,194,186,380,"21 de agosto de 1994"
28,8,35,1244,245,209,454,"21 de agosto de 1994"
28,8,35,1245,94,107,201,"21 de agosto de 1994"
28,8,35,1246,355,333,688,"21 de agosto de 1994"
28,8,35,1247,299,288,587,"21 de agosto de 1994"
28,8,35,1248,303,219,522,"21 de agosto de 1994"
28,8,35,1249,384,372,756,"21 de agosto de 1994"
28,8,35,1250,167,153,320,"21 de agosto de 1994"
28,8,35,1251,206,191,397,"21 de agosto de 1994"
28,8,35,1252,384,364,748,"21 de agosto de 1994"
28,8,35,1253,256,223,479,"21 de agosto de 1994"
28,8,35,1254,459,451,910,"21 de agosto de 1994"
28,8,35,1255,250,190,440,"21 de agosto de 1994"
28,8,35,1256,290,269,559,"21 de agosto de 1994"
28,8,35,1257,251,155,406,"21 de agosto de 1994"
28,8,35,1258,317,257,574,"21 de agosto de 1994"
28,8,35,1259,455,417,872,"21 de agosto de 1994"
28,8,35,1260,376,336,712,"21 de agosto de 1994"
28,8,35,1261,230,190,420,"21 de agosto de 1994"
28,8,35,1262,317,262,579,"21 de agosto de 1994"
28,8,35,1263,416,410,826,"21 de agosto de 1994"
28,8,35,1264,328,325,653,"21 de agosto de 1994"
28,8,35,1265,294,264,558,"21 de agosto de 1994"
28,8,35,1266,45,32,77,"21 de agosto de 1994"
28,8,35,1267,60,52,112,"21 de agosto de 1994"
28,8,35,1268,322,267,589,"21 de agosto de 1994"
28,8,35,1269,188,156,344,"21 de agosto de 1994"
28,8,35,1270,112,95,207,"21 de agosto de 1994"
28,8,35,1271,263,207,470,"21 de agosto de 1994"
28,8,35,1272,305,231,536,"21 de agosto de 1994"
28,8,35,1273,29,22,51,"21 de agosto de 1994"
28,8,35,1274,105,91,196,"21 de agosto de 1994"
28,8,35,1275,99,77,176,"21 de agosto de 1994"
28,8,35,1276,182,126,308,"21 de agosto de 1994"
28,8,35,1277,407,297,704,"21 de agosto de 1994"
28,8,36,1278,196,159,355,"21 de agosto de 1994"
28,8,36,1279,105,87,192,"21 de agosto de 1994"
28,8,37,1280,466,443,909,"21 de agosto de 1994"
28,8,37,1281,340,377,717,"21 de agosto de 1994"
28,8,37,1282,324,307,631,"21 de agosto de 1994"
28,8,37,1283,391,382,773,"21 de agosto de 1994"
28,8,37,1284,277,282,559,"21 de agosto de 1994"
28,8,37,1285,315,240,555,"21 de agosto de 1994"
28,8,37,1286,308,243,551,"21 de agosto de 1994"
28,8,37,1287,271,220,491,"21 de agosto de 1994"
28,8,37,1288,239,190,429,"21 de agosto de 1994"
28,8,37,1289,139,99,238,"21 de agosto de 1994"
28,8,37,1290,317,248,565,"21 de agosto de 1994"
28,8,37,1291,198,157,355,"21 de agosto de 1994"
28,8,37,1292,112,95,207,"21 de agosto de 1994"
28,8,37,1293,128,84,212,"21 de agosto de 1994"
28,8,37,1294,400,373,773,"21 de agosto de 1994"
28,8,37,1295,110,88,198,"21 de agosto de 1994"
28,8,37,1296,157,113,270,"21 de agosto de 1994"
28,8,37,1297,96,41,137,"21 de agosto de 1994"
28,8,37,1298,246,172,418,"21 de agosto de 1994"
28,8,37,1299,353,304,657,"21 de agosto de 1994"
28,8,37,1300,101,71,172,"21 de agosto de 1994"
28,8,37,1301,214,146,360,"21 de agosto de 1994"
28,8,37,1302,353,298,651,"21 de agosto de 1994"
28,8,37,1303,252,202,454,"21 de agosto de 1994"
28,8,42,1712,456,392,848,"21 de agosto de 1994"
28,8,42,1713,394,377,771,"21 de agosto de 1994"
28,8,42,1714,244,207,451,"21 de agosto de 1994"
28,8,42,1715,274,236,510,"21 de agosto de 1994"
28,8,42,1716,353,290,643,"21 de agosto de 1994"
28,8,42,1717,275,210,485,"21 de agosto de 1994"
28,8,42,1718,302,241,543,"21 de agosto de 1994"
28,9,4,101,469,513,982,"21 de agosto de 1994"
28,9,4,102,488,459,947,"21 de agosto de 1994"
28,9,4,103,416,341,757,"21 de agosto de 1994"
28,9,4,104,277,236,513,"21 de agosto de 1994"
28,9,4,105,188,154,342,"21 de agosto de 1994"
28,9,4,106,471,437,908,"21 de agosto de 1994"
28,9,4,107,168,123,291,"21 de agosto de 1994"
28,9,11,266,561,491,1052,"21 de agosto de 1994"
28,9,11,267,74,39,113,"21 de agosto de 1994"
28,9,11,268,527,457,984,"21 de agosto de 1994"
28,9,11,269,299,257,556,"21 de agosto de 1994"
28,9,11,270,366,350,716,"21 de agosto de 1994"
28,9,11,271,389,406,795,"21 de agosto de 1994"
28,9,11,272,433,426,859,"21 de agosto de 1994"
28,9,21,412,351,300,651,"21 de agosto de 1994"
28,9,21,413,176,187,363,"21 de agosto de 1994"
28,9,21,414,142,152,294,"21 de agosto de 1994"
28,9,21,415,317,368,685,"21 de agosto de 1994"
28,9,21,416,543,622,1165,"21 de agosto de 1994"
28,9,21,417,541,641,1182,"21 de agosto de 1994"
28,9,21,418,217,269,486,"21 de agosto de 1994"
28,9,21,419,281,304,585,"21 de agosto de 1994"
28,9,21,420,604,657,1261,"21 de agosto de 1994"
28,9,21,421,505,581,1086,"21 de agosto de 1994"
28,9,21,422,600,640,1240,"21 de agosto de 1994"
28,9,21,423,380,408,788,"21 de agosto de 1994"
28,9,21,424,516,593,1109,"21 de agosto de 1994"
28,9,21,425,314,330,644,"21 de agosto de 1994"
28,9,21,426,389,414,803,"21 de agosto de 1994"
28,9,21,427,368,317,685,"21 de agosto de 1994"
28,9,21,428,445,501,946,"21 de agosto de 1994"
28,9,21,429,200,218,418,"21 de agosto de 1994"
28,9,21,430,418,456,874,"21 de agosto de 1994"
28,9,21,431,492,521,1013,"21 de agosto de 1994"
28,9,21,432,566,625,1191,"21 de agosto de 1994"
28,9,21,433,420,465,885,"21 de agosto de 1994"
28,9,21,434,192,256,448,"21 de agosto de 1994"
28,9,21,435,423,503,926,"21 de agosto de 1994"
28,9,21,436,504,545,1049,"21 de agosto de 1994"
28,9,21,437,511,552,1063,"21 de agosto de 1994"
28,9,21,438,296,294,590,"21 de agosto de 1994"
28,9,21,439,488,530,1018,"21 de agosto de 1994"
28,9,21,440,438,489,927,"21 de agosto de 1994"
28,9,21,441,430,501,931,"21 de agosto de 1994"
28,9,21,442,366,404,770,"21 de agosto de 1994"
28,9,21,443,408,493,901,"21 de agosto de 1994"
28,9,21,444,242,277,519,"21 de agosto de 1994"
28,9,21,445,503,545,1048,"21 de agosto de 1994"
28,9,21,446,342,392,734,"21 de agosto de 1994"
28,9,21,447,354,392,746,"21 de agosto de 1994"
28,9,21,448,558,641,1199,"21 de agosto de 1994"
28,9,21,449,478,510,988,"21 de agosto de 1994"
28,9,21,450,525,568,1093,"21 de agosto de 1994"
28,9,21,451,526,648,1174,"21 de agosto de 1994"
28,9,21,452,472,555,1027,"21 de agosto de 1994"
28,9,21,453,341,396,737,"21 de agosto de 1994"
28,9,21,454,197,202,399,"21 de agosto de 1994"
28,9,21,455,534,599,1133,"21 de agosto de 1994"
28,9,21,456,420,509,929,"21 de agosto de 1994"
28,9,21,457,443,497,940,"21 de agosto de 1994"
28,9,21,458,610,621,1231,"21 de agosto de 1994"
28,9,21,459,343,380,723,"21 de agosto de 1994"
28,9,21,460,419,460,879,"21 de agosto de 1994"
28,9,21,461,542,586,1128,"21 de agosto de 1994"
28,9,21,462,367,434,801,"21 de agosto de 1994"
28,9,21,463,106,108,214,"21 de agosto de 1994"
28,9,21,464,254,287,541,"21 de agosto de 1994"
28,9,21,465,298,316,614,"21 de agosto de 1994"
28,9,21,466,346,358,704,"21 de agosto de 1994"
28,9,21,467,262,223,485,"21 de agosto de 1994"
28,9,21,468,558,535,1093,"21 de agosto de 1994"
28,9,21,469,545,542,1087,"21 de agosto de 1994"
28,9,21,470,288,267,555,"21 de agosto de 1994"
28,9,21,471,578,539,1117,"21 de agosto de 1994"
28,9,21,472,335,305,640,"21 de agosto de 1994"
28,9,21,473,223,217,440,"21 de agosto de 1994"
28,9,21,474,202,195,397,"21 de agosto de 1994"
28,9,21,475,264,228,492,"21 de agosto de 1994"
28,9,21,476,322,321,643,"21 de agosto de 1994"
28,9,21,477,274,251,525,"21 de agosto de 1994"
28,9,21,478,489,466,955,"21 de agosto de 1994"
28,9,21,479,305,274,579,"21 de agosto de 1994"
28,9,21,480,310,336,646,"21 de agosto de 1994"
28,9,21,481,112,97,209,"21 de agosto de 1994"
28,9,21,482,310,309,619,"21 de agosto de 1994"
28,9,21,483,478,405,883,"21 de agosto de 1994"
28,9,21,484,255,216,471,"21 de agosto de 1994"
28,9,21,485,299,275,574,"21 de agosto de 1994"
28,9,21,486,59,63,122,"21 de agosto de 1994"
28,9,21,487,233,246,479,"21 de agosto de 1994"
28,9,21,488,314,290,604,"21 de agosto de 1994"
28,9,21,489,275,272,547,"21 de agosto de 1994"
28,9,21,490,291,269,560,"21 de agosto de 1994"
28,9,21,491,295,243,538,"21 de agosto de 1994"
28,9,21,492,296,257,553,"21 de agosto de 1994"
28,9,21,493,263,226,489,"21 de agosto de 1994"
28,9,21,494,181,170,351,"21 de agosto de 1994"
28,9,21,495,202,169,371,"21 de agosto de 1994"
28,9,21,496,409,375,784,"21 de agosto de 1994"
28,9,21,497,201,177,378,"21 de agosto de 1994"
28,9,28,905,409,325,734,"21 de agosto de 1994"
28,9,28,906,318,318,636,"21 de agosto de 1994"
28,9,28,907,140,112,252,"21 de agosto de 1994"
28,9,29,908,472,401,873,"21 de agosto de 1994"
28,9,29,909,405,427,832,"21 de agosto de 1994"
28,9,29,910,552,532,1084,"21 de agosto de 1994"
28,9,29,911,201,191,392,"21 de agosto de 1994"
28,9,29,912,81,72,153,"21 de agosto de 1994"
28,9,29,913,87,64,151,"21 de agosto de 1994"
28,9,29,914,435,339,774,"21 de agosto de 1994"
28,9,29,915,204,186,390,"21 de agosto de 1994"
28,9,29,916,210,176,386,"21 de agosto de 1994"
28,9,29,917,167,159,326,"21 de agosto de 1994"
28,9,29,918,300,265,565,"21 de agosto de 1994"
28,9,29,919,158,119,277,"21 de agosto de 1994"
28,9,29,920,226,179,405,"21 de agosto de 1994"
28,9,29,921,396,332,728,"21 de agosto de 1994"
28,9,43,1719,505,569,1074,"21 de agosto de 1994"
28,9,43,1720,357,363,720,"21 de agosto de 1994"
28,9,43,1721,423,472,895,"21 de agosto de 1994"
28,9,43,1722,404,409,813,"21 de agosto de 1994"
28,9,43,1723,294,357,651,"21 de agosto de 1994"
28,9,43,1724,416,435,851,"21 de agosto de 1994"
28,9,43,1725,233,187,420,"21 de agosto de 1994"
28,9,43,1726,166,113,279,"21 de agosto de 1994"
28,9,43,1727,80,61,141,"21 de agosto de 1994"
28,9,43,1728,175,168,343,"21 de agosto de 1994"
28,9,43,1729,373,334,707,"21 de agosto de 1994"
28,9,43,1730,414,372,786,"21 de agosto de 1994"
28,9,43,1731,172,165,337,"21 de agosto de 1994"
28,9,43,1732,304,251,555,"21 de agosto de 1994"
28,9,43,1733,145,147,292,"21 de agosto de 1994"
28,9,43,1734,159,144,303,"21 de agosto de 1994"
28,9,43,1735,342,344,686,"21 de agosto de 1994"
28,9,43,1736,338,328,666,"21 de agosto de 1994"
28,9,43,1737,664,586,1250,"21 de agosto de 1994"
28,9,43,1738,368,352,720,"21 de agosto de 1994"
28,9,43,1739,144,146,290,"21 de agosto de 1994"
29,1,10,122,430,437,867,"21 de agosto de 1994"
29,1,10,123,404,462,866,"21 de agosto de 1994"
29,1,10,124,466,458,924,"21 de agosto de 1994"
29,1,10,125,463,425,888,"21 de agosto de 1994"
29,1,10,126,404,402,806,"21 de agosto de 1994"
29,1,10,127,570,666,1236,"21 de agosto de 1994"
29,1,10,128,408,492,900,"21 de agosto de 1994"
29,1,10,129,431,474,905,"21 de agosto de 1994"
29,1,10,130,378,426,804,"21 de agosto de 1994"
29,1,10,131,510,574,1084,"21 de agosto de 1994"
29,1,10,132,360,481,841,"21 de agosto de 1994"
29,1,10,133,336,376,712,"21 de agosto de 1994"
29,1,10,134,363,393,756,"21 de agosto de 1994"
29,1,10,135,324,415,739,"21 de agosto de 1994"
29,1,10,136,136,167,303,"21 de agosto de 1994"
29,1,10,137,477,506,983,"21 de agosto de 1994"
29,1,10,138,438,555,993,"21 de agosto de 1994"
29,1,10,139,843,872,1715,"21 de agosto de 1994"
29,1,10,140,329,362,691,"21 de agosto de 1994"
29,1,10,141,836,879,1715,"21 de agosto de 1994"
29,1,10,142,324,332,656,"21 de agosto de 1994"
29,1,10,143,447,502,949,"21 de agosto de 1994"
29,1,10,144,351,383,734,"21 de agosto de 1994"
29,1,10,145,396,388,784,"21 de agosto de 1994"
29,1,10,146,437,441,878,"21 de agosto de 1994"
29,1,10,147,358,344,702,"21 de agosto de 1994"
29,1,10,148,310,320,630,"21 de agosto de 1994"
29,1,10,149,689,732,1421,"21 de agosto de 1994"
29,1,10,150,219,226,445,"21 de agosto de 1994"
29,1,10,151,725,802,1527,"21 de agosto de 1994"
29,1,10,152,505,528,1033,"21 de agosto de 1994"
29,1,10,153,286,294,580,"21 de agosto de 1994"
29,1,10,154,359,379,738,"21 de agosto de 1994"
29,1,10,155,318,385,703,"21 de agosto de 1994"
29,1,10,156,347,364,711,"21 de agosto de 1994"
29,1,10,157,231,260,491,"21 de agosto de 1994"
29,1,10,158,646,750,1396,"21 de agosto de 1994"
29,1,10,159,489,522,1011,"21 de agosto de 1994"
29,1,10,160,566,630,1196,"21 de agosto de 1994"
29,1,15,232,396,412,808,"21 de agosto de 1994"
29,1,15,233,475,495,970,"21 de agosto de 1994"
29,1,15,234,387,423,810,"21 de agosto de 1994"
29,1,15,235,57,49,106,"21 de agosto de 1994"
29,1,15,236,83,85,168,"21 de agosto de 1994"
29,1,15,237,124,116,240,"21 de agosto de 1994"
29,1,15,238,88,108,196,"21 de agosto de 1994"
29,1,15,239,144,137,281,"21 de agosto de 1994"
29,1,15,240,225,202,427,"21 de agosto de 1994"
29,1,15,241,468,430,898,"21 de agosto de 1994"
29,1,15,242,393,372,765,"21 de agosto de 1994"
29,1,15,243,89,88,177,"21 de agosto de 1994"
29,1,15,244,144,154,298,"21 de agosto de 1994"
29,1,15,245,644,632,1276,"21 de agosto de 1994"
29,1,15,246,188,180,368,"21 de agosto de 1994"
29,1,15,247,443,498,941,"21 de agosto de 1994"
29,1,15,248,327,353,680,"21 de agosto de 1994"
29,1,15,249,137,151,288,"21 de agosto de 1994"
29,1,15,250,256,260,516,"21 de agosto de 1994"
29,1,15,251,737,784,1521,"21 de agosto de 1994"
29,1,15,252,399,454,853,"21 de agosto de 1994"
29,1,15,253,457,505,962,"21 de agosto de 1994"
29,1,15,254,675,681,1356,"21 de agosto de 1994"
29,1,15,255,749,726,1475,"21 de agosto de 1994"
29,1,15,256,380,452,832,"21 de agosto de 1994"
29,1,15,257,221,255,476,"21 de agosto de 1994"
29,1,15,258,135,143,278,"21 de agosto de 1994"
29,1,17,263,423,442,865,"21 de agosto de 1994"
29,1,17,264,399,384,783,"21 de agosto de 1994"
29,1,17,265,379,387,766,"21 de agosto de 1994"
29,1,17,266,474,440,914,"21 de agosto de 1994"
29,1,19,284,338,386,724,"21 de agosto de 1994"
29,1,19,285,464,515,979,"21 de agosto de 1994"
29,1,19,286,648,724,1372,"21 de agosto de 1994"
29,1,19,287,401,426,827,"21 de agosto de 1994"
29,1,19,288,445,427,872,"21 de agosto de 1994"
29,1,19,289,415,457,872,"21 de agosto de 1994"
29,1,19,290,489,512,1001,"21 de agosto de 1994"
29,1,19,291,94,92,186,"21 de agosto de 1994"
29,1,22,309,277,309,586,"21 de agosto de 1994"
29,1,22,310,301,281,582,"21 de agosto de 1994"
29,1,22,311,202,206,408,"21 de agosto de 1994"
29,1,22,312,119,99,218,"21 de agosto de 1994"
29,1,22,313,417,471,888,"21 de agosto de 1994"
29,1,22,314,341,347,688,"21 de agosto de 1994"
29,1,22,315,297,282,579,"21 de agosto de 1994"
29,1,23,316,387,393,780,"21 de agosto de 1994"
29,1,23,317,478,573,1051,"21 de agosto de 1994"
29,1,23,318,255,299,554,"21 de agosto de 1994"
29,1,23,319,658,749,1407,"21 de agosto de 1994"
29,1,23,320,176,175,351,"21 de agosto de 1994"
29,1,23,321,167,176,343,"21 de agosto de 1994"
29,1,23,322,274,286,560,"21 de agosto de 1994"
29,1,23,323,494,540,1034,"21 de agosto de 1994"
29,1,23,324,167,186,353,"21 de agosto de 1994"
29,1,23,325,343,417,760,"21 de agosto de 1994"
29,1,23,326,567,582,1149,"21 de agosto de 1994"
29,1,23,327,471,474,945,"21 de agosto de 1994"
29,1,23,328,263,245,508,"21 de agosto de 1994"
29,1,23,329,382,400,782,"21 de agosto de 1994"
29,1,23,330,296,284,580,"21 de agosto de 1994"
29,1,23,331,233,246,479,"21 de agosto de 1994"
29,1,24,332,585,21,606,"21 de agosto de 1994"
29,1,24,333,89,81,170,"21 de agosto de 1994"
29,1,24,334,322,391,713,"21 de agosto de 1994"
29,1,24,335,198,246,444,"21 de agosto de 1994"
29,1,24,336,550,628,1178,"21 de agosto de 1994"
29,1,24,337,530,681,1211,"21 de agosto de 1994"
29,1,24,338,557,557,1114,"21 de agosto de 1994"
29,1,24,339,312,316,628,"21 de agosto de 1994"
29,1,24,340,272,265,537,"21 de agosto de 1994"
29,1,24,341,38,38,76,"21 de agosto de 1994"
29,1,24,342,465,475,940,"21 de agosto de 1994"
29,1,24,343,166,203,369,"21 de agosto de 1994"
29,1,24,344,151,172,323,"21 de agosto de 1994"
29,1,24,345,386,437,823,"21 de agosto de 1994"
29,1,24,346,493,555,1048,"21 de agosto de 1994"
29,1,24,347,436,471,907,"21 de agosto de 1994"
29,1,25,348,764,795,1559,"21 de agosto de 1994"
29,1,25,349,696,707,1403,"21 de agosto de 1994"
29,1,25,350,908,885,1793,"21 de agosto de 1994"
29,1,25,351,641,647,1288,"21 de agosto de 1994"
29,1,25,352,551,537,1088,"21 de agosto de 1994"
29,1,25,353,624,639,1263,"21 de agosto de 1994"
29,1,25,354,854,817,1671,"21 de agosto de 1994"
29,1,25,355,622,654,1276,"21 de agosto de 1994"
29,1,25,356,766,793,1559,"21 de agosto de 1994"
29,1,25,357,725,736,1461,"21 de agosto de 1994"
29,1,25,358,611,648,1259,"21 de agosto de 1994"
29,1,25,359,438,476,914,"21 de agosto de 1994"
29,1,25,360,494,532,1026,"21 de agosto de 1994"
29,1,25,361,630,690,1320,"21 de agosto de 1994"
29,1,25,362,643,693,1336,"21 de agosto de 1994"
29,1,25,363,465,515,980,"21 de agosto de 1994"
29,1,25,364,436,491,927,"21 de agosto de 1994"
29,1,27,372,390,481,871,"21 de agosto de 1994"
29,1,27,373,356,407,763,"21 de agosto de 1994"
29,1,27,374,256,263,519,"21 de agosto de 1994"
29,1,27,375,548,586,1134,"21 de agosto de 1994"
29,1,27,376,320,389,709,"21 de agosto de 1994"
29,1,27,377,561,565,1126,"21 de agosto de 1994"
29,1,28,378,400,452,852,"21 de agosto de 1994"
29,1,28,379,413,427,840,"21 de agosto de 1994"
29,1,28,380,722,753,1475,"21 de agosto de 1994"
29,1,28,381,433,435,868,"21 de agosto de 1994"
29,1,28,382,328,358,686,"21 de agosto de 1994"
29,1,28,383,334,369,703,"21 de agosto de 1994"
29,1,28,384,332,385,717,"21 de agosto de 1994"
29,1,28,385,70,64,134,"21 de agosto de 1994"
29,1,28,386,534,601,1135,"21 de agosto de 1994"
29,1,29,387,453,512,965,"21 de agosto de 1994"
29,1,29,388,356,384,740,"21 de agosto de 1994"
29,1,29,389,73,75,148,"21 de agosto de 1994"
29,1,29,390,222,246,468,"21 de agosto de 1994"
29,1,29,391,396,400,796,"21 de agosto de 1994"
29,1,29,392,252,253,505,"21 de agosto de 1994"
29,1,29,393,167,189,356,"21 de agosto de 1994"
29,1,29,394,437,486,923,"21 de agosto de 1994"
29,1,29,395,634,684,1318,"21 de agosto de 1994"
29,1,29,396,588,618,1206,"21 de agosto de 1994"
29,1,29,397,456,483,939,"21 de agosto de 1994"
29,1,32,424,331,291,622,"21 de agosto de 1994"
29,1,32,425,400,383,783,"21 de agosto de 1994"
29,1,32,426,450,410,860,"21 de agosto de 1994"
29,1,32,427,523,521,1044,"21 de agosto de 1994"
29,1,32,428,405,423,828,"21 de agosto de 1994"
29,1,32,429,533,500,1033,"21 de agosto de 1994"
29,1,32,430,517,505,1022,"21 de agosto de 1994"
29,1,32,431,306,311,617,"21 de agosto de 1994"
29,1,32,432,323,415,738,"21 de agosto de 1994"
29,1,32,433,387,498,885,"21 de agosto de 1994"
29,1,32,434,156,155,311,"21 de agosto de 1994"
29,1,33,435,362,376,738,"21 de agosto de 1994"
29,1,33,436,337,365,702,"21 de agosto de 1994"
29,1,33,437,230,301,531,"21 de agosto de 1994"
29,1,33,438,392,441,833,"21 de agosto de 1994"
29,1,33,439,434,458,892,"21 de agosto de 1994"
29,1,33,440,337,412,749,"21 de agosto de 1994"
29,1,33,441,461,609,1070,"21 de agosto de 1994"
29,1,33,442,432,473,905,"21 de agosto de 1994"
29,1,33,443,333,360,693,"21 de agosto de 1994"
29,1,33,444,551,685,1236,"21 de agosto de 1994"
29,1,33,445,418,474,892,"21 de agosto de 1994"
29,1,33,446,347,432,779,"21 de agosto de 1994"
29,1,33,447,361,427,788,"21 de agosto de 1994"
29,1,33,448,501,554,1055,"21 de agosto de 1994"
29,1,33,449,458,585,1043,"21 de agosto de 1994"
29,1,33,450,337,418,755,"21 de agosto de 1994"
29,1,33,451,497,606,1103,"21 de agosto de 1994"
29,1,33,452,323,399,722,"21 de agosto de 1994"
29,1,33,453,661,762,1423,"21 de agosto de 1994"
29,1,33,454,305,358,663,"21 de agosto de 1994"
29,1,33,455,229,300,529,"21 de agosto de 1994"
29,1,33,456,436,493,929,"21 de agosto de 1994"
29,1,33,457,394,539,933,"21 de agosto de 1994"
29,1,33,458,605,608,1213,"21 de agosto de 1994"
29,1,33,459,343,457,800,"21 de agosto de 1994"
29,1,33,460,452,509,961,"21 de agosto de 1994"
29,1,33,461,541,640,1181,"21 de agosto de 1994"
29,1,33,462,224,256,480,"21 de agosto de 1994"
29,1,33,463,392,494,886,"21 de agosto de 1994"
29,1,33,464,423,497,920,"21 de agosto de 1994"
29,1,33,465,567,632,1199,"21 de agosto de 1994"
29,1,33,466,717,785,1502,"21 de agosto de 1994"
29,1,33,467,327,360,687,"21 de agosto de 1994"
29,1,33,468,448,468,916,"21 de agosto de 1994"
29,1,33,469,348,394,742,"21 de agosto de 1994"
29,1,36,508,184,223,407,"21 de agosto de 1994"
29,1,36,509,248,265,513,"21 de agosto de 1994"
29,1,36,510,247,236,483,"21 de agosto de 1994"
29,1,36,511,188,229,417,"21 de agosto de 1994"
29,1,36,512,309,336,645,"21 de agosto de 1994"
29,1,36,513,538,602,1140,"21 de agosto de 1994"
29,1,36,514,344,391,735,"21 de agosto de 1994"
29,1,36,515,432,511,943,"21 de agosto de 1994"
29,1,36,516,473,539,1012,"21 de agosto de 1994"
29,1,36,517,243,269,512,"21 de agosto de 1994"
29,1,36,518,276,327,603,"21 de agosto de 1994"
29,1,36,519,205,261,466,"21 de agosto de 1994"
29,1,41,558,652,697,1349,"21 de agosto de 1994"
29,1,41,559,563,605,1168,"21 de agosto de 1994"
29,1,41,560,561,594,1155,"21 de agosto de 1994"
29,1,41,561,653,711,1364,"21 de agosto de 1994"
29,1,41,562,495,502,997,"21 de agosto de 1994"
29,1,41,563,435,556,991,"21 de agosto de 1994"
29,1,41,564,485,528,1013,"21 de agosto de 1994"
29,1,41,565,251,256,507,"21 de agosto de 1994"
29,1,41,566,277,284,561,"21 de agosto de 1994"
29,1,41,567,240,243,483,"21 de agosto de 1994"
29,1,41,568,183,176,359,"21 de agosto de 1994"
29,1,41,569,100,101,201,"21 de agosto de 1994"
29,1,42,570,672,758,1430,"21 de agosto de 1994"
29,1,42,571,493,556,1049,"21 de agosto de 1994"
29,1,42,572,392,422,814,"21 de agosto de 1994"
29,1,42,573,563,625,1188,"21 de agosto de 1994"
29,1,42,574,463,514,977,"21 de agosto de 1994"
29,1,44,586,423,467,890,"21 de agosto de 1994"
29,1,44,587,416,438,854,"21 de agosto de 1994"
29,1,44,588,296,315,611,"21 de agosto de 1994"
29,1,44,589,428,462,890,"21 de agosto de 1994"
29,1,44,590,598,675,1273,"21 de agosto de 1994"
29,1,44,591,781,840,1621,"21 de agosto de 1994"
29,1,44,592,579,656,1235,"21 de agosto de 1994"
29,1,44,593,692,780,1472,"21 de agosto de 1994"
29,1,44,594,365,395,760,"21 de agosto de 1994"
29,1,44,595,574,598,1172,"21 de agosto de 1994"
29,1,44,596,369,419,788,"21 de agosto de 1994"
29,1,44,597,497,535,1032,"21 de agosto de 1994"
29,1,44,598,477,524,1001,"21 de agosto de 1994"
29,1,44,599,497,535,1032,"21 de agosto de 1994"
29,1,44,600,572,675,1247,"21 de agosto de 1994"
29,1,44,601,614,675,1289,"21 de agosto de 1994"
29,1,44,602,390,425,815,"21 de agosto de 1994"
29,1,44,603,217,243,460,"21 de agosto de 1994"
29,1,44,604,646,718,1364,"21 de agosto de 1994"
29,1,44,605,265,285,550,"21 de agosto de 1994"
29,2,1,1,220,234,454,"21 de agosto de 1994"
29,2,1,2,711,747,1458,"21 de agosto de 1994"
29,2,1,3,765,771,1536,"21 de agosto de 1994"
29,2,1,4,130,126,256,"21 de agosto de 1994"
29,2,2,5,553,597,1150,"21 de agosto de 1994"
29,2,2,6,298,327,625,"21 de agosto de 1994"
29,2,2,7,120,154,274,"21 de agosto de 1994"
29,2,2,8,595,729,1324,"21 de agosto de 1994"
29,2,2,9,496,534,1030,"21 de agosto de 1994"
29,2,2,10,535,630,1165,"21 de agosto de 1994"
29,2,2,11,197,220,417,"21 de agosto de 1994"
29,2,3,12,497,580,1077,"21 de agosto de 1994"
29,2,3,13,486,576,1062,"21 de agosto de 1994"
29,2,3,14,484,536,1020,"21 de agosto de 1994"
29,2,3,15,380,449,829,"21 de agosto de 1994"
29,2,3,16,338,395,733,"21 de agosto de 1994"
29,2,3,17,593,762,1355,"21 de agosto de 1994"
29,2,3,18,544,616,1160,"21 de agosto de 1994"
29,2,3,19,493,567,1060,"21 de agosto de 1994"
29,2,3,20,200,231,431,"21 de agosto de 1994"
29,2,3,21,121,140,261,"21 de agosto de 1994"
29,2,3,22,586,728,1314,"21 de agosto de 1994"
29,2,3,23,315,367,682,"21 de agosto de 1994"
29,2,3,24,381,469,850,"21 de agosto de 1994"
29,2,3,25,493,562,1055,"21 de agosto de 1994"
29,2,3,26,450,514,964,"21 de agosto de 1994"
29,2,3,27,632,717,1349,"21 de agosto de 1994"
29,2,3,28,679,803,1482,"21 de agosto de 1994"
29,2,3,29,614,752,1366,"21 de agosto de 1994"
29,2,3,30,408,486,894,"21 de agosto de 1994"
29,2,3,31,529,594,1123,"21 de agosto de 1994"
29,2,3,32,533,651,1184,"21 de agosto de 1994"
29,2,3,33,449,481,930,"21 de agosto de 1994"
29,2,3,34,468,554,1022,"21 de agosto de 1994"
29,2,3,35,378,449,827,"21 de agosto de 1994"
29,2,3,36,479,534,1013,"21 de agosto de 1994"
29,2,3,37,384,441,825,"21 de agosto de 1994"
29,2,3,38,231,219,450,"21 de agosto de 1994"
29,2,3,39,200,197,397,"21 de agosto de 1994"
29,2,3,40,623,621,1244,"21 de agosto de 1994"
29,2,3,41,620,624,1244,"21 de agosto de 1994"
29,2,3,42,83,85,168,"21 de agosto de 1994"
29,2,3,43,351,366,717,"21 de agosto de 1994"
29,2,3,44,328,321,649,"21 de agosto de 1994"
29,2,3,45,41,44,85,"21 de agosto de 1994"
29,2,3,46,268,275,543,"21 de agosto de 1994"
29,2,3,47,178,198,376,"21 de agosto de 1994"
29,2,3,48,154,161,315,"21 de agosto de 1994"
29,2,4,49,181,200,381,"21 de agosto de 1994"
29,2,4,50,83,80,163,"21 de agosto de 1994"
29,2,4,51,69,60,129,"21 de agosto de 1994"
29,2,4,52,27,25,52,"21 de agosto de 1994"
29,2,4,53,297,292,589,"21 de agosto de 1994"
29,2,4,54,93,106,199,"21 de agosto de 1994"
29,2,4,55,77,80,157,"21 de agosto de 1994"
29,2,4,56,262,283,545,"21 de agosto de 1994"
29,2,4,57,84,95,179,"21 de agosto de 1994"
29,2,4,58,7,10,17,"21 de agosto de 1994"
29,2,5,59,309,313,622,"21 de agosto de 1994"
29,2,5,60,173,174,347,"21 de agosto de 1994"
29,2,5,61,190,170,360,"21 de agosto de 1994"
29,2,5,62,98,93,191,"21 de agosto de 1994"
29,2,5,63,89,93,182,"21 de agosto de 1994"
29,2,5,64,89,69,158,"21 de agosto de 1994"
29,2,5,65,77,74,151,"21 de agosto de 1994"
29,2,5,66,136,130,266,"21 de agosto de 1994"
29,2,5,67,73,70,143,"21 de agosto de 1994"
29,2,5,68,475,467,942,"21 de agosto de 1994"
29,2,5,69,229,244,473,"21 de agosto de 1994"
29,2,5,70,167,154,321,"21 de agosto de 1994"
29,2,5,71,248,225,473,"21 de agosto de 1994"
29,2,5,72,170,156,326,"21 de agosto de 1994"
29,2,5,73,66,47,113,"21 de agosto de 1994"
29,2,5,74,242,232,474,"21 de agosto de 1994"
29,2,5,75,83,72,155,"21 de agosto de 1994"
29,2,5,76,76,60,136,"21 de agosto de 1994"
29,2,5,77,337,350,687,"21 de agosto de 1994"
29,2,6,78,645,739,1384,"21 de agosto de 1994"
29,2,6,79,644,743,1387,"21 de agosto de 1994"
29,2,6,80,542,600,1142,"21 de agosto de 1994"
29,2,6,81,486,542,1028,"21 de agosto de 1994"
29,2,6,82,330,391,721,"21 de agosto de 1994"
29,2,6,83,696,802,1498,"21 de agosto de 1994"
29,2,6,84,314,376,690,"21 de agosto de 1994"
29,2,6,85,593,686,1279,"21 de agosto de 1994"
29,2,6,86,401,446,847,"21 de agosto de 1994"
29,2,6,87,351,391,742,"21 de agosto de 1994"
29,2,6,88,507,568,1075,"21 de agosto de 1994"
29,2,6,89,510,527,1037,"21 de agosto de 1994"
29,2,6,90,319,355,674,"21 de agosto de 1994"
29,2,6,91,195,201,396,"21 de agosto de 1994"
29,2,6,92,455,459,914,"21 de agosto de 1994"
29,2,6,93,364,345,709,"21 de agosto de 1994"
29,2,6,94,281,311,592,"21 de agosto de 1994"
29,2,6,95,118,100,218,"21 de agosto de 1994"
29,2,6,96,130,135,265,"21 de agosto de 1994"
29,2,6,97,216,204,420,"21 de agosto de 1994"
29,2,6,98,428,435,863,"21 de agosto de 1994"
29,2,6,99,27,26,53,"21 de agosto de 1994"
29,2,7,100,581,635,1216,"21 de agosto de 1994"
29,2,7,101,577,656,1233,"21 de agosto de 1994"
29,2,7,102,600,627,1227,"21 de agosto de 1994"
29,2,7,103,291,260,551,"21 de agosto de 1994"
29,2,7,104,284,308,592,"21 de agosto de 1994"
29,2,7,105,90,89,179,"21 de agosto de 1994"
29,2,7,106,44,46,90,"21 de agosto de 1994"
29,2,8,107,590,627,1217,"21 de agosto de 1994"
29,2,8,108,372,391,763,"21 de agosto de 1994"
29,2,8,109,515,523,1038,"21 de agosto de 1994"
29,2,8,110,346,323,669,"21 de agosto de 1994"
29,2,8,111,61,52,113,"21 de agosto de 1994"
29,2,8,112,35,30,65,"21 de agosto de 1994"
29,2,8,113,70,70,140,"21 de agosto de 1994"
29,2,8,114,181,160,341,"21 de agosto de 1994"
29,2,8,115,93,84,177,"21 de agosto de 1994"
29,2,8,116,87,79,166,"21 de agosto de 1994"
29,2,9,117,325,336,661,"21 de agosto de 1994"
29,2,9,118,270,271,541,"21 de agosto de 1994"
29,2,9,119,118,115,233,"21 de agosto de 1994"
29,2,9,120,51,55,106,"21 de agosto de 1994"
29,2,9,121,252,256,508,"21 de agosto de 1994"
29,2,11,161,461,475,936,"21 de agosto de 1994"
29,2,11,162,279,272,551,"21 de agosto de 1994"
29,2,11,163,104,107,211,"21 de agosto de 1994"
29,2,11,164,53,51,104,"21 de agosto de 1994"
29,2,12,165,513,505,1018,"21 de agosto de 1994"
29,2,12,166,35,23,58,"21 de agosto de 1994"
29,2,12,167,108,90,198,"21 de agosto de 1994"
29,2,12,168,197,170,367,"21 de agosto de 1994"
29,2,12,169,66,62,128,"21 de agosto de 1994"
29,2,12,170,258,217,475,"21 de agosto de 1994"
29,2,12,171,81,76,157,"21 de agosto de 1994"
29,2,12,172,101,68,169,"21 de agosto de 1994"
29,2,12,173,91,62,153,"21 de agosto de 1994"
29,2,12,174,55,49,104,"21 de agosto de 1994"
29,2,12,175,145,147,292,"21 de agosto de 1994"
29,2,12,176,142,147,289,"21 de agosto de 1994"
29,2,12,177,97,88,185,"21 de agosto de 1994"
29,2,13,178,706,821,1527,"21 de agosto de 1994"
29,2,13,179,621,743,1364,"21 de agosto de 1994"
29,2,13,180,444,451,895,"21 de agosto de 1994"
29,2,13,181,725,813,1538,"21 de agosto de 1994"
29,2,13,182,383,449,832,"21 de agosto de 1994"
29,2,13,183,246,335,581,"21 de agosto de 1994"
29,2,13,184,224,236,460,"21 de agosto de 1994"
29,2,13,185,436,495,931,"21 de agosto de 1994"
29,2,13,186,507,629,1136,"21 de agosto de 1994"
29,2,13,187,699,805,1504,"21 de agosto de 1994"
29,2,13,188,490,529,1019,"21 de agosto de 1994"
29,2,13,189,639,737,1376,"21 de agosto de 1994"
29,2,13,190,404,416,820,"21 de agosto de 1994"
29,2,13,191,378,459,837,"21 de agosto de 1994"
29,2,13,192,528,560,1088,"21 de agosto de 1994"
29,2,13,193,148,150,298,"21 de agosto de 1994"
29,2,13,194,522,590,1112,"21 de agosto de 1994"
29,2,13,195,328,348,676,"21 de agosto de 1994"
29,2,13,196,276,239,515,"21 de agosto de 1994"
29,2,13,197,57,58,115,"21 de agosto de 1994"
29,2,13,198,132,112,244,"21 de agosto de 1994"
29,2,13,199,118,139,257,"21 de agosto de 1994"
29,2,13,200,376,368,744,"21 de agosto de 1994"
29,2,13,201,676,688,1364,"21 de agosto de 1994"
29,2,13,202,114,125,239,"21 de agosto de 1994"
29,2,13,203,520,516,1036,"21 de agosto de 1994"
29,2,13,204,307,321,628,"21 de agosto de 1994"
29,2,13,205,50,49,99,"21 de agosto de 1994"
29,2,13,206,201,181,382,"21 de agosto de 1994"
29,2,13,207,183,179,362,"21 de agosto de 1994"
29,2,13,208,175,176,351,"21 de agosto de 1994"
29,2,13,209,163,209,372,"21 de agosto de 1994"
29,2,13,210,42,37,79,"21 de agosto de 1994"
29,2,13,211,240,236,476,"21 de agosto de 1994"
29,2,13,212,102,102,204,"21 de agosto de 1994"
29,2,13,213,574,619,1193,"21 de agosto de 1994"
29,2,13,214,421,453,874,"21 de agosto de 1994"
29,2,13,215,50,51,101,"21 de agosto de 1994"
29,2,13,216,177,186,363,"21 de agosto de 1994"
29,2,13,217,124,142,266,"21 de agosto de 1994"
29,2,13,218,111,116,227,"21 de agosto de 1994"
29,2,13,219,194,217,411,"21 de agosto de 1994"
29,2,14,220,501,509,1010,"21 de agosto de 1994"
29,2,14,221,586,601,1187,"21 de agosto de 1994"
29,2,14,222,257,229,486,"21 de agosto de 1994"
29,2,14,223,99,100,199,"21 de agosto de 1994"
29,2,14,224,181,170,351,"21 de agosto de 1994"
29,2,14,225,82,73,155,"21 de agosto de 1994"
29,2,14,226,134,130,264,"21 de agosto de 1994"
29,2,14,227,169,162,331,"21 de agosto de 1994"
29,2,14,228,761,799,1560,"21 de agosto de 1994"
29,2,14,229,37,34,71,"21 de agosto de 1994"
29,2,14,230,200,223,423,"21 de agosto de 1994"
29,2,14,231,91,81,172,"21 de agosto de 1994"
29,2,16,259,425,444,869,"21 de agosto de 1994"
29,2,16,260,375,401,776,"21 de agosto de 1994"
29,2,16,261,470,494,964,"21 de agosto de 1994"
29,2,16,262,224,253,477,"21 de agosto de 1994"
29,2,18,267,447,448,895,"21 de agosto de 1994"
29,2,18,268,485,490,975,"21 de agosto de 1994"
29,2,18,269,484,424,908,"21 de agosto de 1994"
29,2,18,270,219,206,425,"21 de agosto de 1994"
29,2,18,271,475,478,953,"21 de agosto de 1994"
29,2,18,272,773,726,1499,"21 de agosto de 1994"
29,2,18,273,511,518,1029,"21 de agosto de 1994"
29,2,18,274,284,281,565,"21 de agosto de 1994"
29,2,18,275,357,350,707,"21 de agosto de 1994"
29,2,18,276,382,385,767,"21 de agosto de 1994"
29,2,18,277,87,82,169,"21 de agosto de 1994"
29,2,18,278,124,126,250,"21 de agosto de 1994"
29,2,18,279,463,390,853,"21 de agosto de 1994"
29,2,18,280,103,112,215,"21 de agosto de 1994"
29,2,18,281,455,357,812,"21 de agosto de 1994"
29,2,18,282,94,87,181,"21 de agosto de 1994"
29,2,18,283,329,323,652,"21 de agosto de 1994"
29,2,20,292,357,382,739,"21 de agosto de 1994"
29,2,20,293,375,387,762,"21 de agosto de 1994"
29,2,20,294,395,367,762,"21 de agosto de 1994"
29,2,20,295,615,629,1244,"21 de agosto de 1994"
29,2,20,296,481,474,955,"21 de agosto de 1994"
29,2,20,297,411,419,830,"21 de agosto de 1994"
29,2,20,298,187,208,395,"21 de agosto de 1994"
29,2,21,299,616,671,1287,"21 de agosto de 1994"
29,2,21,300,496,520,1016,"21 de agosto de 1994"
29,2,21,301,732,810,1542,"21 de agosto de 1994"
29,2,21,302,740,727,1467,"21 de agosto de 1994"
29,2,21,303,318,422,740,"21 de agosto de 1994"
29,2,21,304,317,297,614,"21 de agosto de 1994"
29,2,21,305,98,101,199,"21 de agosto de 1994"
29,2,21,306,24,27,51,"21 de agosto de 1994"
29,2,21,307,132,142,274,"21 de agosto de 1994"
29,2,21,308,326,293,619,"21 de agosto de 1994"
29,2,26,365,185,204,389,"21 de agosto de 1994"
29,2,26,366,510,513,1023,"21 de agosto de 1994"
29,2,26,367,629,700,1329,"21 de agosto de 1994"
29,2,26,368,452,490,942,"21 de agosto de 1994"
29,2,26,369,413,449,862,"21 de agosto de 1994"
29,2,26,370,163,167,330,"21 de agosto de 1994"
29,2,26,371,587,611,1198,"21 de agosto de 1994"
29,2,30,398,532,498,1030,"21 de agosto de 1994"
29,2,30,399,369,353,722,"21 de agosto de 1994"
29,2,30,400,177,145,322,"21 de agosto de 1994"
29,2,30,401,557,533,1090,"21 de agosto de 1994"
29,2,30,402,513,467,980,"21 de agosto de 1994"
29,2,30,403,345,301,646,"21 de agosto de 1994"
29,2,30,404,614,554,1168,"21 de agosto de 1994"
29,2,30,405,49,50,99,"21 de agosto de 1994"
29,2,30,406,118,106,224,"21 de agosto de 1994"
29,2,30,407,169,158,327,"21 de agosto de 1994"
29,2,30,408,295,270,565,"21 de agosto de 1994"
29,2,31,409,216,234,450,"21 de agosto de 1994"
29,2,31,410,300,311,611,"21 de agosto de 1994"
29,2,31,411,424,426,850,"21 de agosto de 1994"
29,2,31,412,392,453,845,"21 de agosto de 1994"
29,2,31,413,297,329,626,"21 de agosto de 1994"
29,2,31,414,322,390,712,"21 de agosto de 1994"
29,2,31,415,292,368,660,"21 de agosto de 1994"
29,2,31,416,306,276,582,"21 de agosto de 1994"
29,2,31,417,63,58,121,"21 de agosto de 1994"
29,2,31,418,64,60,124,"21 de agosto de 1994"
29,2,31,419,143,113,256,"21 de agosto de 1994"
29,2,31,420,432,462,894,"21 de agosto de 1994"
29,2,31,421,435,444,879,"21 de agosto de 1994"
29,2,31,422,524,556,1080,"21 de agosto de 1994"
29,2,31,423,56,48,104,"21 de agosto de 1994"
29,2,34,470,228,273,501,"21 de agosto de 1994"
29,2,34,471,267,285,552,"21 de agosto de 1994"
29,2,34,472,218,259,477,"21 de agosto de 1994"
29,2,34,473,185,236,421,"21 de agosto de 1994"
29,2,34,474,218,240,458,"21 de agosto de 1994"
29,2,34,475,448,534,982,"21 de agosto de 1994"
29,2,34,476,356,381,737,"21 de agosto de 1994"
29,2,34,477,377,445,822,"21 de agosto de 1994"
29,2,34,478,80,100,180,"21 de agosto de 1994"
29,2,34,479,76,72,148,"21 de agosto de 1994"
29,2,34,480,67,51,118,"21 de agosto de 1994"
29,2,34,481,559,652,1211,"21 de agosto de 1994"
29,2,34,482,388,371,759,"21 de agosto de 1994"
29,2,34,483,27,23,50,"21 de agosto de 1994"
29,2,34,484,316,306,622,"21 de agosto de 1994"
29,2,34,485,190,177,367,"21 de agosto de 1994"
29,2,34,486,155,163,318,"21 de agosto de 1994"
29,2,34,487,429,43,472,"21 de agosto de 1994"
29,2,34,488,314,296,610,"21 de agosto de 1994"
29,2,34,489,37,37,74,"21 de agosto de 1994"
29,2,34,490,66,54,120,"21 de agosto de 1994"
29,2,34,491,677,660,1337,"21 de agosto de 1994"
29,2,34,492,71,69,140,"21 de agosto de 1994"
29,2,34,493,131,133,264,"21 de agosto de 1994"
29,2,34,494,194,206,400,"21 de agosto de 1994"
29,2,34,495,226,228,454,"21 de agosto de 1994"
29,2,34,496,156,167,323,"21 de agosto de 1994"
29,2,34,497,148,124,272,"21 de agosto de 1994"
29,2,34,498,87,68,155,"21 de agosto de 1994"
29,2,34,499,189,197,386,"21 de agosto de 1994"
29,2,34,500,130,142,272,"21 de agosto de 1994"
29,2,34,501,390,385,775,"21 de agosto de 1994"
29,2,34,502,79,81,160,"21 de agosto de 1994"
29,2,34,503,28,26,54,"21 de agosto de 1994"
29,2,34,504,57,44,101,"21 de agosto de 1994"
29,2,35,505,632,633,1265,"21 de agosto de 1994"
29,2,35,506,301,294,595,"21 de agosto de 1994"
29,2,35,507,171,172,343,"21 de agosto de 1994"
29,2,37,520,411,461,872,"21 de agosto de 1994"
29,2,37,521,315,324,639,"21 de agosto de 1994"
29,2,37,522,406,454,860,"21 de agosto de 1994"
29,2,37,523,455,552,1007,"21 de agosto de 1994"
29,2,37,524,131,143,274,"21 de agosto de 1994"
29,2,37,525,216,226,442,"21 de agosto de 1994"
29,2,37,526,14,11,25,"21 de agosto de 1994"
29,2,38,527,520,547,1067,"21 de agosto de 1994"
29,2,38,528,456,507,963,"21 de agosto de 1994"
29,2,38,529,369,389,758,"21 de agosto de 1994"
29,2,38,530,275,268,543,"21 de agosto de 1994"
29,2,38,531,262,279,541,"21 de agosto de 1994"
29,2,38,532,184,187,371,"21 de agosto de 1994"
29,2,38,533,209,185,394,"21 de agosto de 1994"
29,2,38,534,283,301,584,"21 de agosto de 1994"
29,2,38,535,139,153,292,"21 de agosto de 1994"
29,2,38,536,161,155,316,"21 de agosto de 1994"
29,2,38,537,73,84,157,"21 de agosto de 1994"
29,2,39,538,459,434,893,"21 de agosto de 1994"
29,2,39,539,555,573,1128,"21 de agosto de 1994"
29,2,39,540,709,740,1449,"21 de agosto de 1994"
29,2,39,541,593,621,1214,"21 de agosto de 1994"
29,2,39,542,552,600,1152,"21 de agosto de 1994"
29,2,39,543,500,544,1044,"21 de agosto de 1994"
29,2,39,544,146,155,301,"21 de agosto de 1994"
29,2,39,545,43,45,88,"21 de agosto de 1994"
29,2,39,546,162,165,327,"21 de agosto de 1994"
29,2,40,547,220,228,448,"21 de agosto de 1994"
29,2,40,548,466,523,989,"21 de agosto de 1994"
29,2,40,549,353,361,714,"21 de agosto de 1994"
29,2,40,550,247,254,501,"21 de agosto de 1994"
29,2,40,551,398,398,796,"21 de agosto de 1994"
29,2,40,552,227,225,452,"21 de agosto de 1994"
29,2,40,553,66,64,130,"21 de agosto de 1994"
29,2,40,554,41,50,91,"21 de agosto de 1994"
29,2,40,555,187,209,396,"21 de agosto de 1994"
29,2,40,556,195,184,379,"21 de agosto de 1994"
29,2,40,557,165,201,366,"21 de agosto de 1994"
29,2,43,575,521,535,1056,"21 de agosto de 1994"
29,2,43,576,387,424,811,"21 de agosto de 1994"
29,2,43,577,182,188,370,"21 de agosto de 1994"
29,2,43,578,254,250,504,"21 de agosto de 1994"
29,2,43,579,273,298,571,"21 de agosto de 1994"
29,2,43,580,154,168,322,"21 de agosto de 1994"
29,2,43,581,494,548,1042,"21 de agosto de 1994"
29,2,43,582,550,518,1068,"21 de agosto de 1994"
29,2,43,583,261,303,564,"21 de agosto de 1994"
29,2,43,584,178,180,358,"21 de agosto de 1994"
29,2,43,585,602,622,1224,"21 de agosto de 1994"
30,1,15,320,362,399,761,"21 de agosto de 1994"
30,1,15,321,492,589,1081,"21 de agosto de 1994"
30,1,15,322,414,494,908,"21 de agosto de 1994"
30,1,15,323,424,472,896,"21 de agosto de 1994"
30,1,15,324,303,347,650,"21 de agosto de 1994"
30,1,15,325,529,622,1151,"21 de agosto de 1994"
30,1,15,326,302,347,649,"21 de agosto de 1994"
30,1,15,327,319,360,679,"21 de agosto de 1994"
30,1,15,328,642,766,1408,"21 de agosto de 1994"
30,1,15,329,570,672,1242,"21 de agosto de 1994"
30,1,15,330,480,542,1022,"21 de agosto de 1994"
30,1,15,331,357,407,764,"21 de agosto de 1994"
30,1,15,332,337,333,670,"21 de agosto de 1994"
30,1,15,333,322,340,662,"21 de agosto de 1994"
30,1,15,334,325,318,643,"21 de agosto de 1994"
30,1,15,335,278,275,553,"21 de agosto de 1994"
30,1,15,336,341,318,659,"21 de agosto de 1994"
30,1,15,337,255,207,462,"21 de agosto de 1994"
30,1,15,338,387,430,817,"21 de agosto de 1994"
30,1,37,695,347,351,698,"21 de agosto de 1994"
30,1,37,696,271,300,571,"21 de agosto de 1994"
30,1,37,697,459,486,945,"21 de agosto de 1994"
30,1,37,698,226,242,468,"21 de agosto de 1994"
30,1,37,699,231,239,470,"21 de agosto de 1994"
30,1,37,700,448,419,867,"21 de agosto de 1994"
30,1,37,701,313,297,610,"21 de agosto de 1994"
30,1,37,702,170,173,343,"21 de agosto de 1994"
30,1,37,703,323,324,647,"21 de agosto de 1994"
30,1,57,1320,437,434,871,"21 de agosto de 1994"
30,1,57,1321,286,268,554,"21 de agosto de 1994"
30,1,57,1322,346,312,658,"21 de agosto de 1994"
30,1,57,1323,277,270,547,"21 de agosto de 1994"
30,1,57,1324,396,343,739,"21 de agosto de 1994"
30,1,57,1325,265,255,520,"21 de agosto de 1994"
30,1,57,1326,229,265,494,"21 de agosto de 1994"
30,1,57,1327,317,350,667,"21 de agosto de 1994"
30,1,57,1328,401,344,745,"21 de agosto de 1994"
30,1,58,1329,451,439,890,"21 de agosto de 1994"
30,1,58,1330,136,100,236,"21 de agosto de 1994"
30,1,58,1331,232,202,434,"21 de agosto de 1994"
30,1,58,1332,168,141,309,"21 de agosto de 1994"
30,1,58,1333,201,210,411,"21 de agosto de 1994"
30,1,58,1334,251,207,458,"21 de agosto de 1994"
30,1,62,1403,274,276,550,"21 de agosto de 1994"
30,1,62,1404,317,316,633,"21 de agosto de 1994"
30,1,62,1405,284,305,589,"21 de agosto de 1994"
30,1,62,1406,350,320,670,"21 de agosto de 1994"
30,1,62,1407,172,160,332,"21 de agosto de 1994"
30,1,62,1408,382,421,803,"21 de agosto de 1994"
30,1,62,1409,319,314,633,"21 de agosto de 1994"
30,1,62,1410,266,254,520,"21 de agosto de 1994"
30,1,62,1411,386,346,732,"21 de agosto de 1994"
30,1,62,1412,672,736,1408,"21 de agosto de 1994"
30,1,65,1463,317,347,664,"21 de agosto de 1994"
30,1,65,1464,223,256,479,"21 de agosto de 1994"
30,1,65,1465,206,194,400,"21 de agosto de 1994"
30,1,65,1466,209,159,368,"21 de agosto de 1994"
30,1,65,1467,511,427,938,"21 de agosto de 1994"
30,1,65,1468,437,433,870,"21 de agosto de 1994"
30,1,65,1469,332,325,657,"21 de agosto de 1994"
30,1,65,1470,409,344,753,"21 de agosto de 1994"
30,1,65,1471,417,394,811,"21 de agosto de 1994"
30,1,65,1472,534,472,1006,"21 de agosto de 1994"
30,1,80,1718,469,485,954,"21 de agosto de 1994"
30,1,80,1719,421,403,824,"21 de agosto de 1994"
30,1,80,1720,483,478,961,"21 de agosto de 1994"
30,1,80,1721,257,255,512,"21 de agosto de 1994"
30,1,80,1722,199,189,388,"21 de agosto de 1994"
30,1,80,1723,364,354,718,"21 de agosto de 1994"
30,1,80,1724,504,471,975,"21 de agosto de 1994"
30,1,80,1725,445,409,854,"21 de agosto de 1994"
30,1,130,3067,543,584,1127,"21 de agosto de 1994"
30,1,130,3068,458,410,868,"21 de agosto de 1994"
30,1,130,3069,424,451,875,"21 de agosto de 1994"
30,1,130,3070,537,513,1050,"21 de agosto de 1994"
30,1,130,3071,436,390,826,"21 de agosto de 1994"
30,1,130,3072,231,223,454,"21 de agosto de 1994"
30,1,130,3073,131,89,220,"21 de agosto de 1994"
30,1,130,3074,444,329,773,"21 de agosto de 1994"
30,1,130,3075,101,102,203,"21 de agosto de 1994"
30,1,130,3076,470,443,913,"21 de agosto de 1994"
30,1,130,3077,114,105,219,"21 de agosto de 1994"
30,1,130,3078,116,101,217,"21 de agosto de 1994"
30,1,130,3079,269,237,506,"21 de agosto de 1994"
30,1,130,3080,161,128,289,"21 de agosto de 1994"
30,1,151,3543,407,408,815,"21 de agosto de 1994"
30,1,151,3544,402,375,777,"21 de agosto de 1994"
30,1,151,3545,212,211,423,"21 de agosto de 1994"
30,1,151,3546,337,276,613,"21 de agosto de 1994"
30,1,151,3547,173,129,302,"21 de agosto de 1994"
30,1,151,3548,319,277,596,"21 de agosto de 1994"
30,1,151,3549,492,433,925,"21 de agosto de 1994"
30,1,151,3550,509,477,986,"21 de agosto de 1994"
30,1,155,3598,496,480,976,"21 de agosto de 1994"
30,1,155,3599,608,523,1131,"21 de agosto de 1994"
30,1,155,3600,328,285,613,"21 de agosto de 1994"
30,1,155,3601,291,245,536,"21 de agosto de 1994"
30,1,155,3602,191,168,359,"21 de agosto de 1994"
30,1,155,3603,560,468,1028,"21 de agosto de 1994"
30,1,155,3604,472,415,887,"21 de agosto de 1994"
30,1,155,3605,134,117,251,"21 de agosto de 1994"
30,1,155,3606,230,209,439,"21 de agosto de 1994"
30,1,155,3607,243,246,489,"21 de agosto de 1994"
30,1,155,3608,284,323,607,"21 de agosto de 1994"
30,1,156,3609,224,240,464,"21 de agosto de 1994"
30,1,156,3610,201,233,434,"21 de agosto de 1994"
30,1,156,3611,556,644,1200,"21 de agosto de 1994"
30,1,156,3612,365,416,781,"21 de agosto de 1994"
30,1,156,3613,290,331,621,"21 de agosto de 1994"
30,1,156,3614,561,615,1176,"21 de agosto de 1994"
30,1,156,3615,501,598,1099,"21 de agosto de 1994"
30,1,156,3616,212,259,471,"21 de agosto de 1994"
30,1,156,3617,125,157,282,"21 de agosto de 1994"
30,1,156,3618,584,681,1265,"21 de agosto de 1994"
30,1,156,3619,599,692,1291,"21 de agosto de 1994"
30,1,156,3620,431,498,929,"21 de agosto de 1994"
30,1,156,3621,518,580,1098,"21 de agosto de 1994"
30,1,156,3622,336,392,728,"21 de agosto de 1994"
30,1,156,3623,288,300,588,"21 de agosto de 1994"
30,1,156,3624,308,323,631,"21 de agosto de 1994"
30,1,156,3625,336,282,618,"21 de agosto de 1994"
30,1,156,3626,186,142,328,"21 de agosto de 1994"
30,1,156,3627,139,98,237,"21 de agosto de 1994"
30,1,156,3628,352,318,670,"21 de agosto de 1994"
30,1,156,3629,450,410,860,"21 de agosto de 1994"
30,1,156,3630,232,233,465,"21 de agosto de 1994"
30,1,156,3631,451,398,849,"21 de agosto de 1994"
30,1,156,3632,357,287,644,"21 de agosto de 1994"
30,1,156,3633,485,461,946,"21 de agosto de 1994"
30,1,156,3634,413,396,809,"21 de agosto de 1994"
30,1,156,3635,471,426,897,"21 de agosto de 1994"
30,1,156,3636,642,587,1229,"21 de agosto de 1994"
30,1,156,3637,469,471,940,"21 de agosto de 1994"
30,1,156,3638,364,288,652,"21 de agosto de 1994"
30,1,156,3639,440,414,854,"21 de agosto de 1994"
30,1,156,3640,482,441,923,"21 de agosto de 1994"
30,1,156,3641,391,359,750,"21 de agosto de 1994"
30,1,156,3642,253,226,479,"21 de agosto de 1994"
30,1,156,3643,429,401,830,"21 de agosto de 1994"
30,1,156,3644,120,102,222,"21 de agosto de 1994"
30,1,156,3645,400,354,754,"21 de agosto de 1994"
30,1,156,3646,220,205,425,"21 de agosto de 1994"
30,1,156,3647,355,313,668,"21 de agosto de 1994"
30,1,156,3648,462,380,842,"21 de agosto de 1994"
30,1,156,3649,231,200,431,"21 de agosto de 1994"
30,1,156,3650,393,347,740,"21 de agosto de 1994"
30,1,156,3651,347,344,691,"21 de agosto de 1994"
30,1,156,3652,284,280,564,"21 de agosto de 1994"
30,1,156,3653,251,247,498,"21 de agosto de 1994"
30,1,156,3654,394,329,723,"21 de agosto de 1994"
30,1,156,3655,357,339,696,"21 de agosto de 1994"
30,1,156,3656,199,178,377,"21 de agosto de 1994"
30,1,156,3657,411,367,778,"21 de agosto de 1994"
30,1,156,3658,179,149,328,"21 de agosto de 1994"
30,1,156,3659,279,258,537,"21 de agosto de 1994"
30,1,156,3660,442,395,837,"21 de agosto de 1994"
30,1,156,3661,555,500,1055,"21 de agosto de 1994"
30,1,156,3662,123,99,222,"21 de agosto de 1994"
30,1,156,3663,645,591,1236,"21 de agosto de 1994"
30,1,156,3664,577,598,1175,"21 de agosto de 1994"
30,1,156,3665,324,320,644,"21 de agosto de 1994"
30,1,156,3666,302,294,596,"21 de agosto de 1994"
30,1,156,3667,453,424,877,"21 de agosto de 1994"
30,1,156,3668,269,279,548,"21 de agosto de 1994"
30,2,35,656,432,489,921,"21 de agosto de 1994"
30,2,35,657,460,496,956,"21 de agosto de 1994"
30,2,35,658,341,374,715,"21 de agosto de 1994"
30,2,35,659,637,590,1227,"21 de agosto de 1994"
30,2,35,660,282,302,584,"21 de agosto de 1994"
30,2,35,661,635,608,1243,"21 de agosto de 1994"
30,2,35,662,204,225,429,"21 de agosto de 1994"
30,2,35,663,477,482,959,"21 de agosto de 1994"
30,2,35,664,144,160,304,"21 de agosto de 1994"
30,2,35,665,267,262,529,"21 de agosto de 1994"
30,2,35,666,560,568,1128,"21 de agosto de 1994"
30,2,35,667,679,691,1370,"21 de agosto de 1994"
30,2,35,668,320,328,648,"21 de agosto de 1994"
30,2,35,669,501,515,1016,"21 de agosto de 1994"
30,2,35,670,190,176,366,"21 de agosto de 1994"
30,2,36,671,369,423,792,"21 de agosto de 1994"
30,2,36,672,545,643,1188,"21 de agosto de 1994"
30,2,36,673,353,421,774,"21 de agosto de 1994"
30,2,36,674,303,368,671,"21 de agosto de 1994"
30,2,36,675,335,403,738,"21 de agosto de 1994"
30,2,36,676,276,343,619,"21 de agosto de 1994"
30,2,36,677,174,240,414,"21 de agosto de 1994"
30,2,36,678,350,396,746,"21 de agosto de 1994"
30,2,36,679,298,366,664,"21 de agosto de 1994"
30,2,36,680,575,711,1286,"21 de agosto de 1994"
30,2,36,681,323,380,703,"21 de agosto de 1994"
30,2,36,682,366,431,797,"21 de agosto de 1994"
30,2,36,683,139,167,306,"21 de agosto de 1994"
30,2,36,684,223,252,475,"21 de agosto de 1994"
30,2,36,685,293,373,666,"21 de agosto de 1994"
30,2,36,686,203,266,469,"21 de agosto de 1994"
30,2,36,687,272,326,598,"21 de agosto de 1994"
30,2,36,688,419,492,911,"21 de agosto de 1994"
30,2,36,689,428,541,969,"21 de agosto de 1994"
30,2,36,690,253,306,559,"21 de agosto de 1994"
30,2,36,691,118,117,235,"21 de agosto de 1994"
30,2,36,692,257,235,492,"21 de agosto de 1994"
30,2,36,693,182,182,364,"21 de agosto de 1994"
30,2,36,694,707,392,1099,"21 de agosto de 1994"
30,2,152,3551,513,502,1015,"21 de agosto de 1994"
30,2,152,3552,406,487,893,"21 de agosto de 1994"
30,2,152,3553,408,456,864,"21 de agosto de 1994"
30,2,152,3554,307,351,658,"21 de agosto de 1994"
30,2,152,3555,180,131,311,"21 de agosto de 1994"
30,2,152,3556,297,280,577,"21 de agosto de 1994"
30,2,152,3557,408,361,769,"21 de agosto de 1994"
30,2,152,3558,441,383,824,"21 de agosto de 1994"
30,2,152,3559,265,246,511,"21 de agosto de 1994"
30,2,152,3560,405,375,780,"21 de agosto de 1994"
30,2,152,3561,408,346,754,"21 de agosto de 1994"
30,2,152,3562,150,119,269,"21 de agosto de 1994"
30,2,152,3563,432,396,828,"21 de agosto de 1994"
30,2,152,3564,437,429,866,"21 de agosto de 1994"
30,2,152,3565,215,169,384,"21 de agosto de 1994"
30,2,152,3566,526,407,933,"21 de agosto de 1994"
30,2,152,3567,416,363,779,"21 de agosto de 1994"
30,2,152,3568,738,715,1453,"21 de agosto de 1994"
30,2,152,3569,309,279,588,"21 de agosto de 1994"
30,2,152,3570,266,258,524,"21 de agosto de 1994"
30,2,152,3571,129,106,235,"21 de agosto de 1994"
30,2,154,3591,167,172,339,"21 de agosto de 1994"
30,2,154,3592,336,331,667,"21 de agosto de 1994"
30,2,154,3593,70,63,133,"21 de agosto de 1994"
30,2,154,3594,128,132,260,"21 de agosto de 1994"
30,2,154,3595,310,340,650,"21 de agosto de 1994"
30,2,154,3596,427,466,893,"21 de agosto de 1994"
30,2,154,3597,259,246,505,"21 de agosto de 1994"
30,2,166,3763,634,649,1283,"21 de agosto de 1994"
30,2,166,3764,556,569,1125,"21 de agosto de 1994"
30,2,166,3765,487,448,935,"21 de agosto de 1994"
30,2,166,3766,387,412,799,"21 de agosto de 1994"
30,2,166,3767,197,194,391,"21 de agosto de 1994"
30,2,166,3768,152,158,310,"21 de agosto de 1994"
30,2,166,3769,231,238,469,"21 de agosto de 1994"
30,2,166,3770,400,382,782,"21 de agosto de 1994"
30,2,166,3771,210,228,438,"21 de agosto de 1994"
30,2,188,4096,115,121,236,"21 de agosto de 1994"
30,2,188,4097,602,665,1267,"21 de agosto de 1994"
30,2,188,4098,121,125,246,"21 de agosto de 1994"
30,2,188,4099,456,599,1055,"21 de agosto de 1994"
30,2,188,4100,581,683,1264,"21 de agosto de 1994"
30,2,188,4101,619,761,1380,"21 de agosto de 1994"
30,2,188,4102,460,519,979,"21 de agosto de 1994"
30,2,188,4103,671,749,1420,"21 de agosto de 1994"
30,2,188,4104,644,737,1381,"21 de agosto de 1994"
30,2,188,4105,535,590,1125,"21 de agosto de 1994"
30,2,188,4106,431,494,925,"21 de agosto de 1994"
30,2,188,4107,527,638,1165,"21 de agosto de 1994"
30,2,188,4108,379,405,784,"21 de agosto de 1994"
30,2,188,4109,301,405,706,"21 de agosto de 1994"
30,2,188,4110,278,351,629,"21 de agosto de 1994"
30,2,188,4111,334,396,730,"21 de agosto de 1994"
30,2,188,4112,301,356,657,"21 de agosto de 1994"
30,2,188,4113,425,539,964,"21 de agosto de 1994"
30,2,188,4114,495,548,1043,"21 de agosto de 1994"
30,2,188,4115,350,391,741,"21 de agosto de 1994"
30,2,188,4116,402,494,896,"21 de agosto de 1994"
30,2,188,4117,419,491,910,"21 de agosto de 1994"
30,2,188,4118,637,733,1370,"21 de agosto de 1994"
30,2,188,4119,512,399,911,"21 de agosto de 1994"
30,2,188,4120,336,388,724,"21 de agosto de 1994"
30,2,188,4121,348,427,775,"21 de agosto de 1994"
30,2,188,4122,418,545,963,"21 de agosto de 1994"
30,2,188,4123,361,446,807,"21 de agosto de 1994"
30,2,188,4124,260,318,578,"21 de agosto de 1994"
30,2,188,4125,600,698,1298,"21 de agosto de 1994"
30,2,188,4126,442,507,949,"21 de agosto de 1994"
30,2,188,4127,397,499,896,"21 de agosto de 1994"
30,2,188,4128,443,531,974,"21 de agosto de 1994"
30,2,188,4129,480,599,1079,"21 de agosto de 1994"
30,2,188,4130,706,811,1517,"21 de agosto de 1994"
30,2,188,4131,134,147,281,"21 de agosto de 1994"
30,2,188,4132,454,547,1001,"21 de agosto de 1994"
30,2,188,4133,460,513,973,"21 de agosto de 1994"
30,2,188,4134,263,306,569,"21 de agosto de 1994"
30,2,188,4135,712,819,1531,"21 de agosto de 1994"
30,2,188,4136,369,443,812,"21 de agosto de 1994"
30,2,188,4137,389,458,847,"21 de agosto de 1994"
30,2,188,4138,354,434,788,"21 de agosto de 1994"
30,2,188,4139,363,417,780,"21 de agosto de 1994"
30,2,188,4140,492,558,1050,"21 de agosto de 1994"
30,2,188,4141,683,768,1451,"21 de agosto de 1994"
30,2,188,4142,743,635,1378,"21 de agosto de 1994"
30,2,188,4143,533,545,1078,"21 de agosto de 1994"
30,2,188,4144,587,680,1267,"21 de agosto de 1994"
30,2,188,4145,345,369,714,"21 de agosto de 1994"
30,2,188,4146,443,523,966,"21 de agosto de 1994"
30,2,188,4147,322,291,613,"21 de agosto de 1994"
30,2,188,4148,546,518,1064,"21 de agosto de 1994"
30,2,188,4149,467,465,932,"21 de agosto de 1994"
30,2,188,4150,302,255,557,"21 de agosto de 1994"
30,2,188,4151,121,100,221,"21 de agosto de 1994"
30,2,188,4152,166,151,317,"21 de agosto de 1994"
30,2,188,4153,487,546,1033,"21 de agosto de 1994"
30,2,188,4154,661,627,1288,"21 de agosto de 1994"
30,2,188,4155,620,728,1348,"21 de agosto de 1994"
30,2,188,4156,524,534,1058,"21 de agosto de 1994"
30,2,188,4157,452,473,925,"21 de agosto de 1994"
30,2,188,4158,368,342,710,"21 de agosto de 1994"
30,2,188,4159,662,696,1358,"21 de agosto de 1994"
30,2,188,4160,517,461,978,"21 de agosto de 1994"
30,2,188,4161,594,596,1190,"21 de agosto de 1994"
30,2,188,4162,203,171,374,"21 de agosto de 1994"
30,2,188,4163,357,326,683,"21 de agosto de 1994"
30,2,188,4164,470,425,895,"21 de agosto de 1994"
30,2,188,4165,581,513,1094,"21 de agosto de 1994"
30,2,188,4166,355,295,650,"21 de agosto de 1994"
30,2,188,4167,479,491,970,"21 de agosto de 1994"
30,2,188,4168,490,421,911,"21 de agosto de 1994"
30,2,188,4169,329,283,612,"21 de agosto de 1994"
30,2,188,4170,348,300,648,"21 de agosto de 1994"
30,3,42,932,497,579,1076,"21 de agosto de 1994"
30,3,42,933,441,488,929,"21 de agosto de 1994"
30,3,42,934,382,465,847,"21 de agosto de 1994"
30,3,42,935,515,570,1085,"21 de agosto de 1994"
30,3,42,936,394,486,880,"21 de agosto de 1994"
30,3,42,937,607,684,1291,"21 de agosto de 1994"
30,3,42,938,665,753,1418,"21 de agosto de 1994"
30,3,42,939,418,504,922,"21 de agosto de 1994"
30,3,42,940,664,778,1442,"21 de agosto de 1994"
30,3,42,941,432,470,902,"21 de agosto de 1994"
30,3,42,942,243,288,531,"21 de agosto de 1994"
30,3,42,943,641,646,1287,"21 de agosto de 1994"
30,3,42,944,404,497,901,"21 de agosto de 1994"
30,3,42,945,269,248,517,"21 de agosto de 1994"
30,3,42,946,564,487,1051,"21 de agosto de 1994"
30,3,42,947,166,161,327,"21 de agosto de 1994"
30,3,42,948,171,176,347,"21 de agosto de 1994"
30,3,42,949,180,186,366,"21 de agosto de 1994"
30,3,42,950,83,80,163,"21 de agosto de 1994"
30,3,42,951,73,66,139,"21 de agosto de 1994"
30,3,42,952,453,452,905,"21 de agosto de 1994"
30,3,42,953,70,72,142,"21 de agosto de 1994"
30,3,42,954,104,92,196,"21 de agosto de 1994"
30,3,42,955,411,433,844,"21 de agosto de 1994"
30,3,42,956,70,74,144,"21 de agosto de 1994"
30,3,42,957,82,73,155,"21 de agosto de 1994"
30,3,42,958,155,146,301,"21 de agosto de 1994"
30,3,42,959,159,151,310,"21 de agosto de 1994"
30,3,42,960,150,133,283,"21 de agosto de 1994"
30,3,132,3109,426,537,963,"21 de agosto de 1994"
30,3,132,3110,371,472,843,"21 de agosto de 1994"
30,3,132,3111,377,491,868,"21 de agosto de 1994"
30,3,132,3112,384,441,825,"21 de agosto de 1994"
30,3,132,3113,527,628,1155,"21 de agosto de 1994"
30,3,132,3114,622,736,1358,"21 de agosto de 1994"
30,3,132,3115,636,781,1417,"21 de agosto de 1994"
30,3,132,3116,363,421,784,"21 de agosto de 1994"
30,3,132,3117,284,344,628,"21 de agosto de 1994"
30,3,132,3118,387,410,797,"21 de agosto de 1994"
30,3,132,3119,492,527,1019,"21 de agosto de 1994"
30,3,132,3120,435,483,918,"21 de agosto de 1994"
30,3,132,3121,351,390,741,"21 de agosto de 1994"
30,3,132,3122,340,411,751,"21 de agosto de 1994"
30,3,132,3123,378,472,850,"21 de agosto de 1994"
30,3,132,3124,644,693,1337,"21 de agosto de 1994"
30,3,132,3125,609,763,1372,"21 de agosto de 1994"
30,3,132,3126,292,361,653,"21 de agosto de 1994"
30,3,132,3127,356,444,800,"21 de agosto de 1994"
30,3,132,3128,314,349,663,"21 de agosto de 1994"
30,3,132,3129,500,593,1093,"21 de agosto de 1994"
30,3,132,3130,613,682,1295,"21 de agosto de 1994"
30,3,132,3131,618,754,1372,"21 de agosto de 1994"
30,3,132,3132,623,743,1366,"21 de agosto de 1994"
30,3,132,3133,384,450,834,"21 de agosto de 1994"
30,3,132,3134,331,418,749,"21 de agosto de 1994"
30,3,132,3135,399,513,912,"21 de agosto de 1994"
30,3,132,3136,450,511,961,"21 de agosto de 1994"
30,3,132,3137,536,618,1154,"21 de agosto de 1994"
30,3,132,3138,275,338,613,"21 de agosto de 1994"
30,3,132,3139,527,596,1123,"21 de agosto de 1994"
30,3,132,3140,550,658,1208,"21 de agosto de 1994"
30,3,132,3141,293,377,670,"21 de agosto de 1994"
30,3,132,3142,387,509,896,"21 de agosto de 1994"
30,3,132,3143,289,370,659,"21 de agosto de 1994"
30,3,132,3144,547,616,1163,"21 de agosto de 1994"
30,3,132,3145,594,679,1273,"21 de agosto de 1994"
30,3,132,3146,518,588,1106,"21 de agosto de 1994"
30,3,132,3147,392,445,837,"21 de agosto de 1994"
30,3,132,3148,316,426,742,"21 de agosto de 1994"
30,3,132,3149,459,529,988,"21 de agosto de 1994"
30,3,132,3150,486,562,1048,"21 de agosto de 1994"
30,3,132,3151,574,668,1242,"21 de agosto de 1994"
30,3,132,3152,475,573,1048,"21 de agosto de 1994"
30,3,132,3153,543,636,1179,"21 de agosto de 1994"
30,3,132,3154,344,478,822,"21 de agosto de 1994"
30,3,132,3155,440,519,959,"21 de agosto de 1994"
30,3,132,3156,575,666,1241,"21 de agosto de 1994"
30,3,132,3157,537,616,1153,"21 de agosto de 1994"
30,3,132,3158,328,380,708,"21 de agosto de 1994"
30,3,132,3159,618,717,1335,"21 de agosto de 1994"
30,3,132,3160,464,547,1011,"21 de agosto de 1994"
30,3,132,3161,415,548,963,"21 de agosto de 1994"
30,3,132,3162,252,325,577,"21 de agosto de 1994"
30,3,132,3163,297,381,678,"21 de agosto de 1994"
30,3,132,3164,441,535,976,"21 de agosto de 1994"
30,3,132,3165,539,641,1180,"21 de agosto de 1994"
30,3,132,3166,580,679,1259,"21 de agosto de 1994"
30,3,132,3167,200,248,448,"21 de agosto de 1994"
30,3,132,3168,506,583,1089,"21 de agosto de 1994"
30,3,132,3169,553,648,1201,"21 de agosto de 1994"
30,3,132,3170,621,726,1347,"21 de agosto de 1994"
30,3,132,3171,571,677,1248,"21 de agosto de 1994"
30,3,132,3172,582,674,1256,"21 de agosto de 1994"
30,3,132,3173,362,420,782,"21 de agosto de 1994"
30,3,132,3174,304,372,676,"21 de agosto de 1994"
30,3,132,3175,554,667,1221,"21 de agosto de 1994"
30,3,132,3176,421,574,995,"21 de agosto de 1994"
30,3,132,3177,341,381,722,"21 de agosto de 1994"
30,3,132,3178,202,252,454,"21 de agosto de 1994"
30,3,132,3179,328,381,709,"21 de agosto de 1994"
30,3,132,3180,408,504,912,"21 de agosto de 1994"
30,3,132,3181,298,355,653,"21 de agosto de 1994"
30,3,132,3182,394,407,801,"21 de agosto de 1994"
30,3,132,3183,370,403,773,"21 de agosto de 1994"
30,3,132,3184,358,430,788,"21 de agosto de 1994"
30,3,132,3185,186,219,405,"21 de agosto de 1994"
30,3,132,3186,439,513,952,"21 de agosto de 1994"
30,3,132,3187,645,748,1393,"21 de agosto de 1994"
30,3,132,3188,712,827,1539,"21 de agosto de 1994"
30,3,132,3189,550,653,1203,"21 de agosto de 1994"
30,3,132,3190,519,627,1146,"21 de agosto de 1994"
30,3,132,3191,610,703,1313,"21 de agosto de 1994"
30,3,132,3192,362,429,791,"21 de agosto de 1994"
30,3,132,3193,366,393,759,"21 de agosto de 1994"
30,3,132,3194,436,494,930,"21 de agosto de 1994"
30,3,132,3195,263,293,556,"21 de agosto de 1994"
30,3,132,3196,420,479,899,"21 de agosto de 1994"
30,3,132,3197,483,501,984,"21 de agosto de 1994"
30,3,132,3198,627,732,1359,"21 de agosto de 1994"
30,3,132,3199,455,496,951,"21 de agosto de 1994"
30,3,132,3200,579,650,1229,"21 de agosto de 1994"
30,3,132,3201,375,431,806,"21 de agosto de 1994"
30,3,132,3202,376,458,834,"21 de agosto de 1994"
30,3,132,3203,548,654,1202,"21 de agosto de 1994"
30,3,132,3204,638,719,1357,"21 de agosto de 1994"
30,3,132,3205,443,488,931,"21 de agosto de 1994"
30,3,132,3206,230,257,487,"21 de agosto de 1994"
30,3,132,3207,681,813,1494,"21 de agosto de 1994"
30,3,132,3208,523,584,1107,"21 de agosto de 1994"
30,3,132,3209,287,339,626,"21 de agosto de 1994"
30,3,132,3210,545,583,1128,"21 de agosto de 1994"
30,3,132,3211,274,316,590,"21 de agosto de 1994"
30,3,132,3212,336,405,741,"21 de agosto de 1994"
30,3,132,3213,540,584,1124,"21 de agosto de 1994"
30,3,132,3214,336,393,729,"21 de agosto de 1994"
30,3,132,3215,609,738,1347,"21 de agosto de 1994"
30,3,132,3216,692,813,1505,"21 de agosto de 1994"
30,3,132,3217,463,508,971,"21 de agosto de 1994"
30,3,132,3218,249,269,518,"21 de agosto de 1994"
30,4,39,709,531,523,1054,"21 de agosto de 1994"
30,4,39,710,408,410,818,"21 de agosto de 1994"
30,4,39,711,376,327,703,"21 de agosto de 1994"
30,4,52,1266,479,514,993,"21 de agosto de 1994"
30,4,52,1267,597,588,1185,"21 de agosto de 1994"
30,4,52,1268,206,238,444,"21 de agosto de 1994"
30,4,52,1269,272,294,566,"21 de agosto de 1994"
30,4,52,1270,233,217,450,"21 de agosto de 1994"
30,4,52,1271,317,308,625,"21 de agosto de 1994"
30,4,52,1272,604,576,1180,"21 de agosto de 1994"
30,4,52,1273,469,436,905,"21 de agosto de 1994"
30,4,52,1274,370,341,711,"21 de agosto de 1994"
30,4,53,1275,494,577,1071,"21 de agosto de 1994"
30,4,53,1276,465,515,980,"21 de agosto de 1994"
30,4,53,1277,473,461,934,"21 de agosto de 1994"
30,4,53,1278,333,350,683,"21 de agosto de 1994"
30,4,53,1279,183,166,349,"21 de agosto de 1994"
30,4,53,1280,397,346,743,"21 de agosto de 1994"
30,4,53,1281,277,283,560,"21 de agosto de 1994"
30,4,53,1282,438,437,875,"21 de agosto de 1994"
30,4,53,1283,499,501,1000,"21 de agosto de 1994"
30,4,53,1284,402,445,847,"21 de agosto de 1994"
30,4,53,1285,509,503,1012,"21 de agosto de 1994"
30,4,66,1473,509,496,1005,"21 de agosto de 1994"
30,4,66,1474,280,280,560,"21 de agosto de 1994"
30,4,68,1510,429,473,902,"21 de agosto de 1994"
30,4,68,1511,276,288,564,"21 de agosto de 1994"
30,4,68,1512,278,267,545,"21 de agosto de 1994"
30,4,68,1513,329,300,629,"21 de agosto de 1994"
30,4,68,1514,560,524,1084,"21 de agosto de 1994"
30,4,68,1515,333,248,581,"21 de agosto de 1994"
30,4,68,1516,439,406,845,"21 de agosto de 1994"
30,4,68,1517,628,621,1249,"21 de agosto de 1994"
30,4,68,1518,598,629,1227,"21 de agosto de 1994"
30,4,68,1519,512,541,1053,"21 de agosto de 1994"
30,4,68,1520,97,78,175,"21 de agosto de 1994"
30,4,68,1521,295,284,579,"21 de agosto de 1994"
30,4,68,1522,418,413,831,"21 de agosto de 1994"
30,4,68,1523,516,494,1010,"21 de agosto de 1994"
30,4,69,1524,423,427,850,"21 de agosto de 1994"
30,4,69,1525,382,369,751,"21 de agosto de 1994"
30,4,69,1526,379,427,806,"21 de agosto de 1994"
30,4,69,1527,390,425,815,"21 de agosto de 1994"
30,4,69,1528,288,265,553,"21 de agosto de 1994"
30,4,71,1556,466,525,991,"21 de agosto de 1994"
30,4,71,1557,329,363,692,"21 de agosto de 1994"
30,4,71,1558,293,349,642,"21 de agosto de 1994"
30,4,71,1559,276,336,612,"21 de agosto de 1994"
30,4,71,1560,264,320,584,"21 de agosto de 1994"
30,4,71,1561,330,432,762,"21 de agosto de 1994"
30,4,71,1562,427,463,890,"21 de agosto de 1994"
30,4,71,1563,383,432,815,"21 de agosto de 1994"
30,4,71,1564,581,680,1261,"21 de agosto de 1994"
30,4,71,1565,584,687,1271,"21 de agosto de 1994"
30,4,71,1566,292,353,645,"21 de agosto de 1994"
30,4,71,1567,322,261,583,"21 de agosto de 1994"
30,4,71,1568,154,131,285,"21 de agosto de 1994"
30,4,71,1569,335,293,628,"21 de agosto de 1994"
30,4,71,1570,390,350,740,"21 de agosto de 1994"
30,4,71,1571,258,221,479,"21 de agosto de 1994"
30,4,71,1572,251,201,452,"21 de agosto de 1994"
30,4,71,1573,569,527,1096,"21 de agosto de 1994"
30,4,71,1574,361,357,718,"21 de agosto de 1994"
30,4,71,1575,414,429,843,"21 de agosto de 1994"
30,4,71,1576,207,230,437,"21 de agosto de 1994"
30,4,71,1577,338,338,676,"21 de agosto de 1994"
30,4,71,1578,299,266,565,"21 de agosto de 1994"
30,4,104,2374,421,430,851,"21 de agosto de 1994"
30,4,104,2375,441,470,911,"21 de agosto de 1994"
30,4,104,2376,420,429,849,"21 de agosto de 1994"
30,4,104,2377,230,238,468,"21 de agosto de 1994"
30,4,104,2378,411,374,785,"21 de agosto de 1994"
30,4,125,2898,462,542,1004,"21 de agosto de 1994"
30,4,125,2899,453,510,963,"21 de agosto de 1994"
30,4,125,2900,329,393,722,"21 de agosto de 1994"
30,4,125,2901,425,504,929,"21 de agosto de 1994"
30,4,125,2902,242,257,499,"21 de agosto de 1994"
30,4,125,2903,306,367,673,"21 de agosto de 1994"
30,4,125,2904,436,499,935,"21 de agosto de 1994"
30,4,125,2905,557,719,1276,"21 de agosto de 1994"
30,4,125,2906,587,669,1256,"21 de agosto de 1994"
30,4,125,2907,567,662,1229,"21 de agosto de 1994"
30,4,125,2908,427,493,920,"21 de agosto de 1994"
30,4,125,2909,243,282,525,"21 de agosto de 1994"
30,4,125,2910,677,763,1440,"21 de agosto de 1994"
30,4,125,2911,571,686,1257,"21 de agosto de 1994"
30,4,125,2912,665,795,1460,"21 de agosto de 1994"
30,4,125,2913,551,623,1174,"21 de agosto de 1994"
30,4,125,2914,601,727,1328,"21 de agosto de 1994"
30,4,125,2915,640,805,1445,"21 de agosto de 1994"
30,4,125,2916,615,738,1353,"21 de agosto de 1994"
30,4,125,2917,652,810,1462,"21 de agosto de 1994"
30,4,125,2918,361,444,805,"21 de agosto de 1994"
30,4,125,2919,385,474,859,"21 de agosto de 1994"
30,4,125,2920,679,759,1438,"21 de agosto de 1994"
30,4,125,2921,481,562,1043,"21 de agosto de 1994"
30,4,125,2922,214,263,477,"21 de agosto de 1994"
30,4,125,2923,513,602,1115,"21 de agosto de 1994"
30,4,125,2924,402,466,868,"21 de agosto de 1994"
30,4,125,2925,388,447,835,"21 de agosto de 1994"
30,4,125,2926,493,516,1009,"21 de agosto de 1994"
30,4,125,2927,479,489,968,"21 de agosto de 1994"
30,4,125,2928,451,491,942,"21 de agosto de 1994"
30,4,125,2929,690,739,1429,"21 de agosto de 1994"
30,4,125,2930,605,606,1211,"21 de agosto de 1994"
30,4,125,2931,197,183,380,"21 de agosto de 1994"
30,4,125,2932,344,382,726,"21 de agosto de 1994"
30,4,125,2933,327,406,733,"21 de agosto de 1994"
30,4,125,2934,392,374,766,"21 de agosto de 1994"
30,4,125,2935,390,440,830,"21 de agosto de 1994"
30,4,125,2936,748,733,1481,"21 de agosto de 1994"
30,4,125,2937,157,200,357,"21 de agosto de 1994"
30,4,125,2938,402,413,815,"21 de agosto de 1994"
30,4,125,2939,301,276,577,"21 de agosto de 1994"
30,4,125,2940,292,266,558,"21 de agosto de 1994"
30,4,125,2941,168,171,339,"21 de agosto de 1994"
30,4,125,2942,370,399,769,"21 de agosto de 1994"
30,4,125,2943,394,440,834,"21 de agosto de 1994"
30,4,125,2944,103,115,218,"21 de agosto de 1994"
30,4,125,2945,483,452,935,"21 de agosto de 1994"
30,4,125,2946,428,465,893,"21 de agosto de 1994"
30,4,125,2947,411,400,811,"21 de agosto de 1994"
30,4,125,2948,364,392,756,"21 de agosto de 1994"
30,4,125,2949,417,407,824,"21 de agosto de 1994"
30,4,125,2950,423,448,871,"21 de agosto de 1994"
30,4,125,2951,211,204,415,"21 de agosto de 1994"
30,4,125,2952,428,422,850,"21 de agosto de 1994"
30,4,125,2953,274,279,553,"21 de agosto de 1994"
30,4,125,2954,342,320,662,"21 de agosto de 1994"
30,4,125,2955,315,349,664,"21 de agosto de 1994"
30,4,125,2956,792,814,1606,"21 de agosto de 1994"
30,4,125,2957,639,630,1269,"21 de agosto de 1994"
30,4,125,2958,327,300,627,"21 de agosto de 1994"
30,4,125,2959,443,410,853,"21 de agosto de 1994"
30,4,125,2960,353,387,740,"21 de agosto de 1994"
30,4,125,2961,274,278,552,"21 de agosto de 1994"
30,4,125,2962,258,252,510,"21 de agosto de 1994"
30,4,125,2963,222,205,427,"21 de agosto de 1994"
30,4,125,2964,508,489,997,"21 de agosto de 1994"
30,4,125,2965,427,397,824,"21 de agosto de 1994"
30,4,125,2966,359,393,752,"21 de agosto de 1994"
30,4,125,2967,476,535,1011,"21 de agosto de 1994"
30,4,125,2968,348,392,740,"21 de agosto de 1994"
30,4,125,2969,350,334,684,"21 de agosto de 1994"
30,4,125,2970,327,311,638,"21 de agosto de 1994"
30,4,125,2971,588,575,1163,"21 de agosto de 1994"
30,4,125,2972,432,376,808,"21 de agosto de 1994"
30,4,125,2973,198,162,360,"21 de agosto de 1994"
30,4,125,2974,300,289,589,"21 de agosto de 1994"
30,4,125,2975,246,254,500,"21 de agosto de 1994"
30,4,125,2976,395,339,734,"21 de agosto de 1994"
30,4,125,2977,344,343,687,"21 de agosto de 1994"
30,4,125,2978,287,288,575,"21 de agosto de 1994"
30,4,125,2979,412,420,832,"21 de agosto de 1994"
30,4,125,2980,440,360,800,"21 de agosto de 1994"
30,4,125,2981,192,162,354,"21 de agosto de 1994"
30,4,125,2982,576,502,1078,"21 de agosto de 1994"
30,4,125,2983,426,369,795,"21 de agosto de 1994"
30,4,125,2984,332,347,679,"21 de agosto de 1994"
30,4,125,2985,503,511,1014,"21 de agosto de 1994"
30,4,125,2986,493,466,959,"21 de agosto de 1994"
30,4,125,2987,487,432,919,"21 de agosto de 1994"
30,4,125,2988,549,475,1024,"21 de agosto de 1994"
30,4,125,2989,501,414,915,"21 de agosto de 1994"
30,4,203,4606,411,399,810,"21 de agosto de 1994"
30,4,203,4607,312,317,629,"21 de agosto de 1994"
30,4,203,4608,405,360,765,"21 de agosto de 1994"
30,4,203,4609,504,473,977,"21 de agosto de 1994"
30,4,203,4610,165,167,332,"21 de agosto de 1994"
30,4,203,4611,384,351,735,"21 de agosto de 1994"
30,4,203,4612,152,147,299,"21 de agosto de 1994"
30,4,203,4613,540,548,1088,"21 de agosto de 1994"
30,5,1,1,595,525,1120,"21 de agosto de 1994"
30,5,1,2,411,386,797,"21 de agosto de 1994"
30,5,1,3,522,431,953,"21 de agosto de 1994"
30,5,1,4,283,166,449,"21 de agosto de 1994"
30,5,24,425,231,253,484,"21 de agosto de 1994"
30,5,24,426,224,262,486,"21 de agosto de 1994"
30,5,24,427,590,521,1111,"21 de agosto de 1994"
30,5,24,428,432,481,913,"21 de agosto de 1994"
30,5,24,429,342,294,636,"21 de agosto de 1994"
30,5,24,430,224,186,410,"21 de agosto de 1994"
30,5,24,431,298,245,543,"21 de agosto de 1994"
30,5,24,432,454,367,821,"21 de agosto de 1994"
30,5,24,433,536,466,1002,"21 de agosto de 1994"
30,5,24,434,571,491,1062,"21 de agosto de 1994"
30,5,24,435,387,385,772,"21 de agosto de 1994"
30,5,24,436,320,272,592,"21 de agosto de 1994"
30,5,24,437,452,397,849,"21 de agosto de 1994"
30,5,24,438,345,279,624,"21 de agosto de 1994"
30,5,24,439,241,239,480,"21 de agosto de 1994"
30,5,24,440,362,306,668,"21 de agosto de 1994"
30,5,24,441,270,220,490,"21 de agosto de 1994"
30,5,24,442,294,267,561,"21 de agosto de 1994"
30,5,24,443,243,228,471,"21 de agosto de 1994"
30,5,24,444,197,190,387,"21 de agosto de 1994"
30,5,24,445,324,274,598,"21 de agosto de 1994"
30,5,24,446,280,276,556,"21 de agosto de 1994"
30,5,24,447,230,256,486,"21 de agosto de 1994"
30,5,24,448,258,226,484,"21 de agosto de 1994"
30,5,24,449,177,155,332,"21 de agosto de 1994"
30,5,24,450,641,538,1179,"21 de agosto de 1994"
30,5,24,451,363,304,667,"21 de agosto de 1994"
30,5,24,452,434,356,790,"21 de agosto de 1994"
30,5,24,453,177,141,318,"21 de agosto de 1994"
30,5,24,454,248,199,447,"21 de agosto de 1994"
30,5,24,455,479,462,941,"21 de agosto de 1994"
30,5,24,456,118,110,228,"21 de agosto de 1994"
30,5,24,457,369,287,656,"21 de agosto de 1994"
30,5,24,458,146,135,281,"21 de agosto de 1994"
30,5,38,704,397,414,811,"21 de agosto de 1994"
30,5,38,705,522,553,1075,"21 de agosto de 1994"
30,5,38,706,209,181,390,"21 de agosto de 1994"
30,5,38,707,220,204,424,"21 de agosto de 1994"
30,5,38,708,138,123,261,"21 de agosto de 1994"
30,5,44,963,476,462,938,"21 de agosto de 1994"
30,5,44,964,391,383,774,"21 de agosto de 1994"
30,5,44,965,255,203,458,"21 de agosto de 1994"
30,5,44,966,40,24,64,"21 de agosto de 1994"
30,5,44,967,202,159,361,"21 de agosto de 1994"
30,5,44,968,111,95,206,"21 de agosto de 1994"
30,5,44,969,263,223,486,"21 de agosto de 1994"
30,5,59,1335,552,504,1056,"21 de agosto de 1994"
30,5,59,1336,511,536,1047,"21 de agosto de 1994"
30,5,59,1337,395,307,702,"21 de agosto de 1994"
30,5,59,1338,268,218,486,"21 de agosto de 1994"
30,5,59,1339,240,200,440,"21 de agosto de 1994"
30,5,59,1340,415,367,782,"21 de agosto de 1994"
30,5,59,1341,191,184,375,"21 de agosto de 1994"
30,5,59,1342,362,304,666,"21 de agosto de 1994"
30,5,94,2170,420,529,949,"21 de agosto de 1994"
30,5,94,2171,361,376,737,"21 de agosto de 1994"
30,5,94,2172,287,272,559,"21 de agosto de 1994"
30,5,94,2173,150,152,302,"21 de agosto de 1994"
30,5,94,2174,578,618,1196,"21 de agosto de 1994"
30,5,94,2175,402,429,831,"21 de agosto de 1994"
30,5,94,2176,520,520,1040,"21 de agosto de 1994"
30,5,94,2177,207,179,386,"21 de agosto de 1994"
30,5,94,2178,318,299,617,"21 de agosto de 1994"
30,5,96,2201,438,482,920,"21 de agosto de 1994"
30,5,96,2202,401,395,796,"21 de agosto de 1994"
30,5,96,2203,269,197,466,"21 de agosto de 1994"
30,5,96,2204,249,216,465,"21 de agosto de 1994"
30,5,96,2205,198,172,370,"21 de agosto de 1994"
30,5,96,2206,388,264,652,"21 de agosto de 1994"
30,5,96,2207,186,142,328,"21 de agosto de 1994"
30,5,96,2208,224,198,422,"21 de agosto de 1994"
30,5,96,2209,400,335,735,"21 de agosto de 1994"
30,5,96,2210,185,165,350,"21 de agosto de 1994"
30,5,96,2211,168,136,304,"21 de agosto de 1994"
30,5,96,2212,198,223,421,"21 de agosto de 1994"
30,5,96,2213,296,241,537,"21 de agosto de 1994"
30,5,96,2214,162,123,285,"21 de agosto de 1994"
30,5,96,2215,226,194,420,"21 de agosto de 1994"
30,5,96,2216,212,182,394,"21 de agosto de 1994"
30,5,96,2217,187,190,377,"21 de agosto de 1994"
30,5,96,2218,138,115,253,"21 de agosto de 1994"
30,5,97,2219,149,215,364,"21 de agosto de 1994"
30,5,97,2220,230,250,480,"21 de agosto de 1994"
30,5,107,2415,268,313,581,"21 de agosto de 1994"
30,5,107,2416,380,426,806,"21 de agosto de 1994"
30,5,107,2417,200,170,370,"21 de agosto de 1994"
30,5,108,2418,326,284,610,"21 de agosto de 1994"
30,5,108,2419,259,207,466,"21 de agosto de 1994"
30,5,110,2526,332,342,674,"21 de agosto de 1994"
30,5,110,2527,312,337,649,"21 de agosto de 1994"
30,5,110,2528,479,546,1025,"21 de agosto de 1994"
30,5,110,2529,438,496,934,"21 de agosto de 1994"
30,5,110,2530,400,403,803,"21 de agosto de 1994"
30,5,110,2531,461,529,990,"21 de agosto de 1994"
30,5,110,2532,367,413,780,"21 de agosto de 1994"
30,5,110,2533,336,421,757,"21 de agosto de 1994"
30,5,110,2534,287,287,574,"21 de agosto de 1994"
30,5,110,2535,576,704,1280,"21 de agosto de 1994"
30,5,110,2536,690,745,1435,"21 de agosto de 1994"
30,5,110,2537,210,245,455,"21 de agosto de 1994"
30,5,110,2538,537,575,1112,"21 de agosto de 1994"
30,5,110,2539,195,218,413,"21 de agosto de 1994"
30,5,110,2540,323,267,590,"21 de agosto de 1994"
30,5,110,2541,260,251,511,"21 de agosto de 1994"
30,5,110,2542,370,323,693,"21 de agosto de 1994"
30,5,110,2543,382,360,742,"21 de agosto de 1994"
30,5,110,2544,210,221,431,"21 de agosto de 1994"
30,5,110,2545,621,533,1154,"21 de agosto de 1994"
30,5,110,2546,404,368,772,"21 de agosto de 1994"
30,5,110,2547,358,365,723,"21 de agosto de 1994"
30,5,110,2548,284,284,568,"21 de agosto de 1994"
30,5,110,2549,394,348,742,"21 de agosto de 1994"
30,5,110,2550,257,252,509,"21 de agosto de 1994"
30,5,110,2551,230,239,469,"21 de agosto de 1994"
30,5,110,2552,159,125,284,"21 de agosto de 1994"
30,5,110,2553,214,164,378,"21 de agosto de 1994"
30,5,110,2554,254,219,473,"21 de agosto de 1994"
30,5,110,2555,439,365,804,"21 de agosto de 1994"
30,5,110,2556,191,164,355,"21 de agosto de 1994"
30,5,110,2557,289,290,579,"21 de agosto de 1994"
30,5,110,2558,333,283,616,"21 de agosto de 1994"
30,5,110,2559,296,288,584,"21 de agosto de 1994"
30,5,110,2560,79,72,151,"21 de agosto de 1994"
30,5,110,2561,260,243,503,"21 de agosto de 1994"
30,5,110,2562,152,113,265,"21 de agosto de 1994"
30,5,110,2563,387,354,741,"21 de agosto de 1994"
30,5,110,2564,255,228,483,"21 de agosto de 1994"
30,5,110,2565,266,243,509,"21 de agosto de 1994"
30,5,110,2566,289,245,534,"21 de agosto de 1994"
30,5,110,2567,228,230,458,"21 de agosto de 1994"
30,5,110,2568,300,268,568,"21 de agosto de 1994"
30,5,110,2569,292,268,560,"21 de agosto de 1994"
30,5,110,2570,255,254,509,"21 de agosto de 1994"
30,5,110,2571,348,346,694,"21 de agosto de 1994"
30,5,110,2572,129,101,230,"21 de agosto de 1994"
30,5,110,2573,297,304,601,"21 de agosto de 1994"
30,5,110,2574,124,124,248,"21 de agosto de 1994"
30,5,110,2575,263,259,522,"21 de agosto de 1994"
30,5,110,2576,278,272,550,"21 de agosto de 1994"
30,5,110,2577,251,231,482,"21 de agosto de 1994"
30,5,115,2610,370,385,755,"21 de agosto de 1994"
30,5,115,2611,361,404,765,"21 de agosto de 1994"
30,5,115,2612,219,230,449,"21 de agosto de 1994"
30,5,115,2613,395,350,745,"21 de agosto de 1994"
30,5,115,2614,368,365,733,"21 de agosto de 1994"
30,5,115,2615,74,68,142,"21 de agosto de 1994"
30,5,115,2616,118,105,223,"21 de agosto de 1994"
30,5,115,2617,392,303,695,"21 de agosto de 1994"
30,5,115,2618,255,192,447,"21 de agosto de 1994"
30,5,115,2619,196,146,342,"21 de agosto de 1994"
30,5,115,2620,255,249,504,"21 de agosto de 1994"
30,5,129,3036,229,270,499,"21 de agosto de 1994"
30,5,129,3037,419,512,931,"21 de agosto de 1994"
30,5,129,3038,419,459,878,"21 de agosto de 1994"
30,5,129,3039,764,871,1635,"21 de agosto de 1994"
30,5,129,3040,601,764,1365,"21 de agosto de 1994"
30,5,129,3041,555,691,1246,"21 de agosto de 1994"
30,5,129,3042,336,408,744,"21 de agosto de 1994"
30,5,129,3043,664,738,1402,"21 de agosto de 1994"
30,5,129,3044,549,710,1259,"21 de agosto de 1994"
30,5,129,3045,581,648,1229,"21 de agosto de 1994"
30,5,129,3046,554,662,1216,"21 de agosto de 1994"
30,5,129,3047,487,551,1038,"21 de agosto de 1994"
30,5,129,3048,96,82,178,"21 de agosto de 1994"
30,5,129,3049,301,324,625,"21 de agosto de 1994"
30,5,129,3050,123,120,243,"21 de agosto de 1994"
30,5,129,3051,555,558,1113,"21 de agosto de 1994"
30,5,129,3052,436,386,822,"21 de agosto de 1994"
30,5,129,3053,192,186,378,"21 de agosto de 1994"
30,5,129,3054,152,161,313,"21 de agosto de 1994"
30,5,129,3055,71,60,131,"21 de agosto de 1994"
30,5,129,3056,193,180,373,"21 de agosto de 1994"
30,5,129,3057,312,339,651,"21 de agosto de 1994"
30,5,129,3058,627,566,1193,"21 de agosto de 1994"
30,5,129,3059,85,93,178,"21 de agosto de 1994"
30,5,129,3060,180,165,345,"21 de agosto de 1994"
30,5,129,3061,428,411,839,"21 de agosto de 1994"
30,5,129,3062,339,314,653,"21 de agosto de 1994"
30,5,129,3063,180,188,368,"21 de agosto de 1994"
30,5,129,3064,95,89,184,"21 de agosto de 1994"
30,5,129,3065,269,188,457,"21 de agosto de 1994"
30,5,129,3066,291,342,633,"21 de agosto de 1994"
30,5,137,3286,658,691,1349,"21 de agosto de 1994"
30,5,137,3287,628,653,1281,"21 de agosto de 1994"
30,5,137,3288,481,540,1021,"21 de agosto de 1994"
30,5,137,3289,431,483,914,"21 de agosto de 1994"
30,5,137,3290,215,194,409,"21 de agosto de 1994"
30,5,137,3291,238,215,453,"21 de agosto de 1994"
30,5,137,3292,363,327,690,"21 de agosto de 1994"
30,5,137,3293,252,205,457,"21 de agosto de 1994"
30,5,157,3669,239,241,480,"21 de agosto de 1994"
30,5,157,3670,361,249,610,"21 de agosto de 1994"
30,5,157,3671,326,288,614,"21 de agosto de 1994"
30,5,157,3672,176,154,330,"21 de agosto de 1994"
30,5,162,3739,345,386,731,"21 de agosto de 1994"
30,5,162,3740,300,296,596,"21 de agosto de 1994"
30,5,162,3741,104,80,184,"21 de agosto de 1994"
30,5,162,3742,349,340,689,"21 de agosto de 1994"
30,5,162,3743,92,93,185,"21 de agosto de 1994"
30,5,162,3744,33,34,67,"21 de agosto de 1994"
30,5,176,3979,330,342,672,"21 de agosto de 1994"
30,5,176,3980,306,228,534,"21 de agosto de 1994"
30,5,176,3981,361,295,656,"21 de agosto de 1994"
30,5,176,3982,372,331,703,"21 de agosto de 1994"
30,5,176,3983,159,134,293,"21 de agosto de 1994"
30,5,176,3984,380,363,743,"21 de agosto de 1994"
30,5,186,4083,278,310,588,"21 de agosto de 1994"
30,5,186,4084,444,415,859,"21 de agosto de 1994"
30,5,186,4085,260,247,507,"21 de agosto de 1994"
30,5,191,4196,445,410,855,"21 de agosto de 1994"
30,5,191,4197,551,584,1135,"21 de agosto de 1994"
30,5,191,4198,338,294,632,"21 de agosto de 1994"
30,5,191,4199,556,584,1140,"21 de agosto de 1994"
30,5,191,4200,201,201,402,"21 de agosto de 1994"
30,5,191,4201,188,162,350,"21 de agosto de 1994"
30,5,191,4202,350,338,688,"21 de agosto de 1994"
30,5,191,4203,119,77,196,"21 de agosto de 1994"
30,5,191,4204,129,115,244,"21 de agosto de 1994"
30,5,191,4205,170,160,330,"21 de agosto de 1994"
30,5,191,4206,119,96,215,"21 de agosto de 1994"
30,5,191,4207,140,121,261,"21 de agosto de 1994"
30,5,191,4208,334,334,668,"21 de agosto de 1994"
30,5,191,4209,348,374,722,"21 de agosto de 1994"
30,5,191,4210,181,204,385,"21 de agosto de 1994"
30,5,191,4211,408,410,818,"21 de agosto de 1994"
30,5,191,4212,356,338,694,"21 de agosto de 1994"
30,5,191,4213,72,59,131,"21 de agosto de 1994"
30,5,191,4214,158,150,308,"21 de agosto de 1994"
30,5,191,4215,139,85,224,"21 de agosto de 1994"
30,5,191,4216,140,105,245,"21 de agosto de 1994"
30,5,193,4501,317,363,680,"21 de agosto de 1994"
30,5,193,4502,384,376,760,"21 de agosto de 1994"
30,5,193,4503,119,129,248,"21 de agosto de 1994"
30,5,193,4504,423,414,837,"21 de agosto de 1994"
30,5,193,4505,408,376,784,"21 de agosto de 1994"
30,5,197,4541,494,506,1000,"21 de agosto de 1994"
30,5,197,4542,213,251,464,"21 de agosto de 1994"
30,5,197,4543,292,345,637,"21 de agosto de 1994"
30,5,197,4544,202,196,398,"21 de agosto de 1994"
30,5,197,4545,291,289,580,"21 de agosto de 1994"
30,5,197,4546,469,476,945,"21 de agosto de 1994"
30,5,197,4547,392,374,766,"21 de agosto de 1994"
30,5,197,4548,130,79,209,"21 de agosto de 1994"
30,5,197,4549,217,197,414,"21 de agosto de 1994"
30,5,197,4550,446,386,832,"21 de agosto de 1994"
30,6,2,5,347,391,738,"21 de agosto de 1994"
30,6,2,6,399,403,802,"21 de agosto de 1994"
30,6,89,1848,491,615,1106,"21 de agosto de 1994"
30,6,89,1849,350,403,753,"21 de agosto de 1994"
30,6,89,1850,570,668,1238,"21 de agosto de 1994"
30,6,89,1851,470,485,955,"21 de agosto de 1994"
30,6,89,1852,368,403,771,"21 de agosto de 1994"
30,6,89,1853,316,408,724,"21 de agosto de 1994"
30,6,89,1854,300,383,683,"21 de agosto de 1994"
30,6,89,1855,368,429,797,"21 de agosto de 1994"
30,6,89,1856,378,440,818,"21 de agosto de 1994"
30,6,89,1857,324,365,689,"21 de agosto de 1994"
30,6,89,1858,361,394,755,"21 de agosto de 1994"
30,6,89,1859,297,344,641,"21 de agosto de 1994"
30,6,89,1860,301,348,649,"21 de agosto de 1994"
30,6,89,1861,247,280,527,"21 de agosto de 1994"
30,6,89,1862,230,260,490,"21 de agosto de 1994"
30,6,89,1863,369,357,726,"21 de agosto de 1994"
30,6,89,1864,214,204,418,"21 de agosto de 1994"
30,6,89,1865,356,394,750,"21 de agosto de 1994"
30,6,89,1866,322,358,680,"21 de agosto de 1994"
30,6,89,1867,338,400,738,"21 de agosto de 1994"
30,6,89,1868,314,341,655,"21 de agosto de 1994"
30,6,89,1869,354,430,784,"21 de agosto de 1994"
30,6,89,1870,367,446,813,"21 de agosto de 1994"
30,6,89,1871,247,322,569,"21 de agosto de 1994"
30,6,89,1872,284,311,595,"21 de agosto de 1994"
30,6,89,1873,179,195,374,"21 de agosto de 1994"
30,6,89,1874,415,440,855,"21 de agosto de 1994"
30,6,89,1875,639,702,1341,"21 de agosto de 1994"
30,6,89,1876,243,294,537,"21 de agosto de 1994"
30,6,89,1877,367,410,777,"21 de agosto de 1994"
30,6,89,1878,281,362,643,"21 de agosto de 1994"
30,6,89,1879,578,715,1293,"21 de agosto de 1994"
30,6,89,1880,390,446,836,"21 de agosto de 1994"
30,6,89,1881,362,425,787,"21 de agosto de 1994"
30,6,89,1882,537,639,1176,"21 de agosto de 1994"
30,6,89,1883,362,401,763,"21 de agosto de 1994"
30,6,89,1884,443,521,964,"21 de agosto de 1994"
30,6,89,1885,472,534,1006,"21 de agosto de 1994"
30,6,89,1886,377,428,805,"21 de agosto de 1994"
30,6,89,1887,372,456,828,"21 de agosto de 1994"
30,6,89,1888,340,402,742,"21 de agosto de 1994"
30,6,89,1889,460,511,971,"21 de agosto de 1994"
30,6,89,1890,409,504,913,"21 de agosto de 1994"
30,6,89,1891,272,366,638,"21 de agosto de 1994"
30,6,89,1892,275,336,611,"21 de agosto de 1994"
30,6,89,1893,278,332,610,"21 de agosto de 1994"
30,6,89,1894,263,306,569,"21 de agosto de 1994"
30,6,89,1895,389,439,828,"21 de agosto de 1994"
30,6,89,1896,306,333,639,"21 de agosto de 1994"
30,6,89,1897,331,238,569,"21 de agosto de 1994"
30,6,89,1898,321,405,726,"21 de agosto de 1994"
30,6,89,1899,428,559,987,"21 de agosto de 1994"
30,6,89,1900,345,462,807,"21 de agosto de 1994"
30,6,89,1901,500,606,1106,"21 de agosto de 1994"
30,6,89,1902,363,428,791,"21 de agosto de 1994"
30,6,89,1903,487,545,1032,"21 de agosto de 1994"
30,6,89,1904,283,307,590,"21 de agosto de 1994"
30,6,89,1905,421,503,924,"21 de agosto de 1994"
30,6,89,1906,286,358,644,"21 de agosto de 1994"
30,6,89,1907,469,624,1093,"21 de agosto de 1994"
30,6,89,1908,501,545,1046,"21 de agosto de 1994"
30,6,89,1909,220,266,486,"21 de agosto de 1994"
30,6,89,1910,365,412,777,"21 de agosto de 1994"
30,6,89,1911,342,419,761,"21 de agosto de 1994"
30,6,89,1912,439,515,954,"21 de agosto de 1994"
30,6,89,1913,385,508,893,"21 de agosto de 1994"
30,6,89,1914,436,546,982,"21 de agosto de 1994"
30,6,89,1915,376,407,783,"21 de agosto de 1994"
30,6,89,1916,479,543,1022,"21 de agosto de 1994"
30,6,89,1917,411,490,901,"21 de agosto de 1994"
30,6,89,1918,411,471,882,"21 de agosto de 1994"
30,6,89,1919,272,309,581,"21 de agosto de 1994"
30,6,89,1920,293,377,670,"21 de agosto de 1994"
30,6,89,1921,315,355,670,"21 de agosto de 1994"
30,6,89,1922,305,330,635,"21 de agosto de 1994"
30,6,89,1923,379,385,764,"21 de agosto de 1994"
30,6,89,1924,274,317,591,"21 de agosto de 1994"
30,6,89,1925,418,480,898,"21 de agosto de 1994"
30,6,89,1926,384,505,889,"21 de agosto de 1994"
30,6,89,1927,334,429,763,"21 de agosto de 1994"
30,6,89,1928,405,485,890,"21 de agosto de 1994"
30,6,89,1929,321,393,714,"21 de agosto de 1994"
30,6,89,1930,259,329,588,"21 de agosto de 1994"
30,6,89,1931,265,325,590,"21 de agosto de 1994"
30,6,89,1932,328,439,767,"21 de agosto de 1994"
30,6,89,1933,378,475,853,"21 de agosto de 1994"
30,6,89,1934,305,395,700,"21 de agosto de 1994"
30,6,89,1935,223,284,507,"21 de agosto de 1994"
30,6,89,1936,331,473,804,"21 de agosto de 1994"
30,6,89,1937,499,622,1121,"21 de agosto de 1994"
30,6,89,1938,457,581,1038,"21 de agosto de 1994"
30,6,89,1939,399,461,860,"21 de agosto de 1994"
30,6,89,1940,467,549,1016,"21 de agosto de 1994"
30,6,89,1941,277,330,607,"21 de agosto de 1994"
30,6,89,1942,355,452,807,"21 de agosto de 1994"
30,6,89,1943,277,371,648,"21 de agosto de 1994"
30,6,89,1944,485,602,1087,"21 de agosto de 1994"
30,6,89,1945,230,294,524,"21 de agosto de 1994"
30,6,89,1946,314,409,723,"21 de agosto de 1994"
30,6,89,1947,315,411,726,"21 de agosto de 1994"
30,6,89,1948,374,447,821,"21 de agosto de 1994"
30,6,89,1949,329,378,707,"21 de agosto de 1994"
30,6,89,1950,268,342,610,"21 de agosto de 1994"
30,6,89,1951,568,659,1227,"21 de agosto de 1994"
30,6,89,1952,245,332,577,"21 de agosto de 1994"
30,6,89,1953,310,424,734,"21 de agosto de 1994"
30,6,89,1954,216,293,509,"21 de agosto de 1994"
30,6,89,1955,393,525,918,"21 de agosto de 1994"
30,6,89,1956,523,644,1167,"21 de agosto de 1994"
30,6,89,1957,378,445,823,"21 de agosto de 1994"
30,6,89,1958,366,421,787,"21 de agosto de 1994"
30,6,89,1959,342,415,757,"21 de agosto de 1994"
30,6,89,1960,375,431,806,"21 de agosto de 1994"
30,6,89,1961,344,393,737,"21 de agosto de 1994"
30,6,89,1962,380,465,845,"21 de agosto de 1994"
30,6,89,1963,244,319,563,"21 de agosto de 1994"
30,6,89,1964,340,436,776,"21 de agosto de 1994"
30,6,89,1965,332,402,734,"21 de agosto de 1994"
30,6,89,1966,387,500,887,"21 de agosto de 1994"
30,6,89,1967,318,380,698,"21 de agosto de 1994"
30,6,89,1968,415,511,926,"21 de agosto de 1994"
30,6,89,1969,291,337,628,"21 de agosto de 1994"
30,6,89,1970,540,637,1177,"21 de agosto de 1994"
30,6,89,1971,410,510,920,"21 de agosto de 1994"
30,6,89,1972,458,556,1014,"21 de agosto de 1994"
30,6,89,1973,520,654,1174,"21 de agosto de 1994"
30,6,89,1974,332,358,690,"21 de agosto de 1994"
30,6,89,1975,275,356,631,"21 de agosto de 1994"
30,6,89,1976,370,468,838,"21 de agosto de 1994"
30,6,89,1977,268,322,590,"21 de agosto de 1994"
30,6,89,1978,292,427,719,"21 de agosto de 1994"
30,6,89,1979,267,375,642,"21 de agosto de 1994"
30,6,89,1980,234,326,560,"21 de agosto de 1994"
30,6,89,1981,269,348,617,"21 de agosto de 1994"
30,6,89,1982,268,349,617,"21 de agosto de 1994"
30,6,89,1983,357,416,773,"21 de agosto de 1994"
30,6,89,1984,307,398,705,"21 de agosto de 1994"
30,6,89,1985,396,438,834,"21 de agosto de 1994"
30,6,89,1986,254,298,552,"21 de agosto de 1994"
30,6,89,1987,285,307,592,"21 de agosto de 1994"
30,6,89,1988,300,359,659,"21 de agosto de 1994"
30,6,89,1989,331,464,795,"21 de agosto de 1994"
30,6,89,1990,279,328,607,"21 de agosto de 1994"
30,6,89,1991,282,353,635,"21 de agosto de 1994"
30,6,89,1992,286,380,666,"21 de agosto de 1994"
30,6,89,1993,287,403,690,"21 de agosto de 1994"
30,6,89,1994,448,575,1023,"21 de agosto de 1994"
30,6,89,1995,277,399,676,"21 de agosto de 1994"
30,6,89,1996,393,547,940,"21 de agosto de 1994"
30,6,89,1997,268,385,653,"21 de agosto de 1994"
30,6,89,1998,250,312,562,"21 de agosto de 1994"
30,6,89,1999,379,449,828,"21 de agosto de 1994"
30,6,89,2000,369,477,846,"21 de agosto de 1994"
30,6,89,2001,307,386,693,"21 de agosto de 1994"
30,6,89,2002,340,408,748,"21 de agosto de 1994"
30,6,89,2003,483,585,1068,"21 de agosto de 1994"
30,6,89,2004,475,636,1111,"21 de agosto de 1994"
30,6,89,2005,574,712,1286,"21 de agosto de 1994"
30,6,89,2006,289,355,644,"21 de agosto de 1994"
30,6,89,2007,321,434,755,"21 de agosto de 1994"
30,6,89,2008,336,425,761,"21 de agosto de 1994"
30,6,89,2009,237,331,568,"21 de agosto de 1994"
30,6,89,2010,295,421,716,"21 de agosto de 1994"
30,6,89,2011,296,400,696,"21 de agosto de 1994"
30,6,89,2012,335,451,786,"21 de agosto de 1994"
30,6,89,2013,324,355,679,"21 de agosto de 1994"
30,6,89,2014,407,443,850,"21 de agosto de 1994"
30,6,89,2015,430,500,930,"21 de agosto de 1994"
30,6,89,2016,377,477,854,"21 de agosto de 1994"
30,6,89,2017,426,563,989,"21 de agosto de 1994"
30,6,89,2018,289,355,644,"21 de agosto de 1994"
30,6,89,2019,410,578,988,"21 de agosto de 1994"
30,6,89,2020,432,632,1064,"21 de agosto de 1994"
30,6,89,2021,442,542,984,"21 de agosto de 1994"
30,6,89,2022,189,265,454,"21 de agosto de 1994"
30,6,89,2023,347,426,773,"21 de agosto de 1994"
30,6,89,2024,447,541,988,"21 de agosto de 1994"
30,6,89,2025,498,580,1078,"21 de agosto de 1994"
30,6,89,2026,424,494,918,"21 de agosto de 1994"
30,6,89,2027,386,480,866,"21 de agosto de 1994"
30,6,89,2028,397,447,844,"21 de agosto de 1994"
30,6,89,2029,396,480,876,"21 de agosto de 1994"
30,6,89,2030,337,436,773,"21 de agosto de 1994"
30,6,89,2031,393,513,906,"21 de agosto de 1994"
30,6,89,2032,272,386,658,"21 de agosto de 1994"
30,6,89,2033,198,290,488,"21 de agosto de 1994"
30,6,89,2034,392,507,899,"21 de agosto de 1994"
30,6,89,2035,384,512,896,"21 de agosto de 1994"
30,6,89,2036,428,537,965,"21 de agosto de 1994"
30,6,89,2037,216,257,473,"21 de agosto de 1994"
30,6,89,2038,462,567,1029,"21 de agosto de 1994"
30,6,89,2039,251,306,557,"21 de agosto de 1994"
30,6,89,2040,363,402,765,"21 de agosto de 1994"
30,6,89,2041,319,359,678,"21 de agosto de 1994"
30,6,89,2042,319,417,736,"21 de agosto de 1994"
30,6,89,2043,266,352,618,"21 de agosto de 1994"
30,6,89,2044,291,343,634,"21 de agosto de 1994"
30,6,89,2045,279,410,689,"21 de agosto de 1994"
30,6,89,2046,279,403,682,"21 de agosto de 1994"
30,6,89,2047,224,332,556,"21 de agosto de 1994"
30,6,89,2048,372,548,920,"21 de agosto de 1994"
30,6,89,2049,363,514,877,"21 de agosto de 1994"
30,6,89,2050,330,463,793,"21 de agosto de 1994"
30,6,89,2051,327,401,728,"21 de agosto de 1994"
30,6,89,2052,308,359,667,"21 de agosto de 1994"
30,6,89,2053,244,264,508,"21 de agosto de 1994"
30,6,89,2054,411,485,896,"21 de agosto de 1994"
30,6,89,2055,385,485,870,"21 de agosto de 1994"
30,6,89,2056,336,390,726,"21 de agosto de 1994"
30,6,89,2057,189,249,438,"21 de agosto de 1994"
30,6,89,2058,250,351,601,"21 de agosto de 1994"
30,6,89,2059,398,519,917,"21 de agosto de 1994"
30,6,89,2060,284,393,677,"21 de agosto de 1994"
30,6,89,2061,359,474,833,"21 de agosto de 1994"
30,6,89,2062,243,368,611,"21 de agosto de 1994"
30,6,89,2063,260,348,608,"21 de agosto de 1994"
30,6,89,2064,409,455,864,"21 de agosto de 1994"
30,6,89,2065,371,440,811,"21 de agosto de 1994"
30,6,89,2066,324,487,811,"21 de agosto de 1994"
30,6,89,2067,386,473,859,"21 de agosto de 1994"
30,6,89,2068,369,418,787,"21 de agosto de 1994"
30,6,89,2069,189,267,456,"21 de agosto de 1994"
30,6,89,2070,283,364,647,"21 de agosto de 1994"
30,6,89,2071,147,212,359,"21 de agosto de 1994"
30,6,89,2072,313,336,649,"21 de agosto de 1994"
30,6,89,2073,233,326,559,"21 de agosto de 1994"
30,6,89,2074,64,91,155,"21 de agosto de 1994"
30,6,89,2075,421,479,900,"21 de agosto de 1994"
30,6,89,2076,328,411,739,"21 de agosto de 1994"
30,6,89,2077,305,377,682,"21 de agosto de 1994"
30,6,89,2078,150,211,361,"21 de agosto de 1994"
30,6,89,2079,213,247,460,"21 de agosto de 1994"
30,6,89,2080,261,315,576,"21 de agosto de 1994"
30,6,89,2081,463,482,945,"21 de agosto de 1994"
30,6,89,2082,309,345,654,"21 de agosto de 1994"
30,6,89,2083,391,478,869,"21 de agosto de 1994"
30,6,89,2084,307,342,649,"21 de agosto de 1994"
30,6,89,2085,380,457,837,"21 de agosto de 1994"
30,6,89,2086,931,1197,2128,"21 de agosto de 1994"
30,6,89,2087,286,298,584,"21 de agosto de 1994"
30,6,89,2088,292,342,634,"21 de agosto de 1994"
30,6,89,2089,355,372,727,"21 de agosto de 1994"
30,6,89,2090,117,146,263,"21 de agosto de 1994"
30,6,89,2091,121,152,273,"21 de agosto de 1994"
30,6,89,2092,534,525,1059,"21 de agosto de 1994"
30,6,89,2093,303,289,592,"21 de agosto de 1994"
30,6,89,2094,215,202,417,"21 de agosto de 1994"
30,6,89,2095,471,460,931,"21 de agosto de 1994"
30,6,89,2096,495,465,960,"21 de agosto de 1994"
30,6,89,2097,139,126,265,"21 de agosto de 1994"
30,6,89,2098,68,72,140,"21 de agosto de 1994"
30,6,89,2099,73,80,153,"21 de agosto de 1994"
30,6,89,2100,165,216,381,"21 de agosto de 1994"
30,6,113,2594,437,487,924,"21 de agosto de 1994"
30,6,113,2595,392,417,809,"21 de agosto de 1994"
30,6,113,2596,440,464,904,"21 de agosto de 1994"
30,6,113,2597,364,418,782,"21 de agosto de 1994"
30,6,113,2598,334,352,686,"21 de agosto de 1994"
30,6,113,2599,273,276,549,"21 de agosto de 1994"
30,6,113,2600,114,117,231,"21 de agosto de 1994"
30,6,113,2601,394,388,782,"21 de agosto de 1994"
30,6,113,2602,255,201,456,"21 de agosto de 1994"
30,6,113,2603,547,532,1079,"21 de agosto de 1994"
30,6,113,2604,313,278,591,"21 de agosto de 1994"
30,6,113,2605,431,368,799,"21 de agosto de 1994"
30,6,113,2606,262,233,495,"21 de agosto de 1994"
30,6,165,3757,714,595,1309,"21 de agosto de 1994"
30,6,165,3758,178,123,301,"21 de agosto de 1994"
30,6,165,3759,438,350,788,"21 de agosto de 1994"
30,6,165,3760,243,205,448,"21 de agosto de 1994"
30,6,165,3761,481,438,919,"21 de agosto de 1994"
30,6,165,3762,245,192,437,"21 de agosto de 1994"
30,7,4,47,457,453,910,"21 de agosto de 1994"
30,7,4,48,419,435,854,"21 de agosto de 1994"
30,7,4,49,461,436,897,"21 de agosto de 1994"
30,7,4,50,390,328,718,"21 de agosto de 1994"
30,7,4,51,566,500,1066,"21 de agosto de 1994"
30,7,4,52,624,626,1250,"21 de agosto de 1994"
30,7,4,53,430,388,818,"21 de agosto de 1994"
30,7,4,54,134,102,236,"21 de agosto de 1994"
30,7,4,55,303,259,562,"21 de agosto de 1994"
30,7,4,56,258,248,506,"21 de agosto de 1994"
30,7,4,57,357,335,692,"21 de agosto de 1994"
30,7,4,58,214,211,425,"21 de agosto de 1994"
30,7,4,59,222,246,468,"21 de agosto de 1994"
30,7,4,60,328,322,650,"21 de agosto de 1994"
30,7,4,61,397,398,795,"21 de agosto de 1994"
30,7,4,62,247,217,464,"21 de agosto de 1994"
30,7,4,63,371,345,716,"21 de agosto de 1994"
30,7,4,64,105,92,197,"21 de agosto de 1994"
30,7,4,65,261,221,482,"21 de agosto de 1994"
30,7,4,66,248,176,424,"21 de agosto de 1994"
30,7,4,67,339,290,629,"21 de agosto de 1994"
30,7,4,68,409,356,765,"21 de agosto de 1994"
30,7,4,69,488,429,917,"21 de agosto de 1994"
30,7,4,70,386,297,683,"21 de agosto de 1994"
30,7,4,71,315,277,592,"21 de agosto de 1994"
30,7,4,72,245,230,475,"21 de agosto de 1994"
30,7,4,73,220,229,449,"21 de agosto de 1994"
30,7,4,74,328,336,664,"21 de agosto de 1994"
30,7,4,75,333,328,661,"21 de agosto de 1994"
30,7,4,76,577,554,1131,"21 de agosto de 1994"
30,7,4,77,338,287,625,"21 de agosto de 1994"
30,7,4,78,143,137,280,"21 de agosto de 1994"
30,7,4,79,195,134,329,"21 de agosto de 1994"
30,7,4,80,99,83,182,"21 de agosto de 1994"
30,7,4,81,150,123,273,"21 de agosto de 1994"
30,7,4,82,46,49,95,"21 de agosto de 1994"
30,7,4,83,306,272,578,"21 de agosto de 1994"
30,7,4,84,493,451,944,"21 de agosto de 1994"
30,7,10,183,333,319,652,"21 de agosto de 1994"
30,7,10,184,443,409,852,"21 de agosto de 1994"
30,7,10,185,226,235,461,"21 de agosto de 1994"
30,7,10,186,441,405,846,"21 de agosto de 1994"
30,7,10,187,229,183,412,"21 de agosto de 1994"
30,7,10,188,119,100,219,"21 de agosto de 1994"
30,7,10,189,71,69,140,"21 de agosto de 1994"
30,7,10,190,125,93,218,"21 de agosto de 1994"
30,7,10,191,157,132,289,"21 de agosto de 1994"
30,7,10,192,284,255,539,"21 de agosto de 1994"
30,7,10,193,136,129,265,"21 de agosto de 1994"
30,7,10,194,142,125,267,"21 de agosto de 1994"
30,7,10,195,46,5,51,"21 de agosto de 1994"
30,7,10,196,21,0,21,"21 de agosto de 1994"
30,7,10,197,470,444,914,"21 de agosto de 1994"
30,7,10,198,219,219,438,"21 de agosto de 1994"
30,7,10,199,169,138,307,"21 de agosto de 1994"
30,7,10,200,245,211,456,"21 de agosto de 1994"
30,7,10,201,159,137,296,"21 de agosto de 1994"
30,7,10,202,393,322,715,"21 de agosto de 1994"
30,7,10,203,104,90,194,"21 de agosto de 1994"
30,7,10,204,203,161,364,"21 de agosto de 1994"
30,7,10,205,67,61,128,"21 de agosto de 1994"
30,7,10,206,311,277,588,"21 de agosto de 1994"
30,7,10,207,254,174,428,"21 de agosto de 1994"
30,7,10,208,213,171,384,"21 de agosto de 1994"
30,7,10,209,235,172,407,"21 de agosto de 1994"
30,7,10,210,196,159,355,"21 de agosto de 1994"
30,7,10,211,335,311,646,"21 de agosto de 1994"
30,7,10,212,310,288,598,"21 de agosto de 1994"
30,7,10,213,150,152,302,"21 de agosto de 1994"
30,7,10,214,176,145,321,"21 de agosto de 1994"
30,7,10,215,472,406,878,"21 de agosto de 1994"
30,7,10,216,360,251,611,"21 de agosto de 1994"
30,7,10,217,266,224,490,"21 de agosto de 1994"
30,7,17,363,333,377,710,"21 de agosto de 1994"
30,7,17,364,262,253,515,"21 de agosto de 1994"
30,7,17,365,397,403,800,"21 de agosto de 1994"
30,7,17,366,261,286,547,"21 de agosto de 1994"
30,7,17,367,477,491,968,"21 de agosto de 1994"
30,7,17,368,452,479,931,"21 de agosto de 1994"
30,7,17,369,255,276,531,"21 de agosto de 1994"
30,7,17,370,246,276,522,"21 de agosto de 1994"
30,7,17,371,304,336,640,"21 de agosto de 1994"
30,7,17,372,215,253,468,"21 de agosto de 1994"
30,7,17,373,350,324,674,"21 de agosto de 1994"
30,7,17,374,413,466,879,"21 de agosto de 1994"
30,7,17,375,417,428,845,"21 de agosto de 1994"
30,7,17,376,355,351,706,"21 de agosto de 1994"
30,7,17,377,384,404,788,"21 de agosto de 1994"
30,7,17,378,258,273,531,"21 de agosto de 1994"
30,7,17,379,318,311,629,"21 de agosto de 1994"
30,7,17,380,223,211,434,"21 de agosto de 1994"
30,7,17,381,342,307,649,"21 de agosto de 1994"
30,7,17,382,170,192,362,"21 de agosto de 1994"
30,7,17,383,209,194,403,"21 de agosto de 1994"
30,7,18,384,285,300,585,"21 de agosto de 1994"
30,7,18,385,405,371,776,"21 de agosto de 1994"
30,7,18,386,252,242,494,"21 de agosto de 1994"
30,7,18,387,174,125,299,"21 de agosto de 1994"
30,7,18,388,68,43,111,"21 de agosto de 1994"
30,7,27,473,352,397,749,"21 de agosto de 1994"
30,7,27,474,330,331,661,"21 de agosto de 1994"
30,7,27,475,267,275,542,"21 de agosto de 1994"
30,7,27,476,492,598,1090,"21 de agosto de 1994"
30,7,27,477,449,545,994,"21 de agosto de 1994"
30,7,27,478,455,508,963,"21 de agosto de 1994"
30,7,27,479,420,476,896,"21 de agosto de 1994"
30,7,27,480,293,334,627,"21 de agosto de 1994"
30,7,27,481,438,442,880,"21 de agosto de 1994"
30,7,40,712,339,329,668,"21 de agosto de 1994"
30,7,40,713,310,322,632,"21 de agosto de 1994"
30,7,40,714,319,310,629,"21 de agosto de 1994"
30,7,40,715,503,558,1061,"21 de agosto de 1994"
30,7,40,716,512,568,1080,"21 de agosto de 1994"
30,7,40,717,373,421,794,"21 de agosto de 1994"
30,7,40,718,204,236,440,"21 de agosto de 1994"
30,7,40,719,312,329,641,"21 de agosto de 1994"
30,7,40,720,476,528,1004,"21 de agosto de 1994"
30,7,40,721,422,492,914,"21 de agosto de 1994"
30,7,40,722,268,333,601,"21 de agosto de 1994"
30,7,40,723,383,514,897,"21 de agosto de 1994"
30,7,40,724,327,450,777,"21 de agosto de 1994"
30,7,40,725,354,443,797,"21 de agosto de 1994"
30,7,40,726,318,405,723,"21 de agosto de 1994"
30,7,40,727,341,439,780,"21 de agosto de 1994"
30,7,40,728,479,568,1047,"21 de agosto de 1994"
30,7,40,729,513,606,1119,"21 de agosto de 1994"
30,7,40,730,309,329,638,"21 de agosto de 1994"
30,7,40,731,441,502,943,"21 de agosto de 1994"
30,7,40,732,365,402,767,"21 de agosto de 1994"
30,7,40,733,275,322,597,"21 de agosto de 1994"
30,7,40,734,353,431,784,"21 de agosto de 1994"
30,7,40,735,333,395,728,"21 de agosto de 1994"
30,7,40,736,356,415,771,"21 de agosto de 1994"
30,7,40,737,238,275,513,"21 de agosto de 1994"
30,7,40,738,228,243,471,"21 de agosto de 1994"
30,7,40,739,273,295,568,"21 de agosto de 1994"
30,7,40,740,324,339,663,"21 de agosto de 1994"
30,7,40,741,294,338,632,"21 de agosto de 1994"
30,7,40,742,365,375,740,"21 de agosto de 1994"
30,7,40,743,98,54,152,"21 de agosto de 1994"
30,7,40,744,441,396,837,"21 de agosto de 1994"
30,7,40,745,387,416,803,"21 de agosto de 1994"
30,7,40,746,447,486,933,"21 de agosto de 1994"
30,7,40,747,327,313,640,"21 de agosto de 1994"
30,7,40,748,248,245,493,"21 de agosto de 1994"
30,7,40,749,481,522,1003,"21 de agosto de 1994"
30,7,40,750,401,355,756,"21 de agosto de 1994"
30,7,40,751,459,463,922,"21 de agosto de 1994"
30,7,40,752,272,276,548,"21 de agosto de 1994"
30,7,40,753,389,390,779,"21 de agosto de 1994"
30,7,40,754,438,460,898,"21 de agosto de 1994"
30,7,40,755,391,419,810,"21 de agosto de 1994"
30,7,40,756,269,315,584,"21 de agosto de 1994"
30,7,40,757,376,400,776,"21 de agosto de 1994"
30,7,40,758,368,401,769,"21 de agosto de 1994"
30,7,40,759,366,332,698,"21 de agosto de 1994"
30,7,40,760,278,308,586,"21 de agosto de 1994"
30,7,40,761,232,242,474,"21 de agosto de 1994"
30,7,40,762,122,118,240,"21 de agosto de 1994"
30,7,67,1475,200,192,392,"21 de agosto de 1994"
30,7,67,1476,280,222,502,"21 de agosto de 1994"
30,7,67,1477,346,293,639,"21 de agosto de 1994"
30,7,67,1478,240,213,453,"21 de agosto de 1994"
30,7,67,1479,383,351,734,"21 de agosto de 1994"
30,7,67,1480,590,152,742,"21 de agosto de 1994"
30,7,67,1481,370,334,704,"21 de agosto de 1994"
30,7,67,1482,341,317,658,"21 de agosto de 1994"
30,7,67,1483,290,277,567,"21 de agosto de 1994"
30,7,67,1484,324,339,663,"21 de agosto de 1994"
30,7,67,1485,462,467,929,"21 de agosto de 1994"
30,7,67,1486,84,89,173,"21 de agosto de 1994"
30,7,67,1487,656,635,1291,"21 de agosto de 1994"
30,7,67,1488,456,390,846,"21 de agosto de 1994"
30,7,67,1489,74,53,127,"21 de agosto de 1994"
30,7,67,1490,179,172,351,"21 de agosto de 1994"
30,7,67,1491,377,337,714,"21 de agosto de 1994"
30,7,67,1492,71,67,138,"21 de agosto de 1994"
30,7,67,1493,284,298,582,"21 de agosto de 1994"
30,7,67,1494,211,201,412,"21 de agosto de 1994"
30,7,67,1495,520,478,998,"21 de agosto de 1994"
30,7,67,1496,261,217,478,"21 de agosto de 1994"
30,7,67,1497,298,282,580,"21 de agosto de 1994"
30,7,67,1498,336,320,656,"21 de agosto de 1994"
30,7,67,1499,241,185,426,"21 de agosto de 1994"
30,7,67,1500,197,176,373,"21 de agosto de 1994"
30,7,67,1501,119,97,216,"21 de agosto de 1994"
30,7,67,1502,211,236,447,"21 de agosto de 1994"
30,7,67,1503,342,313,655,"21 de agosto de 1994"
30,7,67,1504,397,356,753,"21 de agosto de 1994"
30,7,67,1505,271,248,519,"21 de agosto de 1994"
30,7,67,1506,373,363,736,"21 de agosto de 1994"
30,7,67,1507,284,300,584,"21 de agosto de 1994"
30,7,67,1508,464,489,953,"21 de agosto de 1994"
30,7,67,1509,456,419,875,"21 de agosto de 1994"
30,7,90,2101,389,359,748,"21 de agosto de 1994"
30,7,90,2102,380,338,718,"21 de agosto de 1994"
30,7,90,2103,46,27,73,"21 de agosto de 1994"
30,7,90,2104,470,371,841,"21 de agosto de 1994"
30,7,127,3004,314,308,622,"21 de agosto de 1994"
30,7,127,3005,277,255,532,"21 de agosto de 1994"
30,7,127,3006,376,373,749,"21 de agosto de 1994"
30,7,127,3007,348,368,716,"21 de agosto de 1994"
30,7,127,3008,361,378,739,"21 de agosto de 1994"
30,7,127,3009,374,356,730,"21 de agosto de 1994"
30,7,127,3010,283,229,512,"21 de agosto de 1994"
30,7,127,3011,670,583,1253,"21 de agosto de 1994"
30,7,127,3012,491,471,962,"21 de agosto de 1994"
30,7,127,3013,135,122,257,"21 de agosto de 1994"
30,7,127,3014,381,332,713,"21 de agosto de 1994"
30,7,127,3015,712,693,1405,"21 de agosto de 1994"
30,7,127,3016,512,509,1021,"21 de agosto de 1994"
30,7,127,3017,111,108,219,"21 de agosto de 1994"
30,7,127,3018,435,358,793,"21 de agosto de 1994"
30,7,127,3019,249,263,512,"21 de agosto de 1994"
30,7,127,3020,270,251,521,"21 de agosto de 1994"
30,7,127,3021,340,298,638,"21 de agosto de 1994"
30,7,127,3022,558,499,1057,"21 de agosto de 1994"
30,7,127,3023,345,254,599,"21 de agosto de 1994"
30,7,127,3024,403,418,821,"21 de agosto de 1994"
30,7,127,3025,299,294,593,"21 de agosto de 1994"
30,7,127,3026,283,266,549,"21 de agosto de 1994"
30,7,127,3027,379,338,717,"21 de agosto de 1994"
30,7,134,3259,418,369,787,"21 de agosto de 1994"
30,7,134,3260,92,71,163,"21 de agosto de 1994"
30,7,134,3261,421,473,894,"21 de agosto de 1994"
30,7,134,3262,237,277,514,"21 de agosto de 1994"
30,7,134,3263,375,399,774,"21 de agosto de 1994"
30,7,134,3264,459,426,885,"21 de agosto de 1994"
30,7,134,3265,242,249,491,"21 de agosto de 1994"
30,7,134,3266,254,255,509,"21 de agosto de 1994"
30,7,134,3267,520,488,1008,"21 de agosto de 1994"
30,7,134,3268,199,189,388,"21 de agosto de 1994"
30,7,134,3269,373,303,676,"21 de agosto de 1994"
30,7,134,3270,274,181,455,"21 de agosto de 1994"
30,7,134,3271,212,182,394,"21 de agosto de 1994"
30,7,134,3272,390,314,704,"21 de agosto de 1994"
30,7,134,3273,406,303,709,"21 de agosto de 1994"
30,7,136,3283,459,443,902,"21 de agosto de 1994"
30,7,136,3284,464,458,922,"21 de agosto de 1994"
30,7,136,3285,336,335,671,"21 de agosto de 1994"
30,7,181,4037,282,305,587,"21 de agosto de 1994"
30,7,181,4038,359,320,679,"21 de agosto de 1994"
30,7,181,4039,593,677,1270,"21 de agosto de 1994"
30,7,181,4040,355,288,643,"21 de agosto de 1994"
30,7,181,4041,133,116,249,"21 de agosto de 1994"
30,7,190,4173,641,650,1291,"21 de agosto de 1994"
30,7,190,4174,515,595,1110,"21 de agosto de 1994"
30,7,190,4175,474,483,957,"21 de agosto de 1994"
30,7,190,4176,394,371,765,"21 de agosto de 1994"
30,7,190,4177,379,430,809,"21 de agosto de 1994"
30,7,190,4178,390,372,762,"21 de agosto de 1994"
30,7,190,4179,301,296,597,"21 de agosto de 1994"
30,7,190,4180,203,209,412,"21 de agosto de 1994"
30,7,190,4181,387,401,788,"21 de agosto de 1994"
30,7,190,4182,251,222,473,"21 de agosto de 1994"
30,7,190,4183,345,385,730,"21 de agosto de 1994"
30,7,190,4184,261,280,541,"21 de agosto de 1994"
30,7,190,4185,405,413,818,"21 de agosto de 1994"
30,7,190,4186,374,413,787,"21 de agosto de 1994"
30,7,190,4187,189,182,371,"21 de agosto de 1994"
30,7,190,4188,352,379,731,"21 de agosto de 1994"
30,7,190,4189,381,418,799,"21 de agosto de 1994"
30,7,190,4190,460,462,922,"21 de agosto de 1994"
30,7,190,4191,467,504,971,"21 de agosto de 1994"
30,7,190,4192,313,320,633,"21 de agosto de 1994"
30,7,190,4193,517,479,996,"21 de agosto de 1994"
30,7,190,4194,211,212,423,"21 de agosto de 1994"
30,7,190,4195,383,378,761,"21 de agosto de 1994"
30,7,194,4506,300,278,578,"21 de agosto de 1994"
30,7,194,4507,589,589,1178,"21 de agosto de 1994"
30,7,194,4508,548,548,1096,"21 de agosto de 1994"
30,7,194,4509,405,455,860,"21 de agosto de 1994"
30,7,194,4510,369,409,778,"21 de agosto de 1994"
30,7,194,4511,382,388,770,"21 de agosto de 1994"
30,7,194,4512,497,540,1037,"21 de agosto de 1994"
30,7,194,4513,270,245,515,"21 de agosto de 1994"
30,7,194,4514,379,336,715,"21 de agosto de 1994"
30,7,194,4515,167,133,300,"21 de agosto de 1994"
30,7,194,4516,462,353,815,"21 de agosto de 1994"
30,7,194,4517,173,134,307,"21 de agosto de 1994"
30,7,194,4518,291,263,554,"21 de agosto de 1994"
30,7,194,4519,286,292,578,"21 de agosto de 1994"
30,7,194,4520,210,223,433,"21 de agosto de 1994"
30,7,194,4521,354,371,725,"21 de agosto de 1994"
30,7,194,4522,268,270,538,"21 de agosto de 1994"
30,7,194,4523,352,376,728,"21 de agosto de 1994"
30,7,194,4524,258,232,490,"21 de agosto de 1994"
30,8,7,106,644,626,1270,"21 de agosto de 1994"
30,8,7,107,679,574,1253,"21 de agosto de 1994"
30,8,7,108,372,300,672,"21 de agosto de 1994"
30,8,9,178,542,548,1090,"21 de agosto de 1994"
30,8,9,179,371,334,705,"21 de agosto de 1994"
30,8,9,180,451,467,918,"21 de agosto de 1994"
30,8,9,181,284,273,557,"21 de agosto de 1994"
30,8,9,182,400,333,733,"21 de agosto de 1994"
30,8,25,459,468,421,889,"21 de agosto de 1994"
30,8,25,460,657,558,1215,"21 de agosto de 1994"
30,8,25,461,361,329,690,"21 de agosto de 1994"
30,8,25,462,361,303,664,"21 de agosto de 1994"
30,8,25,463,466,371,837,"21 de agosto de 1994"
30,8,25,464,591,502,1093,"21 de agosto de 1994"
30,8,26,465,569,553,1122,"21 de agosto de 1994"
30,8,26,466,561,571,1132,"21 de agosto de 1994"
30,8,26,467,734,751,1485,"21 de agosto de 1994"
30,8,26,468,409,405,814,"21 de agosto de 1994"
30,8,26,469,508,462,970,"21 de agosto de 1994"
30,8,26,470,469,430,899,"21 de agosto de 1994"
30,8,26,471,569,530,1099,"21 de agosto de 1994"
30,8,26,472,419,438,857,"21 de agosto de 1994"
30,8,30,588,510,492,1002,"21 de agosto de 1994"
30,8,30,589,369,337,706,"21 de agosto de 1994"
30,8,30,590,533,464,997,"21 de agosto de 1994"
30,8,30,591,503,483,986,"21 de agosto de 1994"
30,8,30,592,419,389,808,"21 de agosto de 1994"
30,8,32,609,402,357,759,"21 de agosto de 1994"
30,8,32,610,618,548,1166,"21 de agosto de 1994"
30,8,32,611,304,262,566,"21 de agosto de 1994"
30,8,32,612,344,329,673,"21 de agosto de 1994"
30,8,32,613,388,326,714,"21 de agosto de 1994"
30,8,32,614,553,531,1084,"21 de agosto de 1994"
30,8,32,615,455,406,861,"21 de agosto de 1994"
30,8,32,616,398,351,749,"21 de agosto de 1994"
30,8,45,970,419,351,770,"21 de agosto de 1994"
30,8,45,971,341,291,632,"21 de agosto de 1994"
30,8,45,972,362,291,653,"21 de agosto de 1994"
30,8,45,973,724,658,1382,"21 de agosto de 1994"
30,8,45,974,300,226,526,"21 de agosto de 1994"
30,8,45,975,228,149,377,"21 de agosto de 1994"
30,8,45,976,690,517,1207,"21 de agosto de 1994"
30,8,45,977,364,273,637,"21 de agosto de 1994"
30,8,45,978,286,220,506,"21 de agosto de 1994"
30,8,45,979,532,438,970,"21 de agosto de 1994"
30,8,48,1153,323,348,671,"21 de agosto de 1994"
30,8,48,1154,287,305,592,"21 de agosto de 1994"
30,8,48,1155,365,367,732,"21 de agosto de 1994"
30,8,48,1156,485,413,898,"21 de agosto de 1994"
30,8,48,1157,434,366,800,"21 de agosto de 1994"
30,8,48,1158,562,506,1068,"21 de agosto de 1994"
30,8,48,1159,332,283,615,"21 de agosto de 1994"
30,8,48,1160,369,327,696,"21 de agosto de 1994"
30,8,48,1161,320,308,628,"21 de agosto de 1994"
30,8,49,1162,333,342,675,"21 de agosto de 1994"
30,8,49,1163,427,489,916,"21 de agosto de 1994"
30,8,49,1164,373,426,799,"21 de agosto de 1994"
30,8,49,1165,457,471,928,"21 de agosto de 1994"
30,8,49,1166,353,391,744,"21 de agosto de 1994"
30,8,49,1167,405,455,860,"21 de agosto de 1994"
30,8,49,1168,385,409,794,"21 de agosto de 1994"
30,8,49,1169,493,538,1031,"21 de agosto de 1994"
30,8,49,1170,331,330,661,"21 de agosto de 1994"
30,8,49,1171,316,331,647,"21 de agosto de 1994"
30,8,49,1172,391,411,802,"21 de agosto de 1994"
30,8,49,1173,278,253,531,"21 de agosto de 1994"
30,8,49,1174,494,394,888,"21 de agosto de 1994"
30,8,49,1175,347,309,656,"21 de agosto de 1994"
30,8,49,1176,459,422,881,"21 de agosto de 1994"
30,8,49,1177,512,481,993,"21 de agosto de 1994"
30,8,49,1178,347,288,635,"21 de agosto de 1994"
30,8,49,1179,432,404,836,"21 de agosto de 1994"
30,8,49,1180,269,238,507,"21 de agosto de 1994"
30,8,49,1181,352,346,698,"21 de agosto de 1994"
30,8,49,1182,433,431,864,"21 de agosto de 1994"
30,8,49,1183,284,284,568,"21 de agosto de 1994"
30,8,51,1252,593,527,1120,"21 de agosto de 1994"
30,8,51,1253,241,185,426,"21 de agosto de 1994"
30,8,51,1254,319,223,542,"21 de agosto de 1994"
30,8,51,1255,295,260,555,"21 de agosto de 1994"
30,8,51,1256,343,295,638,"21 de agosto de 1994"
30,8,51,1257,343,295,638,"21 de agosto de 1994"
30,8,51,1258,449,437,886,"21 de agosto de 1994"
30,8,51,1259,819,648,1467,"21 de agosto de 1994"
30,8,51,1260,308,263,571,"21 de agosto de 1994"
30,8,51,1261,315,272,587,"21 de agosto de 1994"
30,8,51,1262,272,246,518,"21 de agosto de 1994"
30,8,51,1263,275,242,517,"21 de agosto de 1994"
30,8,51,1264,247,229,476,"21 de agosto de 1994"
30,8,51,1265,503,482,985,"21 de agosto de 1994"
30,8,64,1456,477,452,929,"21 de agosto de 1994"
30,8,64,1457,596,620,1216,"21 de agosto de 1994"
30,8,64,1458,639,684,1323,"21 de agosto de 1994"
30,8,64,1459,724,612,1336,"21 de agosto de 1994"
30,8,64,1460,310,268,578,"21 de agosto de 1994"
30,8,64,1461,370,334,704,"21 de agosto de 1994"
30,8,64,1462,487,442,929,"21 de agosto de 1994"
30,8,73,1597,309,307,616,"21 de agosto de 1994"
30,8,73,1598,335,386,721,"21 de agosto de 1994"
30,8,73,1599,526,591,1117,"21 de agosto de 1994"
30,8,73,1600,498,595,1093,"21 de agosto de 1994"
30,8,73,1601,469,593,1062,"21 de agosto de 1994"
30,8,73,1602,244,287,531,"21 de agosto de 1994"
30,8,73,1603,362,450,812,"21 de agosto de 1994"
30,8,73,1604,615,717,1332,"21 de agosto de 1994"
30,8,73,1605,457,529,986,"21 de agosto de 1994"
30,8,73,1606,589,654,1243,"21 de agosto de 1994"
30,8,73,1607,356,414,770,"21 de agosto de 1994"
30,8,73,1608,420,491,911,"21 de agosto de 1994"
30,8,73,1609,378,407,785,"21 de agosto de 1994"
30,8,73,1610,354,407,761,"21 de agosto de 1994"
30,8,73,1611,364,351,715,"21 de agosto de 1994"
30,8,73,1612,121,105,226,"21 de agosto de 1994"
30,8,73,1613,324,299,623,"21 de agosto de 1994"
30,8,73,1614,472,411,883,"21 de agosto de 1994"
30,8,73,1615,377,316,693,"21 de agosto de 1994"
30,8,73,1616,515,474,989,"21 de agosto de 1994"
30,8,73,1617,229,238,467,"21 de agosto de 1994"
30,8,73,1618,171,149,320,"21 de agosto de 1994"
30,8,73,1619,509,474,983,"21 de agosto de 1994"
30,8,73,1620,468,409,877,"21 de agosto de 1994"
30,8,73,1621,286,254,540,"21 de agosto de 1994"
30,8,73,1622,441,408,849,"21 de agosto de 1994"
30,8,81,1726,412,359,771,"21 de agosto de 1994"
30,8,81,1727,421,409,830,"21 de agosto de 1994"
30,8,81,1728,457,396,853,"21 de agosto de 1994"
30,8,81,1729,436,424,860,"21 de agosto de 1994"
30,8,81,1730,450,387,837,"21 de agosto de 1994"
30,8,83,1764,681,746,1427,"21 de agosto de 1994"
30,8,83,1765,276,277,553,"21 de agosto de 1994"
30,8,83,1766,232,258,490,"21 de agosto de 1994"
30,8,83,1767,440,431,871,"21 de agosto de 1994"
30,8,83,1768,437,414,851,"21 de agosto de 1994"
30,8,83,1769,480,428,908,"21 de agosto de 1994"
30,8,83,1770,286,296,582,"21 de agosto de 1994"
30,8,83,1771,446,419,865,"21 de agosto de 1994"
30,8,83,1772,253,231,484,"21 de agosto de 1994"
30,8,83,1773,408,382,790,"21 de agosto de 1994"
30,8,83,1774,395,317,712,"21 de agosto de 1994"
30,8,126,2990,301,304,605,"21 de agosto de 1994"
30,8,126,2991,592,606,1198,"21 de agosto de 1994"
30,8,126,2992,474,464,938,"21 de agosto de 1994"
30,8,126,2993,384,386,770,"21 de agosto de 1994"
30,8,126,2994,629,634,1263,"21 de agosto de 1994"
30,8,126,2995,570,547,1117,"21 de agosto de 1994"
30,8,126,2996,477,406,883,"21 de agosto de 1994"
30,8,126,2997,479,426,905,"21 de agosto de 1994"
30,8,126,2998,362,307,669,"21 de agosto de 1994"
30,8,126,2999,517,422,939,"21 de agosto de 1994"
30,8,126,3000,399,343,742,"21 de agosto de 1994"
30,8,126,3001,323,272,595,"21 de agosto de 1994"
30,8,126,3002,420,335,755,"21 de agosto de 1994"
30,8,126,3003,557,488,1045,"21 de agosto de 1994"
30,8,147,3502,279,281,560,"21 de agosto de 1994"
30,8,147,3503,339,325,664,"21 de agosto de 1994"
30,8,149,3513,385,399,784,"21 de agosto de 1994"
30,8,149,3514,482,454,936,"21 de agosto de 1994"
30,8,149,3515,371,408,779,"21 de agosto de 1994"
30,8,149,3516,478,476,954,"21 de agosto de 1994"
30,8,149,3517,339,415,754,"21 de agosto de 1994"
30,8,149,3518,413,445,858,"21 de agosto de 1994"
30,8,149,3519,386,402,788,"21 de agosto de 1994"
30,8,149,3520,347,329,676,"21 de agosto de 1994"
30,8,149,3521,346,339,685,"21 de agosto de 1994"
30,8,149,3522,505,408,913,"21 de agosto de 1994"
30,8,149,3523,411,368,779,"21 de agosto de 1994"
30,8,149,3524,485,410,895,"21 de agosto de 1994"
30,8,149,3525,557,437,994,"21 de agosto de 1994"
30,8,149,3526,468,360,828,"21 de agosto de 1994"
30,8,149,3527,318,277,595,"21 de agosto de 1994"
30,8,149,3528,839,662,1501,"21 de agosto de 1994"
30,8,149,3529,603,511,1114,"21 de agosto de 1994"
30,8,161,3736,638,572,1210,"21 de agosto de 1994"
30,8,161,3737,217,163,380,"21 de agosto de 1994"
30,8,161,3738,481,455,936,"21 de agosto de 1994"
30,8,163,3745,590,604,1194,"21 de agosto de 1994"
30,8,163,3746,288,321,609,"21 de agosto de 1994"
30,8,163,3747,413,472,885,"21 de agosto de 1994"
30,8,163,3748,449,503,952,"21 de agosto de 1994"
30,8,163,3749,441,484,925,"21 de agosto de 1994"
30,8,163,3750,291,289,580,"21 de agosto de 1994"
30,8,163,3751,306,299,605,"21 de agosto de 1994"
30,8,163,3752,490,425,915,"21 de agosto de 1994"
30,8,163,3753,432,364,796,"21 de agosto de 1994"
30,8,164,3754,658,544,1202,"21 de agosto de 1994"
30,8,164,3755,614,519,1133,"21 de agosto de 1994"
30,8,164,3756,631,450,1081,"21 de agosto de 1994"
30,8,178,3999,422,385,807,"21 de agosto de 1994"
30,8,178,4000,475,437,912,"21 de agosto de 1994"
30,8,185,4079,373,389,762,"21 de agosto de 1994"
30,8,185,4080,417,465,882,"21 de agosto de 1994"
30,8,185,4081,302,277,579,"21 de agosto de 1994"
30,8,185,4082,471,453,924,"21 de agosto de 1994"
30,8,187,4086,558,494,1052,"21 de agosto de 1994"
30,8,187,4087,465,460,925,"21 de agosto de 1994"
30,8,187,4088,560,414,974,"21 de agosto de 1994"
30,8,187,4089,255,225,480,"21 de agosto de 1994"
30,8,187,4090,191,164,355,"21 de agosto de 1994"
30,8,187,4091,366,292,658,"21 de agosto de 1994"
30,8,187,4092,279,270,549,"21 de agosto de 1994"
30,8,187,4093,440,445,885,"21 de agosto de 1994"
30,8,187,4094,185,172,357,"21 de agosto de 1994"
30,8,187,4095,422,368,790,"21 de agosto de 1994"
30,8,200,4561,318,297,615,"21 de agosto de 1994"
30,8,200,4562,135,126,261,"21 de agosto de 1994"
30,8,200,4563,339,316,655,"21 de agosto de 1994"
30,8,200,4564,317,248,565,"21 de agosto de 1994"
30,8,200,4565,578,502,1080,"21 de agosto de 1994"
30,8,200,4566,457,402,859,"21 de agosto de 1994"
30,8,200,4567,473,415,888,"21 de agosto de 1994"
30,8,200,4568,276,247,523,"21 de agosto de 1994"
30,8,200,4569,358,319,677,"21 de agosto de 1994"
30,9,19,389,333,317,650,"21 de agosto de 1994"
30,9,23,414,211,188,399,"21 de agosto de 1994"
30,9,23,415,370,400,770,"21 de agosto de 1994"
30,9,23,416,298,286,584,"21 de agosto de 1994"
30,9,23,417,432,429,861,"21 de agosto de 1994"
30,9,23,418,353,358,711,"21 de agosto de 1994"
30,9,23,419,318,229,547,"21 de agosto de 1994"
30,9,23,420,361,344,705,"21 de agosto de 1994"
30,9,23,421,313,337,650,"21 de agosto de 1994"
30,9,23,422,225,201,426,"21 de agosto de 1994"
30,9,23,423,541,483,1024,"21 de agosto de 1994"
30,9,23,424,276,266,542,"21 de agosto de 1994"
30,9,76,1668,240,257,497,"21 de agosto de 1994"
30,9,76,1669,350,361,711,"21 de agosto de 1994"
30,9,76,1670,351,383,734,"21 de agosto de 1994"
30,9,76,1671,366,374,740,"21 de agosto de 1994"
30,9,85,1784,432,378,810,"21 de agosto de 1994"
30,9,85,1785,251,214,465,"21 de agosto de 1994"
30,9,85,1786,184,187,371,"21 de agosto de 1994"
30,9,85,1787,255,220,475,"21 de agosto de 1994"
30,9,85,1788,302,269,571,"21 de agosto de 1994"
30,9,85,1789,534,609,1143,"21 de agosto de 1994"
30,9,85,1790,123,132,255,"21 de agosto de 1994"
30,9,100,2240,447,468,915,"21 de agosto de 1994"
30,9,100,2241,457,519,976,"21 de agosto de 1994"
30,9,100,2242,511,517,1028,"21 de agosto de 1994"
30,9,100,2243,484,546,1030,"21 de agosto de 1994"
30,9,100,2244,501,520,1021,"21 de agosto de 1994"
30,9,100,2245,321,304,625,"21 de agosto de 1994"
30,9,100,2246,243,233,476,"21 de agosto de 1994"
30,9,100,2247,73,52,125,"21 de agosto de 1994"
30,9,100,2248,50,42,92,"21 de agosto de 1994"
30,9,102,2265,545,552,1097,"21 de agosto de 1994"
30,9,102,2266,284,258,542,"21 de agosto de 1994"
30,9,102,2267,207,163,370,"21 de agosto de 1994"
30,9,102,2268,308,234,542,"21 de agosto de 1994"
30,9,102,2269,157,158,315,"21 de agosto de 1994"
30,9,102,2270,405,400,805,"21 de agosto de 1994"
30,9,102,2271,236,175,411,"21 de agosto de 1994"
30,9,102,2272,244,225,469,"21 de agosto de 1994"
30,9,102,2273,301,291,592,"21 de agosto de 1994"
30,9,102,2274,204,263,467,"21 de agosto de 1994"
30,9,102,2275,216,267,483,"21 de agosto de 1994"
30,9,102,2276,264,342,606,"21 de agosto de 1994"
30,9,102,2277,368,450,818,"21 de agosto de 1994"
30,9,102,2278,303,361,664,"21 de agosto de 1994"
30,9,102,2279,339,431,770,"21 de agosto de 1994"
30,9,102,2280,425,489,914,"21 de agosto de 1994"
30,9,116,2621,552,618,1170,"21 de agosto de 1994"
30,9,116,2622,460,491,951,"21 de agosto de 1994"
30,9,116,2623,364,412,776,"21 de agosto de 1994"
30,9,116,2624,613,668,1281,"21 de agosto de 1994"
30,9,116,2625,708,809,1517,"21 de agosto de 1994"
30,9,116,2626,573,637,1210,"21 de agosto de 1994"
30,9,116,2627,469,507,976,"21 de agosto de 1994"
30,9,116,2628,445,566,1011,"21 de agosto de 1994"
30,9,116,2629,556,595,1151,"21 de agosto de 1994"
30,9,116,2630,496,565,1061,"21 de agosto de 1994"
30,9,116,2631,383,509,892,"21 de agosto de 1994"
30,9,116,2632,458,492,950,"21 de agosto de 1994"
30,9,116,2633,740,774,1514,"21 de agosto de 1994"
30,9,116,2634,636,684,1320,"21 de agosto de 1994"
30,9,116,2635,613,631,1244,"21 de agosto de 1994"
30,9,116,2636,605,670,1275,"21 de agosto de 1994"
30,9,116,2637,348,327,675,"21 de agosto de 1994"
30,9,116,2638,526,408,934,"21 de agosto de 1994"
30,9,116,2639,256,217,473,"21 de agosto de 1994"
30,9,119,2666,580,675,1255,"21 de agosto de 1994"
30,9,119,2667,325,374,699,"21 de agosto de 1994"
30,9,119,2668,258,287,545,"21 de agosto de 1994"
30,9,119,2669,88,106,194,"21 de agosto de 1994"
30,9,119,2670,391,457,848,"21 de agosto de 1994"
30,9,119,2671,250,301,551,"21 de agosto de 1994"
30,9,119,2672,313,383,696,"21 de agosto de 1994"
30,9,119,2673,267,309,576,"21 de agosto de 1994"
30,9,119,2674,297,309,606,"21 de agosto de 1994"
30,9,119,2675,409,438,847,"21 de agosto de 1994"
30,9,119,2676,267,365,632,"21 de agosto de 1994"
30,9,119,2677,385,442,827,"21 de agosto de 1994"
30,9,119,2678,467,512,979,"21 de agosto de 1994"
30,9,119,2679,590,655,1245,"21 de agosto de 1994"
30,9,119,2680,434,460,894,"21 de agosto de 1994"
30,9,119,2681,308,362,670,"21 de agosto de 1994"
30,9,119,2682,135,181,316,"21 de agosto de 1994"
30,9,119,2683,317,367,684,"21 de agosto de 1994"
30,9,119,2684,494,550,1044,"21 de agosto de 1994"
30,9,119,2685,731,853,1584,"21 de agosto de 1994"
30,9,119,2686,580,629,1209,"21 de agosto de 1994"
30,9,119,2687,246,301,547,"21 de agosto de 1994"
30,9,119,2688,314,352,666,"21 de agosto de 1994"
30,9,119,2689,343,415,758,"21 de agosto de 1994"
30,9,119,2690,322,364,686,"21 de agosto de 1994"
30,9,119,2691,302,334,636,"21 de agosto de 1994"
30,9,119,2692,285,295,580,"21 de agosto de 1994"
30,9,119,2693,404,461,865,"21 de agosto de 1994"
30,9,119,2694,261,304,565,"21 de agosto de 1994"
30,9,119,2695,358,410,768,"21 de agosto de 1994"
30,9,119,2696,226,255,481,"21 de agosto de 1994"
30,9,119,2697,224,239,463,"21 de agosto de 1994"
30,9,119,2698,350,418,768,"21 de agosto de 1994"
30,9,119,2699,325,371,696,"21 de agosto de 1994"
30,9,119,2700,213,227,440,"21 de agosto de 1994"
30,9,119,2701,348,418,766,"21 de agosto de 1994"
30,9,119,2702,425,491,916,"21 de agosto de 1994"
30,9,119,2703,177,233,410,"21 de agosto de 1994"
30,9,119,2704,427,508,935,"21 de agosto de 1994"
30,9,119,2705,342,414,756,"21 de agosto de 1994"
30,9,119,2706,175,205,380,"21 de agosto de 1994"
30,9,119,2707,232,276,508,"21 de agosto de 1994"
30,9,119,2708,520,605,1125,"21 de agosto de 1994"
30,9,119,2709,222,256,478,"21 de agosto de 1994"
30,9,119,2710,203,229,432,"21 de agosto de 1994"
30,9,119,2711,406,450,856,"21 de agosto de 1994"
30,9,119,2712,397,476,873,"21 de agosto de 1994"
30,9,119,2713,367,454,821,"21 de agosto de 1994"
30,9,119,2714,213,274,487,"21 de agosto de 1994"
30,9,119,2715,224,358,582,"21 de agosto de 1994"
30,9,119,2716,668,866,1534,"21 de agosto de 1994"
30,9,119,2717,333,354,687,"21 de agosto de 1994"
30,9,119,2718,576,611,1187,"21 de agosto de 1994"
30,9,119,2719,541,602,1143,"21 de agosto de 1994"
30,9,119,2720,201,214,415,"21 de agosto de 1994"
30,9,119,2721,465,571,1036,"21 de agosto de 1994"
30,9,119,2722,343,396,739,"21 de agosto de 1994"
30,9,119,2723,255,305,560,"21 de agosto de 1994"
30,9,119,2724,478,516,994,"21 de agosto de 1994"
30,9,119,2725,402,468,870,"21 de agosto de 1994"
30,9,119,2726,446,564,1010,"21 de agosto de 1994"
30,9,119,2727,176,228,404,"21 de agosto de 1994"
30,9,119,2728,292,371,663,"21 de agosto de 1994"
30,9,119,2729,445,516,961,"21 de agosto de 1994"
30,9,119,2730,339,422,761,"21 de agosto de 1994"
30,9,119,2731,282,315,597,"21 de agosto de 1994"
30,9,119,2732,302,401,703,"21 de agosto de 1994"
30,9,119,2733,277,356,633,"21 de agosto de 1994"
30,9,119,2734,110,142,252,"21 de agosto de 1994"
30,9,119,2735,278,359,637,"21 de agosto de 1994"
30,9,119,2736,268,337,605,"21 de agosto de 1994"
30,9,119,2737,188,203,391,"21 de agosto de 1994"
30,9,119,2738,318,396,714,"21 de agosto de 1994"
30,9,119,2739,347,404,751,"21 de agosto de 1994"
30,9,119,2740,314,392,706,"21 de agosto de 1994"
30,9,119,2741,244,276,520,"21 de agosto de 1994"
30,9,119,2742,574,626,1200,"21 de agosto de 1994"
30,9,119,2743,440,502,942,"21 de agosto de 1994"
30,9,119,2744,157,178,335,"21 de agosto de 1994"
30,9,119,2745,369,440,809,"21 de agosto de 1994"
30,9,119,2746,291,370,661,"21 de agosto de 1994"
30,9,119,2747,625,744,1369,"21 de agosto de 1994"
30,9,119,2748,374,415,789,"21 de agosto de 1994"
30,9,119,2749,256,325,581,"21 de agosto de 1994"
30,9,119,2750,212,301,513,"21 de agosto de 1994"
30,9,119,2751,343,393,736,"21 de agosto de 1994"
30,9,119,2752,451,494,945,"21 de agosto de 1994"
30,9,119,2753,396,425,821,"21 de agosto de 1994"
30,9,119,2754,368,411,779,"21 de agosto de 1994"
30,9,119,2755,265,338,603,"21 de agosto de 1994"
30,9,119,2756,316,383,699,"21 de agosto de 1994"
30,9,119,2757,464,530,994,"21 de agosto de 1994"
30,9,119,2758,514,554,1068,"21 de agosto de 1994"
30,9,119,2759,152,168,320,"21 de agosto de 1994"
30,9,119,2760,523,554,1077,"21 de agosto de 1994"
30,9,119,2761,406,441,847,"21 de agosto de 1994"
30,9,119,2762,402,486,888,"21 de agosto de 1994"
30,9,119,2763,393,422,815,"21 de agosto de 1994"
30,9,128,3028,546,533,1079,"21 de agosto de 1994"
30,9,128,3029,217,195,412,"21 de agosto de 1994"
30,9,128,3030,185,174,359,"21 de agosto de 1994"
30,9,128,3031,309,282,591,"21 de agosto de 1994"
30,9,128,3032,455,454,909,"21 de agosto de 1994"
30,9,128,3033,629,529,1158,"21 de agosto de 1994"
30,9,128,3034,350,322,672,"21 de agosto de 1994"
30,9,128,3035,328,313,641,"21 de agosto de 1994"
30,9,135,3274,392,387,779,"21 de agosto de 1994"
30,9,135,3275,341,321,662,"21 de agosto de 1994"
30,9,135,3276,146,121,267,"21 de agosto de 1994"
30,9,135,3277,551,562,1113,"21 de agosto de 1994"
30,9,135,3278,68,70,138,"21 de agosto de 1994"
30,9,135,3279,365,382,747,"21 de agosto de 1994"
30,9,135,3280,442,413,855,"21 de agosto de 1994"
30,9,135,3281,242,256,498,"21 de agosto de 1994"
30,9,135,3282,154,113,267,"21 de agosto de 1994"
30,9,139,3297,550,585,1135,"21 de agosto de 1994"
30,9,139,3298,594,669,1263,"21 de agosto de 1994"
30,9,139,3299,694,840,1534,"21 de agosto de 1994"
30,9,139,3300,247,317,564,"21 de agosto de 1994"
30,9,139,3301,509,605,1114,"21 de agosto de 1994"
30,9,139,3302,620,665,1285,"21 de agosto de 1994"
30,9,139,3303,525,603,1128,"21 de agosto de 1994"
30,9,139,3304,640,728,1368,"21 de agosto de 1994"
30,9,139,3305,565,661,1226,"21 de agosto de 1994"
30,9,139,3306,328,374,702,"21 de agosto de 1994"
30,9,139,3307,339,409,748,"21 de agosto de 1994"
30,9,139,3308,403,461,864,"21 de agosto de 1994"
30,9,139,3309,350,411,761,"21 de agosto de 1994"
30,9,139,3310,423,478,901,"21 de agosto de 1994"
30,9,139,3311,379,450,829,"21 de agosto de 1994"
30,9,139,3312,547,628,1175,"21 de agosto de 1994"
30,9,139,3313,469,515,984,"21 de agosto de 1994"
30,9,139,3314,469,503,972,"21 de agosto de 1994"
30,9,139,3315,181,209,390,"21 de agosto de 1994"
30,9,139,3316,504,563,1067,"21 de agosto de 1994"
30,9,139,3317,602,703,1305,"21 de agosto de 1994"
30,9,139,3318,455,532,987,"21 de agosto de 1994"
30,9,139,3319,355,430,785,"21 de agosto de 1994"
30,9,139,3320,422,429,851,"21 de agosto de 1994"
30,10,14,294,303,317,620,"21 de agosto de 1994"
30,10,14,295,569,642,1211,"21 de agosto de 1994"
30,10,14,296,475,490,965,"21 de agosto de 1994"
30,10,14,297,418,457,875,"21 de agosto de 1994"
30,10,14,298,284,242,526,"21 de agosto de 1994"
30,10,14,299,230,215,445,"21 de agosto de 1994"
30,10,14,300,314,307,621,"21 de agosto de 1994"
30,10,14,301,472,470,942,"21 de agosto de 1994"
30,10,14,302,76,74,150,"21 de agosto de 1994"
30,10,14,303,283,342,625,"21 de agosto de 1994"
30,10,14,304,323,372,695,"21 de agosto de 1994"
30,10,14,305,710,744,1454,"21 de agosto de 1994"
30,10,14,306,492,562,1054,"21 de agosto de 1994"
30,10,14,307,599,613,1212,"21 de agosto de 1994"
30,10,14,308,330,440,770,"21 de agosto de 1994"
30,10,14,309,395,399,794,"21 de agosto de 1994"
30,10,14,310,663,707,1370,"21 de agosto de 1994"
30,10,14,311,206,199,405,"21 de agosto de 1994"
30,10,14,312,338,355,693,"21 de agosto de 1994"
30,10,14,313,255,272,527,"21 de agosto de 1994"
30,10,14,314,178,188,366,"21 de agosto de 1994"
30,10,14,315,427,448,875,"21 de agosto de 1994"
30,10,14,316,244,213,457,"21 de agosto de 1994"
30,10,14,317,342,350,692,"21 de agosto de 1994"
30,10,14,318,510,591,1101,"21 de agosto de 1994"
30,10,14,319,112,136,248,"21 de agosto de 1994"
30,10,22,398,322,304,626,"21 de agosto de 1994"
30,10,22,399,575,575,1150,"21 de agosto de 1994"
30,10,22,400,340,307,647,"21 de agosto de 1994"
30,10,22,401,246,229,475,"21 de agosto de 1994"
30,10,22,402,182,163,345,"21 de agosto de 1994"
30,10,22,403,288,220,508,"21 de agosto de 1994"
30,10,22,404,124,94,218,"21 de agosto de 1994"
30,10,22,405,684,732,1416,"21 de agosto de 1994"
30,10,22,406,419,493,912,"21 de agosto de 1994"
30,10,22,407,435,452,887,"21 de agosto de 1994"
30,10,22,408,720,756,1476,"21 de agosto de 1994"
30,10,22,409,680,748,1428,"21 de agosto de 1994"
30,10,22,410,514,536,1050,"21 de agosto de 1994"
30,10,22,411,446,501,947,"21 de agosto de 1994"
30,10,22,412,243,280,523,"21 de agosto de 1994"
30,10,22,413,200,191,391,"21 de agosto de 1994"
30,10,46,980,650,705,1355,"21 de agosto de 1994"
30,10,46,981,548,613,1161,"21 de agosto de 1994"
30,10,46,982,597,605,1202,"21 de agosto de 1994"
30,10,46,983,444,467,911,"21 de agosto de 1994"
30,10,46,984,528,577,1105,"21 de agosto de 1994"
30,10,46,985,449,474,923,"21 de agosto de 1994"
30,10,46,986,577,617,1194,"21 de agosto de 1994"
30,10,46,987,381,440,821,"21 de agosto de 1994"
30,10,46,988,398,491,889,"21 de agosto de 1994"
30,10,46,989,339,357,696,"21 de agosto de 1994"
30,10,46,990,506,575,1081,"21 de agosto de 1994"
30,10,46,991,362,489,851,"21 de agosto de 1994"
30,10,46,992,414,477,891,"21 de agosto de 1994"
30,10,46,993,204,266,470,"21 de agosto de 1994"
30,10,46,994,341,342,683,"21 de agosto de 1994"
30,10,46,995,373,397,770,"21 de agosto de 1994"
30,10,46,996,417,466,883,"21 de agosto de 1994"
30,10,46,997,349,452,801,"21 de agosto de 1994"
30,10,46,998,433,453,886,"21 de agosto de 1994"
30,10,46,999,316,341,657,"21 de agosto de 1994"
30,10,46,1000,303,393,696,"21 de agosto de 1994"
30,10,46,1001,548,625,1173,"21 de agosto de 1994"
30,10,46,1002,415,461,876,"21 de agosto de 1994"
30,10,46,1003,298,358,656,"21 de agosto de 1994"
30,10,46,1004,231,291,522,"21 de agosto de 1994"
30,10,46,1005,224,284,508,"21 de agosto de 1994"
30,10,46,1006,300,362,662,"21 de agosto de 1994"
30,10,46,1007,303,309,612,"21 de agosto de 1994"
30,10,46,1008,430,526,956,"21 de agosto de 1994"
30,10,46,1009,281,317,598,"21 de agosto de 1994"
30,10,46,1010,448,509,957,"21 de agosto de 1994"
30,10,46,1011,418,496,914,"21 de agosto de 1994"
30,10,46,1012,249,280,529,"21 de agosto de 1994"
30,10,46,1013,311,386,697,"21 de agosto de 1994"
30,10,46,1014,438,515,953,"21 de agosto de 1994"
30,10,46,1015,228,291,519,"21 de agosto de 1994"
30,10,46,1016,283,375,658,"21 de agosto de 1994"
30,10,46,1017,359,408,767,"21 de agosto de 1994"
30,10,46,1018,247,272,519,"21 de agosto de 1994"
30,10,46,1019,465,544,1009,"21 de agosto de 1994"
30,10,46,1020,242,314,556,"21 de agosto de 1994"
30,10,46,1021,362,494,856,"21 de agosto de 1994"
30,10,46,1022,413,558,971,"21 de agosto de 1994"
30,10,46,1023,296,377,673,"21 de agosto de 1994"
30,10,46,1024,237,332,569,"21 de agosto de 1994"
30,10,46,1025,276,352,628,"21 de agosto de 1994"
30,10,46,1026,319,382,701,"21 de agosto de 1994"
30,10,46,1027,380,434,814,"21 de agosto de 1994"
30,10,46,1028,461,540,1001,"21 de agosto de 1994"
30,10,46,1029,427,518,945,"21 de agosto de 1994"
30,10,46,1030,732,819,1551,"21 de agosto de 1994"
30,10,46,1031,487,529,1016,"21 de agosto de 1994"
30,10,46,1032,471,497,968,"21 de agosto de 1994"
30,10,46,1033,523,561,1084,"21 de agosto de 1994"
30,10,46,1034,523,634,1157,"21 de agosto de 1994"
30,10,46,1035,379,451,830,"21 de agosto de 1994"
30,10,46,1036,345,392,737,"21 de agosto de 1994"
30,10,46,1037,324,374,698,"21 de agosto de 1994"
30,10,46,1038,426,506,932,"21 de agosto de 1994"
30,10,46,1039,346,427,773,"21 de agosto de 1994"
30,10,46,1040,308,393,701,"21 de agosto de 1994"
30,10,46,1041,350,403,753,"21 de agosto de 1994"
30,10,46,1042,270,334,604,"21 de agosto de 1994"
30,10,46,1043,438,513,951,"21 de agosto de 1994"
30,10,46,1044,206,279,485,"21 de agosto de 1994"
30,10,46,1045,336,417,753,"21 de agosto de 1994"
30,10,46,1046,234,283,517,"21 de agosto de 1994"
30,10,46,1047,335,405,740,"21 de agosto de 1994"
30,10,46,1048,387,426,813,"21 de agosto de 1994"
30,10,46,1049,359,417,776,"21 de agosto de 1994"
30,10,46,1050,567,640,1207,"21 de agosto de 1994"
30,10,46,1051,464,559,1023,"21 de agosto de 1994"
30,10,46,1052,207,279,486,"21 de agosto de 1994"
30,10,46,1053,230,323,553,"21 de agosto de 1994"
30,10,46,1054,401,533,934,"21 de agosto de 1994"
30,10,46,1055,395,472,867,"21 de agosto de 1994"
30,10,46,1056,493,542,1035,"21 de agosto de 1994"
30,10,46,1057,235,276,511,"21 de agosto de 1994"
30,10,46,1058,309,356,665,"21 de agosto de 1994"
30,10,46,1059,728,838,1566,"21 de agosto de 1994"
30,10,46,1060,336,363,699,"21 de agosto de 1994"
30,10,46,1061,313,399,712,"21 de agosto de 1994"
30,10,46,1062,674,737,1411,"21 de agosto de 1994"
30,10,46,1063,282,317,599,"21 de agosto de 1994"
30,10,46,1064,213,311,524,"21 de agosto de 1994"
30,10,46,1065,325,370,695,"21 de agosto de 1994"
30,10,46,1066,377,458,835,"21 de agosto de 1994"
30,10,46,1067,241,287,528,"21 de agosto de 1994"
30,10,46,1068,400,503,903,"21 de agosto de 1994"
30,10,46,1069,294,346,640,"21 de agosto de 1994"
30,10,46,1070,214,289,503,"21 de agosto de 1994"
30,10,46,1071,339,377,716,"21 de agosto de 1994"
30,10,46,1072,511,611,1122,"21 de agosto de 1994"
30,10,46,1073,424,514,938,"21 de agosto de 1994"
30,10,46,1074,339,404,743,"21 de agosto de 1994"
30,10,46,1075,365,296,661,"21 de agosto de 1994"
30,10,46,1076,389,350,739,"21 de agosto de 1994"
30,10,46,1077,331,296,627,"21 de agosto de 1994"
30,10,46,1078,202,214,416,"21 de agosto de 1994"
30,10,46,1079,459,468,927,"21 de agosto de 1994"
30,10,46,1080,292,239,531,"21 de agosto de 1994"
30,10,46,1081,381,400,781,"21 de agosto de 1994"
30,10,46,1082,279,298,577,"21 de agosto de 1994"
30,10,46,1083,190,229,419,"21 de agosto de 1994"
30,10,46,1084,414,380,794,"21 de agosto de 1994"
30,10,46,1085,364,361,725,"21 de agosto de 1994"
30,10,46,1086,264,257,521,"21 de agosto de 1994"
30,10,46,1087,363,392,755,"21 de agosto de 1994"
30,10,46,1088,189,209,398,"21 de agosto de 1994"
30,10,46,1089,715,901,1616,"21 de agosto de 1994"
30,10,46,1090,236,256,492,"21 de agosto de 1994"
30,10,46,1091,917,1085,2002,"21 de agosto de 1994"
30,10,46,1092,360,446,806,"21 de agosto de 1994"
30,10,46,1093,377,410,787,"21 de agosto de 1994"
30,10,70,1529,323,345,668,"21 de agosto de 1994"
30,10,70,1530,691,767,1458,"21 de agosto de 1994"
30,10,70,1531,436,501,937,"21 de agosto de 1994"
30,10,70,1532,470,593,1063,"21 de agosto de 1994"
30,10,70,1533,241,291,532,"21 de agosto de 1994"
30,10,70,1534,422,515,937,"21 de agosto de 1994"
30,10,70,1535,355,411,766,"21 de agosto de 1994"
30,10,70,1536,496,519,1015,"21 de agosto de 1994"
30,10,70,1537,441,581,1022,"21 de agosto de 1994"
30,10,70,1538,377,394,771,"21 de agosto de 1994"
30,10,70,1539,426,407,833,"21 de agosto de 1994"
30,10,70,1540,225,243,468,"21 de agosto de 1994"
30,10,70,1541,462,531,993,"21 de agosto de 1994"
30,10,70,1542,692,757,1449,"21 de agosto de 1994"
30,10,70,1543,480,534,1014,"21 de agosto de 1994"
30,10,70,1544,396,437,833,"21 de agosto de 1994"
30,10,70,1545,510,608,1118,"21 de agosto de 1994"
30,10,70,1546,512,502,1014,"21 de agosto de 1994"
30,10,70,1547,542,595,1137,"21 de agosto de 1994"
30,10,70,1548,485,516,1001,"21 de agosto de 1994"
30,10,70,1549,299,356,655,"21 de agosto de 1994"
30,10,70,1550,429,506,935,"21 de agosto de 1994"
30,10,70,1551,318,390,708,"21 de agosto de 1994"
30,10,70,1552,450,535,985,"21 de agosto de 1994"
30,10,70,1553,361,379,740,"21 de agosto de 1994"
30,10,70,1554,194,190,384,"21 de agosto de 1994"
30,10,70,1555,222,221,443,"21 de agosto de 1994"
30,10,87,1798,411,460,871,"21 de agosto de 1994"
30,10,87,1799,502,522,1024,"21 de agosto de 1994"
30,10,87,1800,363,387,750,"21 de agosto de 1994"
30,10,87,1801,130,106,236,"21 de agosto de 1994"
30,10,87,1802,349,346,695,"21 de agosto de 1994"
30,10,87,1803,411,470,881,"21 de agosto de 1994"
30,10,87,1804,470,452,922,"21 de agosto de 1994"
30,10,87,1805,193,204,397,"21 de agosto de 1994"
30,10,87,1806,434,472,906,"21 de agosto de 1994"
30,10,87,1807,469,494,963,"21 de agosto de 1994"
30,10,87,1808,629,617,1246,"21 de agosto de 1994"
30,10,87,1809,716,718,1434,"21 de agosto de 1994"
30,10,87,1810,578,612,1190,"21 de agosto de 1994"
30,10,87,1811,324,361,685,"21 de agosto de 1994"
30,10,87,1812,533,557,1090,"21 de agosto de 1994"
30,10,87,1813,257,282,539,"21 de agosto de 1994"
30,10,87,1814,307,310,617,"21 de agosto de 1994"
30,10,87,1815,347,396,743,"21 de agosto de 1994"
30,10,87,1816,271,304,575,"21 de agosto de 1994"
30,10,87,1817,354,359,713,"21 de agosto de 1994"
30,10,87,1818,340,384,724,"21 de agosto de 1994"
30,10,87,1819,117,137,254,"21 de agosto de 1994"
30,10,87,1820,166,158,324,"21 de agosto de 1994"
30,10,87,1821,198,191,389,"21 de agosto de 1994"
30,10,87,1822,488,494,982,"21 de agosto de 1994"
30,10,87,1823,478,467,945,"21 de agosto de 1994"
30,10,87,1824,516,457,973,"21 de agosto de 1994"
30,10,87,1825,225,222,447,"21 de agosto de 1994"
30,10,87,1826,39,41,80,"21 de agosto de 1994"
30,10,87,1827,156,161,317,"21 de agosto de 1994"
30,10,87,1828,601,554,1155,"21 de agosto de 1994"
30,10,87,1829,277,280,557,"21 de agosto de 1994"
30,11,192,4217,393,448,841,"21 de agosto de 1994"
30,11,192,4218,384,469,853,"21 de agosto de 1994"
30,11,192,4219,370,366,736,"21 de agosto de 1994"
30,11,192,4220,299,378,677,"21 de agosto de 1994"
30,11,192,4221,377,437,814,"21 de agosto de 1994"
30,11,192,4222,314,327,641,"21 de agosto de 1994"
30,11,192,4223,290,354,644,"21 de agosto de 1994"
30,11,192,4224,310,355,665,"21 de agosto de 1994"
30,11,192,4225,467,538,1005,"21 de agosto de 1994"
30,11,192,4226,399,447,846,"21 de agosto de 1994"
30,11,192,4227,414,498,912,"21 de agosto de 1994"
30,11,192,4228,459,508,967,"21 de agosto de 1994"
30,11,192,4229,494,618,1112,"21 de agosto de 1994"
30,11,192,4230,1486,1860,3346,"21 de agosto de 1994"
30,11,192,4231,667,841,1508,"21 de agosto de 1994"
30,11,192,4232,332,415,747,"21 de agosto de 1994"
30,11,192,4233,316,437,753,"21 de agosto de 1994"
30,11,192,4234,253,350,603,"21 de agosto de 1994"
30,11,192,4235,281,364,645,"21 de agosto de 1994"
30,11,192,4236,475,543,1018,"21 de agosto de 1994"
30,11,192,4237,413,473,886,"21 de agosto de 1994"
30,11,192,4238,490,503,993,"21 de agosto de 1994"
30,11,192,4239,388,442,830,"21 de agosto de 1994"
30,11,192,4240,428,477,905,"21 de agosto de 1994"
30,11,192,4241,240,304,544,"21 de agosto de 1994"
30,11,192,4242,315,427,742,"21 de agosto de 1994"
30,11,192,4243,331,420,751,"21 de agosto de 1994"
30,11,192,4244,362,458,820,"21 de agosto de 1994"
30,11,192,4245,290,380,670,"21 de agosto de 1994"
30,11,192,4246,272,332,604,"21 de agosto de 1994"
30,11,192,4247,245,282,527,"21 de agosto de 1994"
30,11,192,4248,560,610,1170,"21 de agosto de 1994"
30,11,192,4249,359,406,765,"21 de agosto de 1994"
30,11,192,4250,271,308,579,"21 de agosto de 1994"
30,11,192,4251,280,321,601,"21 de agosto de 1994"
30,11,192,4252,294,366,660,"21 de agosto de 1994"
30,11,192,4253,354,413,767,"21 de agosto de 1994"
30,11,192,4254,606,704,1310,"21 de agosto de 1994"
30,11,192,4255,402,476,878,"21 de agosto de 1994"
30,11,192,4256,213,257,470,"21 de agosto de 1994"
30,11,192,4257,218,268,486,"21 de agosto de 1994"
30,11,192,4258,340,388,728,"21 de agosto de 1994"
30,11,192,4259,367,414,781,"21 de agosto de 1994"
30,11,192,4260,754,1005,1759,"21 de agosto de 1994"
30,11,192,4261,258,346,604,"21 de agosto de 1994"
30,11,192,4262,471,581,1052,"21 de agosto de 1994"
30,11,192,4263,371,492,863,"21 de agosto de 1994"
30,11,192,4264,676,750,1426,"21 de agosto de 1994"
30,11,192,4265,439,430,869,"21 de agosto de 1994"
30,11,192,4266,687,725,1412,"21 de agosto de 1994"
30,11,192,4267,714,784,1498,"21 de agosto de 1994"
30,11,192,4268,466,579,1045,"21 de agosto de 1994"
30,11,192,4269,314,348,662,"21 de agosto de 1994"
30,11,192,4270,511,639,1150,"21 de agosto de 1994"
30,11,192,4271,361,378,739,"21 de agosto de 1994"
30,11,192,4272,543,443,986,"21 de agosto de 1994"
30,11,192,4273,205,216,421,"21 de agosto de 1994"
30,11,192,4274,368,476,844,"21 de agosto de 1994"
30,11,192,4275,443,540,983,"21 de agosto de 1994"
30,11,192,4276,554,662,1216,"21 de agosto de 1994"
30,11,192,4277,567,620,1187,"21 de agosto de 1994"
30,11,192,4278,497,565,1062,"21 de agosto de 1994"
30,11,192,4279,591,665,1256,"21 de agosto de 1994"
30,11,192,4280,701,845,1546,"21 de agosto de 1994"
30,11,192,4281,344,422,766,"21 de agosto de 1994"
30,11,192,4282,372,476,848,"21 de agosto de 1994"
30,11,192,4283,531,616,1147,"21 de agosto de 1994"
30,11,192,4284,572,617,1189,"21 de agosto de 1994"
30,11,192,4285,401,489,890,"21 de agosto de 1994"
30,11,192,4286,367,427,794,"21 de agosto de 1994"
30,11,192,4287,329,429,758,"21 de agosto de 1994"
30,11,192,4288,461,542,1003,"21 de agosto de 1994"
30,11,192,4289,304,368,672,"21 de agosto de 1994"
30,11,192,4290,310,408,718,"21 de agosto de 1994"
30,11,192,4291,301,350,651,"21 de agosto de 1994"
30,11,192,4292,422,477,899,"21 de agosto de 1994"
30,11,192,4293,240,295,535,"21 de agosto de 1994"
30,11,192,4294,256,303,559,"21 de agosto de 1994"
30,11,192,4295,271,338,609,"21 de agosto de 1994"
30,11,192,4296,266,289,555,"21 de agosto de 1994"
30,11,192,4297,333,382,715,"21 de agosto de 1994"
30,11,192,4298,247,324,571,"21 de agosto de 1994"
30,11,192,4299,209,253,462,"21 de agosto de 1994"
30,11,192,4300,347,406,753,"21 de agosto de 1994"
30,11,192,4301,251,318,569,"21 de agosto de 1994"
30,11,192,4302,313,390,703,"21 de agosto de 1994"
30,11,192,4303,253,292,545,"21 de agosto de 1994"
30,11,192,4304,585,648,1233,"21 de agosto de 1994"
30,11,192,4305,552,603,1155,"21 de agosto de 1994"
30,11,192,4306,525,582,1107,"21 de agosto de 1994"
30,11,192,4307,259,304,563,"21 de agosto de 1994"
30,11,192,4308,425,511,936,"21 de agosto de 1994"
30,11,192,4309,447,478,925,"21 de agosto de 1994"
30,11,192,4310,473,540,1013,"21 de agosto de 1994"
30,11,192,4311,574,598,1172,"21 de agosto de 1994"
30,11,192,4312,489,494,983,"21 de agosto de 1994"
30,11,192,4313,271,338,609,"21 de agosto de 1994"
30,11,192,4314,275,325,600,"21 de agosto de 1994"
30,11,192,4315,305,384,689,"21 de agosto de 1994"
30,11,192,4316,316,393,709,"21 de agosto de 1994"
30,11,192,4317,407,500,907,"21 de agosto de 1994"
30,11,192,4318,350,395,745,"21 de agosto de 1994"
30,11,192,4319,302,341,643,"21 de agosto de 1994"
30,11,192,4320,230,273,503,"21 de agosto de 1994"
30,11,192,4321,357,395,752,"21 de agosto de 1994"
30,11,192,4322,421,589,1010,"21 de agosto de 1994"
30,11,192,4323,445,536,981,"21 de agosto de 1994"
30,11,192,4324,388,544,932,"21 de agosto de 1994"
30,11,192,4325,384,476,860,"21 de agosto de 1994"
30,11,192,4326,232,363,595,"21 de agosto de 1994"
30,11,192,4327,265,379,644,"21 de agosto de 1994"
30,11,192,4328,274,367,641,"21 de agosto de 1994"
30,11,192,4329,444,473,917,"21 de agosto de 1994"
30,11,192,4330,331,369,700,"21 de agosto de 1994"
30,11,192,4331,359,394,753,"21 de agosto de 1994"
30,11,192,4332,408,507,915,"21 de agosto de 1994"
30,11,192,4333,325,382,707,"21 de agosto de 1994"
30,11,192,4334,340,426,766,"21 de agosto de 1994"
30,11,192,4335,375,384,759,"21 de agosto de 1994"
30,11,192,4336,598,643,1241,"21 de agosto de 1994"
30,11,192,4337,578,649,1227,"21 de agosto de 1994"
30,11,192,4338,413,469,882,"21 de agosto de 1994"
30,11,192,4339,498,545,1043,"21 de agosto de 1994"
30,11,192,4340,433,520,953,"21 de agosto de 1994"
30,11,192,4341,540,643,1183,"21 de agosto de 1994"
30,11,192,4342,384,462,846,"21 de agosto de 1994"
30,11,192,4343,475,521,996,"21 de agosto de 1994"
30,11,192,4344,545,612,1157,"21 de agosto de 1994"
30,11,192,4345,514,562,1076,"21 de agosto de 1994"
30,11,192,4346,514,593,1107,"21 de agosto de 1994"
30,11,192,4347,423,516,939,"21 de agosto de 1994"
30,11,192,4348,401,550,951,"21 de agosto de 1994"
30,11,192,4349,400,471,871,"21 de agosto de 1994"
30,11,192,4350,342,447,789,"21 de agosto de 1994"
30,11,192,4351,347,493,840,"21 de agosto de 1994"
30,11,192,4352,339,438,777,"21 de agosto de 1994"
30,11,192,4353,423,507,930,"21 de agosto de 1994"
30,11,192,4354,496,666,1162,"21 de agosto de 1994"
30,11,192,4355,355,439,794,"21 de agosto de 1994"
30,11,192,4356,374,442,816,"21 de agosto de 1994"
30,11,192,4357,270,331,601,"21 de agosto de 1994"
30,11,192,4358,240,309,549,"21 de agosto de 1994"
30,11,192,4359,311,409,720,"21 de agosto de 1994"
30,11,192,4360,580,602,1182,"21 de agosto de 1994"
30,11,192,4361,399,474,873,"21 de agosto de 1994"
30,11,192,4362,523,563,1086,"21 de agosto de 1994"
30,11,192,4363,400,472,872,"21 de agosto de 1994"
30,11,192,4364,375,445,820,"21 de agosto de 1994"
30,11,192,4365,342,346,688,"21 de agosto de 1994"
30,11,192,4366,611,709,1320,"21 de agosto de 1994"
30,11,192,4367,514,581,1095,"21 de agosto de 1994"
30,11,192,4368,347,376,723,"21 de agosto de 1994"
30,11,192,4369,447,413,860,"21 de agosto de 1994"
30,11,192,4370,315,342,657,"21 de agosto de 1994"
30,11,192,4371,439,497,936,"21 de agosto de 1994"
30,11,192,4372,512,612,1124,"21 de agosto de 1994"
30,11,192,4373,419,504,923,"21 de agosto de 1994"
30,11,192,4374,505,615,1120,"21 de agosto de 1994"
30,11,192,4375,233,316,549,"21 de agosto de 1994"
30,11,192,4376,411,458,869,"21 de agosto de 1994"
30,11,192,4377,250,386,636,"21 de agosto de 1994"
30,11,192,4378,230,294,524,"21 de agosto de 1994"
30,11,192,4379,452,479,931,"21 de agosto de 1994"
30,11,192,4380,320,369,689,"21 de agosto de 1994"
30,11,192,4381,262,278,540,"21 de agosto de 1994"
30,11,192,4382,990,1099,2089,"21 de agosto de 1994"
30,11,192,4383,404,463,867,"21 de agosto de 1994"
30,11,192,4384,869,1012,1881,"21 de agosto de 1994"
30,11,192,4385,318,357,675,"21 de agosto de 1994"
30,11,192,4386,262,347,609,"21 de agosto de 1994"
30,11,192,4387,421,477,898,"21 de agosto de 1994"
30,11,192,4388,383,354,737,"21 de agosto de 1994"
30,11,192,4389,326,403,729,"21 de agosto de 1994"
30,11,192,4390,444,603,1047,"21 de agosto de 1994"
30,12,5,85,419,430,849,"21 de agosto de 1994"
30,12,5,86,362,336,698,"21 de agosto de 1994"
30,12,5,87,86,72,158,"21 de agosto de 1994"
30,12,5,88,125,99,224,"21 de agosto de 1994"
30,12,5,89,154,116,270,"21 de agosto de 1994"
30,12,5,90,135,144,279,"21 de agosto de 1994"
30,12,5,91,238,189,427,"21 de agosto de 1994"
30,12,12,247,395,391,786,"21 de agosto de 1994"
30,12,12,248,293,293,586,"21 de agosto de 1994"
30,12,12,249,165,208,373,"21 de agosto de 1994"
30,12,12,250,227,264,491,"21 de agosto de 1994"
30,12,12,251,174,171,345,"21 de agosto de 1994"
30,12,12,252,437,451,888,"21 de agosto de 1994"
30,12,12,253,242,271,513,"21 de agosto de 1994"
30,12,12,254,327,395,722,"21 de agosto de 1994"
30,12,12,255,638,735,1373,"21 de agosto de 1994"
30,12,12,256,368,436,804,"21 de agosto de 1994"
30,12,12,257,472,508,980,"21 de agosto de 1994"
30,12,12,258,335,389,724,"21 de agosto de 1994"
30,12,12,259,483,485,968,"21 de agosto de 1994"
30,12,12,260,559,649,1208,"21 de agosto de 1994"
30,12,12,261,409,481,890,"21 de agosto de 1994"
30,12,12,262,316,363,679,"21 de agosto de 1994"
30,12,12,263,353,414,767,"21 de agosto de 1994"
30,12,12,264,321,393,714,"21 de agosto de 1994"
30,12,12,265,472,579,1051,"21 de agosto de 1994"
30,12,12,266,145,145,290,"21 de agosto de 1994"
30,12,12,267,221,247,468,"21 de agosto de 1994"
30,12,12,268,300,371,671,"21 de agosto de 1994"
30,12,12,269,144,105,249,"21 de agosto de 1994"
30,12,12,270,297,328,625,"21 de agosto de 1994"
30,12,12,271,848,369,1217,"21 de agosto de 1994"
30,12,12,272,639,682,1321,"21 de agosto de 1994"
30,12,12,273,231,231,462,"21 de agosto de 1994"
30,12,12,274,311,302,613,"21 de agosto de 1994"
30,12,12,275,200,210,410,"21 de agosto de 1994"
30,12,12,276,461,466,927,"21 de agosto de 1994"
30,12,12,277,191,226,417,"21 de agosto de 1994"
30,12,12,278,304,291,595,"21 de agosto de 1994"
30,12,12,279,386,325,711,"21 de agosto de 1994"
30,12,12,280,514,493,1007,"21 de agosto de 1994"
30,12,12,281,257,203,460,"21 de agosto de 1994"
30,12,12,282,502,482,984,"21 de agosto de 1994"
30,12,12,283,424,388,812,"21 de agosto de 1994"
30,12,12,284,511,435,946,"21 de agosto de 1994"
30,12,12,285,142,137,279,"21 de agosto de 1994"
30,12,12,286,156,124,280,"21 de agosto de 1994"
30,12,13,287,452,507,959,"21 de agosto de 1994"
30,12,13,288,240,216,456,"21 de agosto de 1994"
30,12,13,289,320,291,611,"21 de agosto de 1994"
30,12,13,290,329,329,658,"21 de agosto de 1994"
30,12,13,291,342,364,706,"21 de agosto de 1994"
30,12,13,292,152,151,303,"21 de agosto de 1994"
30,12,13,293,284,252,536,"21 de agosto de 1994"
30,12,47,1094,342,337,679,"21 de agosto de 1994"
30,12,47,1095,276,289,565,"21 de agosto de 1994"
30,12,47,1096,317,330,647,"21 de agosto de 1994"
30,12,47,1097,507,481,988,"21 de agosto de 1994"
30,12,47,1098,264,313,577,"21 de agosto de 1994"
30,12,47,1099,390,470,860,"21 de agosto de 1994"
30,12,47,1100,433,488,921,"21 de agosto de 1994"
30,12,47,1101,307,339,646,"21 de agosto de 1994"
30,12,47,1102,369,450,819,"21 de agosto de 1994"
30,12,47,1103,375,478,853,"21 de agosto de 1994"
30,12,47,1104,346,419,765,"21 de agosto de 1994"
30,12,47,1105,293,381,674,"21 de agosto de 1994"
30,12,47,1106,410,518,928,"21 de agosto de 1994"
30,12,47,1107,446,514,960,"21 de agosto de 1994"
30,12,47,1108,421,521,942,"21 de agosto de 1994"
30,12,47,1109,298,362,660,"21 de agosto de 1994"
30,12,47,1110,361,429,790,"21 de agosto de 1994"
30,12,47,1111,466,540,1006,"21 de agosto de 1994"
30,12,47,1112,343,387,730,"21 de agosto de 1994"
30,12,47,1113,382,426,808,"21 de agosto de 1994"
30,12,47,1114,397,414,811,"21 de agosto de 1994"
30,12,47,1115,501,538,1039,"21 de agosto de 1994"
30,12,47,1116,373,317,690,"21 de agosto de 1994"
30,12,47,1117,345,284,629,"21 de agosto de 1994"
30,12,47,1118,306,316,622,"21 de agosto de 1994"
30,12,47,1119,273,204,477,"21 de agosto de 1994"
30,12,47,1120,632,729,1361,"21 de agosto de 1994"
30,12,47,1121,365,376,741,"21 de agosto de 1994"
30,12,47,1122,414,456,870,"21 de agosto de 1994"
30,12,47,1123,227,251,478,"21 de agosto de 1994"
30,12,47,1124,225,261,486,"21 de agosto de 1994"
30,12,47,1125,304,351,655,"21 de agosto de 1994"
30,12,47,1126,552,599,1151,"21 de agosto de 1994"
30,12,47,1127,571,650,1221,"21 de agosto de 1994"
30,12,47,1128,527,606,1133,"21 de agosto de 1994"
30,12,47,1129,305,310,615,"21 de agosto de 1994"
30,12,47,1130,490,533,1023,"21 de agosto de 1994"
30,12,47,1131,503,568,1071,"21 de agosto de 1994"
30,12,47,1132,529,552,1081,"21 de agosto de 1994"
30,12,47,1133,497,497,994,"21 de agosto de 1994"
30,12,47,1134,582,516,1098,"21 de agosto de 1994"
30,12,47,1135,143,114,257,"21 de agosto de 1994"
30,12,47,1136,101,97,198,"21 de agosto de 1994"
30,12,47,1137,455,444,899,"21 de agosto de 1994"
30,12,47,1138,315,306,621,"21 de agosto de 1994"
30,12,47,1139,293,289,582,"21 de agosto de 1994"
30,12,47,1140,547,569,1116,"21 de agosto de 1994"
30,12,47,1141,403,414,817,"21 de agosto de 1994"
30,12,47,1142,403,422,825,"21 de agosto de 1994"
30,12,47,1143,333,302,635,"21 de agosto de 1994"
30,12,47,1144,214,181,395,"21 de agosto de 1994"
30,12,47,1145,218,189,407,"21 de agosto de 1994"
30,12,47,1146,364,291,655,"21 de agosto de 1994"
30,12,47,1147,424,433,857,"21 de agosto de 1994"
30,12,47,1148,497,588,1085,"21 de agosto de 1994"
30,12,47,1149,299,334,633,"21 de agosto de 1994"
30,12,47,1150,439,430,869,"21 de agosto de 1994"
30,12,47,1151,463,460,923,"21 de agosto de 1994"
30,12,47,1152,213,183,396,"21 de agosto de 1994"
30,12,56,1310,358,397,755,"21 de agosto de 1994"
30,12,56,1311,401,461,862,"21 de agosto de 1994"
30,12,56,1312,302,300,602,"21 de agosto de 1994"
30,12,56,1313,335,321,656,"21 de agosto de 1994"
30,12,56,1314,265,224,489,"21 de agosto de 1994"
30,12,56,1315,191,178,369,"21 de agosto de 1994"
30,12,56,1316,536,536,1072,"21 de agosto de 1994"
30,12,56,1317,513,436,949,"21 de agosto de 1994"
30,12,56,1318,343,304,647,"21 de agosto de 1994"
30,12,56,1319,356,297,653,"21 de agosto de 1994"
30,12,77,1672,293,343,636,"21 de agosto de 1994"
30,12,77,1673,267,382,649,"21 de agosto de 1994"
30,12,77,1674,386,488,874,"21 de agosto de 1994"
30,12,77,1675,356,359,715,"21 de agosto de 1994"
30,12,77,1676,260,284,544,"21 de agosto de 1994"
30,12,77,1677,356,336,692,"21 de agosto de 1994"
30,12,77,1678,299,244,543,"21 de agosto de 1994"
30,12,77,1679,209,202,411,"21 de agosto de 1994"
30,12,77,1680,492,472,964,"21 de agosto de 1994"
30,12,77,1681,269,251,520,"21 de agosto de 1994"
30,12,77,1682,311,270,581,"21 de agosto de 1994"
30,12,77,1683,95,74,169,"21 de agosto de 1994"
30,12,77,1684,499,486,985,"21 de agosto de 1994"
30,12,77,1685,461,465,926,"21 de agosto de 1994"
30,12,77,1686,332,329,661,"21 de agosto de 1994"
30,12,77,1687,44,48,92,"21 de agosto de 1994"
30,12,86,1791,556,543,1099,"21 de agosto de 1994"
30,12,86,1792,131,114,245,"21 de agosto de 1994"
30,12,86,1793,203,164,367,"21 de agosto de 1994"
30,12,86,1794,335,266,601,"21 de agosto de 1994"
30,12,86,1795,154,132,286,"21 de agosto de 1994"
30,12,86,1796,259,230,489,"21 de agosto de 1994"
30,12,86,1797,232,235,467,"21 de agosto de 1994"
30,12,120,2764,294,309,603,"21 de agosto de 1994"
30,12,120,2765,368,393,761,"21 de agosto de 1994"
30,12,120,2766,387,371,758,"21 de agosto de 1994"
30,12,120,2767,393,415,808,"21 de agosto de 1994"
30,12,120,2768,75,66,141,"21 de agosto de 1994"
30,12,120,2769,113,69,182,"21 de agosto de 1994"
30,12,173,3859,420,423,843,"21 de agosto de 1994"
30,12,173,3860,195,213,408,"21 de agosto de 1994"
30,12,173,3861,275,308,583,"21 de agosto de 1994"
30,12,173,3862,468,569,1037,"21 de agosto de 1994"
30,12,173,3863,578,659,1237,"21 de agosto de 1994"
30,12,173,3864,284,333,617,"21 de agosto de 1994"
30,12,173,3865,290,289,579,"21 de agosto de 1994"
30,12,173,3866,309,318,627,"21 de agosto de 1994"
30,12,173,3867,583,655,1238,"21 de agosto de 1994"
30,12,173,3868,475,578,1053,"21 de agosto de 1994"
30,12,173,3869,433,497,930,"21 de agosto de 1994"
30,12,173,3870,252,287,539,"21 de agosto de 1994"
30,12,173,3871,591,681,1272,"21 de agosto de 1994"
30,12,173,3872,438,526,964,"21 de agosto de 1994"
30,12,173,3873,266,323,589,"21 de agosto de 1994"
30,12,173,3874,226,216,442,"21 de agosto de 1994"
30,12,173,3875,548,683,1231,"21 de agosto de 1994"
30,12,173,3876,330,354,684,"21 de agosto de 1994"
30,12,173,3877,352,436,788,"21 de agosto de 1994"
30,12,173,3878,507,631,1138,"21 de agosto de 1994"
30,12,173,3879,456,545,1001,"21 de agosto de 1994"
30,12,173,3880,464,519,983,"21 de agosto de 1994"
30,12,173,3881,359,393,752,"21 de agosto de 1994"
30,12,173,3882,540,603,1143,"21 de agosto de 1994"
30,12,173,3883,578,681,1259,"21 de agosto de 1994"
30,12,173,3884,213,287,500,"21 de agosto de 1994"
30,12,173,3885,273,279,552,"21 de agosto de 1994"
30,12,173,3886,568,610,1178,"21 de agosto de 1994"
30,12,173,3887,333,381,714,"21 de agosto de 1994"
30,12,173,3888,273,267,540,"21 de agosto de 1994"
30,12,173,3889,236,215,451,"21 de agosto de 1994"
30,12,173,3890,582,528,1110,"21 de agosto de 1994"
30,12,173,3891,403,360,763,"21 de agosto de 1994"
30,12,173,3892,399,364,763,"21 de agosto de 1994"
30,12,173,3893,330,290,620,"21 de agosto de 1994"
30,12,173,3894,313,279,592,"21 de agosto de 1994"
30,12,173,3895,174,143,317,"21 de agosto de 1994"
30,12,173,3896,672,671,1343,"21 de agosto de 1994"
30,12,173,3897,373,357,730,"21 de agosto de 1994"
30,12,173,3898,349,308,657,"21 de agosto de 1994"
30,12,173,3899,495,465,960,"21 de agosto de 1994"
30,12,173,3900,486,488,974,"21 de agosto de 1994"
30,12,173,3901,261,226,487,"21 de agosto de 1994"
30,12,173,3902,189,154,343,"21 de agosto de 1994"
30,12,173,3903,237,215,452,"21 de agosto de 1994"
30,12,173,3904,148,143,291,"21 de agosto de 1994"
30,12,173,3905,377,363,740,"21 de agosto de 1994"
30,12,173,3906,434,434,868,"21 de agosto de 1994"
30,12,173,3907,498,383,881,"21 de agosto de 1994"
30,12,173,3908,556,488,1044,"21 de agosto de 1994"
30,12,173,3909,355,313,668,"21 de agosto de 1994"
30,12,173,3910,262,228,490,"21 de agosto de 1994"
30,12,173,3911,376,325,701,"21 de agosto de 1994"
30,12,173,3912,85,76,161,"21 de agosto de 1994"
30,12,173,3913,300,269,569,"21 de agosto de 1994"
30,12,173,3914,307,291,598,"21 de agosto de 1994"
30,12,173,3915,129,129,258,"21 de agosto de 1994"
30,12,173,3916,131,90,221,"21 de agosto de 1994"
30,12,173,3917,387,397,784,"21 de agosto de 1994"
30,12,173,3918,285,244,529,"21 de agosto de 1994"
30,12,173,3919,551,447,998,"21 de agosto de 1994"
30,12,173,3920,264,230,494,"21 de agosto de 1994"
30,12,173,3921,241,227,468,"21 de agosto de 1994"
30,12,173,3922,451,367,818,"21 de agosto de 1994"
30,12,173,3923,480,476,956,"21 de agosto de 1994"
30,12,173,3924,124,134,258,"21 de agosto de 1994"
30,12,173,3925,112,87,199,"21 de agosto de 1994"
30,12,175,3975,446,390,836,"21 de agosto de 1994"
30,12,175,3976,483,447,930,"21 de agosto de 1994"
30,12,175,3977,296,322,618,"21 de agosto de 1994"
30,12,175,3978,175,123,298,"21 de agosto de 1994"
30,12,189,4171,325,363,688,"21 de agosto de 1994"
30,12,189,4172,371,365,736,"21 de agosto de 1994"
30,12,204,4614,648,590,1238,"21 de agosto de 1994"
30,12,204,4615,529,531,1060,"21 de agosto de 1994"
30,12,204,4616,467,439,906,"21 de agosto de 1994"
30,12,204,4617,308,310,618,"21 de agosto de 1994"
30,12,204,4618,542,609,1151,"21 de agosto de 1994"
30,12,204,4619,539,550,1089,"21 de agosto de 1994"
30,12,204,4620,312,355,667,"21 de agosto de 1994"
30,12,204,4621,287,286,573,"21 de agosto de 1994"
30,12,204,4622,582,653,1235,"21 de agosto de 1994"
30,12,204,4623,340,366,706,"21 de agosto de 1994"
30,12,204,4624,508,510,1018,"21 de agosto de 1994"
30,12,204,4625,274,271,545,"21 de agosto de 1994"
30,12,204,4626,350,311,661,"21 de agosto de 1994"
30,12,204,4627,365,283,648,"21 de agosto de 1994"
30,12,204,4628,326,295,621,"21 de agosto de 1994"
30,12,204,4629,102,96,198,"21 de agosto de 1994"
30,12,204,4630,249,240,489,"21 de agosto de 1994"
30,12,204,4631,289,275,564,"21 de agosto de 1994"
30,12,204,4632,290,284,574,"21 de agosto de 1994"
30,12,204,4633,288,306,594,"21 de agosto de 1994"
30,12,204,4634,496,463,959,"21 de agosto de 1994"
30,12,204,4635,298,253,551,"21 de agosto de 1994"
30,12,204,4636,153,129,282,"21 de agosto de 1994"
30,12,204,4637,337,310,647,"21 de agosto de 1994"
30,12,204,4638,257,241,498,"21 de agosto de 1994"
30,12,204,4639,589,565,1154,"21 de agosto de 1994"
30,12,204,4640,454,404,858,"21 de agosto de 1994"
30,12,204,4641,350,301,651,"21 de agosto de 1994"
30,12,204,4642,359,368,727,"21 de agosto de 1994"
30,12,204,4643,311,393,704,"21 de agosto de 1994"
30,12,204,4644,385,416,801,"21 de agosto de 1994"
30,12,204,4645,99,95,194,"21 de agosto de 1994"
30,12,204,4646,433,339,772,"21 de agosto de 1994"
30,13,3,7,543,631,1174,"21 de agosto de 1994"
30,13,3,8,301,282,583,"21 de agosto de 1994"
30,13,3,9,440,495,935,"21 de agosto de 1994"
30,13,3,10,282,303,585,"21 de agosto de 1994"
30,13,3,11,525,583,1108,"21 de agosto de 1994"
30,13,3,12,360,354,714,"21 de agosto de 1994"
30,13,3,13,562,591,1153,"21 de agosto de 1994"
30,13,3,14,403,416,819,"21 de agosto de 1994"
30,13,3,15,593,637,1230,"21 de agosto de 1994"
30,13,3,16,579,630,1209,"21 de agosto de 1994"
30,13,3,17,357,398,755,"21 de agosto de 1994"
30,13,3,18,523,559,1082,"21 de agosto de 1994"
30,13,3,19,551,636,1187,"21 de agosto de 1994"
30,13,3,20,369,416,785,"21 de agosto de 1994"
30,13,3,21,402,448,850,"21 de agosto de 1994"
30,13,3,22,391,416,807,"21 de agosto de 1994"
30,13,3,23,721,781,1502,"21 de agosto de 1994"
30,13,3,24,734,745,1479,"21 de agosto de 1994"
30,13,3,25,668,757,1425,"21 de agosto de 1994"
30,13,3,26,505,558,1063,"21 de agosto de 1994"
30,13,3,27,631,660,1291,"21 de agosto de 1994"
30,13,3,28,620,608,1228,"21 de agosto de 1994"
30,13,3,29,557,598,1155,"21 de agosto de 1994"
30,13,3,30,605,640,1245,"21 de agosto de 1994"
30,13,3,31,409,412,821,"21 de agosto de 1994"
30,13,3,32,517,489,1006,"21 de agosto de 1994"
30,13,3,33,402,373,775,"21 de agosto de 1994"
30,13,3,34,630,630,1260,"21 de agosto de 1994"
30,13,3,35,440,360,800,"21 de agosto de 1994"
30,13,3,36,631,574,1205,"21 de agosto de 1994"
30,13,3,37,604,579,1183,"21 de agosto de 1994"
30,13,3,38,465,444,909,"21 de agosto de 1994"
30,13,3,39,567,459,1026,"21 de agosto de 1994"
30,13,3,40,300,271,571,"21 de agosto de 1994"
30,13,3,41,345,325,670,"21 de agosto de 1994"
30,13,3,42,541,450,991,"21 de agosto de 1994"
30,13,3,43,602,518,1120,"21 de agosto de 1994"
30,13,3,44,484,421,905,"21 de agosto de 1994"
30,13,3,45,731,618,1349,"21 de agosto de 1994"
30,13,3,46,358,288,646,"21 de agosto de 1994"
30,13,34,632,207,215,422,"21 de agosto de 1994"
30,13,34,633,691,708,1399,"21 de agosto de 1994"
30,13,34,634,475,471,946,"21 de agosto de 1994"
30,13,34,635,483,514,997,"21 de agosto de 1994"
30,13,34,636,596,593,1189,"21 de agosto de 1994"
30,13,34,637,326,363,689,"21 de agosto de 1994"
30,13,34,638,642,617,1259,"21 de agosto de 1994"
30,13,34,639,411,395,806,"21 de agosto de 1994"
30,13,34,640,485,469,954,"21 de agosto de 1994"
30,13,34,641,522,491,1013,"21 de agosto de 1994"
30,13,34,642,413,447,860,"21 de agosto de 1994"
30,13,34,643,503,618,1121,"21 de agosto de 1994"
30,13,34,644,374,304,678,"21 de agosto de 1994"
30,13,34,645,450,323,773,"21 de agosto de 1994"
30,13,34,646,249,232,481,"21 de agosto de 1994"
30,13,34,647,643,549,1192,"21 de agosto de 1994"
30,13,34,648,211,208,419,"21 de agosto de 1994"
30,13,34,649,356,285,641,"21 de agosto de 1994"
30,13,34,650,304,259,563,"21 de agosto de 1994"
30,13,34,651,316,284,600,"21 de agosto de 1994"
30,13,34,652,468,406,874,"21 de agosto de 1994"
30,13,34,653,486,422,908,"21 de agosto de 1994"
30,13,34,654,578,499,1077,"21 de agosto de 1994"
30,13,34,655,467,350,817,"21 de agosto de 1994"
30,13,75,1641,544,530,1074,"21 de agosto de 1994"
30,13,75,1642,588,570,1158,"21 de agosto de 1994"
30,13,75,1643,233,211,444,"21 de agosto de 1994"
30,13,75,1644,196,169,365,"21 de agosto de 1994"
30,13,75,1645,302,288,590,"21 de agosto de 1994"
30,13,75,1646,215,174,389,"21 de agosto de 1994"
30,13,75,1647,376,351,727,"21 de agosto de 1994"
30,13,75,1648,503,508,1011,"21 de agosto de 1994"
30,13,75,1649,311,283,594,"21 de agosto de 1994"
30,13,75,1650,346,317,663,"21 de agosto de 1994"
30,13,75,1651,523,410,933,"21 de agosto de 1994"
30,13,75,1652,484,464,948,"21 de agosto de 1994"
30,13,75,1653,443,408,851,"21 de agosto de 1994"
30,13,75,1654,252,234,486,"21 de agosto de 1994"
30,13,75,1655,350,344,694,"21 de agosto de 1994"
30,13,75,1656,224,204,428,"21 de agosto de 1994"
30,13,75,1657,434,406,840,"21 de agosto de 1994"
30,13,75,1658,381,371,752,"21 de agosto de 1994"
30,13,75,1659,349,382,731,"21 de agosto de 1994"
30,13,75,1660,231,292,523,"21 de agosto de 1994"
30,13,75,1661,286,298,584,"21 de agosto de 1994"
30,13,75,1662,504,517,1021,"21 de agosto de 1994"
30,13,75,1663,185,196,381,"21 de agosto de 1994"
30,13,75,1664,429,363,792,"21 de agosto de 1994"
30,13,75,1665,713,587,1300,"21 de agosto de 1994"
30,13,75,1666,414,415,829,"21 de agosto de 1994"
30,13,75,1667,494,383,877,"21 de agosto de 1994"
30,13,79,1701,280,320,600,"21 de agosto de 1994"
30,13,79,1702,551,526,1077,"21 de agosto de 1994"
30,13,79,1703,579,622,1201,"21 de agosto de 1994"
30,13,79,1704,628,689,1317,"21 de agosto de 1994"
30,13,79,1705,557,611,1168,"21 de agosto de 1994"
30,13,79,1706,581,643,1224,"21 de agosto de 1994"
30,13,79,1707,531,630,1161,"21 de agosto de 1994"
30,13,79,1708,468,551,1019,"21 de agosto de 1994"
30,13,79,1709,541,550,1091,"21 de agosto de 1994"
30,13,79,1710,576,602,1178,"21 de agosto de 1994"
30,13,79,1711,526,441,967,"21 de agosto de 1994"
30,13,79,1712,484,404,888,"21 de agosto de 1994"
30,13,79,1713,575,479,1054,"21 de agosto de 1994"
30,13,79,1714,543,471,1014,"21 de agosto de 1994"
30,13,79,1715,546,439,985,"21 de agosto de 1994"
30,13,79,1716,295,234,529,"21 de agosto de 1994"
30,13,79,1717,576,469,1045,"21 de agosto de 1994"
30,13,95,2179,480,484,964,"21 de agosto de 1994"
30,13,95,2180,360,377,737,"21 de agosto de 1994"
30,13,95,2181,460,437,897,"21 de agosto de 1994"
30,13,95,2182,472,516,988,"21 de agosto de 1994"
30,13,95,2183,565,577,1142,"21 de agosto de 1994"
30,13,95,2184,561,483,1044,"21 de agosto de 1994"
30,13,95,2185,253,250,503,"21 de agosto de 1994"
30,13,95,2186,252,222,474,"21 de agosto de 1994"
30,13,95,2187,249,211,460,"21 de agosto de 1994"
30,13,95,2188,664,632,1296,"21 de agosto de 1994"
30,13,95,2189,341,278,619,"21 de agosto de 1994"
30,13,95,2190,327,258,585,"21 de agosto de 1994"
30,13,95,2191,461,424,885,"21 de agosto de 1994"
30,13,95,2192,353,315,668,"21 de agosto de 1994"
30,13,95,2193,298,232,530,"21 de agosto de 1994"
30,13,95,2194,339,290,629,"21 de agosto de 1994"
30,13,95,2195,363,299,662,"21 de agosto de 1994"
30,13,95,2196,310,249,559,"21 de agosto de 1994"
30,13,95,2197,334,305,639,"21 de agosto de 1994"
30,13,95,2198,436,417,853,"21 de agosto de 1994"
30,13,95,2199,672,548,1220,"21 de agosto de 1994"
30,13,95,2200,437,387,824,"21 de agosto de 1994"
30,13,105,2379,595,554,1149,"21 de agosto de 1994"
30,13,105,2380,367,354,721,"21 de agosto de 1994"
30,13,105,2381,397,283,680,"21 de agosto de 1994"
30,13,105,2382,266,221,487,"21 de agosto de 1994"
30,13,105,2383,257,233,490,"21 de agosto de 1994"
30,13,105,2384,466,372,838,"21 de agosto de 1994"
30,13,105,2385,379,350,729,"21 de agosto de 1994"
30,13,105,2386,431,360,791,"21 de agosto de 1994"
30,13,105,2387,403,334,737,"21 de agosto de 1994"
30,13,105,2388,630,569,1199,"21 de agosto de 1994"
30,13,105,2389,525,435,960,"21 de agosto de 1994"
30,13,131,3081,725,752,1477,"21 de agosto de 1994"
30,13,131,3082,679,762,1441,"21 de agosto de 1994"
30,13,131,3083,341,409,750,"21 de agosto de 1994"
30,13,131,3084,372,390,762,"21 de agosto de 1994"
30,13,131,3085,450,428,878,"21 de agosto de 1994"
30,13,131,3086,463,414,877,"21 de agosto de 1994"
30,13,131,3087,343,292,635,"21 de agosto de 1994"
30,13,131,3088,387,323,710,"21 de agosto de 1994"
30,13,131,3089,445,415,860,"21 de agosto de 1994"
30,13,131,3090,298,267,565,"21 de agosto de 1994"
30,13,131,3091,250,218,468,"21 de agosto de 1994"
30,13,131,3092,412,372,784,"21 de agosto de 1994"
30,13,131,3093,453,456,909,"21 de agosto de 1994"
30,13,131,3094,447,416,863,"21 de agosto de 1994"
30,13,131,3095,362,351,713,"21 de agosto de 1994"
30,13,131,3096,257,243,500,"21 de agosto de 1994"
30,13,131,3097,272,313,585,"21 de agosto de 1994"
30,13,131,3098,434,366,800,"21 de agosto de 1994"
30,13,131,3099,570,534,1104,"21 de agosto de 1994"
30,13,131,3100,680,633,1313,"21 de agosto de 1994"
30,13,131,3101,493,436,929,"21 de agosto de 1994"
30,13,131,3102,486,377,863,"21 de agosto de 1994"
30,13,131,3103,685,661,1346,"21 de agosto de 1994"
30,13,131,3104,621,647,1268,"21 de agosto de 1994"
30,13,131,3105,533,490,1023,"21 de agosto de 1994"
30,13,131,3106,332,285,617,"21 de agosto de 1994"
30,13,131,3107,427,437,864,"21 de agosto de 1994"
30,13,131,3108,576,519,1095,"21 de agosto de 1994"
30,13,150,3530,413,401,814,"21 de agosto de 1994"
30,13,150,3531,486,473,959,"21 de agosto de 1994"
30,13,150,3532,401,374,775,"21 de agosto de 1994"
30,13,150,3533,560,529,1089,"21 de agosto de 1994"
30,13,150,3534,267,222,489,"21 de agosto de 1994"
30,13,150,3535,461,424,885,"21 de agosto de 1994"
30,13,150,3536,535,478,1013,"21 de agosto de 1994"
30,13,150,3537,216,222,438,"21 de agosto de 1994"
30,13,150,3538,480,443,923,"21 de agosto de 1994"
30,13,150,3539,519,527,1046,"21 de agosto de 1994"
30,13,150,3540,523,560,1083,"21 de agosto de 1994"
30,13,150,3541,505,446,951,"21 de agosto de 1994"
30,13,150,3542,474,445,919,"21 de agosto de 1994"
30,14,63,1413,522,554,1076,"21 de agosto de 1994"
30,14,63,1414,725,742,1467,"21 de agosto de 1994"
30,14,63,1415,425,453,878,"21 de agosto de 1994"
30,14,63,1416,554,591,1145,"21 de agosto de 1994"
30,14,63,1417,659,709,1368,"21 de agosto de 1994"
30,14,63,1418,427,434,861,"21 de agosto de 1994"
30,14,63,1419,530,575,1105,"21 de agosto de 1994"
30,14,63,1420,353,337,690,"21 de agosto de 1994"
30,14,63,1421,431,476,907,"21 de agosto de 1994"
30,14,63,1422,587,588,1175,"21 de agosto de 1994"
30,14,63,1423,336,362,698,"21 de agosto de 1994"
30,14,63,1424,412,403,815,"21 de agosto de 1994"
30,14,63,1425,462,481,943,"21 de agosto de 1994"
30,14,63,1426,419,483,902,"21 de agosto de 1994"
30,14,63,1427,466,470,936,"21 de agosto de 1994"
30,14,63,1428,402,467,869,"21 de agosto de 1994"
30,14,63,1429,454,515,969,"21 de agosto de 1994"
30,14,63,1430,326,341,667,"21 de agosto de 1994"
30,14,63,1431,483,498,981,"21 de agosto de 1994"
30,14,63,1432,429,475,904,"21 de agosto de 1994"
30,14,63,1433,423,465,888,"21 de agosto de 1994"
30,14,63,1434,516,547,1063,"21 de agosto de 1994"
30,14,63,1435,442,482,924,"21 de agosto de 1994"
30,14,63,1436,403,427,830,"21 de agosto de 1994"
30,14,63,1437,592,501,1093,"21 de agosto de 1994"
30,14,63,1438,401,402,803,"21 de agosto de 1994"
30,14,63,1439,195,197,392,"21 de agosto de 1994"
30,14,63,1440,257,180,437,"21 de agosto de 1994"
30,14,63,1441,361,282,643,"21 de agosto de 1994"
30,14,63,1442,382,264,646,"21 de agosto de 1994"
30,14,63,1443,447,357,804,"21 de agosto de 1994"
30,14,63,1444,501,375,876,"21 de agosto de 1994"
30,14,63,1445,608,461,1069,"21 de agosto de 1994"
30,14,63,1446,909,711,1620,"21 de agosto de 1994"
30,14,63,1447,401,302,703,"21 de agosto de 1994"
30,14,63,1448,516,390,906,"21 de agosto de 1994"
30,14,63,1449,195,205,400,"21 de agosto de 1994"
30,14,63,1450,179,124,303,"21 de agosto de 1994"
30,14,63,1451,395,270,665,"21 de agosto de 1994"
30,14,63,1452,377,307,684,"21 de agosto de 1994"
30,14,63,1453,532,415,947,"21 de agosto de 1994"
30,14,63,1454,506,421,927,"21 de agosto de 1994"
30,14,63,1455,667,509,1176,"21 de agosto de 1994"
30,14,109,2420,556,540,1096,"21 de agosto de 1994"
30,14,109,2421,513,514,1027,"21 de agosto de 1994"
30,14,109,2422,375,425,800,"21 de agosto de 1994"
30,14,109,2423,406,426,832,"21 de agosto de 1994"
30,14,109,2424,406,383,789,"21 de agosto de 1994"
30,14,109,2425,471,481,952,"21 de agosto de 1994"
30,14,109,2426,464,460,924,"21 de agosto de 1994"
30,14,109,2427,700,706,1406,"21 de agosto de 1994"
30,14,109,2428,526,531,1057,"21 de agosto de 1994"
30,14,109,2429,587,620,1207,"21 de agosto de 1994"
30,14,109,2430,444,459,903,"21 de agosto de 1994"
30,14,109,2431,814,787,1601,"21 de agosto de 1994"
30,14,109,2432,662,793,1455,"21 de agosto de 1994"
30,14,109,2433,452,517,969,"21 de agosto de 1994"
30,14,109,2434,928,452,1380,"21 de agosto de 1994"
30,14,109,2435,721,774,1495,"21 de agosto de 1994"
30,14,109,2436,462,492,954,"21 de agosto de 1994"
30,14,109,2437,437,428,865,"21 de agosto de 1994"
30,14,109,2438,368,384,752,"21 de agosto de 1994"
30,14,109,2439,391,380,771,"21 de agosto de 1994"
30,14,109,2440,553,579,1132,"21 de agosto de 1994"
30,14,109,2441,513,558,1071,"21 de agosto de 1994"
30,14,109,2442,337,385,722,"21 de agosto de 1994"
30,14,109,2443,352,356,708,"21 de agosto de 1994"
30,14,109,2444,419,486,905,"21 de agosto de 1994"
30,14,109,2445,477,589,1066,"21 de agosto de 1994"
30,14,109,2446,482,494,976,"21 de agosto de 1994"
30,14,109,2447,473,571,1044,"21 de agosto de 1994"
30,14,109,2448,462,519,981,"21 de agosto de 1994"
30,14,109,2449,563,684,1247,"21 de agosto de 1994"
30,14,109,2450,473,464,937,"21 de agosto de 1994"
30,14,109,2451,336,350,686,"21 de agosto de 1994"
30,14,109,2452,569,618,1187,"21 de agosto de 1994"
30,14,109,2453,258,279,537,"21 de agosto de 1994"
30,14,109,2454,237,283,520,"21 de agosto de 1994"
30,14,109,2455,231,255,486,"21 de agosto de 1994"
30,14,109,2456,347,399,746,"21 de agosto de 1994"
30,14,109,2457,356,390,746,"21 de agosto de 1994"
30,14,109,2458,554,613,1167,"21 de agosto de 1994"
30,14,109,2459,513,520,1033,"21 de agosto de 1994"
30,14,109,2460,531,579,1110,"21 de agosto de 1994"
30,14,109,2461,364,428,792,"21 de agosto de 1994"
30,14,109,2462,666,741,1407,"21 de agosto de 1994"
30,14,109,2463,299,329,628,"21 de agosto de 1994"
30,14,109,2464,602,627,1229,"21 de agosto de 1994"
30,14,109,2465,843,942,1785,"21 de agosto de 1994"
30,14,109,2466,299,320,619,"21 de agosto de 1994"
30,14,109,2467,337,345,682,"21 de agosto de 1994"
30,14,109,2468,634,635,1269,"21 de agosto de 1994"
30,14,109,2469,493,542,1035,"21 de agosto de 1994"
30,14,109,2470,706,773,1479,"21 de agosto de 1994"
30,14,109,2471,403,473,876,"21 de agosto de 1994"
30,14,109,2472,449,529,978,"21 de agosto de 1994"
30,14,109,2473,565,615,1180,"21 de agosto de 1994"
30,14,109,2474,354,392,746,"21 de agosto de 1994"
30,14,109,2475,477,563,1040,"21 de agosto de 1994"
30,14,109,2476,693,818,1511,"21 de agosto de 1994"
30,14,109,2477,572,635,1207,"21 de agosto de 1994"
30,14,109,2478,524,597,1121,"21 de agosto de 1994"
30,14,109,2479,602,575,1177,"21 de agosto de 1994"
30,14,109,2480,363,377,740,"21 de agosto de 1994"
30,14,109,2481,530,554,1084,"21 de agosto de 1994"
30,14,109,2482,468,505,973,"21 de agosto de 1994"
30,14,109,2483,493,548,1041,"21 de agosto de 1994"
30,14,109,2484,405,439,844,"21 de agosto de 1994"
30,14,109,2485,352,405,757,"21 de agosto de 1994"
30,14,109,2486,530,582,1112,"21 de agosto de 1994"
30,14,109,2487,342,383,725,"21 de agosto de 1994"
30,14,109,2488,449,480,929,"21 de agosto de 1994"
30,14,109,2489,601,650,1251,"21 de agosto de 1994"
30,14,109,2490,243,225,468,"21 de agosto de 1994"
30,14,109,2491,294,278,572,"21 de agosto de 1994"
30,14,109,2492,467,455,922,"21 de agosto de 1994"
30,14,109,2493,203,204,407,"21 de agosto de 1994"
30,14,109,2494,352,282,634,"21 de agosto de 1994"
30,14,109,2495,295,299,594,"21 de agosto de 1994"
30,14,109,2496,225,184,409,"21 de agosto de 1994"
30,14,109,2497,217,189,406,"21 de agosto de 1994"
30,14,109,2498,454,374,828,"21 de agosto de 1994"
30,14,109,2499,473,368,841,"21 de agosto de 1994"
30,14,109,2500,410,361,771,"21 de agosto de 1994"
30,14,109,2501,399,347,746,"21 de agosto de 1994"
30,14,109,2502,453,395,848,"21 de agosto de 1994"
30,14,109,2503,346,305,651,"21 de agosto de 1994"
30,14,109,2504,505,421,926,"21 de agosto de 1994"
30,14,109,2505,331,312,643,"21 de agosto de 1994"
30,14,109,2506,344,346,690,"21 de agosto de 1994"
30,14,109,2507,316,268,584,"21 de agosto de 1994"
30,14,109,2508,467,345,812,"21 de agosto de 1994"
30,14,109,2509,337,271,608,"21 de agosto de 1994"
30,14,109,2510,425,339,764,"21 de agosto de 1994"
30,14,109,2511,288,210,498,"21 de agosto de 1994"
30,14,109,2512,521,402,923,"21 de agosto de 1994"
30,14,109,2513,482,374,856,"21 de agosto de 1994"
30,14,109,2514,449,318,767,"21 de agosto de 1994"
30,14,109,2515,543,437,980,"21 de agosto de 1994"
30,14,109,2516,530,414,944,"21 de agosto de 1994"
30,14,109,2517,480,330,810,"21 de agosto de 1994"
30,14,109,2518,436,360,796,"21 de agosto de 1994"
30,14,109,2519,519,369,888,"21 de agosto de 1994"
30,14,109,2520,344,262,606,"21 de agosto de 1994"
30,14,109,2521,304,246,550,"21 de agosto de 1994"
30,14,109,2522,293,257,550,"21 de agosto de 1994"
30,14,109,2523,103,75,178,"21 de agosto de 1994"
30,14,109,2524,401,303,704,"21 de agosto de 1994"
30,14,109,2525,556,496,1052,"21 de agosto de 1994"
30,15,41,763,247,281,528,"21 de agosto de 1994"
30,15,41,764,255,266,521,"21 de agosto de 1994"
30,15,41,765,170,205,375,"21 de agosto de 1994"
30,15,41,766,265,316,581,"21 de agosto de 1994"
30,15,41,767,237,226,463,"21 de agosto de 1994"
30,15,41,768,433,462,895,"21 de agosto de 1994"
30,15,41,769,186,198,384,"21 de agosto de 1994"
30,15,41,770,251,269,520,"21 de agosto de 1994"
30,15,41,771,279,312,591,"21 de agosto de 1994"
30,15,41,772,250,263,513,"21 de agosto de 1994"
30,15,41,773,474,486,960,"21 de agosto de 1994"
30,15,41,774,471,532,1003,"21 de agosto de 1994"
30,15,41,775,549,551,1100,"21 de agosto de 1994"
30,15,41,776,366,385,751,"21 de agosto de 1994"
30,15,41,777,389,402,791,"21 de agosto de 1994"
30,15,41,778,382,462,844,"21 de agosto de 1994"
30,15,41,779,360,377,737,"21 de agosto de 1994"
30,15,41,780,492,557,1049,"21 de agosto de 1994"
30,15,41,781,330,377,707,"21 de agosto de 1994"
30,15,41,782,397,438,835,"21 de agosto de 1994"
30,15,41,783,295,314,609,"21 de agosto de 1994"
30,15,41,784,643,659,1302,"21 de agosto de 1994"
30,15,41,785,349,346,695,"21 de agosto de 1994"
30,15,41,786,455,518,973,"21 de agosto de 1994"
30,15,41,787,476,521,997,"21 de agosto de 1994"
30,15,41,788,329,387,716,"21 de agosto de 1994"
30,15,41,789,262,308,570,"21 de agosto de 1994"
30,15,41,790,369,414,783,"21 de agosto de 1994"
30,15,41,791,405,438,843,"21 de agosto de 1994"
30,15,41,792,359,384,743,"21 de agosto de 1994"
30,15,41,793,595,646,1241,"21 de agosto de 1994"
30,15,41,794,438,464,902,"21 de agosto de 1994"
30,15,41,795,491,536,1027,"21 de agosto de 1994"
30,15,41,796,467,527,994,"21 de agosto de 1994"
30,15,41,797,435,510,945,"21 de agosto de 1994"
30,15,41,798,446,453,899,"21 de agosto de 1994"
30,15,41,799,442,498,940,"21 de agosto de 1994"
30,15,41,800,412,447,859,"21 de agosto de 1994"
30,15,41,801,416,467,883,"21 de agosto de 1994"
30,15,41,802,222,257,479,"21 de agosto de 1994"
30,15,41,803,848,308,1156,"21 de agosto de 1994"
30,15,41,804,308,366,674,"21 de agosto de 1994"
30,15,41,805,302,302,604,"21 de agosto de 1994"
30,15,41,806,433,451,884,"21 de agosto de 1994"
30,15,41,807,290,317,607,"21 de agosto de 1994"
30,15,41,808,386,414,800,"21 de agosto de 1994"
30,15,41,809,432,483,915,"21 de agosto de 1994"
30,15,41,810,365,373,738,"21 de agosto de 1994"
30,15,41,811,128,162,290,"21 de agosto de 1994"
30,15,41,812,434,483,917,"21 de agosto de 1994"
30,15,41,813,430,462,892,"21 de agosto de 1994"
30,15,41,814,309,367,676,"21 de agosto de 1994"
30,15,41,815,510,525,1035,"21 de agosto de 1994"
30,15,41,816,1041,1167,2208,"21 de agosto de 1994"
30,15,41,817,711,775,1486,"21 de agosto de 1994"
30,15,41,818,449,518,967,"21 de agosto de 1994"
30,15,41,819,340,421,761,"21 de agosto de 1994"
30,15,41,820,444,502,946,"21 de agosto de 1994"
30,15,41,821,306,292,598,"21 de agosto de 1994"
30,15,41,822,261,277,538,"21 de agosto de 1994"
30,15,41,823,309,358,667,"21 de agosto de 1994"
30,15,41,824,693,691,1384,"21 de agosto de 1994"
30,15,41,825,518,585,1103,"21 de agosto de 1994"
30,15,41,826,404,394,798,"21 de agosto de 1994"
30,15,41,827,259,276,535,"21 de agosto de 1994"
30,15,41,828,356,374,730,"21 de agosto de 1994"
30,15,41,829,353,391,744,"21 de agosto de 1994"
30,15,41,830,525,538,1063,"21 de agosto de 1994"
30,15,41,831,438,496,934,"21 de agosto de 1994"
30,15,41,832,281,325,606,"21 de agosto de 1994"
30,15,41,833,339,375,714,"21 de agosto de 1994"
30,15,41,834,290,335,625,"21 de agosto de 1994"
30,15,41,835,327,373,700,"21 de agosto de 1994"
30,15,41,836,481,554,1035,"21 de agosto de 1994"
30,15,41,837,437,451,888,"21 de agosto de 1994"
30,15,41,838,442,469,911,"21 de agosto de 1994"
30,15,41,839,490,522,1012,"21 de agosto de 1994"
30,15,41,840,557,559,1116,"21 de agosto de 1994"
30,15,41,841,452,520,972,"21 de agosto de 1994"
30,15,41,842,449,440,889,"21 de agosto de 1994"
30,15,41,843,421,465,886,"21 de agosto de 1994"
30,15,41,844,309,299,608,"21 de agosto de 1994"
30,15,41,845,311,355,666,"21 de agosto de 1994"
30,15,41,846,373,434,807,"21 de agosto de 1994"
30,15,41,847,459,455,914,"21 de agosto de 1994"
30,15,41,848,395,431,826,"21 de agosto de 1994"
30,15,41,849,192,207,399,"21 de agosto de 1994"
30,15,41,850,751,755,1506,"21 de agosto de 1994"
30,15,41,851,232,250,482,"21 de agosto de 1994"
30,15,41,852,286,306,592,"21 de agosto de 1994"
30,15,41,853,428,461,889,"21 de agosto de 1994"
30,15,41,854,600,586,1186,"21 de agosto de 1994"
30,15,41,855,637,675,1312,"21 de agosto de 1994"
30,15,41,856,173,166,339,"21 de agosto de 1994"
30,15,41,857,367,339,706,"21 de agosto de 1994"
30,15,41,858,341,374,715,"21 de agosto de 1994"
30,15,41,859,305,333,638,"21 de agosto de 1994"
30,15,41,860,292,358,650,"21 de agosto de 1994"
30,15,41,861,320,380,700,"21 de agosto de 1994"
30,15,41,862,552,526,1078,"21 de agosto de 1994"
30,15,41,863,251,260,511,"21 de agosto de 1994"
30,15,41,864,582,627,1209,"21 de agosto de 1994"
30,15,41,865,393,401,794,"21 de agosto de 1994"
30,15,41,866,191,73,264,"21 de agosto de 1994"
30,15,41,867,280,313,593,"21 de agosto de 1994"
30,15,41,868,424,487,911,"21 de agosto de 1994"
30,15,41,869,292,309,601,"21 de agosto de 1994"
30,15,41,870,331,345,676,"21 de agosto de 1994"
30,15,41,871,281,324,605,"21 de agosto de 1994"
30,15,41,872,530,529,1059,"21 de agosto de 1994"
30,15,41,873,623,638,1261,"21 de agosto de 1994"
30,15,41,874,529,536,1065,"21 de agosto de 1994"
30,15,41,875,413,435,848,"21 de agosto de 1994"
30,15,41,876,133,132,265,"21 de agosto de 1994"
30,15,41,877,202,185,387,"21 de agosto de 1994"
30,15,41,878,322,297,619,"21 de agosto de 1994"
30,15,41,879,408,388,796,"21 de agosto de 1994"
30,15,41,880,550,524,1074,"21 de agosto de 1994"
30,15,41,881,324,319,643,"21 de agosto de 1994"
30,15,41,882,479,476,955,"21 de agosto de 1994"
30,15,41,883,351,362,713,"21 de agosto de 1994"
30,15,41,884,545,554,1099,"21 de agosto de 1994"
30,15,41,885,474,497,971,"21 de agosto de 1994"
30,15,41,886,521,511,1032,"21 de agosto de 1994"
30,15,41,887,633,662,1295,"21 de agosto de 1994"
30,15,41,888,454,484,938,"21 de agosto de 1994"
30,15,41,889,413,429,842,"21 de agosto de 1994"
30,15,41,890,385,427,812,"21 de agosto de 1994"
30,15,41,891,547,557,1104,"21 de agosto de 1994"
30,15,41,892,575,657,1232,"21 de agosto de 1994"
30,15,41,893,436,451,887,"21 de agosto de 1994"
30,15,41,894,593,623,1216,"21 de agosto de 1994"
30,15,41,895,531,570,1101,"21 de agosto de 1994"
30,15,41,896,460,463,923,"21 de agosto de 1994"
30,15,41,897,467,441,908,"21 de agosto de 1994"
30,15,41,898,487,484,971,"21 de agosto de 1994"
30,15,41,899,422,445,867,"21 de agosto de 1994"
30,15,41,900,479,524,1003,"21 de agosto de 1994"
30,15,41,901,382,395,777,"21 de agosto de 1994"
30,15,41,902,388,414,802,"21 de agosto de 1994"
30,15,41,903,296,304,600,"21 de agosto de 1994"
30,15,41,904,283,305,588,"21 de agosto de 1994"
30,15,41,905,529,559,1088,"21 de agosto de 1994"
30,15,41,906,582,624,1206,"21 de agosto de 1994"
30,15,41,907,531,585,1116,"21 de agosto de 1994"
30,15,41,908,222,194,416,"21 de agosto de 1994"
30,15,41,909,457,418,875,"21 de agosto de 1994"
30,15,41,910,560,561,1121,"21 de agosto de 1994"
30,15,41,911,428,392,820,"21 de agosto de 1994"
30,15,41,912,470,413,883,"21 de agosto de 1994"
30,15,41,913,217,228,445,"21 de agosto de 1994"
30,15,41,914,689,706,1395,"21 de agosto de 1994"
30,15,41,915,548,515,1063,"21 de agosto de 1994"
30,15,41,916,471,442,913,"21 de agosto de 1994"
30,15,41,917,395,419,814,"21 de agosto de 1994"
30,15,41,918,628,586,1214,"21 de agosto de 1994"
30,15,41,919,672,636,1308,"21 de agosto de 1994"
30,15,41,920,380,246,626,"21 de agosto de 1994"
30,15,41,921,433,297,730,"21 de agosto de 1994"
30,15,41,922,183,127,310,"21 de agosto de 1994"
30,15,41,923,284,232,516,"21 de agosto de 1994"
30,15,41,924,418,342,760,"21 de agosto de 1994"
30,15,41,925,285,237,522,"21 de agosto de 1994"
30,15,41,926,414,330,744,"21 de agosto de 1994"
30,15,41,927,383,318,701,"21 de agosto de 1994"
30,15,41,928,452,412,864,"21 de agosto de 1994"
30,15,41,929,321,268,589,"21 de agosto de 1994"
30,15,41,930,383,310,693,"21 de agosto de 1994"
30,15,41,931,281,263,544,"21 de agosto de 1994"
30,15,84,1775,696,649,1345,"21 de agosto de 1994"
30,15,84,1776,595,545,1140,"21 de agosto de 1994"
30,15,84,1777,570,484,1054,"21 de agosto de 1994"
30,15,84,1778,581,513,1094,"21 de agosto de 1994"
30,15,84,1779,57,47,104,"21 de agosto de 1994"
30,15,84,1780,560,441,1001,"21 de agosto de 1994"
30,15,84,1781,146,81,227,"21 de agosto de 1994"
30,15,84,1782,558,148,706,"21 de agosto de 1994"
30,15,84,1783,291,210,501,"21 de agosto de 1994"
30,15,112,2583,568,484,1052,"21 de agosto de 1994"
30,15,112,2584,374,318,692,"21 de agosto de 1994"
30,15,112,2585,417,333,750,"21 de agosto de 1994"
30,15,112,2586,558,521,1079,"21 de agosto de 1994"
30,15,112,2587,295,233,528,"21 de agosto de 1994"
30,15,112,2588,651,680,1331,"21 de agosto de 1994"
30,15,112,2589,340,325,665,"21 de agosto de 1994"
30,15,112,2590,542,551,1093,"21 de agosto de 1994"
30,15,112,2591,333,351,684,"21 de agosto de 1994"
30,15,112,2592,589,500,1089,"21 de agosto de 1994"
30,15,112,2593,159,112,271,"21 de agosto de 1994"
30,15,205,4647,587,672,1259,"21 de agosto de 1994"
30,15,205,4648,448,419,867,"21 de agosto de 1994"
30,15,205,4649,590,538,1128,"21 de agosto de 1994"
30,15,205,4650,488,464,952,"21 de agosto de 1994"
30,15,205,4651,410,418,828,"21 de agosto de 1994"
30,15,205,4652,437,459,896,"21 de agosto de 1994"
30,15,205,4653,485,525,1010,"21 de agosto de 1994"
30,15,205,4654,294,271,565,"21 de agosto de 1994"
30,15,205,4655,499,518,1017,"21 de agosto de 1994"
30,15,205,4656,281,254,535,"21 de agosto de 1994"
30,15,205,4657,507,428,935,"21 de agosto de 1994"
30,15,205,4658,381,317,698,"21 de agosto de 1994"
30,15,205,4659,498,481,979,"21 de agosto de 1994"
30,15,205,4660,350,350,700,"21 de agosto de 1994"
30,15,205,4661,354,357,711,"21 de agosto de 1994"
30,15,205,4662,493,471,964,"21 de agosto de 1994"
30,15,205,4663,382,350,732,"21 de agosto de 1994"
30,15,205,4664,356,349,705,"21 de agosto de 1994"
30,15,205,4665,282,230,512,"21 de agosto de 1994"
30,15,205,4666,248,200,448,"21 de agosto de 1994"
30,15,206,4667,313,357,670,"21 de agosto de 1994"
30,15,206,4668,396,401,797,"21 de agosto de 1994"
30,15,206,4669,278,240,518,"21 de agosto de 1994"
30,15,206,4670,534,530,1064,"21 de agosto de 1994"
30,15,206,4671,542,569,1111,"21 de agosto de 1994"
30,15,206,4672,631,647,1278,"21 de agosto de 1994"
30,15,206,4673,433,472,905,"21 de agosto de 1994"
30,15,206,4674,472,458,930,"21 de agosto de 1994"
30,15,206,4675,518,584,1102,"21 de agosto de 1994"
30,15,206,4676,680,696,1376,"21 de agosto de 1994"
30,15,206,4677,434,457,891,"21 de agosto de 1994"
30,15,206,4678,470,450,920,"21 de agosto de 1994"
30,15,206,4679,694,713,1407,"21 de agosto de 1994"
30,15,206,4680,310,331,641,"21 de agosto de 1994"
30,15,206,4681,737,704,1441,"21 de agosto de 1994"
30,15,206,4682,356,320,676,"21 de agosto de 1994"
30,15,206,4683,467,485,952,"21 de agosto de 1994"
30,15,206,4684,444,508,952,"21 de agosto de 1994"
30,15,206,4685,641,604,1245,"21 de agosto de 1994"
30,15,206,4686,494,514,1008,"21 de agosto de 1994"
30,15,206,4687,721,764,1485,"21 de agosto de 1994"
30,15,206,4688,736,693,1429,"21 de agosto de 1994"
30,15,206,4689,373,364,737,"21 de agosto de 1994"
30,15,206,4690,595,581,1176,"21 de agosto de 1994"
30,15,206,4691,216,187,403,"21 de agosto de 1994"
30,15,206,4692,517,499,1016,"21 de agosto de 1994"
30,15,206,4693,233,192,425,"21 de agosto de 1994"
30,15,206,4694,275,210,485,"21 de agosto de 1994"
30,15,206,4695,271,224,495,"21 de agosto de 1994"
30,16,122,2776,704,684,1388,"21 de agosto de 1994"
30,16,122,2777,541,526,1067,"21 de agosto de 1994"
30,16,122,2778,288,181,469,"21 de agosto de 1994"
30,16,122,2779,219,199,418,"21 de agosto de 1994"
30,16,122,2780,132,93,225,"21 de agosto de 1994"
30,16,122,2781,409,374,783,"21 de agosto de 1994"
30,16,122,2782,133,120,253,"21 de agosto de 1994"
30,16,122,2783,123,104,227,"21 de agosto de 1994"
30,16,122,2784,208,161,369,"21 de agosto de 1994"
30,16,122,2785,274,205,479,"21 de agosto de 1994"
30,16,122,2786,253,199,452,"21 de agosto de 1994"
30,16,122,2787,169,140,309,"21 de agosto de 1994"
30,16,122,2788,337,288,625,"21 de agosto de 1994"
30,16,122,2789,189,146,335,"21 de agosto de 1994"
30,16,122,2790,437,373,810,"21 de agosto de 1994"
30,16,122,2791,199,176,375,"21 de agosto de 1994"
30,16,122,2792,245,234,479,"21 de agosto de 1994"
30,16,122,2793,268,220,488,"21 de agosto de 1994"
30,16,122,2794,294,210,504,"21 de agosto de 1994"
30,16,122,2795,266,221,487,"21 de agosto de 1994"
30,16,122,2796,113,66,179,"21 de agosto de 1994"
30,16,122,2797,220,184,404,"21 de agosto de 1994"
30,16,122,2798,319,230,549,"21 de agosto de 1994"
30,16,122,2799,165,115,280,"21 de agosto de 1994"
30,16,122,2800,162,131,293,"21 de agosto de 1994"
30,16,122,2801,280,242,522,"21 de agosto de 1994"
30,16,122,2802,376,288,664,"21 de agosto de 1994"
30,16,122,2803,127,115,242,"21 de agosto de 1994"
30,16,122,2804,230,183,413,"21 de agosto de 1994"
30,16,124,2814,319,320,639,"21 de agosto de 1994"
30,16,124,2815,442,495,937,"21 de agosto de 1994"
30,16,124,2816,397,408,805,"21 de agosto de 1994"
30,16,124,2817,419,476,895,"21 de agosto de 1994"
30,16,124,2818,360,440,800,"21 de agosto de 1994"
30,16,124,2819,279,303,582,"21 de agosto de 1994"
30,16,124,2820,507,561,1068,"21 de agosto de 1994"
30,16,124,2821,331,372,703,"21 de agosto de 1994"
30,16,124,2822,380,450,830,"21 de agosto de 1994"
30,16,124,2823,414,471,885,"21 de agosto de 1994"
30,16,124,2824,421,480,901,"21 de agosto de 1994"
30,16,124,2825,270,292,562,"21 de agosto de 1994"
30,16,124,2826,300,259,559,"21 de agosto de 1994"
30,16,124,2827,303,309,612,"21 de agosto de 1994"
30,16,124,2828,270,319,589,"21 de agosto de 1994"
30,16,124,2829,340,395,735,"21 de agosto de 1994"
30,16,124,2830,526,583,1109,"21 de agosto de 1994"
30,16,124,2831,440,425,865,"21 de agosto de 1994"
30,16,124,2832,390,418,808,"21 de agosto de 1994"
30,16,124,2833,423,438,861,"21 de agosto de 1994"
30,16,124,2834,356,373,729,"21 de agosto de 1994"
30,16,124,2835,339,361,700,"21 de agosto de 1994"
30,16,124,2836,291,368,659,"21 de agosto de 1994"
30,16,124,2837,447,445,892,"21 de agosto de 1994"
30,16,124,2838,409,331,740,"21 de agosto de 1994"
30,16,124,2839,363,315,678,"21 de agosto de 1994"
30,16,124,2840,547,453,1000,"21 de agosto de 1994"
30,16,124,2841,273,216,489,"21 de agosto de 1994"
30,16,124,2842,69,63,132,"21 de agosto de 1994"
30,16,124,2843,102,91,193,"21 de agosto de 1994"
30,16,124,2844,48,46,94,"21 de agosto de 1994"
30,16,124,2845,334,319,653,"21 de agosto de 1994"
30,16,124,2846,67,49,116,"21 de agosto de 1994"
30,16,124,2847,80,80,160,"21 de agosto de 1994"
30,16,124,2848,206,189,395,"21 de agosto de 1994"
30,16,124,2849,136,98,234,"21 de agosto de 1994"
30,16,124,2850,211,165,376,"21 de agosto de 1994"
30,16,124,2851,121,99,220,"21 de agosto de 1994"
30,16,124,2852,148,146,294,"21 de agosto de 1994"
30,16,124,2853,151,134,285,"21 de agosto de 1994"
30,16,124,2854,216,272,488,"21 de agosto de 1994"
30,16,124,2855,262,281,543,"21 de agosto de 1994"
30,16,124,2856,80,92,172,"21 de agosto de 1994"
30,16,124,2857,87,71,158,"21 de agosto de 1994"
30,16,124,2858,209,219,428,"21 de agosto de 1994"
30,16,124,2859,477,483,960,"21 de agosto de 1994"
30,16,124,2860,475,464,939,"21 de agosto de 1994"
30,16,124,2861,380,448,828,"21 de agosto de 1994"
30,16,124,2862,451,461,912,"21 de agosto de 1994"
30,16,124,2863,356,386,742,"21 de agosto de 1994"
30,16,124,2864,248,254,502,"21 de agosto de 1994"
30,16,124,2865,403,414,817,"21 de agosto de 1994"
30,16,124,2866,156,117,273,"21 de agosto de 1994"
30,16,124,2867,207,172,379,"21 de agosto de 1994"
30,16,124,2868,364,341,705,"21 de agosto de 1994"
30,16,124,2869,478,525,1003,"21 de agosto de 1994"
30,16,124,2870,320,346,666,"21 de agosto de 1994"
30,16,124,2871,419,403,822,"21 de agosto de 1994"
30,16,124,2872,148,125,273,"21 de agosto de 1994"
30,16,124,2873,511,400,911,"21 de agosto de 1994"
30,16,124,2874,143,119,262,"21 de agosto de 1994"
30,16,124,2875,340,288,628,"21 de agosto de 1994"
30,16,124,2876,502,417,919,"21 de agosto de 1994"
30,16,124,2877,324,281,605,"21 de agosto de 1994"
30,16,124,2878,190,138,328,"21 de agosto de 1994"
30,16,124,2879,296,244,540,"21 de agosto de 1994"
30,16,124,2880,197,169,366,"21 de agosto de 1994"
30,16,124,2881,208,157,365,"21 de agosto de 1994"
30,16,124,2882,275,270,545,"21 de agosto de 1994"
30,16,124,2883,318,259,577,"21 de agosto de 1994"
30,16,124,2884,497,433,930,"21 de agosto de 1994"
30,16,124,2885,480,368,848,"21 de agosto de 1994"
30,16,124,2886,174,148,322,"21 de agosto de 1994"
30,16,124,2887,131,92,223,"21 de agosto de 1994"
30,16,124,2888,299,224,523,"21 de agosto de 1994"
30,16,124,2889,290,247,537,"21 de agosto de 1994"
30,16,124,2890,66,44,110,"21 de agosto de 1994"
30,16,124,2891,227,167,394,"21 de agosto de 1994"
30,16,124,2892,75,48,123,"21 de agosto de 1994"
30,16,124,2893,541,492,1033,"21 de agosto de 1994"
30,16,124,2894,151,128,279,"21 de agosto de 1994"
30,16,124,2895,263,234,497,"21 de agosto de 1994"
30,16,124,2896,193,154,347,"21 de agosto de 1994"
30,16,124,2897,362,298,660,"21 de agosto de 1994"
30,16,133,3219,324,343,667,"21 de agosto de 1994"
30,16,133,3220,283,317,600,"21 de agosto de 1994"
30,16,133,3221,392,406,798,"21 de agosto de 1994"
30,16,133,3222,288,306,594,"21 de agosto de 1994"
30,16,133,3223,433,435,868,"21 de agosto de 1994"
30,16,133,3224,345,371,716,"21 de agosto de 1994"
30,16,133,3225,293,307,600,"21 de agosto de 1994"
30,16,133,3226,202,205,407,"21 de agosto de 1994"
30,16,133,3227,248,277,525,"21 de agosto de 1994"
30,16,133,3228,232,277,509,"21 de agosto de 1994"
30,16,133,3229,410,458,868,"21 de agosto de 1994"
30,16,133,3230,431,505,936,"21 de agosto de 1994"
30,16,133,3231,298,336,634,"21 de agosto de 1994"
30,16,133,3232,460,522,982,"21 de agosto de 1994"
30,16,133,3233,1010,623,1633,"21 de agosto de 1994"
30,16,133,3234,307,235,542,"21 de agosto de 1994"
30,16,133,3235,371,381,752,"21 de agosto de 1994"
30,16,133,3236,394,342,736,"21 de agosto de 1994"
30,16,133,3237,341,342,683,"21 de agosto de 1994"
30,16,133,3238,322,308,630,"21 de agosto de 1994"
30,16,133,3239,382,406,788,"21 de agosto de 1994"
30,16,133,3240,421,464,885,"21 de agosto de 1994"
30,16,133,3241,308,313,621,"21 de agosto de 1994"
30,16,133,3242,231,249,480,"21 de agosto de 1994"
30,16,133,3243,324,351,675,"21 de agosto de 1994"
30,16,133,3244,270,292,562,"21 de agosto de 1994"
30,16,133,3245,484,522,1006,"21 de agosto de 1994"
30,16,133,3246,311,290,601,"21 de agosto de 1994"
30,16,133,3247,340,369,709,"21 de agosto de 1994"
30,16,133,3248,365,373,738,"21 de agosto de 1994"
30,16,133,3249,287,306,593,"21 de agosto de 1994"
30,16,133,3250,133,131,264,"21 de agosto de 1994"
30,16,133,3251,210,206,416,"21 de agosto de 1994"
30,16,133,3252,325,333,658,"21 de agosto de 1994"
30,16,133,3253,433,463,896,"21 de agosto de 1994"
30,16,133,3254,168,148,316,"21 de agosto de 1994"
30,16,133,3255,224,181,405,"21 de agosto de 1994"
30,16,133,3256,183,141,324,"21 de agosto de 1994"
30,16,133,3257,208,183,391,"21 de agosto de 1994"
30,16,133,3258,63,59,122,"21 de agosto de 1994"
30,16,153,3572,318,336,654,"21 de agosto de 1994"
30,16,153,3573,377,403,780,"21 de agosto de 1994"
30,16,153,3574,131,88,219,"21 de agosto de 1994"
30,16,153,3575,120,95,215,"21 de agosto de 1994"
30,16,153,3576,407,378,785,"21 de agosto de 1994"
30,16,153,3577,137,113,250,"21 de agosto de 1994"
30,16,153,3578,261,209,470,"21 de agosto de 1994"
30,16,153,3579,145,115,260,"21 de agosto de 1994"
30,16,153,3580,291,260,551,"21 de agosto de 1994"
30,16,153,3581,408,351,759,"21 de agosto de 1994"
30,16,153,3582,99,77,176,"21 de agosto de 1994"
30,16,153,3583,133,115,248,"21 de agosto de 1994"
30,16,153,3584,138,94,232,"21 de agosto de 1994"
30,16,153,3585,302,263,565,"21 de agosto de 1994"
30,16,153,3586,362,300,662,"21 de agosto de 1994"
30,16,153,3587,136,116,252,"21 de agosto de 1994"
30,16,153,3588,198,164,362,"21 de agosto de 1994"
30,16,153,3589,266,189,455,"21 de agosto de 1994"
30,16,153,3590,133,95,228,"21 de agosto de 1994"
30,16,160,3706,292,322,614,"21 de agosto de 1994"
30,16,160,3707,429,409,838,"21 de agosto de 1994"
30,16,160,3708,409,367,776,"21 de agosto de 1994"
30,16,160,3709,123,103,226,"21 de agosto de 1994"
30,16,160,3710,435,432,867,"21 de agosto de 1994"
30,16,160,3711,668,704,1372,"21 de agosto de 1994"
30,16,160,3712,597,586,1183,"21 de agosto de 1994"
30,16,160,3713,489,429,918,"21 de agosto de 1994"
30,16,160,3714,450,473,923,"21 de agosto de 1994"
30,16,160,3715,322,266,588,"21 de agosto de 1994"
30,16,160,3716,119,114,233,"21 de agosto de 1994"
30,16,160,3717,223,171,394,"21 de agosto de 1994"
30,16,160,3718,467,378,845,"21 de agosto de 1994"
30,16,160,3719,394,339,733,"21 de agosto de 1994"
30,16,160,3720,174,137,311,"21 de agosto de 1994"
30,16,160,3721,222,157,379,"21 de agosto de 1994"
30,16,160,3722,161,131,292,"21 de agosto de 1994"
30,16,160,3723,332,273,605,"21 de agosto de 1994"
30,16,160,3724,265,239,504,"21 de agosto de 1994"
30,16,160,3725,428,328,756,"21 de agosto de 1994"
30,16,160,3726,253,194,447,"21 de agosto de 1994"
30,16,160,3727,329,269,598,"21 de agosto de 1994"
30,16,160,3728,127,102,229,"21 de agosto de 1994"
30,16,160,3729,459,385,844,"21 de agosto de 1994"
30,16,160,3730,326,280,606,"21 de agosto de 1994"
30,16,160,3731,232,204,436,"21 de agosto de 1994"
30,16,160,3732,328,237,565,"21 de agosto de 1994"
30,16,160,3733,109,90,199,"21 de agosto de 1994"
30,16,160,3734,213,184,397,"21 de agosto de 1994"
30,16,160,3735,215,173,388,"21 de agosto de 1994"
30,16,207,4696,347,348,695,"21 de agosto de 1994"
30,16,207,4697,437,433,870,"21 de agosto de 1994"
30,16,207,4698,451,452,903,"21 de agosto de 1994"
30,16,207,4699,488,508,996,"21 de agosto de 1994"
30,16,207,4700,493,466,959,"21 de agosto de 1994"
30,16,207,4701,357,343,700,"21 de agosto de 1994"
30,16,207,4702,352,299,651,"21 de agosto de 1994"
30,16,207,4703,339,274,613,"21 de agosto de 1994"
30,16,207,4704,130,106,236,"21 de agosto de 1994"
30,16,207,4705,194,165,359,"21 de agosto de 1994"
30,16,207,4706,169,174,343,"21 de agosto de 1994"
30,16,207,4707,380,350,730,"21 de agosto de 1994"
30,16,207,4708,395,346,741,"21 de agosto de 1994"
30,16,207,4709,252,226,478,"21 de agosto de 1994"
30,16,207,4710,345,332,677,"21 de agosto de 1994"
30,16,207,4711,310,267,577,"21 de agosto de 1994"
30,17,28,482,422,459,881,"21 de agosto de 1994"
30,17,28,483,289,313,602,"21 de agosto de 1994"
30,17,28,484,346,396,742,"21 de agosto de 1994"
30,17,28,485,292,267,559,"21 de agosto de 1994"
30,17,28,486,279,308,587,"21 de agosto de 1994"
30,17,28,487,297,308,605,"21 de agosto de 1994"
30,17,28,488,359,375,734,"21 de agosto de 1994"
30,17,28,489,310,340,650,"21 de agosto de 1994"
30,17,28,490,397,423,820,"21 de agosto de 1994"
30,17,28,491,325,388,713,"21 de agosto de 1994"
30,17,60,1343,385,427,812,"21 de agosto de 1994"
30,17,60,1344,476,591,1067,"21 de agosto de 1994"
30,17,60,1345,321,369,690,"21 de agosto de 1994"
30,17,60,1346,340,365,705,"21 de agosto de 1994"
30,17,60,1347,464,436,900,"21 de agosto de 1994"
30,17,60,1348,253,204,457,"21 de agosto de 1994"
30,17,60,1349,130,112,242,"21 de agosto de 1994"
30,17,60,1350,250,232,482,"21 de agosto de 1994"
30,17,60,1351,471,427,898,"21 de agosto de 1994"
30,17,60,1352,527,481,1008,"21 de agosto de 1994"
30,17,60,1353,348,347,695,"21 de agosto de 1994"
30,17,60,1354,147,128,275,"21 de agosto de 1994"
30,17,60,1355,257,201,458,"21 de agosto de 1994"
30,17,60,1356,169,180,349,"21 de agosto de 1994"
30,17,60,1357,221,240,461,"21 de agosto de 1994"
30,17,60,1358,343,323,666,"21 de agosto de 1994"
30,17,60,1359,423,375,798,"21 de agosto de 1994"
30,17,60,1360,482,448,930,"21 de agosto de 1994"
30,17,60,1361,403,408,811,"21 de agosto de 1994"
30,17,60,1362,311,330,641,"21 de agosto de 1994"
30,17,60,1363,241,266,507,"21 de agosto de 1994"
30,17,60,1364,132,131,263,"21 de agosto de 1994"
30,17,60,1365,366,386,752,"21 de agosto de 1994"
30,17,60,1366,383,374,757,"21 de agosto de 1994"
30,17,60,1367,165,180,345,"21 de agosto de 1994"
30,17,60,1368,296,277,573,"21 de agosto de 1994"
30,17,60,1369,448,454,902,"21 de agosto de 1994"
30,17,60,1370,216,256,472,"21 de agosto de 1994"
30,17,60,1371,398,385,783,"21 de agosto de 1994"
30,17,60,1372,244,225,469,"21 de agosto de 1994"
30,17,60,1373,256,226,482,"21 de agosto de 1994"
30,17,60,1374,276,281,557,"21 de agosto de 1994"
30,17,60,1375,328,327,655,"21 de agosto de 1994"
30,17,60,1376,402,432,834,"21 de agosto de 1994"
30,17,60,1377,282,314,596,"21 de agosto de 1994"
30,17,60,1378,359,384,743,"21 de agosto de 1994"
30,17,60,1379,84,75,159,"21 de agosto de 1994"
30,17,60,1380,272,271,543,"21 de agosto de 1994"
30,17,60,1381,188,170,358,"21 de agosto de 1994"
30,17,60,1382,177,197,374,"21 de agosto de 1994"
30,17,60,1383,264,272,536,"21 de agosto de 1994"
30,17,60,1384,162,183,345,"21 de agosto de 1994"
30,17,60,1385,452,475,927,"21 de agosto de 1994"
30,17,60,1386,121,137,258,"21 de agosto de 1994"
30,17,60,1387,131,133,264,"21 de agosto de 1994"
30,17,60,1388,231,255,486,"21 de agosto de 1994"
30,17,60,1389,219,245,464,"21 de agosto de 1994"
30,17,74,1623,379,460,839,"21 de agosto de 1994"
30,17,74,1624,362,417,779,"21 de agosto de 1994"
30,17,74,1625,325,365,690,"21 de agosto de 1994"
30,17,74,1626,223,220,443,"21 de agosto de 1994"
30,17,74,1627,188,182,370,"21 de agosto de 1994"
30,17,74,1628,190,191,381,"21 de agosto de 1994"
30,17,74,1629,66,54,120,"21 de agosto de 1994"
30,17,74,1630,232,220,452,"21 de agosto de 1994"
30,17,74,1631,83,55,138,"21 de agosto de 1994"
30,17,74,1632,67,78,145,"21 de agosto de 1994"
30,17,74,1633,235,209,444,"21 de agosto de 1994"
30,17,74,1634,177,199,376,"21 de agosto de 1994"
30,17,74,1635,163,157,320,"21 de agosto de 1994"
30,17,74,1636,363,348,711,"21 de agosto de 1994"
30,17,74,1637,332,336,668,"21 de agosto de 1994"
30,17,74,1638,412,350,762,"21 de agosto de 1994"
30,17,74,1639,137,93,230,"21 de agosto de 1994"
30,17,74,1640,241,199,440,"21 de agosto de 1994"
30,17,78,1688,181,193,374,"21 de agosto de 1994"
30,17,78,1689,349,382,731,"21 de agosto de 1994"
30,17,78,1690,98,82,180,"21 de agosto de 1994"
30,17,78,1691,189,236,425,"21 de agosto de 1994"
30,17,78,1692,173,188,361,"21 de agosto de 1994"
30,17,78,1693,265,276,541,"21 de agosto de 1994"
30,17,78,1694,294,340,634,"21 de agosto de 1994"
30,17,78,1695,276,264,540,"21 de agosto de 1994"
30,17,78,1696,198,190,388,"21 de agosto de 1994"
30,17,78,1697,282,240,522,"21 de agosto de 1994"
30,17,78,1698,43,32,75,"21 de agosto de 1994"
30,17,78,1699,111,113,224,"21 de agosto de 1994"
30,17,78,1700,200,186,386,"21 de agosto de 1994"
30,17,82,1731,454,421,875,"21 de agosto de 1994"
30,17,82,1732,421,421,842,"21 de agosto de 1994"
30,17,82,1733,354,361,715,"21 de agosto de 1994"
30,17,82,1734,290,289,579,"21 de agosto de 1994"
30,17,82,1735,354,378,732,"21 de agosto de 1994"
30,17,82,1736,362,401,763,"21 de agosto de 1994"
30,17,82,1737,287,256,543,"21 de agosto de 1994"
30,17,82,1738,525,502,1027,"21 de agosto de 1994"
30,17,82,1739,396,377,773,"21 de agosto de 1994"
30,17,82,1740,340,321,661,"21 de agosto de 1994"
30,17,82,1741,232,248,480,"21 de agosto de 1994"
30,17,82,1742,481,583,1064,"21 de agosto de 1994"
30,17,82,1743,277,300,577,"21 de agosto de 1994"
30,17,82,1744,414,420,834,"21 de agosto de 1994"
30,17,82,1745,275,266,541,"21 de agosto de 1994"
30,17,82,1746,497,437,934,"21 de agosto de 1994"
30,17,82,1747,265,268,533,"21 de agosto de 1994"
30,17,82,1748,398,404,802,"21 de agosto de 1994"
30,17,82,1749,351,308,659,"21 de agosto de 1994"
30,17,82,1750,342,334,676,"21 de agosto de 1994"
30,17,82,1751,233,214,447,"21 de agosto de 1994"
30,17,82,1752,73,53,126,"21 de agosto de 1994"
30,17,82,1753,372,352,724,"21 de agosto de 1994"
30,17,82,1754,324,287,611,"21 de agosto de 1994"
30,17,82,1755,206,188,394,"21 de agosto de 1994"
30,17,82,1756,136,103,239,"21 de agosto de 1994"
30,17,82,1757,270,308,578,"21 de agosto de 1994"
30,17,82,1758,227,264,491,"21 de agosto de 1994"
30,17,82,1759,161,190,351,"21 de agosto de 1994"
30,17,82,1760,271,269,540,"21 de agosto de 1994"
30,17,82,1761,198,177,375,"21 de agosto de 1994"
30,17,82,1762,216,206,422,"21 de agosto de 1994"
30,17,82,1763,394,324,718,"21 de agosto de 1994"
30,17,169,3799,522,491,1013,"21 de agosto de 1994"
30,17,169,3800,492,433,925,"21 de agosto de 1994"
30,17,169,3801,329,261,590,"21 de agosto de 1994"
30,17,169,3802,80,64,144,"21 de agosto de 1994"
30,17,169,3803,437,393,830,"21 de agosto de 1994"
30,17,179,4001,477,410,887,"21 de agosto de 1994"
30,17,179,4002,102,104,206,"21 de agosto de 1994"
30,17,179,4003,487,479,966,"21 de agosto de 1994"
30,17,179,4004,261,234,495,"21 de agosto de 1994"
30,17,179,4005,354,313,667,"21 de agosto de 1994"
30,17,179,4006,208,161,369,"21 de agosto de 1994"
30,17,179,4007,109,105,214,"21 de agosto de 1994"
30,17,179,4008,121,96,217,"21 de agosto de 1994"
30,17,179,4009,256,209,465,"21 de agosto de 1994"
30,17,198,4551,399,398,797,"21 de agosto de 1994"
30,17,198,4552,368,327,695,"21 de agosto de 1994"
30,17,198,4553,369,382,751,"21 de agosto de 1994"
30,17,198,4554,180,155,335,"21 de agosto de 1994"
30,17,198,4555,169,154,323,"21 de agosto de 1994"
30,17,198,4556,232,228,460,"21 de agosto de 1994"
30,17,202,4598,303,290,593,"21 de agosto de 1994"
30,17,202,4599,279,302,581,"21 de agosto de 1994"
30,17,202,4600,227,197,424,"21 de agosto de 1994"
30,17,202,4601,342,366,708,"21 de agosto de 1994"
30,17,202,4602,221,220,441,"21 de agosto de 1994"
30,17,202,4603,419,406,825,"21 de agosto de 1994"
30,17,202,4604,332,313,645,"21 de agosto de 1994"
30,17,202,4605,496,443,939,"21 de agosto de 1994"
30,18,8,109,482,528,1010,"21 de agosto de 1994"
30,18,8,110,450,459,909,"21 de agosto de 1994"
30,18,8,111,469,520,989,"21 de agosto de 1994"
30,18,8,112,616,704,1320,"21 de agosto de 1994"
30,18,8,113,304,370,674,"21 de agosto de 1994"
30,18,8,114,653,755,1408,"21 de agosto de 1994"
30,18,8,115,450,493,943,"21 de agosto de 1994"
30,18,8,116,554,553,1107,"21 de agosto de 1994"
30,18,8,117,414,499,913,"21 de agosto de 1994"
30,18,8,118,232,250,482,"21 de agosto de 1994"
30,18,8,119,324,329,653,"21 de agosto de 1994"
30,18,8,120,462,525,987,"21 de agosto de 1994"
30,18,8,121,546,532,1078,"21 de agosto de 1994"
30,18,8,122,165,149,314,"21 de agosto de 1994"
30,18,8,123,378,382,760,"21 de agosto de 1994"
30,18,8,124,184,174,358,"21 de agosto de 1994"
30,18,8,125,251,257,508,"21 de agosto de 1994"
30,18,8,126,247,231,478,"21 de agosto de 1994"
30,18,8,127,93,82,175,"21 de agosto de 1994"
30,18,8,128,383,380,763,"21 de agosto de 1994"
30,18,8,129,656,649,1305,"21 de agosto de 1994"
30,18,8,130,711,657,1368,"21 de agosto de 1994"
30,18,8,131,402,410,812,"21 de agosto de 1994"
30,18,8,132,368,424,792,"21 de agosto de 1994"
30,18,8,133,378,349,727,"21 de agosto de 1994"
30,18,8,134,164,140,304,"21 de agosto de 1994"
30,18,8,135,480,419,899,"21 de agosto de 1994"
30,18,8,136,643,616,1259,"21 de agosto de 1994"
30,18,8,137,361,318,679,"21 de agosto de 1994"
30,18,8,138,194,162,356,"21 de agosto de 1994"
30,18,8,139,325,287,612,"21 de agosto de 1994"
30,18,8,140,549,490,1039,"21 de agosto de 1994"
30,18,8,141,350,290,640,"21 de agosto de 1994"
30,18,8,142,338,296,634,"21 de agosto de 1994"
30,18,8,143,257,283,540,"21 de agosto de 1994"
30,18,8,144,169,143,312,"21 de agosto de 1994"
30,18,8,145,448,374,822,"21 de agosto de 1994"
30,18,8,146,618,581,1199,"21 de agosto de 1994"
30,18,8,147,555,542,1097,"21 de agosto de 1994"
30,18,8,148,352,319,671,"21 de agosto de 1994"
30,18,8,149,357,339,696,"21 de agosto de 1994"
30,18,8,150,423,398,821,"21 de agosto de 1994"
30,18,8,151,322,330,652,"21 de agosto de 1994"
30,18,8,152,561,567,1128,"21 de agosto de 1994"
30,18,8,153,482,441,923,"21 de agosto de 1994"
30,18,8,154,253,272,525,"21 de agosto de 1994"
30,18,8,155,482,514,996,"21 de agosto de 1994"
30,18,8,156,359,302,661,"21 de agosto de 1994"
30,18,8,157,466,422,888,"21 de agosto de 1994"
30,18,8,158,351,331,682,"21 de agosto de 1994"
30,18,8,159,283,272,555,"21 de agosto de 1994"
30,18,8,160,550,495,1045,"21 de agosto de 1994"
30,18,8,161,199,215,414,"21 de agosto de 1994"
30,18,8,162,685,673,1358,"21 de agosto de 1994"
30,18,8,163,514,529,1043,"21 de agosto de 1994"
30,18,8,164,485,449,934,"21 de agosto de 1994"
30,18,8,165,340,303,643,"21 de agosto de 1994"
30,18,8,166,207,177,384,"21 de agosto de 1994"
30,18,8,167,384,369,753,"21 de agosto de 1994"
30,18,8,168,575,527,1102,"21 de agosto de 1994"
30,18,8,169,364,332,696,"21 de agosto de 1994"
30,18,8,170,296,234,530,"21 de agosto de 1994"
30,18,8,171,633,576,1209,"21 de agosto de 1994"
30,18,8,172,280,231,511,"21 de agosto de 1994"
30,18,8,173,412,375,787,"21 de agosto de 1994"
30,18,8,174,261,272,533,"21 de agosto de 1994"
30,18,8,175,421,378,799,"21 de agosto de 1994"
30,18,8,176,296,256,552,"21 de agosto de 1994"
30,18,8,177,154,149,303,"21 de agosto de 1994"
30,18,33,617,583,560,1143,"21 de agosto de 1994"
30,18,33,618,347,350,697,"21 de agosto de 1994"
30,18,33,619,303,282,585,"21 de agosto de 1994"
30,18,33,620,281,246,527,"21 de agosto de 1994"
30,18,33,621,446,410,856,"21 de agosto de 1994"
30,18,33,622,172,166,338,"21 de agosto de 1994"
30,18,33,623,247,201,448,"21 de agosto de 1994"
30,18,33,624,445,379,824,"21 de agosto de 1994"
30,18,33,625,504,451,955,"21 de agosto de 1994"
30,18,33,626,211,175,386,"21 de agosto de 1994"
30,18,33,627,154,149,303,"21 de agosto de 1994"
30,18,33,628,233,201,434,"21 de agosto de 1994"
30,18,33,629,355,335,690,"21 de agosto de 1994"
30,18,33,630,450,431,881,"21 de agosto de 1994"
30,18,33,631,312,274,586,"21 de agosto de 1994"
30,18,174,3926,483,541,1024,"21 de agosto de 1994"
30,18,174,3927,322,343,665,"21 de agosto de 1994"
30,18,174,3928,516,594,1110,"21 de agosto de 1994"
30,18,174,3929,426,453,879,"21 de agosto de 1994"
30,18,174,3930,670,729,1399,"21 de agosto de 1994"
30,18,174,3931,541,600,1141,"21 de agosto de 1994"
30,18,174,3932,370,422,792,"21 de agosto de 1994"
30,18,174,3933,358,352,710,"21 de agosto de 1994"
30,18,174,3934,315,266,581,"21 de agosto de 1994"
30,18,174,3935,483,470,953,"21 de agosto de 1994"
30,18,174,3936,274,264,538,"21 de agosto de 1994"
30,18,174,3937,329,307,636,"21 de agosto de 1994"
30,18,174,3938,457,425,882,"21 de agosto de 1994"
30,18,174,3939,382,395,777,"21 de agosto de 1994"
30,18,174,3940,416,406,822,"21 de agosto de 1994"
30,18,174,3941,479,432,911,"21 de agosto de 1994"
30,18,174,3942,401,372,773,"21 de agosto de 1994"
30,18,174,3943,398,408,806,"21 de agosto de 1994"
30,18,174,3944,489,449,938,"21 de agosto de 1994"
30,18,174,3945,487,445,932,"21 de agosto de 1994"
30,18,174,3946,495,471,966,"21 de agosto de 1994"
30,18,174,3947,194,167,361,"21 de agosto de 1994"
30,18,174,3948,519,520,1039,"21 de agosto de 1994"
30,18,174,3949,723,730,1453,"21 de agosto de 1994"
30,18,174,3950,447,468,915,"21 de agosto de 1994"
30,18,174,3951,483,459,942,"21 de agosto de 1994"
30,18,174,3952,406,421,827,"21 de agosto de 1994"
30,18,174,3953,239,234,473,"21 de agosto de 1994"
30,18,174,3954,771,804,1575,"21 de agosto de 1994"
30,18,174,3955,202,169,371,"21 de agosto de 1994"
30,18,174,3956,270,278,548,"21 de agosto de 1994"
30,18,174,3957,321,299,620,"21 de agosto de 1994"
30,18,174,3958,362,366,728,"21 de agosto de 1994"
30,18,174,3959,417,454,871,"21 de agosto de 1994"
30,18,174,3960,342,369,711,"21 de agosto de 1994"
30,18,174,3961,390,442,832,"21 de agosto de 1994"
30,18,174,3962,419,449,868,"21 de agosto de 1994"
30,18,174,3963,345,386,731,"21 de agosto de 1994"
30,18,174,3964,523,578,1101,"21 de agosto de 1994"
30,18,174,3965,452,524,976,"21 de agosto de 1994"
30,18,174,3966,436,469,905,"21 de agosto de 1994"
30,18,174,3967,470,544,1014,"21 de agosto de 1994"
30,18,174,3968,374,416,790,"21 de agosto de 1994"
30,18,174,3969,425,483,908,"21 de agosto de 1994"
30,18,174,3970,230,281,511,"21 de agosto de 1994"
30,18,174,3971,579,602,1181,"21 de agosto de 1994"
30,18,174,3972,544,595,1139,"21 de agosto de 1994"
30,18,174,3973,649,673,1322,"21 de agosto de 1994"
30,18,174,3974,373,374,747,"21 de agosto de 1994"
30,19,11,218,472,555,1027,"21 de agosto de 1994"
30,19,11,219,595,730,1325,"21 de agosto de 1994"
30,19,11,220,514,720,1234,"21 de agosto de 1994"
30,19,11,221,548,660,1208,"21 de agosto de 1994"
30,19,11,222,543,663,1206,"21 de agosto de 1994"
30,19,11,223,392,491,883,"21 de agosto de 1994"
30,19,11,224,354,288,642,"21 de agosto de 1994"
30,19,11,225,140,99,239,"21 de agosto de 1994"
30,19,11,226,207,176,383,"21 de agosto de 1994"
30,19,11,227,253,214,467,"21 de agosto de 1994"
30,19,11,228,466,405,871,"21 de agosto de 1994"
30,19,11,229,535,451,986,"21 de agosto de 1994"
30,19,11,230,234,191,425,"21 de agosto de 1994"
30,19,11,231,240,223,463,"21 de agosto de 1994"
30,19,11,232,100,84,184,"21 de agosto de 1994"
30,19,11,233,296,274,570,"21 de agosto de 1994"
30,19,11,234,252,241,493,"21 de agosto de 1994"
30,19,11,235,267,275,542,"21 de agosto de 1994"
30,19,11,236,480,534,1014,"21 de agosto de 1994"
30,19,11,237,434,441,875,"21 de agosto de 1994"
30,19,11,238,523,516,1039,"21 de agosto de 1994"
30,19,11,239,337,387,724,"21 de agosto de 1994"
30,19,11,240,324,292,616,"21 de agosto de 1994"
30,19,11,241,219,211,430,"21 de agosto de 1994"
30,19,11,242,478,479,957,"21 de agosto de 1994"
30,19,11,243,288,302,590,"21 de agosto de 1994"
30,19,11,244,423,481,904,"21 de agosto de 1994"
30,19,11,245,383,425,808,"21 de agosto de 1994"
30,19,11,246,135,137,272,"21 de agosto de 1994"
30,19,88,1830,671,689,1360,"21 de agosto de 1994"
30,19,88,1831,549,492,1041,"21 de agosto de 1994"
30,19,88,1832,496,537,1033,"21 de agosto de 1994"
30,19,88,1833,269,265,534,"21 de agosto de 1994"
30,19,88,1834,153,150,303,"21 de agosto de 1994"
30,19,88,1835,228,199,427,"21 de agosto de 1994"
30,19,88,1836,74,58,132,"21 de agosto de 1994"
30,19,88,1837,180,156,336,"21 de agosto de 1994"
30,19,88,1838,472,467,939,"21 de agosto de 1994"
30,19,88,1839,334,319,653,"21 de agosto de 1994"
30,19,88,1840,509,509,1018,"21 de agosto de 1994"
30,19,88,1841,279,263,542,"21 de agosto de 1994"
30,19,88,1842,179,190,369,"21 de agosto de 1994"
30,19,88,1843,344,382,726,"21 de agosto de 1994"
30,19,88,1844,305,291,596,"21 de agosto de 1994"
30,19,88,1845,582,536,1118,"21 de agosto de 1994"
30,19,88,1846,543,543,1086,"21 de agosto de 1994"
30,19,88,1847,108,117,225,"21 de agosto de 1994"
30,19,103,2281,400,422,822,"21 de agosto de 1994"
30,19,103,2282,219,223,442,"21 de agosto de 1994"
30,19,103,2283,343,372,715,"21 de agosto de 1994"
30,19,103,2284,459,492,951,"21 de agosto de 1994"
30,19,103,2285,482,584,1066,"21 de agosto de 1994"
30,19,103,2286,585,603,1188,"21 de agosto de 1994"
30,19,103,2287,307,345,652,"21 de agosto de 1994"
30,19,103,2288,376,403,779,"21 de agosto de 1994"
30,19,103,2289,295,288,583,"21 de agosto de 1994"
30,19,103,2290,492,544,1036,"21 de agosto de 1994"
30,19,103,2291,328,377,705,"21 de agosto de 1994"
30,19,103,2292,382,438,820,"21 de agosto de 1994"
30,19,103,2293,892,695,1587,"21 de agosto de 1994"
30,19,103,2294,275,309,584,"21 de agosto de 1994"
30,19,103,2295,234,226,460,"21 de agosto de 1994"
30,19,103,2296,441,470,911,"21 de agosto de 1994"
30,19,103,2297,507,639,1146,"21 de agosto de 1994"
30,19,103,2298,524,650,1174,"21 de agosto de 1994"
30,19,103,2299,303,328,631,"21 de agosto de 1994"
30,19,103,2300,410,457,867,"21 de agosto de 1994"
30,19,103,2301,443,440,883,"21 de agosto de 1994"
30,19,103,2302,322,373,695,"21 de agosto de 1994"
30,19,103,2303,317,433,750,"21 de agosto de 1994"
30,19,103,2304,412,472,884,"21 de agosto de 1994"
30,19,103,2305,520,657,1177,"21 de agosto de 1994"
30,19,103,2306,281,350,631,"21 de agosto de 1994"
30,19,103,2307,390,461,851,"21 de agosto de 1994"
30,19,103,2308,541,634,1175,"21 de agosto de 1994"
30,19,103,2309,324,389,713,"21 de agosto de 1994"
30,19,103,2310,437,498,935,"21 de agosto de 1994"
30,19,103,2311,507,634,1141,"21 de agosto de 1994"
30,19,103,2312,425,444,869,"21 de agosto de 1994"
30,19,103,2313,310,353,663,"21 de agosto de 1994"
30,19,103,2314,323,324,647,"21 de agosto de 1994"
30,19,103,2315,365,422,787,"21 de agosto de 1994"
30,19,103,2316,619,687,1306,"21 de agosto de 1994"
30,19,103,2317,137,116,253,"21 de agosto de 1994"
30,19,103,2318,58,58,116,"21 de agosto de 1994"
30,19,103,2319,268,240,508,"21 de agosto de 1994"
30,19,103,2320,53,43,96,"21 de agosto de 1994"
30,19,103,2321,165,143,308,"21 de agosto de 1994"
30,19,103,2322,88,80,168,"21 de agosto de 1994"
30,19,103,2323,167,152,319,"21 de agosto de 1994"
30,19,103,2324,29,25,54,"21 de agosto de 1994"
30,19,103,2325,242,216,458,"21 de agosto de 1994"
30,19,103,2326,374,314,688,"21 de agosto de 1994"
30,19,103,2327,280,227,507,"21 de agosto de 1994"
30,19,103,2328,48,43,91,"21 de agosto de 1994"
30,19,103,2329,163,140,303,"21 de agosto de 1994"
30,19,103,2330,29,24,53,"21 de agosto de 1994"
30,19,103,2331,314,268,582,"21 de agosto de 1994"
30,19,103,2332,363,320,683,"21 de agosto de 1994"
30,19,103,2333,93,75,168,"21 de agosto de 1994"
30,19,103,2334,218,197,415,"21 de agosto de 1994"
30,19,103,2335,154,126,280,"21 de agosto de 1994"
30,19,103,2336,203,185,388,"21 de agosto de 1994"
30,19,103,2337,161,146,307,"21 de agosto de 1994"
30,19,103,2338,333,358,691,"21 de agosto de 1994"
30,19,103,2339,634,610,1244,"21 de agosto de 1994"
30,19,103,2340,454,456,910,"21 de agosto de 1994"
30,19,103,2341,653,684,1337,"21 de agosto de 1994"
30,19,103,2342,382,428,810,"21 de agosto de 1994"
30,19,103,2343,442,474,916,"21 de agosto de 1994"
30,19,103,2344,362,396,758,"21 de agosto de 1994"
30,19,103,2345,148,139,287,"21 de agosto de 1994"
30,19,103,2346,72,71,143,"21 de agosto de 1994"
30,19,103,2347,546,496,1042,"21 de agosto de 1994"
30,19,103,2348,303,272,575,"21 de agosto de 1994"
30,19,103,2349,324,321,645,"21 de agosto de 1994"
30,19,103,2350,45,46,91,"21 de agosto de 1994"
30,19,103,2351,239,237,476,"21 de agosto de 1994"
30,19,103,2352,367,401,768,"21 de agosto de 1994"
30,19,103,2353,311,282,593,"21 de agosto de 1994"
30,19,103,2354,367,388,755,"21 de agosto de 1994"
30,19,103,2355,289,278,567,"21 de agosto de 1994"
30,19,103,2356,403,420,823,"21 de agosto de 1994"
30,19,103,2357,360,410,770,"21 de agosto de 1994"
30,19,103,2358,413,433,846,"21 de agosto de 1994"
30,19,103,2359,485,464,949,"21 de agosto de 1994"
30,19,103,2360,617,609,1226,"21 de agosto de 1994"
30,19,103,2361,175,155,330,"21 de agosto de 1994"
30,19,103,2362,92,78,170,"21 de agosto de 1994"
30,19,103,2363,434,425,859,"21 de agosto de 1994"
30,19,103,2364,212,183,395,"21 de agosto de 1994"
30,19,103,2365,186,175,361,"21 de agosto de 1994"
30,19,103,2366,217,239,456,"21 de agosto de 1994"
30,19,103,2367,355,351,706,"21 de agosto de 1994"
30,19,103,2368,232,224,456,"21 de agosto de 1994"
30,19,103,2369,132,124,256,"21 de agosto de 1994"
30,19,103,2370,119,101,220,"21 de agosto de 1994"
30,19,103,2371,153,146,299,"21 de agosto de 1994"
30,19,103,2372,224,166,390,"21 de agosto de 1994"
30,19,103,2373,142,112,254,"21 de agosto de 1994"
30,19,158,3673,83,84,167,"21 de agosto de 1994"
30,19,158,3674,316,336,652,"21 de agosto de 1994"
30,19,158,3675,619,686,1305,"21 de agosto de 1994"
30,19,158,3676,232,210,442,"21 de agosto de 1994"
30,19,158,3677,437,426,863,"21 de agosto de 1994"
30,19,158,3678,48,47,95,"21 de agosto de 1994"
30,19,158,3679,43,25,68,"21 de agosto de 1994"
30,19,158,3680,237,234,471,"21 de agosto de 1994"
30,19,158,3681,156,155,311,"21 de agosto de 1994"
30,19,158,3682,177,170,347,"21 de agosto de 1994"
30,19,158,3683,532,427,959,"21 de agosto de 1994"
30,19,158,3684,134,119,253,"21 de agosto de 1994"
30,19,158,3685,24,27,51,"21 de agosto de 1994"
30,19,158,3686,265,275,540,"21 de agosto de 1994"
30,19,158,3687,259,279,538,"21 de agosto de 1994"
30,19,158,3688,801,713,1514,"21 de agosto de 1994"
30,19,158,3689,38,31,69,"21 de agosto de 1994"
30,19,158,3690,452,418,870,"21 de agosto de 1994"
30,19,158,3691,248,208,456,"21 de agosto de 1994"
30,19,158,3692,387,320,707,"21 de agosto de 1994"
30,19,158,3693,184,138,322,"21 de agosto de 1994"
30,19,158,3694,333,282,615,"21 de agosto de 1994"
30,19,158,3695,233,240,473,"21 de agosto de 1994"
30,19,158,3696,189,206,395,"21 de agosto de 1994"
30,19,158,3697,25,26,51,"21 de agosto de 1994"
30,19,158,3698,601,650,1251,"21 de agosto de 1994"
30,19,182,4042,459,498,957,"21 de agosto de 1994"
30,19,182,4043,515,493,1008,"21 de agosto de 1994"
30,19,182,4044,243,260,503,"21 de agosto de 1994"
30,19,182,4045,559,612,1171,"21 de agosto de 1994"
30,19,182,4046,427,460,887,"21 de agosto de 1994"
30,19,182,4047,400,443,843,"21 de agosto de 1994"
30,19,182,4048,423,506,929,"21 de agosto de 1994"
30,19,182,4049,275,307,582,"21 de agosto de 1994"
30,19,182,4050,409,405,814,"21 de agosto de 1994"
30,19,182,4051,538,531,1069,"21 de agosto de 1994"
30,19,182,4052,511,544,1055,"21 de agosto de 1994"
30,19,182,4053,378,371,749,"21 de agosto de 1994"
30,19,182,4054,432,480,912,"21 de agosto de 1994"
30,19,182,4055,561,592,1153,"21 de agosto de 1994"
30,19,182,4056,492,524,1016,"21 de agosto de 1994"
30,19,182,4057,391,408,799,"21 de agosto de 1994"
30,19,182,4058,58,52,110,"21 de agosto de 1994"
30,19,182,4059,129,99,228,"21 de agosto de 1994"
30,19,182,4060,226,200,426,"21 de agosto de 1994"
30,19,182,4061,433,439,872,"21 de agosto de 1994"
30,19,182,4062,598,637,1235,"21 de agosto de 1994"
30,19,182,4063,662,627,1289,"21 de agosto de 1994"
30,19,182,4064,567,543,1110,"21 de agosto de 1994"
30,19,182,4065,118,72,190,"21 de agosto de 1994"
30,19,182,4066,557,515,1072,"21 de agosto de 1994"
30,19,182,4067,324,308,632,"21 de agosto de 1994"
30,19,182,4068,52,51,103,"21 de agosto de 1994"
30,19,182,4069,276,203,479,"21 de agosto de 1994"
30,19,182,4070,111,110,221,"21 de agosto de 1994"
30,19,182,4071,418,416,834,"21 de agosto de 1994"
30,19,182,4072,114,103,217,"21 de agosto de 1994"
30,19,182,4073,435,398,833,"21 de agosto de 1994"
30,20,6,92,591,595,1186,"21 de agosto de 1994"
30,20,6,93,295,292,587,"21 de agosto de 1994"
30,20,6,94,293,262,555,"21 de agosto de 1994"
30,20,6,95,293,296,589,"21 de agosto de 1994"
30,20,6,96,145,125,270,"21 de agosto de 1994"
30,20,6,97,231,237,468,"21 de agosto de 1994"
30,20,6,98,252,274,526,"21 de agosto de 1994"
30,20,6,99,276,308,584,"21 de agosto de 1994"
30,20,6,100,174,181,355,"21 de agosto de 1994"
30,20,6,101,245,265,510,"21 de agosto de 1994"
30,20,6,102,78,76,154,"21 de agosto de 1994"
30,20,6,103,160,118,278,"21 de agosto de 1994"
30,20,6,104,328,295,623,"21 de agosto de 1994"
30,20,6,105,280,287,567,"21 de agosto de 1994"
30,20,20,390,375,428,803,"21 de agosto de 1994"
30,20,20,391,265,301,566,"21 de agosto de 1994"
30,20,20,392,189,227,416,"21 de agosto de 1994"
30,20,21,393,431,447,878,"21 de agosto de 1994"
30,20,21,394,223,214,437,"21 de agosto de 1994"
30,20,21,395,244,241,485,"21 de agosto de 1994"
30,20,21,396,218,225,443,"21 de agosto de 1994"
30,20,21,397,408,410,818,"21 de agosto de 1994"
30,20,31,593,554,623,1177,"21 de agosto de 1994"
30,20,31,594,458,502,960,"21 de agosto de 1994"
30,20,31,595,445,528,973,"21 de agosto de 1994"
30,20,31,596,359,387,746,"21 de agosto de 1994"
30,20,31,597,426,496,922,"21 de agosto de 1994"
30,20,31,598,366,450,816,"21 de agosto de 1994"
30,20,31,599,584,646,1230,"21 de agosto de 1994"
30,20,31,600,615,636,1251,"21 de agosto de 1994"
30,20,31,601,685,767,1452,"21 de agosto de 1994"
30,20,31,602,706,812,1518,"21 de agosto de 1994"
30,20,31,603,527,643,1170,"21 de agosto de 1994"
30,20,31,604,639,753,1392,"21 de agosto de 1994"
30,20,31,605,532,679,1211,"21 de agosto de 1994"
30,20,31,606,336,355,691,"21 de agosto de 1994"
30,20,31,607,276,138,414,"21 de agosto de 1994"
30,20,31,608,484,273,757,"21 de agosto de 1994"
30,20,43,961,266,297,563,"21 de agosto de 1994"
30,20,43,962,169,153,322,"21 de agosto de 1994"
30,20,54,1286,499,522,1021,"21 de agosto de 1994"
30,20,54,1287,353,334,687,"21 de agosto de 1994"
30,20,54,1288,440,423,863,"21 de agosto de 1994"
30,20,54,1289,264,259,523,"21 de agosto de 1994"
30,20,54,1290,421,456,877,"21 de agosto de 1994"
30,20,54,1291,614,642,1256,"21 de agosto de 1994"
30,20,54,1292,203,205,408,"21 de agosto de 1994"
30,20,55,1293,432,498,930,"21 de agosto de 1994"
30,20,55,1294,455,579,1034,"21 de agosto de 1994"
30,20,55,1295,390,449,839,"21 de agosto de 1994"
30,20,55,1296,270,319,589,"21 de agosto de 1994"
30,20,55,1297,521,584,1105,"21 de agosto de 1994"
30,20,55,1298,339,415,754,"21 de agosto de 1994"
30,20,55,1299,421,497,918,"21 de agosto de 1994"
30,20,55,1300,404,424,828,"21 de agosto de 1994"
30,20,55,1301,202,186,388,"21 de agosto de 1994"
30,20,55,1302,566,624,1190,"21 de agosto de 1994"
30,20,55,1303,244,233,477,"21 de agosto de 1994"
30,20,55,1304,153,162,315,"21 de agosto de 1994"
30,20,55,1305,380,424,804,"21 de agosto de 1994"
30,20,55,1306,621,615,1236,"21 de agosto de 1994"
30,20,55,1307,401,407,808,"21 de agosto de 1994"
30,20,55,1308,48,48,96,"21 de agosto de 1994"
30,20,55,1309,171,157,328,"21 de agosto de 1994"
30,20,99,2237,344,330,674,"21 de agosto de 1994"
30,20,99,2238,65,53,118,"21 de agosto de 1994"
30,20,99,2239,63,60,123,"21 de agosto de 1994"
30,20,111,2578,346,320,666,"21 de agosto de 1994"
30,20,111,2579,426,399,825,"21 de agosto de 1994"
30,20,111,2580,321,301,622,"21 de agosto de 1994"
30,20,111,2581,343,304,647,"21 de agosto de 1994"
30,20,111,2582,414,360,774,"21 de agosto de 1994"
30,20,114,2607,506,549,1055,"21 de agosto de 1994"
30,20,114,2608,229,219,448,"21 de agosto de 1994"
30,20,114,2609,189,158,347,"21 de agosto de 1994"
30,20,118,2650,423,419,842,"21 de agosto de 1994"
30,20,118,2651,445,526,971,"21 de agosto de 1994"
30,20,118,2652,288,356,644,"21 de agosto de 1994"
30,20,118,2653,209,186,395,"21 de agosto de 1994"
30,20,118,2654,175,156,331,"21 de agosto de 1994"
30,20,118,2655,327,293,620,"21 de agosto de 1994"
30,20,118,2656,405,388,793,"21 de agosto de 1994"
30,20,118,2657,270,264,534,"21 de agosto de 1994"
30,20,118,2658,344,353,697,"21 de agosto de 1994"
30,20,118,2659,140,121,261,"21 de agosto de 1994"
30,20,118,2660,433,417,850,"21 de agosto de 1994"
30,20,118,2661,456,411,867,"21 de agosto de 1994"
30,20,118,2662,467,475,942,"21 de agosto de 1994"
30,20,118,2663,373,308,681,"21 de agosto de 1994"
30,20,118,2664,503,501,1004,"21 de agosto de 1994"
30,20,118,2665,261,238,499,"21 de agosto de 1994"
30,20,138,3294,425,405,830,"21 de agosto de 1994"
30,20,138,3295,184,169,353,"21 de agosto de 1994"
30,20,138,3296,277,235,512,"21 de agosto de 1994"
30,20,141,3326,344,337,681,"21 de agosto de 1994"
30,20,141,3327,92,73,165,"21 de agosto de 1994"
30,20,148,3504,444,422,866,"21 de agosto de 1994"
30,20,148,3505,330,305,635,"21 de agosto de 1994"
30,20,148,3506,306,271,577,"21 de agosto de 1994"
30,20,148,3507,336,270,606,"21 de agosto de 1994"
30,20,148,3508,670,727,1397,"21 de agosto de 1994"
30,20,148,3509,107,118,225,"21 de agosto de 1994"
30,20,148,3510,369,341,710,"21 de agosto de 1994"
30,20,148,3511,364,311,675,"21 de agosto de 1994"
30,20,148,3512,166,170,336,"21 de agosto de 1994"
30,20,159,3699,464,405,869,"21 de agosto de 1994"
30,20,159,3700,526,548,1074,"21 de agosto de 1994"
30,20,159,3701,508,540,1048,"21 de agosto de 1994"
30,20,159,3702,277,250,527,"21 de agosto de 1994"
30,20,159,3703,337,318,655,"21 de agosto de 1994"
30,20,159,3704,322,323,645,"21 de agosto de 1994"
30,20,159,3705,669,651,1320,"21 de agosto de 1994"
30,20,167,3772,439,422,861,"21 de agosto de 1994"
30,20,167,3773,548,531,1079,"21 de agosto de 1994"
30,20,167,3774,93,71,164,"21 de agosto de 1994"
30,20,167,3775,114,98,212,"21 de agosto de 1994"
30,20,167,3776,305,274,579,"21 de agosto de 1994"
30,20,167,3777,412,401,813,"21 de agosto de 1994"
30,20,167,3778,289,248,537,"21 de agosto de 1994"
30,20,167,3779,199,185,384,"21 de agosto de 1994"
30,20,170,3804,368,364,732,"21 de agosto de 1994"
30,20,170,3805,432,380,812,"21 de agosto de 1994"
30,20,170,3806,101,79,180,"21 de agosto de 1994"
30,20,170,3807,120,96,216,"21 de agosto de 1994"
30,20,172,3824,474,461,935,"21 de agosto de 1994"
30,20,172,3825,489,552,1041,"21 de agosto de 1994"
30,20,172,3826,418,431,849,"21 de agosto de 1994"
30,20,172,3827,328,303,631,"21 de agosto de 1994"
30,20,172,3828,419,369,788,"21 de agosto de 1994"
30,20,172,3829,352,301,653,"21 de agosto de 1994"
30,20,172,3830,340,294,634,"21 de agosto de 1994"
30,20,172,3831,399,441,840,"21 de agosto de 1994"
30,20,172,3832,380,398,778,"21 de agosto de 1994"
30,20,172,3833,535,580,1115,"21 de agosto de 1994"
30,20,172,3834,520,448,968,"21 de agosto de 1994"
30,20,172,3835,62,43,105,"21 de agosto de 1994"
30,20,172,3836,489,512,1001,"21 de agosto de 1994"
30,20,172,3837,602,588,1190,"21 de agosto de 1994"
30,20,172,3838,116,88,204,"21 de agosto de 1994"
30,20,172,3839,565,492,1057,"21 de agosto de 1994"
30,20,172,3840,244,222,466,"21 de agosto de 1994"
30,20,172,3841,170,129,299,"21 de agosto de 1994"
30,20,172,3842,116,92,208,"21 de agosto de 1994"
30,20,172,3843,594,595,1189,"21 de agosto de 1994"
30,20,172,3844,355,310,665,"21 de agosto de 1994"
30,20,172,3845,519,442,961,"21 de agosto de 1994"
30,20,172,3846,233,245,478,"21 de agosto de 1994"
30,20,172,3847,360,393,753,"21 de agosto de 1994"
30,20,172,3848,139,148,287,"21 de agosto de 1994"
30,20,172,3849,586,587,1173,"21 de agosto de 1994"
30,20,172,3850,281,254,535,"21 de agosto de 1994"
30,20,172,3851,301,286,587,"21 de agosto de 1994"
30,20,172,3852,442,410,852,"21 de agosto de 1994"
30,20,172,3853,266,271,537,"21 de agosto de 1994"
30,20,172,3854,255,252,507,"21 de agosto de 1994"
30,20,172,3855,509,513,1022,"21 de agosto de 1994"
30,20,172,3856,275,260,535,"21 de agosto de 1994"
30,20,172,3857,394,340,734,"21 de agosto de 1994"
30,20,172,3858,165,133,298,"21 de agosto de 1994"
30,20,183,4074,643,662,1305,"21 de agosto de 1994"
30,20,183,4075,285,294,579,"21 de agosto de 1994"
30,20,183,4076,209,194,403,"21 de agosto de 1994"
30,20,184,4077,586,636,1222,"21 de agosto de 1994"
30,20,184,4078,170,158,328,"21 de agosto de 1994"
30,20,195,4525,699,668,1367,"21 de agosto de 1994"
30,20,195,4526,172,133,305,"21 de agosto de 1994"
30,20,196,4527,256,312,568,"21 de agosto de 1994"
30,20,196,4528,324,381,705,"21 de agosto de 1994"
30,20,196,4529,305,372,677,"21 de agosto de 1994"
30,20,196,4530,339,375,714,"21 de agosto de 1994"
30,20,196,4531,287,346,633,"21 de agosto de 1994"
30,20,196,4532,334,375,709,"21 de agosto de 1994"
30,20,196,4533,336,343,679,"21 de agosto de 1994"
30,20,196,4534,241,297,538,"21 de agosto de 1994"
30,20,196,4535,139,151,290,"21 de agosto de 1994"
30,20,196,4536,195,217,412,"21 de agosto de 1994"
30,20,196,4537,527,585,1112,"21 de agosto de 1994"
30,20,196,4538,418,470,888,"21 de agosto de 1994"
30,20,196,4539,666,663,1329,"21 de agosto de 1994"
30,20,196,4540,281,297,578,"21 de agosto de 1994"
30,20,201,4570,449,484,933,"21 de agosto de 1994"
30,20,201,4571,671,794,1465,"21 de agosto de 1994"
30,20,201,4572,294,365,659,"21 de agosto de 1994"
30,20,201,4573,287,285,572,"21 de agosto de 1994"
30,20,201,4574,392,365,757,"21 de agosto de 1994"
30,20,201,4575,171,134,305,"21 de agosto de 1994"
30,20,201,4576,296,276,572,"21 de agosto de 1994"
30,20,201,4577,548,489,1037,"21 de agosto de 1994"
30,20,201,4578,346,308,654,"21 de agosto de 1994"
30,20,201,4579,92,79,171,"21 de agosto de 1994"
30,20,201,4580,227,185,412,"21 de agosto de 1994"
30,20,201,4581,393,393,786,"21 de agosto de 1994"
30,20,201,4582,438,408,846,"21 de agosto de 1994"
30,20,201,4583,343,290,633,"21 de agosto de 1994"
30,20,201,4584,162,144,306,"21 de agosto de 1994"
30,20,201,4585,350,292,642,"21 de agosto de 1994"
30,20,201,4586,271,237,508,"21 de agosto de 1994"
30,20,201,4587,232,206,438,"21 de agosto de 1994"
30,20,201,4588,270,270,540,"21 de agosto de 1994"
30,20,201,4589,187,143,330,"21 de agosto de 1994"
30,20,201,4590,437,400,837,"21 de agosto de 1994"
30,20,201,4591,207,160,367,"21 de agosto de 1994"
30,20,201,4592,253,211,464,"21 de agosto de 1994"
30,20,201,4593,483,442,925,"21 de agosto de 1994"
30,20,201,4594,380,297,677,"21 de agosto de 1994"
30,20,201,4595,111,95,206,"21 de agosto de 1994"
30,20,201,4596,364,319,683,"21 de agosto de 1994"
30,20,201,4597,250,206,456,"21 de agosto de 1994"
30,21,29,492,392,485,877,"21 de agosto de 1994"
30,21,29,493,388,513,901,"21 de agosto de 1994"
30,21,29,494,415,540,955,"21 de agosto de 1994"
30,21,29,495,343,503,846,"21 de agosto de 1994"
30,21,29,496,347,431,778,"21 de agosto de 1994"
30,21,29,497,280,329,609,"21 de agosto de 1994"
30,21,29,498,222,277,499,"21 de agosto de 1994"
30,21,29,499,279,378,657,"21 de agosto de 1994"
30,21,29,500,397,485,882,"21 de agosto de 1994"
30,21,29,501,304,341,645,"21 de agosto de 1994"
30,21,29,502,303,426,729,"21 de agosto de 1994"
30,21,29,503,305,364,669,"21 de agosto de 1994"
30,21,29,504,364,437,801,"21 de agosto de 1994"
30,21,29,505,371,431,802,"21 de agosto de 1994"
30,21,29,506,683,822,1505,"21 de agosto de 1994"
30,21,29,507,568,625,1193,"21 de agosto de 1994"
30,21,29,508,632,741,1373,"21 de agosto de 1994"
30,21,29,509,518,642,1160,"21 de agosto de 1994"
30,21,29,510,468,565,1033,"21 de agosto de 1994"
30,21,29,511,314,406,720,"21 de agosto de 1994"
30,21,29,512,328,413,741,"21 de agosto de 1994"
30,21,29,513,268,303,571,"21 de agosto de 1994"
30,21,29,514,346,364,710,"21 de agosto de 1994"
30,21,29,515,385,442,827,"21 de agosto de 1994"
30,21,29,516,632,745,1377,"21 de agosto de 1994"
30,21,29,517,575,645,1220,"21 de agosto de 1994"
30,21,29,518,427,500,927,"21 de agosto de 1994"
30,21,29,519,492,548,1040,"21 de agosto de 1994"
30,21,29,520,548,639,1187,"21 de agosto de 1994"
30,21,29,521,492,574,1066,"21 de agosto de 1994"
30,21,29,522,670,755,1425,"21 de agosto de 1994"
30,21,29,523,668,747,1415,"21 de agosto de 1994"
30,21,29,524,548,606,1154,"21 de agosto de 1994"
30,21,29,525,423,452,875,"21 de agosto de 1994"
30,21,29,526,457,498,955,"21 de agosto de 1994"
30,21,29,527,258,336,594,"21 de agosto de 1994"
30,21,29,528,210,230,440,"21 de agosto de 1994"
30,21,29,529,669,776,1445,"21 de agosto de 1994"
30,21,29,530,622,731,1353,"21 de agosto de 1994"
30,21,29,531,334,432,766,"21 de agosto de 1994"
30,21,29,532,320,409,729,"21 de agosto de 1994"
30,21,29,533,420,473,893,"21 de agosto de 1994"
30,21,29,534,420,497,917,"21 de agosto de 1994"
30,21,29,535,283,345,628,"21 de agosto de 1994"
30,21,29,536,486,563,1049,"21 de agosto de 1994"
30,21,29,537,469,507,976,"21 de agosto de 1994"
30,21,29,538,258,314,572,"21 de agosto de 1994"
30,21,29,539,219,251,470,"21 de agosto de 1994"
30,21,29,540,282,367,649,"21 de agosto de 1994"
30,21,29,541,480,524,1004,"21 de agosto de 1994"
30,21,29,542,211,210,421,"21 de agosto de 1994"
30,21,29,543,427,476,903,"21 de agosto de 1994"
30,21,29,544,391,447,838,"21 de agosto de 1994"
30,21,29,545,283,362,645,"21 de agosto de 1994"
30,21,29,546,503,156,659,"21 de agosto de 1994"
30,21,29,547,224,248,472,"21 de agosto de 1994"
30,21,29,548,364,418,782,"21 de agosto de 1994"
30,21,29,549,360,404,764,"21 de agosto de 1994"
30,21,29,550,360,442,802,"21 de agosto de 1994"
30,21,29,551,330,386,716,"21 de agosto de 1994"
30,21,29,552,383,448,831,"21 de agosto de 1994"
30,21,29,553,223,244,467,"21 de agosto de 1994"
30,21,29,554,336,396,732,"21 de agosto de 1994"
30,21,29,555,266,332,598,"21 de agosto de 1994"
30,21,29,556,334,411,745,"21 de agosto de 1994"
30,21,29,557,311,392,703,"21 de agosto de 1994"
30,21,29,558,296,337,633,"21 de agosto de 1994"
30,21,29,559,400,449,849,"21 de agosto de 1994"
30,21,29,560,397,440,837,"21 de agosto de 1994"
30,21,29,561,311,361,672,"21 de agosto de 1994"
30,21,29,562,295,392,687,"21 de agosto de 1994"
30,21,29,563,296,336,632,"21 de agosto de 1994"
30,21,29,564,367,419,786,"21 de agosto de 1994"
30,21,29,565,394,443,837,"21 de agosto de 1994"
30,21,29,566,263,297,560,"21 de agosto de 1994"
30,21,29,567,377,446,823,"21 de agosto de 1994"
30,21,29,568,414,485,899,"21 de agosto de 1994"
30,21,29,569,322,354,676,"21 de agosto de 1994"
30,21,29,570,620,776,1396,"21 de agosto de 1994"
30,21,29,571,391,471,862,"21 de agosto de 1994"
30,21,29,572,243,263,506,"21 de agosto de 1994"
30,21,29,573,411,484,895,"21 de agosto de 1994"
30,21,29,574,323,323,646,"21 de agosto de 1994"
30,21,29,575,236,273,509,"21 de agosto de 1994"
30,21,29,576,388,449,837,"21 de agosto de 1994"
30,21,29,577,388,483,871,"21 de agosto de 1994"
30,21,29,578,287,347,634,"21 de agosto de 1994"
30,21,29,579,239,321,560,"21 de agosto de 1994"
30,21,29,580,301,347,648,"21 de agosto de 1994"
30,21,29,581,575,611,1186,"21 de agosto de 1994"
30,21,29,582,261,309,570,"21 de agosto de 1994"
30,21,29,583,240,257,497,"21 de agosto de 1994"
30,21,29,584,352,418,770,"21 de agosto de 1994"
30,21,29,585,453,482,935,"21 de agosto de 1994"
30,21,29,586,483,533,1016,"21 de agosto de 1994"
30,21,29,587,378,476,854,"21 de agosto de 1994"
30,21,92,2138,494,490,984,"21 de agosto de 1994"
30,21,92,2139,255,322,577,"21 de agosto de 1994"
30,21,92,2140,443,464,907,"21 de agosto de 1994"
30,21,92,2141,191,171,362,"21 de agosto de 1994"
30,21,92,2142,492,413,905,"21 de agosto de 1994"
30,21,92,2143,122,108,230,"21 de agosto de 1994"
30,21,92,2144,411,408,819,"21 de agosto de 1994"
30,21,92,2145,304,288,592,"21 de agosto de 1994"
30,21,101,2249,387,438,825,"21 de agosto de 1994"
30,21,101,2250,320,345,665,"21 de agosto de 1994"
30,21,101,2251,288,325,613,"21 de agosto de 1994"
30,21,101,2252,223,246,469,"21 de agosto de 1994"
30,21,101,2253,431,391,822,"21 de agosto de 1994"
30,21,101,2254,501,439,940,"21 de agosto de 1994"
30,21,101,2255,386,335,721,"21 de agosto de 1994"
30,21,101,2256,292,274,566,"21 de agosto de 1994"
30,21,101,2257,442,401,843,"21 de agosto de 1994"
30,21,101,2258,462,449,911,"21 de agosto de 1994"
30,21,101,2259,335,306,641,"21 de agosto de 1994"
30,21,101,2260,218,219,437,"21 de agosto de 1994"
30,21,101,2261,300,271,571,"21 de agosto de 1994"
30,21,101,2262,442,410,852,"21 de agosto de 1994"
30,21,101,2263,462,394,856,"21 de agosto de 1994"
30,21,101,2264,613,549,1162,"21 de agosto de 1994"
30,21,106,2390,482,506,988,"21 de agosto de 1994"
30,21,106,2391,468,414,882,"21 de agosto de 1994"
30,21,106,2392,345,429,774,"21 de agosto de 1994"
30,21,106,2393,296,307,603,"21 de agosto de 1994"
30,21,106,2394,357,415,772,"21 de agosto de 1994"
30,21,106,2395,166,205,371,"21 de agosto de 1994"
30,21,106,2396,362,416,778,"21 de agosto de 1994"
30,21,106,2397,483,484,967,"21 de agosto de 1994"
30,21,106,2398,364,385,749,"21 de agosto de 1994"
30,21,106,2399,318,383,701,"21 de agosto de 1994"
30,21,106,2400,265,281,546,"21 de agosto de 1994"
30,21,106,2401,393,389,782,"21 de agosto de 1994"
30,21,106,2402,389,378,767,"21 de agosto de 1994"
30,21,106,2403,438,403,841,"21 de agosto de 1994"
30,21,106,2404,312,328,640,"21 de agosto de 1994"
30,21,106,2405,454,476,930,"21 de agosto de 1994"
30,21,106,2406,324,329,653,"21 de agosto de 1994"
30,21,106,2407,325,312,637,"21 de agosto de 1994"
30,21,106,2408,319,287,606,"21 de agosto de 1994"
30,21,106,2409,507,547,1054,"21 de agosto de 1994"
30,21,106,2410,300,320,620,"21 de agosto de 1994"
30,21,106,2411,631,623,1254,"21 de agosto de 1994"
30,21,106,2412,134,124,258,"21 de agosto de 1994"
30,21,106,2413,176,173,349,"21 de agosto de 1994"
30,21,106,2414,204,183,387,"21 de agosto de 1994"
30,21,180,4010,519,549,1068,"21 de agosto de 1994"
30,21,180,4011,418,428,846,"21 de agosto de 1994"
30,21,180,4012,559,520,1079,"21 de agosto de 1994"
30,21,180,4013,341,328,669,"21 de agosto de 1994"
30,21,180,4014,474,465,939,"21 de agosto de 1994"
30,21,180,4015,311,280,591,"21 de agosto de 1994"
30,21,180,4016,429,336,765,"21 de agosto de 1994"
30,21,180,4017,400,368,768,"21 de agosto de 1994"
30,21,180,4018,279,300,579,"21 de agosto de 1994"
30,21,180,4019,260,296,556,"21 de agosto de 1994"
30,21,180,4020,359,411,770,"21 de agosto de 1994"
30,21,180,4021,325,322,647,"21 de agosto de 1994"
30,21,180,4022,359,374,733,"21 de agosto de 1994"
30,21,180,4023,295,304,599,"21 de agosto de 1994"
30,21,180,4024,259,250,509,"21 de agosto de 1994"
30,21,180,4025,459,468,927,"21 de agosto de 1994"
30,21,180,4026,530,499,1029,"21 de agosto de 1994"
30,21,180,4027,365,330,695,"21 de agosto de 1994"
30,21,180,4028,193,166,359,"21 de agosto de 1994"
30,21,180,4029,299,256,555,"21 de agosto de 1994"
30,21,180,4030,392,284,676,"21 de agosto de 1994"
30,21,180,4031,249,223,472,"21 de agosto de 1994"
30,21,180,4032,393,359,752,"21 de agosto de 1994"
30,21,180,4033,559,552,1111,"21 de agosto de 1994"
30,21,180,4034,537,533,1070,"21 de agosto de 1994"
30,21,180,4035,616,559,1175,"21 de agosto de 1994"
30,21,180,4036,522,514,1036,"21 de agosto de 1994"
30,21,192,4391,368,464,832,"21 de agosto de 1994"
30,21,192,4392,334,423,757,"21 de agosto de 1994"
30,21,192,4393,416,479,895,"21 de agosto de 1994"
30,21,192,4394,409,507,916,"21 de agosto de 1994"
30,21,192,4395,282,367,649,"21 de agosto de 1994"
30,21,192,4396,307,432,739,"21 de agosto de 1994"
30,21,192,4397,178,244,422,"21 de agosto de 1994"
30,21,192,4398,293,371,664,"21 de agosto de 1994"
30,21,192,4399,264,379,643,"21 de agosto de 1994"
30,21,192,4400,156,215,371,"21 de agosto de 1994"
30,21,192,4401,390,538,928,"21 de agosto de 1994"
30,21,192,4402,457,574,1031,"21 de agosto de 1994"
30,21,192,4403,326,433,759,"21 de agosto de 1994"
30,21,192,4404,205,275,480,"21 de agosto de 1994"
30,21,192,4405,320,455,775,"21 de agosto de 1994"
30,21,192,4406,278,381,659,"21 de agosto de 1994"
30,21,192,4407,229,312,541,"21 de agosto de 1994"
30,21,192,4408,356,434,790,"21 de agosto de 1994"
30,21,192,4409,299,368,667,"21 de agosto de 1994"
30,21,192,4410,385,461,846,"21 de agosto de 1994"
30,21,192,4411,428,506,934,"21 de agosto de 1994"
30,21,192,4412,476,612,1088,"21 de agosto de 1994"
30,21,192,4413,443,473,916,"21 de agosto de 1994"
30,21,192,4414,534,633,1167,"21 de agosto de 1994"
30,21,192,4415,344,392,736,"21 de agosto de 1994"
30,21,192,4416,403,482,885,"21 de agosto de 1994"
30,21,192,4417,337,442,779,"21 de agosto de 1994"
30,21,192,4418,249,295,544,"21 de agosto de 1994"
30,21,192,4419,260,281,541,"21 de agosto de 1994"
30,21,192,4420,443,645,1088,"21 de agosto de 1994"
30,21,192,4421,407,528,935,"21 de agosto de 1994"
30,21,192,4422,241,288,529,"21 de agosto de 1994"
30,21,192,4423,428,475,903,"21 de agosto de 1994"
30,21,192,4424,374,436,810,"21 de agosto de 1994"
30,21,192,4425,330,455,785,"21 de agosto de 1994"
30,21,192,4426,288,355,643,"21 de agosto de 1994"
30,21,192,4427,326,444,770,"21 de agosto de 1994"
30,21,192,4428,260,358,618,"21 de agosto de 1994"
30,21,192,4429,285,379,664,"21 de agosto de 1994"
30,21,192,4430,301,359,660,"21 de agosto de 1994"
30,21,192,4431,322,459,781,"21 de agosto de 1994"
30,21,192,4432,288,397,685,"21 de agosto de 1994"
30,21,192,4433,321,435,756,"21 de agosto de 1994"
30,21,192,4434,377,467,844,"21 de agosto de 1994"
30,21,192,4435,293,442,735,"21 de agosto de 1994"
30,21,192,4436,369,522,891,"21 de agosto de 1994"
30,21,192,4437,384,517,901,"21 de agosto de 1994"
30,21,192,4438,254,342,596,"21 de agosto de 1994"
30,21,192,4439,274,372,646,"21 de agosto de 1994"
30,21,192,4440,372,519,891,"21 de agosto de 1994"
30,21,192,4441,405,434,839,"21 de agosto de 1994"
30,21,192,4442,326,398,724,"21 de agosto de 1994"
30,21,192,4443,265,330,595,"21 de agosto de 1994"
30,21,192,4444,375,415,790,"21 de agosto de 1994"
30,21,192,4445,310,372,682,"21 de agosto de 1994"
30,21,192,4446,382,390,772,"21 de agosto de 1994"
30,21,192,4447,329,371,700,"21 de agosto de 1994"
30,21,192,4448,326,365,691,"21 de agosto de 1994"
30,21,192,4449,293,332,625,"21 de agosto de 1994"
30,21,192,4450,343,395,738,"21 de agosto de 1994"
30,21,192,4451,281,308,589,"21 de agosto de 1994"
30,21,192,4452,426,474,900,"21 de agosto de 1994"
30,21,192,4453,357,391,748,"21 de agosto de 1994"
30,21,192,4454,368,432,800,"21 de agosto de 1994"
30,21,192,4455,180,199,379,"21 de agosto de 1994"
30,21,192,4456,177,257,434,"21 de agosto de 1994"
30,21,192,4457,349,415,764,"21 de agosto de 1994"
30,21,192,4458,295,377,672,"21 de agosto de 1994"
30,21,192,4459,251,300,551,"21 de agosto de 1994"
30,21,192,4460,298,324,622,"21 de agosto de 1994"
30,21,192,4461,358,396,754,"21 de agosto de 1994"
30,21,192,4462,382,416,798,"21 de agosto de 1994"
30,21,192,4463,299,372,671,"21 de agosto de 1994"
30,21,192,4464,297,373,670,"21 de agosto de 1994"
30,21,192,4465,237,287,524,"21 de agosto de 1994"
30,21,192,4466,339,399,738,"21 de agosto de 1994"
30,21,192,4467,268,351,619,"21 de agosto de 1994"
30,21,192,4468,374,518,892,"21 de agosto de 1994"
30,21,192,4469,339,311,650,"21 de agosto de 1994"
30,21,192,4470,375,412,787,"21 de agosto de 1994"
30,21,192,4471,480,577,1057,"21 de agosto de 1994"
30,21,192,4472,296,295,591,"21 de agosto de 1994"
30,21,192,4473,283,264,547,"21 de agosto de 1994"
30,21,192,4474,903,1053,1956,"21 de agosto de 1994"
30,21,192,4475,195,245,440,"21 de agosto de 1994"
30,21,192,4476,345,381,726,"21 de agosto de 1994"
30,21,192,4477,389,424,813,"21 de agosto de 1994"
30,21,192,4478,219,219,438,"21 de agosto de 1994"
30,21,192,4479,279,282,561,"21 de agosto de 1994"
30,21,192,4480,279,278,557,"21 de agosto de 1994"
30,21,192,4481,327,294,621,"21 de agosto de 1994"
30,21,192,4482,319,293,612,"21 de agosto de 1994"
30,21,192,4483,211,208,419,"21 de agosto de 1994"
30,21,192,4484,334,348,682,"21 de agosto de 1994"
30,21,192,4485,460,447,907,"21 de agosto de 1994"
30,21,192,4486,200,225,425,"21 de agosto de 1994"
30,21,192,4487,268,308,576,"21 de agosto de 1994"
30,21,192,4488,487,517,1004,"21 de agosto de 1994"
30,21,192,4489,318,297,615,"21 de agosto de 1994"
30,21,192,4490,404,439,843,"21 de agosto de 1994"
30,21,192,4491,379,351,730,"21 de agosto de 1994"
30,21,192,4492,235,268,503,"21 de agosto de 1994"
30,21,192,4493,287,278,565,"21 de agosto de 1994"
30,21,192,4494,515,518,1033,"21 de agosto de 1994"
30,21,192,4495,341,375,716,"21 de agosto de 1994"
30,21,192,4496,296,273,569,"21 de agosto de 1994"
30,21,192,4497,757,737,1494,"21 de agosto de 1994"
30,21,192,4498,218,209,427,"21 de agosto de 1994"
30,21,192,4499,267,264,531,"21 de agosto de 1994"
30,21,192,4500,362,421,783,"21 de agosto de 1994"
30,22,16,339,547,600,1147,"21 de agosto de 1994"
30,22,16,340,486,582,1068,"21 de agosto de 1994"
30,22,16,341,383,442,825,"21 de agosto de 1994"
30,22,16,342,472,536,1008,"21 de agosto de 1994"
30,22,16,343,400,409,809,"21 de agosto de 1994"
30,22,16,344,419,472,891,"21 de agosto de 1994"
30,22,16,345,394,425,819,"21 de agosto de 1994"
30,22,16,346,367,412,779,"21 de agosto de 1994"
30,22,16,347,148,122,270,"21 de agosto de 1994"
30,22,16,348,378,335,713,"21 de agosto de 1994"
30,22,16,349,789,723,1512,"21 de agosto de 1994"
30,22,16,350,466,429,895,"21 de agosto de 1994"
30,22,16,351,308,321,629,"21 de agosto de 1994"
30,22,16,352,401,408,809,"21 de agosto de 1994"
30,22,16,353,585,603,1188,"21 de agosto de 1994"
30,22,16,354,683,651,1334,"21 de agosto de 1994"
30,22,16,355,288,300,588,"21 de agosto de 1994"
30,22,16,356,535,468,1003,"21 de agosto de 1994"
30,22,16,357,336,325,661,"21 de agosto de 1994"
30,22,16,358,424,392,816,"21 de agosto de 1994"
30,22,16,359,144,151,295,"21 de agosto de 1994"
30,22,16,360,488,508,996,"21 de agosto de 1994"
30,22,16,361,248,243,491,"21 de agosto de 1994"
30,22,16,362,401,357,758,"21 de agosto de 1994"
30,22,98,2221,420,450,870,"21 de agosto de 1994"
30,22,98,2222,524,611,1135,"21 de agosto de 1994"
30,22,98,2223,198,225,423,"21 de agosto de 1994"
30,22,98,2224,595,582,1177,"21 de agosto de 1994"
30,22,98,2225,184,199,383,"21 de agosto de 1994"
30,22,98,2226,364,404,768,"21 de agosto de 1994"
30,22,98,2227,375,457,832,"21 de agosto de 1994"
30,22,98,2228,333,408,741,"21 de agosto de 1994"
30,22,98,2229,334,384,718,"21 de agosto de 1994"
30,22,98,2230,330,390,720,"21 de agosto de 1994"
30,22,98,2231,378,424,802,"21 de agosto de 1994"
30,22,98,2232,348,403,751,"21 de agosto de 1994"
30,22,98,2233,374,380,754,"21 de agosto de 1994"
30,22,98,2234,626,678,1304,"21 de agosto de 1994"
30,22,98,2235,458,522,980,"21 de agosto de 1994"
30,22,98,2236,333,353,686,"21 de agosto de 1994"
30,22,140,3321,296,328,624,"21 de agosto de 1994"
30,22,140,3322,471,500,971,"21 de agosto de 1994"
30,22,140,3323,409,399,808,"21 de agosto de 1994"
30,22,140,3324,486,500,986,"21 de agosto de 1994"
30,22,140,3325,237,230,467,"21 de agosto de 1994"
30,22,142,3328,175,208,383,"21 de agosto de 1994"
30,22,142,3329,703,704,1407,"21 de agosto de 1994"
30,22,142,3330,463,499,962,"21 de agosto de 1994"
30,22,142,3331,337,355,692,"21 de agosto de 1994"
30,22,142,3332,402,446,848,"21 de agosto de 1994"
30,22,142,3333,486,548,1034,"21 de agosto de 1994"
30,22,142,3334,392,462,854,"21 de agosto de 1994"
30,22,142,3335,342,389,731,"21 de agosto de 1994"
30,22,142,3336,525,607,1132,"21 de agosto de 1994"
30,22,142,3337,328,411,739,"21 de agosto de 1994"
30,22,142,3338,460,559,1019,"21 de agosto de 1994"
30,22,142,3339,514,554,1068,"21 de agosto de 1994"
30,22,142,3340,420,448,868,"21 de agosto de 1994"
30,22,142,3341,407,438,845,"21 de agosto de 1994"
30,22,142,3342,358,408,766,"21 de agosto de 1994"
30,22,142,3343,329,335,664,"21 de agosto de 1994"
30,22,142,3344,365,410,775,"21 de agosto de 1994"
30,22,142,3345,482,538,1020,"21 de agosto de 1994"
30,22,142,3346,391,498,889,"21 de agosto de 1994"
30,22,142,3347,480,553,1033,"21 de agosto de 1994"
30,22,142,3348,388,469,857,"21 de agosto de 1994"
30,22,142,3349,520,599,1119,"21 de agosto de 1994"
30,22,142,3350,575,618,1193,"21 de agosto de 1994"
30,22,142,3351,770,590,1360,"21 de agosto de 1994"
30,22,142,3352,441,472,913,"21 de agosto de 1994"
30,22,142,3353,351,415,766,"21 de agosto de 1994"
30,22,142,3354,400,451,851,"21 de agosto de 1994"
30,22,142,3355,575,667,1242,"21 de agosto de 1994"
30,22,142,3356,148,157,305,"21 de agosto de 1994"
30,22,142,3357,329,379,708,"21 de agosto de 1994"
30,22,142,3358,279,261,540,"21 de agosto de 1994"
30,22,142,3359,364,292,656,"21 de agosto de 1994"
30,22,142,3360,373,268,641,"21 de agosto de 1994"
30,22,142,3361,294,293,587,"21 de agosto de 1994"
30,22,142,3362,533,502,1035,"21 de agosto de 1994"
30,22,142,3363,286,219,505,"21 de agosto de 1994"
30,22,142,3364,214,185,399,"21 de agosto de 1994"
30,22,142,3365,739,662,1401,"21 de agosto de 1994"
30,22,142,3366,484,453,937,"21 de agosto de 1994"
30,22,142,3367,649,587,1236,"21 de agosto de 1994"
30,22,142,3368,705,676,1381,"21 de agosto de 1994"
30,22,142,3369,317,281,598,"21 de agosto de 1994"
30,22,142,3370,273,286,559,"21 de agosto de 1994"
30,22,142,3371,451,486,937,"21 de agosto de 1994"
30,22,142,3372,488,510,998,"21 de agosto de 1994"
30,22,142,3373,425,475,900,"21 de agosto de 1994"
30,22,142,3374,462,482,944,"21 de agosto de 1994"
30,22,142,3375,546,546,1092,"21 de agosto de 1994"
30,22,142,3376,673,591,1264,"21 de agosto de 1994"
30,22,142,3377,275,279,554,"21 de agosto de 1994"
30,22,142,3378,523,556,1079,"21 de agosto de 1994"
30,22,142,3379,445,476,921,"21 de agosto de 1994"
30,22,142,3380,353,341,694,"21 de agosto de 1994"
30,22,142,3381,398,446,844,"21 de agosto de 1994"
30,22,142,3382,292,294,586,"21 de agosto de 1994"
30,22,142,3383,427,484,911,"21 de agosto de 1994"
30,22,142,3384,407,389,796,"21 de agosto de 1994"
30,22,142,3385,471,439,910,"21 de agosto de 1994"
30,22,142,3386,276,264,540,"21 de agosto de 1994"
30,22,142,3387,348,371,719,"21 de agosto de 1994"
30,22,142,3388,343,321,664,"21 de agosto de 1994"
30,22,142,3389,506,489,995,"21 de agosto de 1994"
30,22,142,3390,414,365,779,"21 de agosto de 1994"
30,22,142,3391,258,234,492,"21 de agosto de 1994"
30,22,142,3392,469,475,944,"21 de agosto de 1994"
30,22,142,3393,176,172,348,"21 de agosto de 1994"
30,22,142,3394,522,466,988,"21 de agosto de 1994"
30,22,142,3395,194,190,384,"21 de agosto de 1994"
30,22,142,3396,438,439,877,"21 de agosto de 1994"
30,22,142,3397,564,538,1102,"21 de agosto de 1994"
30,22,142,3398,623,560,1183,"21 de agosto de 1994"
30,22,142,3399,585,494,1079,"21 de agosto de 1994"
30,22,142,3400,263,224,487,"21 de agosto de 1994"
30,22,142,3401,308,290,598,"21 de agosto de 1994"
30,22,142,3402,532,467,999,"21 de agosto de 1994"
30,22,142,3403,560,463,1023,"21 de agosto de 1994"
30,22,142,3404,578,482,1060,"21 de agosto de 1994"
30,22,142,3405,192,171,363,"21 de agosto de 1994"
30,22,142,3406,549,488,1037,"21 de agosto de 1994"
30,22,142,3407,346,326,672,"21 de agosto de 1994"
30,22,142,3408,204,171,375,"21 de agosto de 1994"
30,22,144,3437,546,601,1147,"21 de agosto de 1994"
30,22,144,3438,396,406,802,"21 de agosto de 1994"
30,22,144,3439,273,298,571,"21 de agosto de 1994"
30,22,144,3440,333,359,692,"21 de agosto de 1994"
30,22,144,3441,399,418,817,"21 de agosto de 1994"
30,22,144,3442,333,396,729,"21 de agosto de 1994"
30,22,144,3443,326,358,684,"21 de agosto de 1994"
30,22,144,3444,276,307,583,"21 de agosto de 1994"
30,22,144,3445,453,491,944,"21 de agosto de 1994"
30,22,144,3446,431,460,891,"21 de agosto de 1994"
30,22,144,3447,278,270,548,"21 de agosto de 1994"
30,22,144,3448,246,263,509,"21 de agosto de 1994"
30,22,144,3449,168,151,319,"21 de agosto de 1994"
30,22,144,3450,260,241,501,"21 de agosto de 1994"
30,22,144,3451,249,224,473,"21 de agosto de 1994"
30,22,144,3452,354,299,653,"21 de agosto de 1994"
30,22,144,3453,537,542,1079,"21 de agosto de 1994"
30,22,144,3454,372,355,727,"21 de agosto de 1994"
30,22,144,3455,373,369,742,"21 de agosto de 1994"
30,22,144,3456,434,440,874,"21 de agosto de 1994"
30,22,144,3457,243,219,462,"21 de agosto de 1994"
30,22,144,3458,382,353,735,"21 de agosto de 1994"
30,22,144,3459,371,310,681,"21 de agosto de 1994"
30,22,144,3460,399,419,818,"21 de agosto de 1994"
30,22,144,3461,409,404,813,"21 de agosto de 1994"
30,22,144,3462,193,203,396,"21 de agosto de 1994"
30,22,144,3463,504,473,977,"21 de agosto de 1994"
30,22,144,3464,281,246,527,"21 de agosto de 1994"
30,22,144,3465,426,418,844,"21 de agosto de 1994"
30,22,144,3466,438,460,898,"21 de agosto de 1994"
30,22,144,3467,460,447,907,"21 de agosto de 1994"
30,22,144,3468,511,501,1012,"21 de agosto de 1994"
30,22,144,3469,136,115,251,"21 de agosto de 1994"
30,22,144,3470,394,407,801,"21 de agosto de 1994"
30,22,144,3471,509,443,952,"21 de agosto de 1994"
30,22,144,3472,464,516,980,"21 de agosto de 1994"
30,22,144,3473,214,201,415,"21 de agosto de 1994"
30,22,144,3474,408,365,773,"21 de agosto de 1994"
30,22,168,3780,358,364,722,"21 de agosto de 1994"
30,22,168,3781,127,144,271,"21 de agosto de 1994"
30,22,168,3782,434,405,839,"21 de agosto de 1994"
30,22,168,3783,330,397,727,"21 de agosto de 1994"
30,22,168,3784,414,420,834,"21 de agosto de 1994"
30,22,168,3785,185,223,408,"21 de agosto de 1994"
30,22,168,3786,292,319,611,"21 de agosto de 1994"
30,22,168,3787,416,379,795,"21 de agosto de 1994"
30,22,168,3788,363,332,695,"21 de agosto de 1994"
30,22,168,3789,448,417,865,"21 de agosto de 1994"
30,22,168,3790,515,453,968,"21 de agosto de 1994"
30,22,168,3791,470,372,842,"21 de agosto de 1994"
30,22,168,3792,307,316,623,"21 de agosto de 1994"
30,22,168,3793,424,426,850,"21 de agosto de 1994"
30,22,168,3794,270,234,504,"21 de agosto de 1994"
30,22,168,3795,232,219,451,"21 de agosto de 1994"
30,22,168,3796,572,438,1010,"21 de agosto de 1994"
30,22,168,3797,355,292,647,"21 de agosto de 1994"
30,22,168,3798,209,157,366,"21 de agosto de 1994"
30,22,177,3985,437,451,888,"21 de agosto de 1994"
30,22,177,3986,317,415,732,"21 de agosto de 1994"
30,22,177,3987,323,392,715,"21 de agosto de 1994"
30,22,177,3988,438,489,927,"21 de agosto de 1994"
30,22,177,3989,591,627,1218,"21 de agosto de 1994"
30,22,177,3990,287,308,595,"21 de agosto de 1994"
30,22,177,3991,296,360,656,"21 de agosto de 1994"
30,22,177,3992,69,46,115,"21 de agosto de 1994"
30,22,177,3993,137,113,250,"21 de agosto de 1994"
30,22,177,3994,516,437,953,"21 de agosto de 1994"
30,22,177,3995,372,310,682,"21 de agosto de 1994"
30,22,177,3996,398,334,732,"21 de agosto de 1994"
30,22,177,3997,193,168,361,"21 de agosto de 1994"
30,22,177,3998,211,170,381,"21 de agosto de 1994"
30,23,50,1184,252,256,508,"21 de agosto de 1994"
30,23,50,1185,286,259,545,"21 de agosto de 1994"
30,23,50,1186,329,317,646,"21 de agosto de 1994"
30,23,50,1187,138,116,254,"21 de agosto de 1994"
30,23,50,1188,290,274,564,"21 de agosto de 1994"
30,23,50,1189,286,275,561,"21 de agosto de 1994"
30,23,50,1190,282,291,573,"21 de agosto de 1994"
30,23,50,1191,318,321,639,"21 de agosto de 1994"
30,23,50,1192,497,483,980,"21 de agosto de 1994"
30,23,50,1193,425,416,841,"21 de agosto de 1994"
30,23,50,1194,307,287,594,"21 de agosto de 1994"
30,23,50,1195,336,358,694,"21 de agosto de 1994"
30,23,50,1196,303,322,625,"21 de agosto de 1994"
30,23,50,1197,271,280,551,"21 de agosto de 1994"
30,23,50,1198,247,230,477,"21 de agosto de 1994"
30,23,50,1199,194,203,397,"21 de agosto de 1994"
30,23,50,1200,221,205,426,"21 de agosto de 1994"
30,23,50,1201,298,276,574,"21 de agosto de 1994"
30,23,50,1202,246,241,487,"21 de agosto de 1994"
30,23,50,1203,316,331,647,"21 de agosto de 1994"
30,23,50,1204,279,275,554,"21 de agosto de 1994"
30,23,50,1205,178,256,434,"21 de agosto de 1994"
30,23,50,1206,380,395,775,"21 de agosto de 1994"
30,23,50,1207,361,311,672,"21 de agosto de 1994"
30,23,50,1208,286,297,583,"21 de agosto de 1994"
30,23,50,1209,246,268,514,"21 de agosto de 1994"
30,23,50,1210,156,175,331,"21 de agosto de 1994"
30,23,50,1211,52,53,105,"21 de agosto de 1994"
30,23,50,1212,276,315,591,"21 de agosto de 1994"
30,23,50,1213,222,264,486,"21 de agosto de 1994"
30,23,50,1214,207,255,462,"21 de agosto de 1994"
30,23,50,1215,268,296,564,"21 de agosto de 1994"
30,23,50,1216,231,216,447,"21 de agosto de 1994"
30,23,50,1217,430,441,871,"21 de agosto de 1994"
30,23,50,1218,337,394,731,"21 de agosto de 1994"
30,23,50,1219,324,330,654,"21 de agosto de 1994"
30,23,50,1220,219,236,455,"21 de agosto de 1994"
30,23,50,1221,292,328,620,"21 de agosto de 1994"
30,23,50,1222,439,481,920,"21 de agosto de 1994"
30,23,50,1223,164,201,365,"21 de agosto de 1994"
30,23,50,1224,631,678,1309,"21 de agosto de 1994"
30,23,50,1225,410,442,852,"21 de agosto de 1994"
30,23,50,1226,449,455,904,"21 de agosto de 1994"
30,23,50,1227,261,253,514,"21 de agosto de 1994"
30,23,50,1228,777,761,1538,"21 de agosto de 1994"
30,23,50,1229,171,163,334,"21 de agosto de 1994"
30,23,50,1230,346,379,725,"21 de agosto de 1994"
30,23,50,1231,424,440,864,"21 de agosto de 1994"
30,23,50,1232,634,664,1298,"21 de agosto de 1994"
30,23,50,1233,267,289,556,"21 de agosto de 1994"
30,23,50,1234,614,727,1341,"21 de agosto de 1994"
30,23,50,1235,514,549,1063,"21 de agosto de 1994"
30,23,50,1236,446,520,966,"21 de agosto de 1994"
30,23,50,1237,245,250,495,"21 de agosto de 1994"
30,23,50,1238,556,597,1153,"21 de agosto de 1994"
30,23,50,1239,714,744,1458,"21 de agosto de 1994"
30,23,50,1240,397,470,867,"21 de agosto de 1994"
30,23,50,1241,144,130,274,"21 de agosto de 1994"
30,23,50,1242,405,385,790,"21 de agosto de 1994"
30,23,50,1243,436,458,894,"21 de agosto de 1994"
30,23,50,1244,140,129,269,"21 de agosto de 1994"
30,23,50,1245,287,270,557,"21 de agosto de 1994"
30,23,50,1246,267,263,530,"21 de agosto de 1994"
30,23,50,1247,298,270,568,"21 de agosto de 1994"
30,23,50,1248,317,316,633,"21 de agosto de 1994"
30,23,50,1249,243,234,477,"21 de agosto de 1994"
30,23,50,1250,230,232,462,"21 de agosto de 1994"
30,23,50,1251,320,312,632,"21 de agosto de 1994"
30,23,61,1390,446,451,897,"21 de agosto de 1994"
30,23,61,1391,402,403,805,"21 de agosto de 1994"
30,23,61,1392,249,258,507,"21 de agosto de 1994"
30,23,61,1393,809,782,1591,"21 de agosto de 1994"
30,23,61,1394,496,475,971,"21 de agosto de 1994"
30,23,61,1395,111,92,203,"21 de agosto de 1994"
30,23,61,1396,418,365,783,"21 de agosto de 1994"
30,23,61,1397,261,215,476,"21 de agosto de 1994"
30,23,61,1398,359,347,706,"21 de agosto de 1994"
30,23,61,1399,291,257,548,"21 de agosto de 1994"
30,23,61,1400,234,200,434,"21 de agosto de 1994"
30,23,61,1401,180,139,319,"21 de agosto de 1994"
30,23,61,1402,66,68,134,"21 de agosto de 1994"
30,23,72,1579,422,378,800,"21 de agosto de 1994"
30,23,72,1580,339,297,636,"21 de agosto de 1994"
30,23,72,1581,325,291,616,"21 de agosto de 1994"
30,23,72,1582,270,200,470,"21 de agosto de 1994"
30,23,72,1583,326,243,569,"21 de agosto de 1994"
30,23,72,1584,305,235,540,"21 de agosto de 1994"
30,23,72,1585,534,394,928,"21 de agosto de 1994"
30,23,72,1586,311,238,549,"21 de agosto de 1994"
30,23,72,1587,241,178,419,"21 de agosto de 1994"
30,23,72,1588,415,276,691,"21 de agosto de 1994"
30,23,72,1589,444,347,791,"21 de agosto de 1994"
30,23,72,1590,278,231,509,"21 de agosto de 1994"
30,23,72,1591,267,178,445,"21 de agosto de 1994"
30,23,72,1592,309,208,517,"21 de agosto de 1994"
30,23,72,1593,211,129,340,"21 de agosto de 1994"
30,23,72,1594,178,116,294,"21 de agosto de 1994"
30,23,72,1595,756,640,1396,"21 de agosto de 1994"
30,23,72,1596,139,80,219,"21 de agosto de 1994"
30,23,91,2105,227,263,490,"21 de agosto de 1994"
30,23,91,2106,250,290,540,"21 de agosto de 1994"
30,23,91,2107,546,554,1100,"21 de agosto de 1994"
30,23,91,2108,458,511,969,"21 de agosto de 1994"
30,23,91,2109,252,268,520,"21 de agosto de 1994"
30,23,91,2110,372,405,777,"21 de agosto de 1994"
30,23,91,2111,244,258,502,"21 de agosto de 1994"
30,23,91,2112,426,436,862,"21 de agosto de 1994"
30,23,91,2113,483,538,1021,"21 de agosto de 1994"
30,23,91,2114,616,635,1251,"21 de agosto de 1994"
30,23,91,2115,453,464,917,"21 de agosto de 1994"
30,23,91,2116,475,510,985,"21 de agosto de 1994"
30,23,91,2117,435,450,885,"21 de agosto de 1994"
30,23,91,2118,387,417,804,"21 de agosto de 1994"
30,23,91,2119,132,130,262,"21 de agosto de 1994"
30,23,91,2120,640,664,1304,"21 de agosto de 1994"
30,23,91,2121,431,477,908,"21 de agosto de 1994"
30,23,91,2122,423,462,885,"21 de agosto de 1994"
30,23,91,2123,412,445,857,"21 de agosto de 1994"
30,23,91,2124,458,541,999,"21 de agosto de 1994"
30,23,91,2125,366,366,732,"21 de agosto de 1994"
30,23,91,2126,294,283,577,"21 de agosto de 1994"
30,23,91,2127,346,367,713,"21 de agosto de 1994"
30,23,91,2128,413,397,810,"21 de agosto de 1994"
30,23,91,2129,155,116,271,"21 de agosto de 1994"
30,23,91,2130,152,131,283,"21 de agosto de 1994"
30,23,91,2131,130,137,267,"21 de agosto de 1994"
30,23,91,2132,414,357,771,"21 de agosto de 1994"
30,23,91,2133,135,115,250,"21 de agosto de 1994"
30,23,91,2134,106,83,189,"21 de agosto de 1994"
30,23,91,2135,136,117,253,"21 de agosto de 1994"
30,23,91,2136,313,265,578,"21 de agosto de 1994"
30,23,91,2137,305,266,571,"21 de agosto de 1994"
30,23,93,2146,392,318,710,"21 de agosto de 1994"
30,23,93,2147,244,271,515,"21 de agosto de 1994"
30,23,93,2148,139,139,278,"21 de agosto de 1994"
30,23,93,2149,296,314,610,"21 de agosto de 1994"
30,23,93,2150,130,109,239,"21 de agosto de 1994"
30,23,93,2151,91,61,152,"21 de agosto de 1994"
30,23,93,2152,278,232,510,"21 de agosto de 1994"
30,23,93,2153,646,494,1140,"21 de agosto de 1994"
30,23,93,2154,212,179,391,"21 de agosto de 1994"
30,23,93,2155,668,619,1287,"21 de agosto de 1994"
30,23,93,2156,305,271,576,"21 de agosto de 1994"
30,23,93,2157,315,260,575,"21 de agosto de 1994"
30,23,93,2158,225,174,399,"21 de agosto de 1994"
30,23,93,2159,410,325,735,"21 de agosto de 1994"
30,23,93,2160,257,202,459,"21 de agosto de 1994"
30,23,93,2161,245,300,545,"21 de agosto de 1994"
30,23,93,2162,258,305,563,"21 de agosto de 1994"
30,23,93,2163,320,307,627,"21 de agosto de 1994"
30,23,93,2164,324,221,545,"21 de agosto de 1994"
30,23,93,2165,187,159,346,"21 de agosto de 1994"
30,23,93,2166,296,246,542,"21 de agosto de 1994"
30,23,93,2167,455,377,832,"21 de agosto de 1994"
30,23,93,2168,365,272,637,"21 de agosto de 1994"
30,23,93,2169,355,266,621,"21 de agosto de 1994"
30,23,117,2640,382,420,802,"21 de agosto de 1994"
30,23,117,2641,412,394,806,"21 de agosto de 1994"
30,23,117,2642,517,487,1004,"21 de agosto de 1994"
30,23,117,2643,307,355,662,"21 de agosto de 1994"
30,23,117,2644,379,392,771,"21 de agosto de 1994"
30,23,117,2645,416,466,882,"21 de agosto de 1994"
30,23,117,2646,400,403,803,"21 de agosto de 1994"
30,23,117,2647,100,72,172,"21 de agosto de 1994"
30,23,117,2648,347,282,629,"21 de agosto de 1994"
30,23,117,2649,71,57,128,"21 de agosto de 1994"
30,23,121,2770,53,40,93,"21 de agosto de 1994"
30,23,121,2771,521,490,1011,"21 de agosto de 1994"
30,23,121,2772,463,420,883,"21 de agosto de 1994"
30,23,121,2773,493,497,990,"21 de agosto de 1994"
30,23,121,2774,475,452,927,"21 de agosto de 1994"
30,23,121,2775,443,391,834,"21 de agosto de 1994"
30,23,123,2805,309,283,592,"21 de agosto de 1994"
30,23,123,2806,347,289,636,"21 de agosto de 1994"
30,23,123,2807,316,299,615,"21 de agosto de 1994"
30,23,123,2808,383,339,722,"21 de agosto de 1994"
30,23,123,2809,156,127,283,"21 de agosto de 1994"
30,23,123,2810,301,315,616,"21 de agosto de 1994"
30,23,123,2811,315,252,567,"21 de agosto de 1994"
30,23,123,2812,443,403,846,"21 de agosto de 1994"
30,23,123,2813,293,231,524,"21 de agosto de 1994"
30,23,143,3409,162,175,337,"21 de agosto de 1994"
30,23,143,3410,381,409,790,"21 de agosto de 1994"
30,23,143,3411,354,353,707,"21 de agosto de 1994"
30,23,143,3412,356,354,710,"21 de agosto de 1994"
30,23,143,3413,362,329,691,"21 de agosto de 1994"
30,23,143,3414,379,293,672,"21 de agosto de 1994"
30,23,143,3415,341,265,606,"21 de agosto de 1994"
30,23,143,3416,484,442,926,"21 de agosto de 1994"
30,23,143,3417,334,308,642,"21 de agosto de 1994"
30,23,143,3418,257,207,464,"21 de agosto de 1994"
30,23,143,3419,221,168,389,"21 de agosto de 1994"
30,23,143,3420,294,250,544,"21 de agosto de 1994"
30,23,143,3421,714,735,1449,"21 de agosto de 1994"
30,23,143,3422,431,459,890,"21 de agosto de 1994"
30,23,143,3423,222,196,418,"21 de agosto de 1994"
30,23,143,3424,349,308,657,"21 de agosto de 1994"
30,23,143,3425,128,107,235,"21 de agosto de 1994"
30,23,143,3426,284,287,571,"21 de agosto de 1994"
30,23,143,3427,302,256,558,"21 de agosto de 1994"
30,23,143,3428,661,620,1281,"21 de agosto de 1994"
30,23,143,3429,33,31,64,"21 de agosto de 1994"
30,23,143,3430,200,181,381,"21 de agosto de 1994"
30,23,143,3431,380,300,680,"21 de agosto de 1994"
30,23,143,3432,110,86,196,"21 de agosto de 1994"
30,23,143,3433,367,309,676,"21 de agosto de 1994"
30,23,143,3434,182,154,336,"21 de agosto de 1994"
30,23,143,3435,456,360,816,"21 de agosto de 1994"
30,23,143,3436,188,172,360,"21 de agosto de 1994"
30,23,145,3475,466,459,925,"21 de agosto de 1994"
30,23,145,3476,446,392,838,"21 de agosto de 1994"
30,23,145,3477,479,413,892,"21 de agosto de 1994"
30,23,145,3478,389,376,765,"21 de agosto de 1994"
30,23,145,3479,484,414,898,"21 de agosto de 1994"
30,23,145,3480,414,348,762,"21 de agosto de 1994"
30,23,145,3481,504,476,980,"21 de agosto de 1994"
30,23,145,3482,81,57,138,"21 de agosto de 1994"
30,23,145,3483,187,125,312,"21 de agosto de 1994"
30,23,145,3484,155,126,281,"21 de agosto de 1994"
30,23,145,3485,409,376,785,"21 de agosto de 1994"
30,23,145,3486,405,390,795,"21 de agosto de 1994"
30,23,145,3487,574,529,1103,"21 de agosto de 1994"
30,23,145,3488,382,356,738,"21 de agosto de 1994"
30,23,145,3489,402,303,705,"21 de agosto de 1994"
30,23,145,3490,486,370,856,"21 de agosto de 1994"
30,23,145,3491,570,565,1135,"21 de agosto de 1994"
30,23,145,3492,319,270,589,"21 de agosto de 1994"
30,23,145,3493,199,136,335,"21 de agosto de 1994"
30,23,146,3494,337,359,696,"21 de agosto de 1994"
30,23,146,3495,439,418,857,"21 de agosto de 1994"
30,23,146,3496,459,470,929,"21 de agosto de 1994"
30,23,146,3497,203,169,372,"21 de agosto de 1994"
30,23,146,3498,220,140,360,"21 de agosto de 1994"
30,23,146,3499,240,235,475,"21 de agosto de 1994"
30,23,146,3500,246,208,454,"21 de agosto de 1994"
30,23,146,3501,316,372,688,"21 de agosto de 1994"
30,23,171,3808,401,380,781,"21 de agosto de 1994"
30,23,171,3809,423,405,828,"21 de agosto de 1994"
30,23,171,3810,244,234,478,"21 de agosto de 1994"
30,23,171,3811,429,436,865,"21 de agosto de 1994"
30,23,171,3812,541,500,1041,"21 de agosto de 1994"
30,23,171,3813,355,300,655,"21 de agosto de 1994"
30,23,171,3814,259,245,504,"21 de agosto de 1994"
30,23,171,3815,463,387,850,"21 de agosto de 1994"
30,23,171,3816,150,135,285,"21 de agosto de 1994"
30,23,171,3817,248,213,461,"21 de agosto de 1994"
30,23,171,3818,320,291,611,"21 de agosto de 1994"
30,23,171,3819,454,404,858,"21 de agosto de 1994"
30,23,171,3820,151,121,272,"21 de agosto de 1994"
30,23,171,3821,155,125,280,"21 de agosto de 1994"
30,23,171,3822,335,292,627,"21 de agosto de 1994"
30,23,171,3823,276,208,484,"21 de agosto de 1994"
30,23,199,4557,563,554,1117,"21 de agosto de 1994"
30,23,199,4558,669,678,1347,"21 de agosto de 1994"
30,23,199,4559,283,283,566,"21 de agosto de 1994"
30,23,199,4560,267,227,494,"21 de agosto de 1994"
31,1,50,254,258,263,521,"21 de agosto de 1994"
31,1,50,255,155,156,311,"21 de agosto de 1994"
31,1,50,256,158,148,306,"21 de agosto de 1994"
31,1,50,257,453,543,996,"21 de agosto de 1994"
31,1,50,258,540,541,1081,"21 de agosto de 1994"
31,1,50,259,455,470,925,"21 de agosto de 1994"
31,1,50,260,287,302,589,"21 de agosto de 1994"
31,1,50,261,235,251,486,"21 de agosto de 1994"
31,1,50,262,55,41,96,"21 de agosto de 1994"
31,1,50,263,274,320,594,"21 de agosto de 1994"
31,1,50,264,299,364,663,"21 de agosto de 1994"
31,1,50,265,388,482,870,"21 de agosto de 1994"
31,1,50,266,213,221,434,"21 de agosto de 1994"
31,1,50,267,312,349,661,"21 de agosto de 1994"
31,1,50,268,184,233,417,"21 de agosto de 1994"
31,1,50,269,489,511,1000,"21 de agosto de 1994"
31,1,50,270,292,336,628,"21 de agosto de 1994"
31,1,50,271,345,421,766,"21 de agosto de 1994"
31,1,50,272,377,425,802,"21 de agosto de 1994"
31,1,50,273,247,298,545,"21 de agosto de 1994"
31,1,50,274,335,379,714,"21 de agosto de 1994"
31,1,50,275,146,188,334,"21 de agosto de 1994"
31,1,50,276,316,371,687,"21 de agosto de 1994"
31,1,50,277,351,393,744,"21 de agosto de 1994"
31,1,50,278,128,122,250,"21 de agosto de 1994"
31,1,50,279,455,523,978,"21 de agosto de 1994"
31,1,50,280,409,473,882,"21 de agosto de 1994"
31,1,50,281,248,284,532,"21 de agosto de 1994"
31,1,50,282,344,385,729,"21 de agosto de 1994"
31,1,50,283,291,299,590,"21 de agosto de 1994"
31,1,50,284,306,350,656,"21 de agosto de 1994"
31,1,50,285,373,407,780,"21 de agosto de 1994"
31,1,50,286,329,358,687,"21 de agosto de 1994"
31,1,50,287,361,407,768,"21 de agosto de 1994"
31,1,50,288,277,313,590,"21 de agosto de 1994"
31,1,50,289,199,199,398,"21 de agosto de 1994"
31,1,50,290,199,224,423,"21 de agosto de 1994"
31,1,50,291,285,326,611,"21 de agosto de 1994"
31,1,50,292,297,356,653,"21 de agosto de 1994"
31,1,50,293,333,406,739,"21 de agosto de 1994"
31,1,50,294,341,385,726,"21 de agosto de 1994"
31,1,50,295,503,534,1037,"21 de agosto de 1994"
31,1,50,296,371,467,838,"21 de agosto de 1994"
31,1,50,297,301,317,618,"21 de agosto de 1994"
31,1,50,298,503,564,1067,"21 de agosto de 1994"
31,1,50,299,498,580,1078,"21 de agosto de 1994"
31,1,50,300,297,382,679,"21 de agosto de 1994"
31,1,50,301,492,531,1023,"21 de agosto de 1994"
31,1,50,302,258,319,577,"21 de agosto de 1994"
31,1,50,303,895,997,1892,"21 de agosto de 1994"
31,1,50,304,260,305,565,"21 de agosto de 1994"
31,1,50,305,479,573,1052,"21 de agosto de 1994"
31,1,50,306,305,347,652,"21 de agosto de 1994"
31,1,50,307,338,381,719,"21 de agosto de 1994"
31,1,50,308,255,273,528,"21 de agosto de 1994"
31,1,50,309,350,340,690,"21 de agosto de 1994"
31,1,50,310,366,462,828,"21 de agosto de 1994"
31,1,50,311,457,515,972,"21 de agosto de 1994"
31,1,50,312,188,240,428,"21 de agosto de 1994"
31,1,50,313,256,277,533,"21 de agosto de 1994"
31,1,50,314,368,384,752,"21 de agosto de 1994"
31,1,50,315,308,337,645,"21 de agosto de 1994"
31,1,50,316,245,287,532,"21 de agosto de 1994"
31,1,50,317,304,374,678,"21 de agosto de 1994"
31,1,50,318,324,314,638,"21 de agosto de 1994"
31,1,50,319,438,526,964,"21 de agosto de 1994"
31,1,50,320,369,414,783,"21 de agosto de 1994"
31,1,50,321,583,659,1242,"21 de agosto de 1994"
31,1,50,322,450,490,940,"21 de agosto de 1994"
31,1,50,323,306,322,628,"21 de agosto de 1994"
31,1,50,324,271,285,556,"21 de agosto de 1994"
31,1,50,325,398,426,824,"21 de agosto de 1994"
31,1,50,326,326,411,737,"21 de agosto de 1994"
31,1,50,327,510,599,1109,"21 de agosto de 1994"
31,1,50,328,438,498,936,"21 de agosto de 1994"
31,1,50,329,481,545,1026,"21 de agosto de 1994"
31,1,50,330,357,416,773,"21 de agosto de 1994"
31,1,50,331,373,418,791,"21 de agosto de 1994"
31,1,50,332,379,404,783,"21 de agosto de 1994"
31,1,50,333,415,472,887,"21 de agosto de 1994"
31,1,50,334,265,300,565,"21 de agosto de 1994"
31,1,50,335,437,530,967,"21 de agosto de 1994"
31,1,50,336,362,396,758,"21 de agosto de 1994"
31,1,50,337,341,389,730,"21 de agosto de 1994"
31,1,50,338,330,393,723,"21 de agosto de 1994"
31,1,50,339,336,398,734,"21 de agosto de 1994"
31,1,50,340,283,348,631,"21 de agosto de 1994"
31,1,50,341,315,388,703,"21 de agosto de 1994"
31,1,50,342,429,503,932,"21 de agosto de 1994"
31,1,50,343,278,322,600,"21 de agosto de 1994"
31,1,50,344,285,342,627,"21 de agosto de 1994"
31,1,50,345,205,264,469,"21 de agosto de 1994"
31,1,50,346,291,330,621,"21 de agosto de 1994"
31,1,50,347,346,438,784,"21 de agosto de 1994"
31,1,50,348,291,370,661,"21 de agosto de 1994"
31,1,50,349,363,442,805,"21 de agosto de 1994"
31,1,50,350,343,421,764,"21 de agosto de 1994"
31,1,50,351,457,557,1014,"21 de agosto de 1994"
31,1,50,352,364,422,786,"21 de agosto de 1994"
31,1,50,353,341,429,770,"21 de agosto de 1994"
31,1,50,354,468,578,1046,"21 de agosto de 1994"
31,1,50,355,512,572,1084,"21 de agosto de 1994"
31,1,50,356,517,593,1110,"21 de agosto de 1994"
31,1,50,357,342,399,741,"21 de agosto de 1994"
31,1,50,358,449,505,954,"21 de agosto de 1994"
31,1,50,359,429,494,923,"21 de agosto de 1994"
31,1,50,360,311,373,684,"21 de agosto de 1994"
31,1,50,361,277,330,607,"21 de agosto de 1994"
31,1,50,362,566,624,1190,"21 de agosto de 1994"
31,1,50,363,585,659,1244,"21 de agosto de 1994"
31,1,50,364,266,300,566,"21 de agosto de 1994"
31,1,50,365,320,346,666,"21 de agosto de 1994"
31,1,50,366,347,418,765,"21 de agosto de 1994"
31,1,50,367,448,545,993,"21 de agosto de 1994"
31,1,50,368,345,397,742,"21 de agosto de 1994"
31,1,50,369,374,429,803,"21 de agosto de 1994"
31,1,50,370,283,345,628,"21 de agosto de 1994"
31,1,50,371,303,372,675,"21 de agosto de 1994"
31,1,50,372,265,320,585,"21 de agosto de 1994"
31,1,50,373,370,424,794,"21 de agosto de 1994"
31,1,50,374,184,223,407,"21 de agosto de 1994"
31,1,50,375,263,294,557,"21 de agosto de 1994"
31,1,50,376,315,414,729,"21 de agosto de 1994"
31,1,50,377,237,306,543,"21 de agosto de 1994"
31,1,50,378,393,435,828,"21 de agosto de 1994"
31,1,50,379,330,375,705,"21 de agosto de 1994"
31,1,50,380,237,265,502,"21 de agosto de 1994"
31,1,50,381,277,321,598,"21 de agosto de 1994"
31,1,50,382,480,558,1038,"21 de agosto de 1994"
31,1,50,383,379,448,827,"21 de agosto de 1994"
31,1,50,384,230,276,506,"21 de agosto de 1994"
31,1,50,385,233,268,501,"21 de agosto de 1994"
31,1,50,386,271,333,604,"21 de agosto de 1994"
31,1,50,387,271,270,541,"21 de agosto de 1994"
31,1,50,388,263,312,575,"21 de agosto de 1994"
31,1,50,389,312,393,705,"21 de agosto de 1994"
31,1,50,390,290,328,618,"21 de agosto de 1994"
31,1,50,391,536,613,1149,"21 de agosto de 1994"
31,1,50,392,324,445,769,"21 de agosto de 1994"
31,1,50,393,354,425,779,"21 de agosto de 1994"
31,1,50,394,252,320,572,"21 de agosto de 1994"
31,1,50,395,229,373,602,"21 de agosto de 1994"
31,1,50,396,342,442,784,"21 de agosto de 1994"
31,1,50,397,344,391,735,"21 de agosto de 1994"
31,1,50,398,350,423,773,"21 de agosto de 1994"
31,1,50,399,382,437,819,"21 de agosto de 1994"
31,1,50,400,341,395,736,"21 de agosto de 1994"
31,1,50,401,333,345,678,"21 de agosto de 1994"
31,1,50,402,387,423,810,"21 de agosto de 1994"
31,1,50,403,462,499,961,"21 de agosto de 1994"
31,1,50,404,425,454,879,"21 de agosto de 1994"
31,1,50,405,327,366,693,"21 de agosto de 1994"
31,1,50,406,411,473,884,"21 de agosto de 1994"
31,1,50,407,410,480,890,"21 de agosto de 1994"
31,1,50,408,369,395,764,"21 de agosto de 1994"
31,1,50,409,378,453,831,"21 de agosto de 1994"
31,1,50,410,325,374,699,"21 de agosto de 1994"
31,1,50,411,324,379,703,"21 de agosto de 1994"
31,1,50,412,354,381,735,"21 de agosto de 1994"
31,1,50,413,421,469,890,"21 de agosto de 1994"
31,1,50,414,346,406,752,"21 de agosto de 1994"
31,1,50,415,313,377,690,"21 de agosto de 1994"
31,1,50,416,392,456,848,"21 de agosto de 1994"
31,1,50,417,249,287,536,"21 de agosto de 1994"
31,1,50,418,362,369,731,"21 de agosto de 1994"
31,1,50,419,370,383,753,"21 de agosto de 1994"
31,1,50,420,462,493,955,"21 de agosto de 1994"
31,1,50,421,373,436,809,"21 de agosto de 1994"
31,1,50,422,435,517,952,"21 de agosto de 1994"
31,1,50,423,344,451,795,"21 de agosto de 1994"
31,1,50,424,257,288,545,"21 de agosto de 1994"
31,1,50,425,260,311,571,"21 de agosto de 1994"
31,1,50,426,342,414,756,"21 de agosto de 1994"
31,1,50,427,197,251,448,"21 de agosto de 1994"
31,1,50,428,343,402,745,"21 de agosto de 1994"
31,1,50,429,346,404,750,"21 de agosto de 1994"
31,1,50,430,253,319,572,"21 de agosto de 1994"
31,1,50,431,320,342,662,"21 de agosto de 1994"
31,1,50,432,342,390,732,"21 de agosto de 1994"
31,1,50,433,306,358,664,"21 de agosto de 1994"
31,1,50,434,479,561,1040,"21 de agosto de 1994"
31,1,50,435,327,346,673,"21 de agosto de 1994"
31,1,50,436,434,520,954,"21 de agosto de 1994"
31,1,50,437,372,464,836,"21 de agosto de 1994"
31,1,50,438,441,471,912,"21 de agosto de 1994"
31,1,50,439,419,482,901,"21 de agosto de 1994"
31,1,50,440,393,415,808,"21 de agosto de 1994"
31,1,50,441,329,362,691,"21 de agosto de 1994"
31,1,50,442,237,269,506,"21 de agosto de 1994"
31,1,50,443,277,341,618,"21 de agosto de 1994"
31,1,50,444,247,291,538,"21 de agosto de 1994"
31,1,50,445,297,379,676,"21 de agosto de 1994"
31,1,50,446,463,498,961,"21 de agosto de 1994"
31,1,50,447,458,506,964,"21 de agosto de 1994"
31,1,50,448,554,594,1148,"21 de agosto de 1994"
31,1,50,449,483,553,1036,"21 de agosto de 1994"
31,1,50,450,508,552,1060,"21 de agosto de 1994"
31,1,50,451,347,400,747,"21 de agosto de 1994"
31,1,50,452,485,563,1048,"21 de agosto de 1994"
31,1,50,453,320,385,705,"21 de agosto de 1994"
31,1,50,454,497,544,1041,"21 de agosto de 1994"
31,1,50,455,520,600,1120,"21 de agosto de 1994"
31,1,50,456,298,377,675,"21 de agosto de 1994"
31,1,50,457,245,290,535,"21 de agosto de 1994"
31,1,50,458,326,345,671,"21 de agosto de 1994"
31,1,50,459,205,215,420,"21 de agosto de 1994"
31,1,50,460,200,252,452,"21 de agosto de 1994"
31,1,50,461,292,361,653,"21 de agosto de 1994"
31,1,50,462,268,302,570,"21 de agosto de 1994"
31,1,50,463,241,313,554,"21 de agosto de 1994"
31,1,50,464,163,198,361,"21 de agosto de 1994"
31,1,50,465,534,542,1076,"21 de agosto de 1994"
31,1,50,466,349,460,809,"21 de agosto de 1994"
31,1,50,467,350,385,735,"21 de agosto de 1994"
31,1,50,468,490,567,1057,"21 de agosto de 1994"
31,1,50,469,300,361,661,"21 de agosto de 1994"
31,1,50,470,367,379,746,"21 de agosto de 1994"
31,1,50,471,412,504,916,"21 de agosto de 1994"
31,1,50,472,286,335,621,"21 de agosto de 1994"
31,1,50,473,410,506,916,"21 de agosto de 1994"
31,1,50,474,465,493,958,"21 de agosto de 1994"
31,1,50,475,392,470,862,"21 de agosto de 1994"
31,1,50,476,430,474,904,"21 de agosto de 1994"
31,1,50,477,429,460,889,"21 de agosto de 1994"
31,1,50,478,440,485,925,"21 de agosto de 1994"
31,1,50,479,398,453,851,"21 de agosto de 1994"
31,1,50,480,355,439,794,"21 de agosto de 1994"
31,1,50,481,312,373,685,"21 de agosto de 1994"
31,1,50,482,399,473,872,"21 de agosto de 1994"
31,1,50,483,503,637,1140,"21 de agosto de 1994"
31,1,50,484,316,377,693,"21 de agosto de 1994"
31,1,50,485,352,430,782,"21 de agosto de 1994"
31,1,50,486,472,581,1053,"21 de agosto de 1994"
31,1,50,487,537,647,1184,"21 de agosto de 1994"
31,1,50,488,483,542,1025,"21 de agosto de 1994"
31,1,50,489,284,303,587,"21 de agosto de 1994"
31,1,50,490,323,362,685,"21 de agosto de 1994"
31,1,50,491,459,491,950,"21 de agosto de 1994"
31,1,50,492,418,488,906,"21 de agosto de 1994"
31,1,50,493,346,390,736,"21 de agosto de 1994"
31,1,50,494,352,414,766,"21 de agosto de 1994"
31,1,50,495,276,321,597,"21 de agosto de 1994"
31,1,50,496,630,752,1382,"21 de agosto de 1994"
31,1,50,497,266,355,621,"21 de agosto de 1994"
31,1,50,498,362,390,752,"21 de agosto de 1994"
31,1,50,499,293,286,579,"21 de agosto de 1994"
31,1,50,500,440,492,932,"21 de agosto de 1994"
31,1,50,501,305,337,642,"21 de agosto de 1994"
31,1,50,502,370,390,760,"21 de agosto de 1994"
31,1,50,503,311,367,678,"21 de agosto de 1994"
31,1,50,504,506,580,1086,"21 de agosto de 1994"
31,1,50,505,404,442,846,"21 de agosto de 1994"
31,1,50,506,409,431,840,"21 de agosto de 1994"
31,1,50,507,322,382,704,"21 de agosto de 1994"
31,1,50,508,613,711,1324,"21 de agosto de 1994"
31,1,50,509,245,268,513,"21 de agosto de 1994"
31,1,50,510,751,853,1604,"21 de agosto de 1994"
31,1,50,511,304,309,613,"21 de agosto de 1994"
31,1,50,512,518,574,1092,"21 de agosto de 1994"
31,1,50,513,418,472,890,"21 de agosto de 1994"
31,1,50,514,262,318,580,"21 de agosto de 1994"
31,1,50,515,524,566,1090,"21 de agosto de 1994"
31,1,50,516,432,505,937,"21 de agosto de 1994"
31,1,50,517,677,754,1431,"21 de agosto de 1994"
31,1,50,518,363,429,792,"21 de agosto de 1994"
31,1,50,519,550,622,1172,"21 de agosto de 1994"
31,1,50,520,463,518,981,"21 de agosto de 1994"
31,1,50,521,299,351,650,"21 de agosto de 1994"
31,1,50,522,397,490,887,"21 de agosto de 1994"
31,1,50,523,569,608,1177,"21 de agosto de 1994"
31,1,50,524,307,374,681,"21 de agosto de 1994"
31,1,50,525,387,451,838,"21 de agosto de 1994"
31,1,50,526,459,544,1003,"21 de agosto de 1994"
31,1,50,527,634,687,1321,"21 de agosto de 1994"
31,1,50,528,412,460,872,"21 de agosto de 1994"
31,1,50,529,387,433,820,"21 de agosto de 1994"
31,1,50,530,352,367,719,"21 de agosto de 1994"
31,1,50,531,193,231,424,"21 de agosto de 1994"
31,1,50,532,420,473,893,"21 de agosto de 1994"
31,1,50,533,313,324,637,"21 de agosto de 1994"
31,1,50,534,455,519,974,"21 de agosto de 1994"
31,1,50,535,356,401,757,"21 de agosto de 1994"
31,1,50,536,335,390,725,"21 de agosto de 1994"
31,1,50,537,517,570,1087,"21 de agosto de 1994"
31,1,50,538,509,628,1137,"21 de agosto de 1994"
31,1,50,539,392,430,822,"21 de agosto de 1994"
31,1,50,540,385,425,810,"21 de agosto de 1994"
31,1,50,541,382,425,807,"21 de agosto de 1994"
31,1,50,542,361,411,772,"21 de agosto de 1994"
31,1,50,543,338,376,714,"21 de agosto de 1994"
31,1,50,544,362,443,805,"21 de agosto de 1994"
31,1,50,545,324,377,701,"21 de agosto de 1994"
31,1,50,546,455,522,977,"21 de agosto de 1994"
31,1,50,547,349,415,764,"21 de agosto de 1994"
31,1,50,548,317,324,641,"21 de agosto de 1994"
31,1,50,549,354,452,806,"21 de agosto de 1994"
31,1,50,550,220,273,493,"21 de agosto de 1994"
31,1,50,551,336,399,735,"21 de agosto de 1994"
31,1,50,552,216,250,466,"21 de agosto de 1994"
31,1,50,553,204,230,434,"21 de agosto de 1994"
31,1,50,554,349,362,711,"21 de agosto de 1994"
31,1,50,555,385,422,807,"21 de agosto de 1994"
31,1,50,556,330,406,736,"21 de agosto de 1994"
31,1,50,557,496,527,1023,"21 de agosto de 1994"
31,1,50,558,361,375,736,"21 de agosto de 1994"
31,1,50,559,399,436,835,"21 de agosto de 1994"
31,1,50,560,335,358,693,"21 de agosto de 1994"
31,1,50,561,426,468,894,"21 de agosto de 1994"
31,1,50,562,383,441,824,"21 de agosto de 1994"
31,1,50,563,358,469,827,"21 de agosto de 1994"
31,1,50,564,359,402,761,"21 de agosto de 1994"
31,1,50,565,249,294,543,"21 de agosto de 1994"
31,1,50,566,426,442,868,"21 de agosto de 1994"
31,1,50,567,350,464,814,"21 de agosto de 1994"
31,1,50,568,278,323,601,"21 de agosto de 1994"
31,1,50,569,374,465,839,"21 de agosto de 1994"
31,1,50,570,797,456,1253,"21 de agosto de 1994"
31,1,50,571,284,343,627,"21 de agosto de 1994"
31,1,50,572,256,300,556,"21 de agosto de 1994"
31,1,50,573,260,349,609,"21 de agosto de 1994"
31,1,50,574,296,326,622,"21 de agosto de 1994"
31,1,50,575,354,362,716,"21 de agosto de 1994"
31,1,50,576,359,382,741,"21 de agosto de 1994"
31,1,50,577,265,291,556,"21 de agosto de 1994"
31,1,50,578,409,507,916,"21 de agosto de 1994"
31,1,50,579,204,238,442,"21 de agosto de 1994"
31,1,50,580,306,304,610,"21 de agosto de 1994"
31,1,50,581,328,371,699,"21 de agosto de 1994"
31,1,50,587,0,1,1,"21 de agosto de 1994"
31,2,1,1,517,469,986,"21 de agosto de 1994"
31,2,1,2,55,46,101,"21 de agosto de 1994"
31,2,1,3,88,83,171,"21 de agosto de 1994"
31,2,1,4,266,214,480,"21 de agosto de 1994"
31,2,1,5,373,356,729,"21 de agosto de 1994"
31,2,1,6,132,118,250,"21 de agosto de 1994"
31,2,3,14,406,462,868,"21 de agosto de 1994"
31,2,3,15,484,455,939,"21 de agosto de 1994"
31,2,3,16,340,345,685,"21 de agosto de 1994"
31,2,3,17,326,334,660,"21 de agosto de 1994"
31,2,3,18,207,221,428,"21 de agosto de 1994"
31,2,3,19,28,22,50,"21 de agosto de 1994"
31,2,10,47,327,275,602,"21 de agosto de 1994"
31,2,10,48,93,66,159,"21 de agosto de 1994"
31,2,10,49,48,31,79,"21 de agosto de 1994"
31,2,11,50,272,241,513,"21 de agosto de 1994"
31,2,11,51,253,235,488,"21 de agosto de 1994"
31,2,11,52,299,250,549,"21 de agosto de 1994"
31,2,11,53,252,197,449,"21 de agosto de 1994"
31,2,15,67,355,332,687,"21 de agosto de 1994"
31,2,15,68,468,451,919,"21 de agosto de 1994"
31,2,15,69,194,183,377,"21 de agosto de 1994"
31,2,16,70,488,461,949,"21 de agosto de 1994"
31,2,18,75,238,218,456,"21 de agosto de 1994"
31,2,18,76,313,254,567,"21 de agosto de 1994"
31,2,18,77,240,200,440,"21 de agosto de 1994"
31,2,23,103,354,343,697,"21 de agosto de 1994"
31,2,23,104,325,345,670,"21 de agosto de 1994"
31,2,23,105,350,328,678,"21 de agosto de 1994"
31,2,24,106,371,340,711,"21 de agosto de 1994"
31,2,24,107,347,321,668,"21 de agosto de 1994"
31,2,25,108,474,460,934,"21 de agosto de 1994"
31,2,25,109,534,514,1048,"21 de agosto de 1994"
31,2,33,142,549,515,1064,"21 de agosto de 1994"
31,2,33,143,400,413,813,"21 de agosto de 1994"
31,2,33,144,391,418,809,"21 de agosto de 1994"
31,2,33,145,524,567,1091,"21 de agosto de 1994"
31,2,33,146,410,383,793,"21 de agosto de 1994"
31,2,33,147,75,63,138,"21 de agosto de 1994"
31,2,33,148,499,438,937,"21 de agosto de 1994"
31,2,33,149,641,581,1222,"21 de agosto de 1994"
31,2,33,150,361,352,713,"21 de agosto de 1994"
31,2,33,151,384,350,734,"21 de agosto de 1994"
31,2,36,162,304,297,601,"21 de agosto de 1994"
31,2,36,163,299,252,551,"21 de agosto de 1994"
31,2,36,164,375,337,712,"21 de agosto de 1994"
31,2,36,165,318,315,633,"21 de agosto de 1994"
31,2,36,166,59,46,105,"21 de agosto de 1994"
31,2,36,167,194,170,364,"21 de agosto de 1994"
31,2,37,168,454,414,868,"21 de agosto de 1994"
31,2,37,169,274,248,522,"21 de agosto de 1994"
31,2,37,170,409,401,810,"21 de agosto de 1994"
31,2,37,171,60,33,93,"21 de agosto de 1994"
31,2,38,172,244,177,421,"21 de agosto de 1994"
31,2,38,173,295,269,564,"21 de agosto de 1994"
31,2,38,174,375,362,737,"21 de agosto de 1994"
31,2,38,175,434,403,837,"21 de agosto de 1994"
31,2,38,176,449,425,874,"21 de agosto de 1994"
31,2,38,177,452,402,854,"21 de agosto de 1994"
31,2,38,178,697,633,1330,"21 de agosto de 1994"
31,2,38,179,477,419,896,"21 de agosto de 1994"
31,2,38,180,335,279,614,"21 de agosto de 1994"
31,2,38,181,382,356,738,"21 de agosto de 1994"
31,2,38,182,234,176,410,"21 de agosto de 1994"
31,2,38,183,244,206,450,"21 de agosto de 1994"
31,2,38,184,187,156,343,"21 de agosto de 1994"
31,2,38,185,58,42,100,"21 de agosto de 1994"
31,2,38,186,550,485,1035,"21 de agosto de 1994"
31,2,44,228,184,172,356,"21 de agosto de 1994"
31,2,44,229,525,488,1013,"21 de agosto de 1994"
31,2,44,230,590,570,1160,"21 de agosto de 1994"
31,2,44,231,49,38,87,"21 de agosto de 1994"
31,2,45,232,525,482,1007,"21 de agosto de 1994"
31,2,45,233,137,109,246,"21 de agosto de 1994"
31,2,46,234,299,273,572,"21 de agosto de 1994"
31,2,46,235,357,354,711,"21 de agosto de 1994"
31,2,47,236,439,446,885,"21 de agosto de 1994"
31,2,47,237,518,465,983,"21 de agosto de 1994"
31,2,47,238,198,187,385,"21 de agosto de 1994"
31,2,48,239,593,542,1135,"21 de agosto de 1994"
31,2,48,240,430,416,846,"21 de agosto de 1994"
31,2,48,241,332,323,655,"21 de agosto de 1994"
31,2,48,242,388,339,727,"21 de agosto de 1994"
31,2,48,243,518,471,989,"21 de agosto de 1994"
31,2,48,244,720,643,1363,"21 de agosto de 1994"
31,2,48,245,343,290,633,"21 de agosto de 1994"
31,2,48,246,406,365,771,"21 de agosto de 1994"
31,2,48,247,300,269,569,"21 de agosto de 1994"
31,2,48,248,146,114,260,"21 de agosto de 1994"
31,2,48,249,246,208,454,"21 de agosto de 1994"
31,2,48,250,346,297,643,"21 de agosto de 1994"
31,2,48,251,35,29,64,"21 de agosto de 1994"
31,2,49,252,187,148,335,"21 de agosto de 1994"
31,2,49,253,293,269,562,"21 de agosto de 1994"
31,2,53,680,279,289,568,"21 de agosto de 1994"
31,2,53,681,639,723,1362,"21 de agosto de 1994"
31,2,53,682,636,692,1328,"21 de agosto de 1994"
31,2,53,683,470,453,923,"21 de agosto de 1994"
31,2,53,684,682,712,1394,"21 de agosto de 1994"
31,2,53,685,77,93,170,"21 de agosto de 1994"
31,2,53,686,104,105,209,"21 de agosto de 1994"
31,2,55,690,496,430,926,"21 de agosto de 1994"
31,2,55,691,455,361,816,"21 de agosto de 1994"
31,2,55,692,298,261,559,"21 de agosto de 1994"
31,2,56,693,255,237,492,"21 de agosto de 1994"
31,2,56,694,439,455,894,"21 de agosto de 1994"
31,2,56,695,407,414,821,"21 de agosto de 1994"
31,2,56,696,365,350,715,"21 de agosto de 1994"
31,2,56,697,61,65,126,"21 de agosto de 1994"
31,2,56,698,406,414,820,"21 de agosto de 1994"
31,2,56,699,435,456,891,"21 de agosto de 1994"
31,2,56,700,519,534,1053,"21 de agosto de 1994"
31,2,56,701,389,418,807,"21 de agosto de 1994"
31,2,56,702,353,318,671,"21 de agosto de 1994"
31,2,56,703,278,287,565,"21 de agosto de 1994"
31,2,56,704,381,308,689,"21 de agosto de 1994"
31,2,56,705,241,222,463,"21 de agosto de 1994"
31,2,56,706,222,168,390,"21 de agosto de 1994"
31,2,56,707,242,189,431,"21 de agosto de 1994"
31,2,56,708,76,51,127,"21 de agosto de 1994"
31,2,58,715,385,354,739,"21 de agosto de 1994"
31,2,58,716,416,346,762,"21 de agosto de 1994"
31,2,58,717,197,168,365,"21 de agosto de 1994"
31,2,58,718,395,427,822,"21 de agosto de 1994"
31,2,58,719,441,453,894,"21 de agosto de 1994"
31,2,58,720,386,395,781,"21 de agosto de 1994"
31,2,58,721,327,341,668,"21 de agosto de 1994"
31,2,58,722,158,167,325,"21 de agosto de 1994"
31,2,58,723,419,381,800,"21 de agosto de 1994"
31,2,58,724,249,209,458,"21 de agosto de 1994"
31,2,58,725,164,90,254,"21 de agosto de 1994"
31,2,58,726,83,41,124,"21 de agosto de 1994"
31,2,58,727,76,49,125,"21 de agosto de 1994"
31,2,58,728,169,127,296,"21 de agosto de 1994"
31,2,58,729,134,102,236,"21 de agosto de 1994"
31,2,58,730,243,143,386,"21 de agosto de 1994"
31,2,58,731,30,14,44,"21 de agosto de 1994"
31,2,58,732,154,113,267,"21 de agosto de 1994"
31,2,58,733,61,38,99,"21 de agosto de 1994"
31,2,62,769,371,351,722,"21 de agosto de 1994"
31,2,62,770,484,435,919,"21 de agosto de 1994"
31,2,62,771,138,144,282,"21 de agosto de 1994"
31,2,63,772,625,575,1200,"21 de agosto de 1994"
31,2,63,773,178,164,342,"21 de agosto de 1994"
31,2,63,774,307,282,589,"21 de agosto de 1994"
31,2,64,775,434,404,838,"21 de agosto de 1994"
31,2,66,778,409,405,814,"21 de agosto de 1994"
31,2,66,779,256,234,490,"21 de agosto de 1994"
31,2,66,780,67,59,126,"21 de agosto de 1994"
31,2,73,802,551,518,1069,"21 de agosto de 1994"
31,2,75,805,488,514,1002,"21 de agosto de 1994"
31,2,75,806,555,532,1087,"21 de agosto de 1994"
31,2,76,807,697,685,1382,"21 de agosto de 1994"
31,2,76,808,336,328,664,"21 de agosto de 1994"
31,2,76,809,375,363,738,"21 de agosto de 1994"
31,2,76,810,512,454,966,"21 de agosto de 1994"
31,2,76,811,148,123,271,"21 de agosto de 1994"
31,2,76,812,279,240,519,"21 de agosto de 1994"
31,2,76,813,139,97,236,"21 de agosto de 1994"
31,2,76,814,445,409,854,"21 de agosto de 1994"
31,2,76,815,359,308,667,"21 de agosto de 1994"
31,2,76,816,72,66,138,"21 de agosto de 1994"
31,2,79,826,357,371,728,"21 de agosto de 1994"
31,2,79,827,555,551,1106,"21 de agosto de 1994"
31,2,79,828,324,303,627,"21 de agosto de 1994"
31,2,79,829,329,296,625,"21 de agosto de 1994"
31,2,79,830,414,399,813,"21 de agosto de 1994"
31,2,79,831,222,233,455,"21 de agosto de 1994"
31,2,79,832,316,314,630,"21 de agosto de 1994"
31,2,79,833,442,464,906,"21 de agosto de 1994"
31,2,79,834,380,381,761,"21 de agosto de 1994"
31,2,79,835,530,483,1013,"21 de agosto de 1994"
31,2,79,836,314,242,556,"21 de agosto de 1994"
31,2,79,837,225,201,426,"21 de agosto de 1994"
31,2,79,838,270,229,499,"21 de agosto de 1994"
31,2,79,839,260,246,506,"21 de agosto de 1994"
31,2,79,840,667,521,1188,"21 de agosto de 1994"
31,2,79,841,87,90,177,"21 de agosto de 1994"
31,2,79,842,426,352,778,"21 de agosto de 1994"
31,2,79,843,193,112,305,"21 de agosto de 1994"
31,2,79,844,346,277,623,"21 de agosto de 1994"
31,2,79,845,48,24,72,"21 de agosto de 1994"
31,2,80,846,558,521,1079,"21 de agosto de 1994"
31,2,80,847,448,425,873,"21 de agosto de 1994"
31,2,80,848,641,551,1192,"21 de agosto de 1994"
31,2,80,849,282,275,557,"21 de agosto de 1994"
31,2,80,850,17,14,31,"21 de agosto de 1994"
31,2,87,878,540,484,1024,"21 de agosto de 1994"
31,2,87,879,504,454,958,"21 de agosto de 1994"
31,2,89,882,286,291,577,"21 de agosto de 1994"
31,2,89,883,314,282,596,"21 de agosto de 1994"
31,2,89,884,510,521,1031,"21 de agosto de 1994"
31,2,89,885,530,579,1109,"21 de agosto de 1994"
31,2,89,886,286,292,578,"21 de agosto de 1994"
31,2,89,887,217,223,440,"21 de agosto de 1994"
31,2,89,888,368,369,737,"21 de agosto de 1994"
31,2,89,889,319,297,616,"21 de agosto de 1994"
31,2,89,890,249,264,513,"21 de agosto de 1994"
31,2,89,891,454,450,904,"21 de agosto de 1994"
31,2,89,892,409,397,806,"21 de agosto de 1994"
31,2,89,893,539,503,1042,"21 de agosto de 1994"
31,2,89,894,409,413,822,"21 de agosto de 1994"
31,2,89,895,289,307,596,"21 de agosto de 1994"
31,2,89,896,465,455,920,"21 de agosto de 1994"
31,2,89,897,434,360,794,"21 de agosto de 1994"
31,2,90,898,460,433,893,"21 de agosto de 1994"
31,2,90,899,406,404,810,"21 de agosto de 1994"
31,2,90,900,411,390,801,"21 de agosto de 1994"
31,2,94,922,208,228,436,"21 de agosto de 1994"
31,2,94,923,249,246,495,"21 de agosto de 1994"
31,2,94,924,121,98,219,"21 de agosto de 1994"
31,2,94,925,258,250,508,"21 de agosto de 1994"
31,2,98,977,475,460,935,"21 de agosto de 1994"
31,2,98,978,581,520,1101,"21 de agosto de 1994"
31,2,98,979,451,400,851,"21 de agosto de 1994"
31,2,98,980,432,360,792,"21 de agosto de 1994"
31,2,98,981,104,93,197,"21 de agosto de 1994"
31,2,98,982,288,233,521,"21 de agosto de 1994"
31,2,98,983,143,81,224,"21 de agosto de 1994"
31,2,98,984,164,94,258,"21 de agosto de 1994"
31,2,100,988,519,438,957,"21 de agosto de 1994"
31,2,100,989,224,182,406,"21 de agosto de 1994"
31,2,101,627,0,1,1,"21 de agosto de 1994"
31,2,101,990,652,627,1279,"21 de agosto de 1994"
31,2,101,991,590,616,1206,"21 de agosto de 1994"
31,2,101,992,247,300,547,"21 de agosto de 1994"
31,2,101,993,311,348,659,"21 de agosto de 1994"
31,2,101,994,343,372,715,"21 de agosto de 1994"
31,2,101,995,555,533,1088,"21 de agosto de 1994"
31,2,101,996,719,718,1437,"21 de agosto de 1994"
31,2,101,997,426,405,831,"21 de agosto de 1994"
31,2,101,998,758,785,1543,"21 de agosto de 1994"
31,2,101,999,393,409,802,"21 de agosto de 1994"
31,2,101,1000,697,698,1395,"21 de agosto de 1994"
31,2,101,1001,232,198,430,"21 de agosto de 1994"
31,2,101,1002,219,238,457,"21 de agosto de 1994"
31,2,101,1003,264,332,596,"21 de agosto de 1994"
31,2,101,1004,423,473,896,"21 de agosto de 1994"
31,2,101,1005,376,333,709,"21 de agosto de 1994"
31,2,101,1006,610,520,1130,"21 de agosto de 1994"
31,2,101,1007,126,110,236,"21 de agosto de 1994"
31,2,101,1008,239,228,467,"21 de agosto de 1994"
31,2,101,1009,305,266,571,"21 de agosto de 1994"
31,3,6,27,582,554,1136,"21 de agosto de 1994"
31,3,6,28,535,507,1042,"21 de agosto de 1994"
31,3,6,29,375,416,791,"21 de agosto de 1994"
31,3,6,30,324,286,610,"21 de agosto de 1994"
31,3,6,31,145,136,281,"21 de agosto de 1994"
31,3,6,32,102,76,178,"21 de agosto de 1994"
31,3,8,37,399,353,752,"21 de agosto de 1994"
31,3,8,38,346,286,632,"21 de agosto de 1994"
31,3,8,39,116,100,216,"21 de agosto de 1994"
31,3,8,40,192,177,369,"21 de agosto de 1994"
31,3,12,54,125,159,284,"21 de agosto de 1994"
31,3,12,55,252,294,546,"21 de agosto de 1994"
31,3,12,56,230,301,531,"21 de agosto de 1994"
31,3,12,57,195,224,419,"21 de agosto de 1994"
31,3,12,58,97,84,181,"21 de agosto de 1994"
31,3,14,65,252,242,494,"21 de agosto de 1994"
31,3,14,66,76,67,143,"21 de agosto de 1994"
31,3,17,71,442,412,854,"21 de agosto de 1994"
31,3,17,72,198,176,374,"21 de agosto de 1994"
31,3,17,73,203,195,398,"21 de agosto de 1994"
31,3,17,74,191,174,365,"21 de agosto de 1994"
31,3,19,78,736,703,1439,"21 de agosto de 1994"
31,3,19,79,401,366,767,"21 de agosto de 1994"
31,3,19,80,417,374,791,"21 de agosto de 1994"
31,3,19,81,582,554,1136,"21 de agosto de 1994"
31,3,19,82,372,308,680,"21 de agosto de 1994"
31,3,19,83,473,401,874,"21 de agosto de 1994"
31,3,19,84,358,331,689,"21 de agosto de 1994"
31,3,19,85,156,126,282,"21 de agosto de 1994"
31,3,19,86,540,462,1002,"21 de agosto de 1994"
31,3,19,87,119,99,218,"21 de agosto de 1994"
31,3,19,88,354,311,665,"21 de agosto de 1994"
31,3,19,89,421,372,793,"21 de agosto de 1994"
31,3,19,90,201,150,351,"21 de agosto de 1994"
31,3,21,93,302,323,625,"21 de agosto de 1994"
31,3,21,94,299,318,617,"21 de agosto de 1994"
31,3,21,95,265,297,562,"21 de agosto de 1994"
31,3,21,96,165,145,310,"21 de agosto de 1994"
31,3,21,97,89,81,170,"21 de agosto de 1994"
31,3,21,98,119,125,244,"21 de agosto de 1994"
31,3,22,99,447,465,912,"21 de agosto de 1994"
31,3,22,100,29,31,60,"21 de agosto de 1994"
31,3,22,101,106,88,194,"21 de agosto de 1994"
31,3,22,102,202,170,372,"21 de agosto de 1994"
31,3,27,114,494,438,932,"21 de agosto de 1994"
31,3,27,115,603,609,1212,"21 de agosto de 1994"
31,3,27,116,270,258,528,"21 de agosto de 1994"
31,3,27,117,606,534,1140,"21 de agosto de 1994"
31,3,27,118,358,341,699,"21 de agosto de 1994"
31,3,27,119,24,13,37,"21 de agosto de 1994"
31,3,28,120,322,289,611,"21 de agosto de 1994"
31,3,28,121,344,303,647,"21 de agosto de 1994"
31,3,29,122,275,265,540,"21 de agosto de 1994"
31,3,29,123,358,350,708,"21 de agosto de 1994"
31,3,29,124,301,268,569,"21 de agosto de 1994"
31,3,29,125,323,318,641,"21 de agosto de 1994"
31,3,29,126,314,308,622,"21 de agosto de 1994"
31,3,30,127,214,210,424,"21 de agosto de 1994"
31,3,30,128,187,183,370,"21 de agosto de 1994"
31,3,30,129,310,322,632,"21 de agosto de 1994"
31,3,30,130,186,159,345,"21 de agosto de 1994"
31,3,31,131,258,254,512,"21 de agosto de 1994"
31,3,31,132,453,438,891,"21 de agosto de 1994"
31,3,31,133,148,127,275,"21 de agosto de 1994"
31,3,32,134,487,421,908,"21 de agosto de 1994"
31,3,32,135,337,258,595,"21 de agosto de 1994"
31,3,32,136,333,287,620,"21 de agosto de 1994"
31,3,32,137,433,391,824,"21 de agosto de 1994"
31,3,32,138,527,459,986,"21 de agosto de 1994"
31,3,32,139,182,146,328,"21 de agosto de 1994"
31,3,32,140,116,102,218,"21 de agosto de 1994"
31,3,32,141,346,324,670,"21 de agosto de 1994"
31,3,40,189,497,476,973,"21 de agosto de 1994"
31,3,40,190,310,359,669,"21 de agosto de 1994"
31,3,40,191,268,259,527,"21 de agosto de 1994"
31,3,40,192,525,559,1084,"21 de agosto de 1994"
31,3,40,193,465,459,924,"21 de agosto de 1994"
31,3,40,194,396,376,772,"21 de agosto de 1994"
31,3,40,195,453,445,898,"21 de agosto de 1994"
31,3,40,196,379,420,799,"21 de agosto de 1994"
31,3,40,197,442,436,878,"21 de agosto de 1994"
31,3,40,198,500,549,1049,"21 de agosto de 1994"
31,3,40,199,564,543,1107,"21 de agosto de 1994"
31,3,40,200,408,425,833,"21 de agosto de 1994"
31,3,40,201,456,490,946,"21 de agosto de 1994"
31,3,40,202,101,103,204,"21 de agosto de 1994"
31,3,40,203,327,287,614,"21 de agosto de 1994"
31,3,42,224,379,359,738,"21 de agosto de 1994"
31,3,42,225,378,343,721,"21 de agosto de 1994"
31,3,42,226,444,412,856,"21 de agosto de 1994"
31,3,43,227,462,427,889,"21 de agosto de 1994"
31,3,57,709,400,406,806,"21 de agosto de 1994"
31,3,57,710,371,341,712,"21 de agosto de 1994"
31,3,57,711,338,391,729,"21 de agosto de 1994"
31,3,57,712,401,399,800,"21 de agosto de 1994"
31,3,57,713,124,92,216,"21 de agosto de 1994"
31,3,57,714,298,253,551,"21 de agosto de 1994"
31,3,60,765,286,275,561,"21 de agosto de 1994"
31,3,61,766,375,323,698,"21 de agosto de 1994"
31,3,61,767,141,121,262,"21 de agosto de 1994"
31,3,61,768,189,154,343,"21 de agosto de 1994"
31,3,65,776,276,245,521,"21 de agosto de 1994"
31,3,65,777,112,98,210,"21 de agosto de 1994"
31,3,69,789,338,330,668,"21 de agosto de 1994"
31,3,69,790,200,176,376,"21 de agosto de 1994"
31,3,69,791,204,206,410,"21 de agosto de 1994"
31,3,69,792,355,325,680,"21 de agosto de 1994"
31,3,69,793,324,291,615,"21 de agosto de 1994"
31,3,69,794,121,106,227,"21 de agosto de 1994"
31,3,69,795,174,153,327,"21 de agosto de 1994"
31,3,70,796,428,428,856,"21 de agosto de 1994"
31,3,70,797,536,492,1028,"21 de agosto de 1994"
31,3,71,798,328,289,617,"21 de agosto de 1994"
31,3,71,799,96,74,170,"21 de agosto de 1994"
31,3,77,817,427,395,822,"21 de agosto de 1994"
31,3,77,818,203,195,398,"21 de agosto de 1994"
31,3,81,851,256,265,521,"21 de agosto de 1994"
31,3,81,852,241,260,501,"21 de agosto de 1994"
31,3,81,853,62,65,127,"21 de agosto de 1994"
31,3,81,854,49,41,90,"21 de agosto de 1994"
31,3,84,861,586,549,1135,"21 de agosto de 1994"
31,3,84,862,371,364,735,"21 de agosto de 1994"
31,3,84,863,377,374,751,"21 de agosto de 1994"
31,3,84,864,425,417,842,"21 de agosto de 1994"
31,3,84,865,52,46,98,"21 de agosto de 1994"
31,3,84,866,115,98,213,"21 de agosto de 1994"
31,3,85,867,432,386,818,"21 de agosto de 1994"
31,3,85,868,301,317,618,"21 de agosto de 1994"
31,3,85,869,472,416,888,"21 de agosto de 1994"
31,3,85,870,462,363,825,"21 de agosto de 1994"
31,3,85,871,64,54,118,"21 de agosto de 1994"
31,3,85,872,94,71,165,"21 de agosto de 1994"
31,3,85,873,203,147,350,"21 de agosto de 1994"
31,3,85,874,536,472,1008,"21 de agosto de 1994"
31,3,86,875,211,189,400,"21 de agosto de 1994"
31,3,86,876,398,395,793,"21 de agosto de 1994"
31,3,86,877,36,36,72,"21 de agosto de 1994"
31,3,91,901,286,287,573,"21 de agosto de 1994"
31,3,91,902,253,267,520,"21 de agosto de 1994"
31,3,91,903,409,360,769,"21 de agosto de 1994"
31,3,91,904,406,320,726,"21 de agosto de 1994"
31,3,91,905,287,222,509,"21 de agosto de 1994"
31,3,91,906,106,86,192,"21 de agosto de 1994"
31,3,91,907,263,225,488,"21 de agosto de 1994"
31,3,92,908,323,320,643,"21 de agosto de 1994"
31,3,92,909,255,258,513,"21 de agosto de 1994"
31,3,92,910,167,132,299,"21 de agosto de 1994"
31,3,92,911,364,344,708,"21 de agosto de 1994"
31,3,96,932,158,139,297,"21 de agosto de 1994"
31,3,96,933,215,189,404,"21 de agosto de 1994"
31,3,96,934,286,287,573,"21 de agosto de 1994"
31,3,96,935,242,237,479,"21 de agosto de 1994"
31,3,96,936,213,173,386,"21 de agosto de 1994"
31,3,96,937,309,299,608,"21 de agosto de 1994"
31,3,96,938,449,472,921,"21 de agosto de 1994"
31,3,96,939,370,356,726,"21 de agosto de 1994"
31,3,96,940,173,188,361,"21 de agosto de 1994"
31,3,96,941,212,237,449,"21 de agosto de 1994"
31,3,96,942,415,421,836,"21 de agosto de 1994"
31,3,96,943,315,287,602,"21 de agosto de 1994"
31,3,96,944,385,401,786,"21 de agosto de 1994"
31,3,96,945,467,486,953,"21 de agosto de 1994"
31,3,96,946,251,231,482,"21 de agosto de 1994"
31,3,96,947,204,200,404,"21 de agosto de 1994"
31,3,96,948,305,293,598,"21 de agosto de 1994"
31,3,96,949,422,400,822,"21 de agosto de 1994"
31,3,96,950,435,467,902,"21 de agosto de 1994"
31,3,96,951,365,364,729,"21 de agosto de 1994"
31,3,96,952,348,323,671,"21 de agosto de 1994"
31,3,96,953,246,228,474,"21 de agosto de 1994"
31,3,96,954,400,408,808,"21 de agosto de 1994"
31,3,96,955,307,326,633,"21 de agosto de 1994"
31,3,96,956,264,211,475,"21 de agosto de 1994"
31,3,96,957,155,158,313,"21 de agosto de 1994"
31,3,96,958,240,175,415,"21 de agosto de 1994"
31,3,96,959,473,292,765,"21 de agosto de 1994"
31,3,96,960,265,220,485,"21 de agosto de 1994"
31,3,96,961,191,123,314,"21 de agosto de 1994"
31,3,96,962,108,34,142,"21 de agosto de 1994"
31,3,96,963,99,72,171,"21 de agosto de 1994"
31,3,96,964,299,236,535,"21 de agosto de 1994"
31,3,96,965,175,139,314,"21 de agosto de 1994"
31,3,96,966,466,331,797,"21 de agosto de 1994"
31,3,96,967,160,137,297,"21 de agosto de 1994"
31,3,96,968,412,244,656,"21 de agosto de 1994"
31,3,96,969,298,206,504,"21 de agosto de 1994"
31,3,96,970,562,468,1030,"21 de agosto de 1994"
31,3,96,971,416,306,722,"21 de agosto de 1994"
31,3,96,972,760,590,1350,"21 de agosto de 1994"
31,3,97,973,259,251,510,"21 de agosto de 1994"
31,3,97,974,340,328,668,"21 de agosto de 1994"
31,3,97,975,284,307,591,"21 de agosto de 1994"
31,3,97,976,48,55,103,"21 de agosto de 1994"
31,3,99,985,303,305,608,"21 de agosto de 1994"
31,3,99,986,287,262,549,"21 de agosto de 1994"
31,3,99,987,99,81,180,"21 de agosto de 1994"
31,3,102,1010,261,232,493,"21 de agosto de 1994"
31,3,102,1011,225,266,491,"21 de agosto de 1994"
31,3,102,1012,280,286,566,"21 de agosto de 1994"
31,3,102,1013,326,321,647,"21 de agosto de 1994"
31,3,102,1014,241,245,486,"21 de agosto de 1994"
31,3,102,1015,207,208,415,"21 de agosto de 1994"
31,3,102,1016,237,324,561,"21 de agosto de 1994"
31,3,102,1017,347,364,711,"21 de agosto de 1994"
31,3,102,1018,415,438,853,"21 de agosto de 1994"
31,3,102,1019,350,369,719,"21 de agosto de 1994"
31,3,102,1020,244,246,490,"21 de agosto de 1994"
31,3,102,1021,408,441,849,"21 de agosto de 1994"
31,3,102,1022,317,357,674,"21 de agosto de 1994"
31,3,102,1023,394,427,821,"21 de agosto de 1994"
31,3,102,1024,351,363,714,"21 de agosto de 1994"
31,3,102,1025,342,350,692,"21 de agosto de 1994"
31,3,102,1026,727,227,954,"21 de agosto de 1994"
31,3,102,1027,261,308,569,"21 de agosto de 1994"
31,3,102,1028,309,297,606,"21 de agosto de 1994"
31,3,102,1029,340,360,700,"21 de agosto de 1994"
31,3,102,1030,263,268,531,"21 de agosto de 1994"
31,3,102,1031,231,219,450,"21 de agosto de 1994"
31,3,102,1032,490,408,898,"21 de agosto de 1994"
31,3,102,1033,591,445,1036,"21 de agosto de 1994"
31,3,102,1034,391,317,708,"21 de agosto de 1994"
31,3,102,1035,197,200,397,"21 de agosto de 1994"
31,3,102,1036,346,274,620,"21 de agosto de 1994"
31,3,102,1037,146,142,288,"21 de agosto de 1994"
31,3,102,1038,210,215,425,"21 de agosto de 1994"
31,3,102,1039,239,212,451,"21 de agosto de 1994"
31,3,102,1040,522,453,975,"21 de agosto de 1994"
31,3,102,1041,409,414,823,"21 de agosto de 1994"
31,3,102,1042,206,178,384,"21 de agosto de 1994"
31,3,104,1045,272,247,519,"21 de agosto de 1994"
31,3,104,1046,316,295,611,"21 de agosto de 1994"
31,3,104,1047,387,334,721,"21 de agosto de 1994"
31,3,104,1048,221,175,396,"21 de agosto de 1994"
31,3,104,1049,143,144,287,"21 de agosto de 1994"
31,3,104,1050,71,62,133,"21 de agosto de 1994"
31,3,104,1051,196,191,387,"21 de agosto de 1994"
31,3,104,1052,281,236,517,"21 de agosto de 1994"
31,3,104,1053,404,290,694,"21 de agosto de 1994"
31,3,104,1054,76,70,146,"21 de agosto de 1994"
31,3,104,1055,412,311,723,"21 de agosto de 1994"
31,4,2,7,502,445,947,"21 de agosto de 1994"
31,4,2,8,595,517,1112,"21 de agosto de 1994"
31,4,2,9,693,663,1356,"21 de agosto de 1994"
31,4,2,10,685,658,1343,"21 de agosto de 1994"
31,4,2,11,193,174,367,"21 de agosto de 1994"
31,4,2,12,344,365,709,"21 de agosto de 1994"
31,4,2,13,172,174,346,"21 de agosto de 1994"
31,4,4,20,462,455,917,"21 de agosto de 1994"
31,4,4,21,307,309,616,"21 de agosto de 1994"
31,4,4,22,299,318,617,"21 de agosto de 1994"
31,4,4,23,239,241,480,"21 de agosto de 1994"
31,4,4,24,204,178,382,"21 de agosto de 1994"
31,4,5,25,299,316,615,"21 de agosto de 1994"
31,4,5,26,268,238,506,"21 de agosto de 1994"
31,4,7,33,342,318,660,"21 de agosto de 1994"
31,4,7,34,494,462,956,"21 de agosto de 1994"
31,4,7,35,461,443,904,"21 de agosto de 1994"
31,4,7,36,397,397,794,"21 de agosto de 1994"
31,4,9,41,234,233,467,"21 de agosto de 1994"
31,4,9,42,342,347,689,"21 de agosto de 1994"
31,4,9,43,306,335,641,"21 de agosto de 1994"
31,4,9,44,333,314,647,"21 de agosto de 1994"
31,4,9,45,85,68,153,"21 de agosto de 1994"
31,4,9,46,45,34,79,"21 de agosto de 1994"
31,4,13,59,473,450,923,"21 de agosto de 1994"
31,4,13,60,235,231,466,"21 de agosto de 1994"
31,4,13,61,441,435,876,"21 de agosto de 1994"
31,4,13,62,428,459,887,"21 de agosto de 1994"
31,4,13,63,47,50,97,"21 de agosto de 1994"
31,4,13,64,322,288,610,"21 de agosto de 1994"
31,4,20,91,512,508,1020,"21 de agosto de 1994"
31,4,20,92,369,345,714,"21 de agosto de 1994"
31,4,26,110,275,285,560,"21 de agosto de 1994"
31,4,26,111,384,393,777,"21 de agosto de 1994"
31,4,26,112,385,360,745,"21 de agosto de 1994"
31,4,26,113,38,25,63,"21 de agosto de 1994"
31,4,34,152,181,203,384,"21 de agosto de 1994"
31,4,34,153,252,238,490,"21 de agosto de 1994"
31,4,34,154,284,286,570,"21 de agosto de 1994"
31,4,34,155,353,329,682,"21 de agosto de 1994"
31,4,34,156,363,352,715,"21 de agosto de 1994"
31,4,35,157,283,319,602,"21 de agosto de 1994"
31,4,35,158,206,209,415,"21 de agosto de 1994"
31,4,35,159,411,411,822,"21 de agosto de 1994"
31,4,35,160,391,442,833,"21 de agosto de 1994"
31,4,35,161,146,144,290,"21 de agosto de 1994"
31,4,39,187,334,340,674,"21 de agosto de 1994"
31,4,39,188,403,376,779,"21 de agosto de 1994"
31,4,41,204,181,231,412,"21 de agosto de 1994"
31,4,41,205,488,499,987,"21 de agosto de 1994"
31,4,41,206,631,594,1225,"21 de agosto de 1994"
31,4,41,207,546,502,1048,"21 de agosto de 1994"
31,4,41,208,541,522,1063,"21 de agosto de 1994"
31,4,41,209,306,327,633,"21 de agosto de 1994"
31,4,41,210,270,321,591,"21 de agosto de 1994"
31,4,41,211,237,275,512,"21 de agosto de 1994"
31,4,41,212,348,380,728,"21 de agosto de 1994"
31,4,41,213,310,341,651,"21 de agosto de 1994"
31,4,41,214,421,503,924,"21 de agosto de 1994"
31,4,41,215,190,226,416,"21 de agosto de 1994"
31,4,41,216,136,188,324,"21 de agosto de 1994"
31,4,41,217,492,527,1019,"21 de agosto de 1994"
31,4,41,218,286,330,616,"21 de agosto de 1994"
31,4,41,219,262,273,535,"21 de agosto de 1994"
31,4,41,220,173,152,325,"21 de agosto de 1994"
31,4,41,221,99,92,191,"21 de agosto de 1994"
31,4,41,222,159,175,334,"21 de agosto de 1994"
31,4,41,223,129,156,285,"21 de agosto de 1994"
31,4,50,382,0,0,0,"21 de agosto de 1994"
31,4,50,582,344,402,746,"21 de agosto de 1994"
31,4,50,583,330,364,694,"21 de agosto de 1994"
31,4,50,584,233,274,507,"21 de agosto de 1994"
31,4,50,585,250,274,524,"21 de agosto de 1994"
31,4,50,586,253,292,545,"21 de agosto de 1994"
31,4,50,587,328,394,722,"21 de agosto de 1994"
31,4,50,588,406,480,886,"21 de agosto de 1994"
31,4,50,589,429,508,937,"21 de agosto de 1994"
31,4,50,590,469,524,993,"21 de agosto de 1994"
31,4,50,591,294,341,635,"21 de agosto de 1994"
31,4,50,592,304,355,659,"21 de agosto de 1994"
31,4,50,593,366,426,792,"21 de agosto de 1994"
31,4,50,594,671,776,1447,"21 de agosto de 1994"
31,4,50,595,278,302,580,"21 de agosto de 1994"
31,4,50,596,456,497,953,"21 de agosto de 1994"
31,4,50,597,356,403,759,"21 de agosto de 1994"
31,4,50,598,421,492,913,"21 de agosto de 1994"
31,4,50,599,337,359,696,"21 de agosto de 1994"
31,4,50,600,434,508,942,"21 de agosto de 1994"
31,4,50,601,392,440,832,"21 de agosto de 1994"
31,4,50,602,325,364,689,"21 de agosto de 1994"
31,4,50,603,571,661,1232,"21 de agosto de 1994"
31,4,50,604,645,740,1385,"21 de agosto de 1994"
31,4,50,605,566,641,1207,"21 de agosto de 1994"
31,4,50,606,518,580,1098,"21 de agosto de 1994"
31,4,50,607,475,556,1031,"21 de agosto de 1994"
31,4,50,608,425,446,871,"21 de agosto de 1994"
31,4,50,609,461,537,998,"21 de agosto de 1994"
31,4,50,610,418,465,883,"21 de agosto de 1994"
31,4,50,611,439,350,789,"21 de agosto de 1994"
31,4,50,612,340,412,752,"21 de agosto de 1994"
31,4,50,613,395,449,844,"21 de agosto de 1994"
31,4,50,614,497,587,1084,"21 de agosto de 1994"
31,4,50,615,422,506,928,"21 de agosto de 1994"
31,4,50,616,458,510,968,"21 de agosto de 1994"
31,4,50,617,275,288,563,"21 de agosto de 1994"
31,4,50,618,408,475,883,"21 de agosto de 1994"
31,4,50,619,489,567,1056,"21 de agosto de 1994"
31,4,50,620,548,555,1103,"21 de agosto de 1994"
31,4,50,621,456,518,974,"21 de agosto de 1994"
31,4,50,622,285,300,585,"21 de agosto de 1994"
31,4,50,623,339,342,681,"21 de agosto de 1994"
31,4,50,624,437,458,895,"21 de agosto de 1994"
31,4,50,625,601,623,1224,"21 de agosto de 1994"
31,4,50,626,448,496,944,"21 de agosto de 1994"
31,4,50,627,817,902,1719,"21 de agosto de 1994"
31,4,50,628,290,311,601,"21 de agosto de 1994"
31,4,50,629,130,83,213,"21 de agosto de 1994"
31,4,50,630,126,128,254,"21 de agosto de 1994"
31,4,50,631,275,267,542,"21 de agosto de 1994"
31,4,50,632,274,264,538,"21 de agosto de 1994"
31,4,50,633,279,227,506,"21 de agosto de 1994"
31,4,50,634,401,370,771,"21 de agosto de 1994"
31,4,50,635,445,411,856,"21 de agosto de 1994"
31,4,50,636,152,131,283,"21 de agosto de 1994"
31,4,50,637,622,568,1190,"21 de agosto de 1994"
31,4,50,638,292,280,572,"21 de agosto de 1994"
31,4,50,639,274,270,544,"21 de agosto de 1994"
31,4,50,640,212,209,421,"21 de agosto de 1994"
31,4,50,641,476,459,935,"21 de agosto de 1994"
31,4,50,642,717,636,1353,"21 de agosto de 1994"
31,4,50,643,406,377,783,"21 de agosto de 1994"
31,4,50,644,656,633,1289,"21 de agosto de 1994"
31,4,50,645,607,612,1219,"21 de agosto de 1994"
31,4,50,646,332,298,630,"21 de agosto de 1994"
31,4,50,647,138,112,250,"21 de agosto de 1994"
31,4,50,648,150,144,294,"21 de agosto de 1994"
31,4,50,649,247,276,523,"21 de agosto de 1994"
31,4,50,650,500,464,964,"21 de agosto de 1994"
31,4,50,651,117,110,227,"21 de agosto de 1994"
31,4,50,652,414,420,834,"21 de agosto de 1994"
31,4,50,653,637,597,1234,"21 de agosto de 1994"
31,4,50,654,455,443,898,"21 de agosto de 1994"
31,4,50,655,233,226,459,"21 de agosto de 1994"
31,4,50,656,192,170,362,"21 de agosto de 1994"
31,4,51,657,220,215,435,"21 de agosto de 1994"
31,4,51,658,302,302,604,"21 de agosto de 1994"
31,4,51,659,141,115,256,"21 de agosto de 1994"
31,4,51,660,164,149,313,"21 de agosto de 1994"
31,4,52,661,593,612,1205,"21 de agosto de 1994"
31,4,52,662,535,542,1077,"21 de agosto de 1994"
31,4,52,663,483,555,1038,"21 de agosto de 1994"
31,4,52,664,328,365,693,"21 de agosto de 1994"
31,4,52,665,470,476,946,"21 de agosto de 1994"
31,4,52,666,429,472,901,"21 de agosto de 1994"
31,4,52,667,568,602,1170,"21 de agosto de 1994"
31,4,52,668,661,668,1329,"21 de agosto de 1994"
31,4,52,669,382,405,787,"21 de agosto de 1994"
31,4,52,670,237,233,470,"21 de agosto de 1994"
31,4,52,671,204,201,405,"21 de agosto de 1994"
31,4,52,672,264,230,494,"21 de agosto de 1994"
31,4,52,673,48,56,104,"21 de agosto de 1994"
31,4,52,674,417,445,862,"21 de agosto de 1994"
31,4,52,675,81,69,150,"21 de agosto de 1994"
31,4,52,676,505,545,1050,"21 de agosto de 1994"
31,4,52,677,478,460,938,"21 de agosto de 1994"
31,4,52,678,163,151,314,"21 de agosto de 1994"
31,4,52,679,259,255,514,"21 de agosto de 1994"
31,4,54,687,223,203,426,"21 de agosto de 1994"
31,4,54,688,416,412,828,"21 de agosto de 1994"
31,4,54,689,75,85,160,"21 de agosto de 1994"
31,4,59,734,356,287,643,"21 de agosto de 1994"
31,4,59,735,45,42,87,"21 de agosto de 1994"
31,4,59,736,44,34,78,"21 de agosto de 1994"
31,4,59,737,573,574,1147,"21 de agosto de 1994"
31,4,59,738,444,42,486,"21 de agosto de 1994"
31,4,59,739,188,213,401,"21 de agosto de 1994"
31,4,59,740,401,478,879,"21 de agosto de 1994"
31,4,59,741,606,675,1281,"21 de agosto de 1994"
31,4,59,742,560,596,1156,"21 de agosto de 1994"
31,4,59,743,383,348,731,"21 de agosto de 1994"
31,4,59,744,323,358,681,"21 de agosto de 1994"
31,4,59,745,345,411,756,"21 de agosto de 1994"
31,4,59,746,534,562,1096,"21 de agosto de 1994"
31,4,59,747,190,217,407,"21 de agosto de 1994"
31,4,59,748,313,384,697,"21 de agosto de 1994"
31,4,59,749,287,314,601,"21 de agosto de 1994"
31,4,59,750,340,359,699,"21 de agosto de 1994"
31,4,59,751,20,18,38,"21 de agosto de 1994"
31,4,59,752,22,17,39,"21 de agosto de 1994"
31,4,59,753,619,711,1330,"21 de agosto de 1994"
31,4,59,754,592,667,1259,"21 de agosto de 1994"
31,4,59,755,454,519,973,"21 de agosto de 1994"
31,4,59,756,344,370,714,"21 de agosto de 1994"
31,4,59,757,656,717,1373,"21 de agosto de 1994"
31,4,59,758,607,659,1266,"21 de agosto de 1994"
31,4,59,759,70,113,183,"21 de agosto de 1994"
31,4,59,760,121,115,236,"21 de agosto de 1994"
31,4,59,761,202,223,425,"21 de agosto de 1994"
31,4,59,762,211,191,402,"21 de agosto de 1994"
31,4,59,763,526,570,1096,"21 de agosto de 1994"
31,4,59,764,443,463,906,"21 de agosto de 1994"
31,4,67,781,488,434,922,"21 de agosto de 1994"
31,4,67,782,278,217,495,"21 de agosto de 1994"
31,4,67,783,669,620,1289,"21 de agosto de 1994"
31,4,67,784,501,456,957,"21 de agosto de 1994"
31,4,67,785,244,225,469,"21 de agosto de 1994"
31,4,68,786,420,384,804,"21 de agosto de 1994"
31,4,68,787,397,362,759,"21 de agosto de 1994"
31,4,68,788,136,119,255,"21 de agosto de 1994"
31,4,72,800,285,266,551,"21 de agosto de 1994"
31,4,72,801,291,271,562,"21 de agosto de 1994"
31,4,74,803,510,462,972,"21 de agosto de 1994"
31,4,74,804,591,573,1164,"21 de agosto de 1994"
31,4,78,819,328,322,650,"21 de agosto de 1994"
31,4,78,820,153,157,310,"21 de agosto de 1994"
31,4,78,821,142,164,306,"21 de agosto de 1994"
31,4,78,822,341,364,705,"21 de agosto de 1994"
31,4,78,823,31,26,57,"21 de agosto de 1994"
31,4,78,824,122,100,222,"21 de agosto de 1994"
31,4,78,825,40,31,71,"21 de agosto de 1994"
31,4,82,855,330,360,690,"21 de agosto de 1994"
31,4,82,856,223,222,445,"21 de agosto de 1994"
31,4,82,857,248,237,485,"21 de agosto de 1994"
31,4,82,858,281,263,544,"21 de agosto de 1994"
31,4,83,859,259,224,483,"21 de agosto de 1994"
31,4,83,860,131,110,241,"21 de agosto de 1994"
31,4,88,880,214,230,444,"21 de agosto de 1994"
31,4,88,881,322,307,629,"21 de agosto de 1994"
31,4,93,912,342,328,670,"21 de agosto de 1994"
31,4,93,913,556,627,1183,"21 de agosto de 1994"
31,4,93,914,452,447,899,"21 de agosto de 1994"
31,4,93,915,335,333,668,"21 de agosto de 1994"
31,4,93,916,417,433,850,"21 de agosto de 1994"
31,4,93,917,419,429,848,"21 de agosto de 1994"
31,4,93,918,404,417,821,"21 de agosto de 1994"
31,4,93,919,311,308,619,"21 de agosto de 1994"
31,4,93,920,544,532,1076,"21 de agosto de 1994"
31,4,93,921,113,100,213,"21 de agosto de 1994"
31,4,95,926,312,328,640,"21 de agosto de 1994"
31,4,95,927,132,128,260,"21 de agosto de 1994"
31,4,95,928,572,575,1147,"21 de agosto de 1994"
31,4,95,929,166,145,311,"21 de agosto de 1994"
31,4,95,930,114,91,205,"21 de agosto de 1994"
31,4,95,931,93,99,192,"21 de agosto de 1994"
31,4,103,1043,323,291,614,"21 de agosto de 1994"
31,4,103,1044,426,420,846,"21 de agosto de 1994"
31,4,105,1056,694,663,1357,"21 de agosto de 1994"
31,4,106,1057,210,177,387,"21 de agosto de 1994"
31,4,106,1058,350,328,678,"21 de agosto de 1994"
31,4,106,1059,88,67,155,"21 de agosto de 1994"
32,1,20,606,171,175,346,"21 de agosto de 1994"
32,1,20,607,199,258,457,"21 de agosto de 1994"
32,1,20,608,200,218,418,"21 de agosto de 1994"
32,1,20,609,184,239,423,"21 de agosto de 1994"
32,1,20,610,219,278,497,"21 de agosto de 1994"
32,1,20,611,172,228,400,"21 de agosto de 1994"
32,1,20,612,211,250,461,"21 de agosto de 1994"
32,1,20,613,285,322,607,"21 de agosto de 1994"
32,1,20,614,238,249,487,"21 de agosto de 1994"
32,1,20,615,242,281,523,"21 de agosto de 1994"
32,1,20,616,235,270,505,"21 de agosto de 1994"
32,1,20,617,208,246,454,"21 de agosto de 1994"
32,1,20,618,223,266,489,"21 de agosto de 1994"
32,1,20,619,275,317,592,"21 de agosto de 1994"
32,1,20,620,148,167,315,"21 de agosto de 1994"
32,1,20,621,173,209,382,"21 de agosto de 1994"
32,1,20,622,185,260,445,"21 de agosto de 1994"
32,1,20,623,176,216,392,"21 de agosto de 1994"
32,1,20,624,244,299,543,"21 de agosto de 1994"
32,1,20,625,196,230,426,"21 de agosto de 1994"
32,1,20,626,206,235,441,"21 de agosto de 1994"
32,1,20,627,287,317,604,"21 de agosto de 1994"
32,1,20,628,155,174,329,"21 de agosto de 1994"
32,1,20,629,212,246,458,"21 de agosto de 1994"
32,1,20,630,247,325,572,"21 de agosto de 1994"
32,1,20,631,241,280,521,"21 de agosto de 1994"
32,1,20,632,263,326,589,"21 de agosto de 1994"
32,1,20,633,294,336,630,"21 de agosto de 1994"
32,1,20,634,182,211,393,"21 de agosto de 1994"
32,1,20,635,209,231,440,"21 de agosto de 1994"
32,1,20,636,142,190,332,"21 de agosto de 1994"
32,1,20,637,217,339,556,"21 de agosto de 1994"
32,1,20,638,322,394,716,"21 de agosto de 1994"
32,1,20,639,170,240,410,"21 de agosto de 1994"
32,1,20,640,218,272,490,"21 de agosto de 1994"
32,1,20,641,253,329,582,"21 de agosto de 1994"
32,1,20,642,225,268,493,"21 de agosto de 1994"
32,1,20,643,97,114,211,"21 de agosto de 1994"
32,1,20,644,204,257,461,"21 de agosto de 1994"
32,1,20,645,218,239,457,"21 de agosto de 1994"
32,1,20,646,202,287,489,"21 de agosto de 1994"
32,1,20,647,83,104,187,"21 de agosto de 1994"
32,1,20,648,199,236,435,"21 de agosto de 1994"
32,1,20,649,223,287,510,"21 de agosto de 1994"
32,1,20,650,80,87,167,"21 de agosto de 1994"
32,1,20,651,108,166,274,"21 de agosto de 1994"
32,1,20,652,175,220,395,"21 de agosto de 1994"
32,1,20,653,163,237,400,"21 de agosto de 1994"
32,1,20,654,145,216,361,"21 de agosto de 1994"
32,1,20,655,88,129,217,"21 de agosto de 1994"
32,1,20,656,148,189,337,"21 de agosto de 1994"
32,1,20,657,180,233,413,"21 de agosto de 1994"
32,1,20,658,41,56,97,"21 de agosto de 1994"
32,1,20,659,117,102,219,"21 de agosto de 1994"
32,1,20,660,65,58,123,"21 de agosto de 1994"
32,1,20,661,74,68,142,"21 de agosto de 1994"
32,1,20,662,63,73,136,"21 de agosto de 1994"
32,1,20,663,140,178,318,"21 de agosto de 1994"
32,1,20,664,87,104,191,"21 de agosto de 1994"
32,1,20,665,87,106,193,"21 de agosto de 1994"
32,1,20,666,82,99,181,"21 de agosto de 1994"
32,1,20,667,89,100,189,"21 de agosto de 1994"
32,1,20,668,56,59,115,"21 de agosto de 1994"
32,1,20,669,91,96,187,"21 de agosto de 1994"
32,1,20,670,146,159,305,"21 de agosto de 1994"
32,1,20,671,140,156,296,"21 de agosto de 1994"
32,1,20,672,157,196,353,"21 de agosto de 1994"
32,1,20,673,59,61,120,"21 de agosto de 1994"
32,1,20,674,59,56,115,"21 de agosto de 1994"
32,1,20,675,139,168,307,"21 de agosto de 1994"
32,1,20,676,85,118,203,"21 de agosto de 1994"
32,1,20,677,121,129,250,"21 de agosto de 1994"
32,1,20,678,59,75,134,"21 de agosto de 1994"
32,1,20,679,133,150,283,"21 de agosto de 1994"
32,1,20,680,115,143,258,"21 de agosto de 1994"
32,1,20,681,56,64,120,"21 de agosto de 1994"
32,1,20,682,215,261,476,"21 de agosto de 1994"
32,1,20,683,61,84,145,"21 de agosto de 1994"
32,1,20,684,95,104,199,"21 de agosto de 1994"
32,1,20,685,86,105,191,"21 de agosto de 1994"
32,1,20,686,108,133,241,"21 de agosto de 1994"
32,1,20,687,90,112,202,"21 de agosto de 1994"
32,1,20,688,87,116,203,"21 de agosto de 1994"
32,1,20,689,55,59,114,"21 de agosto de 1994"
32,1,20,690,75,74,149,"21 de agosto de 1994"
32,1,20,691,115,169,284,"21 de agosto de 1994"
32,1,20,692,85,113,198,"21 de agosto de 1994"
32,1,20,693,43,59,102,"21 de agosto de 1994"
32,1,20,694,142,220,362,"21 de agosto de 1994"
32,1,20,695,53,83,136,"21 de agosto de 1994"
32,1,20,696,44,86,130,"21 de agosto de 1994"
32,1,20,697,59,106,165,"21 de agosto de 1994"
32,1,20,698,120,123,243,"21 de agosto de 1994"
32,1,20,699,84,105,189,"21 de agosto de 1994"
32,1,20,700,18,31,49,"21 de agosto de 1994"
32,1,20,701,51,54,105,"21 de agosto de 1994"
32,1,20,702,23,30,53,"21 de agosto de 1994"
32,1,20,703,48,53,101,"21 de agosto de 1994"
32,1,20,704,93,126,219,"21 de agosto de 1994"
32,1,20,705,36,51,87,"21 de agosto de 1994"
32,1,20,706,30,39,69,"21 de agosto de 1994"
32,1,20,707,37,39,76,"21 de agosto de 1994"
32,1,31,914,164,214,378,"21 de agosto de 1994"
32,1,31,915,182,222,404,"21 de agosto de 1994"
32,1,31,916,129,159,288,"21 de agosto de 1994"
32,1,31,917,145,173,318,"21 de agosto de 1994"
32,1,31,918,211,305,516,"21 de agosto de 1994"
32,1,31,919,138,156,294,"21 de agosto de 1994"
32,1,31,920,15,15,30,"21 de agosto de 1994"
32,1,31,921,58,91,149,"21 de agosto de 1994"
32,1,31,922,50,51,101,"21 de agosto de 1994"
32,1,31,923,144,181,325,"21 de agosto de 1994"
32,1,31,924,53,67,120,"21 de agosto de 1994"
32,1,31,925,74,80,154,"21 de agosto de 1994"
32,1,31,926,78,101,179,"21 de agosto de 1994"
32,1,31,927,189,212,401,"21 de agosto de 1994"
32,1,31,928,118,140,258,"21 de agosto de 1994"
32,1,31,929,73,88,161,"21 de agosto de 1994"
32,1,31,930,32,28,60,"21 de agosto de 1994"
32,1,31,931,72,85,157,"21 de agosto de 1994"
32,1,31,932,45,61,106,"21 de agosto de 1994"
32,1,31,933,141,196,337,"21 de agosto de 1994"
32,1,31,934,51,41,92,"21 de agosto de 1994"
32,1,31,935,44,39,83,"21 de agosto de 1994"
32,1,31,936,51,51,102,"21 de agosto de 1994"
32,1,31,937,18,22,40,"21 de agosto de 1994"
32,1,31,938,34,46,80,"21 de agosto de 1994"
32,1,31,939,35,52,87,"21 de agosto de 1994"
32,1,31,940,74,98,172,"21 de agosto de 1994"
32,1,31,941,45,50,95,"21 de agosto de 1994"
32,1,31,942,18,18,36,"21 de agosto de 1994"
32,1,31,943,52,61,113,"21 de agosto de 1994"
32,1,31,944,31,38,69,"21 de agosto de 1994"
32,1,43,1384,116,144,260,"21 de agosto de 1994"
32,1,43,1385,128,186,314,"21 de agosto de 1994"
32,1,43,1386,23,39,62,"21 de agosto de 1994"
32,1,43,1387,79,96,175,"21 de agosto de 1994"
32,1,46,1433,116,144,260,"21 de agosto de 1994"
32,1,46,1434,181,211,392,"21 de agosto de 1994"
32,1,46,1435,135,180,315,"21 de agosto de 1994"
32,1,46,1436,88,94,182,"21 de agosto de 1994"
32,1,46,1437,55,79,134,"21 de agosto de 1994"
32,1,46,1438,51,64,115,"21 de agosto de 1994"
32,1,46,1439,120,124,244,"21 de agosto de 1994"
32,1,46,1440,58,58,116,"21 de agosto de 1994"
32,1,46,1441,20,29,49,"21 de agosto de 1994"
32,1,46,1442,186,256,442,"21 de agosto de 1994"
32,1,46,1443,98,128,226,"21 de agosto de 1994"
32,1,46,1444,112,113,225,"21 de agosto de 1994"
32,1,46,1445,45,65,110,"21 de agosto de 1994"
32,1,46,1446,42,65,107,"21 de agosto de 1994"
32,1,46,1447,91,172,263,"21 de agosto de 1994"
32,1,46,1448,62,69,131,"21 de agosto de 1994"
32,1,46,1449,30,43,73,"21 de agosto de 1994"
32,1,46,1450,103,117,220,"21 de agosto de 1994"
32,1,46,1451,31,45,76,"21 de agosto de 1994"
32,1,46,1452,196,237,433,"21 de agosto de 1994"
32,1,46,1453,33,34,67,"21 de agosto de 1994"
32,1,46,1454,77,93,170,"21 de agosto de 1994"
32,1,46,1455,179,261,440,"21 de agosto de 1994"
32,1,46,1456,40,49,89,"21 de agosto de 1994"
32,1,46,1457,40,47,87,"21 de agosto de 1994"
32,1,46,1458,39,56,95,"21 de agosto de 1994"
32,1,46,1459,28,44,72,"21 de agosto de 1994"
32,1,46,1460,65,73,138,"21 de agosto de 1994"
32,1,46,1461,43,45,88,"21 de agosto de 1994"
32,1,46,1462,47,65,112,"21 de agosto de 1994"
32,1,46,1463,50,75,125,"21 de agosto de 1994"
32,1,46,1464,28,40,68,"21 de agosto de 1994"
32,1,49,1525,108,130,238,"21 de agosto de 1994"
32,1,49,1526,182,208,390,"21 de agosto de 1994"
32,1,49,1527,262,301,563,"21 de agosto de 1994"
32,1,49,1528,189,204,393,"21 de agosto de 1994"
32,1,49,1529,151,185,336,"21 de agosto de 1994"
32,1,49,1530,167,193,360,"21 de agosto de 1994"
32,1,49,1531,248,281,529,"21 de agosto de 1994"
32,1,49,1532,147,165,312,"21 de agosto de 1994"
32,1,49,1533,268,290,558,"21 de agosto de 1994"
32,1,49,1534,328,379,707,"21 de agosto de 1994"
32,1,49,1535,207,265,472,"21 de agosto de 1994"
32,1,49,1536,216,261,477,"21 de agosto de 1994"
32,1,49,1537,90,117,207,"21 de agosto de 1994"
32,1,49,1538,219,251,470,"21 de agosto de 1994"
32,1,49,1539,179,236,415,"21 de agosto de 1994"
32,1,49,1540,104,132,236,"21 de agosto de 1994"
32,1,49,1541,151,210,361,"21 de agosto de 1994"
32,1,49,1542,84,72,156,"21 de agosto de 1994"
32,1,49,1543,182,200,382,"21 de agosto de 1994"
32,1,49,1544,84,96,180,"21 de agosto de 1994"
32,1,49,1545,153,164,317,"21 de agosto de 1994"
32,1,49,1546,89,104,193,"21 de agosto de 1994"
32,1,49,1547,72,95,167,"21 de agosto de 1994"
32,1,49,1548,77,72,149,"21 de agosto de 1994"
32,1,49,1549,113,111,224,"21 de agosto de 1994"
32,1,49,1550,109,101,210,"21 de agosto de 1994"
32,1,49,1551,164,174,338,"21 de agosto de 1994"
32,1,49,1552,112,102,214,"21 de agosto de 1994"
32,1,49,1553,63,65,128,"21 de agosto de 1994"
32,1,49,1554,59,73,132,"21 de agosto de 1994"
32,1,49,1555,98,128,226,"21 de agosto de 1994"
32,1,49,1556,48,65,113,"21 de agosto de 1994"
32,1,49,1557,124,152,276,"21 de agosto de 1994"
32,1,49,1558,107,121,228,"21 de agosto de 1994"
32,1,49,1559,212,252,464,"21 de agosto de 1994"
32,1,49,1560,159,190,349,"21 de agosto de 1994"
32,1,49,1561,184,243,427,"21 de agosto de 1994"
32,1,49,1562,195,264,459,"21 de agosto de 1994"
32,1,49,1563,204,255,459,"21 de agosto de 1994"
32,1,49,1564,150,161,311,"21 de agosto de 1994"
32,1,49,1565,32,43,75,"21 de agosto de 1994"
32,1,49,1566,54,89,143,"21 de agosto de 1994"
32,1,49,1567,103,137,240,"21 de agosto de 1994"
32,1,49,1568,85,95,180,"21 de agosto de 1994"
32,1,49,1569,164,203,367,"21 de agosto de 1994"
32,1,49,1570,76,85,161,"21 de agosto de 1994"
32,1,49,1571,107,118,225,"21 de agosto de 1994"
32,1,49,1572,59,91,150,"21 de agosto de 1994"
32,1,49,1573,124,159,283,"21 de agosto de 1994"
32,1,49,1574,32,48,80,"21 de agosto de 1994"
32,1,49,1575,84,108,192,"21 de agosto de 1994"
32,1,49,1576,76,94,170,"21 de agosto de 1994"
32,1,49,1577,175,203,378,"21 de agosto de 1994"
32,1,49,1578,194,262,456,"21 de agosto de 1994"
32,1,49,1579,72,89,161,"21 de agosto de 1994"
32,1,49,1580,141,176,317,"21 de agosto de 1994"
32,1,49,1581,33,49,82,"21 de agosto de 1994"
32,1,49,1582,54,55,109,"21 de agosto de 1994"
32,1,49,1583,47,55,102,"21 de agosto de 1994"
32,1,49,1584,160,209,369,"21 de agosto de 1994"
32,1,49,1585,108,125,233,"21 de agosto de 1994"
32,1,49,1586,216,221,437,"21 de agosto de 1994"
32,1,49,1587,54,50,104,"21 de agosto de 1994"
32,1,49,1588,162,207,369,"21 de agosto de 1994"
32,1,49,1589,101,132,233,"21 de agosto de 1994"
32,1,49,1590,119,134,253,"21 de agosto de 1994"
32,1,49,1591,106,108,214,"21 de agosto de 1994"
32,1,49,1592,45,49,94,"21 de agosto de 1994"
32,1,49,1593,74,81,155,"21 de agosto de 1994"
32,1,49,1594,52,76,128,"21 de agosto de 1994"
32,1,49,1595,29,37,66,"21 de agosto de 1994"
32,1,49,1596,86,97,183,"21 de agosto de 1994"
32,1,49,1597,113,119,232,"21 de agosto de 1994"
32,1,49,1598,79,78,157,"21 de agosto de 1994"
32,1,49,1599,35,41,76,"21 de agosto de 1994"
32,1,49,1600,117,127,244,"21 de agosto de 1994"
32,1,56,1772,305,344,649,"21 de agosto de 1994"
32,1,56,1773,378,434,812,"21 de agosto de 1994"
32,1,56,1774,322,370,692,"21 de agosto de 1994"
32,1,56,1775,380,434,814,"21 de agosto de 1994"
32,1,56,1776,215,255,470,"21 de agosto de 1994"
32,1,56,1777,276,319,595,"21 de agosto de 1994"
32,1,56,1778,327,398,725,"21 de agosto de 1994"
32,1,56,1779,334,441,775,"21 de agosto de 1994"
32,1,56,1780,301,341,642,"21 de agosto de 1994"
32,1,56,1781,242,319,561,"21 de agosto de 1994"
32,1,56,1782,255,319,574,"21 de agosto de 1994"
32,1,56,1783,342,390,732,"21 de agosto de 1994"
32,1,56,1784,241,287,528,"21 de agosto de 1994"
32,1,56,1785,310,346,656,"21 de agosto de 1994"
32,1,56,1786,219,275,494,"21 de agosto de 1994"
32,1,56,1787,194,282,476,"21 de agosto de 1994"
32,1,56,1788,251,301,552,"21 de agosto de 1994"
32,1,56,1789,349,392,741,"21 de agosto de 1994"
32,1,56,1790,299,303,602,"21 de agosto de 1994"
32,1,56,1791,307,358,665,"21 de agosto de 1994"
32,1,56,1792,363,415,778,"21 de agosto de 1994"
32,1,56,1793,327,376,703,"21 de agosto de 1994"
32,1,56,1794,205,274,479,"21 de agosto de 1994"
32,1,56,1795,248,273,521,"21 de agosto de 1994"
32,1,56,1796,173,263,436,"21 de agosto de 1994"
32,1,56,1797,233,283,516,"21 de agosto de 1994"
32,1,56,1798,277,321,598,"21 de agosto de 1994"
32,1,56,1799,290,334,624,"21 de agosto de 1994"
32,1,56,1800,258,299,557,"21 de agosto de 1994"
32,1,56,1801,255,307,562,"21 de agosto de 1994"
32,1,56,1802,174,198,372,"21 de agosto de 1994"
32,1,56,1803,285,322,607,"21 de agosto de 1994"
32,1,56,1804,307,351,658,"21 de agosto de 1994"
32,1,56,1805,272,327,599,"21 de agosto de 1994"
32,1,56,1806,313,394,707,"21 de agosto de 1994"
32,1,56,1807,225,251,476,"21 de agosto de 1994"
32,1,56,1808,145,176,321,"21 de agosto de 1994"
32,1,56,1809,298,328,626,"21 de agosto de 1994"
32,1,56,1810,313,364,677,"21 de agosto de 1994"
32,1,56,1811,302,314,616,"21 de agosto de 1994"
32,1,56,1812,286,306,592,"21 de agosto de 1994"
32,1,56,1813,311,363,674,"21 de agosto de 1994"
32,1,56,1814,121,156,277,"21 de agosto de 1994"
32,1,56,1815,181,240,421,"21 de agosto de 1994"
32,1,56,1816,169,247,416,"21 de agosto de 1994"
32,1,56,1817,292,373,665,"21 de agosto de 1994"
32,1,56,1818,460,507,967,"21 de agosto de 1994"
32,1,56,1819,341,374,715,"21 de agosto de 1994"
32,1,56,1820,225,275,500,"21 de agosto de 1994"
32,1,56,1821,273,322,595,"21 de agosto de 1994"
32,1,56,1822,301,339,640,"21 de agosto de 1994"
32,1,56,1823,333,362,695,"21 de agosto de 1994"
32,1,56,1824,363,434,797,"21 de agosto de 1994"
32,1,56,1825,353,388,741,"21 de agosto de 1994"
32,1,56,1826,386,416,802,"21 de agosto de 1994"
32,1,56,1827,318,369,687,"21 de agosto de 1994"
32,1,56,1828,328,384,712,"21 de agosto de 1994"
32,1,56,1829,244,311,555,"21 de agosto de 1994"
32,1,56,1830,330,364,694,"21 de agosto de 1994"
32,1,56,1831,317,358,675,"21 de agosto de 1994"
32,1,56,1832,386,410,796,"21 de agosto de 1994"
32,1,56,1833,351,385,736,"21 de agosto de 1994"
32,1,56,1834,329,379,708,"21 de agosto de 1994"
32,1,56,1835,347,390,737,"21 de agosto de 1994"
32,1,56,1836,328,397,725,"21 de agosto de 1994"
32,1,56,1837,275,334,609,"21 de agosto de 1994"
32,1,56,1838,263,325,588,"21 de agosto de 1994"
32,1,56,1839,274,339,613,"21 de agosto de 1994"
32,1,56,1840,268,313,581,"21 de agosto de 1994"
32,1,56,1841,334,361,695,"21 de agosto de 1994"
32,1,56,1842,254,272,526,"21 de agosto de 1994"
32,1,56,1843,287,333,620,"21 de agosto de 1994"
32,1,56,1844,302,317,619,"21 de agosto de 1994"
32,1,56,1845,186,229,415,"21 de agosto de 1994"
32,1,56,1846,204,229,433,"21 de agosto de 1994"
32,1,56,1847,197,253,450,"21 de agosto de 1994"
32,1,56,1848,261,272,533,"21 de agosto de 1994"
32,1,56,1849,259,279,538,"21 de agosto de 1994"
32,1,56,1850,162,234,396,"21 de agosto de 1994"
32,1,56,1851,253,285,538,"21 de agosto de 1994"
32,1,56,1852,273,331,604,"21 de agosto de 1994"
32,1,56,1853,339,387,726,"21 de agosto de 1994"
32,1,56,1854,324,376,700,"21 de agosto de 1994"
32,1,56,1855,296,344,640,"21 de agosto de 1994"
32,1,56,1856,347,379,726,"21 de agosto de 1994"
32,1,56,1857,199,213,412,"21 de agosto de 1994"
32,1,56,1858,227,273,500,"21 de agosto de 1994"
32,1,56,1859,142,164,306,"21 de agosto de 1994"
32,1,56,1860,323,342,665,"21 de agosto de 1994"
32,1,56,1861,289,337,626,"21 de agosto de 1994"
32,1,56,1862,213,258,471,"21 de agosto de 1994"
32,1,56,1863,342,398,740,"21 de agosto de 1994"
32,1,56,1864,272,331,603,"21 de agosto de 1994"
32,1,56,1865,151,166,317,"21 de agosto de 1994"
32,1,56,1866,166,196,362,"21 de agosto de 1994"
32,1,56,1867,92,114,206,"21 de agosto de 1994"
32,1,56,1868,225,251,476,"21 de agosto de 1994"
32,1,56,1869,428,438,866,"21 de agosto de 1994"
32,1,56,1870,328,369,697,"21 de agosto de 1994"
32,1,56,1871,135,138,273,"21 de agosto de 1994"
32,1,56,1872,141,139,280,"21 de agosto de 1994"
32,1,56,1873,171,176,347,"21 de agosto de 1994"
32,1,56,1874,359,340,699,"21 de agosto de 1994"
32,1,56,1875,314,307,621,"21 de agosto de 1994"
32,1,56,1876,90,106,196,"21 de agosto de 1994"
32,1,56,1877,297,349,646,"21 de agosto de 1994"
32,1,56,1878,155,165,320,"21 de agosto de 1994"
32,1,56,1879,106,121,227,"21 de agosto de 1994"
32,1,56,1880,163,183,346,"21 de agosto de 1994"
32,1,56,1881,99,101,200,"21 de agosto de 1994"
32,1,56,1882,71,75,146,"21 de agosto de 1994"
32,2,5,40,330,350,680,"21 de agosto de 1994"
32,2,5,41,314,327,641,"21 de agosto de 1994"
32,2,5,42,181,180,361,"21 de agosto de 1994"
32,2,5,43,296,294,590,"21 de agosto de 1994"
32,2,5,44,195,189,384,"21 de agosto de 1994"
32,2,5,45,147,153,300,"21 de agosto de 1994"
32,2,5,46,331,365,696,"21 de agosto de 1994"
32,2,5,47,347,360,707,"21 de agosto de 1994"
32,2,5,48,313,319,632,"21 de agosto de 1994"
32,2,5,49,271,289,560,"21 de agosto de 1994"
32,2,5,50,417,434,851,"21 de agosto de 1994"
32,2,5,51,384,403,787,"21 de agosto de 1994"
32,2,5,52,250,256,506,"21 de agosto de 1994"
32,2,5,53,425,405,830,"21 de agosto de 1994"
32,2,5,54,283,321,604,"21 de agosto de 1994"
32,2,5,55,291,303,594,"21 de agosto de 1994"
32,2,5,56,367,383,750,"21 de agosto de 1994"
32,2,5,57,389,358,747,"21 de agosto de 1994"
32,2,5,58,187,182,369,"21 de agosto de 1994"
32,2,5,59,205,195,400,"21 de agosto de 1994"
32,2,5,60,66,68,134,"21 de agosto de 1994"
32,2,9,114,174,222,396,"21 de agosto de 1994"
32,2,9,115,111,128,239,"21 de agosto de 1994"
32,2,9,116,194,235,429,"21 de agosto de 1994"
32,2,9,117,146,188,334,"21 de agosto de 1994"
32,2,9,118,159,193,352,"21 de agosto de 1994"
32,2,9,119,240,258,498,"21 de agosto de 1994"
32,2,9,120,133,131,264,"21 de agosto de 1994"
32,2,9,121,118,141,259,"21 de agosto de 1994"
32,2,9,122,129,163,292,"21 de agosto de 1994"
32,2,9,123,175,229,404,"21 de agosto de 1994"
32,2,9,124,176,150,326,"21 de agosto de 1994"
32,2,9,125,196,175,371,"21 de agosto de 1994"
32,2,9,126,51,68,119,"21 de agosto de 1994"
32,2,9,127,175,212,387,"21 de agosto de 1994"
32,2,9,128,194,215,409,"21 de agosto de 1994"
32,2,9,129,144,149,293,"21 de agosto de 1994"
32,2,9,130,130,156,286,"21 de agosto de 1994"
32,2,9,131,145,143,288,"21 de agosto de 1994"
32,2,9,132,154,199,353,"21 de agosto de 1994"
32,2,9,133,113,125,238,"21 de agosto de 1994"
32,2,9,134,125,120,245,"21 de agosto de 1994"
32,2,10,135,138,154,292,"21 de agosto de 1994"
32,2,10,136,267,306,573,"21 de agosto de 1994"
32,2,10,137,195,220,415,"21 de agosto de 1994"
32,2,10,138,160,194,354,"21 de agosto de 1994"
32,2,10,139,326,371,697,"21 de agosto de 1994"
32,2,10,140,207,230,437,"21 de agosto de 1994"
32,2,10,141,173,183,356,"21 de agosto de 1994"
32,2,10,142,202,245,447,"21 de agosto de 1994"
32,2,10,143,260,312,572,"21 de agosto de 1994"
32,2,10,144,385,405,790,"21 de agosto de 1994"
32,2,10,145,184,225,409,"21 de agosto de 1994"
32,2,10,146,164,203,367,"21 de agosto de 1994"
32,2,10,147,197,229,426,"21 de agosto de 1994"
32,2,10,148,119,109,228,"21 de agosto de 1994"
32,2,10,149,258,288,546,"21 de agosto de 1994"
32,2,10,150,378,413,791,"21 de agosto de 1994"
32,2,10,151,453,492,945,"21 de agosto de 1994"
32,2,10,152,348,379,727,"21 de agosto de 1994"
32,2,10,153,167,217,384,"21 de agosto de 1994"
32,2,10,154,287,327,614,"21 de agosto de 1994"
32,2,10,155,322,336,658,"21 de agosto de 1994"
32,2,10,156,268,276,544,"21 de agosto de 1994"
32,2,10,157,466,502,968,"21 de agosto de 1994"
32,2,10,158,197,248,445,"21 de agosto de 1994"
32,2,10,159,262,284,546,"21 de agosto de 1994"
32,2,10,160,197,234,431,"21 de agosto de 1994"
32,2,10,161,183,208,391,"21 de agosto de 1994"
32,2,10,162,310,369,679,"21 de agosto de 1994"
32,2,10,163,183,216,399,"21 de agosto de 1994"
32,2,10,164,288,294,582,"21 de agosto de 1994"
32,2,10,165,291,384,675,"21 de agosto de 1994"
32,2,10,166,294,356,650,"21 de agosto de 1994"
32,2,10,167,273,294,567,"21 de agosto de 1994"
32,2,10,168,260,304,564,"21 de agosto de 1994"
32,2,10,169,313,367,680,"21 de agosto de 1994"
32,2,10,170,290,324,614,"21 de agosto de 1994"
32,2,10,171,337,381,718,"21 de agosto de 1994"
32,2,10,172,181,219,400,"21 de agosto de 1994"
32,2,10,173,287,324,611,"21 de agosto de 1994"
32,2,10,174,251,313,564,"21 de agosto de 1994"
32,2,10,175,264,330,594,"21 de agosto de 1994"
32,2,10,176,245,315,560,"21 de agosto de 1994"
32,2,10,177,358,410,768,"21 de agosto de 1994"
32,2,10,178,240,284,524,"21 de agosto de 1994"
32,2,10,179,248,304,552,"21 de agosto de 1994"
32,2,10,180,360,391,751,"21 de agosto de 1994"
32,2,10,181,298,398,696,"21 de agosto de 1994"
32,2,10,182,352,447,799,"21 de agosto de 1994"
32,2,10,183,209,252,461,"21 de agosto de 1994"
32,2,10,184,203,225,428,"21 de agosto de 1994"
32,2,10,185,176,211,387,"21 de agosto de 1994"
32,2,10,186,259,280,539,"21 de agosto de 1994"
32,2,10,187,192,245,437,"21 de agosto de 1994"
32,2,10,188,197,213,410,"21 de agosto de 1994"
32,2,10,189,327,369,696,"21 de agosto de 1994"
32,2,10,190,261,263,524,"21 de agosto de 1994"
32,2,10,191,309,362,671,"21 de agosto de 1994"
32,2,10,192,281,336,617,"21 de agosto de 1994"
32,2,10,193,250,298,548,"21 de agosto de 1994"
32,2,10,194,127,150,277,"21 de agosto de 1994"
32,2,10,195,353,395,748,"21 de agosto de 1994"
32,2,10,196,293,314,607,"21 de agosto de 1994"
32,2,10,197,236,275,511,"21 de agosto de 1994"
32,2,10,198,249,291,540,"21 de agosto de 1994"
32,2,10,199,150,152,302,"21 de agosto de 1994"
32,2,10,200,289,379,668,"21 de agosto de 1994"
32,2,10,201,214,264,478,"21 de agosto de 1994"
32,2,10,202,188,191,379,"21 de agosto de 1994"
32,2,10,203,318,408,726,"21 de agosto de 1994"
32,2,10,204,316,349,665,"21 de agosto de 1994"
32,2,10,205,200,283,483,"21 de agosto de 1994"
32,2,10,206,347,414,761,"21 de agosto de 1994"
32,2,10,207,318,382,700,"21 de agosto de 1994"
32,2,10,208,281,376,657,"21 de agosto de 1994"
32,2,10,209,288,343,631,"21 de agosto de 1994"
32,2,10,210,431,448,879,"21 de agosto de 1994"
32,2,10,211,286,322,608,"21 de agosto de 1994"
32,2,10,212,263,261,524,"21 de agosto de 1994"
32,2,10,213,134,161,295,"21 de agosto de 1994"
32,2,10,214,190,234,424,"21 de agosto de 1994"
32,2,10,215,219,252,471,"21 de agosto de 1994"
32,2,10,216,351,408,759,"21 de agosto de 1994"
32,2,10,217,149,160,309,"21 de agosto de 1994"
32,2,10,218,232,226,458,"21 de agosto de 1994"
32,2,10,219,111,118,229,"21 de agosto de 1994"
32,2,10,220,177,181,358,"21 de agosto de 1994"
32,2,10,221,119,107,226,"21 de agosto de 1994"
32,2,10,222,132,114,246,"21 de agosto de 1994"
32,2,10,223,127,117,244,"21 de agosto de 1994"
32,2,10,224,123,133,256,"21 de agosto de 1994"
32,2,10,225,280,265,545,"21 de agosto de 1994"
32,2,10,226,96,89,185,"21 de agosto de 1994"
32,2,10,227,197,185,382,"21 de agosto de 1994"
32,2,10,228,469,488,957,"21 de agosto de 1994"
32,2,10,229,448,442,890,"21 de agosto de 1994"
32,2,10,230,256,248,504,"21 de agosto de 1994"
32,2,10,231,268,264,532,"21 de agosto de 1994"
32,2,10,232,253,210,463,"21 de agosto de 1994"
32,2,10,233,228,232,460,"21 de agosto de 1994"
32,2,10,234,127,141,268,"21 de agosto de 1994"
32,2,10,235,175,198,373,"21 de agosto de 1994"
32,2,10,236,55,53,108,"21 de agosto de 1994"
32,2,10,237,186,214,400,"21 de agosto de 1994"
32,2,10,238,101,119,220,"21 de agosto de 1994"
32,2,10,239,252,248,500,"21 de agosto de 1994"
32,2,10,240,292,305,597,"21 de agosto de 1994"
32,2,10,241,99,92,191,"21 de agosto de 1994"
32,2,10,242,109,106,215,"21 de agosto de 1994"
32,2,10,243,197,223,420,"21 de agosto de 1994"
32,2,10,244,129,130,259,"21 de agosto de 1994"
32,2,10,245,257,235,492,"21 de agosto de 1994"
32,2,10,246,319,282,601,"21 de agosto de 1994"
32,2,10,247,113,88,201,"21 de agosto de 1994"
32,2,10,248,157,134,291,"21 de agosto de 1994"
32,2,10,249,304,311,615,"21 de agosto de 1994"
32,2,10,250,259,259,518,"21 de agosto de 1994"
32,2,10,251,265,276,541,"21 de agosto de 1994"
32,2,10,252,319,293,612,"21 de agosto de 1994"
32,2,10,253,251,262,513,"21 de agosto de 1994"
32,2,10,254,86,90,176,"21 de agosto de 1994"
32,2,10,255,40,39,79,"21 de agosto de 1994"
32,2,10,256,191,193,384,"21 de agosto de 1994"
32,2,10,257,147,189,336,"21 de agosto de 1994"
32,2,10,258,55,48,103,"21 de agosto de 1994"
32,2,10,259,76,76,152,"21 de agosto de 1994"
32,2,10,260,149,158,307,"21 de agosto de 1994"
32,2,10,261,142,122,264,"21 de agosto de 1994"
32,2,10,262,42,36,78,"21 de agosto de 1994"
32,2,10,263,164,175,339,"21 de agosto de 1994"
32,2,10,264,169,181,350,"21 de agosto de 1994"
32,2,10,265,293,298,591,"21 de agosto de 1994"
32,2,10,266,388,377,765,"21 de agosto de 1994"
32,2,10,267,379,378,757,"21 de agosto de 1994"
32,2,10,268,259,262,521,"21 de agosto de 1994"
32,2,10,269,142,123,265,"21 de agosto de 1994"
32,2,10,270,299,324,623,"21 de agosto de 1994"
32,2,10,271,270,277,547,"21 de agosto de 1994"
32,2,10,272,252,265,517,"21 de agosto de 1994"
32,2,10,273,128,108,236,"21 de agosto de 1994"
32,2,10,274,380,331,711,"21 de agosto de 1994"
32,2,10,275,162,164,326,"21 de agosto de 1994"
32,2,10,276,359,392,751,"21 de agosto de 1994"
32,2,10,277,301,324,625,"21 de agosto de 1994"
32,2,10,278,35,46,81,"21 de agosto de 1994"
32,2,10,279,253,257,510,"21 de agosto de 1994"
32,2,10,280,130,131,261,"21 de agosto de 1994"
32,2,10,281,84,91,175,"21 de agosto de 1994"
32,2,10,282,269,317,586,"21 de agosto de 1994"
32,2,10,283,103,99,202,"21 de agosto de 1994"
32,2,10,284,183,174,357,"21 de agosto de 1994"
32,2,10,285,53,58,111,"21 de agosto de 1994"
32,2,10,286,50,74,124,"21 de agosto de 1994"
32,2,10,287,25,31,56,"21 de agosto de 1994"
32,2,10,288,108,91,199,"21 de agosto de 1994"
32,2,10,289,125,120,245,"21 de agosto de 1994"
32,2,10,290,265,234,499,"21 de agosto de 1994"
32,2,10,291,231,224,455,"21 de agosto de 1994"
32,2,10,292,423,428,851,"21 de agosto de 1994"
32,2,10,293,184,180,364,"21 de agosto de 1994"
32,2,10,294,132,146,278,"21 de agosto de 1994"
32,2,10,295,134,133,267,"21 de agosto de 1994"
32,2,10,296,84,106,190,"21 de agosto de 1994"
32,2,10,297,87,87,174,"21 de agosto de 1994"
32,2,10,298,108,106,214,"21 de agosto de 1994"
32,2,10,299,89,85,174,"21 de agosto de 1994"
32,2,10,300,318,310,628,"21 de agosto de 1994"
32,2,10,301,28,24,52,"21 de agosto de 1994"
32,2,10,302,105,113,218,"21 de agosto de 1994"
32,2,10,303,275,246,521,"21 de agosto de 1994"
32,2,10,304,314,294,608,"21 de agosto de 1994"
32,2,10,305,137,120,257,"21 de agosto de 1994"
32,2,10,306,55,54,109,"21 de agosto de 1994"
32,2,10,307,169,142,311,"21 de agosto de 1994"
32,2,10,308,79,90,169,"21 de agosto de 1994"
32,2,10,309,80,80,160,"21 de agosto de 1994"
32,2,10,310,174,193,367,"21 de agosto de 1994"
32,2,10,311,182,158,340,"21 de agosto de 1994"
32,2,10,312,162,172,334,"21 de agosto de 1994"
32,2,10,313,136,128,264,"21 de agosto de 1994"
32,2,10,314,171,168,339,"21 de agosto de 1994"
32,2,10,315,48,57,105,"21 de agosto de 1994"
32,2,10,316,46,52,98,"21 de agosto de 1994"
32,2,10,317,129,114,243,"21 de agosto de 1994"
32,2,10,318,691,685,1376,"21 de agosto de 1994"
32,2,10,319,59,64,123,"21 de agosto de 1994"
32,2,10,320,62,78,140,"21 de agosto de 1994"
32,2,10,321,188,212,400,"21 de agosto de 1994"
32,2,10,322,56,71,127,"21 de agosto de 1994"
32,2,10,323,33,24,57,"21 de agosto de 1994"
32,2,10,324,81,96,177,"21 de agosto de 1994"
32,2,10,325,161,173,334,"21 de agosto de 1994"
32,2,10,326,60,57,117,"21 de agosto de 1994"
32,2,10,327,68,67,135,"21 de agosto de 1994"
32,2,10,328,54,64,118,"21 de agosto de 1994"
32,2,10,329,51,53,104,"21 de agosto de 1994"
32,2,10,330,70,66,136,"21 de agosto de 1994"
32,2,10,331,44,40,84,"21 de agosto de 1994"
32,2,10,332,105,99,204,"21 de agosto de 1994"
32,2,10,333,85,76,161,"21 de agosto de 1994"
32,2,10,334,46,47,93,"21 de agosto de 1994"
32,2,10,335,60,66,126,"21 de agosto de 1994"
32,2,10,336,53,42,95,"21 de agosto de 1994"
32,2,10,337,36,35,71,"21 de agosto de 1994"
32,2,10,338,112,101,213,"21 de agosto de 1994"
32,2,10,339,121,104,225,"21 de agosto de 1994"
32,2,10,340,173,157,330,"21 de agosto de 1994"
32,2,10,341,151,154,305,"21 de agosto de 1994"
32,2,10,342,28,25,53,"21 de agosto de 1994"
32,2,10,343,47,40,87,"21 de agosto de 1994"
32,2,10,344,156,150,306,"21 de agosto de 1994"
32,2,10,345,86,74,160,"21 de agosto de 1994"
32,2,10,346,99,120,219,"21 de agosto de 1994"
32,2,10,347,56,66,122,"21 de agosto de 1994"
32,2,10,348,31,25,56,"21 de agosto de 1994"
32,2,10,1156,1,0,1,"21 de agosto de 1994"
32,2,13,378,241,276,517,"21 de agosto de 1994"
32,2,13,379,370,388,758,"21 de agosto de 1994"
32,2,13,380,260,287,547,"21 de agosto de 1994"
32,2,13,381,178,174,352,"21 de agosto de 1994"
32,2,13,382,187,187,374,"21 de agosto de 1994"
32,2,13,383,67,74,141,"21 de agosto de 1994"
32,2,13,384,41,47,88,"21 de agosto de 1994"
32,2,13,385,28,27,55,"21 de agosto de 1994"
32,2,21,708,132,159,291,"21 de agosto de 1994"
32,2,21,709,133,157,290,"21 de agosto de 1994"
32,2,21,710,115,119,234,"21 de agosto de 1994"
32,2,21,711,149,201,350,"21 de agosto de 1994"
32,2,21,712,108,107,215,"21 de agosto de 1994"
32,2,21,713,129,144,273,"21 de agosto de 1994"
32,2,21,714,81,81,162,"21 de agosto de 1994"
32,2,21,715,61,65,126,"21 de agosto de 1994"
32,2,21,716,81,89,170,"21 de agosto de 1994"
32,2,21,717,66,79,145,"21 de agosto de 1994"
32,2,42,1289,310,322,632,"21 de agosto de 1994"
32,2,42,1290,208,226,434,"21 de agosto de 1994"
32,2,42,1291,140,150,290,"21 de agosto de 1994"
32,2,42,1292,257,259,516,"21 de agosto de 1994"
32,2,42,1293,317,370,687,"21 de agosto de 1994"
32,2,42,1294,228,259,487,"21 de agosto de 1994"
32,2,42,1295,102,125,227,"21 de agosto de 1994"
32,2,42,1296,252,271,523,"21 de agosto de 1994"
32,2,42,1297,267,299,566,"21 de agosto de 1994"
32,2,42,1298,284,348,632,"21 de agosto de 1994"
32,2,42,1299,296,323,619,"21 de agosto de 1994"
32,2,42,1300,229,265,494,"21 de agosto de 1994"
32,2,42,1301,270,332,602,"21 de agosto de 1994"
32,2,42,1302,270,300,570,"21 de agosto de 1994"
32,2,42,1303,260,327,587,"21 de agosto de 1994"
32,2,42,1304,346,407,753,"21 de agosto de 1994"
32,2,42,1305,232,230,462,"21 de agosto de 1994"
32,2,42,1306,173,199,372,"21 de agosto de 1994"
32,2,42,1307,77,87,164,"21 de agosto de 1994"
32,2,42,1308,129,112,241,"21 de agosto de 1994"
32,2,42,1309,277,275,552,"21 de agosto de 1994"
32,2,42,1310,192,168,360,"21 de agosto de 1994"
32,2,42,1311,169,178,347,"21 de agosto de 1994"
32,2,42,1312,199,192,391,"21 de agosto de 1994"
32,2,42,1313,239,252,491,"21 de agosto de 1994"
32,2,42,1314,210,249,459,"21 de agosto de 1994"
32,2,42,1315,234,246,480,"21 de agosto de 1994"
32,2,42,1316,253,273,526,"21 de agosto de 1994"
32,2,42,1317,158,132,290,"21 de agosto de 1994"
32,2,42,1318,140,144,284,"21 de agosto de 1994"
32,2,42,1319,175,173,348,"21 de agosto de 1994"
32,2,42,1320,92,89,181,"21 de agosto de 1994"
32,2,42,1321,217,271,488,"21 de agosto de 1994"
32,2,42,1322,205,189,394,"21 de agosto de 1994"
32,2,42,1323,290,338,628,"21 de agosto de 1994"
32,2,42,1324,85,79,164,"21 de agosto de 1994"
32,2,42,1325,182,183,365,"21 de agosto de 1994"
32,2,42,1326,235,272,507,"21 de agosto de 1994"
32,2,42,1327,134,180,314,"21 de agosto de 1994"
32,2,42,1328,115,156,271,"21 de agosto de 1994"
32,2,42,1329,208,196,404,"21 de agosto de 1994"
32,2,42,1330,59,63,122,"21 de agosto de 1994"
32,2,42,1331,205,196,401,"21 de agosto de 1994"
32,2,42,1332,32,33,65,"21 de agosto de 1994"
32,2,42,1333,95,140,235,"21 de agosto de 1994"
32,2,42,1334,158,177,335,"21 de agosto de 1994"
32,2,42,1335,157,200,357,"21 de agosto de 1994"
32,2,42,1336,182,256,438,"21 de agosto de 1994"
32,2,42,1337,78,88,166,"21 de agosto de 1994"
32,2,42,1338,106,125,231,"21 de agosto de 1994"
32,2,42,1339,326,344,670,"21 de agosto de 1994"
32,2,42,1340,195,184,379,"21 de agosto de 1994"
32,2,42,1341,116,120,236,"21 de agosto de 1994"
32,2,42,1342,119,104,223,"21 de agosto de 1994"
32,2,42,1343,118,123,241,"21 de agosto de 1994"
32,2,42,1344,126,158,284,"21 de agosto de 1994"
32,2,42,1345,187,199,386,"21 de agosto de 1994"
32,2,42,1346,278,257,535,"21 de agosto de 1994"
32,2,42,1347,168,216,384,"21 de agosto de 1994"
32,2,42,1348,69,102,171,"21 de agosto de 1994"
32,2,42,1349,138,130,268,"21 de agosto de 1994"
32,2,42,1350,130,131,261,"21 de agosto de 1994"
32,2,42,1351,124,111,235,"21 de agosto de 1994"
32,2,42,1352,119,117,236,"21 de agosto de 1994"
32,2,42,1353,191,207,398,"21 de agosto de 1994"
32,2,42,1354,63,84,147,"21 de agosto de 1994"
32,2,42,1355,113,136,249,"21 de agosto de 1994"
32,2,42,1356,184,234,418,"21 de agosto de 1994"
32,2,42,1357,100,111,211,"21 de agosto de 1994"
32,2,42,1358,237,217,454,"21 de agosto de 1994"
32,2,42,1359,64,79,143,"21 de agosto de 1994"
32,2,42,1360,99,118,217,"21 de agosto de 1994"
32,2,42,1361,119,152,271,"21 de agosto de 1994"
32,2,42,1362,149,176,325,"21 de agosto de 1994"
32,2,42,1363,108,113,221,"21 de agosto de 1994"
32,2,42,1364,99,148,247,"21 de agosto de 1994"
32,2,42,1365,141,152,293,"21 de agosto de 1994"
32,2,42,1366,149,132,281,"21 de agosto de 1994"
32,2,42,1367,92,88,180,"21 de agosto de 1994"
32,2,42,1368,123,131,254,"21 de agosto de 1994"
32,2,42,1369,59,62,121,"21 de agosto de 1994"
32,2,42,1370,63,58,121,"21 de agosto de 1994"
32,2,42,1371,72,63,135,"21 de agosto de 1994"
32,2,42,1372,63,64,127,"21 de agosto de 1994"
32,2,42,1373,83,85,168,"21 de agosto de 1994"
32,2,42,1374,26,36,62,"21 de agosto de 1994"
32,2,42,1375,133,123,256,"21 de agosto de 1994"
32,2,42,1376,32,41,73,"21 de agosto de 1994"
32,2,42,1377,75,76,151,"21 de agosto de 1994"
32,2,42,1378,35,36,71,"21 de agosto de 1994"
32,2,42,1379,29,23,52,"21 de agosto de 1994"
32,2,42,1380,39,45,84,"21 de agosto de 1994"
32,2,42,1381,79,95,174,"21 de agosto de 1994"
32,2,42,1382,44,53,97,"21 de agosto de 1994"
32,2,42,1383,71,68,139,"21 de agosto de 1994"
32,3,1,1,165,160,325,"21 de agosto de 1994"
32,3,1,2,238,295,533,"21 de agosto de 1994"
32,3,1,3,213,268,481,"21 de agosto de 1994"
32,3,1,4,155,157,312,"21 de agosto de 1994"
32,3,1,5,135,152,287,"21 de agosto de 1994"
32,3,1,6,246,307,553,"21 de agosto de 1994"
32,3,1,7,127,124,251,"21 de agosto de 1994"
32,3,1,8,183,242,425,"21 de agosto de 1994"
32,3,1,9,66,81,147,"21 de agosto de 1994"
32,3,1,10,82,126,208,"21 de agosto de 1994"
32,3,1,11,44,62,106,"21 de agosto de 1994"
32,3,1,12,53,79,132,"21 de agosto de 1994"
32,3,1,13,155,215,370,"21 de agosto de 1994"
32,3,2,14,168,215,383,"21 de agosto de 1994"
32,3,2,15,183,231,414,"21 de agosto de 1994"
32,3,2,16,73,100,173,"21 de agosto de 1994"
32,3,2,17,219,231,450,"21 de agosto de 1994"
32,3,2,18,186,205,391,"21 de agosto de 1994"
32,3,2,19,95,138,233,"21 de agosto de 1994"
32,3,2,20,128,163,291,"21 de agosto de 1994"
32,3,2,21,59,84,143,"21 de agosto de 1994"
32,3,3,22,151,191,342,"21 de agosto de 1994"
32,3,3,23,137,164,301,"21 de agosto de 1994"
32,3,3,24,139,196,335,"21 de agosto de 1994"
32,3,3,25,77,97,174,"21 de agosto de 1994"
32,3,3,26,110,172,282,"21 de agosto de 1994"
32,3,3,27,101,147,248,"21 de agosto de 1994"
32,3,3,28,58,71,129,"21 de agosto de 1994"
32,3,3,29,51,76,127,"21 de agosto de 1994"
32,3,3,30,48,63,111,"21 de agosto de 1994"
32,3,4,31,154,176,330,"21 de agosto de 1994"
32,3,4,32,133,180,313,"21 de agosto de 1994"
32,3,4,33,83,108,191,"21 de agosto de 1994"
32,3,4,34,147,148,295,"21 de agosto de 1994"
32,3,4,35,153,184,337,"21 de agosto de 1994"
32,3,4,36,94,119,213,"21 de agosto de 1994"
32,3,4,37,99,103,202,"21 de agosto de 1994"
32,3,4,38,128,160,288,"21 de agosto de 1994"
32,3,4,39,54,54,108,"21 de agosto de 1994"
32,3,11,349,121,149,270,"21 de agosto de 1994"
32,3,11,350,150,176,326,"21 de agosto de 1994"
32,3,11,351,123,133,256,"21 de agosto de 1994"
32,3,11,352,123,162,285,"21 de agosto de 1994"
32,3,11,353,88,133,221,"21 de agosto de 1994"
32,3,11,354,75,76,151,"21 de agosto de 1994"
32,3,11,355,52,69,121,"21 de agosto de 1994"
32,3,11,356,122,136,258,"21 de agosto de 1994"
32,3,11,357,16,19,35,"21 de agosto de 1994"
32,3,11,358,31,37,68,"21 de agosto de 1994"
32,3,15,428,231,237,468,"21 de agosto de 1994"
32,3,15,429,107,144,251,"21 de agosto de 1994"
32,3,15,430,127,163,290,"21 de agosto de 1994"
32,3,15,431,35,47,82,"21 de agosto de 1994"
32,3,15,432,34,56,90,"21 de agosto de 1994"
32,3,15,433,54,70,124,"21 de agosto de 1994"
32,3,15,434,41,46,87,"21 de agosto de 1994"
32,3,15,435,46,63,109,"21 de agosto de 1994"
32,3,18,552,267,321,588,"21 de agosto de 1994"
32,3,18,553,76,81,157,"21 de agosto de 1994"
32,3,18,554,189,208,397,"21 de agosto de 1994"
32,3,18,555,99,100,199,"21 de agosto de 1994"
32,3,18,556,82,96,178,"21 de agosto de 1994"
32,3,18,557,91,101,192,"21 de agosto de 1994"
32,3,18,558,95,136,231,"21 de agosto de 1994"
32,3,18,559,115,195,310,"21 de agosto de 1994"
32,3,18,560,123,175,298,"21 de agosto de 1994"
32,3,18,561,32,45,77,"21 de agosto de 1994"
32,3,18,562,29,41,70,"21 de agosto de 1994"
32,3,18,563,58,73,131,"21 de agosto de 1994"
32,3,18,564,51,77,128,"21 de agosto de 1994"
32,3,18,565,55,68,123,"21 de agosto de 1994"
32,3,19,566,111,132,243,"21 de agosto de 1994"
32,3,19,567,240,285,525,"21 de agosto de 1994"
32,3,19,568,269,326,595,"21 de agosto de 1994"
32,3,19,569,249,303,552,"21 de agosto de 1994"
32,3,19,570,241,288,529,"21 de agosto de 1994"
32,3,19,571,215,262,477,"21 de agosto de 1994"
32,3,19,572,315,395,710,"21 de agosto de 1994"
32,3,19,573,217,268,485,"21 de agosto de 1994"
32,3,19,574,231,245,476,"21 de agosto de 1994"
32,3,19,575,210,280,490,"21 de agosto de 1994"
32,3,19,576,213,222,435,"21 de agosto de 1994"
32,3,19,577,175,199,374,"21 de agosto de 1994"
32,3,19,578,269,306,575,"21 de agosto de 1994"
32,3,19,579,240,337,577,"21 de agosto de 1994"
32,3,19,580,129,128,257,"21 de agosto de 1994"
32,3,19,581,149,186,335,"21 de agosto de 1994"
32,3,19,582,159,170,329,"21 de agosto de 1994"
32,3,19,583,252,289,541,"21 de agosto de 1994"
32,3,19,584,87,83,170,"21 de agosto de 1994"
32,3,19,585,43,48,91,"21 de agosto de 1994"
32,3,19,586,204,279,483,"21 de agosto de 1994"
32,3,19,587,191,232,423,"21 de agosto de 1994"
32,3,19,588,76,61,137,"21 de agosto de 1994"
32,3,19,589,185,206,391,"21 de agosto de 1994"
32,3,19,590,84,108,192,"21 de agosto de 1994"
32,3,19,591,107,114,221,"21 de agosto de 1994"
32,3,19,592,67,69,136,"21 de agosto de 1994"
32,3,19,593,148,201,349,"21 de agosto de 1994"
32,3,19,594,102,128,230,"21 de agosto de 1994"
32,3,19,595,33,40,73,"21 de agosto de 1994"
32,3,19,596,124,167,291,"21 de agosto de 1994"
32,3,19,597,71,102,173,"21 de agosto de 1994"
32,3,19,598,40,53,93,"21 de agosto de 1994"
32,3,19,599,100,114,214,"21 de agosto de 1994"
32,3,19,600,45,63,108,"21 de agosto de 1994"
32,3,19,601,89,108,197,"21 de agosto de 1994"
32,3,19,602,48,49,97,"21 de agosto de 1994"
32,3,19,603,62,113,175,"21 de agosto de 1994"
32,3,19,604,119,127,246,"21 de agosto de 1994"
32,3,19,605,84,113,197,"21 de agosto de 1994"
32,3,23,742,405,465,870,"21 de agosto de 1994"
32,3,23,743,264,300,564,"21 de agosto de 1994"
32,3,23,744,350,411,761,"21 de agosto de 1994"
32,3,23,745,258,298,556,"21 de agosto de 1994"
32,3,23,746,175,221,396,"21 de agosto de 1994"
32,3,23,747,199,219,418,"21 de agosto de 1994"
32,3,23,748,285,308,593,"21 de agosto de 1994"
32,3,23,749,248,289,537,"21 de agosto de 1994"
32,3,23,750,135,163,298,"21 de agosto de 1994"
32,3,23,751,84,88,172,"21 de agosto de 1994"
32,3,23,752,198,258,456,"21 de agosto de 1994"
32,3,23,753,176,191,367,"21 de agosto de 1994"
32,3,23,754,78,116,194,"21 de agosto de 1994"
32,3,23,755,103,107,210,"21 de agosto de 1994"
32,3,23,756,278,328,606,"21 de agosto de 1994"
32,3,23,757,95,106,201,"21 de agosto de 1994"
32,3,23,758,123,145,268,"21 de agosto de 1994"
32,3,23,759,51,69,120,"21 de agosto de 1994"
32,3,23,760,43,69,112,"21 de agosto de 1994"
32,3,23,761,44,54,98,"21 de agosto de 1994"
32,3,23,762,71,75,146,"21 de agosto de 1994"
32,3,28,876,194,210,404,"21 de agosto de 1994"
32,3,28,877,250,275,525,"21 de agosto de 1994"
32,3,28,878,102,118,220,"21 de agosto de 1994"
32,3,28,879,54,40,94,"21 de agosto de 1994"
32,3,28,880,56,59,115,"21 de agosto de 1994"
32,3,28,881,37,48,85,"21 de agosto de 1994"
32,3,28,882,40,55,95,"21 de agosto de 1994"
32,3,28,883,73,79,152,"21 de agosto de 1994"
32,3,30,906,87,115,202,"21 de agosto de 1994"
32,3,30,907,131,169,300,"21 de agosto de 1994"
32,3,30,908,243,302,545,"21 de agosto de 1994"
32,3,30,909,71,103,174,"21 de agosto de 1994"
32,3,30,910,35,57,92,"21 de agosto de 1994"
32,3,30,911,100,133,233,"21 de agosto de 1994"
32,3,30,912,19,25,44,"21 de agosto de 1994"
32,3,30,913,68,99,167,"21 de agosto de 1994"
32,3,33,954,215,228,443,"21 de agosto de 1994"
32,3,33,955,126,145,271,"21 de agosto de 1994"
32,3,33,956,237,276,513,"21 de agosto de 1994"
32,3,33,957,181,228,409,"21 de agosto de 1994"
32,3,33,958,222,260,482,"21 de agosto de 1994"
32,3,33,959,57,97,154,"21 de agosto de 1994"
32,3,33,960,92,103,195,"21 de agosto de 1994"
32,3,33,961,189,209,398,"21 de agosto de 1994"
32,3,33,962,107,121,228,"21 de agosto de 1994"
32,3,33,963,137,161,298,"21 de agosto de 1994"
32,3,33,964,166,191,357,"21 de agosto de 1994"
32,3,34,965,238,313,551,"21 de agosto de 1994"
32,3,34,966,311,399,710,"21 de agosto de 1994"
32,3,34,967,295,330,625,"21 de agosto de 1994"
32,3,34,968,326,436,762,"21 de agosto de 1994"
32,3,34,969,229,307,536,"21 de agosto de 1994"
32,3,34,970,246,344,590,"21 de agosto de 1994"
32,3,34,971,285,356,641,"21 de agosto de 1994"
32,3,34,972,265,312,577,"21 de agosto de 1994"
32,3,34,973,291,407,698,"21 de agosto de 1994"
32,3,34,974,188,271,459,"21 de agosto de 1994"
32,3,34,975,123,152,275,"21 de agosto de 1994"
32,3,34,976,315,371,686,"21 de agosto de 1994"
32,3,34,977,268,318,586,"21 de agosto de 1994"
32,3,34,978,222,270,492,"21 de agosto de 1994"
32,3,34,979,241,318,559,"21 de agosto de 1994"
32,3,34,980,139,176,315,"21 de agosto de 1994"
32,3,34,981,43,76,119,"21 de agosto de 1994"
32,3,34,982,261,416,677,"21 de agosto de 1994"
32,3,34,983,217,281,498,"21 de agosto de 1994"
32,3,34,984,60,77,137,"21 de agosto de 1994"
32,3,34,985,30,51,81,"21 de agosto de 1994"
32,3,34,986,68,115,183,"21 de agosto de 1994"
32,3,34,987,86,140,226,"21 de agosto de 1994"
32,3,34,988,46,80,126,"21 de agosto de 1994"
32,3,34,989,46,72,118,"21 de agosto de 1994"
32,3,34,990,70,115,185,"21 de agosto de 1994"
32,3,34,991,46,63,109,"21 de agosto de 1994"
32,3,34,992,51,70,121,"21 de agosto de 1994"
32,3,34,993,116,159,275,"21 de agosto de 1994"
32,3,34,994,60,101,161,"21 de agosto de 1994"
32,3,34,995,174,227,401,"21 de agosto de 1994"
32,3,34,996,92,121,213,"21 de agosto de 1994"
32,3,34,997,147,193,340,"21 de agosto de 1994"
32,3,34,998,58,68,126,"21 de agosto de 1994"
32,3,34,999,183,254,437,"21 de agosto de 1994"
32,3,34,1000,115,153,268,"21 de agosto de 1994"
32,3,34,1001,87,110,197,"21 de agosto de 1994"
32,3,34,1002,190,206,396,"21 de agosto de 1994"
32,3,34,1003,133,165,298,"21 de agosto de 1994"
32,3,34,1004,66,90,156,"21 de agosto de 1994"
32,3,34,1005,79,122,201,"21 de agosto de 1994"
32,3,34,1006,40,69,109,"21 de agosto de 1994"
32,3,34,1007,92,146,238,"21 de agosto de 1994"
32,3,34,1008,119,123,242,"21 de agosto de 1994"
32,3,34,1009,22,38,60,"21 de agosto de 1994"
32,3,34,1010,46,58,104,"21 de agosto de 1994"
32,3,34,1011,63,105,168,"21 de agosto de 1994"
32,3,34,1012,108,138,246,"21 de agosto de 1994"
32,3,34,1013,42,55,97,"21 de agosto de 1994"
32,3,34,1014,60,89,149,"21 de agosto de 1994"
32,3,34,1015,31,54,85,"21 de agosto de 1994"
32,3,34,1016,73,100,173,"21 de agosto de 1994"
32,3,34,1017,18,34,52,"21 de agosto de 1994"
32,3,34,1018,73,95,168,"21 de agosto de 1994"
32,3,34,1019,72,112,184,"21 de agosto de 1994"
32,3,44,1388,105,111,216,"21 de agosto de 1994"
32,3,44,1389,360,406,766,"21 de agosto de 1994"
32,3,44,1390,235,289,524,"21 de agosto de 1994"
32,3,44,1391,244,301,545,"21 de agosto de 1994"
32,3,44,1392,273,316,589,"21 de agosto de 1994"
32,3,44,1393,115,152,267,"21 de agosto de 1994"
32,3,44,1394,112,141,253,"21 de agosto de 1994"
32,3,44,1395,137,187,324,"21 de agosto de 1994"
32,3,44,1396,445,501,946,"21 de agosto de 1994"
32,3,44,1397,213,245,458,"21 de agosto de 1994"
32,3,44,1398,125,137,262,"21 de agosto de 1994"
32,3,44,1399,96,121,217,"21 de agosto de 1994"
32,3,44,1400,152,176,328,"21 de agosto de 1994"
32,3,44,1401,167,160,327,"21 de agosto de 1994"
32,3,44,1402,163,215,378,"21 de agosto de 1994"
32,3,44,1403,133,166,299,"21 de agosto de 1994"
32,3,44,1404,56,63,119,"21 de agosto de 1994"
32,3,44,1405,80,85,165,"21 de agosto de 1994"
32,3,44,1406,45,52,97,"21 de agosto de 1994"
32,3,44,1407,51,68,119,"21 de agosto de 1994"
32,3,44,1408,61,80,141,"21 de agosto de 1994"
32,3,44,1409,106,141,247,"21 de agosto de 1994"
32,3,44,1410,33,38,71,"21 de agosto de 1994"
32,3,44,1411,110,112,222,"21 de agosto de 1994"
32,3,45,1412,86,122,208,"21 de agosto de 1994"
32,3,45,1413,129,156,285,"21 de agosto de 1994"
32,3,45,1414,153,176,329,"21 de agosto de 1994"
32,3,45,1415,133,168,301,"21 de agosto de 1994"
32,3,45,1416,140,166,306,"21 de agosto de 1994"
32,3,45,1417,186,271,457,"21 de agosto de 1994"
32,3,45,1418,136,170,306,"21 de agosto de 1994"
32,3,45,1419,111,136,247,"21 de agosto de 1994"
32,3,45,1420,119,137,256,"21 de agosto de 1994"
32,3,45,1421,77,88,165,"21 de agosto de 1994"
32,3,45,1422,117,124,241,"21 de agosto de 1994"
32,3,45,1423,156,199,355,"21 de agosto de 1994"
32,3,45,1424,62,72,134,"21 de agosto de 1994"
32,3,45,1425,66,79,145,"21 de agosto de 1994"
32,3,45,1426,27,35,62,"21 de agosto de 1994"
32,3,45,1427,106,142,248,"21 de agosto de 1994"
32,3,45,1428,56,65,121,"21 de agosto de 1994"
32,3,45,1429,62,60,122,"21 de agosto de 1994"
32,3,45,1430,219,305,524,"21 de agosto de 1994"
32,3,45,1431,56,69,125,"21 de agosto de 1994"
32,3,45,1432,65,81,146,"21 de agosto de 1994"
32,3,47,1465,264,319,583,"21 de agosto de 1994"
32,3,47,1466,155,205,360,"21 de agosto de 1994"
32,3,47,1467,241,271,512,"21 de agosto de 1994"
32,3,47,1468,244,269,513,"21 de agosto de 1994"
32,3,47,1469,30,32,62,"21 de agosto de 1994"
32,3,47,1470,138,176,314,"21 de agosto de 1994"
32,3,47,1471,184,214,398,"21 de agosto de 1994"
32,3,47,1472,85,94,179,"21 de agosto de 1994"
32,3,47,1473,91,114,205,"21 de agosto de 1994"
32,3,47,1474,70,84,154,"21 de agosto de 1994"
32,3,47,1475,124,145,269,"21 de agosto de 1994"
32,3,47,1476,130,144,274,"21 de agosto de 1994"
32,3,47,1477,36,34,70,"21 de agosto de 1994"
32,3,47,1478,149,168,317,"21 de agosto de 1994"
32,3,47,1479,74,54,128,"21 de agosto de 1994"
32,3,47,1480,101,118,219,"21 de agosto de 1994"
32,3,47,1481,114,113,227,"21 de agosto de 1994"
32,3,47,1482,78,93,171,"21 de agosto de 1994"
32,3,47,1483,73,77,150,"21 de agosto de 1994"
32,3,47,1484,60,66,126,"21 de agosto de 1994"
32,3,48,1485,138,162,300,"21 de agosto de 1994"
32,3,48,1486,240,274,514,"21 de agosto de 1994"
32,3,48,1487,241,296,537,"21 de agosto de 1994"
32,3,48,1488,98,135,233,"21 de agosto de 1994"
32,3,48,1489,186,239,425,"21 de agosto de 1994"
32,3,48,1490,190,251,441,"21 de agosto de 1994"
32,3,48,1491,232,252,484,"21 de agosto de 1994"
32,3,48,1492,265,323,588,"21 de agosto de 1994"
32,3,48,1493,238,288,526,"21 de agosto de 1994"
32,3,48,1494,162,215,377,"21 de agosto de 1994"
32,3,48,1495,262,310,572,"21 de agosto de 1994"
32,3,48,1496,216,264,480,"21 de agosto de 1994"
32,3,48,1497,234,248,482,"21 de agosto de 1994"
32,3,48,1498,683,237,920,"21 de agosto de 1994"
32,3,48,1499,78,88,166,"21 de agosto de 1994"
32,3,48,1500,54,73,127,"21 de agosto de 1994"
32,3,48,1501,106,132,238,"21 de agosto de 1994"
32,3,48,1502,151,145,296,"21 de agosto de 1994"
32,3,48,1503,76,77,153,"21 de agosto de 1994"
32,3,48,1504,88,80,168,"21 de agosto de 1994"
32,3,48,1505,85,94,179,"21 de agosto de 1994"
32,3,48,1506,123,180,303,"21 de agosto de 1994"
32,3,48,1507,120,127,247,"21 de agosto de 1994"
32,3,48,1508,90,105,195,"21 de agosto de 1994"
32,3,48,1509,57,60,117,"21 de agosto de 1994"
32,3,48,1510,158,185,343,"21 de agosto de 1994"
32,3,48,1511,228,274,502,"21 de agosto de 1994"
32,3,48,1512,51,47,98,"21 de agosto de 1994"
32,3,48,1513,107,130,237,"21 de agosto de 1994"
32,3,48,1514,106,122,228,"21 de agosto de 1994"
32,3,48,1515,57,58,115,"21 de agosto de 1994"
32,3,48,1516,44,64,108,"21 de agosto de 1994"
32,3,48,1517,36,53,89,"21 de agosto de 1994"
32,3,48,1518,62,68,130,"21 de agosto de 1994"
32,3,48,1519,95,78,173,"21 de agosto de 1994"
32,3,48,1520,48,45,93,"21 de agosto de 1994"
32,3,48,1521,74,57,131,"21 de agosto de 1994"
32,3,48,1522,89,92,181,"21 de agosto de 1994"
32,3,48,1523,44,51,95,"21 de agosto de 1994"
32,3,48,1524,74,70,144,"21 de agosto de 1994"
32,3,55,1711,262,285,547,"21 de agosto de 1994"
32,3,55,1712,180,243,423,"21 de agosto de 1994"
32,3,55,1713,176,244,420,"21 de agosto de 1994"
32,3,55,1714,139,183,322,"21 de agosto de 1994"
32,3,55,1715,215,292,507,"21 de agosto de 1994"
32,3,55,1716,262,337,599,"21 de agosto de 1994"
32,3,55,1717,204,268,472,"21 de agosto de 1994"
32,3,55,1718,231,300,531,"21 de agosto de 1994"
32,3,55,1719,222,289,511,"21 de agosto de 1994"
32,3,55,1720,174,210,384,"21 de agosto de 1994"
32,3,55,1721,63,74,137,"21 de agosto de 1994"
32,3,55,1722,136,172,308,"21 de agosto de 1994"
32,3,55,1723,181,199,380,"21 de agosto de 1994"
32,3,55,1724,242,277,519,"21 de agosto de 1994"
32,3,55,1725,246,279,525,"21 de agosto de 1994"
32,3,55,1726,228,289,517,"21 de agosto de 1994"
32,3,55,1727,198,283,481,"21 de agosto de 1994"
32,3,55,1728,198,247,445,"21 de agosto de 1994"
32,3,55,1729,38,50,88,"21 de agosto de 1994"
32,3,55,1730,168,196,364,"21 de agosto de 1994"
32,3,55,1731,140,149,289,"21 de agosto de 1994"
32,3,55,1732,71,81,152,"21 de agosto de 1994"
32,3,55,1733,74,89,163,"21 de agosto de 1994"
32,3,55,1734,357,361,718,"21 de agosto de 1994"
32,3,55,1735,82,110,192,"21 de agosto de 1994"
32,3,55,1736,134,235,369,"21 de agosto de 1994"
32,3,55,1737,149,226,375,"21 de agosto de 1994"
32,3,55,1738,194,216,410,"21 de agosto de 1994"
32,3,55,1739,227,299,526,"21 de agosto de 1994"
32,3,55,1740,258,367,625,"21 de agosto de 1994"
32,3,55,1741,41,54,95,"21 de agosto de 1994"
32,3,55,1742,81,85,166,"21 de agosto de 1994"
32,3,55,1743,81,108,189,"21 de agosto de 1994"
32,3,55,1744,168,172,340,"21 de agosto de 1994"
32,3,55,1745,204,200,404,"21 de agosto de 1994"
32,3,55,1746,71,80,151,"21 de agosto de 1994"
32,3,55,1747,49,84,133,"21 de agosto de 1994"
32,3,55,1748,170,200,370,"21 de agosto de 1994"
32,3,55,1749,200,291,491,"21 de agosto de 1994"
32,3,55,1750,112,120,232,"21 de agosto de 1994"
32,3,55,1751,102,114,216,"21 de agosto de 1994"
32,3,55,1752,60,61,121,"21 de agosto de 1994"
32,3,55,1753,103,124,227,"21 de agosto de 1994"
32,3,55,1754,23,24,47,"21 de agosto de 1994"
32,3,55,1755,124,152,276,"21 de agosto de 1994"
32,3,55,1756,44,60,104,"21 de agosto de 1994"
32,3,55,1757,65,92,157,"21 de agosto de 1994"
32,3,55,1758,101,117,218,"21 de agosto de 1994"
32,3,55,1759,111,205,316,"21 de agosto de 1994"
32,3,55,1760,64,76,140,"21 de agosto de 1994"
32,3,55,1761,38,67,105,"21 de agosto de 1994"
32,3,55,1762,53,66,119,"21 de agosto de 1994"
32,3,55,1763,46,47,93,"21 de agosto de 1994"
32,3,55,1764,56,71,127,"21 de agosto de 1994"
32,3,55,1765,42,66,108,"21 de agosto de 1994"
32,3,55,1766,35,43,78,"21 de agosto de 1994"
32,3,55,1767,18,19,37,"21 de agosto de 1994"
32,3,55,1768,26,27,53,"21 de agosto de 1994"
32,3,55,1769,102,126,228,"21 de agosto de 1994"
32,3,55,1770,53,47,100,"21 de agosto de 1994"
32,3,55,1771,22,30,52,"21 de agosto de 1994"
32,4,6,61,232,233,465,"21 de agosto de 1994"
32,4,6,62,280,288,568,"21 de agosto de 1994"
32,4,6,63,262,276,538,"21 de agosto de 1994"
32,4,6,64,254,256,510,"21 de agosto de 1994"
32,4,6,65,228,273,501,"21 de agosto de 1994"
32,4,6,66,275,301,576,"21 de agosto de 1994"
32,4,6,67,131,118,249,"21 de agosto de 1994"
32,4,6,68,94,78,172,"21 de agosto de 1994"
32,4,6,69,340,326,666,"21 de agosto de 1994"
32,4,6,70,164,170,334,"21 de agosto de 1994"
32,4,6,71,53,45,98,"21 de agosto de 1994"
32,4,6,72,27,24,51,"21 de agosto de 1994"
32,4,7,73,209,225,434,"21 de agosto de 1994"
32,4,7,74,192,204,396,"21 de agosto de 1994"
32,4,7,75,224,235,459,"21 de agosto de 1994"
32,4,7,76,328,371,699,"21 de agosto de 1994"
32,4,7,77,309,280,589,"21 de agosto de 1994"
32,4,7,78,236,260,496,"21 de agosto de 1994"
32,4,7,79,318,335,653,"21 de agosto de 1994"
32,4,7,80,387,416,803,"21 de agosto de 1994"
32,4,7,81,38,29,67,"21 de agosto de 1994"
32,4,7,82,94,85,179,"21 de agosto de 1994"
32,4,7,83,169,152,321,"21 de agosto de 1994"
32,4,7,84,132,116,248,"21 de agosto de 1994"
32,4,7,85,96,94,190,"21 de agosto de 1994"
32,4,7,86,73,63,136,"21 de agosto de 1994"
32,4,7,87,100,86,186,"21 de agosto de 1994"
32,4,7,88,42,35,77,"21 de agosto de 1994"
32,4,7,89,57,49,106,"21 de agosto de 1994"
32,4,7,90,36,35,71,"21 de agosto de 1994"
32,4,7,91,147,126,273,"21 de agosto de 1994"
32,4,7,92,110,94,204,"21 de agosto de 1994"
32,4,7,93,76,47,123,"21 de agosto de 1994"
32,4,7,94,70,46,116,"21 de agosto de 1994"
32,4,7,95,39,26,65,"21 de agosto de 1994"
32,4,7,96,153,108,261,"21 de agosto de 1994"
32,4,7,97,46,37,83,"21 de agosto de 1994"
32,4,7,98,54,48,102,"21 de agosto de 1994"
32,4,7,99,47,31,78,"21 de agosto de 1994"
32,4,7,100,28,25,53,"21 de agosto de 1994"
32,4,7,101,30,28,58,"21 de agosto de 1994"
32,4,7,102,37,26,63,"21 de agosto de 1994"
32,4,14,386,233,276,509,"21 de agosto de 1994"
32,4,14,387,248,302,550,"21 de agosto de 1994"
32,4,14,388,201,230,431,"21 de agosto de 1994"
32,4,14,389,204,268,472,"21 de agosto de 1994"
32,4,14,390,187,230,417,"21 de agosto de 1994"
32,4,14,391,194,254,448,"21 de agosto de 1994"
32,4,14,392,98,104,202,"21 de agosto de 1994"
32,4,14,393,183,201,384,"21 de agosto de 1994"
32,4,14,394,139,153,292,"21 de agosto de 1994"
32,4,14,395,120,135,255,"21 de agosto de 1994"
32,4,14,396,121,179,300,"21 de agosto de 1994"
32,4,14,397,185,203,388,"21 de agosto de 1994"
32,4,14,398,126,164,290,"21 de agosto de 1994"
32,4,14,399,139,194,333,"21 de agosto de 1994"
32,4,14,400,113,138,251,"21 de agosto de 1994"
32,4,14,401,77,100,177,"21 de agosto de 1994"
32,4,14,402,232,238,470,"21 de agosto de 1994"
32,4,14,403,78,120,198,"21 de agosto de 1994"
32,4,14,404,91,112,203,"21 de agosto de 1994"
32,4,14,405,140,147,287,"21 de agosto de 1994"
32,4,14,406,85,173,258,"21 de agosto de 1994"
32,4,14,407,143,195,338,"21 de agosto de 1994"
32,4,14,408,197,190,387,"21 de agosto de 1994"
32,4,14,409,179,187,366,"21 de agosto de 1994"
32,4,14,410,176,144,320,"21 de agosto de 1994"
32,4,14,411,93,95,188,"21 de agosto de 1994"
32,4,14,412,165,252,417,"21 de agosto de 1994"
32,4,14,413,228,298,526,"21 de agosto de 1994"
32,4,14,414,167,207,374,"21 de agosto de 1994"
32,4,14,415,95,105,200,"21 de agosto de 1994"
32,4,14,416,45,40,85,"21 de agosto de 1994"
32,4,14,417,53,54,107,"21 de agosto de 1994"
32,4,14,418,77,115,192,"21 de agosto de 1994"
32,4,14,419,69,87,156,"21 de agosto de 1994"
32,4,14,420,54,72,126,"21 de agosto de 1994"
32,4,14,421,93,133,226,"21 de agosto de 1994"
32,4,14,422,53,48,101,"21 de agosto de 1994"
32,4,14,423,37,50,87,"21 de agosto de 1994"
32,4,14,424,47,41,88,"21 de agosto de 1994"
32,4,14,425,112,140,252,"21 de agosto de 1994"
32,4,14,426,66,76,142,"21 de agosto de 1994"
32,4,14,427,53,64,117,"21 de agosto de 1994"
32,4,22,718,290,309,599,"21 de agosto de 1994"
32,4,22,719,301,370,671,"21 de agosto de 1994"
32,4,22,720,220,222,442,"21 de agosto de 1994"
32,4,22,721,175,219,394,"21 de agosto de 1994"
32,4,22,722,291,306,597,"21 de agosto de 1994"
32,4,22,723,271,324,595,"21 de agosto de 1994"
32,4,22,724,151,164,315,"21 de agosto de 1994"
32,4,22,725,290,338,628,"21 de agosto de 1994"
32,4,22,726,288,330,618,"21 de agosto de 1994"
32,4,22,727,156,194,350,"21 de agosto de 1994"
32,4,22,728,219,245,464,"21 de agosto de 1994"
32,4,22,729,187,224,411,"21 de agosto de 1994"
32,4,22,730,247,261,508,"21 de agosto de 1994"
32,4,22,731,70,81,151,"21 de agosto de 1994"
32,4,22,732,91,106,197,"21 de agosto de 1994"
32,4,22,733,183,200,383,"21 de agosto de 1994"
32,4,22,734,115,116,231,"21 de agosto de 1994"
32,4,22,735,101,126,227,"21 de agosto de 1994"
32,4,22,736,166,207,373,"21 de agosto de 1994"
32,4,22,737,161,184,345,"21 de agosto de 1994"
32,4,22,738,57,39,96,"21 de agosto de 1994"
32,4,22,739,167,157,324,"21 de agosto de 1994"
32,4,22,740,81,109,190,"21 de agosto de 1994"
32,4,22,741,25,21,46,"21 de agosto de 1994"
32,4,26,808,176,144,320,"21 de agosto de 1994"
32,4,26,809,250,244,494,"21 de agosto de 1994"
32,4,26,810,203,194,397,"21 de agosto de 1994"
32,4,26,811,212,241,453,"21 de agosto de 1994"
32,4,26,812,52,42,94,"21 de agosto de 1994"
32,4,26,813,71,75,146,"21 de agosto de 1994"
32,4,26,814,76,77,153,"21 de agosto de 1994"
32,4,26,815,35,35,70,"21 de agosto de 1994"
32,4,26,816,164,157,321,"21 de agosto de 1994"
32,4,26,817,166,139,305,"21 de agosto de 1994"
32,4,26,818,65,46,111,"21 de agosto de 1994"
32,4,26,819,78,85,163,"21 de agosto de 1994"
32,4,26,820,192,166,358,"21 de agosto de 1994"
32,4,26,821,95,82,177,"21 de agosto de 1994"
32,4,26,822,171,156,327,"21 de agosto de 1994"
32,4,26,823,127,108,235,"21 de agosto de 1994"
32,4,26,824,111,100,211,"21 de agosto de 1994"
32,4,26,825,32,24,56,"21 de agosto de 1994"
32,4,26,826,89,70,159,"21 de agosto de 1994"
32,4,26,827,170,151,321,"21 de agosto de 1994"
32,4,26,828,98,77,175,"21 de agosto de 1994"
32,4,26,829,55,35,90,"21 de agosto de 1994"
32,4,26,830,35,31,66,"21 de agosto de 1994"
32,4,26,831,125,100,225,"21 de agosto de 1994"
32,4,26,832,88,67,155,"21 de agosto de 1994"
32,4,26,833,70,55,125,"21 de agosto de 1994"
32,4,26,834,83,84,167,"21 de agosto de 1994"
32,4,26,835,76,72,148,"21 de agosto de 1994"
32,4,26,836,122,95,217,"21 de agosto de 1994"
32,4,26,837,121,104,225,"21 de agosto de 1994"
32,4,26,838,94,66,160,"21 de agosto de 1994"
32,4,26,839,41,32,73,"21 de agosto de 1994"
32,4,26,840,31,28,59,"21 de agosto de 1994"
32,4,26,841,228,156,384,"21 de agosto de 1994"
32,4,26,842,90,75,165,"21 de agosto de 1994"
32,4,26,843,56,45,101,"21 de agosto de 1994"
32,4,26,844,154,128,282,"21 de agosto de 1994"
32,4,26,845,131,117,248,"21 de agosto de 1994"
32,4,26,846,63,55,118,"21 de agosto de 1994"
32,4,26,847,56,43,99,"21 de agosto de 1994"
32,4,26,848,38,26,64,"21 de agosto de 1994"
32,4,26,849,58,63,121,"21 de agosto de 1994"
32,4,26,850,67,52,119,"21 de agosto de 1994"
32,4,26,851,79,55,134,"21 de agosto de 1994"
32,4,26,852,26,22,48,"21 de agosto de 1994"
32,4,26,853,83,76,159,"21 de agosto de 1994"
32,4,26,854,44,38,82,"21 de agosto de 1994"
32,4,26,855,26,29,55,"21 de agosto de 1994"
32,4,26,856,34,34,68,"21 de agosto de 1994"
32,4,26,857,28,25,53,"21 de agosto de 1994"
32,4,26,858,37,34,71,"21 de agosto de 1994"
32,4,26,859,108,92,200,"21 de agosto de 1994"
32,4,26,860,75,62,137,"21 de agosto de 1994"
32,4,26,861,69,58,127,"21 de agosto de 1994"
32,4,26,862,53,45,98,"21 de agosto de 1994"
32,4,26,863,64,51,115,"21 de agosto de 1994"
32,4,26,864,39,34,73,"21 de agosto de 1994"
32,4,26,865,43,46,89,"21 de agosto de 1994"
32,4,26,866,79,50,129,"21 de agosto de 1994"
32,4,26,867,79,64,143,"21 de agosto de 1994"
32,4,27,868,208,205,413,"21 de agosto de 1994"
32,4,27,869,174,136,310,"21 de agosto de 1994"
32,4,27,870,56,41,97,"21 de agosto de 1994"
32,4,27,871,85,71,156,"21 de agosto de 1994"
32,4,27,872,37,31,68,"21 de agosto de 1994"
32,4,27,873,126,114,240,"21 de agosto de 1994"
32,4,27,874,95,82,177,"21 de agosto de 1994"
32,4,27,875,45,38,83,"21 de agosto de 1994"
32,4,29,884,273,296,569,"21 de agosto de 1994"
32,4,29,885,311,333,644,"21 de agosto de 1994"
32,4,29,886,175,180,355,"21 de agosto de 1994"
32,4,29,887,192,230,422,"21 de agosto de 1994"
32,4,29,888,236,237,473,"21 de agosto de 1994"
32,4,29,889,150,157,307,"21 de agosto de 1994"
32,4,29,890,260,311,571,"21 de agosto de 1994"
32,4,29,891,282,331,613,"21 de agosto de 1994"
32,4,29,892,265,289,554,"21 de agosto de 1994"
32,4,29,893,199,221,420,"21 de agosto de 1994"
32,4,29,894,327,363,690,"21 de agosto de 1994"
32,4,29,895,173,155,328,"21 de agosto de 1994"
32,4,29,896,151,158,309,"21 de agosto de 1994"
32,4,29,897,109,128,237,"21 de agosto de 1994"
32,4,29,898,124,135,259,"21 de agosto de 1994"
32,4,29,899,129,145,274,"21 de agosto de 1994"
32,4,29,900,192,234,426,"21 de agosto de 1994"
32,4,29,901,201,228,429,"21 de agosto de 1994"
32,4,29,902,29,34,63,"21 de agosto de 1994"
32,4,29,903,99,111,210,"21 de agosto de 1994"
32,4,29,904,140,134,274,"21 de agosto de 1994"
32,4,29,905,24,23,47,"21 de agosto de 1994"
32,4,39,1192,244,268,512,"21 de agosto de 1994"
32,4,39,1193,221,294,515,"21 de agosto de 1994"
32,4,39,1194,189,245,434,"21 de agosto de 1994"
32,4,39,1195,238,268,506,"21 de agosto de 1994"
32,4,39,1196,167,203,370,"21 de agosto de 1994"
32,4,39,1197,174,246,420,"21 de agosto de 1994"
32,4,39,1198,211,238,449,"21 de agosto de 1994"
32,4,39,1199,224,244,468,"21 de agosto de 1994"
32,4,39,1200,378,406,784,"21 de agosto de 1994"
32,4,39,1201,256,319,575,"21 de agosto de 1994"
32,4,39,1202,339,420,759,"21 de agosto de 1994"
32,4,39,1203,191,226,417,"21 de agosto de 1994"
32,4,39,1204,221,218,439,"21 de agosto de 1994"
32,4,39,1205,221,245,466,"21 de agosto de 1994"
32,4,39,1206,260,291,551,"21 de agosto de 1994"
32,4,39,1207,279,314,593,"21 de agosto de 1994"
32,4,39,1208,185,220,405,"21 de agosto de 1994"
32,4,39,1209,219,250,469,"21 de agosto de 1994"
32,4,39,1210,297,388,685,"21 de agosto de 1994"
32,4,39,1211,357,424,781,"21 de agosto de 1994"
32,4,39,1212,308,326,634,"21 de agosto de 1994"
32,4,39,1213,253,294,547,"21 de agosto de 1994"
32,4,39,1214,93,104,197,"21 de agosto de 1994"
32,4,39,1215,277,301,578,"21 de agosto de 1994"
32,4,39,1216,163,177,340,"21 de agosto de 1994"
32,4,39,1217,242,273,515,"21 de agosto de 1994"
32,4,39,1218,192,239,431,"21 de agosto de 1994"
32,4,39,1219,191,272,463,"21 de agosto de 1994"
32,4,39,1220,231,302,533,"21 de agosto de 1994"
32,4,39,1221,195,276,471,"21 de agosto de 1994"
32,4,39,1222,130,152,282,"21 de agosto de 1994"
32,4,39,1223,229,259,488,"21 de agosto de 1994"
32,4,39,1224,162,176,338,"21 de agosto de 1994"
32,4,39,1225,184,212,396,"21 de agosto de 1994"
32,4,39,1226,424,516,940,"21 de agosto de 1994"
32,4,39,1227,203,274,477,"21 de agosto de 1994"
32,4,39,1228,186,222,408,"21 de agosto de 1994"
32,4,39,1229,217,255,472,"21 de agosto de 1994"
32,4,39,1230,176,214,390,"21 de agosto de 1994"
32,4,39,1231,283,348,631,"21 de agosto de 1994"
32,4,39,1232,261,305,566,"21 de agosto de 1994"
32,4,39,1233,213,256,469,"21 de agosto de 1994"
32,4,39,1234,181,262,443,"21 de agosto de 1994"
32,4,39,1235,279,300,579,"21 de agosto de 1994"
32,4,39,1236,261,286,547,"21 de agosto de 1994"
32,4,39,1237,290,313,603,"21 de agosto de 1994"
32,4,39,1238,169,191,360,"21 de agosto de 1994"
32,4,39,1239,151,186,337,"21 de agosto de 1994"
32,4,39,1240,192,309,501,"21 de agosto de 1994"
32,4,39,1241,190,261,451,"21 de agosto de 1994"
32,4,39,1242,253,283,536,"21 de agosto de 1994"
32,4,39,1243,107,149,256,"21 de agosto de 1994"
32,4,39,1244,91,131,222,"21 de agosto de 1994"
32,4,39,1245,159,209,368,"21 de agosto de 1994"
32,4,39,1246,145,206,351,"21 de agosto de 1994"
32,4,39,1247,148,194,342,"21 de agosto de 1994"
32,4,39,1248,123,147,270,"21 de agosto de 1994"
32,4,39,1249,216,290,506,"21 de agosto de 1994"
32,4,39,1250,239,275,514,"21 de agosto de 1994"
32,4,39,1251,104,117,221,"21 de agosto de 1994"
32,4,39,1252,189,187,376,"21 de agosto de 1994"
32,4,39,1253,130,130,260,"21 de agosto de 1994"
32,4,39,1254,23,19,42,"21 de agosto de 1994"
32,4,39,1255,84,86,170,"21 de agosto de 1994"
32,4,40,1256,285,310,595,"21 de agosto de 1994"
32,4,40,1257,190,272,462,"21 de agosto de 1994"
32,4,40,1258,235,274,509,"21 de agosto de 1994"
32,4,40,1259,201,254,455,"21 de agosto de 1994"
32,4,40,1260,198,235,433,"21 de agosto de 1994"
32,4,40,1261,148,159,307,"21 de agosto de 1994"
32,4,40,1262,153,175,328,"21 de agosto de 1994"
32,4,40,1263,136,148,284,"21 de agosto de 1994"
32,4,40,1264,143,171,314,"21 de agosto de 1994"
32,4,40,1265,138,140,278,"21 de agosto de 1994"
32,4,40,1266,275,311,586,"21 de agosto de 1994"
32,4,40,1267,72,96,168,"21 de agosto de 1994"
32,4,40,1268,191,191,382,"21 de agosto de 1994"
32,4,40,1269,229,231,460,"21 de agosto de 1994"
32,4,40,1270,234,251,485,"21 de agosto de 1994"
32,4,40,1271,167,194,361,"21 de agosto de 1994"
32,4,40,1272,96,129,225,"21 de agosto de 1994"
32,4,40,1273,246,297,543,"21 de agosto de 1994"
32,4,40,1274,188,217,405,"21 de agosto de 1994"
32,4,40,1275,95,97,192,"21 de agosto de 1994"
32,4,40,1276,156,143,299,"21 de agosto de 1994"
32,4,40,1277,238,269,507,"21 de agosto de 1994"
32,4,40,1278,236,239,475,"21 de agosto de 1994"
32,4,40,1279,127,135,262,"21 de agosto de 1994"
32,4,40,1280,88,98,186,"21 de agosto de 1994"
32,4,40,1281,118,119,237,"21 de agosto de 1994"
32,4,40,1282,61,58,119,"21 de agosto de 1994"
32,4,41,1283,174,145,319,"21 de agosto de 1994"
32,4,41,1284,197,165,362,"21 de agosto de 1994"
32,4,41,1285,51,37,88,"21 de agosto de 1994"
32,4,41,1286,298,296,594,"21 de agosto de 1994"
32,4,41,1287,134,116,250,"21 de agosto de 1994"
32,4,41,1288,49,38,87,"21 de agosto de 1994"
32,4,51,1609,254,242,496,"21 de agosto de 1994"
32,4,51,1610,281,282,563,"21 de agosto de 1994"
32,4,51,1611,248,271,519,"21 de agosto de 1994"
32,4,51,1612,230,241,471,"21 de agosto de 1994"
32,4,51,1613,349,339,688,"21 de agosto de 1994"
32,4,51,1614,314,277,591,"21 de agosto de 1994"
32,4,51,1615,297,282,579,"21 de agosto de 1994"
32,4,51,1616,98,87,185,"21 de agosto de 1994"
32,4,51,1617,63,45,108,"21 de agosto de 1994"
32,4,51,1618,317,303,620,"21 de agosto de 1994"
32,4,51,1619,123,98,221,"21 de agosto de 1994"
32,4,51,1620,87,65,152,"21 de agosto de 1994"
32,4,51,1621,149,122,271,"21 de agosto de 1994"
32,4,51,1622,163,161,324,"21 de agosto de 1994"
32,4,51,1623,81,70,151,"21 de agosto de 1994"
32,4,51,1624,240,212,452,"21 de agosto de 1994"
32,4,51,1625,54,58,112,"21 de agosto de 1994"
32,4,51,1626,93,95,188,"21 de agosto de 1994"
32,4,51,1627,280,232,512,"21 de agosto de 1994"
32,4,51,1628,179,179,358,"21 de agosto de 1994"
32,4,51,1629,156,132,288,"21 de agosto de 1994"
32,4,51,1630,72,64,136,"21 de agosto de 1994"
32,4,51,1631,159,156,315,"21 de agosto de 1994"
32,4,51,1632,245,217,462,"21 de agosto de 1994"
32,4,51,1633,208,197,405,"21 de agosto de 1994"
32,4,51,1634,215,197,412,"21 de agosto de 1994"
32,4,51,1635,216,220,436,"21 de agosto de 1994"
32,4,51,1636,240,204,444,"21 de agosto de 1994"
32,4,51,1637,240,194,434,"21 de agosto de 1994"
32,4,51,1638,242,216,458,"21 de agosto de 1994"
32,4,51,1639,180,147,327,"21 de agosto de 1994"
32,4,51,1640,250,227,477,"21 de agosto de 1994"
32,4,51,1641,238,226,464,"21 de agosto de 1994"
32,4,51,1642,124,109,233,"21 de agosto de 1994"
32,4,51,1643,123,110,233,"21 de agosto de 1994"
32,4,51,1644,56,42,98,"21 de agosto de 1994"
32,4,51,1645,63,61,124,"21 de agosto de 1994"
32,4,51,1646,59,56,115,"21 de agosto de 1994"
32,4,51,1647,75,64,139,"21 de agosto de 1994"
32,4,51,1648,64,58,122,"21 de agosto de 1994"
32,4,51,1649,45,34,79,"21 de agosto de 1994"
32,4,51,1650,114,103,217,"21 de agosto de 1994"
32,4,51,1651,30,21,51,"21 de agosto de 1994"
32,4,51,1652,110,91,201,"21 de agosto de 1994"
32,4,51,1653,136,127,263,"21 de agosto de 1994"
32,4,51,1654,194,158,352,"21 de agosto de 1994"
32,4,51,1655,93,80,173,"21 de agosto de 1994"
32,4,51,1656,66,60,126,"21 de agosto de 1994"
32,4,51,1657,41,35,76,"21 de agosto de 1994"
32,4,51,1658,50,43,93,"21 de agosto de 1994"
32,5,8,103,300,363,663,"21 de agosto de 1994"
32,5,8,104,260,263,523,"21 de agosto de 1994"
32,5,8,105,349,367,716,"21 de agosto de 1994"
32,5,8,106,276,314,590,"21 de agosto de 1994"
32,5,8,107,264,276,540,"21 de agosto de 1994"
32,5,8,108,254,246,500,"21 de agosto de 1994"
32,5,8,109,128,164,292,"21 de agosto de 1994"
32,5,8,110,142,179,321,"21 de agosto de 1994"
32,5,8,111,131,156,287,"21 de agosto de 1994"
32,5,8,112,253,254,507,"21 de agosto de 1994"
32,5,8,113,89,77,166,"21 de agosto de 1994"
32,5,12,359,155,190,345,"21 de agosto de 1994"
32,5,12,360,80,81,161,"21 de agosto de 1994"
32,5,12,361,154,163,317,"21 de agosto de 1994"
32,5,12,362,112,101,213,"21 de agosto de 1994"
32,5,12,363,29,33,62,"21 de agosto de 1994"
32,5,12,364,276,276,552,"21 de agosto de 1994"
32,5,12,365,122,123,245,"21 de agosto de 1994"
32,5,12,366,83,79,162,"21 de agosto de 1994"
32,5,12,367,31,29,60,"21 de agosto de 1994"
32,5,12,368,52,44,96,"21 de agosto de 1994"
32,5,12,369,205,193,398,"21 de agosto de 1994"
32,5,12,370,121,129,250,"21 de agosto de 1994"
32,5,12,371,65,71,136,"21 de agosto de 1994"
32,5,12,372,57,42,99,"21 de agosto de 1994"
32,5,12,373,57,54,111,"21 de agosto de 1994"
32,5,12,374,79,91,170,"21 de agosto de 1994"
32,5,12,375,64,75,139,"21 de agosto de 1994"
32,5,12,376,43,48,91,"21 de agosto de 1994"
32,5,12,377,51,58,109,"21 de agosto de 1994"
32,5,16,436,228,270,498,"21 de agosto de 1994"
32,5,16,437,271,322,593,"21 de agosto de 1994"
32,5,16,438,246,272,518,"21 de agosto de 1994"
32,5,16,439,262,297,559,"21 de agosto de 1994"
32,5,16,440,165,180,345,"21 de agosto de 1994"
32,5,16,441,406,449,855,"21 de agosto de 1994"
32,5,16,442,296,336,632,"21 de agosto de 1994"
32,5,16,443,111,122,233,"21 de agosto de 1994"
32,5,16,444,148,169,317,"21 de agosto de 1994"
32,5,16,445,319,306,625,"21 de agosto de 1994"
32,5,16,446,218,184,402,"21 de agosto de 1994"
32,5,16,447,292,271,563,"21 de agosto de 1994"
32,5,16,448,248,225,473,"21 de agosto de 1994"
32,5,16,449,184,190,374,"21 de agosto de 1994"
32,5,16,450,213,247,460,"21 de agosto de 1994"
32,5,16,451,174,195,369,"21 de agosto de 1994"
32,5,16,452,263,279,542,"21 de agosto de 1994"
32,5,16,453,195,231,426,"21 de agosto de 1994"
32,5,16,454,134,153,287,"21 de agosto de 1994"
32,5,16,455,219,251,470,"21 de agosto de 1994"
32,5,16,456,215,274,489,"21 de agosto de 1994"
32,5,16,457,90,94,184,"21 de agosto de 1994"
32,5,16,458,121,117,238,"21 de agosto de 1994"
32,5,16,459,200,222,422,"21 de agosto de 1994"
32,5,17,460,189,215,404,"21 de agosto de 1994"
32,5,17,461,239,280,519,"21 de agosto de 1994"
32,5,17,462,204,227,431,"21 de agosto de 1994"
32,5,17,463,213,281,494,"21 de agosto de 1994"
32,5,17,464,259,291,550,"21 de agosto de 1994"
32,5,17,465,271,294,565,"21 de agosto de 1994"
32,5,17,466,304,384,688,"21 de agosto de 1994"
32,5,17,467,278,325,603,"21 de agosto de 1994"
32,5,17,468,226,261,487,"21 de agosto de 1994"
32,5,17,469,279,308,587,"21 de agosto de 1994"
32,5,17,470,327,357,684,"21 de agosto de 1994"
32,5,17,471,354,402,756,"21 de agosto de 1994"
32,5,17,472,359,382,741,"21 de agosto de 1994"
32,5,17,473,291,355,646,"21 de agosto de 1994"
32,5,17,474,213,222,435,"21 de agosto de 1994"
32,5,17,475,301,321,622,"21 de agosto de 1994"
32,5,17,476,222,260,482,"21 de agosto de 1994"
32,5,17,477,190,232,422,"21 de agosto de 1994"
32,5,17,478,214,254,468,"21 de agosto de 1994"
32,5,17,479,260,310,570,"21 de agosto de 1994"
32,5,17,480,192,234,426,"21 de agosto de 1994"
32,5,17,481,186,229,415,"21 de agosto de 1994"
32,5,17,482,284,330,614,"21 de agosto de 1994"
32,5,17,483,264,318,582,"21 de agosto de 1994"
32,5,17,484,282,324,606,"21 de agosto de 1994"
32,5,17,485,354,360,714,"21 de agosto de 1994"
32,5,17,486,305,338,643,"21 de agosto de 1994"
32,5,17,487,362,402,764,"21 de agosto de 1994"
32,5,17,488,310,325,635,"21 de agosto de 1994"
32,5,17,489,223,224,447,"21 de agosto de 1994"
32,5,17,490,285,313,598,"21 de agosto de 1994"
32,5,17,491,127,141,268,"21 de agosto de 1994"
32,5,17,492,428,467,895,"21 de agosto de 1994"
32,5,17,493,390,408,798,"21 de agosto de 1994"
32,5,17,494,415,459,874,"21 de agosto de 1994"
32,5,17,495,259,327,586,"21 de agosto de 1994"
32,5,17,496,176,218,394,"21 de agosto de 1994"
32,5,17,497,114,138,252,"21 de agosto de 1994"
32,5,17,498,161,196,357,"21 de agosto de 1994"
32,5,17,499,264,328,592,"21 de agosto de 1994"
32,5,17,500,192,241,433,"21 de agosto de 1994"
32,5,17,501,179,196,375,"21 de agosto de 1994"
32,5,17,502,315,337,652,"21 de agosto de 1994"
32,5,17,503,284,332,616,"21 de agosto de 1994"
32,5,17,504,369,352,721,"21 de agosto de 1994"
32,5,17,505,246,263,509,"21 de agosto de 1994"
32,5,17,506,297,321,618,"21 de agosto de 1994"
32,5,17,507,436,455,891,"21 de agosto de 1994"
32,5,17,508,412,463,875,"21 de agosto de 1994"
32,5,17,509,339,372,711,"21 de agosto de 1994"
32,5,17,510,310,333,643,"21 de agosto de 1994"
32,5,17,511,193,183,376,"21 de agosto de 1994"
32,5,17,512,357,388,745,"21 de agosto de 1994"
32,5,17,513,210,214,424,"21 de agosto de 1994"
32,5,17,514,313,257,570,"21 de agosto de 1994"
32,5,17,515,239,242,481,"21 de agosto de 1994"
32,5,17,516,186,190,376,"21 de agosto de 1994"
32,5,17,517,261,269,530,"21 de agosto de 1994"
32,5,17,518,339,331,670,"21 de agosto de 1994"
32,5,17,519,339,341,680,"21 de agosto de 1994"
32,5,17,520,306,335,641,"21 de agosto de 1994"
32,5,17,521,266,255,521,"21 de agosto de 1994"
32,5,17,522,359,383,742,"21 de agosto de 1994"
32,5,17,523,371,400,771,"21 de agosto de 1994"
32,5,17,524,396,412,808,"21 de agosto de 1994"
32,5,17,525,104,82,186,"21 de agosto de 1994"
32,5,17,526,154,144,298,"21 de agosto de 1994"
32,5,17,527,364,391,755,"21 de agosto de 1994"
32,5,17,528,368,374,742,"21 de agosto de 1994"
32,5,17,529,333,343,676,"21 de agosto de 1994"
32,5,17,530,344,347,691,"21 de agosto de 1994"
32,5,17,531,353,385,738,"21 de agosto de 1994"
32,5,17,532,367,391,758,"21 de agosto de 1994"
32,5,17,533,274,288,562,"21 de agosto de 1994"
32,5,17,534,190,185,375,"21 de agosto de 1994"
32,5,17,535,265,241,506,"21 de agosto de 1994"
32,5,17,536,248,229,477,"21 de agosto de 1994"
32,5,17,537,268,244,512,"21 de agosto de 1994"
32,5,17,538,68,66,134,"21 de agosto de 1994"
32,5,17,539,233,251,484,"21 de agosto de 1994"
32,5,17,540,187,194,381,"21 de agosto de 1994"
32,5,17,541,178,208,386,"21 de agosto de 1994"
32,5,17,542,328,402,730,"21 de agosto de 1994"
32,5,17,543,312,313,625,"21 de agosto de 1994"
32,5,17,544,40,39,79,"21 de agosto de 1994"
32,5,17,545,88,86,174,"21 de agosto de 1994"
32,5,17,546,72,74,146,"21 de agosto de 1994"
32,5,17,547,117,115,232,"21 de agosto de 1994"
32,5,17,548,36,34,70,"21 de agosto de 1994"
32,5,17,549,39,33,72,"21 de agosto de 1994"
32,5,17,550,539,44,583,"21 de agosto de 1994"
32,5,17,551,145,147,292,"21 de agosto de 1994"
32,5,24,763,398,404,802,"21 de agosto de 1994"
32,5,24,764,350,401,751,"21 de agosto de 1994"
32,5,24,765,377,419,796,"21 de agosto de 1994"
32,5,24,766,394,423,817,"21 de agosto de 1994"
32,5,24,767,307,357,664,"21 de agosto de 1994"
32,5,24,768,304,301,605,"21 de agosto de 1994"
32,5,24,769,323,339,662,"21 de agosto de 1994"
32,5,24,770,139,160,299,"21 de agosto de 1994"
32,5,24,771,148,136,284,"21 de agosto de 1994"
32,5,24,772,319,340,659,"21 de agosto de 1994"
32,5,24,773,276,325,601,"21 de agosto de 1994"
32,5,24,774,355,341,696,"21 de agosto de 1994"
32,5,24,775,285,326,611,"21 de agosto de 1994"
32,5,24,776,183,172,355,"21 de agosto de 1994"
32,5,24,777,301,327,628,"21 de agosto de 1994"
32,5,24,778,253,259,512,"21 de agosto de 1994"
32,5,24,779,258,247,505,"21 de agosto de 1994"
32,5,24,780,328,343,671,"21 de agosto de 1994"
32,5,24,781,263,247,510,"21 de agosto de 1994"
32,5,24,782,275,259,534,"21 de agosto de 1994"
32,5,24,783,164,187,351,"21 de agosto de 1994"
32,5,24,784,167,191,358,"21 de agosto de 1994"
32,5,24,785,193,191,384,"21 de agosto de 1994"
32,5,24,786,291,301,592,"21 de agosto de 1994"
32,5,24,787,269,233,502,"21 de agosto de 1994"
32,5,24,788,268,255,523,"21 de agosto de 1994"
32,5,24,789,263,251,514,"21 de agosto de 1994"
32,5,24,790,300,282,582,"21 de agosto de 1994"
32,5,24,791,228,244,472,"21 de agosto de 1994"
32,5,24,792,440,400,840,"21 de agosto de 1994"
32,5,24,793,113,101,214,"21 de agosto de 1994"
32,5,25,794,295,343,638,"21 de agosto de 1994"
32,5,25,795,272,319,591,"21 de agosto de 1994"
32,5,25,796,221,252,473,"21 de agosto de 1994"
32,5,25,797,250,280,530,"21 de agosto de 1994"
32,5,25,798,365,412,777,"21 de agosto de 1994"
32,5,25,799,188,202,390,"21 de agosto de 1994"
32,5,25,800,250,246,496,"21 de agosto de 1994"
32,5,25,801,41,35,76,"21 de agosto de 1994"
32,5,25,802,243,267,510,"21 de agosto de 1994"
32,5,25,803,216,217,433,"21 de agosto de 1994"
32,5,25,804,130,117,247,"21 de agosto de 1994"
32,5,25,805,264,261,525,"21 de agosto de 1994"
32,5,25,806,129,148,277,"21 de agosto de 1994"
32,5,25,807,19,23,42,"21 de agosto de 1994"
32,5,32,945,339,350,689,"21 de agosto de 1994"
32,5,32,946,391,391,782,"21 de agosto de 1994"
32,5,32,947,372,382,754,"21 de agosto de 1994"
32,5,32,948,254,249,503,"21 de agosto de 1994"
32,5,32,949,223,195,418,"21 de agosto de 1994"
32,5,32,950,30,28,58,"21 de agosto de 1994"
32,5,32,951,254,251,505,"21 de agosto de 1994"
32,5,32,952,458,469,927,"21 de agosto de 1994"
32,5,32,953,255,251,506,"21 de agosto de 1994"
32,5,35,1020,218,208,426,"21 de agosto de 1994"
32,5,35,1021,280,263,543,"21 de agosto de 1994"
32,5,35,1022,197,211,408,"21 de agosto de 1994"
32,5,35,1023,141,157,298,"21 de agosto de 1994"
32,5,35,1024,263,292,555,"21 de agosto de 1994"
32,5,35,1025,194,219,413,"21 de agosto de 1994"
32,5,35,1026,218,261,479,"21 de agosto de 1994"
32,5,35,1027,83,113,196,"21 de agosto de 1994"
32,5,35,1028,208,218,426,"21 de agosto de 1994"
32,5,35,1029,188,195,383,"21 de agosto de 1994"
32,5,35,1030,395,410,805,"21 de agosto de 1994"
32,5,35,1031,274,280,554,"21 de agosto de 1994"
32,5,35,1032,135,141,276,"21 de agosto de 1994"
32,5,35,1033,229,227,456,"21 de agosto de 1994"
32,5,35,1034,113,98,211,"21 de agosto de 1994"
32,5,35,1035,46,45,91,"21 de agosto de 1994"
32,5,36,1036,223,252,475,"21 de agosto de 1994"
32,5,36,1037,347,359,706,"21 de agosto de 1994"
32,5,36,1038,245,290,535,"21 de agosto de 1994"
32,5,36,1039,236,261,497,"21 de agosto de 1994"
32,5,36,1040,228,292,520,"21 de agosto de 1994"
32,5,36,1041,273,301,574,"21 de agosto de 1994"
32,5,36,1042,296,310,606,"21 de agosto de 1994"
32,5,36,1043,344,377,721,"21 de agosto de 1994"
32,5,36,1044,325,390,715,"21 de agosto de 1994"
32,5,36,1045,321,348,669,"21 de agosto de 1994"
32,5,36,1046,268,285,553,"21 de agosto de 1994"
32,5,36,1047,362,391,753,"21 de agosto de 1994"
32,5,36,1048,239,245,484,"21 de agosto de 1994"
32,5,36,1049,207,220,427,"21 de agosto de 1994"
32,5,36,1050,136,127,263,"21 de agosto de 1994"
32,5,36,1051,267,250,517,"21 de agosto de 1994"
32,5,36,1052,156,166,322,"21 de agosto de 1994"
32,5,36,1053,186,192,378,"21 de agosto de 1994"
32,5,36,1054,152,150,302,"21 de agosto de 1994"
32,5,36,1055,111,126,237,"21 de agosto de 1994"
32,5,36,1056,208,228,436,"21 de agosto de 1994"
32,5,36,1057,225,252,477,"21 de agosto de 1994"
32,5,36,1058,273,266,539,"21 de agosto de 1994"
32,5,36,1059,161,153,314,"21 de agosto de 1994"
32,5,36,1060,266,267,533,"21 de agosto de 1994"
32,5,36,1061,53,49,102,"21 de agosto de 1994"
32,5,36,1062,95,92,187,"21 de agosto de 1994"
32,5,36,1063,126,135,261,"21 de agosto de 1994"
32,5,36,1064,169,186,355,"21 de agosto de 1994"
32,5,36,1065,114,113,227,"21 de agosto de 1994"
32,5,36,1066,274,292,566,"21 de agosto de 1994"
32,5,36,1067,385,374,759,"21 de agosto de 1994"
32,5,36,1068,119,163,282,"21 de agosto de 1994"
32,5,36,1069,160,198,358,"21 de agosto de 1994"
32,5,36,1070,124,151,275,"21 de agosto de 1994"
32,5,36,1071,101,104,205,"21 de agosto de 1994"
32,5,36,1072,72,79,151,"21 de agosto de 1994"
32,5,36,1073,223,237,460,"21 de agosto de 1994"
32,5,36,1074,59,55,114,"21 de agosto de 1994"
32,5,36,1075,66,60,126,"21 de agosto de 1994"
32,5,36,1076,84,80,164,"21 de agosto de 1994"
32,5,36,1077,32,31,63,"21 de agosto de 1994"
32,5,36,1078,45,45,90,"21 de agosto de 1994"
32,5,36,1079,38,36,74,"21 de agosto de 1994"
32,5,37,1080,265,282,547,"21 de agosto de 1994"
32,5,37,1081,247,250,497,"21 de agosto de 1994"
32,5,37,1082,339,351,690,"21 de agosto de 1994"
32,5,37,1083,47,34,81,"21 de agosto de 1994"
32,5,37,1084,216,199,415,"21 de agosto de 1994"
32,5,37,1085,88,89,177,"21 de agosto de 1994"
32,5,37,1086,346,318,664,"21 de agosto de 1994"
32,5,37,1087,417,351,768,"21 de agosto de 1994"
32,5,37,1088,327,302,629,"21 de agosto de 1994"
32,5,37,1089,360,350,710,"21 de agosto de 1994"
32,5,37,1090,406,405,811,"21 de agosto de 1994"
32,5,37,1091,303,315,618,"21 de agosto de 1994"
32,5,37,1092,99,103,202,"21 de agosto de 1994"
32,5,37,1093,125,118,243,"21 de agosto de 1994"
32,5,38,1094,235,247,482,"21 de agosto de 1994"
32,5,38,1095,196,209,405,"21 de agosto de 1994"
32,5,38,1096,211,249,460,"21 de agosto de 1994"
32,5,38,1097,347,363,710,"21 de agosto de 1994"
32,5,38,1098,84,86,170,"21 de agosto de 1994"
32,5,38,1099,221,216,437,"21 de agosto de 1994"
32,5,38,1100,245,295,540,"21 de agosto de 1994"
32,5,38,1101,71,83,154,"21 de agosto de 1994"
32,5,38,1102,80,84,164,"21 de agosto de 1994"
32,5,38,1103,59,49,108,"21 de agosto de 1994"
32,5,38,1104,40,45,85,"21 de agosto de 1994"
32,5,38,1105,69,44,113,"21 de agosto de 1994"
32,5,38,1106,280,238,518,"21 de agosto de 1994"
32,5,38,1107,196,193,389,"21 de agosto de 1994"
32,5,38,1108,178,180,358,"21 de agosto de 1994"
32,5,38,1109,328,327,655,"21 de agosto de 1994"
32,5,38,1110,192,186,378,"21 de agosto de 1994"
32,5,38,1111,251,249,500,"21 de agosto de 1994"
32,5,38,1112,145,129,274,"21 de agosto de 1994"
32,5,38,1113,122,115,237,"21 de agosto de 1994"
32,5,38,1114,124,116,240,"21 de agosto de 1994"
32,5,38,1115,330,343,673,"21 de agosto de 1994"
32,5,38,1116,147,154,301,"21 de agosto de 1994"
32,5,38,1117,113,95,208,"21 de agosto de 1994"
32,5,38,1118,203,266,469,"21 de agosto de 1994"
32,5,38,1119,309,222,531,"21 de agosto de 1994"
32,5,38,1120,297,314,611,"21 de agosto de 1994"
32,5,38,1121,273,336,609,"21 de agosto de 1994"
32,5,38,1122,78,63,141,"21 de agosto de 1994"
32,5,38,1123,253,279,532,"21 de agosto de 1994"
32,5,38,1124,149,155,304,"21 de agosto de 1994"
32,5,38,1125,199,208,407,"21 de agosto de 1994"
32,5,38,1126,100,112,212,"21 de agosto de 1994"
32,5,38,1127,321,336,657,"21 de agosto de 1994"
32,5,38,1128,155,144,299,"21 de agosto de 1994"
32,5,38,1129,160,144,304,"21 de agosto de 1994"
32,5,38,1130,187,191,378,"21 de agosto de 1994"
32,5,38,1131,305,307,612,"21 de agosto de 1994"
32,5,38,1132,122,146,268,"21 de agosto de 1994"
32,5,38,1133,79,92,171,"21 de agosto de 1994"
32,5,38,1134,256,269,525,"21 de agosto de 1994"
32,5,38,1135,230,232,462,"21 de agosto de 1994"
32,5,38,1136,145,152,297,"21 de agosto de 1994"
32,5,38,1137,137,171,308,"21 de agosto de 1994"
32,5,38,1138,293,261,554,"21 de agosto de 1994"
32,5,38,1139,220,240,460,"21 de agosto de 1994"
32,5,38,1140,89,84,173,"21 de agosto de 1994"
32,5,38,1141,79,70,149,"21 de agosto de 1994"
32,5,38,1142,142,143,285,"21 de agosto de 1994"
32,5,38,1143,170,207,377,"21 de agosto de 1994"
32,5,38,1144,201,253,454,"21 de agosto de 1994"
32,5,38,1145,108,126,234,"21 de agosto de 1994"
32,5,38,1146,89,98,187,"21 de agosto de 1994"
32,5,38,1147,185,246,431,"21 de agosto de 1994"
32,5,38,1148,125,133,258,"21 de agosto de 1994"
32,5,38,1149,115,96,211,"21 de agosto de 1994"
32,5,38,1150,132,141,273,"21 de agosto de 1994"
32,5,38,1151,202,217,419,"21 de agosto de 1994"
32,5,38,1152,214,277,491,"21 de agosto de 1994"
32,5,38,1153,84,105,189,"21 de agosto de 1994"
32,5,38,1154,129,156,285,"21 de agosto de 1994"
32,5,38,1155,182,193,375,"21 de agosto de 1994"
32,5,38,1156,56,44,100,"21 de agosto de 1994"
32,5,38,1157,110,110,220,"21 de agosto de 1994"
32,5,38,1158,73,67,140,"21 de agosto de 1994"
32,5,38,1159,224,240,464,"21 de agosto de 1994"
32,5,38,1160,105,115,220,"21 de agosto de 1994"
32,5,38,1161,76,77,153,"21 de agosto de 1994"
32,5,38,1162,77,87,164,"21 de agosto de 1994"
32,5,38,1163,60,64,124,"21 de agosto de 1994"
32,5,38,1164,125,113,238,"21 de agosto de 1994"
32,5,38,1165,96,86,182,"21 de agosto de 1994"
32,5,38,1166,63,59,122,"21 de agosto de 1994"
32,5,38,1167,54,63,117,"21 de agosto de 1994"
32,5,38,1168,26,28,54,"21 de agosto de 1994"
32,5,38,1169,198,184,382,"21 de agosto de 1994"
32,5,38,1170,71,75,146,"21 de agosto de 1994"
32,5,38,1171,136,156,292,"21 de agosto de 1994"
32,5,38,1172,72,66,138,"21 de agosto de 1994"
32,5,38,1173,45,42,87,"21 de agosto de 1994"
32,5,38,1174,88,81,169,"21 de agosto de 1994"
32,5,38,1175,70,63,133,"21 de agosto de 1994"
32,5,38,1176,108,100,208,"21 de agosto de 1994"
32,5,38,1177,61,65,126,"21 de agosto de 1994"
32,5,38,1178,51,59,110,"21 de agosto de 1994"
32,5,38,1179,71,76,147,"21 de agosto de 1994"
32,5,38,1180,106,89,195,"21 de agosto de 1994"
32,5,38,1181,50,52,102,"21 de agosto de 1994"
32,5,38,1182,96,84,180,"21 de agosto de 1994"
32,5,38,1183,55,56,111,"21 de agosto de 1994"
32,5,38,1184,33,36,69,"21 de agosto de 1994"
32,5,38,1185,65,57,122,"21 de agosto de 1994"
32,5,38,1186,71,67,138,"21 de agosto de 1994"
32,5,38,1187,62,53,115,"21 de agosto de 1994"
32,5,38,1188,64,59,123,"21 de agosto de 1994"
32,5,38,1189,41,44,85,"21 de agosto de 1994"
32,5,38,1190,113,117,230,"21 de agosto de 1994"
32,5,38,1191,65,68,133,"21 de agosto de 1994"
32,5,50,1601,233,232,465,"21 de agosto de 1994"
32,5,50,1602,219,232,451,"21 de agosto de 1994"
32,5,50,1603,359,365,724,"21 de agosto de 1994"
32,5,50,1604,236,228,464,"21 de agosto de 1994"
32,5,50,1605,66,54,120,"21 de agosto de 1994"
32,5,50,1606,317,362,679,"21 de agosto de 1994"
32,5,50,1607,254,270,524,"21 de agosto de 1994"
32,5,50,1608,359,355,714,"21 de agosto de 1994"
32,5,52,1659,413,412,825,"21 de agosto de 1994"
32,5,52,1660,296,336,632,"21 de agosto de 1994"
32,5,52,1661,350,361,711,"21 de agosto de 1994"
32,5,52,1662,359,381,740,"21 de agosto de 1994"
32,5,52,1663,133,109,242,"21 de agosto de 1994"
32,5,52,1664,207,173,380,"21 de agosto de 1994"
32,5,52,1665,208,182,390,"21 de agosto de 1994"
32,5,52,1666,124,140,264,"21 de agosto de 1994"
32,5,52,1667,215,220,435,"21 de agosto de 1994"
32,5,52,1668,253,255,508,"21 de agosto de 1994"
32,5,52,1669,108,97,205,"21 de agosto de 1994"
32,5,52,1670,151,149,300,"21 de agosto de 1994"
32,5,52,1671,236,232,468,"21 de agosto de 1994"
32,5,52,1672,65,63,128,"21 de agosto de 1994"
32,5,52,1673,231,255,486,"21 de agosto de 1994"
32,5,52,1674,46,50,96,"21 de agosto de 1994"
32,5,53,1675,247,311,558,"21 de agosto de 1994"
32,5,53,1676,261,259,520,"21 de agosto de 1994"
32,5,53,1677,287,334,621,"21 de agosto de 1994"
32,5,53,1678,280,285,565,"21 de agosto de 1994"
32,5,53,1679,165,193,358,"21 de agosto de 1994"
32,5,53,1680,311,317,628,"21 de agosto de 1994"
32,5,53,1681,228,233,461,"21 de agosto de 1994"
32,5,53,1682,96,111,207,"21 de agosto de 1994"
32,5,53,1683,161,239,400,"21 de agosto de 1994"
32,5,53,1684,122,181,303,"21 de agosto de 1994"
32,5,53,1685,142,198,340,"21 de agosto de 1994"
32,5,53,1686,180,259,439,"21 de agosto de 1994"
32,5,54,1687,374,403,777,"21 de agosto de 1994"
32,5,54,1688,329,320,649,"21 de agosto de 1994"
32,5,54,1689,278,263,541,"21 de agosto de 1994"
32,5,54,1690,124,131,255,"21 de agosto de 1994"
32,5,54,1691,238,241,479,"21 de agosto de 1994"
32,5,54,1692,127,141,268,"21 de agosto de 1994"
32,5,54,1693,198,218,416,"21 de agosto de 1994"
32,5,54,1694,131,123,254,"21 de agosto de 1994"
32,5,54,1695,170,161,331,"21 de agosto de 1994"
32,5,54,1696,158,141,299,"21 de agosto de 1994"
32,5,54,1697,149,135,284,"21 de agosto de 1994"
32,5,54,1698,76,72,148,"21 de agosto de 1994"
32,5,54,1699,293,257,550,"21 de agosto de 1994"
32,5,54,1700,318,351,669,"21 de agosto de 1994"
32,5,54,1701,92,94,186,"21 de agosto de 1994"
32,5,54,1702,98,83,181,"21 de agosto de 1994"
32,5,54,1703,61,55,116,"21 de agosto de 1994"
32,5,54,1704,32,32,64,"21 de agosto de 1994"
32,5,54,1705,52,49,101,"21 de agosto de 1994"
32,5,54,1706,27,21,48,"21 de agosto de 1994"
32,5,54,1707,71,57,128,"21 de agosto de 1994"
32,5,54,1708,86,81,167,"21 de agosto de 1994"
32,5,54,1709,95,79,174,"21 de agosto de 1994"
32,5,54,1710,155,142,297,"21 de agosto de 1994"
