"ESTADO","DISTRITO","MUNICIPIO","SECCION","LISTA_HOMBRES","LISTA_MUJERES","LISTA","FECHA"
1,1,2,338,507,551,1058,"6 de julio de 1997"
1,1,2,339,486,524,1010,"6 de julio de 1997"
1,1,2,340,454,430,884,"6 de julio de 1997"
1,1,2,341,447,465,912,"6 de julio de 1997"
1,1,2,342,398,381,779,"6 de julio de 1997"
1,1,2,343,765,769,1534,"6 de julio de 1997"
1,1,2,344,645,668,1313,"6 de julio de 1997"
1,1,2,345,628,678,1306,"6 de julio de 1997"
1,1,2,346,506,489,995,"6 de julio de 1997"
1,1,2,347,659,711,1370,"6 de julio de 1997"
1,1,2,348,366,410,776,"6 de julio de 1997"
1,1,2,349,546,651,1197,"6 de julio de 1997"
1,1,2,350,649,623,1272,"6 de julio de 1997"
1,1,2,351,441,463,904,"6 de julio de 1997"
1,1,2,352,681,714,1395,"6 de julio de 1997"
1,1,2,353,420,436,856,"6 de julio de 1997"
1,1,2,354,470,438,908,"6 de julio de 1997"
1,1,3,355,350,412,762,"6 de julio de 1997"
1,1,3,356,756,846,1602,"6 de julio de 1997"
1,1,3,357,563,660,1223,"6 de julio de 1997"
1,1,3,358,786,651,1437,"6 de julio de 1997"
1,1,3,359,374,486,860,"6 de julio de 1997"
1,1,3,360,321,377,698,"6 de julio de 1997"
1,1,3,361,646,749,1395,"6 de julio de 1997"
1,1,3,362,694,776,1470,"6 de julio de 1997"
1,1,3,363,395,442,837,"6 de julio de 1997"
1,1,3,364,219,309,528,"6 de julio de 1997"
1,1,3,365,135,167,302,"6 de julio de 1997"
1,1,3,366,211,240,451,"6 de julio de 1997"
1,1,3,367,517,690,1207,"6 de julio de 1997"
1,1,3,368,30,40,70,"6 de julio de 1997"
1,1,3,369,164,187,351,"6 de julio de 1997"
1,1,3,370,389,489,878,"6 de julio de 1997"
1,1,3,371,287,359,646,"6 de julio de 1997"
1,1,3,372,254,302,556,"6 de julio de 1997"
1,1,3,373,180,179,359,"6 de julio de 1997"
1,1,3,374,338,407,745,"6 de julio de 1997"
1,1,3,375,393,477,870,"6 de julio de 1997"
1,1,3,376,523,648,1171,"6 de julio de 1997"
1,1,3,377,483,568,1051,"6 de julio de 1997"
1,1,3,378,120,134,254,"6 de julio de 1997"
1,1,3,379,517,595,1112,"6 de julio de 1997"
1,1,3,380,508,543,1051,"6 de julio de 1997"
1,1,3,381,244,329,573,"6 de julio de 1997"
1,1,3,382,513,685,1198,"6 de julio de 1997"
1,1,3,383,516,629,1145,"6 de julio de 1997"
1,1,3,384,268,344,612,"6 de julio de 1997"
1,1,3,385,404,586,990,"6 de julio de 1997"
1,1,3,386,478,590,1068,"6 de julio de 1997"
1,1,4,387,777,807,1584,"6 de julio de 1997"
1,1,4,388,641,715,1356,"6 de julio de 1997"
1,1,4,389,644,672,1316,"6 de julio de 1997"
1,1,4,390,625,587,1212,"6 de julio de 1997"
1,1,4,391,665,648,1313,"6 de julio de 1997"
1,1,5,392,629,682,1311,"6 de julio de 1997"
1,1,5,393,452,540,992,"6 de julio de 1997"
1,1,5,394,750,886,1636,"6 de julio de 1997"
1,1,5,395,641,721,1362,"6 de julio de 1997"
1,1,5,396,1008,1111,2119,"6 de julio de 1997"
1,1,5,397,1252,1414,2666,"6 de julio de 1997"
1,1,5,398,475,549,1024,"6 de julio de 1997"
1,1,5,399,275,314,589,"6 de julio de 1997"
1,1,5,400,430,468,898,"6 de julio de 1997"
1,1,5,401,559,594,1153,"6 de julio de 1997"
1,1,5,402,394,398,792,"6 de julio de 1997"
1,1,5,403,760,896,1656,"6 de julio de 1997"
1,1,5,404,193,198,391,"6 de julio de 1997"
1,1,5,405,806,846,1652,"6 de julio de 1997"
1,1,5,406,497,547,1044,"6 de julio de 1997"
1,1,5,407,235,262,497,"6 de julio de 1997"
1,1,5,408,140,146,286,"6 de julio de 1997"
1,1,5,409,299,332,631,"6 de julio de 1997"
1,1,5,410,640,688,1328,"6 de julio de 1997"
1,1,5,411,328,351,679,"6 de julio de 1997"
1,1,5,412,773,913,1686,"6 de julio de 1997"
1,1,5,413,344,395,739,"6 de julio de 1997"
1,1,5,414,518,613,1131,"6 de julio de 1997"
1,1,6,415,756,865,1621,"6 de julio de 1997"
1,1,6,416,382,429,811,"6 de julio de 1997"
1,1,6,417,516,560,1076,"6 de julio de 1997"
1,1,6,418,505,585,1090,"6 de julio de 1997"
1,1,6,419,699,793,1492,"6 de julio de 1997"
1,1,6,420,469,535,1004,"6 de julio de 1997"
1,1,6,421,622,732,1354,"6 de julio de 1997"
1,1,6,422,411,470,881,"6 de julio de 1997"
1,1,6,423,560,634,1194,"6 de julio de 1997"
1,1,6,424,639,682,1321,"6 de julio de 1997"
1,1,6,425,286,309,595,"6 de julio de 1997"
1,1,6,426,329,356,685,"6 de julio de 1997"
1,1,6,427,285,290,575,"6 de julio de 1997"
1,1,6,428,469,537,1006,"6 de julio de 1997"
1,1,6,429,633,649,1282,"6 de julio de 1997"
1,1,6,430,385,398,783,"6 de julio de 1997"
1,1,7,431,343,374,717,"6 de julio de 1997"
1,1,7,432,546,541,1087,"6 de julio de 1997"
1,1,7,433,300,334,634,"6 de julio de 1997"
1,1,7,434,401,451,852,"6 de julio de 1997"
1,1,7,435,386,432,818,"6 de julio de 1997"
1,1,7,436,441,487,928,"6 de julio de 1997"
1,1,7,437,458,473,931,"6 de julio de 1997"
1,1,7,438,387,434,821,"6 de julio de 1997"
1,1,7,439,711,792,1503,"6 de julio de 1997"
1,1,7,440,1072,1186,2258,"6 de julio de 1997"
1,1,7,441,476,474,950,"6 de julio de 1997"
1,1,7,442,548,576,1124,"6 de julio de 1997"
1,1,7,443,529,577,1106,"6 de julio de 1997"
1,1,7,444,272,307,579,"6 de julio de 1997"
1,1,7,445,558,591,1149,"6 de julio de 1997"
1,1,7,446,400,415,815,"6 de julio de 1997"
1,1,7,447,595,585,1180,"6 de julio de 1997"
1,1,7,448,432,408,840,"6 de julio de 1997"
1,1,7,449,632,665,1297,"6 de julio de 1997"
1,1,7,450,363,367,730,"6 de julio de 1997"
1,1,7,451,324,336,660,"6 de julio de 1997"
1,1,8,452,364,421,785,"6 de julio de 1997"
1,1,8,453,336,338,674,"6 de julio de 1997"
1,1,8,454,433,479,912,"6 de julio de 1997"
1,1,8,455,106,98,204,"6 de julio de 1997"
1,1,8,456,127,116,243,"6 de julio de 1997"
1,1,8,457,218,259,477,"6 de julio de 1997"
1,1,8,458,315,359,674,"6 de julio de 1997"
1,1,8,459,54,62,116,"6 de julio de 1997"
1,1,9,460,406,435,841,"6 de julio de 1997"
1,1,9,461,521,558,1079,"6 de julio de 1997"
1,1,9,462,505,583,1088,"6 de julio de 1997"
1,1,9,463,519,576,1095,"6 de julio de 1997"
1,1,9,464,452,459,911,"6 de julio de 1997"
1,1,9,465,185,163,348,"6 de julio de 1997"
1,1,9,466,192,169,361,"6 de julio de 1997"
1,1,9,467,522,545,1067,"6 de julio de 1997"
1,1,9,468,232,233,465,"6 de julio de 1997"
1,1,9,469,693,735,1428,"6 de julio de 1997"
1,1,10,470,617,701,1318,"6 de julio de 1997"
1,1,10,471,709,830,1539,"6 de julio de 1997"
1,1,10,472,525,561,1086,"6 de julio de 1997"
1,1,10,473,639,695,1334,"6 de julio de 1997"
1,1,10,474,418,474,892,"6 de julio de 1997"
1,1,10,475,353,330,683,"6 de julio de 1997"
1,1,10,476,387,408,795,"6 de julio de 1997"
1,1,10,477,434,461,895,"6 de julio de 1997"
1,1,10,478,562,596,1158,"6 de julio de 1997"
1,1,11,479,576,578,1154,"6 de julio de 1997"
1,1,11,480,521,535,1056,"6 de julio de 1997"
1,1,11,481,418,420,838,"6 de julio de 1997"
1,1,11,482,738,710,1448,"6 de julio de 1997"
1,1,11,483,266,220,486,"6 de julio de 1997"
1,1,11,484,281,256,537,"6 de julio de 1997"
1,1,11,485,723,768,1491,"6 de julio de 1997"
1,1,11,486,535,542,1077,"6 de julio de 1997"
1,2,1,1,560,594,1154,"6 de julio de 1997"
1,2,1,2,446,471,917,"6 de julio de 1997"
1,2,1,3,512,571,1083,"6 de julio de 1997"
1,2,1,4,376,408,784,"6 de julio de 1997"
1,2,1,5,352,368,720,"6 de julio de 1997"
1,2,1,6,312,356,668,"6 de julio de 1997"
1,2,1,7,344,422,766,"6 de julio de 1997"
1,2,1,8,461,538,999,"6 de julio de 1997"
1,2,1,9,538,635,1173,"6 de julio de 1997"
1,2,1,10,522,605,1127,"6 de julio de 1997"
1,2,1,11,553,629,1182,"6 de julio de 1997"
1,2,1,12,399,452,851,"6 de julio de 1997"
1,2,1,13,370,444,814,"6 de julio de 1997"
1,2,1,14,388,442,830,"6 de julio de 1997"
1,2,1,15,464,526,990,"6 de julio de 1997"
1,2,1,16,434,511,945,"6 de julio de 1997"
1,2,1,17,522,576,1098,"6 de julio de 1997"
1,2,1,18,523,606,1129,"6 de julio de 1997"
1,2,1,19,411,507,918,"6 de julio de 1997"
1,2,1,20,397,426,823,"6 de julio de 1997"
1,2,1,21,672,795,1467,"6 de julio de 1997"
1,2,1,22,363,456,819,"6 de julio de 1997"
1,2,1,23,506,593,1099,"6 de julio de 1997"
1,2,1,24,330,422,752,"6 de julio de 1997"
1,2,1,25,425,564,989,"6 de julio de 1997"
1,2,1,26,603,714,1317,"6 de julio de 1997"
1,2,1,27,317,386,703,"6 de julio de 1997"
1,2,1,28,251,257,508,"6 de julio de 1997"
1,2,1,29,442,558,1000,"6 de julio de 1997"
1,2,1,30,326,403,729,"6 de julio de 1997"
1,2,1,31,462,512,974,"6 de julio de 1997"
1,2,1,32,588,690,1278,"6 de julio de 1997"
1,2,1,33,450,528,978,"6 de julio de 1997"
1,2,1,34,287,389,676,"6 de julio de 1997"
1,2,1,35,391,421,812,"6 de julio de 1997"
1,2,1,36,416,487,903,"6 de julio de 1997"
1,2,1,37,619,712,1331,"6 de julio de 1997"
1,2,1,38,651,784,1435,"6 de julio de 1997"
1,2,1,39,453,536,989,"6 de julio de 1997"
1,2,1,40,606,742,1348,"6 de julio de 1997"
1,2,1,41,474,556,1030,"6 de julio de 1997"
1,2,1,42,495,528,1023,"6 de julio de 1997"
1,2,1,43,513,570,1083,"6 de julio de 1997"
1,2,1,44,872,1050,1922,"6 de julio de 1997"
1,2,1,45,540,601,1141,"6 de julio de 1997"
1,2,1,46,548,665,1213,"6 de julio de 1997"
1,2,1,47,887,991,1878,"6 de julio de 1997"
1,2,1,48,527,581,1108,"6 de julio de 1997"
1,2,1,49,544,639,1183,"6 de julio de 1997"
1,2,1,50,536,599,1135,"6 de julio de 1997"
1,2,1,51,638,695,1333,"6 de julio de 1997"
1,2,1,52,496,560,1056,"6 de julio de 1997"
1,2,1,53,592,696,1288,"6 de julio de 1997"
1,2,1,54,584,668,1252,"6 de julio de 1997"
1,2,1,55,594,667,1261,"6 de julio de 1997"
1,2,1,56,500,556,1056,"6 de julio de 1997"
1,2,1,57,429,498,927,"6 de julio de 1997"
1,2,1,58,335,448,783,"6 de julio de 1997"
1,2,1,59,336,402,738,"6 de julio de 1997"
1,2,1,60,587,675,1262,"6 de julio de 1997"
1,2,1,61,409,509,918,"6 de julio de 1997"
1,2,1,62,327,417,744,"6 de julio de 1997"
1,2,1,63,337,405,742,"6 de julio de 1997"
1,2,1,64,419,523,942,"6 de julio de 1997"
1,2,1,65,279,373,652,"6 de julio de 1997"
1,2,1,66,414,569,983,"6 de julio de 1997"
1,2,1,67,257,288,545,"6 de julio de 1997"
1,2,1,68,352,436,788,"6 de julio de 1997"
1,2,1,69,469,576,1045,"6 de julio de 1997"
1,2,1,70,340,415,755,"6 de julio de 1997"
1,2,1,71,540,653,1193,"6 de julio de 1997"
1,2,1,72,283,370,653,"6 de julio de 1997"
1,2,1,73,398,575,973,"6 de julio de 1997"
1,2,1,74,319,412,731,"6 de julio de 1997"
1,2,1,75,334,448,782,"6 de julio de 1997"
1,2,1,76,233,366,599,"6 de julio de 1997"
1,2,1,77,264,397,661,"6 de julio de 1997"
1,2,1,78,375,480,855,"6 de julio de 1997"
1,2,1,79,433,533,966,"6 de julio de 1997"
1,2,1,80,1296,1417,2713,"6 de julio de 1997"
1,2,1,81,776,832,1608,"6 de julio de 1997"
1,2,1,82,590,623,1213,"6 de julio de 1997"
1,2,1,83,681,766,1447,"6 de julio de 1997"
1,2,1,84,637,709,1346,"6 de julio de 1997"
1,2,1,85,839,937,1776,"6 de julio de 1997"
1,2,1,86,862,921,1783,"6 de julio de 1997"
1,2,1,87,281,297,578,"6 de julio de 1997"
1,2,1,88,311,346,657,"6 de julio de 1997"
1,2,1,89,548,593,1141,"6 de julio de 1997"
1,2,1,90,725,797,1522,"6 de julio de 1997"
1,2,1,91,304,346,650,"6 de julio de 1997"
1,2,1,92,326,352,678,"6 de julio de 1997"
1,2,1,93,363,446,809,"6 de julio de 1997"
1,2,1,94,368,451,819,"6 de julio de 1997"
1,2,1,95,430,503,933,"6 de julio de 1997"
1,2,1,96,414,506,920,"6 de julio de 1997"
1,2,1,97,412,483,895,"6 de julio de 1997"
1,2,1,98,1848,2259,4107,"6 de julio de 1997"
1,2,1,99,876,533,1409,"6 de julio de 1997"
1,2,1,100,462,540,1002,"6 de julio de 1997"
1,2,1,101,307,383,690,"6 de julio de 1997"
1,2,1,102,482,511,993,"6 de julio de 1997"
1,2,1,103,433,442,875,"6 de julio de 1997"
1,2,1,104,427,435,862,"6 de julio de 1997"
1,2,1,105,377,434,811,"6 de julio de 1997"
1,2,1,106,654,712,1366,"6 de julio de 1997"
1,2,1,107,579,709,1288,"6 de julio de 1997"
1,2,1,108,494,603,1097,"6 de julio de 1997"
1,2,1,109,658,733,1391,"6 de julio de 1997"
1,2,1,110,271,320,591,"6 de julio de 1997"
1,2,1,111,698,729,1427,"6 de julio de 1997"
1,2,1,112,392,441,833,"6 de julio de 1997"
1,2,1,113,347,405,752,"6 de julio de 1997"
1,2,1,114,321,395,716,"6 de julio de 1997"
1,2,1,115,418,464,882,"6 de julio de 1997"
1,2,1,116,1355,1577,2932,"6 de julio de 1997"
1,2,1,117,539,582,1121,"6 de julio de 1997"
1,2,1,118,918,1019,1937,"6 de julio de 1997"
1,2,1,119,508,579,1087,"6 de julio de 1997"
1,2,1,120,368,422,790,"6 de julio de 1997"
1,2,1,121,334,419,753,"6 de julio de 1997"
1,2,1,122,561,652,1213,"6 de julio de 1997"
1,2,1,126,503,531,1034,"6 de julio de 1997"
1,2,1,127,566,582,1148,"6 de julio de 1997"
1,2,1,128,331,384,715,"6 de julio de 1997"
1,2,1,129,392,463,855,"6 de julio de 1997"
1,2,1,130,492,527,1019,"6 de julio de 1997"
1,2,1,131,421,451,872,"6 de julio de 1997"
1,2,1,132,392,452,844,"6 de julio de 1997"
1,2,1,133,419,451,870,"6 de julio de 1997"
1,2,1,134,352,403,755,"6 de julio de 1997"
1,2,1,135,339,375,714,"6 de julio de 1997"
1,2,1,136,626,650,1276,"6 de julio de 1997"
1,2,1,137,167,182,349,"6 de julio de 1997"
1,2,1,150,313,366,679,"6 de julio de 1997"
1,2,1,151,199,221,420,"6 de julio de 1997"
1,2,1,152,745,846,1591,"6 de julio de 1997"
1,2,1,153,278,305,583,"6 de julio de 1997"
1,2,1,171,337,398,735,"6 de julio de 1997"
1,2,1,172,367,417,784,"6 de julio de 1997"
1,2,1,173,283,351,634,"6 de julio de 1997"
1,2,1,174,551,737,1288,"6 de julio de 1997"
1,2,1,175,438,598,1036,"6 de julio de 1997"
1,2,1,176,229,295,524,"6 de julio de 1997"
1,2,1,177,407,574,981,"6 de julio de 1997"
1,2,1,271,440,527,967,"6 de julio de 1997"
1,2,1,272,410,457,867,"6 de julio de 1997"
1,2,1,273,426,496,922,"6 de julio de 1997"
1,2,1,274,404,494,898,"6 de julio de 1997"
1,2,1,275,473,582,1055,"6 de julio de 1997"
1,2,1,276,436,588,1024,"6 de julio de 1997"
1,2,1,277,437,527,964,"6 de julio de 1997"
1,2,1,278,398,454,852,"6 de julio de 1997"
1,2,1,279,308,364,672,"6 de julio de 1997"
1,2,1,280,281,334,615,"6 de julio de 1997"
1,2,1,281,297,342,639,"6 de julio de 1997"
1,2,1,283,314,348,662,"6 de julio de 1997"
1,2,1,316,612,675,1287,"6 de julio de 1997"
1,2,1,317,723,755,1478,"6 de julio de 1997"
1,2,1,318,465,391,856,"6 de julio de 1997"
1,2,1,319,1966,2172,4138,"6 de julio de 1997"
1,2,1,320,763,842,1605,"6 de julio de 1997"
1,2,1,321,337,294,631,"6 de julio de 1997"
1,2,1,322,841,877,1718,"6 de julio de 1997"
1,3,1,123,378,440,818,"6 de julio de 1997"
1,3,1,124,264,318,582,"6 de julio de 1997"
1,3,1,125,570,578,1148,"6 de julio de 1997"
1,3,1,138,539,616,1155,"6 de julio de 1997"
1,3,1,139,476,510,986,"6 de julio de 1997"
1,3,1,140,614,575,1189,"6 de julio de 1997"
1,3,1,141,560,584,1144,"6 de julio de 1997"
1,3,1,142,390,443,833,"6 de julio de 1997"
1,3,1,143,387,483,870,"6 de julio de 1997"
1,3,1,144,460,484,944,"6 de julio de 1997"
1,3,1,145,321,382,703,"6 de julio de 1997"
1,3,1,146,515,597,1112,"6 de julio de 1997"
1,3,1,147,601,580,1181,"6 de julio de 1997"
1,3,1,148,711,760,1471,"6 de julio de 1997"
1,3,1,149,751,860,1611,"6 de julio de 1997"
1,3,1,154,460,466,926,"6 de julio de 1997"
1,3,1,155,1422,1559,2981,"6 de julio de 1997"
1,3,1,156,1957,2243,4200,"6 de julio de 1997"
1,3,1,157,437,465,902,"6 de julio de 1997"
1,3,1,158,164,177,341,"6 de julio de 1997"
1,3,1,159,319,387,706,"6 de julio de 1997"
1,3,1,160,371,454,825,"6 de julio de 1997"
1,3,1,161,1105,1184,2289,"6 de julio de 1997"
1,3,1,162,533,571,1104,"6 de julio de 1997"
1,3,1,163,401,456,857,"6 de julio de 1997"
1,3,1,164,1157,1319,2476,"6 de julio de 1997"
1,3,1,165,454,505,959,"6 de julio de 1997"
1,3,1,166,2477,2774,5251,"6 de julio de 1997"
1,3,1,167,199,241,440,"6 de julio de 1997"
1,3,1,168,595,672,1267,"6 de julio de 1997"
1,3,1,169,625,752,1377,"6 de julio de 1997"
1,3,1,170,588,681,1269,"6 de julio de 1997"
1,3,1,178,332,426,758,"6 de julio de 1997"
1,3,1,179,430,538,968,"6 de julio de 1997"
1,3,1,180,280,333,613,"6 de julio de 1997"
1,3,1,181,272,344,616,"6 de julio de 1997"
1,3,1,182,306,418,724,"6 de julio de 1997"
1,3,1,183,226,319,545,"6 de julio de 1997"
1,3,1,184,493,583,1076,"6 de julio de 1997"
1,3,1,185,236,274,510,"6 de julio de 1997"
1,3,1,186,213,254,467,"6 de julio de 1997"
1,3,1,187,412,470,882,"6 de julio de 1997"
1,3,1,188,569,706,1275,"6 de julio de 1997"
1,3,1,189,555,684,1239,"6 de julio de 1997"
1,3,1,190,479,685,1164,"6 de julio de 1997"
1,3,1,191,303,373,676,"6 de julio de 1997"
1,3,1,192,591,651,1242,"6 de julio de 1997"
1,3,1,193,493,543,1036,"6 de julio de 1997"
1,3,1,194,783,851,1634,"6 de julio de 1997"
1,3,1,195,453,536,989,"6 de julio de 1997"
1,3,1,196,285,395,680,"6 de julio de 1997"
1,3,1,197,376,481,857,"6 de julio de 1997"
1,3,1,198,288,359,647,"6 de julio de 1997"
1,3,1,199,337,392,729,"6 de julio de 1997"
1,3,1,200,393,462,855,"6 de julio de 1997"
1,3,1,201,431,474,905,"6 de julio de 1997"
1,3,1,202,377,414,791,"6 de julio de 1997"
1,3,1,203,393,444,837,"6 de julio de 1997"
1,3,1,204,694,726,1420,"6 de julio de 1997"
1,3,1,205,578,657,1235,"6 de julio de 1997"
1,3,1,206,299,332,631,"6 de julio de 1997"
1,3,1,207,577,619,1196,"6 de julio de 1997"
1,3,1,208,559,658,1217,"6 de julio de 1997"
1,3,1,209,448,568,1016,"6 de julio de 1997"
1,3,1,210,528,629,1157,"6 de julio de 1997"
1,3,1,211,332,385,717,"6 de julio de 1997"
1,3,1,212,426,489,915,"6 de julio de 1997"
1,3,1,213,374,411,785,"6 de julio de 1997"
1,3,1,214,431,555,986,"6 de julio de 1997"
1,3,1,215,458,545,1003,"6 de julio de 1997"
1,3,1,216,422,499,921,"6 de julio de 1997"
1,3,1,217,445,552,997,"6 de julio de 1997"
1,3,1,218,449,512,961,"6 de julio de 1997"
1,3,1,219,286,371,657,"6 de julio de 1997"
1,3,1,220,347,396,743,"6 de julio de 1997"
1,3,1,221,368,382,750,"6 de julio de 1997"
1,3,1,222,320,378,698,"6 de julio de 1997"
1,3,1,223,225,263,488,"6 de julio de 1997"
1,3,1,224,361,384,745,"6 de julio de 1997"
1,3,1,225,333,407,740,"6 de julio de 1997"
1,3,1,226,319,344,663,"6 de julio de 1997"
1,3,1,227,380,421,801,"6 de julio de 1997"
1,3,1,228,350,398,748,"6 de julio de 1997"
1,3,1,229,332,360,692,"6 de julio de 1997"
1,3,1,230,325,386,711,"6 de julio de 1997"
1,3,1,231,403,440,843,"6 de julio de 1997"
1,3,1,232,250,280,530,"6 de julio de 1997"
1,3,1,233,407,469,876,"6 de julio de 1997"
1,3,1,234,331,363,694,"6 de julio de 1997"
1,3,1,235,278,313,591,"6 de julio de 1997"
1,3,1,236,429,465,894,"6 de julio de 1997"
1,3,1,237,354,397,751,"6 de julio de 1997"
1,3,1,238,330,347,677,"6 de julio de 1997"
1,3,1,239,395,439,834,"6 de julio de 1997"
1,3,1,240,343,359,702,"6 de julio de 1997"
1,3,1,241,271,341,612,"6 de julio de 1997"
1,3,1,242,283,310,593,"6 de julio de 1997"
1,3,1,243,539,590,1129,"6 de julio de 1997"
1,3,1,244,472,545,1017,"6 de julio de 1997"
1,3,1,245,329,393,722,"6 de julio de 1997"
1,3,1,246,484,511,995,"6 de julio de 1997"
1,3,1,247,453,483,936,"6 de julio de 1997"
1,3,1,248,363,422,785,"6 de julio de 1997"
1,3,1,249,470,481,951,"6 de julio de 1997"
1,3,1,250,379,420,799,"6 de julio de 1997"
1,3,1,251,468,509,977,"6 de julio de 1997"
1,3,1,252,465,544,1009,"6 de julio de 1997"
1,3,1,253,391,417,808,"6 de julio de 1997"
1,3,1,254,349,361,710,"6 de julio de 1997"
1,3,1,255,341,380,721,"6 de julio de 1997"
1,3,1,256,426,446,872,"6 de julio de 1997"
1,3,1,257,426,475,901,"6 de julio de 1997"
1,3,1,258,505,589,1094,"6 de julio de 1997"
1,3,1,259,292,342,634,"6 de julio de 1997"
1,3,1,260,357,434,791,"6 de julio de 1997"
1,3,1,261,353,416,769,"6 de julio de 1997"
1,3,1,262,219,276,495,"6 de julio de 1997"
1,3,1,263,308,324,632,"6 de julio de 1997"
1,3,1,264,366,428,794,"6 de julio de 1997"
1,3,1,265,313,370,683,"6 de julio de 1997"
1,3,1,266,242,265,507,"6 de julio de 1997"
1,3,1,267,438,502,940,"6 de julio de 1997"
1,3,1,268,241,286,527,"6 de julio de 1997"
1,3,1,269,389,391,780,"6 de julio de 1997"
1,3,1,270,638,736,1374,"6 de julio de 1997"
1,3,1,282,199,228,427,"6 de julio de 1997"
1,3,1,284,433,463,896,"6 de julio de 1997"
1,3,1,285,326,376,702,"6 de julio de 1997"
1,3,1,286,293,395,688,"6 de julio de 1997"
1,3,1,287,326,416,742,"6 de julio de 1997"
1,3,1,288,413,459,872,"6 de julio de 1997"
1,3,1,289,377,454,831,"6 de julio de 1997"
1,3,1,290,310,337,647,"6 de julio de 1997"
1,3,1,291,493,554,1047,"6 de julio de 1997"
1,3,1,292,477,546,1023,"6 de julio de 1997"
1,3,1,293,370,406,776,"6 de julio de 1997"
1,3,1,294,526,572,1098,"6 de julio de 1997"
1,3,1,295,605,669,1274,"6 de julio de 1997"
1,3,1,296,502,555,1057,"6 de julio de 1997"
1,3,1,297,448,480,928,"6 de julio de 1997"
1,3,1,298,611,696,1307,"6 de julio de 1997"
1,3,1,299,562,584,1146,"6 de julio de 1997"
1,3,1,300,374,427,801,"6 de julio de 1997"
1,3,1,301,487,497,984,"6 de julio de 1997"
1,3,1,302,436,485,921,"6 de julio de 1997"
1,3,1,303,414,432,846,"6 de julio de 1997"
1,3,1,304,503,565,1068,"6 de julio de 1997"
1,3,1,305,511,557,1068,"6 de julio de 1997"
1,3,1,306,544,542,1086,"6 de julio de 1997"
1,3,1,307,487,627,1114,"6 de julio de 1997"
1,3,1,308,389,454,843,"6 de julio de 1997"
1,3,1,309,443,529,972,"6 de julio de 1997"
1,3,1,310,425,490,915,"6 de julio de 1997"
1,3,1,311,429,497,926,"6 de julio de 1997"
1,3,1,312,489,529,1018,"6 de julio de 1997"
1,3,1,313,637,709,1346,"6 de julio de 1997"
1,3,1,314,509,586,1095,"6 de julio de 1997"
1,3,1,315,833,827,1660,"6 de julio de 1997"
1,3,1,323,196,186,382,"6 de julio de 1997"
1,3,1,324,510,477,987,"6 de julio de 1997"
1,3,1,325,634,645,1279,"6 de julio de 1997"
1,3,1,326,312,282,594,"6 de julio de 1997"
1,3,1,327,436,455,891,"6 de julio de 1997"
1,3,1,328,370,411,781,"6 de julio de 1997"
1,3,1,329,293,327,620,"6 de julio de 1997"
1,3,1,330,652,664,1316,"6 de julio de 1997"
1,3,1,331,419,407,826,"6 de julio de 1997"
1,3,1,332,540,558,1098,"6 de julio de 1997"
1,3,1,333,496,537,1033,"6 de julio de 1997"
1,3,1,334,421,452,873,"6 de julio de 1997"
1,3,1,335,178,169,347,"6 de julio de 1997"
1,3,1,336,405,386,791,"6 de julio de 1997"
1,3,1,337,370,403,773,"6 de julio de 1997"
2,1,2,374,368,457,825,"6 de julio de 1997"
2,1,2,375,446,524,970,"6 de julio de 1997"
2,1,2,376,496,566,1062,"6 de julio de 1997"
2,1,2,377,585,646,1231,"6 de julio de 1997"
2,1,2,378,436,488,924,"6 de julio de 1997"
2,1,2,379,408,453,861,"6 de julio de 1997"
2,1,2,380,252,260,512,"6 de julio de 1997"
2,1,2,381,370,379,749,"6 de julio de 1997"
2,1,2,382,526,568,1094,"6 de julio de 1997"
2,1,2,383,376,413,789,"6 de julio de 1997"
2,1,2,384,593,619,1212,"6 de julio de 1997"
2,1,2,385,612,663,1275,"6 de julio de 1997"
2,1,2,386,417,497,914,"6 de julio de 1997"
2,1,2,387,408,461,869,"6 de julio de 1997"
2,1,2,395,557,614,1171,"6 de julio de 1997"
2,1,2,396,583,627,1210,"6 de julio de 1997"
2,1,2,397,388,450,838,"6 de julio de 1997"
2,1,2,398,486,497,983,"6 de julio de 1997"
2,1,2,432,458,493,951,"6 de julio de 1997"
2,1,2,434,378,434,812,"6 de julio de 1997"
2,1,2,435,563,595,1158,"6 de julio de 1997"
2,1,2,436,554,627,1181,"6 de julio de 1997"
2,1,2,437,347,360,707,"6 de julio de 1997"
2,1,2,438,512,581,1093,"6 de julio de 1997"
2,1,2,439,578,697,1275,"6 de julio de 1997"
2,1,2,440,484,541,1025,"6 de julio de 1997"
2,1,2,441,589,668,1257,"6 de julio de 1997"
2,1,2,442,656,675,1331,"6 de julio de 1997"
2,1,2,443,633,682,1315,"6 de julio de 1997"
2,1,2,444,1224,1362,2586,"6 de julio de 1997"
2,1,2,445,521,579,1100,"6 de julio de 1997"
2,1,2,446,623,685,1308,"6 de julio de 1997"
2,1,2,447,382,444,826,"6 de julio de 1997"
2,1,2,448,715,772,1487,"6 de julio de 1997"
2,1,2,449,692,787,1479,"6 de julio de 1997"
2,1,2,450,666,697,1363,"6 de julio de 1997"
2,1,2,451,365,401,766,"6 de julio de 1997"
2,1,2,452,396,445,841,"6 de julio de 1997"
2,1,2,453,400,427,827,"6 de julio de 1997"
2,1,2,454,639,720,1359,"6 de julio de 1997"
2,1,2,455,444,482,926,"6 de julio de 1997"
2,1,2,456,442,572,1014,"6 de julio de 1997"
2,1,2,457,633,700,1333,"6 de julio de 1997"
2,1,2,458,378,410,788,"6 de julio de 1997"
2,1,2,459,521,529,1050,"6 de julio de 1997"
2,1,2,460,343,382,725,"6 de julio de 1997"
2,1,2,461,476,488,964,"6 de julio de 1997"
2,1,2,462,334,346,680,"6 de julio de 1997"
2,1,2,463,432,534,966,"6 de julio de 1997"
2,1,2,464,305,313,618,"6 de julio de 1997"
2,1,2,465,546,528,1074,"6 de julio de 1997"
2,1,2,466,412,463,875,"6 de julio de 1997"
2,1,2,467,479,570,1049,"6 de julio de 1997"
2,1,2,468,471,501,972,"6 de julio de 1997"
2,1,2,469,723,803,1526,"6 de julio de 1997"
2,1,2,470,782,872,1654,"6 de julio de 1997"
2,1,2,471,413,477,890,"6 de julio de 1997"
2,1,2,472,399,463,862,"6 de julio de 1997"
2,1,2,473,321,343,664,"6 de julio de 1997"
2,1,2,474,403,477,880,"6 de julio de 1997"
2,1,2,475,251,292,543,"6 de julio de 1997"
2,1,2,476,558,631,1189,"6 de julio de 1997"
2,1,2,477,565,603,1168,"6 de julio de 1997"
2,1,2,478,543,632,1175,"6 de julio de 1997"
2,1,2,479,332,369,701,"6 de julio de 1997"
2,1,2,480,254,306,560,"6 de julio de 1997"
2,1,2,481,355,445,800,"6 de julio de 1997"
2,1,2,482,471,555,1026,"6 de julio de 1997"
2,1,2,483,318,293,611,"6 de julio de 1997"
2,1,2,484,381,405,786,"6 de julio de 1997"
2,1,2,485,299,364,663,"6 de julio de 1997"
2,1,2,486,500,507,1007,"6 de julio de 1997"
2,1,2,487,300,374,674,"6 de julio de 1997"
2,1,2,488,954,1176,2130,"6 de julio de 1997"
2,1,2,489,311,347,658,"6 de julio de 1997"
2,1,2,490,240,291,531,"6 de julio de 1997"
2,1,2,491,435,461,896,"6 de julio de 1997"
2,1,2,492,493,572,1065,"6 de julio de 1997"
2,1,2,493,535,611,1146,"6 de julio de 1997"
2,1,2,494,448,480,928,"6 de julio de 1997"
2,1,2,495,457,498,955,"6 de julio de 1997"
2,1,2,496,351,331,682,"6 de julio de 1997"
2,1,2,497,307,343,650,"6 de julio de 1997"
2,1,2,498,354,388,742,"6 de julio de 1997"
2,1,2,499,493,573,1066,"6 de julio de 1997"
2,1,2,500,290,339,629,"6 de julio de 1997"
2,1,2,501,743,910,1653,"6 de julio de 1997"
2,1,2,502,344,391,735,"6 de julio de 1997"
2,1,2,503,258,286,544,"6 de julio de 1997"
2,1,2,504,423,505,928,"6 de julio de 1997"
2,1,2,505,350,412,762,"6 de julio de 1997"
2,1,2,506,282,333,615,"6 de julio de 1997"
2,1,2,507,313,340,653,"6 de julio de 1997"
2,1,2,508,413,430,843,"6 de julio de 1997"
2,1,2,509,310,360,670,"6 de julio de 1997"
2,1,2,510,313,358,671,"6 de julio de 1997"
2,1,2,511,341,369,710,"6 de julio de 1997"
2,1,2,512,319,346,665,"6 de julio de 1997"
2,1,2,513,299,349,648,"6 de julio de 1997"
2,1,2,514,330,374,704,"6 de julio de 1997"
2,1,2,515,297,325,622,"6 de julio de 1997"
2,1,2,516,431,475,906,"6 de julio de 1997"
2,1,2,540,481,499,980,"6 de julio de 1997"
2,1,2,548,145,143,288,"6 de julio de 1997"
2,1,2,549,344,261,605,"6 de julio de 1997"
2,1,2,550,389,352,741,"6 de julio de 1997"
2,1,2,551,325,285,610,"6 de julio de 1997"
2,1,2,552,481,443,924,"6 de julio de 1997"
2,1,2,553,338,346,684,"6 de julio de 1997"
2,1,2,554,489,492,981,"6 de julio de 1997"
2,1,2,555,454,491,945,"6 de julio de 1997"
2,1,2,556,617,628,1245,"6 de julio de 1997"
2,1,2,557,201,160,361,"6 de julio de 1997"
2,1,2,558,539,533,1072,"6 de julio de 1997"
2,1,2,559,478,499,977,"6 de julio de 1997"
2,1,2,560,495,523,1018,"6 de julio de 1997"
2,1,2,561,467,457,924,"6 de julio de 1997"
2,1,2,562,364,376,740,"6 de julio de 1997"
2,1,2,563,450,417,867,"6 de julio de 1997"
2,1,2,564,403,387,790,"6 de julio de 1997"
2,1,2,566,290,343,633,"6 de julio de 1997"
2,1,2,567,373,410,783,"6 de julio de 1997"
2,1,2,568,349,320,669,"6 de julio de 1997"
2,1,2,569,229,217,446,"6 de julio de 1997"
2,1,2,570,445,470,915,"6 de julio de 1997"
2,1,2,571,426,424,850,"6 de julio de 1997"
2,1,2,572,479,498,977,"6 de julio de 1997"
2,1,2,573,365,360,725,"6 de julio de 1997"
2,1,2,574,462,448,910,"6 de julio de 1997"
2,1,2,575,589,547,1136,"6 de julio de 1997"
2,1,2,576,146,141,287,"6 de julio de 1997"
2,1,2,577,504,513,1017,"6 de julio de 1997"
2,1,2,578,567,568,1135,"6 de julio de 1997"
2,1,2,579,501,504,1005,"6 de julio de 1997"
2,1,2,580,267,231,498,"6 de julio de 1997"
2,1,2,581,491,468,959,"6 de julio de 1997"
2,1,2,582,456,407,863,"6 de julio de 1997"
2,1,2,583,313,308,621,"6 de julio de 1997"
2,1,2,584,342,344,686,"6 de julio de 1997"
2,1,2,585,389,426,815,"6 de julio de 1997"
2,1,2,586,383,371,754,"6 de julio de 1997"
2,1,2,587,103,104,207,"6 de julio de 1997"
2,1,2,588,337,372,709,"6 de julio de 1997"
2,1,2,589,370,360,730,"6 de julio de 1997"
2,1,2,590,599,650,1249,"6 de julio de 1997"
2,1,2,591,247,249,496,"6 de julio de 1997"
2,1,2,592,519,472,991,"6 de julio de 1997"
2,1,2,593,313,325,638,"6 de julio de 1997"
2,1,2,594,358,382,740,"6 de julio de 1997"
2,1,2,595,471,462,933,"6 de julio de 1997"
2,1,2,596,485,511,996,"6 de julio de 1997"
2,1,2,597,634,558,1192,"6 de julio de 1997"
2,1,2,598,328,302,630,"6 de julio de 1997"
2,1,2,599,530,502,1032,"6 de julio de 1997"
2,1,2,600,382,352,734,"6 de julio de 1997"
2,1,2,601,394,372,766,"6 de julio de 1997"
2,1,2,602,395,377,772,"6 de julio de 1997"
2,1,2,603,617,568,1185,"6 de julio de 1997"
2,1,2,604,250,284,534,"6 de julio de 1997"
2,1,2,605,379,387,766,"6 de julio de 1997"
2,1,2,606,389,394,783,"6 de julio de 1997"
2,1,2,607,428,405,833,"6 de julio de 1997"
2,1,2,608,379,406,785,"6 de julio de 1997"
2,1,2,609,227,243,470,"6 de julio de 1997"
2,1,2,610,426,399,825,"6 de julio de 1997"
2,1,2,611,435,433,868,"6 de julio de 1997"
2,1,2,612,128,99,227,"6 de julio de 1997"
2,1,2,613,651,597,1248,"6 de julio de 1997"
2,1,2,614,325,294,619,"6 de julio de 1997"
2,1,2,615,608,601,1209,"6 de julio de 1997"
2,1,2,616,299,291,590,"6 de julio de 1997"
2,1,2,617,375,351,726,"6 de julio de 1997"
2,1,2,618,306,297,603,"6 de julio de 1997"
2,1,2,619,192,192,384,"6 de julio de 1997"
2,1,2,620,606,581,1187,"6 de julio de 1997"
2,1,2,621,518,526,1044,"6 de julio de 1997"
2,1,2,622,567,615,1182,"6 de julio de 1997"
2,1,2,623,433,464,897,"6 de julio de 1997"
2,1,2,624,500,458,958,"6 de julio de 1997"
2,1,2,625,512,455,967,"6 de julio de 1997"
2,1,2,626,438,372,810,"6 de julio de 1997"
2,1,2,627,449,398,847,"6 de julio de 1997"
2,1,2,628,352,361,713,"6 de julio de 1997"
2,1,2,629,329,313,642,"6 de julio de 1997"
2,1,2,630,343,344,687,"6 de julio de 1997"
2,1,2,631,424,393,817,"6 de julio de 1997"
2,1,2,632,301,302,603,"6 de julio de 1997"
2,1,2,633,379,377,756,"6 de julio de 1997"
2,1,2,634,536,510,1046,"6 de julio de 1997"
2,1,2,635,394,339,733,"6 de julio de 1997"
2,1,2,636,184,192,376,"6 de julio de 1997"
2,1,2,637,209,195,404,"6 de julio de 1997"
2,1,2,638,373,405,778,"6 de julio de 1997"
2,1,2,639,435,403,838,"6 de julio de 1997"
2,1,2,640,330,296,626,"6 de julio de 1997"
2,1,2,641,448,471,919,"6 de julio de 1997"
2,1,2,642,341,356,697,"6 de julio de 1997"
2,1,2,643,355,364,719,"6 de julio de 1997"
2,1,2,644,350,392,742,"6 de julio de 1997"
2,1,2,645,613,676,1289,"6 de julio de 1997"
2,1,2,646,281,272,553,"6 de julio de 1997"
2,1,2,647,327,321,648,"6 de julio de 1997"
2,1,2,648,460,459,919,"6 de julio de 1997"
2,1,2,649,298,284,582,"6 de julio de 1997"
2,1,2,650,309,316,625,"6 de julio de 1997"
2,1,2,651,521,498,1019,"6 de julio de 1997"
2,1,2,652,216,247,463,"6 de julio de 1997"
2,1,2,653,492,493,985,"6 de julio de 1997"
2,1,2,654,382,372,754,"6 de julio de 1997"
2,1,2,655,292,294,586,"6 de julio de 1997"
2,1,2,656,362,387,749,"6 de julio de 1997"
2,1,2,657,283,288,571,"6 de julio de 1997"
2,1,2,658,250,239,489,"6 de julio de 1997"
2,1,2,659,294,289,583,"6 de julio de 1997"
2,1,2,660,281,261,542,"6 de julio de 1997"
2,1,2,661,37,32,69,"6 de julio de 1997"
2,1,2,662,87,67,154,"6 de julio de 1997"
2,1,2,663,575,560,1135,"6 de julio de 1997"
2,1,2,664,460,494,954,"6 de julio de 1997"
2,1,2,665,310,323,633,"6 de julio de 1997"
2,1,2,666,225,248,473,"6 de julio de 1997"
2,1,2,667,378,396,774,"6 de julio de 1997"
2,1,2,668,281,303,584,"6 de julio de 1997"
2,1,2,669,166,126,292,"6 de julio de 1997"
2,1,2,670,197,157,354,"6 de julio de 1997"
2,1,2,671,177,160,337,"6 de julio de 1997"
2,1,2,672,150,122,272,"6 de julio de 1997"
2,1,2,673,549,499,1048,"6 de julio de 1997"
2,1,2,674,308,275,583,"6 de julio de 1997"
2,1,2,675,425,409,834,"6 de julio de 1997"
2,1,2,676,270,259,529,"6 de julio de 1997"
2,1,2,677,380,403,783,"6 de julio de 1997"
2,1,2,678,349,382,731,"6 de julio de 1997"
2,1,2,679,391,380,771,"6 de julio de 1997"
2,1,2,680,332,327,659,"6 de julio de 1997"
2,1,2,682,288,279,567,"6 de julio de 1997"
2,1,2,684,301,355,656,"6 de julio de 1997"
2,1,2,685,276,327,603,"6 de julio de 1997"
2,1,2,686,267,323,590,"6 de julio de 1997"
2,1,2,687,314,334,648,"6 de julio de 1997"
2,1,2,688,328,307,635,"6 de julio de 1997"
2,1,2,689,320,303,623,"6 de julio de 1997"
2,1,2,692,214,246,460,"6 de julio de 1997"
2,1,2,693,340,324,664,"6 de julio de 1997"
2,2,2,211,436,461,897,"6 de julio de 1997"
2,2,2,212,363,425,788,"6 de julio de 1997"
2,2,2,213,451,477,928,"6 de julio de 1997"
2,2,2,214,352,403,755,"6 de julio de 1997"
2,2,2,215,404,396,800,"6 de julio de 1997"
2,2,2,216,268,286,554,"6 de julio de 1997"
2,2,2,217,280,190,470,"6 de julio de 1997"
2,2,2,218,351,316,667,"6 de julio de 1997"
2,2,2,219,278,326,604,"6 de julio de 1997"
2,2,2,220,250,267,517,"6 de julio de 1997"
2,2,2,221,453,453,906,"6 de julio de 1997"
2,2,2,222,386,429,815,"6 de julio de 1997"
2,2,2,223,370,427,797,"6 de julio de 1997"
2,2,2,224,366,374,740,"6 de julio de 1997"
2,2,2,225,381,469,850,"6 de julio de 1997"
2,2,2,226,392,438,830,"6 de julio de 1997"
2,2,2,227,444,412,856,"6 de julio de 1997"
2,2,2,228,310,289,599,"6 de julio de 1997"
2,2,2,229,286,330,616,"6 de julio de 1997"
2,2,2,230,397,412,809,"6 de julio de 1997"
2,2,2,231,445,502,947,"6 de julio de 1997"
2,2,2,232,407,453,860,"6 de julio de 1997"
2,2,2,233,409,425,834,"6 de julio de 1997"
2,2,2,234,333,388,721,"6 de julio de 1997"
2,2,2,235,378,401,779,"6 de julio de 1997"
2,2,2,236,345,370,715,"6 de julio de 1997"
2,2,2,237,424,472,896,"6 de julio de 1997"
2,2,2,238,339,371,710,"6 de julio de 1997"
2,2,2,239,268,260,528,"6 de julio de 1997"
2,2,2,240,434,489,923,"6 de julio de 1997"
2,2,2,241,440,505,945,"6 de julio de 1997"
2,2,2,242,366,394,760,"6 de julio de 1997"
2,2,2,243,315,342,657,"6 de julio de 1997"
2,2,2,244,444,481,925,"6 de julio de 1997"
2,2,2,245,397,428,825,"6 de julio de 1997"
2,2,2,246,500,531,1031,"6 de julio de 1997"
2,2,2,247,513,559,1072,"6 de julio de 1997"
2,2,2,248,390,364,754,"6 de julio de 1997"
2,2,2,249,273,295,568,"6 de julio de 1997"
2,2,2,250,313,350,663,"6 de julio de 1997"
2,2,2,251,320,321,641,"6 de julio de 1997"
2,2,2,252,469,554,1023,"6 de julio de 1997"
2,2,2,253,366,407,773,"6 de julio de 1997"
2,2,2,254,525,585,1110,"6 de julio de 1997"
2,2,2,255,488,543,1031,"6 de julio de 1997"
2,2,2,256,327,398,725,"6 de julio de 1997"
2,2,2,257,371,445,816,"6 de julio de 1997"
2,2,2,258,413,445,858,"6 de julio de 1997"
2,2,2,259,296,322,618,"6 de julio de 1997"
2,2,2,260,344,377,721,"6 de julio de 1997"
2,2,2,261,357,380,737,"6 de julio de 1997"
2,2,2,262,334,372,706,"6 de julio de 1997"
2,2,2,263,363,389,752,"6 de julio de 1997"
2,2,2,264,309,311,620,"6 de julio de 1997"
2,2,2,265,290,319,609,"6 de julio de 1997"
2,2,2,266,335,393,728,"6 de julio de 1997"
2,2,2,267,300,332,632,"6 de julio de 1997"
2,2,2,268,504,541,1045,"6 de julio de 1997"
2,2,2,269,378,397,775,"6 de julio de 1997"
2,2,2,270,442,487,929,"6 de julio de 1997"
2,2,2,271,588,636,1224,"6 de julio de 1997"
2,2,2,272,427,450,877,"6 de julio de 1997"
2,2,2,273,411,399,810,"6 de julio de 1997"
2,2,2,274,406,459,865,"6 de julio de 1997"
2,2,2,275,378,438,816,"6 de julio de 1997"
2,2,2,276,365,446,811,"6 de julio de 1997"
2,2,2,277,364,369,733,"6 de julio de 1997"
2,2,2,278,278,311,589,"6 de julio de 1997"
2,2,2,279,367,379,746,"6 de julio de 1997"
2,2,2,280,354,399,753,"6 de julio de 1997"
2,2,2,281,409,487,896,"6 de julio de 1997"
2,2,2,282,364,442,806,"6 de julio de 1997"
2,2,2,283,352,418,770,"6 de julio de 1997"
2,2,2,284,363,440,803,"6 de julio de 1997"
2,2,2,285,554,549,1103,"6 de julio de 1997"
2,2,2,286,468,507,975,"6 de julio de 1997"
2,2,2,287,453,475,928,"6 de julio de 1997"
2,2,2,288,364,377,741,"6 de julio de 1997"
2,2,2,289,368,407,775,"6 de julio de 1997"
2,2,2,290,481,522,1003,"6 de julio de 1997"
2,2,2,291,564,654,1218,"6 de julio de 1997"
2,2,2,292,522,630,1152,"6 de julio de 1997"
2,2,2,293,516,547,1063,"6 de julio de 1997"
2,2,2,294,531,534,1065,"6 de julio de 1997"
2,2,2,295,295,317,612,"6 de julio de 1997"
2,2,2,296,380,445,825,"6 de julio de 1997"
2,2,2,297,479,530,1009,"6 de julio de 1997"
2,2,2,298,361,376,737,"6 de julio de 1997"
2,2,2,299,486,572,1058,"6 de julio de 1997"
2,2,2,300,418,467,885,"6 de julio de 1997"
2,2,2,301,516,590,1106,"6 de julio de 1997"
2,2,2,302,343,417,760,"6 de julio de 1997"
2,2,2,303,439,496,935,"6 de julio de 1997"
2,2,2,304,797,193,990,"6 de julio de 1997"
2,2,2,305,545,635,1180,"6 de julio de 1997"
2,2,2,306,577,635,1212,"6 de julio de 1997"
2,2,2,307,456,483,939,"6 de julio de 1997"
2,2,2,308,424,442,866,"6 de julio de 1997"
2,2,2,309,392,430,822,"6 de julio de 1997"
2,2,2,310,418,514,932,"6 de julio de 1997"
2,2,2,311,307,373,680,"6 de julio de 1997"
2,2,2,312,350,401,751,"6 de julio de 1997"
2,2,2,313,466,558,1024,"6 de julio de 1997"
2,2,2,314,393,485,878,"6 de julio de 1997"
2,2,2,315,362,409,771,"6 de julio de 1997"
2,2,2,316,522,559,1081,"6 de julio de 1997"
2,2,2,317,521,506,1027,"6 de julio de 1997"
2,2,2,318,350,401,751,"6 de julio de 1997"
2,2,2,319,465,509,974,"6 de julio de 1997"
2,2,2,320,399,397,796,"6 de julio de 1997"
2,2,2,321,560,598,1158,"6 de julio de 1997"
2,2,2,322,319,377,696,"6 de julio de 1997"
2,2,2,323,384,423,807,"6 de julio de 1997"
2,2,2,324,370,399,769,"6 de julio de 1997"
2,2,2,325,330,380,710,"6 de julio de 1997"
2,2,2,326,513,596,1109,"6 de julio de 1997"
2,2,2,327,458,554,1012,"6 de julio de 1997"
2,2,2,328,526,566,1092,"6 de julio de 1997"
2,2,2,329,458,544,1002,"6 de julio de 1997"
2,2,2,330,458,543,1001,"6 de julio de 1997"
2,2,2,331,702,849,1551,"6 de julio de 1997"
2,2,2,332,337,399,736,"6 de julio de 1997"
2,2,2,333,452,540,992,"6 de julio de 1997"
2,2,2,334,408,444,852,"6 de julio de 1997"
2,2,2,335,489,538,1027,"6 de julio de 1997"
2,2,2,336,354,379,733,"6 de julio de 1997"
2,2,2,337,478,492,970,"6 de julio de 1997"
2,2,2,338,651,696,1347,"6 de julio de 1997"
2,2,2,339,451,454,905,"6 de julio de 1997"
2,2,2,340,404,434,838,"6 de julio de 1997"
2,2,2,341,497,545,1042,"6 de julio de 1997"
2,2,2,342,532,588,1120,"6 de julio de 1997"
2,2,2,343,448,503,951,"6 de julio de 1997"
2,2,2,344,411,475,886,"6 de julio de 1997"
2,2,2,345,469,497,966,"6 de julio de 1997"
2,2,2,346,479,526,1005,"6 de julio de 1997"
2,2,2,347,510,567,1077,"6 de julio de 1997"
2,2,2,348,372,471,843,"6 de julio de 1997"
2,2,2,349,483,510,993,"6 de julio de 1997"
2,2,2,350,439,502,941,"6 de julio de 1997"
2,2,2,351,445,533,978,"6 de julio de 1997"
2,2,2,352,352,419,771,"6 de julio de 1997"
2,2,2,353,428,437,865,"6 de julio de 1997"
2,2,2,354,380,357,737,"6 de julio de 1997"
2,2,2,355,492,527,1019,"6 de julio de 1997"
2,2,2,356,590,643,1233,"6 de julio de 1997"
2,2,2,357,494,559,1053,"6 de julio de 1997"
2,2,2,358,506,557,1063,"6 de julio de 1997"
2,2,2,359,375,369,744,"6 de julio de 1997"
2,2,2,360,422,488,910,"6 de julio de 1997"
2,2,2,361,507,544,1051,"6 de julio de 1997"
2,2,2,362,466,547,1013,"6 de julio de 1997"
2,2,2,363,404,429,833,"6 de julio de 1997"
2,2,2,364,485,539,1024,"6 de julio de 1997"
2,2,2,365,506,561,1067,"6 de julio de 1997"
2,2,2,366,455,502,957,"6 de julio de 1997"
2,2,2,367,483,512,995,"6 de julio de 1997"
2,2,2,368,519,532,1051,"6 de julio de 1997"
2,2,2,369,307,366,673,"6 de julio de 1997"
2,2,2,370,390,428,818,"6 de julio de 1997"
2,2,2,371,359,426,785,"6 de julio de 1997"
2,2,2,372,399,449,848,"6 de julio de 1997"
2,2,2,373,354,396,750,"6 de julio de 1997"
2,2,2,388,538,624,1162,"6 de julio de 1997"
2,2,2,389,370,511,881,"6 de julio de 1997"
2,2,2,390,373,398,771,"6 de julio de 1997"
2,2,2,391,406,460,866,"6 de julio de 1997"
2,2,2,392,574,637,1211,"6 de julio de 1997"
2,2,2,393,443,512,955,"6 de julio de 1997"
2,2,2,394,449,476,925,"6 de julio de 1997"
2,2,2,399,476,587,1063,"6 de julio de 1997"
2,2,2,400,532,604,1136,"6 de julio de 1997"
2,2,2,401,516,539,1055,"6 de julio de 1997"
2,2,2,402,451,525,976,"6 de julio de 1997"
2,2,2,403,485,554,1039,"6 de julio de 1997"
2,2,2,404,357,441,798,"6 de julio de 1997"
2,2,2,405,392,445,837,"6 de julio de 1997"
2,2,2,406,563,625,1188,"6 de julio de 1997"
2,2,2,407,279,324,603,"6 de julio de 1997"
2,2,2,408,326,348,674,"6 de julio de 1997"
2,2,2,409,547,672,1219,"6 de julio de 1997"
2,2,2,410,426,449,875,"6 de julio de 1997"
2,2,2,411,535,603,1138,"6 de julio de 1997"
2,2,2,412,371,421,792,"6 de julio de 1997"
2,2,2,413,435,460,895,"6 de julio de 1997"
2,2,2,414,484,579,1063,"6 de julio de 1997"
2,2,2,415,404,445,849,"6 de julio de 1997"
2,2,2,416,411,430,841,"6 de julio de 1997"
2,2,2,417,519,601,1120,"6 de julio de 1997"
2,2,2,418,407,446,853,"6 de julio de 1997"
2,2,2,419,344,381,725,"6 de julio de 1997"
2,2,2,420,394,423,817,"6 de julio de 1997"
2,2,2,421,360,414,774,"6 de julio de 1997"
2,2,2,422,396,438,834,"6 de julio de 1997"
2,2,2,423,540,558,1098,"6 de julio de 1997"
2,2,2,424,489,567,1056,"6 de julio de 1997"
2,2,2,425,496,549,1045,"6 de julio de 1997"
2,2,2,426,419,485,904,"6 de julio de 1997"
2,2,2,427,423,459,882,"6 de julio de 1997"
2,2,2,428,275,312,587,"6 de julio de 1997"
2,2,2,429,411,465,876,"6 de julio de 1997"
2,2,2,430,424,469,893,"6 de julio de 1997"
2,2,2,431,388,443,831,"6 de julio de 1997"
2,2,2,433,513,518,1031,"6 de julio de 1997"
2,2,2,517,470,530,1000,"6 de julio de 1997"
2,2,2,518,446,570,1016,"6 de julio de 1997"
2,2,2,519,217,279,496,"6 de julio de 1997"
2,2,2,520,282,333,615,"6 de julio de 1997"
2,2,2,521,356,388,744,"6 de julio de 1997"
2,2,2,522,383,466,849,"6 de julio de 1997"
2,2,2,523,249,287,536,"6 de julio de 1997"
2,2,2,524,275,346,621,"6 de julio de 1997"
2,2,2,525,334,342,676,"6 de julio de 1997"
2,2,2,526,324,353,677,"6 de julio de 1997"
2,2,2,527,246,296,542,"6 de julio de 1997"
2,2,2,528,215,254,469,"6 de julio de 1997"
2,2,2,529,459,460,919,"6 de julio de 1997"
2,2,2,530,344,425,769,"6 de julio de 1997"
2,2,2,531,435,500,935,"6 de julio de 1997"
2,2,2,532,441,551,992,"6 de julio de 1997"
2,2,2,533,485,528,1013,"6 de julio de 1997"
2,2,2,534,283,296,579,"6 de julio de 1997"
2,2,2,535,150,198,348,"6 de julio de 1997"
2,2,2,536,193,201,394,"6 de julio de 1997"
2,2,2,537,289,324,613,"6 de julio de 1997"
2,2,2,538,654,768,1422,"6 de julio de 1997"
2,2,2,539,229,284,513,"6 de julio de 1997"
2,2,2,541,447,576,1023,"6 de julio de 1997"
2,2,2,542,443,508,951,"6 de julio de 1997"
2,2,2,543,352,426,778,"6 de julio de 1997"
2,2,2,544,841,1051,1892,"6 de julio de 1997"
2,2,2,545,305,349,654,"6 de julio de 1997"
2,2,2,546,168,191,359,"6 de julio de 1997"
2,2,2,547,335,402,737,"6 de julio de 1997"
2,2,2,565,632,721,1353,"6 de julio de 1997"
2,2,2,681,241,254,495,"6 de julio de 1997"
2,2,2,683,293,324,617,"6 de julio de 1997"
2,2,2,690,786,850,1636,"6 de julio de 1997"
2,2,2,691,1381,1599,2980,"6 de julio de 1997"
2,3,1,1,233,270,503,"6 de julio de 1997"
2,3,1,2,434,473,907,"6 de julio de 1997"
2,3,1,3,355,363,718,"6 de julio de 1997"
2,3,1,4,525,525,1050,"6 de julio de 1997"
2,3,1,5,225,224,449,"6 de julio de 1997"
2,3,1,6,225,196,421,"6 de julio de 1997"
2,3,1,7,276,272,548,"6 de julio de 1997"
2,3,1,8,280,317,597,"6 de julio de 1997"
2,3,1,9,408,472,880,"6 de julio de 1997"
2,3,1,10,440,474,914,"6 de julio de 1997"
2,3,1,11,566,682,1248,"6 de julio de 1997"
2,3,1,12,481,509,990,"6 de julio de 1997"
2,3,1,13,561,553,1114,"6 de julio de 1997"
2,3,1,14,1004,1116,2120,"6 de julio de 1997"
2,3,1,15,626,657,1283,"6 de julio de 1997"
2,3,1,16,669,682,1351,"6 de julio de 1997"
2,3,1,17,692,723,1415,"6 de julio de 1997"
2,3,1,18,632,675,1307,"6 de julio de 1997"
2,3,1,19,572,597,1169,"6 de julio de 1997"
2,3,1,20,416,480,896,"6 de julio de 1997"
2,3,1,21,335,336,671,"6 de julio de 1997"
2,3,1,22,448,494,942,"6 de julio de 1997"
2,3,1,23,547,618,1165,"6 de julio de 1997"
2,3,1,24,633,616,1249,"6 de julio de 1997"
2,3,1,25,453,502,955,"6 de julio de 1997"
2,3,1,26,333,398,731,"6 de julio de 1997"
2,3,1,27,540,574,1114,"6 de julio de 1997"
2,3,1,28,272,304,576,"6 de julio de 1997"
2,3,1,29,315,350,665,"6 de julio de 1997"
2,3,1,30,472,464,936,"6 de julio de 1997"
2,3,1,31,275,282,557,"6 de julio de 1997"
2,3,1,32,632,642,1274,"6 de julio de 1997"
2,3,1,33,578,604,1182,"6 de julio de 1997"
2,3,1,34,414,445,859,"6 de julio de 1997"
2,3,1,35,308,334,642,"6 de julio de 1997"
2,3,1,36,370,384,754,"6 de julio de 1997"
2,3,1,37,333,384,717,"6 de julio de 1997"
2,3,1,38,564,593,1157,"6 de julio de 1997"
2,3,1,39,557,610,1167,"6 de julio de 1997"
2,3,1,40,533,570,1103,"6 de julio de 1997"
2,3,1,41,463,507,970,"6 de julio de 1997"
2,3,1,42,406,421,827,"6 de julio de 1997"
2,3,1,43,479,502,981,"6 de julio de 1997"
2,3,1,44,330,315,645,"6 de julio de 1997"
2,3,1,45,359,372,731,"6 de julio de 1997"
2,3,1,46,384,456,840,"6 de julio de 1997"
2,3,1,47,553,557,1110,"6 de julio de 1997"
2,3,1,48,665,634,1299,"6 de julio de 1997"
2,3,1,49,352,163,515,"6 de julio de 1997"
2,3,1,50,529,268,797,"6 de julio de 1997"
2,3,1,51,339,289,628,"6 de julio de 1997"
2,3,1,52,451,416,867,"6 de julio de 1997"
2,3,1,53,338,309,647,"6 de julio de 1997"
2,3,1,54,436,489,925,"6 de julio de 1997"
2,3,1,55,311,333,644,"6 de julio de 1997"
2,3,1,56,389,400,789,"6 de julio de 1997"
2,3,1,57,251,257,508,"6 de julio de 1997"
2,3,1,58,637,674,1311,"6 de julio de 1997"
2,3,1,59,467,469,936,"6 de julio de 1997"
2,3,1,60,727,800,1527,"6 de julio de 1997"
2,3,1,61,512,547,1059,"6 de julio de 1997"
2,3,1,62,387,356,743,"6 de julio de 1997"
2,3,1,63,384,428,812,"6 de julio de 1997"
2,3,1,64,373,377,750,"6 de julio de 1997"
2,3,1,65,573,631,1204,"6 de julio de 1997"
2,3,1,66,412,465,877,"6 de julio de 1997"
2,3,1,67,417,426,843,"6 de julio de 1997"
2,3,1,68,419,441,860,"6 de julio de 1997"
2,3,1,69,446,432,878,"6 de julio de 1997"
2,3,1,70,394,426,820,"6 de julio de 1997"
2,3,1,71,398,407,805,"6 de julio de 1997"
2,3,1,72,562,593,1155,"6 de julio de 1997"
2,3,1,73,359,373,732,"6 de julio de 1997"
2,3,1,74,518,521,1039,"6 de julio de 1997"
2,3,1,75,544,535,1079,"6 de julio de 1997"
2,3,1,76,514,565,1079,"6 de julio de 1997"
2,3,1,77,514,567,1081,"6 de julio de 1997"
2,3,1,78,420,501,921,"6 de julio de 1997"
2,3,1,79,547,529,1076,"6 de julio de 1997"
2,3,1,80,344,403,747,"6 de julio de 1997"
2,3,1,81,267,282,549,"6 de julio de 1997"
2,3,1,82,218,217,435,"6 de julio de 1997"
2,3,1,83,463,474,937,"6 de julio de 1997"
2,3,1,84,470,454,924,"6 de julio de 1997"
2,3,1,85,385,454,839,"6 de julio de 1997"
2,3,1,86,649,682,1331,"6 de julio de 1997"
2,3,1,87,445,514,959,"6 de julio de 1997"
2,3,1,88,576,618,1194,"6 de julio de 1997"
2,3,1,89,463,496,959,"6 de julio de 1997"
2,3,1,90,518,599,1117,"6 de julio de 1997"
2,3,1,91,302,369,671,"6 de julio de 1997"
2,3,1,92,431,492,923,"6 de julio de 1997"
2,3,1,93,392,428,820,"6 de julio de 1997"
2,3,1,94,461,509,970,"6 de julio de 1997"
2,3,1,95,462,503,965,"6 de julio de 1997"
2,3,1,96,365,399,764,"6 de julio de 1997"
2,3,1,97,264,287,551,"6 de julio de 1997"
2,3,1,98,658,740,1398,"6 de julio de 1997"
2,3,1,99,462,499,961,"6 de julio de 1997"
2,3,1,100,656,685,1341,"6 de julio de 1997"
2,3,1,101,510,556,1066,"6 de julio de 1997"
2,3,1,102,651,730,1381,"6 de julio de 1997"
2,3,1,103,587,635,1222,"6 de julio de 1997"
2,3,1,104,642,681,1323,"6 de julio de 1997"
2,3,1,105,596,692,1288,"6 de julio de 1997"
2,3,1,106,573,635,1208,"6 de julio de 1997"
2,3,1,107,560,589,1149,"6 de julio de 1997"
2,3,1,108,525,545,1070,"6 de julio de 1997"
2,3,1,109,536,558,1094,"6 de julio de 1997"
2,3,1,110,499,559,1058,"6 de julio de 1997"
2,3,1,111,244,280,524,"6 de julio de 1997"
2,3,1,112,323,373,696,"6 de julio de 1997"
2,3,1,113,601,637,1238,"6 de julio de 1997"
2,3,1,114,417,498,915,"6 de julio de 1997"
2,3,1,115,356,408,764,"6 de julio de 1997"
2,3,1,116,728,841,1569,"6 de julio de 1997"
2,3,1,117,310,388,698,"6 de julio de 1997"
2,3,1,118,469,518,987,"6 de julio de 1997"
2,3,1,119,398,469,867,"6 de julio de 1997"
2,3,1,120,353,412,765,"6 de julio de 1997"
2,3,1,121,336,409,745,"6 de julio de 1997"
2,3,1,122,600,284,884,"6 de julio de 1997"
2,3,1,123,453,440,893,"6 de julio de 1997"
2,3,1,124,169,148,317,"6 de julio de 1997"
2,3,1,125,316,328,644,"6 de julio de 1997"
2,3,1,126,647,689,1336,"6 de julio de 1997"
2,3,1,127,463,482,945,"6 de julio de 1997"
2,3,1,128,418,408,826,"6 de julio de 1997"
2,3,1,129,384,360,744,"6 de julio de 1997"
2,3,1,130,522,565,1087,"6 de julio de 1997"
2,3,1,131,508,517,1025,"6 de julio de 1997"
2,3,1,132,629,637,1266,"6 de julio de 1997"
2,3,1,133,516,549,1065,"6 de julio de 1997"
2,3,1,134,511,586,1097,"6 de julio de 1997"
2,3,1,135,457,412,869,"6 de julio de 1997"
2,3,1,136,304,285,589,"6 de julio de 1997"
2,3,1,137,326,357,683,"6 de julio de 1997"
2,3,1,138,321,305,626,"6 de julio de 1997"
2,3,1,139,451,473,924,"6 de julio de 1997"
2,3,1,140,365,411,776,"6 de julio de 1997"
2,3,1,141,366,391,757,"6 de julio de 1997"
2,3,1,142,332,319,651,"6 de julio de 1997"
2,3,1,143,236,215,451,"6 de julio de 1997"
2,3,1,144,221,215,436,"6 de julio de 1997"
2,3,1,145,225,227,452,"6 de julio de 1997"
2,3,1,146,349,324,673,"6 de julio de 1997"
2,3,1,147,169,169,338,"6 de julio de 1997"
2,3,1,148,310,272,582,"6 de julio de 1997"
2,3,1,149,286,304,590,"6 de julio de 1997"
2,3,1,150,347,315,662,"6 de julio de 1997"
2,3,1,151,540,457,997,"6 de julio de 1997"
2,3,1,152,592,538,1130,"6 de julio de 1997"
2,3,1,153,671,623,1294,"6 de julio de 1997"
2,3,1,154,518,505,1023,"6 de julio de 1997"
2,3,1,155,343,330,673,"6 de julio de 1997"
2,3,1,156,306,315,621,"6 de julio de 1997"
2,3,1,157,269,290,559,"6 de julio de 1997"
2,3,1,158,558,576,1134,"6 de julio de 1997"
2,3,1,159,291,324,615,"6 de julio de 1997"
2,3,1,160,757,418,1175,"6 de julio de 1997"
2,3,1,161,289,290,579,"6 de julio de 1997"
2,3,1,162,415,364,779,"6 de julio de 1997"
2,3,1,163,267,219,486,"6 de julio de 1997"
2,3,1,164,304,263,567,"6 de julio de 1997"
2,3,1,165,196,163,359,"6 de julio de 1997"
2,3,1,166,465,470,935,"6 de julio de 1997"
2,3,1,167,141,71,212,"6 de julio de 1997"
2,3,1,168,491,476,967,"6 de julio de 1997"
2,3,1,169,243,210,453,"6 de julio de 1997"
2,3,1,170,248,199,447,"6 de julio de 1997"
2,3,1,171,467,395,862,"6 de julio de 1997"
2,3,1,172,111,79,190,"6 de julio de 1997"
2,3,1,173,323,284,607,"6 de julio de 1997"
2,3,1,174,80,74,154,"6 de julio de 1997"
2,3,1,175,172,180,352,"6 de julio de 1997"
2,3,1,176,798,708,1506,"6 de julio de 1997"
2,3,1,177,248,221,469,"6 de julio de 1997"
2,3,1,178,617,600,1217,"6 de julio de 1997"
2,3,1,179,315,208,523,"6 de julio de 1997"
2,3,1,180,295,198,493,"6 de julio de 1997"
2,3,1,181,321,248,569,"6 de julio de 1997"
2,3,1,182,254,180,434,"6 de julio de 1997"
2,3,1,183,305,278,583,"6 de julio de 1997"
2,3,1,184,145,111,256,"6 de julio de 1997"
2,3,1,185,707,569,1276,"6 de julio de 1997"
2,3,1,186,508,449,957,"6 de julio de 1997"
2,3,1,187,503,471,974,"6 de julio de 1997"
2,3,1,188,265,223,488,"6 de julio de 1997"
2,3,1,189,901,814,1715,"6 de julio de 1997"
2,3,1,190,483,435,918,"6 de julio de 1997"
2,3,1,191,242,253,495,"6 de julio de 1997"
2,3,1,192,772,705,1477,"6 de julio de 1997"
2,3,1,193,95,65,160,"6 de julio de 1997"
2,3,1,194,590,483,1073,"6 de julio de 1997"
2,3,1,195,489,425,914,"6 de julio de 1997"
2,3,1,196,248,204,452,"6 de julio de 1997"
2,3,1,197,493,388,881,"6 de julio de 1997"
2,3,1,198,165,157,322,"6 de julio de 1997"
2,3,1,199,591,501,1092,"6 de julio de 1997"
2,3,1,200,132,105,237,"6 de julio de 1997"
2,3,1,201,167,122,289,"6 de julio de 1997"
2,3,1,202,174,140,314,"6 de julio de 1997"
2,3,1,203,188,138,326,"6 de julio de 1997"
2,3,1,204,46,30,76,"6 de julio de 1997"
2,3,1,205,14,1,15,"6 de julio de 1997"
2,3,1,206,392,414,806,"6 de julio de 1997"
2,3,1,207,313,323,636,"6 de julio de 1997"
2,3,1,208,485,495,980,"6 de julio de 1997"
2,3,1,209,548,574,1122,"6 de julio de 1997"
2,3,1,210,286,263,549,"6 de julio de 1997"
2,3,3,694,523,531,1054,"6 de julio de 1997"
2,3,3,695,438,436,874,"6 de julio de 1997"
2,3,3,696,755,755,1510,"6 de julio de 1997"
2,3,3,697,611,631,1242,"6 de julio de 1997"
2,3,3,698,444,393,837,"6 de julio de 1997"
2,3,3,699,469,471,940,"6 de julio de 1997"
2,3,3,700,607,621,1228,"6 de julio de 1997"
2,3,3,701,577,574,1151,"6 de julio de 1997"
2,3,3,702,509,479,988,"6 de julio de 1997"
2,3,3,703,605,656,1261,"6 de julio de 1997"
2,3,3,704,346,357,703,"6 de julio de 1997"
2,3,3,705,600,694,1294,"6 de julio de 1997"
2,3,3,706,600,581,1181,"6 de julio de 1997"
2,3,3,707,493,562,1055,"6 de julio de 1997"
2,3,3,708,437,489,926,"6 de julio de 1997"
2,3,3,709,536,512,1048,"6 de julio de 1997"
2,3,3,710,475,425,900,"6 de julio de 1997"
2,3,3,711,603,616,1219,"6 de julio de 1997"
2,3,3,712,640,655,1295,"6 de julio de 1997"
2,3,3,713,601,591,1192,"6 de julio de 1997"
2,3,3,714,616,643,1259,"6 de julio de 1997"
2,3,3,715,754,721,1475,"6 de julio de 1997"
2,3,3,716,575,595,1170,"6 de julio de 1997"
2,3,3,717,515,527,1042,"6 de julio de 1997"
2,3,3,718,456,489,945,"6 de julio de 1997"
2,3,3,719,493,497,990,"6 de julio de 1997"
2,3,3,720,481,503,984,"6 de julio de 1997"
2,3,3,721,598,596,1194,"6 de julio de 1997"
2,3,3,722,798,813,1611,"6 de julio de 1997"
2,3,3,723,854,797,1651,"6 de julio de 1997"
2,3,3,724,597,447,1044,"6 de julio de 1997"
2,3,3,725,313,253,566,"6 de julio de 1997"
2,3,3,726,280,309,589,"6 de julio de 1997"
2,3,3,727,227,168,395,"6 de julio de 1997"
2,3,3,728,184,123,307,"6 de julio de 1997"
2,3,3,729,281,255,536,"6 de julio de 1997"
2,3,3,730,356,263,619,"6 de julio de 1997"
2,3,3,731,144,109,253,"6 de julio de 1997"
2,3,3,732,102,88,190,"6 de julio de 1997"
2,3,3,733,219,159,378,"6 de julio de 1997"
2,3,3,734,199,164,363,"6 de julio de 1997"
2,3,5,1194,369,332,701,"6 de julio de 1997"
2,3,5,1259,418,435,853,"6 de julio de 1997"
2,3,5,1260,517,516,1033,"6 de julio de 1997"
2,3,5,1261,510,537,1047,"6 de julio de 1997"
2,3,5,1262,655,681,1336,"6 de julio de 1997"
2,3,5,1263,829,872,1701,"6 de julio de 1997"
2,3,5,1264,582,592,1174,"6 de julio de 1997"
2,3,5,1265,482,528,1010,"6 de julio de 1997"
2,3,5,1266,566,667,1233,"6 de julio de 1997"
2,3,5,1267,230,230,460,"6 de julio de 1997"
2,3,5,1268,288,294,582,"6 de julio de 1997"
2,3,5,1269,471,448,919,"6 de julio de 1997"
2,3,5,1270,419,378,797,"6 de julio de 1997"
2,3,5,1271,485,488,973,"6 de julio de 1997"
2,3,5,1272,332,313,645,"6 de julio de 1997"
2,3,5,1273,379,332,711,"6 de julio de 1997"
2,3,5,1290,366,335,701,"6 de julio de 1997"
2,3,5,1291,351,337,688,"6 de julio de 1997"
2,3,5,1295,743,779,1522,"6 de julio de 1997"
2,3,5,1297,242,235,477,"6 de julio de 1997"
2,3,5,1298,252,217,469,"6 de julio de 1997"
2,3,5,1363,77,76,153,"6 de julio de 1997"
2,3,5,1364,268,223,491,"6 de julio de 1997"
2,3,5,1365,338,333,671,"6 de julio de 1997"
2,3,5,1366,270,291,561,"6 de julio de 1997"
2,3,5,1367,114,122,236,"6 de julio de 1997"
2,3,5,1370,177,151,328,"6 de julio de 1997"
2,4,4,964,491,480,971,"6 de julio de 1997"
2,4,4,965,528,560,1088,"6 de julio de 1997"
2,4,4,966,543,582,1125,"6 de julio de 1997"
2,4,4,967,290,350,640,"6 de julio de 1997"
2,4,4,968,291,323,614,"6 de julio de 1997"
2,4,4,1000,254,243,497,"6 de julio de 1997"
2,4,4,1001,411,396,807,"6 de julio de 1997"
2,4,4,1002,503,535,1038,"6 de julio de 1997"
2,4,4,1003,419,505,924,"6 de julio de 1997"
2,4,4,1004,464,536,1000,"6 de julio de 1997"
2,4,4,1005,307,341,648,"6 de julio de 1997"
2,4,4,1006,299,346,645,"6 de julio de 1997"
2,4,4,1007,432,504,936,"6 de julio de 1997"
2,4,4,1008,319,358,677,"6 de julio de 1997"
2,4,4,1009,342,399,741,"6 de julio de 1997"
2,4,4,1010,160,194,354,"6 de julio de 1997"
2,4,4,1011,503,440,943,"6 de julio de 1997"
2,4,4,1012,347,403,750,"6 de julio de 1997"
2,4,4,1013,433,538,971,"6 de julio de 1997"
2,4,4,1014,455,512,967,"6 de julio de 1997"
2,4,4,1031,366,400,766,"6 de julio de 1997"
2,4,4,1032,380,388,768,"6 de julio de 1997"
2,4,4,1033,336,333,669,"6 de julio de 1997"
2,4,4,1034,381,406,787,"6 de julio de 1997"
2,4,4,1035,340,344,684,"6 de julio de 1997"
2,4,4,1036,421,494,915,"6 de julio de 1997"
2,4,4,1037,332,358,690,"6 de julio de 1997"
2,4,4,1045,620,680,1300,"6 de julio de 1997"
2,4,4,1046,452,442,894,"6 de julio de 1997"
2,4,4,1047,716,707,1423,"6 de julio de 1997"
2,4,4,1048,895,806,1701,"6 de julio de 1997"
2,4,4,1049,1070,970,2040,"6 de julio de 1997"
2,4,4,1050,656,609,1265,"6 de julio de 1997"
2,4,4,1051,450,413,863,"6 de julio de 1997"
2,4,4,1052,743,775,1518,"6 de julio de 1997"
2,4,4,1072,445,455,900,"6 de julio de 1997"
2,4,4,1073,548,478,1026,"6 de julio de 1997"
2,4,4,1074,503,476,979,"6 de julio de 1997"
2,4,4,1075,502,480,982,"6 de julio de 1997"
2,4,4,1076,828,959,1787,"6 de julio de 1997"
2,4,4,1096,543,590,1133,"6 de julio de 1997"
2,4,4,1097,1007,1061,2068,"6 de julio de 1997"
2,4,4,1098,598,508,1106,"6 de julio de 1997"
2,4,4,1099,592,597,1189,"6 de julio de 1997"
2,4,4,1100,521,492,1013,"6 de julio de 1997"
2,4,4,1101,791,804,1595,"6 de julio de 1997"
2,4,4,1102,361,395,756,"6 de julio de 1997"
2,4,4,1103,842,844,1686,"6 de julio de 1997"
2,4,4,1104,288,292,580,"6 de julio de 1997"
2,4,4,1117,224,235,459,"6 de julio de 1997"
2,4,4,1118,553,586,1139,"6 de julio de 1997"
2,4,4,1119,867,962,1829,"6 de julio de 1997"
2,4,4,1120,246,296,542,"6 de julio de 1997"
2,4,4,1121,572,610,1182,"6 de julio de 1997"
2,4,4,1122,1022,1051,2073,"6 de julio de 1997"
2,4,4,1123,336,335,671,"6 de julio de 1997"
2,4,4,1124,395,364,759,"6 de julio de 1997"
2,4,4,1125,366,367,733,"6 de julio de 1997"
2,4,4,1126,345,347,692,"6 de julio de 1997"
2,4,4,1127,280,267,547,"6 de julio de 1997"
2,4,4,1128,778,741,1519,"6 de julio de 1997"
2,4,4,1129,457,458,915,"6 de julio de 1997"
2,4,4,1130,481,533,1014,"6 de julio de 1997"
2,4,4,1131,607,606,1213,"6 de julio de 1997"
2,4,4,1132,530,635,1165,"6 de julio de 1997"
2,4,4,1138,641,649,1290,"6 de julio de 1997"
2,4,4,1139,646,632,1278,"6 de julio de 1997"
2,4,4,1140,895,939,1834,"6 de julio de 1997"
2,4,4,1141,542,559,1101,"6 de julio de 1997"
2,4,4,1142,542,550,1092,"6 de julio de 1997"
2,4,4,1143,833,846,1679,"6 de julio de 1997"
2,4,4,1144,470,519,989,"6 de julio de 1997"
2,4,4,1145,754,874,1628,"6 de julio de 1997"
2,4,4,1146,614,786,1400,"6 de julio de 1997"
2,4,4,1147,673,759,1432,"6 de julio de 1997"
2,4,4,1148,275,330,605,"6 de julio de 1997"
2,4,4,1149,732,776,1508,"6 de julio de 1997"
2,4,4,1150,368,371,739,"6 de julio de 1997"
2,4,4,1151,449,457,906,"6 de julio de 1997"
2,4,4,1152,1112,1089,2201,"6 de julio de 1997"
2,4,4,1153,963,981,1944,"6 de julio de 1997"
2,4,4,1154,619,609,1228,"6 de julio de 1997"
2,4,4,1155,467,472,939,"6 de julio de 1997"
2,4,4,1156,622,617,1239,"6 de julio de 1997"
2,4,4,1157,1502,1521,3023,"6 de julio de 1997"
2,4,4,1158,718,728,1446,"6 de julio de 1997"
2,4,4,1159,500,476,976,"6 de julio de 1997"
2,4,4,1160,597,662,1259,"6 de julio de 1997"
2,4,4,1161,304,365,669,"6 de julio de 1997"
2,4,4,1162,446,516,962,"6 de julio de 1997"
2,4,4,1163,460,464,924,"6 de julio de 1997"
2,4,4,1164,559,639,1198,"6 de julio de 1997"
2,4,4,1169,964,884,1848,"6 de julio de 1997"
2,4,4,1170,466,514,980,"6 de julio de 1997"
2,4,4,1171,419,495,914,"6 de julio de 1997"
2,4,4,1172,343,326,669,"6 de julio de 1997"
2,4,4,1173,456,470,926,"6 de julio de 1997"
2,4,4,1174,594,592,1186,"6 de julio de 1997"
2,4,4,1175,590,579,1169,"6 de julio de 1997"
2,4,4,1176,289,327,616,"6 de julio de 1997"
2,4,4,1177,616,656,1272,"6 de julio de 1997"
2,4,4,1178,320,353,673,"6 de julio de 1997"
2,4,4,1179,430,405,835,"6 de julio de 1997"
2,4,4,1180,538,562,1100,"6 de julio de 1997"
2,4,4,1181,375,357,732,"6 de julio de 1997"
2,4,4,1182,424,432,856,"6 de julio de 1997"
2,4,4,1183,486,459,945,"6 de julio de 1997"
2,4,4,1184,549,577,1126,"6 de julio de 1997"
2,4,4,1185,603,601,1204,"6 de julio de 1997"
2,4,4,1186,451,436,887,"6 de julio de 1997"
2,4,4,1187,603,630,1233,"6 de julio de 1997"
2,4,4,1188,456,462,918,"6 de julio de 1997"
2,4,4,1189,1567,1659,3226,"6 de julio de 1997"
2,4,4,1190,617,556,1173,"6 de julio de 1997"
2,4,4,1214,416,380,796,"6 de julio de 1997"
2,4,4,1215,435,465,900,"6 de julio de 1997"
2,4,4,1216,384,399,783,"6 de julio de 1997"
2,4,4,1217,563,643,1206,"6 de julio de 1997"
2,4,4,1218,506,513,1019,"6 de julio de 1997"
2,4,4,1219,493,470,963,"6 de julio de 1997"
2,4,4,1220,579,522,1101,"6 de julio de 1997"
2,4,4,1221,619,610,1229,"6 de julio de 1997"
2,4,4,1222,476,518,994,"6 de julio de 1997"
2,4,4,1223,506,516,1022,"6 de julio de 1997"
2,4,4,1224,388,416,804,"6 de julio de 1997"
2,4,4,1225,312,337,649,"6 de julio de 1997"
2,4,4,1226,519,573,1092,"6 de julio de 1997"
2,4,4,1227,377,378,755,"6 de julio de 1997"
2,4,4,1228,533,556,1089,"6 de julio de 1997"
2,4,4,1229,522,523,1045,"6 de julio de 1997"
2,4,4,1230,695,716,1411,"6 de julio de 1997"
2,4,4,1231,412,427,839,"6 de julio de 1997"
2,4,4,1232,541,543,1084,"6 de julio de 1997"
2,4,4,1233,482,469,951,"6 de julio de 1997"
2,4,4,1234,349,428,777,"6 de julio de 1997"
2,4,4,1235,295,320,615,"6 de julio de 1997"
2,4,4,1236,1455,1535,2990,"6 de julio de 1997"
2,4,4,1274,294,349,643,"6 de julio de 1997"
2,4,4,1275,280,298,578,"6 de julio de 1997"
2,4,4,1276,523,507,1030,"6 de julio de 1997"
2,4,4,1277,427,467,894,"6 de julio de 1997"
2,4,4,1278,1160,1262,2422,"6 de julio de 1997"
2,4,4,1279,555,542,1097,"6 de julio de 1997"
2,4,4,1280,537,562,1099,"6 de julio de 1997"
2,4,4,1281,332,344,676,"6 de julio de 1997"
2,4,4,1282,444,441,885,"6 de julio de 1997"
2,4,4,1292,1723,1542,3265,"6 de julio de 1997"
2,4,4,1293,172,130,302,"6 de julio de 1997"
2,4,4,1294,337,264,601,"6 de julio de 1997"
2,4,4,1300,1016,1125,2141,"6 de julio de 1997"
2,4,4,1301,357,374,731,"6 de julio de 1997"
2,4,4,1302,662,655,1317,"6 de julio de 1997"
2,4,4,1303,544,481,1025,"6 de julio de 1997"
2,4,4,1310,454,463,917,"6 de julio de 1997"
2,4,4,1311,555,480,1035,"6 de julio de 1997"
2,4,4,1312,459,408,867,"6 de julio de 1997"
2,4,4,1313,327,339,666,"6 de julio de 1997"
2,4,4,1314,464,479,943,"6 de julio de 1997"
2,4,4,1318,418,459,877,"6 de julio de 1997"
2,4,4,1319,675,601,1276,"6 de julio de 1997"
2,4,4,1320,476,482,958,"6 de julio de 1997"
2,4,4,1321,915,894,1809,"6 de julio de 1997"
2,4,4,1322,306,328,634,"6 de julio de 1997"
2,4,4,1325,335,340,675,"6 de julio de 1997"
2,4,4,1326,415,444,859,"6 de julio de 1997"
2,4,4,1327,753,800,1553,"6 de julio de 1997"
2,4,4,1328,1294,1300,2594,"6 de julio de 1997"
2,4,4,1329,383,441,824,"6 de julio de 1997"
2,4,4,1330,287,326,613,"6 de julio de 1997"
2,4,4,1331,613,708,1321,"6 de julio de 1997"
2,4,4,1332,451,511,962,"6 de julio de 1997"
2,4,4,1333,282,310,592,"6 de julio de 1997"
2,4,4,1334,347,397,744,"6 de julio de 1997"
2,4,4,1335,475,579,1054,"6 de julio de 1997"
2,4,4,1336,1412,1596,3008,"6 de julio de 1997"
2,4,4,1337,524,565,1089,"6 de julio de 1997"
2,4,4,1338,256,290,546,"6 de julio de 1997"
2,4,4,1339,287,336,623,"6 de julio de 1997"
2,4,4,1340,322,346,668,"6 de julio de 1997"
2,4,4,1341,359,328,687,"6 de julio de 1997"
2,4,4,1353,270,263,533,"6 de julio de 1997"
2,4,4,1354,2045,2187,4232,"6 de julio de 1997"
2,4,4,1369,0,0,0,"6 de julio de 1997"
2,5,4,868,577,396,973,"6 de julio de 1997"
2,5,4,869,291,255,546,"6 de julio de 1997"
2,5,4,870,217,210,427,"6 de julio de 1997"
2,5,4,871,345,449,794,"6 de julio de 1997"
2,5,4,872,441,532,973,"6 de julio de 1997"
2,5,4,873,434,321,755,"6 de julio de 1997"
2,5,4,874,563,418,981,"6 de julio de 1997"
2,5,4,875,436,379,815,"6 de julio de 1997"
2,5,4,876,375,347,722,"6 de julio de 1997"
2,5,4,877,204,183,387,"6 de julio de 1997"
2,5,4,878,361,310,671,"6 de julio de 1997"
2,5,4,879,199,212,411,"6 de julio de 1997"
2,5,4,880,491,389,880,"6 de julio de 1997"
2,5,4,881,336,310,646,"6 de julio de 1997"
2,5,4,882,436,449,885,"6 de julio de 1997"
2,5,4,883,360,393,753,"6 de julio de 1997"
2,5,4,884,540,637,1177,"6 de julio de 1997"
2,5,4,885,257,322,579,"6 de julio de 1997"
2,5,4,886,354,450,804,"6 de julio de 1997"
2,5,4,887,297,380,677,"6 de julio de 1997"
2,5,4,888,302,358,660,"6 de julio de 1997"
2,5,4,889,322,321,643,"6 de julio de 1997"
2,5,4,890,243,280,523,"6 de julio de 1997"
2,5,4,891,440,441,881,"6 de julio de 1997"
2,5,4,892,393,331,724,"6 de julio de 1997"
2,5,4,896,439,467,906,"6 de julio de 1997"
2,5,4,897,466,526,992,"6 de julio de 1997"
2,5,4,898,504,539,1043,"6 de julio de 1997"
2,5,4,899,222,276,498,"6 de julio de 1997"
2,5,4,900,476,489,965,"6 de julio de 1997"
2,5,4,901,506,557,1063,"6 de julio de 1997"
2,5,4,902,271,351,622,"6 de julio de 1997"
2,5,4,904,355,401,756,"6 de julio de 1997"
2,5,4,927,574,572,1146,"6 de julio de 1997"
2,5,4,928,370,439,809,"6 de julio de 1997"
2,5,4,929,293,331,624,"6 de julio de 1997"
2,5,4,930,506,532,1038,"6 de julio de 1997"
2,5,4,931,492,601,1093,"6 de julio de 1997"
2,5,4,932,212,282,494,"6 de julio de 1997"
2,5,4,933,352,441,793,"6 de julio de 1997"
2,5,4,934,393,503,896,"6 de julio de 1997"
2,5,4,935,588,631,1219,"6 de julio de 1997"
2,5,4,936,360,424,784,"6 de julio de 1997"
2,5,4,937,396,431,827,"6 de julio de 1997"
2,5,4,938,295,318,613,"6 de julio de 1997"
2,5,4,939,390,416,806,"6 de julio de 1997"
2,5,4,940,458,500,958,"6 de julio de 1997"
2,5,4,941,247,337,584,"6 de julio de 1997"
2,5,4,942,444,591,1035,"6 de julio de 1997"
2,5,4,943,411,409,820,"6 de julio de 1997"
2,5,4,957,348,387,735,"6 de julio de 1997"
2,5,4,958,430,537,967,"6 de julio de 1997"
2,5,4,959,425,507,932,"6 de julio de 1997"
2,5,4,960,495,571,1066,"6 de julio de 1997"
2,5,4,961,403,439,842,"6 de julio de 1997"
2,5,4,962,553,627,1180,"6 de julio de 1997"
2,5,4,963,318,369,687,"6 de julio de 1997"
2,5,4,969,441,411,852,"6 de julio de 1997"
2,5,4,970,397,447,844,"6 de julio de 1997"
2,5,4,971,347,319,666,"6 de julio de 1997"
2,5,4,972,483,525,1008,"6 de julio de 1997"
2,5,4,973,407,424,831,"6 de julio de 1997"
2,5,4,974,340,420,760,"6 de julio de 1997"
2,5,4,975,323,337,660,"6 de julio de 1997"
2,5,4,976,398,405,803,"6 de julio de 1997"
2,5,4,999,404,477,881,"6 de julio de 1997"
2,5,4,1015,433,471,904,"6 de julio de 1997"
2,5,4,1016,384,417,801,"6 de julio de 1997"
2,5,4,1019,226,264,490,"6 de julio de 1997"
2,5,4,1020,305,319,624,"6 de julio de 1997"
2,5,4,1021,257,283,540,"6 de julio de 1997"
2,5,4,1022,313,340,653,"6 de julio de 1997"
2,5,4,1025,284,321,605,"6 de julio de 1997"
2,5,4,1030,366,370,736,"6 de julio de 1997"
2,5,4,1038,478,496,974,"6 de julio de 1997"
2,5,4,1039,637,691,1328,"6 de julio de 1997"
2,5,4,1040,505,587,1092,"6 de julio de 1997"
2,5,4,1041,382,447,829,"6 de julio de 1997"
2,5,4,1042,538,548,1086,"6 de julio de 1997"
2,5,4,1043,433,433,866,"6 de julio de 1997"
2,5,4,1044,830,902,1732,"6 de julio de 1997"
2,5,4,1053,402,392,794,"6 de julio de 1997"
2,5,4,1054,455,462,917,"6 de julio de 1997"
2,5,4,1055,382,334,716,"6 de julio de 1997"
2,5,4,1056,372,465,837,"6 de julio de 1997"
2,5,4,1057,419,485,904,"6 de julio de 1997"
2,5,4,1058,524,572,1096,"6 de julio de 1997"
2,5,4,1059,519,586,1105,"6 de julio de 1997"
2,5,4,1060,558,626,1184,"6 de julio de 1997"
2,5,4,1061,338,357,695,"6 de julio de 1997"
2,5,4,1062,452,534,986,"6 de julio de 1997"
2,5,4,1063,488,467,955,"6 de julio de 1997"
2,5,4,1064,355,394,749,"6 de julio de 1997"
2,5,4,1065,380,374,754,"6 de julio de 1997"
2,5,4,1066,364,404,768,"6 de julio de 1997"
2,5,4,1067,274,319,593,"6 de julio de 1997"
2,5,4,1068,410,363,773,"6 de julio de 1997"
2,5,4,1069,402,479,881,"6 de julio de 1997"
2,5,4,1070,655,664,1319,"6 de julio de 1997"
2,5,4,1071,506,560,1066,"6 de julio de 1997"
2,5,4,1077,585,681,1266,"6 de julio de 1997"
2,5,4,1078,730,664,1394,"6 de julio de 1997"
2,5,4,1079,515,497,1012,"6 de julio de 1997"
2,5,4,1080,461,438,899,"6 de julio de 1997"
2,5,4,1081,486,493,979,"6 de julio de 1997"
2,5,4,1082,328,341,669,"6 de julio de 1997"
2,5,4,1083,628,569,1197,"6 de julio de 1997"
2,5,4,1084,370,431,801,"6 de julio de 1997"
2,5,4,1085,500,526,1026,"6 de julio de 1997"
2,5,4,1086,431,527,958,"6 de julio de 1997"
2,5,4,1087,368,383,751,"6 de julio de 1997"
2,5,4,1088,419,454,873,"6 de julio de 1997"
2,5,4,1089,498,457,955,"6 de julio de 1997"
2,5,4,1090,555,584,1139,"6 de julio de 1997"
2,5,4,1091,482,468,950,"6 de julio de 1997"
2,5,4,1092,553,585,1138,"6 de julio de 1997"
2,5,4,1093,653,759,1412,"6 de julio de 1997"
2,5,4,1094,528,614,1142,"6 de julio de 1997"
2,5,4,1095,541,591,1132,"6 de julio de 1997"
2,5,4,1105,282,296,578,"6 de julio de 1997"
2,5,4,1106,502,549,1051,"6 de julio de 1997"
2,5,4,1107,589,610,1199,"6 de julio de 1997"
2,5,4,1108,349,365,714,"6 de julio de 1997"
2,5,4,1109,565,636,1201,"6 de julio de 1997"
2,5,4,1110,482,520,1002,"6 de julio de 1997"
2,5,4,1111,383,450,833,"6 de julio de 1997"
2,5,4,1112,457,449,906,"6 de julio de 1997"
2,5,4,1113,482,500,982,"6 de julio de 1997"
2,5,4,1114,443,448,891,"6 de julio de 1997"
2,5,4,1115,354,335,689,"6 de julio de 1997"
2,5,4,1116,732,723,1455,"6 de julio de 1997"
2,5,4,1133,321,333,654,"6 de julio de 1997"
2,5,4,1134,325,321,646,"6 de julio de 1997"
2,5,4,1135,651,588,1239,"6 de julio de 1997"
2,5,4,1136,384,351,735,"6 de julio de 1997"
2,5,4,1137,566,615,1181,"6 de julio de 1997"
2,5,4,1165,420,386,806,"6 de julio de 1997"
2,5,4,1166,412,422,834,"6 de julio de 1997"
2,5,4,1167,549,601,1150,"6 de julio de 1997"
2,5,4,1168,744,772,1516,"6 de julio de 1997"
2,5,4,1191,662,661,1323,"6 de julio de 1997"
2,5,4,1192,700,764,1464,"6 de julio de 1997"
2,5,4,1193,514,561,1075,"6 de julio de 1997"
2,5,4,1195,637,631,1268,"6 de julio de 1997"
2,5,4,1196,527,544,1071,"6 de julio de 1997"
2,5,4,1197,478,514,992,"6 de julio de 1997"
2,5,4,1198,791,755,1546,"6 de julio de 1997"
2,5,4,1199,577,585,1162,"6 de julio de 1997"
2,5,4,1200,652,656,1308,"6 de julio de 1997"
2,5,4,1201,598,605,1203,"6 de julio de 1997"
2,5,4,1202,816,795,1611,"6 de julio de 1997"
2,5,4,1203,676,678,1354,"6 de julio de 1997"
2,5,4,1204,568,585,1153,"6 de julio de 1997"
2,5,4,1205,569,605,1174,"6 de julio de 1997"
2,5,4,1206,153,181,334,"6 de julio de 1997"
2,5,4,1207,63,56,119,"6 de julio de 1997"
2,5,4,1208,152,128,280,"6 de julio de 1997"
2,5,4,1209,488,500,988,"6 de julio de 1997"
2,5,4,1210,513,603,1116,"6 de julio de 1997"
2,5,4,1211,474,519,993,"6 de julio de 1997"
2,5,4,1212,689,764,1453,"6 de julio de 1997"
2,5,4,1213,595,687,1282,"6 de julio de 1997"
2,5,4,1237,660,736,1396,"6 de julio de 1997"
2,5,4,1238,851,884,1735,"6 de julio de 1997"
2,5,4,1239,895,907,1802,"6 de julio de 1997"
2,5,4,1240,619,641,1260,"6 de julio de 1997"
2,5,4,1241,530,508,1038,"6 de julio de 1997"
2,5,4,1242,1047,1134,2181,"6 de julio de 1997"
2,5,4,1243,352,374,726,"6 de julio de 1997"
2,5,4,1244,645,693,1338,"6 de julio de 1997"
2,5,4,1283,358,368,726,"6 de julio de 1997"
2,5,4,1284,589,592,1181,"6 de julio de 1997"
2,5,4,1285,386,437,823,"6 de julio de 1997"
2,5,4,1286,690,752,1442,"6 de julio de 1997"
2,5,4,1287,423,458,881,"6 de julio de 1997"
2,5,4,1288,498,514,1012,"6 de julio de 1997"
2,5,4,1289,648,583,1231,"6 de julio de 1997"
2,5,4,1299,326,357,683,"6 de julio de 1997"
2,5,4,1304,423,464,887,"6 de julio de 1997"
2,5,4,1305,411,423,834,"6 de julio de 1997"
2,5,4,1306,188,229,417,"6 de julio de 1997"
2,5,4,1307,378,392,770,"6 de julio de 1997"
2,5,4,1308,410,404,814,"6 de julio de 1997"
2,5,4,1309,389,422,811,"6 de julio de 1997"
2,5,4,1315,367,397,764,"6 de julio de 1997"
2,5,4,1316,417,376,793,"6 de julio de 1997"
2,5,4,1317,411,427,838,"6 de julio de 1997"
2,5,4,1323,298,273,571,"6 de julio de 1997"
2,5,4,1324,477,479,956,"6 de julio de 1997"
2,5,4,1342,349,429,778,"6 de julio de 1997"
2,5,4,1343,363,413,776,"6 de julio de 1997"
2,5,4,1344,454,462,916,"6 de julio de 1997"
2,5,4,1345,479,554,1033,"6 de julio de 1997"
2,5,4,1346,606,621,1227,"6 de julio de 1997"
2,5,4,1347,580,557,1137,"6 de julio de 1997"
2,5,4,1348,490,483,973,"6 de julio de 1997"
2,5,4,1349,700,646,1346,"6 de julio de 1997"
2,5,4,1350,324,313,637,"6 de julio de 1997"
2,5,4,1351,380,400,780,"6 de julio de 1997"
2,5,4,1352,402,393,795,"6 de julio de 1997"
2,5,4,1355,216,231,447,"6 de julio de 1997"
2,5,4,1356,530,606,1136,"6 de julio de 1997"
2,5,4,1357,356,396,752,"6 de julio de 1997"
2,5,4,1368,72,64,136,"6 de julio de 1997"
2,6,4,735,560,627,1187,"6 de julio de 1997"
2,6,4,736,453,462,915,"6 de julio de 1997"
2,6,4,737,427,516,943,"6 de julio de 1997"
2,6,4,738,399,516,915,"6 de julio de 1997"
2,6,4,739,461,537,998,"6 de julio de 1997"
2,6,4,740,544,596,1140,"6 de julio de 1997"
2,6,4,741,484,530,1014,"6 de julio de 1997"
2,6,4,742,469,514,983,"6 de julio de 1997"
2,6,4,743,301,332,633,"6 de julio de 1997"
2,6,4,744,346,369,715,"6 de julio de 1997"
2,6,4,745,315,358,673,"6 de julio de 1997"
2,6,4,746,458,531,989,"6 de julio de 1997"
2,6,4,747,477,438,915,"6 de julio de 1997"
2,6,4,748,328,408,736,"6 de julio de 1997"
2,6,4,749,508,469,977,"6 de julio de 1997"
2,6,4,750,427,411,838,"6 de julio de 1997"
2,6,4,751,523,413,936,"6 de julio de 1997"
2,6,4,752,422,370,792,"6 de julio de 1997"
2,6,4,753,479,406,885,"6 de julio de 1997"
2,6,4,754,405,375,780,"6 de julio de 1997"
2,6,4,755,307,292,599,"6 de julio de 1997"
2,6,4,756,491,482,973,"6 de julio de 1997"
2,6,4,757,442,469,911,"6 de julio de 1997"
2,6,4,758,366,433,799,"6 de julio de 1997"
2,6,4,759,284,315,599,"6 de julio de 1997"
2,6,4,760,337,363,700,"6 de julio de 1997"
2,6,4,761,535,584,1119,"6 de julio de 1997"
2,6,4,762,419,467,886,"6 de julio de 1997"
2,6,4,763,479,515,994,"6 de julio de 1997"
2,6,4,764,355,381,736,"6 de julio de 1997"
2,6,4,765,527,578,1105,"6 de julio de 1997"
2,6,4,766,607,654,1261,"6 de julio de 1997"
2,6,4,767,498,515,1013,"6 de julio de 1997"
2,6,4,768,359,417,776,"6 de julio de 1997"
2,6,4,769,403,468,871,"6 de julio de 1997"
2,6,4,770,262,280,542,"6 de julio de 1997"
2,6,4,771,418,463,881,"6 de julio de 1997"
2,6,4,772,396,417,813,"6 de julio de 1997"
2,6,4,773,316,355,671,"6 de julio de 1997"
2,6,4,774,274,271,545,"6 de julio de 1997"
2,6,4,775,466,434,900,"6 de julio de 1997"
2,6,4,776,388,446,834,"6 de julio de 1997"
2,6,4,777,415,450,865,"6 de julio de 1997"
2,6,4,778,387,416,803,"6 de julio de 1997"
2,6,4,779,375,346,721,"6 de julio de 1997"
2,6,4,780,333,280,613,"6 de julio de 1997"
2,6,4,781,376,269,645,"6 de julio de 1997"
2,6,4,782,380,355,735,"6 de julio de 1997"
2,6,4,783,540,494,1034,"6 de julio de 1997"
2,6,4,784,315,340,655,"6 de julio de 1997"
2,6,4,785,384,435,819,"6 de julio de 1997"
2,6,4,786,463,497,960,"6 de julio de 1997"
2,6,4,787,454,542,996,"6 de julio de 1997"
2,6,4,788,360,358,718,"6 de julio de 1997"
2,6,4,789,345,416,761,"6 de julio de 1997"
2,6,4,790,487,475,962,"6 de julio de 1997"
2,6,4,791,309,309,618,"6 de julio de 1997"
2,6,4,792,426,461,887,"6 de julio de 1997"
2,6,4,793,396,479,875,"6 de julio de 1997"
2,6,4,794,598,621,1219,"6 de julio de 1997"
2,6,4,795,436,525,961,"6 de julio de 1997"
2,6,4,796,488,535,1023,"6 de julio de 1997"
2,6,4,797,342,355,697,"6 de julio de 1997"
2,6,4,798,465,510,975,"6 de julio de 1997"
2,6,4,799,393,422,815,"6 de julio de 1997"
2,6,4,800,552,617,1169,"6 de julio de 1997"
2,6,4,801,425,515,940,"6 de julio de 1997"
2,6,4,802,499,547,1046,"6 de julio de 1997"
2,6,4,803,673,710,1383,"6 de julio de 1997"
2,6,4,804,607,619,1226,"6 de julio de 1997"
2,6,4,805,594,647,1241,"6 de julio de 1997"
2,6,4,806,335,369,704,"6 de julio de 1997"
2,6,4,807,443,469,912,"6 de julio de 1997"
2,6,4,808,547,624,1171,"6 de julio de 1997"
2,6,4,809,338,406,744,"6 de julio de 1997"
2,6,4,810,357,389,746,"6 de julio de 1997"
2,6,4,811,496,501,997,"6 de julio de 1997"
2,6,4,812,433,443,876,"6 de julio de 1997"
2,6,4,813,341,345,686,"6 de julio de 1997"
2,6,4,814,444,439,883,"6 de julio de 1997"
2,6,4,815,500,384,884,"6 de julio de 1997"
2,6,4,816,398,420,818,"6 de julio de 1997"
2,6,4,817,346,379,725,"6 de julio de 1997"
2,6,4,818,367,434,801,"6 de julio de 1997"
2,6,4,819,463,538,1001,"6 de julio de 1997"
2,6,4,820,537,551,1088,"6 de julio de 1997"
2,6,4,821,558,592,1150,"6 de julio de 1997"
2,6,4,822,573,652,1225,"6 de julio de 1997"
2,6,4,823,434,422,856,"6 de julio de 1997"
2,6,4,824,423,442,865,"6 de julio de 1997"
2,6,4,825,370,400,770,"6 de julio de 1997"
2,6,4,826,402,460,862,"6 de julio de 1997"
2,6,4,827,538,570,1108,"6 de julio de 1997"
2,6,4,828,417,468,885,"6 de julio de 1997"
2,6,4,829,509,539,1048,"6 de julio de 1997"
2,6,4,830,503,541,1044,"6 de julio de 1997"
2,6,4,831,320,274,594,"6 de julio de 1997"
2,6,4,832,324,360,684,"6 de julio de 1997"
2,6,4,833,465,499,964,"6 de julio de 1997"
2,6,4,834,499,489,988,"6 de julio de 1997"
2,6,4,835,304,318,622,"6 de julio de 1997"
2,6,4,836,389,441,830,"6 de julio de 1997"
2,6,4,837,398,452,850,"6 de julio de 1997"
2,6,4,838,562,587,1149,"6 de julio de 1997"
2,6,4,839,372,405,777,"6 de julio de 1997"
2,6,4,840,457,520,977,"6 de julio de 1997"
2,6,4,841,319,333,652,"6 de julio de 1997"
2,6,4,842,356,389,745,"6 de julio de 1997"
2,6,4,843,457,515,972,"6 de julio de 1997"
2,6,4,844,399,404,803,"6 de julio de 1997"
2,6,4,845,313,351,664,"6 de julio de 1997"
2,6,4,846,471,514,985,"6 de julio de 1997"
2,6,4,847,437,519,956,"6 de julio de 1997"
2,6,4,848,494,595,1089,"6 de julio de 1997"
2,6,4,849,521,576,1097,"6 de julio de 1997"
2,6,4,850,515,538,1053,"6 de julio de 1997"
2,6,4,851,373,440,813,"6 de julio de 1997"
2,6,4,852,456,488,944,"6 de julio de 1997"
2,6,4,853,540,541,1081,"6 de julio de 1997"
2,6,4,854,653,665,1318,"6 de julio de 1997"
2,6,4,855,259,269,528,"6 de julio de 1997"
2,6,4,856,491,483,974,"6 de julio de 1997"
2,6,4,857,439,437,876,"6 de julio de 1997"
2,6,4,858,740,786,1526,"6 de julio de 1997"
2,6,4,859,280,296,576,"6 de julio de 1997"
2,6,4,860,315,335,650,"6 de julio de 1997"
2,6,4,861,310,328,638,"6 de julio de 1997"
2,6,4,862,272,282,554,"6 de julio de 1997"
2,6,4,863,253,295,548,"6 de julio de 1997"
2,6,4,864,238,227,465,"6 de julio de 1997"
2,6,4,865,346,392,738,"6 de julio de 1997"
2,6,4,866,280,309,589,"6 de julio de 1997"
2,6,4,867,282,316,598,"6 de julio de 1997"
2,6,4,893,464,432,896,"6 de julio de 1997"
2,6,4,894,507,608,1115,"6 de julio de 1997"
2,6,4,895,426,445,871,"6 de julio de 1997"
2,6,4,903,308,358,666,"6 de julio de 1997"
2,6,4,905,283,299,582,"6 de julio de 1997"
2,6,4,906,248,266,514,"6 de julio de 1997"
2,6,4,907,243,287,530,"6 de julio de 1997"
2,6,4,908,378,403,781,"6 de julio de 1997"
2,6,4,909,173,207,380,"6 de julio de 1997"
2,6,4,910,416,421,837,"6 de julio de 1997"
2,6,4,911,475,502,977,"6 de julio de 1997"
2,6,4,912,321,403,724,"6 de julio de 1997"
2,6,4,913,387,381,768,"6 de julio de 1997"
2,6,4,914,401,363,764,"6 de julio de 1997"
2,6,4,915,230,256,486,"6 de julio de 1997"
2,6,4,916,344,349,693,"6 de julio de 1997"
2,6,4,917,458,481,939,"6 de julio de 1997"
2,6,4,918,219,190,409,"6 de julio de 1997"
2,6,4,919,294,295,589,"6 de julio de 1997"
2,6,4,920,263,292,555,"6 de julio de 1997"
2,6,4,921,195,177,372,"6 de julio de 1997"
2,6,4,922,379,387,766,"6 de julio de 1997"
2,6,4,923,378,430,808,"6 de julio de 1997"
2,6,4,924,410,417,827,"6 de julio de 1997"
2,6,4,925,302,342,644,"6 de julio de 1997"
2,6,4,926,484,556,1040,"6 de julio de 1997"
2,6,4,944,137,131,268,"6 de julio de 1997"
2,6,4,945,293,301,594,"6 de julio de 1997"
2,6,4,946,188,175,363,"6 de julio de 1997"
2,6,4,947,345,369,714,"6 de julio de 1997"
2,6,4,948,385,428,813,"6 de julio de 1997"
2,6,4,949,274,281,555,"6 de julio de 1997"
2,6,4,950,301,362,663,"6 de julio de 1997"
2,6,4,951,321,345,666,"6 de julio de 1997"
2,6,4,952,613,661,1274,"6 de julio de 1997"
2,6,4,953,378,442,820,"6 de julio de 1997"
2,6,4,954,525,543,1068,"6 de julio de 1997"
2,6,4,955,411,439,850,"6 de julio de 1997"
2,6,4,956,346,364,710,"6 de julio de 1997"
2,6,4,977,424,437,861,"6 de julio de 1997"
2,6,4,978,439,462,901,"6 de julio de 1997"
2,6,4,979,506,532,1038,"6 de julio de 1997"
2,6,4,980,489,569,1058,"6 de julio de 1997"
2,6,4,981,475,490,965,"6 de julio de 1997"
2,6,4,982,445,453,898,"6 de julio de 1997"
2,6,4,983,515,562,1077,"6 de julio de 1997"
2,6,4,984,355,332,687,"6 de julio de 1997"
2,6,4,985,462,420,882,"6 de julio de 1997"
2,6,4,986,314,334,648,"6 de julio de 1997"
2,6,4,987,428,498,926,"6 de julio de 1997"
2,6,4,988,529,447,976,"6 de julio de 1997"
2,6,4,989,417,414,831,"6 de julio de 1997"
2,6,4,990,539,588,1127,"6 de julio de 1997"
2,6,4,991,246,260,506,"6 de julio de 1997"
2,6,4,992,216,225,441,"6 de julio de 1997"
2,6,4,993,597,651,1248,"6 de julio de 1997"
2,6,4,994,577,567,1144,"6 de julio de 1997"
2,6,4,995,346,337,683,"6 de julio de 1997"
2,6,4,996,375,342,717,"6 de julio de 1997"
2,6,4,997,402,97,499,"6 de julio de 1997"
2,6,4,998,309,316,625,"6 de julio de 1997"
2,6,4,1017,430,443,873,"6 de julio de 1997"
2,6,4,1018,292,316,608,"6 de julio de 1997"
2,6,4,1023,286,302,588,"6 de julio de 1997"
2,6,4,1024,309,311,620,"6 de julio de 1997"
2,6,4,1026,302,294,596,"6 de julio de 1997"
2,6,4,1027,382,369,751,"6 de julio de 1997"
2,6,4,1028,325,316,641,"6 de julio de 1997"
2,6,4,1029,284,285,569,"6 de julio de 1997"
2,6,4,1245,574,622,1196,"6 de julio de 1997"
2,6,4,1246,420,506,926,"6 de julio de 1997"
2,6,4,1247,513,547,1060,"6 de julio de 1997"
2,6,4,1248,423,497,920,"6 de julio de 1997"
2,6,4,1249,601,675,1276,"6 de julio de 1997"
2,6,4,1250,550,596,1146,"6 de julio de 1997"
2,6,4,1251,407,516,923,"6 de julio de 1997"
2,6,4,1252,554,652,1206,"6 de julio de 1997"
2,6,4,1253,479,502,981,"6 de julio de 1997"
2,6,4,1254,633,755,1388,"6 de julio de 1997"
2,6,4,1255,458,485,943,"6 de julio de 1997"
2,6,4,1256,397,369,766,"6 de julio de 1997"
2,6,4,1257,355,422,777,"6 de julio de 1997"
2,6,4,1258,349,389,738,"6 de julio de 1997"
2,6,4,1296,417,452,869,"6 de julio de 1997"
2,6,4,1358,310,352,662,"6 de julio de 1997"
2,6,4,1359,289,343,632,"6 de julio de 1997"
2,6,4,1360,329,385,714,"6 de julio de 1997"
2,6,4,1361,343,440,783,"6 de julio de 1997"
2,6,4,1362,281,372,653,"6 de julio de 1997"
3,1,1,1,317,329,646,"6 de julio de 1997"
3,1,1,2,152,141,293,"6 de julio de 1997"
3,1,1,3,290,301,591,"6 de julio de 1997"
3,1,1,4,329,353,682,"6 de julio de 1997"
3,1,1,5,341,425,766,"6 de julio de 1997"
3,1,1,6,642,130,772,"6 de julio de 1997"
3,1,1,7,293,310,603,"6 de julio de 1997"
3,1,1,8,283,284,567,"6 de julio de 1997"
3,1,1,9,235,282,517,"6 de julio de 1997"
3,1,1,10,374,395,769,"6 de julio de 1997"
3,1,1,11,236,220,456,"6 de julio de 1997"
3,1,1,12,179,185,364,"6 de julio de 1997"
3,1,1,13,220,265,485,"6 de julio de 1997"
3,1,1,14,232,250,482,"6 de julio de 1997"
3,1,1,15,311,325,636,"6 de julio de 1997"
3,1,1,16,308,340,648,"6 de julio de 1997"
3,1,1,17,181,206,387,"6 de julio de 1997"
3,1,1,18,369,397,766,"6 de julio de 1997"
3,1,1,19,226,246,472,"6 de julio de 1997"
3,1,1,20,342,334,676,"6 de julio de 1997"
3,1,1,21,369,413,782,"6 de julio de 1997"
3,1,1,22,323,374,697,"6 de julio de 1997"
3,1,1,23,398,412,810,"6 de julio de 1997"
3,1,1,24,241,253,494,"6 de julio de 1997"
3,1,1,25,405,408,813,"6 de julio de 1997"
3,1,1,26,402,442,844,"6 de julio de 1997"
3,1,1,27,275,278,553,"6 de julio de 1997"
3,1,1,28,520,529,1049,"6 de julio de 1997"
3,1,1,29,364,391,755,"6 de julio de 1997"
3,1,1,30,442,459,901,"6 de julio de 1997"
3,1,1,31,382,403,785,"6 de julio de 1997"
3,1,1,32,336,356,692,"6 de julio de 1997"
3,1,1,33,203,167,370,"6 de julio de 1997"
3,1,1,34,207,218,425,"6 de julio de 1997"
3,1,1,35,164,77,241,"6 de julio de 1997"
3,1,1,36,146,119,265,"6 de julio de 1997"
3,1,1,37,120,107,227,"6 de julio de 1997"
3,1,1,38,90,96,186,"6 de julio de 1997"
3,1,1,39,89,67,156,"6 de julio de 1997"
3,1,1,40,304,323,627,"6 de julio de 1997"
3,1,1,41,399,414,813,"6 de julio de 1997"
3,1,1,42,345,321,666,"6 de julio de 1997"
3,1,1,43,294,263,557,"6 de julio de 1997"
3,1,1,44,360,398,758,"6 de julio de 1997"
3,1,1,45,271,320,591,"6 de julio de 1997"
3,1,1,46,313,315,628,"6 de julio de 1997"
3,1,1,47,269,271,540,"6 de julio de 1997"
3,1,1,48,405,398,803,"6 de julio de 1997"
3,1,1,49,69,49,118,"6 de julio de 1997"
3,1,1,50,121,100,221,"6 de julio de 1997"
3,1,1,51,131,137,268,"6 de julio de 1997"
3,1,1,52,192,168,360,"6 de julio de 1997"
3,1,1,53,166,142,308,"6 de julio de 1997"
3,1,1,54,379,336,715,"6 de julio de 1997"
3,1,1,55,186,153,339,"6 de julio de 1997"
3,1,1,56,136,125,261,"6 de julio de 1997"
3,1,1,57,306,285,591,"6 de julio de 1997"
3,1,1,58,311,268,579,"6 de julio de 1997"
3,1,1,59,352,318,670,"6 de julio de 1997"
3,1,1,60,339,257,596,"6 de julio de 1997"
3,1,1,61,411,329,740,"6 de julio de 1997"
3,1,1,62,85,65,150,"6 de julio de 1997"
3,1,1,63,83,63,146,"6 de julio de 1997"
3,1,1,64,73,43,116,"6 de julio de 1997"
3,1,1,65,41,29,70,"6 de julio de 1997"
3,1,1,66,73,57,130,"6 de julio de 1997"
3,1,1,67,261,238,499,"6 de julio de 1997"
3,1,1,68,183,170,353,"6 de julio de 1997"
3,1,1,69,131,102,233,"6 de julio de 1997"
3,1,1,70,119,89,208,"6 de julio de 1997"
3,1,1,71,92,80,172,"6 de julio de 1997"
3,1,1,72,210,167,377,"6 de julio de 1997"
3,1,1,73,267,216,483,"6 de julio de 1997"
3,1,1,74,54,48,102,"6 de julio de 1997"
3,1,2,75,190,174,364,"6 de julio de 1997"
3,1,2,76,513,463,976,"6 de julio de 1997"
3,1,2,77,263,273,536,"6 de julio de 1997"
3,1,2,78,420,362,782,"6 de julio de 1997"
3,1,2,79,287,316,603,"6 de julio de 1997"
3,1,2,80,538,437,975,"6 de julio de 1997"
3,1,2,81,275,247,522,"6 de julio de 1997"
3,1,2,82,449,415,864,"6 de julio de 1997"
3,1,2,83,572,547,1119,"6 de julio de 1997"
3,1,2,84,200,182,382,"6 de julio de 1997"
3,1,2,85,320,256,576,"6 de julio de 1997"
3,1,2,86,68,51,119,"6 de julio de 1997"
3,1,2,87,159,127,286,"6 de julio de 1997"
3,1,2,88,338,286,624,"6 de julio de 1997"
3,1,2,89,300,283,583,"6 de julio de 1997"
3,1,2,90,285,275,560,"6 de julio de 1997"
3,1,2,91,116,102,218,"6 de julio de 1997"
3,1,2,92,245,244,489,"6 de julio de 1997"
3,1,2,93,293,290,583,"6 de julio de 1997"
3,1,2,94,594,567,1161,"6 de julio de 1997"
3,1,2,95,528,469,997,"6 de julio de 1997"
3,1,2,96,363,351,714,"6 de julio de 1997"
3,1,2,97,372,364,736,"6 de julio de 1997"
3,1,2,98,419,416,835,"6 de julio de 1997"
3,1,2,99,119,128,247,"6 de julio de 1997"
3,1,2,100,34,26,60,"6 de julio de 1997"
3,1,2,101,205,141,346,"6 de julio de 1997"
3,1,2,102,215,143,358,"6 de julio de 1997"
3,1,2,103,366,318,684,"6 de julio de 1997"
3,1,2,104,568,508,1076,"6 de julio de 1997"
3,1,2,105,121,77,198,"6 de julio de 1997"
3,1,2,106,51,41,92,"6 de julio de 1997"
3,1,2,107,256,257,513,"6 de julio de 1997"
3,1,2,108,324,290,614,"6 de julio de 1997"
3,1,2,109,318,278,596,"6 de julio de 1997"
3,1,2,110,94,74,168,"6 de julio de 1997"
3,1,2,111,99,79,178,"6 de julio de 1997"
3,1,2,112,258,225,483,"6 de julio de 1997"
3,1,2,113,202,159,361,"6 de julio de 1997"
3,1,2,114,305,287,592,"6 de julio de 1997"
3,1,2,115,102,87,189,"6 de julio de 1997"
3,1,2,116,435,379,814,"6 de julio de 1997"
3,1,2,117,139,129,268,"6 de julio de 1997"
3,1,2,118,159,103,262,"6 de julio de 1997"
3,1,2,119,112,62,174,"6 de julio de 1997"
3,1,2,120,262,231,493,"6 de julio de 1997"
3,1,5,337,20,34,54,"6 de julio de 1997"
3,1,5,338,377,340,717,"6 de julio de 1997"
3,1,5,339,486,511,997,"6 de julio de 1997"
3,1,5,340,456,448,904,"6 de julio de 1997"
3,1,5,341,403,399,802,"6 de julio de 1997"
3,1,5,342,398,393,791,"6 de julio de 1997"
3,1,5,343,109,113,222,"6 de julio de 1997"
3,1,5,344,427,370,797,"6 de julio de 1997"
3,1,5,345,114,97,211,"6 de julio de 1997"
3,1,5,346,126,105,231,"6 de julio de 1997"
3,1,5,347,82,77,159,"6 de julio de 1997"
3,2,3,121,287,317,604,"6 de julio de 1997"
3,2,3,122,332,286,618,"6 de julio de 1997"
3,2,3,123,441,477,918,"6 de julio de 1997"
3,2,3,124,555,590,1145,"6 de julio de 1997"
3,2,3,125,312,341,653,"6 de julio de 1997"
3,2,3,126,352,386,738,"6 de julio de 1997"
3,2,3,127,426,402,828,"6 de julio de 1997"
3,2,3,128,275,278,553,"6 de julio de 1997"
3,2,3,129,309,337,646,"6 de julio de 1997"
3,2,3,130,185,218,403,"6 de julio de 1997"
3,2,3,131,256,314,570,"6 de julio de 1997"
3,2,3,132,208,242,450,"6 de julio de 1997"
3,2,3,133,182,194,376,"6 de julio de 1997"
3,2,3,134,129,175,304,"6 de julio de 1997"
3,2,3,135,458,488,946,"6 de julio de 1997"
3,2,3,136,368,379,747,"6 de julio de 1997"
3,2,3,137,415,422,837,"6 de julio de 1997"
3,2,3,138,323,300,623,"6 de julio de 1997"
3,2,3,139,283,251,534,"6 de julio de 1997"
3,2,3,140,206,237,443,"6 de julio de 1997"
3,2,3,141,320,330,650,"6 de julio de 1997"
3,2,3,142,386,394,780,"6 de julio de 1997"
3,2,3,143,293,334,627,"6 de julio de 1997"
3,2,3,144,336,362,698,"6 de julio de 1997"
3,2,3,145,291,269,560,"6 de julio de 1997"
3,2,3,146,253,249,502,"6 de julio de 1997"
3,2,3,147,287,307,594,"6 de julio de 1997"
3,2,3,148,288,300,588,"6 de julio de 1997"
3,2,3,149,352,324,676,"6 de julio de 1997"
3,2,3,150,260,275,535,"6 de julio de 1997"
3,2,3,151,204,226,430,"6 de julio de 1997"
3,2,3,152,265,272,537,"6 de julio de 1997"
3,2,3,153,213,237,450,"6 de julio de 1997"
3,2,3,154,426,432,858,"6 de julio de 1997"
3,2,3,155,490,522,1012,"6 de julio de 1997"
3,2,3,156,437,441,878,"6 de julio de 1997"
3,2,3,157,274,302,576,"6 de julio de 1997"
3,2,3,158,282,326,608,"6 de julio de 1997"
3,2,3,159,276,279,555,"6 de julio de 1997"
3,2,3,160,350,311,661,"6 de julio de 1997"
3,2,3,161,383,411,794,"6 de julio de 1997"
3,2,3,162,484,515,999,"6 de julio de 1997"
3,2,3,163,360,371,731,"6 de julio de 1997"
3,2,3,164,463,432,895,"6 de julio de 1997"
3,2,3,165,466,479,945,"6 de julio de 1997"
3,2,3,166,340,362,702,"6 de julio de 1997"
3,2,3,167,537,541,1078,"6 de julio de 1997"
3,2,3,168,480,440,920,"6 de julio de 1997"
3,2,3,169,504,318,822,"6 de julio de 1997"
3,2,3,170,291,258,549,"6 de julio de 1997"
3,2,3,171,274,288,562,"6 de julio de 1997"
3,2,3,172,382,355,737,"6 de julio de 1997"
3,2,3,173,502,524,1026,"6 de julio de 1997"
3,2,3,174,490,531,1021,"6 de julio de 1997"
3,2,3,175,488,499,987,"6 de julio de 1997"
3,2,3,176,264,273,537,"6 de julio de 1997"
3,2,3,177,309,295,604,"6 de julio de 1997"
3,2,3,178,256,237,493,"6 de julio de 1997"
3,2,3,179,347,355,702,"6 de julio de 1997"
3,2,3,180,311,291,602,"6 de julio de 1997"
3,2,3,181,483,502,985,"6 de julio de 1997"
3,2,3,182,254,269,523,"6 de julio de 1997"
3,2,3,183,269,249,518,"6 de julio de 1997"
3,2,3,184,268,185,453,"6 de julio de 1997"
3,2,3,185,295,325,620,"6 de julio de 1997"
3,2,3,186,437,460,897,"6 de julio de 1997"
3,2,3,187,476,499,975,"6 de julio de 1997"
3,2,3,188,457,458,915,"6 de julio de 1997"
3,2,3,189,434,501,935,"6 de julio de 1997"
3,2,3,190,457,477,934,"6 de julio de 1997"
3,2,3,191,470,500,970,"6 de julio de 1997"
3,2,3,192,277,315,592,"6 de julio de 1997"
3,2,3,193,439,449,888,"6 de julio de 1997"
3,2,3,194,251,282,533,"6 de julio de 1997"
3,2,3,195,389,377,766,"6 de julio de 1997"
3,2,3,196,429,443,872,"6 de julio de 1997"
3,2,3,197,348,352,700,"6 de julio de 1997"
3,2,3,198,357,342,699,"6 de julio de 1997"
3,2,3,199,308,320,628,"6 de julio de 1997"
3,2,3,200,351,339,690,"6 de julio de 1997"
3,2,3,201,227,239,466,"6 de julio de 1997"
3,2,3,202,279,322,601,"6 de julio de 1997"
3,2,3,203,335,341,676,"6 de julio de 1997"
3,2,3,204,338,348,686,"6 de julio de 1997"
3,2,3,205,292,294,586,"6 de julio de 1997"
3,2,3,206,265,261,526,"6 de julio de 1997"
3,2,3,207,301,275,576,"6 de julio de 1997"
3,2,3,208,398,390,788,"6 de julio de 1997"
3,2,3,209,307,322,629,"6 de julio de 1997"
3,2,3,210,350,373,723,"6 de julio de 1997"
3,2,3,211,375,412,787,"6 de julio de 1997"
3,2,3,212,221,230,451,"6 de julio de 1997"
3,2,3,213,656,666,1322,"6 de julio de 1997"
3,2,3,214,343,373,716,"6 de julio de 1997"
3,2,3,215,345,398,743,"6 de julio de 1997"
3,2,3,216,209,210,419,"6 de julio de 1997"
3,2,3,217,543,603,1146,"6 de julio de 1997"
3,2,3,218,249,200,449,"6 de julio de 1997"
3,2,3,219,349,363,712,"6 de julio de 1997"
3,2,3,220,466,496,962,"6 de julio de 1997"
3,2,3,221,305,335,640,"6 de julio de 1997"
3,2,3,222,286,293,579,"6 de julio de 1997"
3,2,3,223,496,520,1016,"6 de julio de 1997"
3,2,3,224,250,273,523,"6 de julio de 1997"
3,2,3,225,285,297,582,"6 de julio de 1997"
3,2,3,226,277,291,568,"6 de julio de 1997"
3,2,3,227,463,457,920,"6 de julio de 1997"
3,2,3,228,241,282,523,"6 de julio de 1997"
3,2,3,229,271,301,572,"6 de julio de 1997"
3,2,3,230,284,314,598,"6 de julio de 1997"
3,2,3,231,179,197,376,"6 de julio de 1997"
3,2,3,232,289,327,616,"6 de julio de 1997"
3,2,3,233,209,271,480,"6 de julio de 1997"
3,2,3,234,352,420,772,"6 de julio de 1997"
3,2,3,235,295,345,640,"6 de julio de 1997"
3,2,3,236,150,164,314,"6 de julio de 1997"
3,2,3,237,315,356,671,"6 de julio de 1997"
3,2,3,238,271,357,628,"6 de julio de 1997"
3,2,3,239,300,345,645,"6 de julio de 1997"
3,2,3,240,189,184,373,"6 de julio de 1997"
3,2,3,241,132,120,252,"6 de julio de 1997"
3,2,3,242,294,280,574,"6 de julio de 1997"
3,2,3,243,351,353,704,"6 de julio de 1997"
3,2,3,244,389,460,849,"6 de julio de 1997"
3,2,3,245,263,293,556,"6 de julio de 1997"
3,2,3,246,507,535,1042,"6 de julio de 1997"
3,2,3,247,413,409,822,"6 de julio de 1997"
3,2,3,248,204,240,444,"6 de julio de 1997"
3,2,3,249,265,285,550,"6 de julio de 1997"
3,2,3,250,544,568,1112,"6 de julio de 1997"
3,2,3,251,251,283,534,"6 de julio de 1997"
3,2,3,252,641,652,1293,"6 de julio de 1997"
3,2,3,253,696,709,1405,"6 de julio de 1997"
3,2,3,254,104,77,181,"6 de julio de 1997"
3,2,3,255,237,221,458,"6 de julio de 1997"
3,2,3,256,516,434,950,"6 de julio de 1997"
3,2,3,257,344,326,670,"6 de julio de 1997"
3,2,3,258,127,86,213,"6 de julio de 1997"
3,2,3,259,67,59,126,"6 de julio de 1997"
3,2,3,260,134,96,230,"6 de julio de 1997"
3,2,3,261,239,173,412,"6 de julio de 1997"
3,2,3,262,62,54,116,"6 de julio de 1997"
3,2,3,263,110,100,210,"6 de julio de 1997"
3,2,3,264,84,59,143,"6 de julio de 1997"
3,2,3,265,168,145,313,"6 de julio de 1997"
3,2,3,266,124,109,233,"6 de julio de 1997"
3,2,3,267,273,229,502,"6 de julio de 1997"
3,2,3,268,158,117,275,"6 de julio de 1997"
3,2,3,269,259,242,501,"6 de julio de 1997"
3,2,3,270,667,544,1211,"6 de julio de 1997"
3,2,3,271,270,250,520,"6 de julio de 1997"
3,2,3,272,138,117,255,"6 de julio de 1997"
3,2,3,273,80,57,137,"6 de julio de 1997"
3,2,3,274,107,79,186,"6 de julio de 1997"
3,2,3,275,37,25,62,"6 de julio de 1997"
3,2,3,276,184,143,327,"6 de julio de 1997"
3,2,3,277,157,128,285,"6 de julio de 1997"
3,2,3,278,252,219,471,"6 de julio de 1997"
3,2,3,279,44,32,76,"6 de julio de 1997"
3,2,3,280,452,357,809,"6 de julio de 1997"
3,2,3,281,339,289,628,"6 de julio de 1997"
3,2,3,282,376,329,705,"6 de julio de 1997"
3,2,3,283,413,366,779,"6 de julio de 1997"
3,2,3,284,50,39,89,"6 de julio de 1997"
3,2,3,285,35,32,67,"6 de julio de 1997"
3,2,3,286,38,40,78,"6 de julio de 1997"
3,2,3,287,47,38,85,"6 de julio de 1997"
3,2,3,288,206,192,398,"6 de julio de 1997"
3,2,3,289,172,167,339,"6 de julio de 1997"
3,2,3,348,126,145,271,"6 de julio de 1997"
3,2,3,349,164,196,360,"6 de julio de 1997"
3,2,3,350,109,141,250,"6 de julio de 1997"
3,2,4,290,265,224,489,"6 de julio de 1997"
3,2,4,291,635,559,1194,"6 de julio de 1997"
3,2,4,292,358,296,654,"6 de julio de 1997"
3,2,4,293,438,415,853,"6 de julio de 1997"
3,2,4,294,398,346,744,"6 de julio de 1997"
3,2,4,295,544,454,998,"6 de julio de 1997"
3,2,4,296,406,368,774,"6 de julio de 1997"
3,2,4,297,634,482,1116,"6 de julio de 1997"
3,2,4,298,805,624,1429,"6 de julio de 1997"
3,2,4,299,320,276,596,"6 de julio de 1997"
3,2,4,300,508,436,944,"6 de julio de 1997"
3,2,4,301,775,683,1458,"6 de julio de 1997"
3,2,4,302,377,383,760,"6 de julio de 1997"
3,2,4,303,144,126,270,"6 de julio de 1997"
3,2,4,304,472,390,862,"6 de julio de 1997"
3,2,4,305,223,177,400,"6 de julio de 1997"
3,2,4,306,503,405,908,"6 de julio de 1997"
3,2,4,307,141,97,238,"6 de julio de 1997"
3,2,4,308,601,497,1098,"6 de julio de 1997"
3,2,4,309,224,160,384,"6 de julio de 1997"
3,2,4,310,262,207,469,"6 de julio de 1997"
3,2,4,311,234,203,437,"6 de julio de 1997"
3,2,4,312,574,497,1071,"6 de julio de 1997"
3,2,4,313,353,323,676,"6 de julio de 1997"
3,2,4,314,546,501,1047,"6 de julio de 1997"
3,2,4,315,187,150,337,"6 de julio de 1997"
3,2,4,316,396,302,698,"6 de julio de 1997"
3,2,4,317,743,480,1223,"6 de julio de 1997"
3,2,4,318,434,385,819,"6 de julio de 1997"
3,2,4,319,173,152,325,"6 de julio de 1997"
3,2,4,320,532,413,945,"6 de julio de 1997"
3,2,4,321,374,298,672,"6 de julio de 1997"
3,2,4,322,354,316,670,"6 de julio de 1997"
3,2,4,323,454,409,863,"6 de julio de 1997"
3,2,4,324,741,547,1288,"6 de julio de 1997"
3,2,4,325,696,457,1153,"6 de julio de 1997"
3,2,4,326,330,235,565,"6 de julio de 1997"
3,2,4,327,436,434,870,"6 de julio de 1997"
3,2,4,328,434,374,808,"6 de julio de 1997"
3,2,4,329,273,235,508,"6 de julio de 1997"
3,2,4,330,668,555,1223,"6 de julio de 1997"
3,2,4,331,386,417,803,"6 de julio de 1997"
3,2,4,332,475,363,838,"6 de julio de 1997"
3,2,4,333,340,304,644,"6 de julio de 1997"
3,2,4,334,99,73,172,"6 de julio de 1997"
3,2,4,335,77,69,146,"6 de julio de 1997"
3,2,4,336,35,40,75,"6 de julio de 1997"
3,2,4,351,42,38,80,"6 de julio de 1997"
3,2,4,352,111,118,229,"6 de julio de 1997"
4,1,1,1,215,220,435,"6 de julio de 1997"
4,1,1,2,280,306,586,"6 de julio de 1997"
4,1,1,3,262,307,569,"6 de julio de 1997"
4,1,1,4,571,667,1238,"6 de julio de 1997"
4,1,1,5,328,402,730,"6 de julio de 1997"
4,1,1,6,255,280,535,"6 de julio de 1997"
4,1,1,7,331,339,670,"6 de julio de 1997"
4,1,1,8,264,306,570,"6 de julio de 1997"
4,1,1,9,465,488,953,"6 de julio de 1997"
4,1,1,10,441,465,906,"6 de julio de 1997"
4,1,1,11,364,357,721,"6 de julio de 1997"
4,1,1,12,633,722,1355,"6 de julio de 1997"
4,1,1,13,476,508,984,"6 de julio de 1997"
4,1,1,14,360,428,788,"6 de julio de 1997"
4,1,1,15,312,385,697,"6 de julio de 1997"
4,1,1,16,307,295,602,"6 de julio de 1997"
4,1,1,17,258,304,562,"6 de julio de 1997"
4,1,1,18,256,268,524,"6 de julio de 1997"
4,1,1,19,264,285,549,"6 de julio de 1997"
4,1,1,20,377,408,785,"6 de julio de 1997"
4,1,1,21,383,411,794,"6 de julio de 1997"
4,1,1,22,376,411,787,"6 de julio de 1997"
4,1,1,23,301,361,662,"6 de julio de 1997"
4,1,1,24,482,543,1025,"6 de julio de 1997"
4,1,1,25,299,360,659,"6 de julio de 1997"
4,1,1,26,544,580,1124,"6 de julio de 1997"
4,1,1,27,494,674,1168,"6 de julio de 1997"
4,1,1,28,407,420,827,"6 de julio de 1997"
4,1,1,29,431,524,955,"6 de julio de 1997"
4,1,1,30,362,410,772,"6 de julio de 1997"
4,1,1,31,356,399,755,"6 de julio de 1997"
4,1,1,32,430,451,881,"6 de julio de 1997"
4,1,1,33,399,436,835,"6 de julio de 1997"
4,1,1,34,493,522,1015,"6 de julio de 1997"
4,1,1,35,346,361,707,"6 de julio de 1997"
4,1,1,36,467,428,895,"6 de julio de 1997"
4,1,1,37,261,282,543,"6 de julio de 1997"
4,1,1,38,254,276,530,"6 de julio de 1997"
4,1,1,39,509,609,1118,"6 de julio de 1997"
4,1,1,40,304,374,678,"6 de julio de 1997"
4,1,1,41,345,379,724,"6 de julio de 1997"
4,1,1,42,508,542,1050,"6 de julio de 1997"
4,1,1,43,473,469,942,"6 de julio de 1997"
4,1,1,44,385,413,798,"6 de julio de 1997"
4,1,1,45,413,436,849,"6 de julio de 1997"
4,1,1,46,453,505,958,"6 de julio de 1997"
4,1,1,47,412,472,884,"6 de julio de 1997"
4,1,1,48,461,551,1012,"6 de julio de 1997"
4,1,1,49,538,611,1149,"6 de julio de 1997"
4,1,1,50,515,544,1059,"6 de julio de 1997"
4,1,1,51,602,602,1204,"6 de julio de 1997"
4,1,1,52,401,454,855,"6 de julio de 1997"
4,1,1,53,549,589,1138,"6 de julio de 1997"
4,1,1,54,455,483,938,"6 de julio de 1997"
4,1,1,55,653,712,1365,"6 de julio de 1997"
4,1,1,56,432,494,926,"6 de julio de 1997"
4,1,1,57,410,445,855,"6 de julio de 1997"
4,1,1,58,514,588,1102,"6 de julio de 1997"
4,1,1,59,490,530,1020,"6 de julio de 1997"
4,1,1,60,439,435,874,"6 de julio de 1997"
4,1,1,61,392,460,852,"6 de julio de 1997"
4,1,1,62,410,417,827,"6 de julio de 1997"
4,1,1,63,477,519,996,"6 de julio de 1997"
4,1,1,64,428,463,891,"6 de julio de 1997"
4,1,1,65,540,584,1124,"6 de julio de 1997"
4,1,1,66,428,458,886,"6 de julio de 1997"
4,1,1,67,459,452,911,"6 de julio de 1997"
4,1,1,68,371,407,778,"6 de julio de 1997"
4,1,1,69,394,417,811,"6 de julio de 1997"
4,1,1,70,441,494,935,"6 de julio de 1997"
4,1,1,71,451,506,957,"6 de julio de 1997"
4,1,1,72,577,641,1218,"6 de julio de 1997"
4,1,1,73,757,432,1189,"6 de julio de 1997"
4,1,1,74,665,752,1417,"6 de julio de 1997"
4,1,1,75,482,562,1044,"6 de julio de 1997"
4,1,1,76,421,519,940,"6 de julio de 1997"
4,1,1,77,365,412,777,"6 de julio de 1997"
4,1,1,78,426,441,867,"6 de julio de 1997"
4,1,1,79,501,459,960,"6 de julio de 1997"
4,1,1,80,360,379,739,"6 de julio de 1997"
4,1,1,81,923,1113,2036,"6 de julio de 1997"
4,1,1,82,372,430,802,"6 de julio de 1997"
4,1,1,83,600,778,1378,"6 de julio de 1997"
4,1,1,84,284,316,600,"6 de julio de 1997"
4,1,1,85,411,421,832,"6 de julio de 1997"
4,1,1,86,412,491,903,"6 de julio de 1997"
4,1,1,87,386,417,803,"6 de julio de 1997"
4,1,1,88,279,346,625,"6 de julio de 1997"
4,1,1,89,476,513,989,"6 de julio de 1997"
4,1,1,90,550,578,1128,"6 de julio de 1997"
4,1,1,91,505,502,1007,"6 de julio de 1997"
4,1,1,92,302,315,617,"6 de julio de 1997"
4,1,1,93,284,315,599,"6 de julio de 1997"
4,1,1,94,403,414,817,"6 de julio de 1997"
4,1,1,95,305,304,609,"6 de julio de 1997"
4,1,1,96,402,469,871,"6 de julio de 1997"
4,1,1,97,390,424,814,"6 de julio de 1997"
4,1,1,98,291,361,652,"6 de julio de 1997"
4,1,1,99,457,478,935,"6 de julio de 1997"
4,1,1,100,693,736,1429,"6 de julio de 1997"
4,1,1,101,674,719,1393,"6 de julio de 1997"
4,1,1,102,396,453,849,"6 de julio de 1997"
4,1,1,103,410,469,879,"6 de julio de 1997"
4,1,1,104,319,356,675,"6 de julio de 1997"
4,1,1,105,659,760,1419,"6 de julio de 1997"
4,1,1,106,373,398,771,"6 de julio de 1997"
4,1,1,107,418,434,852,"6 de julio de 1997"
4,1,1,108,534,636,1170,"6 de julio de 1997"
4,1,1,109,481,504,985,"6 de julio de 1997"
4,1,1,110,575,346,921,"6 de julio de 1997"
4,1,1,111,494,475,969,"6 de julio de 1997"
4,1,1,112,475,531,1006,"6 de julio de 1997"
4,1,1,113,406,431,837,"6 de julio de 1997"
4,1,1,114,441,403,844,"6 de julio de 1997"
4,1,1,115,340,338,678,"6 de julio de 1997"
4,1,1,116,364,382,746,"6 de julio de 1997"
4,1,1,117,317,335,652,"6 de julio de 1997"
4,1,1,118,280,251,531,"6 de julio de 1997"
4,1,1,119,104,78,182,"6 de julio de 1997"
4,1,1,120,178,155,333,"6 de julio de 1997"
4,1,1,121,182,170,352,"6 de julio de 1997"
4,1,1,122,279,218,497,"6 de julio de 1997"
4,1,1,123,203,173,376,"6 de julio de 1997"
4,1,1,124,327,278,605,"6 de julio de 1997"
4,1,1,125,384,389,773,"6 de julio de 1997"
4,1,1,126,507,490,997,"6 de julio de 1997"
4,1,1,127,247,232,479,"6 de julio de 1997"
4,1,1,128,51,45,96,"6 de julio de 1997"
4,1,1,129,439,336,775,"6 de julio de 1997"
4,1,1,130,128,105,233,"6 de julio de 1997"
4,1,1,131,60,46,106,"6 de julio de 1997"
4,1,1,132,54,42,96,"6 de julio de 1997"
4,1,1,133,152,114,266,"6 de julio de 1997"
4,1,1,134,96,58,154,"6 de julio de 1997"
4,1,1,135,206,158,364,"6 de julio de 1997"
4,1,1,136,58,40,98,"6 de julio de 1997"
4,1,1,137,47,27,74,"6 de julio de 1997"
4,1,1,138,143,109,252,"6 de julio de 1997"
4,1,1,139,200,152,352,"6 de julio de 1997"
4,1,1,140,372,343,715,"6 de julio de 1997"
4,1,1,141,345,314,659,"6 de julio de 1997"
4,1,1,142,466,395,861,"6 de julio de 1997"
4,1,1,143,125,90,215,"6 de julio de 1997"
4,1,1,144,60,47,107,"6 de julio de 1997"
4,1,1,145,288,240,528,"6 de julio de 1997"
4,1,1,146,119,79,198,"6 de julio de 1997"
4,1,2,147,386,410,796,"6 de julio de 1997"
4,1,2,148,345,390,735,"6 de julio de 1997"
4,1,2,149,409,388,797,"6 de julio de 1997"
4,1,2,150,315,374,689,"6 de julio de 1997"
4,1,2,151,286,322,608,"6 de julio de 1997"
4,1,2,152,402,401,803,"6 de julio de 1997"
4,1,2,153,385,400,785,"6 de julio de 1997"
4,1,2,154,467,467,934,"6 de julio de 1997"
4,1,2,155,458,464,922,"6 de julio de 1997"
4,1,2,156,222,235,457,"6 de julio de 1997"
4,1,2,157,226,164,390,"6 de julio de 1997"
4,1,2,158,275,246,521,"6 de julio de 1997"
4,1,2,159,287,293,580,"6 de julio de 1997"
4,1,2,160,288,347,635,"6 de julio de 1997"
4,1,2,161,321,348,669,"6 de julio de 1997"
4,1,2,162,269,275,544,"6 de julio de 1997"
4,1,2,163,273,265,538,"6 de julio de 1997"
4,1,2,164,313,330,643,"6 de julio de 1997"
4,1,2,165,77,69,146,"6 de julio de 1997"
4,1,2,166,638,610,1248,"6 de julio de 1997"
4,1,2,167,410,348,758,"6 de julio de 1997"
4,1,2,168,406,346,752,"6 de julio de 1997"
4,1,2,169,435,468,903,"6 de julio de 1997"
4,1,2,170,288,266,554,"6 de julio de 1997"
4,1,2,171,195,191,386,"6 de julio de 1997"
4,1,2,172,340,348,688,"6 de julio de 1997"
4,1,2,173,505,435,940,"6 de julio de 1997"
4,1,2,174,380,385,765,"6 de julio de 1997"
4,1,2,175,586,510,1096,"6 de julio de 1997"
4,1,2,176,554,506,1060,"6 de julio de 1997"
4,1,2,177,470,452,922,"6 de julio de 1997"
4,1,2,178,113,114,227,"6 de julio de 1997"
4,1,2,179,396,386,782,"6 de julio de 1997"
4,1,2,180,509,468,977,"6 de julio de 1997"
4,1,2,181,114,106,220,"6 de julio de 1997"
4,1,2,182,52,51,103,"6 de julio de 1997"
4,1,5,363,613,573,1186,"6 de julio de 1997"
4,1,5,364,559,532,1091,"6 de julio de 1997"
4,1,5,365,339,353,692,"6 de julio de 1997"
4,1,5,366,421,437,858,"6 de julio de 1997"
4,1,5,367,359,360,719,"6 de julio de 1997"
4,1,5,368,383,358,741,"6 de julio de 1997"
4,1,5,369,216,191,407,"6 de julio de 1997"
4,1,5,370,413,373,786,"6 de julio de 1997"
4,1,5,371,211,205,416,"6 de julio de 1997"
4,1,5,372,367,314,681,"6 de julio de 1997"
4,1,5,373,183,167,350,"6 de julio de 1997"
4,1,5,374,94,86,180,"6 de julio de 1997"
4,1,5,375,411,378,789,"6 de julio de 1997"
4,1,5,376,415,358,773,"6 de julio de 1997"
4,1,5,377,381,399,780,"6 de julio de 1997"
4,1,5,378,375,340,715,"6 de julio de 1997"
4,1,5,379,283,277,560,"6 de julio de 1997"
4,1,5,380,150,120,270,"6 de julio de 1997"
4,1,6,381,445,464,909,"6 de julio de 1997"
4,1,6,382,569,547,1116,"6 de julio de 1997"
4,1,6,383,391,388,779,"6 de julio de 1997"
4,1,6,384,314,297,611,"6 de julio de 1997"
4,1,6,385,83,86,169,"6 de julio de 1997"
4,1,6,386,123,96,219,"6 de julio de 1997"
4,1,6,387,58,41,99,"6 de julio de 1997"
4,1,6,388,713,651,1364,"6 de julio de 1997"
4,1,6,389,293,237,530,"6 de julio de 1997"
4,1,6,390,71,52,123,"6 de julio de 1997"
4,1,6,391,161,112,273,"6 de julio de 1997"
4,1,6,392,39,30,69,"6 de julio de 1997"
4,1,6,393,49,40,89,"6 de julio de 1997"
4,1,6,394,239,194,433,"6 de julio de 1997"
4,1,6,395,217,182,399,"6 de julio de 1997"
4,1,6,396,165,162,327,"6 de julio de 1997"
4,1,6,397,231,200,431,"6 de julio de 1997"
4,1,6,398,233,205,438,"6 de julio de 1997"
4,1,6,399,164,134,298,"6 de julio de 1997"
4,1,6,400,355,280,635,"6 de julio de 1997"
4,1,6,401,402,360,762,"6 de julio de 1997"
4,1,6,402,46,42,88,"6 de julio de 1997"
4,1,6,403,339,308,647,"6 de julio de 1997"
4,1,6,404,327,273,600,"6 de julio de 1997"
4,1,6,405,55,29,84,"6 de julio de 1997"
4,1,6,406,125,91,216,"6 de julio de 1997"
4,1,6,407,260,239,499,"6 de julio de 1997"
4,1,6,408,109,81,190,"6 de julio de 1997"
4,1,6,409,202,183,385,"6 de julio de 1997"
4,1,6,410,362,321,683,"6 de julio de 1997"
4,1,6,411,136,84,220,"6 de julio de 1997"
4,1,6,412,80,81,161,"6 de julio de 1997"
4,1,6,413,93,72,165,"6 de julio de 1997"
4,1,6,414,93,65,158,"6 de julio de 1997"
4,1,6,415,539,405,944,"6 de julio de 1997"
4,1,6,416,46,32,78,"6 de julio de 1997"
4,1,6,417,468,387,855,"6 de julio de 1997"
4,1,6,418,71,49,120,"6 de julio de 1997"
4,1,6,419,122,110,232,"6 de julio de 1997"
4,1,6,420,50,52,102,"6 de julio de 1997"
4,1,6,421,452,386,838,"6 de julio de 1997"
4,1,6,422,290,223,513,"6 de julio de 1997"
4,1,6,423,75,57,132,"6 de julio de 1997"
4,1,6,424,173,128,301,"6 de julio de 1997"
4,1,6,425,134,94,228,"6 de julio de 1997"
4,1,6,426,420,327,747,"6 de julio de 1997"
4,1,6,427,188,130,318,"6 de julio de 1997"
4,1,8,440,407,383,790,"6 de julio de 1997"
4,1,8,441,474,451,925,"6 de julio de 1997"
4,1,8,442,471,425,896,"6 de julio de 1997"
4,1,8,443,482,402,884,"6 de julio de 1997"
4,1,8,444,40,36,76,"6 de julio de 1997"
4,1,8,445,335,297,632,"6 de julio de 1997"
4,1,8,446,32,30,62,"6 de julio de 1997"
4,1,8,447,122,107,229,"6 de julio de 1997"
4,2,3,183,180,186,366,"6 de julio de 1997"
4,2,3,184,633,628,1261,"6 de julio de 1997"
4,2,3,185,473,468,941,"6 de julio de 1997"
4,2,3,186,350,325,675,"6 de julio de 1997"
4,2,3,187,552,504,1056,"6 de julio de 1997"
4,2,3,188,398,416,814,"6 de julio de 1997"
4,2,3,189,499,513,1012,"6 de julio de 1997"
4,2,3,190,403,427,830,"6 de julio de 1997"
4,2,3,191,351,362,713,"6 de julio de 1997"
4,2,3,192,395,353,748,"6 de julio de 1997"
4,2,3,193,233,230,463,"6 de julio de 1997"
4,2,3,194,382,371,753,"6 de julio de 1997"
4,2,3,195,411,410,821,"6 de julio de 1997"
4,2,3,196,510,470,980,"6 de julio de 1997"
4,2,3,197,378,379,757,"6 de julio de 1997"
4,2,3,198,101,9,110,"6 de julio de 1997"
4,2,3,199,706,682,1388,"6 de julio de 1997"
4,2,3,200,415,419,834,"6 de julio de 1997"
4,2,3,201,327,327,654,"6 de julio de 1997"
4,2,3,202,665,668,1333,"6 de julio de 1997"
4,2,3,203,485,468,953,"6 de julio de 1997"
4,2,3,204,238,263,501,"6 de julio de 1997"
4,2,3,205,743,792,1535,"6 de julio de 1997"
4,2,3,206,392,439,831,"6 de julio de 1997"
4,2,3,207,346,342,688,"6 de julio de 1997"
4,2,3,208,534,575,1109,"6 de julio de 1997"
4,2,3,209,592,609,1201,"6 de julio de 1997"
4,2,3,210,655,636,1291,"6 de julio de 1997"
4,2,3,211,600,665,1265,"6 de julio de 1997"
4,2,3,212,363,361,724,"6 de julio de 1997"
4,2,3,213,409,440,849,"6 de julio de 1997"
4,2,3,214,534,529,1063,"6 de julio de 1997"
4,2,3,215,177,179,356,"6 de julio de 1997"
4,2,3,216,443,424,867,"6 de julio de 1997"
4,2,3,217,504,514,1018,"6 de julio de 1997"
4,2,3,218,584,582,1166,"6 de julio de 1997"
4,2,3,219,200,240,440,"6 de julio de 1997"
4,2,3,220,300,310,610,"6 de julio de 1997"
4,2,3,221,348,379,727,"6 de julio de 1997"
4,2,3,222,284,285,569,"6 de julio de 1997"
4,2,3,223,354,340,694,"6 de julio de 1997"
4,2,3,224,504,527,1031,"6 de julio de 1997"
4,2,3,225,483,458,941,"6 de julio de 1997"
4,2,3,226,445,414,859,"6 de julio de 1997"
4,2,3,227,564,508,1072,"6 de julio de 1997"
4,2,3,228,378,374,752,"6 de julio de 1997"
4,2,3,229,732,764,1496,"6 de julio de 1997"
4,2,3,230,1398,1487,2885,"6 de julio de 1997"
4,2,3,231,303,312,615,"6 de julio de 1997"
4,2,3,232,613,556,1169,"6 de julio de 1997"
4,2,3,233,623,593,1216,"6 de julio de 1997"
4,2,3,234,587,579,1166,"6 de julio de 1997"
4,2,3,235,420,437,857,"6 de julio de 1997"
4,2,3,236,354,355,709,"6 de julio de 1997"
4,2,3,237,455,472,927,"6 de julio de 1997"
4,2,3,238,324,14,338,"6 de julio de 1997"
4,2,3,239,378,372,750,"6 de julio de 1997"
4,2,3,240,372,393,765,"6 de julio de 1997"
4,2,3,241,434,436,870,"6 de julio de 1997"
4,2,3,242,415,414,829,"6 de julio de 1997"
4,2,3,243,483,465,948,"6 de julio de 1997"
4,2,3,244,1186,1230,2416,"6 de julio de 1997"
4,2,3,245,415,449,864,"6 de julio de 1997"
4,2,3,246,451,413,864,"6 de julio de 1997"
4,2,3,247,306,299,605,"6 de julio de 1997"
4,2,3,248,414,384,798,"6 de julio de 1997"
4,2,3,249,430,433,863,"6 de julio de 1997"
4,2,3,250,460,387,847,"6 de julio de 1997"
4,2,3,251,345,311,656,"6 de julio de 1997"
4,2,3,252,328,320,648,"6 de julio de 1997"
4,2,3,253,452,391,843,"6 de julio de 1997"
4,2,3,254,192,149,341,"6 de julio de 1997"
4,2,3,255,168,136,304,"6 de julio de 1997"
4,2,3,256,378,360,738,"6 de julio de 1997"
4,2,3,257,421,393,814,"6 de julio de 1997"
4,2,3,258,438,355,793,"6 de julio de 1997"
4,2,3,259,458,360,818,"6 de julio de 1997"
4,2,3,260,182,151,333,"6 de julio de 1997"
4,2,3,261,351,263,614,"6 de julio de 1997"
4,2,3,262,471,389,860,"6 de julio de 1997"
4,2,3,263,260,203,463,"6 de julio de 1997"
4,2,3,264,152,106,258,"6 de julio de 1997"
4,2,3,265,466,439,905,"6 de julio de 1997"
4,2,3,266,441,408,849,"6 de julio de 1997"
4,2,3,267,736,626,1362,"6 de julio de 1997"
4,2,3,268,521,373,894,"6 de julio de 1997"
4,2,3,269,110,92,202,"6 de julio de 1997"
4,2,3,270,66,39,105,"6 de julio de 1997"
4,2,3,271,214,170,384,"6 de julio de 1997"
4,2,3,272,55,40,95,"6 de julio de 1997"
4,2,3,273,641,449,1090,"6 de julio de 1997"
4,2,3,274,424,402,826,"6 de julio de 1997"
4,2,3,275,185,147,332,"6 de julio de 1997"
4,2,3,276,134,103,237,"6 de julio de 1997"
4,2,3,277,562,444,1006,"6 de julio de 1997"
4,2,3,278,791,527,1318,"6 de julio de 1997"
4,2,3,279,404,352,756,"6 de julio de 1997"
4,2,3,280,347,369,716,"6 de julio de 1997"
4,2,3,281,501,482,983,"6 de julio de 1997"
4,2,3,282,303,285,588,"6 de julio de 1997"
4,2,3,283,360,354,714,"6 de julio de 1997"
4,2,3,284,113,81,194,"6 de julio de 1997"
4,2,3,285,328,263,591,"6 de julio de 1997"
4,2,3,286,80,65,145,"6 de julio de 1997"
4,2,3,287,137,126,263,"6 de julio de 1997"
4,2,3,288,171,142,313,"6 de julio de 1997"
4,2,3,289,370,272,642,"6 de julio de 1997"
4,2,3,290,46,27,73,"6 de julio de 1997"
4,2,3,291,465,372,837,"6 de julio de 1997"
4,2,3,292,206,159,365,"6 de julio de 1997"
4,2,3,293,410,368,778,"6 de julio de 1997"
4,2,3,294,63,46,109,"6 de julio de 1997"
4,2,3,295,288,143,431,"6 de julio de 1997"
4,2,3,296,228,199,427,"6 de julio de 1997"
4,2,3,297,221,140,361,"6 de julio de 1997"
4,2,3,298,392,315,707,"6 de julio de 1997"
4,2,3,299,360,299,659,"6 de julio de 1997"
4,2,3,300,170,115,285,"6 de julio de 1997"
4,2,3,301,183,106,289,"6 de julio de 1997"
4,2,3,302,92,87,179,"6 de julio de 1997"
4,2,4,303,301,208,509,"6 de julio de 1997"
4,2,4,304,368,387,755,"6 de julio de 1997"
4,2,4,305,360,397,757,"6 de julio de 1997"
4,2,4,306,351,365,716,"6 de julio de 1997"
4,2,4,307,356,345,701,"6 de julio de 1997"
4,2,4,308,221,201,422,"6 de julio de 1997"
4,2,4,309,405,360,765,"6 de julio de 1997"
4,2,4,310,334,291,625,"6 de julio de 1997"
4,2,4,311,317,284,601,"6 de julio de 1997"
4,2,4,312,317,309,626,"6 de julio de 1997"
4,2,4,313,370,350,720,"6 de julio de 1997"
4,2,4,314,419,409,828,"6 de julio de 1997"
4,2,4,315,398,388,786,"6 de julio de 1997"
4,2,4,316,352,369,721,"6 de julio de 1997"
4,2,4,317,353,384,737,"6 de julio de 1997"
4,2,4,318,375,388,763,"6 de julio de 1997"
4,2,4,319,569,547,1116,"6 de julio de 1997"
4,2,4,320,377,309,686,"6 de julio de 1997"
4,2,4,321,322,301,623,"6 de julio de 1997"
4,2,4,322,294,316,610,"6 de julio de 1997"
4,2,4,323,393,365,758,"6 de julio de 1997"
4,2,4,324,399,399,798,"6 de julio de 1997"
4,2,4,325,312,293,605,"6 de julio de 1997"
4,2,4,326,238,194,432,"6 de julio de 1997"
4,2,4,327,417,408,825,"6 de julio de 1997"
4,2,4,328,350,350,700,"6 de julio de 1997"
4,2,4,329,336,263,599,"6 de julio de 1997"
4,2,4,330,356,326,682,"6 de julio de 1997"
4,2,4,331,406,376,782,"6 de julio de 1997"
4,2,4,332,218,216,434,"6 de julio de 1997"
4,2,4,333,511,374,885,"6 de julio de 1997"
4,2,4,334,397,294,691,"6 de julio de 1997"
4,2,4,335,244,259,503,"6 de julio de 1997"
4,2,4,336,330,244,574,"6 de julio de 1997"
4,2,4,337,235,210,445,"6 de julio de 1997"
4,2,4,338,101,81,182,"6 de julio de 1997"
4,2,4,339,378,267,645,"6 de julio de 1997"
4,2,4,340,518,356,874,"6 de julio de 1997"
4,2,4,341,420,370,790,"6 de julio de 1997"
4,2,4,342,502,421,923,"6 de julio de 1997"
4,2,4,343,304,259,563,"6 de julio de 1997"
4,2,4,344,290,244,534,"6 de julio de 1997"
4,2,4,345,296,230,526,"6 de julio de 1997"
4,2,4,346,373,352,725,"6 de julio de 1997"
4,2,4,347,423,315,738,"6 de julio de 1997"
4,2,4,348,302,214,516,"6 de julio de 1997"
4,2,4,349,327,271,598,"6 de julio de 1997"
4,2,4,350,394,335,729,"6 de julio de 1997"
4,2,4,351,112,91,203,"6 de julio de 1997"
4,2,4,352,168,127,295,"6 de julio de 1997"
4,2,4,353,115,87,202,"6 de julio de 1997"
4,2,4,354,199,143,342,"6 de julio de 1997"
4,2,4,355,86,71,157,"6 de julio de 1997"
4,2,4,356,540,433,973,"6 de julio de 1997"
4,2,4,357,182,158,340,"6 de julio de 1997"
4,2,4,358,120,124,244,"6 de julio de 1997"
4,2,4,359,286,225,511,"6 de julio de 1997"
4,2,4,360,416,335,751,"6 de julio de 1997"
4,2,4,361,480,396,876,"6 de julio de 1997"
4,2,4,362,183,122,305,"6 de julio de 1997"
4,2,7,428,464,443,907,"6 de julio de 1997"
4,2,7,429,653,638,1291,"6 de julio de 1997"
4,2,7,430,139,140,279,"6 de julio de 1997"
4,2,7,431,242,224,466,"6 de julio de 1997"
4,2,7,432,159,132,291,"6 de julio de 1997"
4,2,7,433,171,155,326,"6 de julio de 1997"
4,2,7,434,30,25,55,"6 de julio de 1997"
4,2,7,435,199,163,362,"6 de julio de 1997"
4,2,7,436,32,30,62,"6 de julio de 1997"
4,2,7,437,41,36,77,"6 de julio de 1997"
4,2,7,438,39,22,61,"6 de julio de 1997"
4,2,7,439,128,100,228,"6 de julio de 1997"
4,2,9,448,485,473,958,"6 de julio de 1997"
4,2,9,449,457,440,897,"6 de julio de 1997"
4,2,9,450,417,403,820,"6 de julio de 1997"
4,2,9,451,452,445,897,"6 de julio de 1997"
4,2,9,452,345,347,692,"6 de julio de 1997"
4,2,9,453,401,399,800,"6 de julio de 1997"
4,2,9,454,420,421,841,"6 de julio de 1997"
4,2,9,455,774,391,1165,"6 de julio de 1997"
4,2,9,456,264,290,554,"6 de julio de 1997"
4,2,9,457,283,324,607,"6 de julio de 1997"
4,2,9,458,351,383,734,"6 de julio de 1997"
4,2,9,459,308,307,615,"6 de julio de 1997"
4,2,9,460,352,340,692,"6 de julio de 1997"
4,2,9,461,369,376,745,"6 de julio de 1997"
4,2,9,462,357,350,707,"6 de julio de 1997"
4,2,9,463,337,372,709,"6 de julio de 1997"
4,2,9,464,456,439,895,"6 de julio de 1997"
4,2,9,465,139,100,239,"6 de julio de 1997"
4,2,9,466,147,104,251,"6 de julio de 1997"
4,2,9,467,229,176,405,"6 de julio de 1997"
4,2,9,468,542,437,979,"6 de julio de 1997"
4,2,9,469,210,157,367,"6 de julio de 1997"
4,2,9,470,347,310,657,"6 de julio de 1997"
4,2,9,471,358,258,616,"6 de julio de 1997"
4,2,9,472,326,288,614,"6 de julio de 1997"
4,2,9,473,385,330,715,"6 de julio de 1997"
4,2,9,474,69,57,126,"6 de julio de 1997"
4,2,9,475,321,306,627,"6 de julio de 1997"
4,2,9,476,282,299,581,"6 de julio de 1997"
4,2,9,477,348,311,659,"6 de julio de 1997"
4,2,9,478,427,333,760,"6 de julio de 1997"
4,2,9,479,216,181,397,"6 de julio de 1997"
4,2,9,480,324,276,600,"6 de julio de 1997"
4,2,9,481,444,394,838,"6 de julio de 1997"
4,2,9,482,218,180,398,"6 de julio de 1997"
4,2,9,483,129,94,223,"6 de julio de 1997"
4,2,9,484,452,360,812,"6 de julio de 1997"
4,2,9,485,269,232,501,"6 de julio de 1997"
4,2,9,486,413,360,773,"6 de julio de 1997"
4,2,9,487,308,255,563,"6 de julio de 1997"
4,2,9,488,208,163,371,"6 de julio de 1997"
4,2,9,489,281,303,584,"6 de julio de 1997"
5,1,2,3,848,867,1715,"6 de julio de 1997"
5,1,2,4,821,792,1613,"6 de julio de 1997"
5,1,2,5,261,269,530,"6 de julio de 1997"
5,1,2,6,479,515,994,"6 de julio de 1997"
5,1,2,7,529,605,1134,"6 de julio de 1997"
5,1,2,8,510,595,1105,"6 de julio de 1997"
5,1,2,9,750,712,1462,"6 de julio de 1997"
5,1,2,10,979,875,1854,"6 de julio de 1997"
5,1,2,11,889,876,1765,"6 de julio de 1997"
5,1,2,12,739,783,1522,"6 de julio de 1997"
5,1,2,13,233,258,491,"6 de julio de 1997"
5,1,2,14,426,490,916,"6 de julio de 1997"
5,1,2,15,513,546,1059,"6 de julio de 1997"
5,1,2,16,561,508,1069,"6 de julio de 1997"
5,1,2,17,542,530,1072,"6 de julio de 1997"
5,1,2,18,571,611,1182,"6 de julio de 1997"
5,1,2,19,496,503,999,"6 de julio de 1997"
5,1,2,20,545,626,1171,"6 de julio de 1997"
5,1,2,21,431,429,860,"6 de julio de 1997"
5,1,2,22,452,502,954,"6 de julio de 1997"
5,1,2,23,426,408,834,"6 de julio de 1997"
5,1,2,24,409,444,853,"6 de julio de 1997"
5,1,2,25,463,499,962,"6 de julio de 1997"
5,1,2,26,215,260,475,"6 de julio de 1997"
5,1,2,27,440,512,952,"6 de julio de 1997"
5,1,2,28,513,550,1063,"6 de julio de 1997"
5,1,2,29,627,649,1276,"6 de julio de 1997"
5,1,2,30,508,519,1027,"6 de julio de 1997"
5,1,2,31,427,409,836,"6 de julio de 1997"
5,1,2,32,567,551,1118,"6 de julio de 1997"
5,1,2,33,359,394,753,"6 de julio de 1997"
5,1,2,34,822,856,1678,"6 de julio de 1997"
5,1,2,35,599,637,1236,"6 de julio de 1997"
5,1,2,36,584,581,1165,"6 de julio de 1997"
5,1,2,37,331,344,675,"6 de julio de 1997"
5,1,2,38,24,11,35,"6 de julio de 1997"
5,1,2,39,34,22,56,"6 de julio de 1997"
5,1,2,40,45,31,76,"6 de julio de 1997"
5,1,2,41,375,402,777,"6 de julio de 1997"
5,1,3,42,268,309,577,"6 de julio de 1997"
5,1,3,43,354,431,785,"6 de julio de 1997"
5,1,3,44,414,455,869,"6 de julio de 1997"
5,1,3,45,392,440,832,"6 de julio de 1997"
5,1,3,46,368,461,829,"6 de julio de 1997"
5,1,3,47,400,434,834,"6 de julio de 1997"
5,1,3,48,313,310,623,"6 de julio de 1997"
5,1,3,49,580,637,1217,"6 de julio de 1997"
5,1,3,50,498,580,1078,"6 de julio de 1997"
5,1,3,51,311,336,647,"6 de julio de 1997"
5,1,3,52,277,344,621,"6 de julio de 1997"
5,1,3,53,360,405,765,"6 de julio de 1997"
5,1,3,54,555,543,1098,"6 de julio de 1997"
5,1,3,55,488,500,988,"6 de julio de 1997"
5,1,3,56,66,48,114,"6 de julio de 1997"
5,1,12,233,207,183,390,"6 de julio de 1997"
5,1,12,234,158,141,299,"6 de julio de 1997"
5,1,12,235,85,59,144,"6 de julio de 1997"
5,1,12,236,125,115,240,"6 de julio de 1997"
5,1,12,237,87,84,171,"6 de julio de 1997"
5,1,13,238,209,176,385,"6 de julio de 1997"
5,1,13,239,116,113,229,"6 de julio de 1997"
5,1,14,240,194,189,383,"6 de julio de 1997"
5,1,14,241,149,127,276,"6 de julio de 1997"
5,1,14,242,471,530,1001,"6 de julio de 1997"
5,1,14,243,311,288,599,"6 de julio de 1997"
5,1,14,244,216,203,419,"6 de julio de 1997"
5,1,14,245,456,432,888,"6 de julio de 1997"
5,1,14,246,441,436,877,"6 de julio de 1997"
5,1,14,247,34,29,63,"6 de julio de 1997"
5,1,14,248,85,59,144,"6 de julio de 1997"
5,1,14,249,210,202,412,"6 de julio de 1997"
5,1,19,444,237,283,520,"6 de julio de 1997"
5,1,19,445,417,466,883,"6 de julio de 1997"
5,1,19,446,455,476,931,"6 de julio de 1997"
5,1,19,447,419,439,858,"6 de julio de 1997"
5,1,19,448,266,256,522,"6 de julio de 1997"
5,1,19,449,299,297,596,"6 de julio de 1997"
5,1,20,450,348,390,738,"6 de julio de 1997"
5,1,20,451,415,481,896,"6 de julio de 1997"
5,1,20,452,513,561,1074,"6 de julio de 1997"
5,1,20,453,540,579,1119,"6 de julio de 1997"
5,1,20,454,614,745,1359,"6 de julio de 1997"
5,1,20,455,365,399,764,"6 de julio de 1997"
5,1,20,456,232,240,472,"6 de julio de 1997"
5,1,20,457,589,596,1185,"6 de julio de 1997"
5,1,20,458,570,644,1214,"6 de julio de 1997"
5,1,20,459,491,554,1045,"6 de julio de 1997"
5,1,20,460,370,375,745,"6 de julio de 1997"
5,1,20,461,550,573,1123,"6 de julio de 1997"
5,1,20,462,472,622,1094,"6 de julio de 1997"
5,1,20,463,244,259,503,"6 de julio de 1997"
5,1,20,464,514,629,1143,"6 de julio de 1997"
5,1,20,465,226,268,494,"6 de julio de 1997"
5,1,20,466,297,300,597,"6 de julio de 1997"
5,1,20,467,508,550,1058,"6 de julio de 1997"
5,1,20,468,482,543,1025,"6 de julio de 1997"
5,1,20,469,464,521,985,"6 de julio de 1997"
5,1,20,470,482,324,806,"6 de julio de 1997"
5,1,20,471,27,5,32,"6 de julio de 1997"
5,1,20,472,23,13,36,"6 de julio de 1997"
5,1,20,473,287,279,566,"6 de julio de 1997"
5,1,20,474,227,245,472,"6 de julio de 1997"
5,1,20,475,269,278,547,"6 de julio de 1997"
5,1,20,476,478,500,978,"6 de julio de 1997"
5,1,20,477,371,395,766,"6 de julio de 1997"
5,1,20,478,589,604,1193,"6 de julio de 1997"
5,1,20,479,556,588,1144,"6 de julio de 1997"
5,1,20,480,396,399,795,"6 de julio de 1997"
5,1,20,481,310,321,631,"6 de julio de 1997"
5,1,20,482,435,404,839,"6 de julio de 1997"
5,1,20,483,345,378,723,"6 de julio de 1997"
5,1,20,484,248,241,489,"6 de julio de 1997"
5,1,20,485,236,237,473,"6 de julio de 1997"
5,1,20,486,288,297,585,"6 de julio de 1997"
5,1,20,487,171,159,330,"6 de julio de 1997"
5,1,20,488,249,265,514,"6 de julio de 1997"
5,1,20,489,397,416,813,"6 de julio de 1997"
5,1,20,490,394,382,776,"6 de julio de 1997"
5,1,20,491,81,75,156,"6 de julio de 1997"
5,1,20,492,542,553,1095,"6 de julio de 1997"
5,1,20,493,387,407,794,"6 de julio de 1997"
5,1,20,494,233,266,499,"6 de julio de 1997"
5,1,20,495,407,431,838,"6 de julio de 1997"
5,1,20,496,276,288,564,"6 de julio de 1997"
5,1,20,497,346,348,694,"6 de julio de 1997"
5,1,20,498,205,203,408,"6 de julio de 1997"
5,1,20,499,333,343,676,"6 de julio de 1997"
5,1,22,508,563,526,1089,"6 de julio de 1997"
5,1,22,509,368,328,696,"6 de julio de 1997"
5,1,22,510,552,466,1018,"6 de julio de 1997"
5,1,22,511,437,423,860,"6 de julio de 1997"
5,1,22,512,385,384,769,"6 de julio de 1997"
5,1,22,513,339,323,662,"6 de julio de 1997"
5,1,22,514,418,404,822,"6 de julio de 1997"
5,1,22,515,622,590,1212,"6 de julio de 1997"
5,1,22,516,492,475,967,"6 de julio de 1997"
5,1,22,517,334,359,693,"6 de julio de 1997"
5,1,22,518,292,301,593,"6 de julio de 1997"
5,1,22,519,277,279,556,"6 de julio de 1997"
5,1,22,520,98,98,196,"6 de julio de 1997"
5,1,22,521,40,26,66,"6 de julio de 1997"
5,1,22,522,33,42,75,"6 de julio de 1997"
5,1,22,523,135,127,262,"6 de julio de 1997"
5,1,22,524,22,15,37,"6 de julio de 1997"
5,1,22,525,122,100,222,"6 de julio de 1997"
5,1,25,577,286,311,597,"6 de julio de 1997"
5,1,25,578,458,495,953,"6 de julio de 1997"
5,1,25,579,369,396,765,"6 de julio de 1997"
5,1,25,580,367,400,767,"6 de julio de 1997"
5,1,25,581,518,595,1113,"6 de julio de 1997"
5,1,25,582,213,254,467,"6 de julio de 1997"
5,1,25,583,292,337,629,"6 de julio de 1997"
5,1,25,584,321,351,672,"6 de julio de 1997"
5,1,25,585,530,547,1077,"6 de julio de 1997"
5,1,25,586,720,709,1429,"6 de julio de 1997"
5,1,25,587,1249,1340,2589,"6 de julio de 1997"
5,1,25,588,611,634,1245,"6 de julio de 1997"
5,1,25,589,240,270,510,"6 de julio de 1997"
5,1,25,590,212,237,449,"6 de julio de 1997"
5,1,25,591,406,468,874,"6 de julio de 1997"
5,1,25,592,282,295,577,"6 de julio de 1997"
5,1,25,593,366,382,748,"6 de julio de 1997"
5,1,25,594,537,509,1046,"6 de julio de 1997"
5,1,25,595,524,562,1086,"6 de julio de 1997"
5,1,25,596,391,453,844,"6 de julio de 1997"
5,1,25,597,453,565,1018,"6 de julio de 1997"
5,1,25,598,383,443,826,"6 de julio de 1997"
5,1,25,599,291,313,604,"6 de julio de 1997"
5,1,25,600,352,361,713,"6 de julio de 1997"
5,1,25,601,521,586,1107,"6 de julio de 1997"
5,1,25,602,486,534,1020,"6 de julio de 1997"
5,1,25,603,389,440,829,"6 de julio de 1997"
5,1,25,604,337,324,661,"6 de julio de 1997"
5,1,25,605,385,434,819,"6 de julio de 1997"
5,1,25,606,425,466,891,"6 de julio de 1997"
5,1,25,607,333,336,669,"6 de julio de 1997"
5,1,25,608,406,455,861,"6 de julio de 1997"
5,1,25,609,413,435,848,"6 de julio de 1997"
5,1,25,610,471,493,964,"6 de julio de 1997"
5,1,25,611,1665,1815,3480,"6 de julio de 1997"
5,1,25,612,630,690,1320,"6 de julio de 1997"
5,1,25,613,707,792,1499,"6 de julio de 1997"
5,1,25,614,564,634,1198,"6 de julio de 1997"
5,1,25,615,377,460,837,"6 de julio de 1997"
5,1,25,616,277,341,618,"6 de julio de 1997"
5,1,25,617,459,532,991,"6 de julio de 1997"
5,1,25,618,794,815,1609,"6 de julio de 1997"
5,1,25,619,388,410,798,"6 de julio de 1997"
5,1,25,620,594,657,1251,"6 de julio de 1997"
5,1,25,621,637,690,1327,"6 de julio de 1997"
5,1,25,622,430,465,895,"6 de julio de 1997"
5,1,25,623,700,776,1476,"6 de julio de 1997"
5,1,25,624,512,610,1122,"6 de julio de 1997"
5,1,25,625,367,380,747,"6 de julio de 1997"
5,1,25,626,398,419,817,"6 de julio de 1997"
5,1,25,627,564,657,1221,"6 de julio de 1997"
5,1,25,628,459,507,966,"6 de julio de 1997"
5,1,25,629,314,346,660,"6 de julio de 1997"
5,1,25,630,371,361,732,"6 de julio de 1997"
5,1,25,631,519,486,1005,"6 de julio de 1997"
5,1,25,632,469,564,1033,"6 de julio de 1997"
5,1,25,633,433,486,919,"6 de julio de 1997"
5,1,25,634,352,377,729,"6 de julio de 1997"
5,1,25,635,387,425,812,"6 de julio de 1997"
5,1,25,636,444,467,911,"6 de julio de 1997"
5,1,25,637,422,428,850,"6 de julio de 1997"
5,1,25,638,440,505,945,"6 de julio de 1997"
5,1,25,639,641,677,1318,"6 de julio de 1997"
5,1,25,640,818,893,1711,"6 de julio de 1997"
5,1,25,641,605,648,1253,"6 de julio de 1997"
5,1,25,642,126,118,244,"6 de julio de 1997"
5,1,25,643,142,128,270,"6 de julio de 1997"
5,1,25,644,65,48,113,"6 de julio de 1997"
5,1,37,1498,140,146,286,"6 de julio de 1997"
5,1,37,1499,279,322,601,"6 de julio de 1997"
5,1,37,1500,345,415,760,"6 de julio de 1997"
5,1,37,1501,316,329,645,"6 de julio de 1997"
5,1,37,1502,336,379,715,"6 de julio de 1997"
5,1,37,1503,120,78,198,"6 de julio de 1997"
5,1,37,1504,45,42,87,"6 de julio de 1997"
5,1,37,1505,138,116,254,"6 de julio de 1997"
5,1,38,1506,394,431,825,"6 de julio de 1997"
5,1,38,1507,357,390,747,"6 de julio de 1997"
5,1,38,1508,473,502,975,"6 de julio de 1997"
5,1,38,1509,353,414,767,"6 de julio de 1997"
5,1,38,1510,235,256,491,"6 de julio de 1997"
5,1,38,1511,393,408,801,"6 de julio de 1997"
5,1,38,1512,387,418,805,"6 de julio de 1997"
5,1,38,1513,314,326,640,"6 de julio de 1997"
5,1,38,1514,23,14,37,"6 de julio de 1997"
5,1,38,1515,117,62,179,"6 de julio de 1997"
5,1,38,1516,197,189,386,"6 de julio de 1997"
5,1,38,1517,97,80,177,"6 de julio de 1997"
5,1,38,1518,76,56,132,"6 de julio de 1997"
5,1,38,1519,34,20,54,"6 de julio de 1997"
5,1,38,1520,135,139,274,"6 de julio de 1997"
5,2,7,110,249,255,504,"6 de julio de 1997"
5,2,7,111,443,463,906,"6 de julio de 1997"
5,2,7,112,297,324,621,"6 de julio de 1997"
5,2,7,113,406,439,845,"6 de julio de 1997"
5,2,7,114,362,399,761,"6 de julio de 1997"
5,2,7,115,404,385,789,"6 de julio de 1997"
5,2,7,116,447,438,885,"6 de julio de 1997"
5,2,7,117,44,30,74,"6 de julio de 1997"
5,2,7,118,47,32,79,"6 de julio de 1997"
5,2,7,119,72,63,135,"6 de julio de 1997"
5,2,7,120,38,22,60,"6 de julio de 1997"
5,2,7,121,60,64,124,"6 de julio de 1997"
5,2,7,122,163,113,276,"6 de julio de 1997"
5,2,7,123,193,141,334,"6 de julio de 1997"
5,2,7,124,80,60,140,"6 de julio de 1997"
5,2,7,125,79,44,123,"6 de julio de 1997"
5,2,7,126,96,78,174,"6 de julio de 1997"
5,2,9,131,667,617,1284,"6 de julio de 1997"
5,2,9,132,360,345,705,"6 de julio de 1997"
5,2,9,133,278,312,590,"6 de julio de 1997"
5,2,9,134,485,535,1020,"6 de julio de 1997"
5,2,9,135,568,650,1218,"6 de julio de 1997"
5,2,9,136,448,510,958,"6 de julio de 1997"
5,2,9,137,204,235,439,"6 de julio de 1997"
5,2,9,138,367,441,808,"6 de julio de 1997"
5,2,9,139,449,515,964,"6 de julio de 1997"
5,2,9,140,239,279,518,"6 de julio de 1997"
5,2,9,141,407,438,845,"6 de julio de 1997"
5,2,9,142,342,395,737,"6 de julio de 1997"
5,2,9,143,525,602,1127,"6 de julio de 1997"
5,2,9,144,546,643,1189,"6 de julio de 1997"
5,2,9,145,461,486,947,"6 de julio de 1997"
5,2,9,146,603,614,1217,"6 de julio de 1997"
5,2,9,147,390,448,838,"6 de julio de 1997"
5,2,9,148,335,299,634,"6 de julio de 1997"
5,2,9,149,107,74,181,"6 de julio de 1997"
5,2,9,150,218,216,434,"6 de julio de 1997"
5,2,9,151,68,63,131,"6 de julio de 1997"
5,2,9,152,266,292,558,"6 de julio de 1997"
5,2,9,153,228,241,469,"6 de julio de 1997"
5,2,9,154,250,243,493,"6 de julio de 1997"
5,2,9,155,179,177,356,"6 de julio de 1997"
5,2,9,156,305,321,626,"6 de julio de 1997"
5,2,9,157,378,373,751,"6 de julio de 1997"
5,2,9,158,263,274,537,"6 de julio de 1997"
5,2,9,159,419,448,867,"6 de julio de 1997"
5,2,9,160,232,254,486,"6 de julio de 1997"
5,2,9,161,293,309,602,"6 de julio de 1997"
5,2,9,162,559,601,1160,"6 de julio de 1997"
5,2,9,163,227,236,463,"6 de julio de 1997"
5,2,9,164,182,192,374,"6 de julio de 1997"
5,2,9,165,272,278,550,"6 de julio de 1997"
5,2,9,166,271,282,553,"6 de julio de 1997"
5,2,9,167,136,103,239,"6 de julio de 1997"
5,2,9,168,505,529,1034,"6 de julio de 1997"
5,2,9,169,563,595,1158,"6 de julio de 1997"
5,2,9,170,229,211,440,"6 de julio de 1997"
5,2,9,171,360,356,716,"6 de julio de 1997"
5,2,9,172,217,224,441,"6 de julio de 1997"
5,2,10,173,437,442,879,"6 de julio de 1997"
5,2,10,174,565,565,1130,"6 de julio de 1997"
5,2,10,175,467,450,917,"6 de julio de 1997"
5,2,10,176,440,465,905,"6 de julio de 1997"
5,2,10,177,567,580,1147,"6 de julio de 1997"
5,2,10,178,524,525,1049,"6 de julio de 1997"
5,2,10,179,553,562,1115,"6 de julio de 1997"
5,2,10,180,574,563,1137,"6 de julio de 1997"
5,2,10,181,251,246,497,"6 de julio de 1997"
5,2,10,182,410,413,823,"6 de julio de 1997"
5,2,10,183,397,396,793,"6 de julio de 1997"
5,2,10,184,289,287,576,"6 de julio de 1997"
5,2,10,185,590,540,1130,"6 de julio de 1997"
5,2,10,186,466,538,1004,"6 de julio de 1997"
5,2,10,187,538,573,1111,"6 de julio de 1997"
5,2,10,188,467,478,945,"6 de julio de 1997"
5,2,10,189,243,226,469,"6 de julio de 1997"
5,2,10,190,492,511,1003,"6 de julio de 1997"
5,2,10,191,150,158,308,"6 de julio de 1997"
5,2,10,192,665,585,1250,"6 de julio de 1997"
5,2,10,193,604,655,1259,"6 de julio de 1997"
5,2,10,194,323,364,687,"6 de julio de 1997"
5,2,10,195,530,578,1108,"6 de julio de 1997"
5,2,10,196,392,398,790,"6 de julio de 1997"
5,2,10,197,607,638,1245,"6 de julio de 1997"
5,2,10,198,429,423,852,"6 de julio de 1997"
5,2,10,199,624,616,1240,"6 de julio de 1997"
5,2,10,200,612,587,1199,"6 de julio de 1997"
5,2,10,201,379,381,760,"6 de julio de 1997"
5,2,10,202,484,487,971,"6 de julio de 1997"
5,2,10,203,496,481,977,"6 de julio de 1997"
5,2,10,204,516,513,1029,"6 de julio de 1997"
5,2,10,205,239,224,463,"6 de julio de 1997"
5,2,10,206,465,452,917,"6 de julio de 1997"
5,2,10,207,507,486,993,"6 de julio de 1997"
5,2,10,208,485,480,965,"6 de julio de 1997"
5,2,10,209,401,416,817,"6 de julio de 1997"
5,2,10,210,429,437,866,"6 de julio de 1997"
5,2,10,211,452,428,880,"6 de julio de 1997"
5,2,10,212,397,388,785,"6 de julio de 1997"
5,2,10,213,79,51,130,"6 de julio de 1997"
5,2,16,255,278,295,573,"6 de julio de 1997"
5,2,16,256,370,345,715,"6 de julio de 1997"
5,2,21,500,329,328,657,"6 de julio de 1997"
5,2,21,501,404,392,796,"6 de julio de 1997"
5,2,21,502,344,315,659,"6 de julio de 1997"
5,2,21,503,289,270,559,"6 de julio de 1997"
5,2,21,504,148,105,253,"6 de julio de 1997"
5,2,21,505,323,264,587,"6 de julio de 1997"
5,2,21,506,50,50,100,"6 de julio de 1997"
5,2,21,507,46,44,90,"6 de julio de 1997"
5,2,23,526,484,504,988,"6 de julio de 1997"
5,2,23,527,370,365,735,"6 de julio de 1997"
5,2,23,528,103,89,192,"6 de julio de 1997"
5,2,23,529,102,67,169,"6 de julio de 1997"
5,2,23,530,107,91,198,"6 de julio de 1997"
5,2,23,531,99,79,178,"6 de julio de 1997"
5,2,23,532,363,311,674,"6 de julio de 1997"
5,2,23,533,119,93,212,"6 de julio de 1997"
5,2,23,534,119,102,221,"6 de julio de 1997"
5,2,23,535,132,97,229,"6 de julio de 1997"
5,2,23,536,111,69,180,"6 de julio de 1997"
5,2,23,537,98,84,182,"6 de julio de 1997"
5,2,23,538,79,64,143,"6 de julio de 1997"
5,2,23,539,410,335,745,"6 de julio de 1997"
5,2,23,540,470,458,928,"6 de julio de 1997"
5,2,23,541,18,28,46,"6 de julio de 1997"
5,2,29,728,346,316,662,"6 de julio de 1997"
5,2,29,729,319,289,608,"6 de julio de 1997"
5,2,33,1091,296,306,602,"6 de julio de 1997"
5,2,33,1092,105,94,199,"6 de julio de 1997"
5,2,33,1093,579,602,1181,"6 de julio de 1997"
5,2,33,1094,218,258,476,"6 de julio de 1997"
5,2,33,1095,397,443,840,"6 de julio de 1997"
5,2,33,1096,729,749,1478,"6 de julio de 1997"
5,2,33,1097,353,389,742,"6 de julio de 1997"
5,2,33,1098,800,831,1631,"6 de julio de 1997"
5,2,33,1099,460,458,918,"6 de julio de 1997"
5,2,33,1100,656,686,1342,"6 de julio de 1997"
5,2,33,1101,321,375,696,"6 de julio de 1997"
5,2,33,1102,315,342,657,"6 de julio de 1997"
5,2,33,1103,563,600,1163,"6 de julio de 1997"
5,2,33,1104,547,587,1134,"6 de julio de 1997"
5,2,33,1105,340,331,671,"6 de julio de 1997"
5,2,33,1106,239,247,486,"6 de julio de 1997"
5,2,33,1107,211,225,436,"6 de julio de 1997"
5,2,33,1108,486,483,969,"6 de julio de 1997"
5,2,33,1109,502,591,1093,"6 de julio de 1997"
5,2,33,1110,250,252,502,"6 de julio de 1997"
5,2,33,1111,676,804,1480,"6 de julio de 1997"
5,2,33,1112,474,513,987,"6 de julio de 1997"
5,2,33,1113,442,563,1005,"6 de julio de 1997"
5,2,33,1114,159,180,339,"6 de julio de 1997"
5,2,33,1115,344,374,718,"6 de julio de 1997"
5,2,33,1116,635,672,1307,"6 de julio de 1997"
5,2,33,1117,574,594,1168,"6 de julio de 1997"
5,2,33,1118,241,282,523,"6 de julio de 1997"
5,2,33,1119,101,80,181,"6 de julio de 1997"
5,2,33,1120,106,87,193,"6 de julio de 1997"
5,2,33,1121,104,106,210,"6 de julio de 1997"
5,2,33,1122,265,243,508,"6 de julio de 1997"
5,2,33,1123,34,30,64,"6 de julio de 1997"
5,2,33,1124,84,67,151,"6 de julio de 1997"
5,2,33,1125,429,445,874,"6 de julio de 1997"
5,2,33,1126,149,130,279,"6 de julio de 1997"
5,2,33,1127,230,245,475,"6 de julio de 1997"
5,2,33,1128,350,357,707,"6 de julio de 1997"
5,2,33,1129,363,336,699,"6 de julio de 1997"
5,2,33,1130,278,288,566,"6 de julio de 1997"
5,2,33,1131,364,328,692,"6 de julio de 1997"
5,2,33,1132,485,484,969,"6 de julio de 1997"
5,2,33,1133,192,178,370,"6 de julio de 1997"
5,2,33,1134,83,84,167,"6 de julio de 1997"
5,2,33,1135,357,290,647,"6 de julio de 1997"
5,2,33,1136,511,522,1033,"6 de julio de 1997"
5,2,33,1137,394,424,818,"6 de julio de 1997"
5,2,33,1138,405,381,786,"6 de julio de 1997"
5,2,33,1139,316,315,631,"6 de julio de 1997"
5,2,33,1140,636,685,1321,"6 de julio de 1997"
5,2,33,1141,575,611,1186,"6 de julio de 1997"
5,2,33,1142,480,462,942,"6 de julio de 1997"
5,2,33,1143,203,182,385,"6 de julio de 1997"
5,2,33,1144,179,146,325,"6 de julio de 1997"
5,2,33,1145,44,36,80,"6 de julio de 1997"
5,2,33,1146,441,417,858,"6 de julio de 1997"
5,2,33,1147,352,337,689,"6 de julio de 1997"
5,2,33,1148,411,376,787,"6 de julio de 1997"
5,2,33,1149,652,609,1261,"6 de julio de 1997"
5,2,33,1150,169,175,344,"6 de julio de 1997"
5,2,33,1151,299,308,607,"6 de julio de 1997"
5,2,33,1152,154,139,293,"6 de julio de 1997"
5,2,33,1153,245,233,478,"6 de julio de 1997"
5,2,33,1154,325,306,631,"6 de julio de 1997"
5,2,33,1155,264,247,511,"6 de julio de 1997"
5,2,33,1156,451,468,919,"6 de julio de 1997"
5,2,33,1157,580,529,1109,"6 de julio de 1997"
5,2,33,1158,349,358,707,"6 de julio de 1997"
5,2,33,1159,452,420,872,"6 de julio de 1997"
5,2,33,1160,327,311,638,"6 de julio de 1997"
5,2,33,1161,417,364,781,"6 de julio de 1997"
5,2,33,1162,543,485,1028,"6 de julio de 1997"
5,2,33,1163,583,533,1116,"6 de julio de 1997"
5,2,33,1164,208,188,396,"6 de julio de 1997"
5,2,33,1165,177,147,324,"6 de julio de 1997"
5,2,34,1166,201,176,377,"6 de julio de 1997"
5,2,34,1167,732,547,1279,"6 de julio de 1997"
5,2,34,1168,103,69,172,"6 de julio de 1997"
5,2,34,1169,34,19,53,"6 de julio de 1997"
5,2,34,1170,421,401,822,"6 de julio de 1997"
5,2,34,1171,180,120,300,"6 de julio de 1997"
5,3,1,1,259,268,527,"6 de julio de 1997"
5,3,1,2,154,187,341,"6 de julio de 1997"
5,3,5,81,166,147,313,"6 de julio de 1997"
5,3,5,82,308,327,635,"6 de julio de 1997"
5,3,5,83,76,63,139,"6 de julio de 1997"
5,3,6,84,388,393,781,"6 de julio de 1997"
5,3,6,85,218,237,455,"6 de julio de 1997"
5,3,6,86,174,192,366,"6 de julio de 1997"
5,3,6,87,556,583,1139,"6 de julio de 1997"
5,3,6,88,572,602,1174,"6 de julio de 1997"
5,3,6,89,572,585,1157,"6 de julio de 1997"
5,3,6,90,312,344,656,"6 de julio de 1997"
5,3,6,91,444,438,882,"6 de julio de 1997"
5,3,6,92,357,420,777,"6 de julio de 1997"
5,3,6,93,370,442,812,"6 de julio de 1997"
5,3,6,94,639,659,1298,"6 de julio de 1997"
5,3,6,95,408,412,820,"6 de julio de 1997"
5,3,6,96,525,573,1098,"6 de julio de 1997"
5,3,6,97,148,120,268,"6 de julio de 1997"
5,3,6,98,82,60,142,"6 de julio de 1997"
5,3,6,99,53,36,89,"6 de julio de 1997"
5,3,6,100,29,16,45,"6 de julio de 1997"
5,3,6,101,67,29,96,"6 de julio de 1997"
5,3,6,102,77,49,126,"6 de julio de 1997"
5,3,6,103,48,24,72,"6 de julio de 1997"
5,3,6,104,124,107,231,"6 de julio de 1997"
5,3,6,105,73,55,128,"6 de julio de 1997"
5,3,6,106,69,55,124,"6 de julio de 1997"
5,3,6,107,44,31,75,"6 de julio de 1997"
5,3,6,108,77,58,135,"6 de julio de 1997"
5,3,6,109,81,49,130,"6 de julio de 1997"
5,3,8,127,98,87,185,"6 de julio de 1997"
5,3,8,128,87,96,183,"6 de julio de 1997"
5,3,8,129,132,124,256,"6 de julio de 1997"
5,3,8,130,475,566,1041,"6 de julio de 1997"
5,3,15,250,129,170,299,"6 de julio de 1997"
5,3,15,251,100,107,207,"6 de julio de 1997"
5,3,15,252,115,101,216,"6 de julio de 1997"
5,3,15,253,41,41,82,"6 de julio de 1997"
5,3,15,254,53,43,96,"6 de julio de 1997"
5,3,18,319,333,306,639,"6 de julio de 1997"
5,3,18,320,211,235,446,"6 de julio de 1997"
5,3,18,321,429,407,836,"6 de julio de 1997"
5,3,18,322,193,191,384,"6 de julio de 1997"
5,3,18,323,387,404,791,"6 de julio de 1997"
5,3,18,324,179,172,351,"6 de julio de 1997"
5,3,18,325,314,328,642,"6 de julio de 1997"
5,3,18,326,457,480,937,"6 de julio de 1997"
5,3,18,327,267,279,546,"6 de julio de 1997"
5,3,18,328,212,236,448,"6 de julio de 1997"
5,3,18,329,128,122,250,"6 de julio de 1997"
5,3,18,330,213,228,441,"6 de julio de 1997"
5,3,18,331,357,386,743,"6 de julio de 1997"
5,3,18,332,481,517,998,"6 de julio de 1997"
5,3,18,333,379,420,799,"6 de julio de 1997"
5,3,18,334,606,619,1225,"6 de julio de 1997"
5,3,18,335,531,587,1118,"6 de julio de 1997"
5,3,18,336,381,368,749,"6 de julio de 1997"
5,3,18,337,458,470,928,"6 de julio de 1997"
5,3,18,338,299,302,601,"6 de julio de 1997"
5,3,18,339,507,530,1037,"6 de julio de 1997"
5,3,18,340,520,560,1080,"6 de julio de 1997"
5,3,18,341,543,592,1135,"6 de julio de 1997"
5,3,18,342,594,593,1187,"6 de julio de 1997"
5,3,18,343,470,482,952,"6 de julio de 1997"
5,3,18,344,432,469,901,"6 de julio de 1997"
5,3,18,345,521,551,1072,"6 de julio de 1997"
5,3,18,346,369,370,739,"6 de julio de 1997"
5,3,18,347,575,595,1170,"6 de julio de 1997"
5,3,18,348,330,354,684,"6 de julio de 1997"
5,3,18,349,442,492,934,"6 de julio de 1997"
5,3,18,350,560,589,1149,"6 de julio de 1997"
5,3,18,351,722,761,1483,"6 de julio de 1997"
5,3,18,352,438,464,902,"6 de julio de 1997"
5,3,18,353,471,540,1011,"6 de julio de 1997"
5,3,18,354,263,268,531,"6 de julio de 1997"
5,3,18,355,531,524,1055,"6 de julio de 1997"
5,3,18,356,596,580,1176,"6 de julio de 1997"
5,3,18,357,630,668,1298,"6 de julio de 1997"
5,3,18,358,323,369,692,"6 de julio de 1997"
5,3,18,359,456,479,935,"6 de julio de 1997"
5,3,18,360,502,554,1056,"6 de julio de 1997"
5,3,18,361,598,615,1213,"6 de julio de 1997"
5,3,18,362,261,331,592,"6 de julio de 1997"
5,3,18,363,227,258,485,"6 de julio de 1997"
5,3,18,364,519,548,1067,"6 de julio de 1997"
5,3,18,365,306,346,652,"6 de julio de 1997"
5,3,18,366,223,217,440,"6 de julio de 1997"
5,3,18,367,464,470,934,"6 de julio de 1997"
5,3,18,368,409,450,859,"6 de julio de 1997"
5,3,18,369,585,603,1188,"6 de julio de 1997"
5,3,18,370,600,605,1205,"6 de julio de 1997"
5,3,18,371,521,503,1024,"6 de julio de 1997"
5,3,18,372,464,484,948,"6 de julio de 1997"
5,3,18,373,445,473,918,"6 de julio de 1997"
5,3,18,374,300,324,624,"6 de julio de 1997"
5,3,18,375,278,333,611,"6 de julio de 1997"
5,3,18,376,425,419,844,"6 de julio de 1997"
5,3,18,377,457,493,950,"6 de julio de 1997"
5,3,18,378,380,406,786,"6 de julio de 1997"
5,3,18,379,454,489,943,"6 de julio de 1997"
5,3,18,380,364,376,740,"6 de julio de 1997"
5,3,18,381,429,488,917,"6 de julio de 1997"
5,3,18,382,463,511,974,"6 de julio de 1997"
5,3,18,383,411,417,828,"6 de julio de 1997"
5,3,18,384,355,386,741,"6 de julio de 1997"
5,3,18,385,241,271,512,"6 de julio de 1997"
5,3,18,386,492,519,1011,"6 de julio de 1997"
5,3,18,387,648,667,1315,"6 de julio de 1997"
5,3,18,388,448,383,831,"6 de julio de 1997"
5,3,18,389,411,428,839,"6 de julio de 1997"
5,3,18,390,524,540,1064,"6 de julio de 1997"
5,3,18,391,388,394,782,"6 de julio de 1997"
5,3,18,392,485,539,1024,"6 de julio de 1997"
5,3,18,393,341,387,728,"6 de julio de 1997"
5,3,18,394,214,226,440,"6 de julio de 1997"
5,3,18,395,358,400,758,"6 de julio de 1997"
5,3,18,396,458,431,889,"6 de julio de 1997"
5,3,18,397,188,188,376,"6 de julio de 1997"
5,3,18,398,238,262,500,"6 de julio de 1997"
5,3,18,399,461,492,953,"6 de julio de 1997"
5,3,18,400,342,365,707,"6 de julio de 1997"
5,3,18,401,342,310,652,"6 de julio de 1997"
5,3,18,402,427,464,891,"6 de julio de 1997"
5,3,18,403,457,442,899,"6 de julio de 1997"
5,3,18,404,572,612,1184,"6 de julio de 1997"
5,3,18,405,567,542,1109,"6 de julio de 1997"
5,3,18,406,522,529,1051,"6 de julio de 1997"
5,3,18,407,433,457,890,"6 de julio de 1997"
5,3,18,408,514,540,1054,"6 de julio de 1997"
5,3,18,409,269,278,547,"6 de julio de 1997"
5,3,18,410,405,393,798,"6 de julio de 1997"
5,3,18,411,394,438,832,"6 de julio de 1997"
5,3,18,412,599,645,1244,"6 de julio de 1997"
5,3,18,413,592,633,1225,"6 de julio de 1997"
5,3,18,414,174,174,348,"6 de julio de 1997"
5,3,18,415,504,504,1008,"6 de julio de 1997"
5,3,18,416,595,626,1221,"6 de julio de 1997"
5,3,18,417,377,406,783,"6 de julio de 1997"
5,3,18,418,299,300,599,"6 de julio de 1997"
5,3,18,419,604,636,1240,"6 de julio de 1997"
5,3,18,420,426,453,879,"6 de julio de 1997"
5,3,18,421,142,141,283,"6 de julio de 1997"
5,3,18,422,482,529,1011,"6 de julio de 1997"
5,3,18,423,74,105,179,"6 de julio de 1997"
5,3,18,424,381,369,750,"6 de julio de 1997"
5,3,18,425,432,510,942,"6 de julio de 1997"
5,3,18,426,383,391,774,"6 de julio de 1997"
5,3,18,427,393,418,811,"6 de julio de 1997"
5,3,18,428,535,535,1070,"6 de julio de 1997"
5,3,18,429,629,664,1293,"6 de julio de 1997"
5,3,18,430,365,388,753,"6 de julio de 1997"
5,3,18,431,779,792,1571,"6 de julio de 1997"
5,3,18,432,392,431,823,"6 de julio de 1997"
5,3,18,433,405,423,828,"6 de julio de 1997"
5,3,18,434,651,670,1321,"6 de julio de 1997"
5,3,18,435,259,280,539,"6 de julio de 1997"
5,3,18,436,538,560,1098,"6 de julio de 1997"
5,3,18,437,448,468,916,"6 de julio de 1997"
5,3,18,438,286,301,587,"6 de julio de 1997"
5,3,18,439,398,409,807,"6 de julio de 1997"
5,3,18,440,202,223,425,"6 de julio de 1997"
5,3,18,441,308,311,619,"6 de julio de 1997"
5,3,18,442,96,90,186,"6 de julio de 1997"
5,3,18,443,38,26,64,"6 de julio de 1997"
5,3,26,645,86,122,208,"6 de julio de 1997"
5,3,26,646,86,126,212,"6 de julio de 1997"
5,3,26,647,232,181,413,"6 de julio de 1997"
5,3,26,648,176,184,360,"6 de julio de 1997"
5,3,26,649,245,203,448,"6 de julio de 1997"
5,3,26,650,167,177,344,"6 de julio de 1997"
5,3,26,651,48,37,85,"6 de julio de 1997"
5,3,28,691,292,284,576,"6 de julio de 1997"
5,3,28,692,687,765,1452,"6 de julio de 1997"
5,3,28,693,878,937,1815,"6 de julio de 1997"
5,3,28,694,591,718,1309,"6 de julio de 1997"
5,3,28,695,480,523,1003,"6 de julio de 1997"
5,3,28,696,520,593,1113,"6 de julio de 1997"
5,3,28,697,245,261,506,"6 de julio de 1997"
5,3,28,698,463,482,945,"6 de julio de 1997"
5,3,28,699,400,410,810,"6 de julio de 1997"
5,3,28,700,328,406,734,"6 de julio de 1997"
5,3,28,701,460,540,1000,"6 de julio de 1997"
5,3,28,702,528,658,1186,"6 de julio de 1997"
5,3,28,703,511,591,1102,"6 de julio de 1997"
5,3,28,704,221,237,458,"6 de julio de 1997"
5,3,28,705,337,404,741,"6 de julio de 1997"
5,3,28,706,420,428,848,"6 de julio de 1997"
5,3,28,707,444,476,920,"6 de julio de 1997"
5,3,28,708,455,501,956,"6 de julio de 1997"
5,3,28,709,552,612,1164,"6 de julio de 1997"
5,3,28,710,496,527,1023,"6 de julio de 1997"
5,3,28,711,566,615,1181,"6 de julio de 1997"
5,3,28,712,112,117,229,"6 de julio de 1997"
5,3,28,713,84,86,170,"6 de julio de 1997"
5,3,28,714,408,444,852,"6 de julio de 1997"
5,3,28,715,507,551,1058,"6 de julio de 1997"
5,3,28,716,89,66,155,"6 de julio de 1997"
5,3,28,717,294,313,607,"6 de julio de 1997"
5,3,28,718,246,258,504,"6 de julio de 1997"
5,3,28,719,256,284,540,"6 de julio de 1997"
5,3,28,720,214,236,450,"6 de julio de 1997"
5,3,28,721,341,375,716,"6 de julio de 1997"
5,3,28,722,391,391,782,"6 de julio de 1997"
5,3,28,723,572,602,1174,"6 de julio de 1997"
5,3,28,724,531,578,1109,"6 de julio de 1997"
5,3,28,725,366,412,778,"6 de julio de 1997"
5,3,28,726,203,239,442,"6 de julio de 1997"
5,3,28,727,73,68,141,"6 de julio de 1997"
5,3,31,1040,301,288,589,"6 de julio de 1997"
5,3,31,1041,485,477,962,"6 de julio de 1997"
5,3,31,1042,307,300,607,"6 de julio de 1997"
5,3,31,1043,417,433,850,"6 de julio de 1997"
5,3,31,1044,500,540,1040,"6 de julio de 1997"
5,3,31,1045,349,372,721,"6 de julio de 1997"
5,3,31,1046,443,431,874,"6 de julio de 1997"
5,3,31,1047,532,594,1126,"6 de julio de 1997"
5,3,31,1048,479,475,954,"6 de julio de 1997"
5,3,31,1049,312,374,686,"6 de julio de 1997"
5,3,31,1050,255,309,564,"6 de julio de 1997"
5,3,31,1051,324,340,664,"6 de julio de 1997"
5,3,31,1052,221,230,451,"6 de julio de 1997"
5,3,31,1053,36,29,65,"6 de julio de 1997"
5,3,31,1054,96,76,172,"6 de julio de 1997"
5,3,31,1055,173,174,347,"6 de julio de 1997"
5,3,31,1056,154,184,338,"6 de julio de 1997"
5,3,31,1057,185,144,329,"6 de julio de 1997"
5,3,32,1058,268,277,545,"6 de julio de 1997"
5,3,32,1059,223,224,447,"6 de julio de 1997"
5,3,32,1060,232,201,433,"6 de julio de 1997"
5,3,32,1061,484,549,1033,"6 de julio de 1997"
5,3,32,1062,253,275,528,"6 de julio de 1997"
5,3,32,1063,436,476,912,"6 de julio de 1997"
5,3,32,1064,641,691,1332,"6 de julio de 1997"
5,3,32,1065,271,284,555,"6 de julio de 1997"
5,3,32,1066,365,375,740,"6 de julio de 1997"
5,3,32,1067,497,548,1045,"6 de julio de 1997"
5,3,32,1068,525,593,1118,"6 de julio de 1997"
5,3,32,1069,118,125,243,"6 de julio de 1997"
5,3,32,1070,187,206,393,"6 de julio de 1997"
5,3,32,1071,611,668,1279,"6 de julio de 1997"
5,3,32,1072,489,566,1055,"6 de julio de 1997"
5,3,32,1073,567,636,1203,"6 de julio de 1997"
5,3,32,1074,382,355,737,"6 de julio de 1997"
5,3,32,1075,292,357,649,"6 de julio de 1997"
5,3,32,1076,588,634,1222,"6 de julio de 1997"
5,3,32,1077,331,358,689,"6 de julio de 1997"
5,3,32,1078,376,377,753,"6 de julio de 1997"
5,3,32,1079,479,527,1006,"6 de julio de 1997"
5,3,32,1080,362,439,801,"6 de julio de 1997"
5,3,32,1081,270,334,604,"6 de julio de 1997"
5,3,32,1082,416,437,853,"6 de julio de 1997"
5,3,32,1083,532,568,1100,"6 de julio de 1997"
5,3,32,1084,421,471,892,"6 de julio de 1997"
5,3,32,1085,332,392,724,"6 de julio de 1997"
5,3,32,1086,409,484,893,"6 de julio de 1997"
5,3,32,1087,309,347,656,"6 de julio de 1997"
5,3,32,1088,299,310,609,"6 de julio de 1997"
5,3,32,1089,146,182,328,"6 de julio de 1997"
5,3,32,1090,145,145,290,"6 de julio de 1997"
5,4,4,57,824,830,1654,"6 de julio de 1997"
5,4,4,58,221,206,427,"6 de julio de 1997"
5,4,4,59,595,588,1183,"6 de julio de 1997"
5,4,4,60,31,24,55,"6 de julio de 1997"
5,4,4,61,83,63,146,"6 de julio de 1997"
5,4,4,62,61,55,116,"6 de julio de 1997"
5,4,4,63,365,345,710,"6 de julio de 1997"
5,4,4,64,413,355,768,"6 de julio de 1997"
5,4,4,65,34,25,59,"6 de julio de 1997"
5,4,4,66,238,202,440,"6 de julio de 1997"
5,4,4,67,57,52,109,"6 de julio de 1997"
5,4,4,68,160,120,280,"6 de julio de 1997"
5,4,4,69,363,304,667,"6 de julio de 1997"
5,4,4,70,180,147,327,"6 de julio de 1997"
5,4,4,71,89,67,156,"6 de julio de 1997"
5,4,4,72,49,35,84,"6 de julio de 1997"
5,4,4,73,89,68,157,"6 de julio de 1997"
5,4,4,74,174,165,339,"6 de julio de 1997"
5,4,4,75,655,566,1221,"6 de julio de 1997"
5,4,4,76,60,59,119,"6 de julio de 1997"
5,4,4,77,81,54,135,"6 de julio de 1997"
5,4,4,78,335,304,639,"6 de julio de 1997"
5,4,4,79,479,405,884,"6 de julio de 1997"
5,4,4,80,128,95,223,"6 de julio de 1997"
5,4,11,214,427,355,782,"6 de julio de 1997"
5,4,11,215,364,331,695,"6 de julio de 1997"
5,4,11,216,453,439,892,"6 de julio de 1997"
5,4,11,217,302,226,528,"6 de julio de 1997"
5,4,11,218,152,155,307,"6 de julio de 1997"
5,4,11,219,57,40,97,"6 de julio de 1997"
5,4,11,220,185,127,312,"6 de julio de 1997"
5,4,11,221,30,34,64,"6 de julio de 1997"
5,4,11,222,266,219,485,"6 de julio de 1997"
5,4,11,223,238,200,438,"6 de julio de 1997"
5,4,11,224,38,29,67,"6 de julio de 1997"
5,4,11,225,207,167,374,"6 de julio de 1997"
5,4,11,226,126,91,217,"6 de julio de 1997"
5,4,11,227,186,156,342,"6 de julio de 1997"
5,4,11,228,154,112,266,"6 de julio de 1997"
5,4,11,229,161,117,278,"6 de julio de 1997"
5,4,11,230,100,80,180,"6 de julio de 1997"
5,4,11,231,274,234,508,"6 de julio de 1997"
5,4,11,232,28,19,47,"6 de julio de 1997"
5,4,24,542,356,312,668,"6 de julio de 1997"
5,4,24,543,747,824,1571,"6 de julio de 1997"
5,4,24,544,460,496,956,"6 de julio de 1997"
5,4,24,545,469,533,1002,"6 de julio de 1997"
5,4,24,546,450,425,875,"6 de julio de 1997"
5,4,24,547,500,530,1030,"6 de julio de 1997"
5,4,24,548,265,271,536,"6 de julio de 1997"
5,4,24,549,589,615,1204,"6 de julio de 1997"
5,4,24,550,702,808,1510,"6 de julio de 1997"
5,4,24,551,519,631,1150,"6 de julio de 1997"
5,4,24,552,302,311,613,"6 de julio de 1997"
5,4,24,553,341,348,689,"6 de julio de 1997"
5,4,24,554,436,504,940,"6 de julio de 1997"
5,4,24,555,306,374,680,"6 de julio de 1997"
5,4,24,556,394,454,848,"6 de julio de 1997"
5,4,24,557,563,593,1156,"6 de julio de 1997"
5,4,24,558,579,595,1174,"6 de julio de 1997"
5,4,24,559,260,265,525,"6 de julio de 1997"
5,4,24,560,175,142,317,"6 de julio de 1997"
5,4,24,561,66,50,116,"6 de julio de 1997"
5,4,24,562,118,103,221,"6 de julio de 1997"
5,4,24,563,162,121,283,"6 de julio de 1997"
5,4,24,564,187,159,346,"6 de julio de 1997"
5,4,24,565,302,226,528,"6 de julio de 1997"
5,4,24,566,380,286,666,"6 de julio de 1997"
5,4,24,567,409,360,769,"6 de julio de 1997"
5,4,24,568,187,148,335,"6 de julio de 1997"
5,4,24,569,281,209,490,"6 de julio de 1997"
5,4,24,570,151,123,274,"6 de julio de 1997"
5,4,24,571,390,312,702,"6 de julio de 1997"
5,4,24,572,41,21,62,"6 de julio de 1997"
5,4,24,573,341,241,582,"6 de julio de 1997"
5,4,24,574,183,154,337,"6 de julio de 1997"
5,4,24,575,243,209,452,"6 de julio de 1997"
5,4,24,576,61,28,89,"6 de julio de 1997"
5,4,27,652,378,400,778,"6 de julio de 1997"
5,4,27,653,264,267,531,"6 de julio de 1997"
5,4,27,654,568,563,1131,"6 de julio de 1997"
5,4,27,655,575,649,1224,"6 de julio de 1997"
5,4,27,656,296,317,613,"6 de julio de 1997"
5,4,27,657,517,549,1066,"6 de julio de 1997"
5,4,27,658,305,333,638,"6 de julio de 1997"
5,4,27,659,496,516,1012,"6 de julio de 1997"
5,4,27,660,506,496,1002,"6 de julio de 1997"
5,4,27,661,622,643,1265,"6 de julio de 1997"
5,4,27,662,323,340,663,"6 de julio de 1997"
5,4,27,663,691,696,1387,"6 de julio de 1997"
5,4,27,664,724,785,1509,"6 de julio de 1997"
5,4,27,665,103,66,169,"6 de julio de 1997"
5,4,27,666,136,103,239,"6 de julio de 1997"
5,4,27,667,146,110,256,"6 de julio de 1997"
5,4,27,668,41,38,79,"6 de julio de 1997"
5,4,27,669,180,130,310,"6 de julio de 1997"
5,4,27,670,104,76,180,"6 de julio de 1997"
5,4,27,671,184,149,333,"6 de julio de 1997"
5,4,27,672,43,40,83,"6 de julio de 1997"
5,4,27,673,370,350,720,"6 de julio de 1997"
5,4,27,674,82,61,143,"6 de julio de 1997"
5,4,27,675,51,29,80,"6 de julio de 1997"
5,4,27,676,218,179,397,"6 de julio de 1997"
5,4,27,677,178,162,340,"6 de julio de 1997"
5,4,27,678,52,43,95,"6 de julio de 1997"
5,4,27,679,68,46,114,"6 de julio de 1997"
5,4,27,680,43,46,89,"6 de julio de 1997"
5,4,27,681,94,67,161,"6 de julio de 1997"
5,4,27,682,47,37,84,"6 de julio de 1997"
5,4,27,683,74,69,143,"6 de julio de 1997"
5,4,27,684,124,108,232,"6 de julio de 1997"
5,4,27,685,127,104,231,"6 de julio de 1997"
5,4,27,686,160,159,319,"6 de julio de 1997"
5,4,27,687,55,49,104,"6 de julio de 1997"
5,4,27,688,98,78,176,"6 de julio de 1997"
5,4,27,689,115,79,194,"6 de julio de 1997"
5,4,27,690,57,44,101,"6 de julio de 1997"
5,4,30,730,415,451,866,"6 de julio de 1997"
5,4,30,731,305,341,646,"6 de julio de 1997"
5,4,30,732,423,435,858,"6 de julio de 1997"
5,4,30,733,585,663,1248,"6 de julio de 1997"
5,4,30,734,444,469,913,"6 de julio de 1997"
5,4,30,735,432,478,910,"6 de julio de 1997"
5,4,30,736,526,580,1106,"6 de julio de 1997"
5,4,30,737,509,576,1085,"6 de julio de 1997"
5,4,30,738,472,451,923,"6 de julio de 1997"
5,4,30,739,612,676,1288,"6 de julio de 1997"
5,4,30,740,554,613,1167,"6 de julio de 1997"
5,4,30,741,412,460,872,"6 de julio de 1997"
5,4,30,742,627,664,1291,"6 de julio de 1997"
5,4,30,744,485,519,1004,"6 de julio de 1997"
5,4,30,745,352,407,759,"6 de julio de 1997"
5,4,30,746,405,428,833,"6 de julio de 1997"
5,4,30,747,458,469,927,"6 de julio de 1997"
5,4,30,748,568,641,1209,"6 de julio de 1997"
5,4,30,749,378,414,792,"6 de julio de 1997"
5,4,30,750,564,657,1221,"6 de julio de 1997"
5,4,30,751,587,663,1250,"6 de julio de 1997"
5,4,30,752,536,553,1089,"6 de julio de 1997"
5,4,30,753,537,558,1095,"6 de julio de 1997"
5,4,30,754,416,473,889,"6 de julio de 1997"
5,4,30,755,225,242,467,"6 de julio de 1997"
5,4,30,756,457,495,952,"6 de julio de 1997"
5,4,30,757,624,676,1300,"6 de julio de 1997"
5,4,30,758,471,504,975,"6 de julio de 1997"
5,4,30,759,552,621,1173,"6 de julio de 1997"
5,4,30,760,307,341,648,"6 de julio de 1997"
5,4,30,761,476,506,982,"6 de julio de 1997"
5,4,30,762,355,403,758,"6 de julio de 1997"
5,4,30,763,617,725,1342,"6 de julio de 1997"
5,4,30,764,588,636,1224,"6 de julio de 1997"
5,4,30,765,462,491,953,"6 de julio de 1997"
5,4,30,766,451,479,930,"6 de julio de 1997"
5,4,30,772,343,352,695,"6 de julio de 1997"
5,4,30,773,381,424,805,"6 de julio de 1997"
5,4,30,774,531,592,1123,"6 de julio de 1997"
5,4,30,775,468,479,947,"6 de julio de 1997"
5,4,30,776,419,427,846,"6 de julio de 1997"
5,4,30,777,447,481,928,"6 de julio de 1997"
5,4,30,778,469,504,973,"6 de julio de 1997"
5,4,30,779,573,646,1219,"6 de julio de 1997"
5,4,30,780,404,450,854,"6 de julio de 1997"
5,4,30,781,417,508,925,"6 de julio de 1997"
5,4,30,782,436,534,970,"6 de julio de 1997"
5,4,30,799,344,404,748,"6 de julio de 1997"
5,4,30,800,564,640,1204,"6 de julio de 1997"
5,4,30,801,420,463,883,"6 de julio de 1997"
5,4,30,802,274,291,565,"6 de julio de 1997"
5,4,30,803,450,471,921,"6 de julio de 1997"
5,4,30,804,594,556,1150,"6 de julio de 1997"
5,4,30,805,482,515,997,"6 de julio de 1997"
5,4,30,806,241,268,509,"6 de julio de 1997"
5,4,30,807,514,535,1049,"6 de julio de 1997"
5,4,30,828,549,617,1166,"6 de julio de 1997"
5,4,30,829,615,625,1240,"6 de julio de 1997"
5,4,30,830,786,840,1626,"6 de julio de 1997"
5,4,30,831,500,514,1014,"6 de julio de 1997"
5,4,30,832,517,595,1112,"6 de julio de 1997"
5,4,30,833,489,539,1028,"6 de julio de 1997"
5,4,30,834,170,200,370,"6 de julio de 1997"
5,4,30,835,594,628,1222,"6 de julio de 1997"
5,4,30,836,648,795,1443,"6 de julio de 1997"
5,4,30,837,431,497,928,"6 de julio de 1997"
5,4,30,838,501,523,1024,"6 de julio de 1997"
5,4,30,839,404,459,863,"6 de julio de 1997"
5,4,30,840,354,394,748,"6 de julio de 1997"
5,4,30,862,488,536,1024,"6 de julio de 1997"
5,4,30,863,799,831,1630,"6 de julio de 1997"
5,4,30,864,811,815,1626,"6 de julio de 1997"
5,4,30,865,675,771,1446,"6 de julio de 1997"
5,4,30,866,462,508,970,"6 de julio de 1997"
5,4,30,867,588,630,1218,"6 de julio de 1997"
5,4,30,868,738,727,1465,"6 de julio de 1997"
5,4,30,869,557,568,1125,"6 de julio de 1997"
5,4,30,870,307,346,653,"6 de julio de 1997"
5,4,30,871,431,482,913,"6 de julio de 1997"
5,4,30,872,652,696,1348,"6 de julio de 1997"
5,4,30,873,544,603,1147,"6 de julio de 1997"
5,4,30,874,300,333,633,"6 de julio de 1997"
5,4,30,898,421,515,936,"6 de julio de 1997"
5,4,30,899,441,533,974,"6 de julio de 1997"
5,4,30,900,267,278,545,"6 de julio de 1997"
5,4,30,901,227,275,502,"6 de julio de 1997"
5,4,30,902,555,636,1191,"6 de julio de 1997"
5,4,30,903,548,561,1109,"6 de julio de 1997"
5,4,30,904,407,403,810,"6 de julio de 1997"
5,4,30,905,641,710,1351,"6 de julio de 1997"
5,4,30,906,409,474,883,"6 de julio de 1997"
5,4,30,907,1130,1377,2507,"6 de julio de 1997"
5,4,30,908,315,353,668,"6 de julio de 1997"
5,4,30,909,322,367,689,"6 de julio de 1997"
5,4,30,910,423,500,923,"6 de julio de 1997"
5,4,30,911,559,601,1160,"6 de julio de 1997"
5,4,30,912,477,548,1025,"6 de julio de 1997"
5,4,30,913,479,556,1035,"6 de julio de 1997"
5,4,30,939,355,425,780,"6 de julio de 1997"
5,4,30,941,542,637,1179,"6 de julio de 1997"
5,4,30,942,563,611,1174,"6 de julio de 1997"
5,4,30,944,264,288,552,"6 de julio de 1997"
5,4,30,945,302,354,656,"6 de julio de 1997"
5,4,30,946,311,380,691,"6 de julio de 1997"
5,4,30,947,284,338,622,"6 de julio de 1997"
5,4,30,948,337,415,752,"6 de julio de 1997"
5,4,30,949,656,696,1352,"6 de julio de 1997"
5,4,30,950,476,526,1002,"6 de julio de 1997"
5,4,30,951,318,355,673,"6 de julio de 1997"
5,5,17,257,384,389,773,"6 de julio de 1997"
5,5,17,258,592,607,1199,"6 de julio de 1997"
5,5,17,259,545,556,1101,"6 de julio de 1997"
5,5,17,260,568,628,1196,"6 de julio de 1997"
5,5,17,261,586,666,1252,"6 de julio de 1997"
5,5,17,262,764,799,1563,"6 de julio de 1997"
5,5,17,263,656,714,1370,"6 de julio de 1997"
5,5,17,264,429,459,888,"6 de julio de 1997"
5,5,17,265,533,592,1125,"6 de julio de 1997"
5,5,17,266,558,678,1236,"6 de julio de 1997"
5,5,17,267,522,610,1132,"6 de julio de 1997"
5,5,17,268,203,250,453,"6 de julio de 1997"
5,5,17,269,837,896,1733,"6 de julio de 1997"
5,5,17,270,433,493,926,"6 de julio de 1997"
5,5,17,271,738,842,1580,"6 de julio de 1997"
5,5,17,272,709,777,1486,"6 de julio de 1997"
5,5,17,273,461,500,961,"6 de julio de 1997"
5,5,17,274,566,627,1193,"6 de julio de 1997"
5,5,17,275,345,366,711,"6 de julio de 1997"
5,5,17,276,382,431,813,"6 de julio de 1997"
5,5,17,277,245,244,489,"6 de julio de 1997"
5,5,17,278,277,236,513,"6 de julio de 1997"
5,5,17,279,339,362,701,"6 de julio de 1997"
5,5,17,280,627,712,1339,"6 de julio de 1997"
5,5,17,281,229,242,471,"6 de julio de 1997"
5,5,17,282,320,329,649,"6 de julio de 1997"
5,5,17,283,410,409,819,"6 de julio de 1997"
5,5,17,284,415,475,890,"6 de julio de 1997"
5,5,17,285,494,482,976,"6 de julio de 1997"
5,5,17,286,488,495,983,"6 de julio de 1997"
5,5,17,287,643,662,1305,"6 de julio de 1997"
5,5,17,288,536,628,1164,"6 de julio de 1997"
5,5,17,289,336,327,663,"6 de julio de 1997"
5,5,17,290,594,609,1203,"6 de julio de 1997"
5,5,17,291,550,537,1087,"6 de julio de 1997"
5,5,17,292,222,230,452,"6 de julio de 1997"
5,5,17,293,431,429,860,"6 de julio de 1997"
5,5,17,294,322,383,705,"6 de julio de 1997"
5,5,17,295,205,163,368,"6 de julio de 1997"
5,5,17,296,349,300,649,"6 de julio de 1997"
5,5,17,297,587,577,1164,"6 de julio de 1997"
5,5,17,298,399,381,780,"6 de julio de 1997"
5,5,17,299,187,177,364,"6 de julio de 1997"
5,5,17,300,203,207,410,"6 de julio de 1997"
5,5,17,301,229,224,453,"6 de julio de 1997"
5,5,17,302,252,256,508,"6 de julio de 1997"
5,5,17,303,340,371,711,"6 de julio de 1997"
5,5,17,304,371,389,760,"6 de julio de 1997"
5,5,17,305,798,836,1634,"6 de julio de 1997"
5,5,17,306,645,652,1297,"6 de julio de 1997"
5,5,17,307,399,386,785,"6 de julio de 1997"
5,5,17,308,323,373,696,"6 de julio de 1997"
5,5,17,309,181,163,344,"6 de julio de 1997"
5,5,17,310,376,367,743,"6 de julio de 1997"
5,5,17,311,213,193,406,"6 de julio de 1997"
5,5,17,312,533,576,1109,"6 de julio de 1997"
5,5,17,313,190,183,373,"6 de julio de 1997"
5,5,17,314,352,335,687,"6 de julio de 1997"
5,5,17,315,157,155,312,"6 de julio de 1997"
5,5,17,316,79,88,167,"6 de julio de 1997"
5,5,17,317,93,95,188,"6 de julio de 1997"
5,5,17,318,358,368,726,"6 de julio de 1997"
5,5,35,1172,244,259,503,"6 de julio de 1997"
5,5,35,1173,366,421,787,"6 de julio de 1997"
5,5,35,1174,280,271,551,"6 de julio de 1997"
5,5,35,1175,273,305,578,"6 de julio de 1997"
5,5,35,1176,426,416,842,"6 de julio de 1997"
5,5,35,1177,301,322,623,"6 de julio de 1997"
5,5,35,1178,339,378,717,"6 de julio de 1997"
5,5,35,1179,491,542,1033,"6 de julio de 1997"
5,5,35,1181,324,392,716,"6 de julio de 1997"
5,5,35,1182,336,445,781,"6 de julio de 1997"
5,5,35,1183,253,263,516,"6 de julio de 1997"
5,5,35,1184,418,471,889,"6 de julio de 1997"
5,5,35,1310,198,231,429,"6 de julio de 1997"
5,5,35,1311,525,524,1049,"6 de julio de 1997"
5,5,35,1312,444,488,932,"6 de julio de 1997"
5,5,35,1313,493,558,1051,"6 de julio de 1997"
5,5,35,1314,433,474,907,"6 de julio de 1997"
5,5,35,1315,482,547,1029,"6 de julio de 1997"
5,5,35,1316,415,441,856,"6 de julio de 1997"
5,5,35,1317,506,529,1035,"6 de julio de 1997"
5,5,35,1318,504,547,1051,"6 de julio de 1997"
5,5,35,1319,419,476,895,"6 de julio de 1997"
5,5,35,1320,670,707,1377,"6 de julio de 1997"
5,5,35,1321,317,349,666,"6 de julio de 1997"
5,5,35,1322,614,663,1277,"6 de julio de 1997"
5,5,35,1323,589,701,1290,"6 de julio de 1997"
5,5,35,1324,502,595,1097,"6 de julio de 1997"
5,5,35,1347,473,515,988,"6 de julio de 1997"
5,5,35,1348,461,515,976,"6 de julio de 1997"
5,5,35,1349,506,551,1057,"6 de julio de 1997"
5,5,35,1350,2341,2788,5129,"6 de julio de 1997"
5,5,35,1351,605,661,1266,"6 de julio de 1997"
5,5,35,1352,203,235,438,"6 de julio de 1997"
5,5,35,1353,390,438,828,"6 de julio de 1997"
5,5,35,1354,1223,1095,2318,"6 de julio de 1997"
5,5,35,1355,525,589,1114,"6 de julio de 1997"
5,5,35,1356,385,461,846,"6 de julio de 1997"
5,5,35,1357,313,363,676,"6 de julio de 1997"
5,5,35,1358,443,482,925,"6 de julio de 1997"
5,5,35,1359,389,413,802,"6 de julio de 1997"
5,5,35,1360,1349,1469,2818,"6 de julio de 1997"
5,5,35,1361,506,555,1061,"6 de julio de 1997"
5,5,35,1362,499,590,1089,"6 de julio de 1997"
5,5,35,1363,546,584,1130,"6 de julio de 1997"
5,5,35,1364,351,438,789,"6 de julio de 1997"
5,5,35,1365,1800,2019,3819,"6 de julio de 1997"
5,5,35,1366,383,466,849,"6 de julio de 1997"
5,5,35,1382,838,950,1788,"6 de julio de 1997"
5,5,35,1383,500,537,1037,"6 de julio de 1997"
5,5,35,1384,679,783,1462,"6 de julio de 1997"
5,5,35,1385,267,329,596,"6 de julio de 1997"
5,5,35,1386,362,384,746,"6 de julio de 1997"
5,5,35,1387,460,512,972,"6 de julio de 1997"
5,5,35,1388,894,1056,1950,"6 de julio de 1997"
5,5,35,1389,320,353,673,"6 de julio de 1997"
5,5,35,1390,538,585,1123,"6 de julio de 1997"
5,5,35,1391,495,615,1110,"6 de julio de 1997"
5,5,35,1392,467,539,1006,"6 de julio de 1997"
5,5,35,1402,548,628,1176,"6 de julio de 1997"
5,5,35,1403,494,539,1033,"6 de julio de 1997"
5,5,35,1404,385,458,843,"6 de julio de 1997"
5,5,35,1405,398,427,825,"6 de julio de 1997"
5,5,35,1406,397,463,860,"6 de julio de 1997"
5,5,35,1407,608,703,1311,"6 de julio de 1997"
5,5,35,1408,366,421,787,"6 de julio de 1997"
5,5,35,1409,1196,1305,2501,"6 de julio de 1997"
5,5,35,1410,580,575,1155,"6 de julio de 1997"
5,5,35,1411,886,1036,1922,"6 de julio de 1997"
5,5,35,1412,395,406,801,"6 de julio de 1997"
5,5,35,1413,405,458,863,"6 de julio de 1997"
5,5,35,1414,474,535,1009,"6 de julio de 1997"
5,5,35,1415,451,473,924,"6 de julio de 1997"
5,5,35,1416,368,428,796,"6 de julio de 1997"
5,5,35,1417,352,417,769,"6 de julio de 1997"
5,5,35,1418,458,548,1006,"6 de julio de 1997"
5,5,35,1419,345,437,782,"6 de julio de 1997"
5,5,35,1420,460,560,1020,"6 de julio de 1997"
5,5,35,1421,414,479,893,"6 de julio de 1997"
5,5,35,1422,394,461,855,"6 de julio de 1997"
5,5,35,1423,421,472,893,"6 de julio de 1997"
5,5,35,1424,451,492,943,"6 de julio de 1997"
5,5,35,1425,497,546,1043,"6 de julio de 1997"
5,5,35,1426,584,580,1164,"6 de julio de 1997"
5,5,35,1427,513,522,1035,"6 de julio de 1997"
5,5,35,1428,508,604,1112,"6 de julio de 1997"
5,5,35,1436,88,106,194,"6 de julio de 1997"
5,5,35,1440,458,497,955,"6 de julio de 1997"
5,5,35,1441,377,426,803,"6 de julio de 1997"
5,5,35,1442,681,776,1457,"6 de julio de 1997"
5,5,35,1443,435,458,893,"6 de julio de 1997"
5,5,35,1444,503,568,1071,"6 de julio de 1997"
5,5,35,1445,703,740,1443,"6 de julio de 1997"
5,5,35,1446,452,489,941,"6 de julio de 1997"
5,5,35,1447,349,399,748,"6 de julio de 1997"
5,5,35,1448,292,370,662,"6 de julio de 1997"
5,5,35,1449,446,486,932,"6 de julio de 1997"
5,5,35,1450,304,353,657,"6 de julio de 1997"
5,5,35,1451,481,552,1033,"6 de julio de 1997"
5,5,35,1452,391,453,844,"6 de julio de 1997"
5,5,35,1453,404,424,828,"6 de julio de 1997"
5,5,35,1454,378,411,789,"6 de julio de 1997"
5,5,35,1455,333,398,731,"6 de julio de 1997"
5,5,35,1456,454,516,970,"6 de julio de 1997"
5,5,35,1458,271,275,546,"6 de julio de 1997"
5,5,35,1459,571,583,1154,"6 de julio de 1997"
5,5,35,1460,647,658,1305,"6 de julio de 1997"
5,5,35,1461,691,687,1378,"6 de julio de 1997"
5,5,35,1462,783,770,1553,"6 de julio de 1997"
5,5,35,1463,610,678,1288,"6 de julio de 1997"
5,5,35,1464,541,547,1088,"6 de julio de 1997"
5,5,35,1465,635,678,1313,"6 de julio de 1997"
5,5,35,1466,398,488,886,"6 de julio de 1997"
5,5,35,1467,587,626,1213,"6 de julio de 1997"
5,5,35,1468,286,322,608,"6 de julio de 1997"
5,5,35,1469,718,713,1431,"6 de julio de 1997"
5,5,35,1470,484,476,960,"6 de julio de 1997"
5,5,35,1471,175,171,346,"6 de julio de 1997"
5,5,35,1472,183,190,373,"6 de julio de 1997"
5,5,35,1473,245,265,510,"6 de julio de 1997"
5,5,35,1474,106,103,209,"6 de julio de 1997"
5,5,36,1475,469,482,951,"6 de julio de 1997"
5,5,36,1476,669,630,1299,"6 de julio de 1997"
5,5,36,1477,140,112,252,"6 de julio de 1997"
5,5,36,1478,219,240,459,"6 de julio de 1997"
5,5,36,1479,267,240,507,"6 de julio de 1997"
5,5,36,1480,129,123,252,"6 de julio de 1997"
5,5,36,1481,139,127,266,"6 de julio de 1997"
5,5,36,1482,183,176,359,"6 de julio de 1997"
5,5,36,1483,166,175,341,"6 de julio de 1997"
5,5,36,1484,311,320,631,"6 de julio de 1997"
5,5,36,1485,359,362,721,"6 de julio de 1997"
5,5,36,1486,181,150,331,"6 de julio de 1997"
5,5,36,1487,22,15,37,"6 de julio de 1997"
5,5,36,1488,82,53,135,"6 de julio de 1997"
5,5,36,1489,328,309,637,"6 de julio de 1997"
5,5,36,1490,579,569,1148,"6 de julio de 1997"
5,5,36,1491,591,594,1185,"6 de julio de 1997"
5,5,36,1492,362,384,746,"6 de julio de 1997"
5,5,36,1493,333,332,665,"6 de julio de 1997"
5,5,36,1494,83,43,126,"6 de julio de 1997"
5,5,36,1495,76,61,137,"6 de julio de 1997"
5,5,36,1496,82,77,159,"6 de julio de 1997"
5,5,36,1497,182,159,341,"6 de julio de 1997"
5,6,35,1180,394,465,859,"6 de julio de 1997"
5,6,35,1185,623,678,1301,"6 de julio de 1997"
5,6,35,1186,272,316,588,"6 de julio de 1997"
5,6,35,1187,446,560,1006,"6 de julio de 1997"
5,6,35,1188,394,445,839,"6 de julio de 1997"
5,6,35,1189,581,635,1216,"6 de julio de 1997"
5,6,35,1190,595,631,1226,"6 de julio de 1997"
5,6,35,1191,375,429,804,"6 de julio de 1997"
5,6,35,1192,503,591,1094,"6 de julio de 1997"
5,6,35,1193,413,476,889,"6 de julio de 1997"
5,6,35,1194,529,621,1150,"6 de julio de 1997"
5,6,35,1195,599,650,1249,"6 de julio de 1997"
5,6,35,1196,651,703,1354,"6 de julio de 1997"
5,6,35,1197,720,796,1516,"6 de julio de 1997"
5,6,35,1198,530,641,1171,"6 de julio de 1997"
5,6,35,1199,441,516,957,"6 de julio de 1997"
5,6,35,1200,561,596,1157,"6 de julio de 1997"
5,6,35,1201,517,597,1114,"6 de julio de 1997"
5,6,35,1202,564,604,1168,"6 de julio de 1997"
5,6,35,1203,463,488,951,"6 de julio de 1997"
5,6,35,1204,525,597,1122,"6 de julio de 1997"
5,6,35,1205,488,564,1052,"6 de julio de 1997"
5,6,35,1206,524,624,1148,"6 de julio de 1997"
5,6,35,1207,654,713,1367,"6 de julio de 1997"
5,6,35,1208,567,609,1176,"6 de julio de 1997"
5,6,35,1209,655,816,1471,"6 de julio de 1997"
5,6,35,1210,686,809,1495,"6 de julio de 1997"
5,6,35,1211,420,467,887,"6 de julio de 1997"
5,6,35,1212,426,437,863,"6 de julio de 1997"
5,6,35,1213,672,773,1445,"6 de julio de 1997"
5,6,35,1214,834,837,1671,"6 de julio de 1997"
5,6,35,1215,608,716,1324,"6 de julio de 1997"
5,6,35,1216,411,488,899,"6 de julio de 1997"
5,6,35,1217,309,353,662,"6 de julio de 1997"
5,6,35,1218,648,761,1409,"6 de julio de 1997"
5,6,35,1219,470,550,1020,"6 de julio de 1997"
5,6,35,1220,576,737,1313,"6 de julio de 1997"
5,6,35,1221,581,661,1242,"6 de julio de 1997"
5,6,35,1222,464,631,1095,"6 de julio de 1997"
5,6,35,1223,423,554,977,"6 de julio de 1997"
5,6,35,1224,566,674,1240,"6 de julio de 1997"
5,6,35,1225,407,462,869,"6 de julio de 1997"
5,6,35,1226,339,447,786,"6 de julio de 1997"
5,6,35,1227,591,635,1226,"6 de julio de 1997"
5,6,35,1228,486,617,1103,"6 de julio de 1997"
5,6,35,1229,341,442,783,"6 de julio de 1997"
5,6,35,1230,410,482,892,"6 de julio de 1997"
5,6,35,1231,300,362,662,"6 de julio de 1997"
5,6,35,1232,487,608,1095,"6 de julio de 1997"
5,6,35,1233,514,639,1153,"6 de julio de 1997"
5,6,35,1234,431,518,949,"6 de julio de 1997"
5,6,35,1235,356,436,792,"6 de julio de 1997"
5,6,35,1236,338,392,730,"6 de julio de 1997"
5,6,35,1237,331,402,733,"6 de julio de 1997"
5,6,35,1238,312,386,698,"6 de julio de 1997"
5,6,35,1239,363,489,852,"6 de julio de 1997"
5,6,35,1240,477,532,1009,"6 de julio de 1997"
5,6,35,1241,359,497,856,"6 de julio de 1997"
5,6,35,1242,418,508,926,"6 de julio de 1997"
5,6,35,1243,324,397,721,"6 de julio de 1997"
5,6,35,1244,281,369,650,"6 de julio de 1997"
5,6,35,1245,398,508,906,"6 de julio de 1997"
5,6,35,1246,347,411,758,"6 de julio de 1997"
5,6,35,1247,517,614,1131,"6 de julio de 1997"
5,6,35,1248,604,663,1267,"6 de julio de 1997"
5,6,35,1249,392,470,862,"6 de julio de 1997"
5,6,35,1250,446,487,933,"6 de julio de 1997"
5,6,35,1251,345,359,704,"6 de julio de 1997"
5,6,35,1252,441,548,989,"6 de julio de 1997"
5,6,35,1253,526,619,1145,"6 de julio de 1997"
5,6,35,1254,550,663,1213,"6 de julio de 1997"
5,6,35,1255,344,489,833,"6 de julio de 1997"
5,6,35,1256,390,451,841,"6 de julio de 1997"
5,6,35,1257,667,735,1402,"6 de julio de 1997"
5,6,35,1258,618,637,1255,"6 de julio de 1997"
5,6,35,1259,606,651,1257,"6 de julio de 1997"
5,6,35,1260,678,676,1354,"6 de julio de 1997"
5,6,35,1261,678,706,1384,"6 de julio de 1997"
5,6,35,1262,404,401,805,"6 de julio de 1997"
5,6,35,1263,393,452,845,"6 de julio de 1997"
5,6,35,1264,616,697,1313,"6 de julio de 1997"
5,6,35,1265,373,423,796,"6 de julio de 1997"
5,6,35,1266,787,799,1586,"6 de julio de 1997"
5,6,35,1267,684,718,1402,"6 de julio de 1997"
5,6,35,1268,302,366,668,"6 de julio de 1997"
5,6,35,1269,600,636,1236,"6 de julio de 1997"
5,6,35,1270,362,361,723,"6 de julio de 1997"
5,6,35,1271,666,661,1327,"6 de julio de 1997"
5,6,35,1272,458,535,993,"6 de julio de 1997"
5,6,35,1273,444,481,925,"6 de julio de 1997"
5,6,35,1274,490,539,1029,"6 de julio de 1997"
5,6,35,1275,513,586,1099,"6 de julio de 1997"
5,6,35,1276,706,748,1454,"6 de julio de 1997"
5,6,35,1277,700,799,1499,"6 de julio de 1997"
5,6,35,1278,452,491,943,"6 de julio de 1997"
5,6,35,1279,332,398,730,"6 de julio de 1997"
5,6,35,1280,316,329,645,"6 de julio de 1997"
5,6,35,1281,297,314,611,"6 de julio de 1997"
5,6,35,1282,275,343,618,"6 de julio de 1997"
5,6,35,1283,544,669,1213,"6 de julio de 1997"
5,6,35,1284,371,381,752,"6 de julio de 1997"
5,6,35,1285,546,546,1092,"6 de julio de 1997"
5,6,35,1286,293,324,617,"6 de julio de 1997"
5,6,35,1287,470,527,997,"6 de julio de 1997"
5,6,35,1288,192,170,362,"6 de julio de 1997"
5,6,35,1289,308,286,594,"6 de julio de 1997"
5,6,35,1290,265,312,577,"6 de julio de 1997"
5,6,35,1291,530,576,1106,"6 de julio de 1997"
5,6,35,1292,331,327,658,"6 de julio de 1997"
5,6,35,1293,241,253,494,"6 de julio de 1997"
5,6,35,1294,340,365,705,"6 de julio de 1997"
5,6,35,1295,313,335,648,"6 de julio de 1997"
5,6,35,1296,433,458,891,"6 de julio de 1997"
5,6,35,1297,255,302,557,"6 de julio de 1997"
5,6,35,1298,421,417,838,"6 de julio de 1997"
5,6,35,1299,352,337,689,"6 de julio de 1997"
5,6,35,1300,446,503,949,"6 de julio de 1997"
5,6,35,1301,372,439,811,"6 de julio de 1997"
5,6,35,1302,406,446,852,"6 de julio de 1997"
5,6,35,1303,317,354,671,"6 de julio de 1997"
5,6,35,1304,284,318,602,"6 de julio de 1997"
5,6,35,1305,191,195,386,"6 de julio de 1997"
5,6,35,1306,419,461,880,"6 de julio de 1997"
5,6,35,1307,367,429,796,"6 de julio de 1997"
5,6,35,1308,313,382,695,"6 de julio de 1997"
5,6,35,1309,406,389,795,"6 de julio de 1997"
5,6,35,1325,520,570,1090,"6 de julio de 1997"
5,6,35,1326,545,626,1171,"6 de julio de 1997"
5,6,35,1327,596,641,1237,"6 de julio de 1997"
5,6,35,1328,494,567,1061,"6 de julio de 1997"
5,6,35,1329,725,766,1491,"6 de julio de 1997"
5,6,35,1330,543,581,1124,"6 de julio de 1997"
5,6,35,1331,499,593,1092,"6 de julio de 1997"
5,6,35,1332,538,625,1163,"6 de julio de 1997"
5,6,35,1333,475,586,1061,"6 de julio de 1997"
5,6,35,1334,449,524,973,"6 de julio de 1997"
5,6,35,1335,271,318,589,"6 de julio de 1997"
5,6,35,1336,606,634,1240,"6 de julio de 1997"
5,6,35,1337,488,530,1018,"6 de julio de 1997"
5,6,35,1338,577,667,1244,"6 de julio de 1997"
5,6,35,1339,598,647,1245,"6 de julio de 1997"
5,6,35,1340,517,573,1090,"6 de julio de 1997"
5,6,35,1341,479,564,1043,"6 de julio de 1997"
5,6,35,1342,580,663,1243,"6 de julio de 1997"
5,6,35,1343,795,873,1668,"6 de julio de 1997"
5,6,35,1344,410,446,856,"6 de julio de 1997"
5,6,35,1345,618,697,1315,"6 de julio de 1997"
5,6,35,1346,541,642,1183,"6 de julio de 1997"
5,6,35,1367,623,731,1354,"6 de julio de 1997"
5,6,35,1368,643,704,1347,"6 de julio de 1997"
5,6,35,1369,449,561,1010,"6 de julio de 1997"
5,6,35,1370,257,340,597,"6 de julio de 1997"
5,6,35,1371,396,472,868,"6 de julio de 1997"
5,6,35,1372,415,471,886,"6 de julio de 1997"
5,6,35,1373,508,616,1124,"6 de julio de 1997"
5,6,35,1374,555,695,1250,"6 de julio de 1997"
5,6,35,1375,473,536,1009,"6 de julio de 1997"
5,6,35,1376,441,560,1001,"6 de julio de 1997"
5,6,35,1377,594,716,1310,"6 de julio de 1997"
5,6,35,1378,444,522,966,"6 de julio de 1997"
5,6,35,1379,324,425,749,"6 de julio de 1997"
5,6,35,1380,568,686,1254,"6 de julio de 1997"
5,6,35,1381,481,577,1058,"6 de julio de 1997"
5,6,35,1393,595,694,1289,"6 de julio de 1997"
5,6,35,1394,317,386,703,"6 de julio de 1997"
5,6,35,1395,526,671,1197,"6 de julio de 1997"
5,6,35,1396,316,369,685,"6 de julio de 1997"
5,6,35,1397,569,659,1228,"6 de julio de 1997"
5,6,35,1398,691,811,1502,"6 de julio de 1997"
5,6,35,1399,502,620,1122,"6 de julio de 1997"
5,6,35,1400,392,506,898,"6 de julio de 1997"
5,6,35,1401,425,511,936,"6 de julio de 1997"
5,6,35,1429,522,595,1117,"6 de julio de 1997"
5,6,35,1430,544,653,1197,"6 de julio de 1997"
5,6,35,1431,462,504,966,"6 de julio de 1997"
5,6,35,1432,555,602,1157,"6 de julio de 1997"
5,6,35,1433,592,685,1277,"6 de julio de 1997"
5,6,35,1434,560,596,1156,"6 de julio de 1997"
5,6,35,1435,429,452,881,"6 de julio de 1997"
5,6,35,1437,393,409,802,"6 de julio de 1997"
5,6,35,1438,519,541,1060,"6 de julio de 1997"
5,6,35,1439,551,560,1111,"6 de julio de 1997"
5,6,35,1457,248,277,525,"6 de julio de 1997"
5,7,30,743,597,714,1311,"6 de julio de 1997"
5,7,30,767,390,405,795,"6 de julio de 1997"
5,7,30,768,830,857,1687,"6 de julio de 1997"
5,7,30,769,497,498,995,"6 de julio de 1997"
5,7,30,770,372,426,798,"6 de julio de 1997"
5,7,30,771,515,534,1049,"6 de julio de 1997"
5,7,30,783,514,632,1146,"6 de julio de 1997"
5,7,30,784,407,489,896,"6 de julio de 1997"
5,7,30,785,322,380,702,"6 de julio de 1997"
5,7,30,786,419,517,936,"6 de julio de 1997"
5,7,30,787,528,570,1098,"6 de julio de 1997"
5,7,30,788,460,556,1016,"6 de julio de 1997"
5,7,30,789,356,400,756,"6 de julio de 1997"
5,7,30,790,415,496,911,"6 de julio de 1997"
5,7,30,791,429,434,863,"6 de julio de 1997"
5,7,30,792,606,655,1261,"6 de julio de 1997"
5,7,30,793,383,419,802,"6 de julio de 1997"
5,7,30,794,523,527,1050,"6 de julio de 1997"
5,7,30,795,645,716,1361,"6 de julio de 1997"
5,7,30,796,725,847,1572,"6 de julio de 1997"
5,7,30,797,380,432,812,"6 de julio de 1997"
5,7,30,798,424,517,941,"6 de julio de 1997"
5,7,30,808,447,480,927,"6 de julio de 1997"
5,7,30,809,369,398,767,"6 de julio de 1997"
5,7,30,810,355,430,785,"6 de julio de 1997"
5,7,30,811,304,401,705,"6 de julio de 1997"
5,7,30,812,573,614,1187,"6 de julio de 1997"
5,7,30,813,487,533,1020,"6 de julio de 1997"
5,7,30,814,588,700,1288,"6 de julio de 1997"
5,7,30,815,496,515,1011,"6 de julio de 1997"
5,7,30,816,846,925,1771,"6 de julio de 1997"
5,7,30,817,453,499,952,"6 de julio de 1997"
5,7,30,818,518,555,1073,"6 de julio de 1997"
5,7,30,819,615,703,1318,"6 de julio de 1997"
5,7,30,820,419,455,874,"6 de julio de 1997"
5,7,30,821,427,490,917,"6 de julio de 1997"
5,7,30,822,466,494,960,"6 de julio de 1997"
5,7,30,823,425,452,877,"6 de julio de 1997"
5,7,30,824,344,386,730,"6 de julio de 1997"
5,7,30,825,355,388,743,"6 de julio de 1997"
5,7,30,826,373,428,801,"6 de julio de 1997"
5,7,30,827,347,464,811,"6 de julio de 1997"
5,7,30,841,355,388,743,"6 de julio de 1997"
5,7,30,842,327,369,696,"6 de julio de 1997"
5,7,30,843,357,403,760,"6 de julio de 1997"
5,7,30,844,324,391,715,"6 de julio de 1997"
5,7,30,845,320,378,698,"6 de julio de 1997"
5,7,30,846,345,408,753,"6 de julio de 1997"
5,7,30,847,499,623,1122,"6 de julio de 1997"
5,7,30,848,355,524,879,"6 de julio de 1997"
5,7,30,849,283,315,598,"6 de julio de 1997"
5,7,30,850,590,703,1293,"6 de julio de 1997"
5,7,30,851,647,631,1278,"6 de julio de 1997"
5,7,30,852,392,424,816,"6 de julio de 1997"
5,7,30,853,499,513,1012,"6 de julio de 1997"
5,7,30,854,494,551,1045,"6 de julio de 1997"
5,7,30,855,394,480,874,"6 de julio de 1997"
5,7,30,856,425,483,908,"6 de julio de 1997"
5,7,30,857,429,559,988,"6 de julio de 1997"
5,7,30,858,384,456,840,"6 de julio de 1997"
5,7,30,859,420,486,906,"6 de julio de 1997"
5,7,30,860,408,469,877,"6 de julio de 1997"
5,7,30,861,321,394,715,"6 de julio de 1997"
5,7,30,875,376,457,833,"6 de julio de 1997"
5,7,30,876,508,550,1058,"6 de julio de 1997"
5,7,30,877,416,599,1015,"6 de julio de 1997"
5,7,30,878,303,352,655,"6 de julio de 1997"
5,7,30,879,402,478,880,"6 de julio de 1997"
5,7,30,880,540,579,1119,"6 de julio de 1997"
5,7,30,881,264,379,643,"6 de julio de 1997"
5,7,30,882,369,463,832,"6 de julio de 1997"
5,7,30,883,546,596,1142,"6 de julio de 1997"
5,7,30,884,496,520,1016,"6 de julio de 1997"
5,7,30,885,553,535,1088,"6 de julio de 1997"
5,7,30,886,511,542,1053,"6 de julio de 1997"
5,7,30,887,590,627,1217,"6 de julio de 1997"
5,7,30,888,739,789,1528,"6 de julio de 1997"
5,7,30,889,494,551,1045,"6 de julio de 1997"
5,7,30,890,427,465,892,"6 de julio de 1997"
5,7,30,891,404,485,889,"6 de julio de 1997"
5,7,30,892,389,430,819,"6 de julio de 1997"
5,7,30,893,488,596,1084,"6 de julio de 1997"
5,7,30,894,378,422,800,"6 de julio de 1997"
5,7,30,895,519,593,1112,"6 de julio de 1997"
5,7,30,896,434,512,946,"6 de julio de 1997"
5,7,30,897,577,669,1246,"6 de julio de 1997"
5,7,30,914,507,530,1037,"6 de julio de 1997"
5,7,30,915,480,497,977,"6 de julio de 1997"
5,7,30,916,387,429,816,"6 de julio de 1997"
5,7,30,917,436,467,903,"6 de julio de 1997"
5,7,30,918,426,488,914,"6 de julio de 1997"
5,7,30,919,621,643,1264,"6 de julio de 1997"
5,7,30,920,464,466,930,"6 de julio de 1997"
5,7,30,921,561,620,1181,"6 de julio de 1997"
5,7,30,922,573,634,1207,"6 de julio de 1997"
5,7,30,923,587,687,1274,"6 de julio de 1997"
5,7,30,924,430,458,888,"6 de julio de 1997"
5,7,30,925,496,526,1022,"6 de julio de 1997"
5,7,30,926,472,496,968,"6 de julio de 1997"
5,7,30,927,483,488,971,"6 de julio de 1997"
5,7,30,928,449,493,942,"6 de julio de 1997"
5,7,30,929,439,494,933,"6 de julio de 1997"
5,7,30,930,488,587,1075,"6 de julio de 1997"
5,7,30,931,478,483,961,"6 de julio de 1997"
5,7,30,932,661,732,1393,"6 de julio de 1997"
5,7,30,933,830,558,1388,"6 de julio de 1997"
5,7,30,934,515,597,1112,"6 de julio de 1997"
5,7,30,935,541,590,1131,"6 de julio de 1997"
5,7,30,936,417,476,893,"6 de julio de 1997"
5,7,30,937,507,568,1075,"6 de julio de 1997"
5,7,30,938,484,554,1038,"6 de julio de 1997"
5,7,30,940,451,497,948,"6 de julio de 1997"
5,7,30,943,385,442,827,"6 de julio de 1997"
5,7,30,952,519,575,1094,"6 de julio de 1997"
5,7,30,953,631,634,1265,"6 de julio de 1997"
5,7,30,954,585,643,1228,"6 de julio de 1997"
5,7,30,955,525,519,1044,"6 de julio de 1997"
5,7,30,956,596,626,1222,"6 de julio de 1997"
5,7,30,957,456,522,978,"6 de julio de 1997"
5,7,30,958,549,606,1155,"6 de julio de 1997"
5,7,30,959,527,555,1082,"6 de julio de 1997"
5,7,30,960,358,346,704,"6 de julio de 1997"
5,7,30,961,563,653,1216,"6 de julio de 1997"
5,7,30,962,437,459,896,"6 de julio de 1997"
5,7,30,963,636,675,1311,"6 de julio de 1997"
5,7,30,964,534,562,1096,"6 de julio de 1997"
5,7,30,965,485,500,985,"6 de julio de 1997"
5,7,30,966,558,609,1167,"6 de julio de 1997"
5,7,30,967,533,599,1132,"6 de julio de 1997"
5,7,30,968,329,410,739,"6 de julio de 1997"
5,7,30,969,346,377,723,"6 de julio de 1997"
5,7,30,970,674,710,1384,"6 de julio de 1997"
5,7,30,971,507,558,1065,"6 de julio de 1997"
5,7,30,972,566,543,1109,"6 de julio de 1997"
5,7,30,973,589,593,1182,"6 de julio de 1997"
5,7,30,974,698,750,1448,"6 de julio de 1997"
5,7,30,975,398,420,818,"6 de julio de 1997"
5,7,30,976,442,480,922,"6 de julio de 1997"
5,7,30,977,531,591,1122,"6 de julio de 1997"
5,7,30,978,714,822,1536,"6 de julio de 1997"
5,7,30,979,599,603,1202,"6 de julio de 1997"
5,7,30,980,416,429,845,"6 de julio de 1997"
5,7,30,981,499,545,1044,"6 de julio de 1997"
5,7,30,982,405,479,884,"6 de julio de 1997"
5,7,30,983,438,453,891,"6 de julio de 1997"
5,7,30,984,575,637,1212,"6 de julio de 1997"
5,7,30,985,766,785,1551,"6 de julio de 1997"
5,7,30,986,514,535,1049,"6 de julio de 1997"
5,7,30,987,401,435,836,"6 de julio de 1997"
5,7,30,988,306,329,635,"6 de julio de 1997"
5,7,30,989,513,524,1037,"6 de julio de 1997"
5,7,30,990,461,502,963,"6 de julio de 1997"
5,7,30,991,301,345,646,"6 de julio de 1997"
5,7,30,992,452,362,814,"6 de julio de 1997"
5,7,30,993,1047,1109,2156,"6 de julio de 1997"
5,7,30,994,371,442,813,"6 de julio de 1997"
5,7,30,995,325,343,668,"6 de julio de 1997"
5,7,30,996,360,439,799,"6 de julio de 1997"
5,7,30,997,257,272,529,"6 de julio de 1997"
5,7,30,998,277,302,579,"6 de julio de 1997"
5,7,30,999,254,285,539,"6 de julio de 1997"
5,7,30,1000,132,102,234,"6 de julio de 1997"
5,7,30,1001,153,118,271,"6 de julio de 1997"
5,7,30,1002,156,131,287,"6 de julio de 1997"
5,7,30,1003,57,45,102,"6 de julio de 1997"
5,7,30,1004,132,120,252,"6 de julio de 1997"
5,7,30,1005,145,114,259,"6 de julio de 1997"
5,7,30,1006,709,451,1160,"6 de julio de 1997"
5,7,30,1007,129,106,235,"6 de julio de 1997"
5,7,30,1008,160,122,282,"6 de julio de 1997"
5,7,30,1009,344,252,596,"6 de julio de 1997"
5,7,30,1010,110,105,215,"6 de julio de 1997"
5,7,30,1011,437,365,802,"6 de julio de 1997"
5,7,30,1012,74,57,131,"6 de julio de 1997"
5,7,30,1013,85,53,138,"6 de julio de 1997"
5,7,30,1014,376,355,731,"6 de julio de 1997"
5,7,30,1015,136,122,258,"6 de julio de 1997"
5,7,30,1016,126,112,238,"6 de julio de 1997"
5,7,30,1017,83,68,151,"6 de julio de 1997"
5,7,30,1018,65,72,137,"6 de julio de 1997"
5,7,30,1019,104,74,178,"6 de julio de 1997"
5,7,30,1020,101,78,179,"6 de julio de 1997"
5,7,30,1021,93,92,185,"6 de julio de 1997"
5,7,30,1022,101,87,188,"6 de julio de 1997"
5,7,30,1023,109,81,190,"6 de julio de 1997"
5,7,30,1024,52,46,98,"6 de julio de 1997"
5,7,30,1025,179,126,305,"6 de julio de 1997"
5,7,30,1026,135,128,263,"6 de julio de 1997"
5,7,30,1027,86,74,160,"6 de julio de 1997"
5,7,30,1028,71,61,132,"6 de julio de 1997"
5,7,30,1029,111,79,190,"6 de julio de 1997"
5,7,30,1030,78,58,136,"6 de julio de 1997"
5,7,30,1031,207,168,375,"6 de julio de 1997"
5,7,30,1032,65,47,112,"6 de julio de 1997"
5,7,30,1033,134,110,244,"6 de julio de 1997"
5,7,30,1034,93,74,167,"6 de julio de 1997"
5,7,30,1035,96,73,169,"6 de julio de 1997"
5,7,30,1036,100,76,176,"6 de julio de 1997"
5,7,30,1037,39,34,73,"6 de julio de 1997"
5,7,30,1038,208,182,390,"6 de julio de 1997"
5,7,30,1039,221,186,407,"6 de julio de 1997"
6,1,1,1,618,679,1297,"6 de julio de 1997"
6,1,1,2,189,199,388,"6 de julio de 1997"
6,1,1,3,620,783,1403,"6 de julio de 1997"
6,1,1,4,326,405,731,"6 de julio de 1997"
6,1,1,5,250,291,541,"6 de julio de 1997"
6,1,1,6,396,450,846,"6 de julio de 1997"
6,1,1,7,421,476,897,"6 de julio de 1997"
6,1,1,8,546,646,1192,"6 de julio de 1997"
6,1,1,9,448,521,969,"6 de julio de 1997"
6,1,1,10,532,587,1119,"6 de julio de 1997"
6,1,1,11,315,359,674,"6 de julio de 1997"
6,1,1,12,201,254,455,"6 de julio de 1997"
6,1,1,13,351,396,747,"6 de julio de 1997"
6,1,1,14,314,440,754,"6 de julio de 1997"
6,1,1,15,247,322,569,"6 de julio de 1997"
6,1,1,16,285,371,656,"6 de julio de 1997"
6,1,1,17,375,430,805,"6 de julio de 1997"
6,1,1,18,544,572,1116,"6 de julio de 1997"
6,1,1,19,529,585,1114,"6 de julio de 1997"
6,1,1,20,465,552,1017,"6 de julio de 1997"
6,1,1,21,507,536,1043,"6 de julio de 1997"
6,1,1,22,304,336,640,"6 de julio de 1997"
6,1,1,23,146,154,300,"6 de julio de 1997"
6,1,1,24,339,370,709,"6 de julio de 1997"
6,1,1,25,490,562,1052,"6 de julio de 1997"
6,1,1,26,460,551,1011,"6 de julio de 1997"
6,1,1,27,360,433,793,"6 de julio de 1997"
6,1,1,28,258,339,597,"6 de julio de 1997"
6,1,1,29,373,486,859,"6 de julio de 1997"
6,1,1,30,287,371,658,"6 de julio de 1997"
6,1,1,31,525,665,1190,"6 de julio de 1997"
6,1,1,32,608,692,1300,"6 de julio de 1997"
6,1,1,33,618,716,1334,"6 de julio de 1997"
6,1,1,34,437,507,944,"6 de julio de 1997"
6,1,1,35,501,560,1061,"6 de julio de 1997"
6,1,1,36,333,405,738,"6 de julio de 1997"
6,1,1,37,354,416,770,"6 de julio de 1997"
6,1,1,38,444,532,976,"6 de julio de 1997"
6,1,1,39,275,326,601,"6 de julio de 1997"
6,1,1,40,290,362,652,"6 de julio de 1997"
6,1,1,41,238,299,537,"6 de julio de 1997"
6,1,1,42,333,393,726,"6 de julio de 1997"
6,1,1,43,503,603,1106,"6 de julio de 1997"
6,1,1,44,649,231,880,"6 de julio de 1997"
6,1,1,45,745,858,1603,"6 de julio de 1997"
6,1,1,46,360,435,795,"6 de julio de 1997"
6,1,1,47,524,655,1179,"6 de julio de 1997"
6,1,1,48,472,544,1016,"6 de julio de 1997"
6,1,1,49,220,233,453,"6 de julio de 1997"
6,1,1,50,497,585,1082,"6 de julio de 1997"
6,1,1,51,421,497,918,"6 de julio de 1997"
6,1,1,52,853,942,1795,"6 de julio de 1997"
6,1,1,53,573,660,1233,"6 de julio de 1997"
6,1,1,54,466,529,995,"6 de julio de 1997"
6,1,1,55,570,623,1193,"6 de julio de 1997"
6,1,1,56,234,307,541,"6 de julio de 1997"
6,1,1,57,364,457,821,"6 de julio de 1997"
6,1,1,58,424,498,922,"6 de julio de 1997"
6,1,1,59,563,618,1181,"6 de julio de 1997"
6,1,1,60,309,422,731,"6 de julio de 1997"
6,1,1,61,258,295,553,"6 de julio de 1997"
6,1,1,62,359,385,744,"6 de julio de 1997"
6,1,1,63,437,490,927,"6 de julio de 1997"
6,1,1,64,621,637,1258,"6 de julio de 1997"
6,1,1,65,197,236,433,"6 de julio de 1997"
6,1,1,66,574,672,1246,"6 de julio de 1997"
6,1,1,67,552,646,1198,"6 de julio de 1997"
6,1,1,68,616,686,1302,"6 de julio de 1997"
6,1,1,69,262,279,541,"6 de julio de 1997"
6,1,1,70,516,580,1096,"6 de julio de 1997"
6,1,1,71,407,443,850,"6 de julio de 1997"
6,1,1,72,321,377,698,"6 de julio de 1997"
6,1,1,73,209,252,461,"6 de julio de 1997"
6,1,1,74,417,439,856,"6 de julio de 1997"
6,1,1,75,348,359,707,"6 de julio de 1997"
6,1,1,76,341,387,728,"6 de julio de 1997"
6,1,1,77,200,215,415,"6 de julio de 1997"
6,1,1,78,42,44,86,"6 de julio de 1997"
6,1,1,79,494,566,1060,"6 de julio de 1997"
6,1,1,80,213,241,454,"6 de julio de 1997"
6,1,1,81,599,698,1297,"6 de julio de 1997"
6,1,1,82,602,671,1273,"6 de julio de 1997"
6,1,1,83,181,175,356,"6 de julio de 1997"
6,1,1,84,459,447,906,"6 de julio de 1997"
6,1,1,85,442,399,841,"6 de julio de 1997"
6,1,1,86,140,162,302,"6 de julio de 1997"
6,1,1,87,313,270,583,"6 de julio de 1997"
6,1,1,88,384,447,831,"6 de julio de 1997"
6,1,1,89,311,339,650,"6 de julio de 1997"
6,1,1,90,194,160,354,"6 de julio de 1997"
6,1,1,91,207,190,397,"6 de julio de 1997"
6,1,2,92,522,576,1098,"6 de julio de 1997"
6,1,2,93,527,597,1124,"6 de julio de 1997"
6,1,2,94,532,639,1171,"6 de julio de 1997"
6,1,2,95,506,542,1048,"6 de julio de 1997"
6,1,2,96,511,549,1060,"6 de julio de 1997"
6,1,2,97,183,176,359,"6 de julio de 1997"
6,1,2,98,44,43,87,"6 de julio de 1997"
6,1,2,99,238,232,470,"6 de julio de 1997"
6,1,2,100,403,447,850,"6 de julio de 1997"
6,1,2,101,448,506,954,"6 de julio de 1997"
6,1,2,102,217,212,429,"6 de julio de 1997"
6,1,2,103,465,483,948,"6 de julio de 1997"
6,1,2,104,470,480,950,"6 de julio de 1997"
6,1,3,105,359,411,770,"6 de julio de 1997"
6,1,3,106,561,582,1143,"6 de julio de 1997"
6,1,3,107,502,565,1067,"6 de julio de 1997"
6,1,3,108,387,428,815,"6 de julio de 1997"
6,1,3,109,436,446,882,"6 de julio de 1997"
6,1,3,110,390,413,803,"6 de julio de 1997"
6,1,3,111,481,584,1065,"6 de julio de 1997"
6,1,3,112,154,128,282,"6 de julio de 1997"
6,1,3,113,141,143,284,"6 de julio de 1997"
6,1,3,114,76,83,159,"6 de julio de 1997"
6,1,3,115,113,95,208,"6 de julio de 1997"
6,1,3,116,527,502,1029,"6 de julio de 1997"
6,1,3,117,303,273,576,"6 de julio de 1997"
6,1,3,118,213,192,405,"6 de julio de 1997"
6,1,3,119,218,187,405,"6 de julio de 1997"
6,1,4,120,570,603,1173,"6 de julio de 1997"
6,1,4,121,399,436,835,"6 de julio de 1997"
6,1,4,122,414,440,854,"6 de julio de 1997"
6,1,4,123,497,509,1006,"6 de julio de 1997"
6,1,4,124,452,457,909,"6 de julio de 1997"
6,1,4,125,320,334,654,"6 de julio de 1997"
6,1,4,126,472,446,918,"6 de julio de 1997"
6,1,4,127,365,405,770,"6 de julio de 1997"
6,1,4,128,377,400,777,"6 de julio de 1997"
6,1,4,129,445,451,896,"6 de julio de 1997"
6,1,4,130,530,548,1078,"6 de julio de 1997"
6,1,4,131,453,470,923,"6 de julio de 1997"
6,1,4,132,521,541,1062,"6 de julio de 1997"
6,1,4,133,355,359,714,"6 de julio de 1997"
6,1,4,134,616,571,1187,"6 de julio de 1997"
6,1,4,135,470,473,943,"6 de julio de 1997"
6,1,4,136,224,229,453,"6 de julio de 1997"
6,1,4,137,365,388,753,"6 de julio de 1997"
6,1,5,138,524,641,1165,"6 de julio de 1997"
6,1,5,139,612,679,1291,"6 de julio de 1997"
6,1,5,140,613,696,1309,"6 de julio de 1997"
6,1,5,141,186,225,411,"6 de julio de 1997"
6,1,5,142,336,397,733,"6 de julio de 1997"
6,1,5,143,379,455,834,"6 de julio de 1997"
6,1,5,144,492,597,1089,"6 de julio de 1997"
6,1,5,145,895,1036,1931,"6 de julio de 1997"
6,1,5,146,277,288,565,"6 de julio de 1997"
6,1,5,147,691,784,1475,"6 de julio de 1997"
6,1,5,148,763,842,1605,"6 de julio de 1997"
6,1,5,149,567,673,1240,"6 de julio de 1997"
6,1,5,150,490,512,1002,"6 de julio de 1997"
6,1,5,151,437,527,964,"6 de julio de 1997"
6,1,5,152,506,582,1088,"6 de julio de 1997"
6,1,5,153,495,592,1087,"6 de julio de 1997"
6,1,5,154,472,541,1013,"6 de julio de 1997"
6,1,5,155,570,631,1201,"6 de julio de 1997"
6,1,5,156,479,467,946,"6 de julio de 1997"
6,1,5,157,509,533,1042,"6 de julio de 1997"
6,1,5,158,288,328,616,"6 de julio de 1997"
6,1,5,159,759,804,1563,"6 de julio de 1997"
6,1,5,160,512,589,1101,"6 de julio de 1997"
6,1,5,161,847,1018,1865,"6 de julio de 1997"
6,1,5,162,238,326,564,"6 de julio de 1997"
6,1,5,163,1915,2284,4199,"6 de julio de 1997"
6,1,5,164,624,714,1338,"6 de julio de 1997"
6,1,5,165,409,448,857,"6 de julio de 1997"
6,1,5,166,109,81,190,"6 de julio de 1997"
6,1,5,167,228,211,439,"6 de julio de 1997"
6,1,5,168,135,141,276,"6 de julio de 1997"
6,1,5,169,84,72,156,"6 de julio de 1997"
6,2,6,170,402,431,833,"6 de julio de 1997"
6,2,6,171,505,492,997,"6 de julio de 1997"
6,2,6,172,344,375,719,"6 de julio de 1997"
6,2,6,173,531,561,1092,"6 de julio de 1997"
6,2,6,174,420,421,841,"6 de julio de 1997"
6,2,6,175,297,319,616,"6 de julio de 1997"
6,2,6,176,476,531,1007,"6 de julio de 1997"
6,2,6,177,518,519,1037,"6 de julio de 1997"
6,2,6,178,422,428,850,"6 de julio de 1997"
6,2,6,179,367,358,725,"6 de julio de 1997"
6,2,6,180,365,383,748,"6 de julio de 1997"
6,2,6,181,439,462,901,"6 de julio de 1997"
6,2,6,182,402,421,823,"6 de julio de 1997"
6,2,6,183,304,257,561,"6 de julio de 1997"
6,2,6,184,198,198,396,"6 de julio de 1997"
6,2,6,185,301,299,600,"6 de julio de 1997"
6,2,6,186,498,489,987,"6 de julio de 1997"
6,2,6,187,412,428,840,"6 de julio de 1997"
6,2,6,188,447,512,959,"6 de julio de 1997"
6,2,6,189,138,124,262,"6 de julio de 1997"
6,2,6,190,160,163,323,"6 de julio de 1997"
6,2,7,191,379,430,809,"6 de julio de 1997"
6,2,7,192,331,371,702,"6 de julio de 1997"
6,2,7,193,116,94,210,"6 de julio de 1997"
6,2,7,194,110,99,209,"6 de julio de 1997"
6,2,7,195,227,199,426,"6 de julio de 1997"
6,2,7,196,146,130,276,"6 de julio de 1997"
6,2,7,197,110,97,207,"6 de julio de 1997"
6,2,7,198,42,33,75,"6 de julio de 1997"
6,2,7,199,230,184,414,"6 de julio de 1997"
6,2,8,200,831,421,1252,"6 de julio de 1997"
6,2,8,201,115,97,212,"6 de julio de 1997"
6,2,8,202,805,860,1665,"6 de julio de 1997"
6,2,8,203,630,662,1292,"6 de julio de 1997"
6,2,8,204,581,583,1164,"6 de julio de 1997"
6,2,8,205,391,419,810,"6 de julio de 1997"
6,2,8,206,612,592,1204,"6 de julio de 1997"
6,2,8,207,352,396,748,"6 de julio de 1997"
6,2,8,208,582,603,1185,"6 de julio de 1997"
6,2,8,209,726,698,1424,"6 de julio de 1997"
6,2,8,210,636,618,1254,"6 de julio de 1997"
6,2,8,211,682,675,1357,"6 de julio de 1997"
6,2,8,212,437,428,865,"6 de julio de 1997"
6,2,8,213,595,570,1165,"6 de julio de 1997"
6,2,8,214,648,671,1319,"6 de julio de 1997"
6,2,8,215,603,594,1197,"6 de julio de 1997"
6,2,8,216,500,450,950,"6 de julio de 1997"
6,2,8,217,553,603,1156,"6 de julio de 1997"
6,2,8,218,397,425,822,"6 de julio de 1997"
6,2,8,219,545,568,1113,"6 de julio de 1997"
6,2,8,220,336,397,733,"6 de julio de 1997"
6,2,8,221,501,503,1004,"6 de julio de 1997"
6,2,8,222,247,215,462,"6 de julio de 1997"
6,2,8,223,270,244,514,"6 de julio de 1997"
6,2,8,224,152,121,273,"6 de julio de 1997"
6,2,8,225,365,382,747,"6 de julio de 1997"
6,2,8,226,404,370,774,"6 de julio de 1997"
6,2,8,227,302,263,565,"6 de julio de 1997"
6,2,8,228,586,549,1135,"6 de julio de 1997"
6,2,8,229,83,74,157,"6 de julio de 1997"
6,2,8,230,696,713,1409,"6 de julio de 1997"
6,2,8,231,155,133,288,"6 de julio de 1997"
6,2,8,232,329,311,640,"6 de julio de 1997"
6,2,8,233,426,409,835,"6 de julio de 1997"
6,2,8,234,476,412,888,"6 de julio de 1997"
6,2,8,235,288,277,565,"6 de julio de 1997"
6,2,8,236,924,887,1811,"6 de julio de 1997"
6,2,8,237,858,807,1665,"6 de julio de 1997"
6,2,8,238,846,863,1709,"6 de julio de 1997"
6,2,8,239,357,342,699,"6 de julio de 1997"
6,2,8,240,590,637,1227,"6 de julio de 1997"
6,2,8,241,450,444,894,"6 de julio de 1997"
6,2,8,242,198,188,386,"6 de julio de 1997"
6,2,8,243,597,621,1218,"6 de julio de 1997"
6,2,8,244,292,255,547,"6 de julio de 1997"
6,2,8,245,753,743,1496,"6 de julio de 1997"
6,2,8,246,719,719,1438,"6 de julio de 1997"
6,2,8,247,100,85,185,"6 de julio de 1997"
6,2,8,248,333,351,684,"6 de julio de 1997"
6,2,8,249,334,334,668,"6 de julio de 1997"
6,2,8,250,849,921,1770,"6 de julio de 1997"
6,2,8,251,980,1094,2074,"6 de julio de 1997"
6,2,8,252,411,455,866,"6 de julio de 1997"
6,2,8,253,521,545,1066,"6 de julio de 1997"
6,2,8,254,262,265,527,"6 de julio de 1997"
6,2,8,255,119,156,275,"6 de julio de 1997"
6,2,8,256,690,375,1065,"6 de julio de 1997"
6,2,8,257,372,357,729,"6 de julio de 1997"
6,2,8,258,913,918,1831,"6 de julio de 1997"
6,2,8,259,507,472,979,"6 de julio de 1997"
6,2,8,260,836,848,1684,"6 de julio de 1997"
6,2,8,261,542,596,1138,"6 de julio de 1997"
6,2,8,262,480,482,962,"6 de julio de 1997"
6,2,8,263,350,327,677,"6 de julio de 1997"
6,2,8,264,359,352,711,"6 de julio de 1997"
6,2,8,265,183,178,361,"6 de julio de 1997"
6,2,8,266,267,267,534,"6 de julio de 1997"
6,2,8,267,597,602,1199,"6 de julio de 1997"
6,2,8,268,337,294,631,"6 de julio de 1997"
6,2,8,269,590,548,1138,"6 de julio de 1997"
6,2,9,270,532,492,1024,"6 de julio de 1997"
6,2,9,271,340,318,658,"6 de julio de 1997"
6,2,9,272,394,385,779,"6 de julio de 1997"
6,2,9,273,297,247,544,"6 de julio de 1997"
6,2,9,274,190,128,318,"6 de julio de 1997"
6,2,9,275,366,273,639,"6 de julio de 1997"
6,2,9,276,285,247,532,"6 de julio de 1997"
6,2,10,277,808,772,1580,"6 de julio de 1997"
6,2,10,278,482,549,1031,"6 de julio de 1997"
6,2,10,279,242,253,495,"6 de julio de 1997"
6,2,10,280,594,634,1228,"6 de julio de 1997"
6,2,10,281,449,503,952,"6 de julio de 1997"
6,2,10,282,759,838,1597,"6 de julio de 1997"
6,2,10,283,859,917,1776,"6 de julio de 1997"
6,2,10,284,410,431,841,"6 de julio de 1997"
6,2,10,285,322,351,673,"6 de julio de 1997"
6,2,10,286,353,395,748,"6 de julio de 1997"
6,2,10,287,315,347,662,"6 de julio de 1997"
6,2,10,288,269,340,609,"6 de julio de 1997"
6,2,10,289,554,577,1131,"6 de julio de 1997"
6,2,10,290,573,611,1184,"6 de julio de 1997"
6,2,10,291,596,611,1207,"6 de julio de 1997"
6,2,10,292,529,535,1064,"6 de julio de 1997"
6,2,10,293,447,456,903,"6 de julio de 1997"
6,2,10,294,300,322,622,"6 de julio de 1997"
6,2,10,295,405,433,838,"6 de julio de 1997"
6,2,10,296,397,412,809,"6 de julio de 1997"
6,2,10,297,498,553,1051,"6 de julio de 1997"
6,2,10,298,490,535,1025,"6 de julio de 1997"
6,2,10,299,522,545,1067,"6 de julio de 1997"
6,2,10,300,410,483,893,"6 de julio de 1997"
6,2,10,301,413,515,928,"6 de julio de 1997"
6,2,10,302,347,353,700,"6 de julio de 1997"
6,2,10,303,381,437,818,"6 de julio de 1997"
6,2,10,304,398,441,839,"6 de julio de 1997"
6,2,10,305,655,663,1318,"6 de julio de 1997"
6,2,10,306,403,459,862,"6 de julio de 1997"
6,2,10,307,645,387,1032,"6 de julio de 1997"
6,2,10,308,498,524,1022,"6 de julio de 1997"
6,2,10,309,309,309,618,"6 de julio de 1997"
6,2,10,310,371,387,758,"6 de julio de 1997"
6,2,10,311,803,831,1634,"6 de julio de 1997"
6,2,10,312,966,1014,1980,"6 de julio de 1997"
6,2,10,313,468,487,955,"6 de julio de 1997"
6,2,10,314,365,387,752,"6 de julio de 1997"
6,2,10,315,407,414,821,"6 de julio de 1997"
6,2,10,316,580,580,1160,"6 de julio de 1997"
6,2,10,317,350,396,746,"6 de julio de 1997"
6,2,10,318,377,391,768,"6 de julio de 1997"
6,2,10,319,345,352,697,"6 de julio de 1997"
6,2,10,320,357,338,695,"6 de julio de 1997"
6,2,10,321,559,553,1112,"6 de julio de 1997"
6,2,10,322,203,200,403,"6 de julio de 1997"
6,2,10,323,140,150,290,"6 de julio de 1997"
6,2,10,324,366,408,774,"6 de julio de 1997"
6,2,10,325,253,248,501,"6 de julio de 1997"
6,2,10,326,301,313,614,"6 de julio de 1997"
6,2,10,327,80,82,162,"6 de julio de 1997"
6,2,10,328,212,191,403,"6 de julio de 1997"
6,2,10,329,585,563,1148,"6 de julio de 1997"
6,2,10,330,47,39,86,"6 de julio de 1997"
6,2,10,331,88,74,162,"6 de julio de 1997"
6,2,10,332,125,103,228,"6 de julio de 1997"
6,2,10,333,115,91,206,"6 de julio de 1997"
6,2,10,334,420,394,814,"6 de julio de 1997"
6,2,10,335,542,488,1030,"6 de julio de 1997"
6,2,10,336,667,640,1307,"6 de julio de 1997"
7,1,16,186,391,385,776,"6 de julio de 1997"
7,1,16,187,590,571,1161,"6 de julio de 1997"
7,1,16,188,585,500,1085,"6 de julio de 1997"
7,1,16,189,361,304,665,"6 de julio de 1997"
7,1,16,190,172,161,333,"6 de julio de 1997"
7,1,16,191,213,195,408,"6 de julio de 1997"
7,1,16,192,457,419,876,"6 de julio de 1997"
7,1,16,193,754,660,1414,"6 de julio de 1997"
7,1,16,194,554,510,1064,"6 de julio de 1997"
7,1,16,195,257,226,483,"6 de julio de 1997"
7,1,16,196,229,204,433,"6 de julio de 1997"
7,1,31,456,533,528,1061,"6 de julio de 1997"
7,1,31,457,652,653,1305,"6 de julio de 1997"
7,1,31,458,568,585,1153,"6 de julio de 1997"
7,1,31,459,573,605,1178,"6 de julio de 1997"
7,1,31,460,417,400,817,"6 de julio de 1997"
7,1,31,461,541,522,1063,"6 de julio de 1997"
7,1,31,462,818,842,1660,"6 de julio de 1997"
7,1,31,463,423,414,837,"6 de julio de 1997"
7,1,31,464,589,589,1178,"6 de julio de 1997"
7,1,31,465,399,347,746,"6 de julio de 1997"
7,1,31,466,464,410,874,"6 de julio de 1997"
7,1,31,467,401,403,804,"6 de julio de 1997"
7,1,31,468,416,360,776,"6 de julio de 1997"
7,1,31,469,392,359,751,"6 de julio de 1997"
7,1,31,470,357,369,726,"6 de julio de 1997"
7,1,31,471,623,631,1254,"6 de julio de 1997"
7,1,31,472,335,334,669,"6 de julio de 1997"
7,1,31,473,669,662,1331,"6 de julio de 1997"
7,1,31,474,270,249,519,"6 de julio de 1997"
7,1,31,475,377,389,766,"6 de julio de 1997"
7,1,31,476,568,554,1122,"6 de julio de 1997"
7,1,31,477,648,664,1312,"6 de julio de 1997"
7,1,31,478,760,791,1551,"6 de julio de 1997"
7,1,31,479,378,387,765,"6 de julio de 1997"
7,1,31,480,352,347,699,"6 de julio de 1997"
7,1,31,481,861,824,1685,"6 de julio de 1997"
7,1,31,482,766,742,1508,"6 de julio de 1997"
7,1,31,483,377,344,721,"6 de julio de 1997"
7,1,31,484,453,421,874,"6 de julio de 1997"
7,1,31,485,381,381,762,"6 de julio de 1997"
7,1,31,486,751,798,1549,"6 de julio de 1997"
7,1,31,487,845,803,1648,"6 de julio de 1997"
7,1,31,488,625,659,1284,"6 de julio de 1997"
7,1,50,692,171,201,372,"6 de julio de 1997"
7,1,50,693,319,284,603,"6 de julio de 1997"
7,1,50,694,302,270,572,"6 de julio de 1997"
7,1,50,695,326,278,604,"6 de julio de 1997"
7,1,50,696,482,456,938,"6 de julio de 1997"
7,1,65,944,710,601,1311,"6 de julio de 1997"
7,1,65,945,856,754,1610,"6 de julio de 1997"
7,1,65,946,883,873,1756,"6 de julio de 1997"
7,1,65,947,1076,1053,2129,"6 de julio de 1997"
7,1,65,948,852,874,1726,"6 de julio de 1997"
7,1,65,949,891,891,1782,"6 de julio de 1997"
7,1,65,950,1160,1098,2258,"6 de julio de 1997"
7,1,65,951,1040,1030,2070,"6 de julio de 1997"
7,1,65,952,902,861,1763,"6 de julio de 1997"
7,1,65,953,703,670,1373,"6 de julio de 1997"
7,1,65,954,507,483,990,"6 de julio de 1997"
7,1,65,955,388,316,704,"6 de julio de 1997"
7,1,65,956,437,366,803,"6 de julio de 1997"
7,1,65,957,421,349,770,"6 de julio de 1997"
7,1,65,958,435,354,789,"6 de julio de 1997"
7,1,65,959,389,359,748,"6 de julio de 1997"
7,1,65,960,593,526,1119,"6 de julio de 1997"
7,1,65,961,254,231,485,"6 de julio de 1997"
7,1,65,962,602,585,1187,"6 de julio de 1997"
7,1,65,963,563,527,1090,"6 de julio de 1997"
7,1,65,964,751,684,1435,"6 de julio de 1997"
7,1,65,965,628,534,1162,"6 de julio de 1997"
7,1,65,966,232,185,417,"6 de julio de 1997"
7,1,65,967,282,241,523,"6 de julio de 1997"
7,1,65,968,585,501,1086,"6 de julio de 1997"
7,1,65,969,604,590,1194,"6 de julio de 1997"
7,1,65,970,584,506,1090,"6 de julio de 1997"
7,1,65,971,679,589,1268,"6 de julio de 1997"
7,1,65,972,695,558,1253,"6 de julio de 1997"
7,1,65,973,565,410,975,"6 de julio de 1997"
7,1,65,974,738,610,1348,"6 de julio de 1997"
7,1,65,975,654,579,1233,"6 de julio de 1997"
7,1,65,976,544,439,983,"6 de julio de 1997"
7,1,75,1082,478,454,932,"6 de julio de 1997"
7,1,75,1083,526,468,994,"6 de julio de 1997"
7,1,75,1084,495,478,973,"6 de julio de 1997"
7,1,75,1085,454,433,887,"6 de julio de 1997"
7,1,75,1086,265,236,501,"6 de julio de 1997"
7,1,75,1087,686,689,1375,"6 de julio de 1997"
7,1,75,1088,467,446,913,"6 de julio de 1997"
7,1,75,1089,456,481,937,"6 de julio de 1997"
7,1,75,1090,363,327,690,"6 de julio de 1997"
7,1,75,1091,342,357,699,"6 de julio de 1997"
7,1,76,1092,578,593,1171,"6 de julio de 1997"
7,1,76,1093,593,598,1191,"6 de julio de 1997"
7,1,76,1094,452,371,823,"6 de julio de 1997"
7,1,76,1095,371,289,660,"6 de julio de 1997"
7,1,76,1096,628,529,1157,"6 de julio de 1997"
7,1,76,1097,457,390,847,"6 de julio de 1997"
7,1,76,1098,662,608,1270,"6 de julio de 1997"
7,1,76,1099,429,379,808,"6 de julio de 1997"
7,1,76,1100,666,636,1302,"6 de julio de 1997"
7,1,76,1101,310,351,661,"6 de julio de 1997"
7,1,76,1102,450,416,866,"6 de julio de 1997"
7,1,76,1103,594,600,1194,"6 de julio de 1997"
7,1,76,1104,438,553,991,"6 de julio de 1997"
7,1,76,1105,495,541,1036,"6 de julio de 1997"
7,1,76,1106,747,837,1584,"6 de julio de 1997"
7,1,76,1107,555,599,1154,"6 de julio de 1997"
7,1,76,1108,745,724,1469,"6 de julio de 1997"
7,1,76,1109,455,426,881,"6 de julio de 1997"
7,1,76,1110,446,482,928,"6 de julio de 1997"
7,1,76,1111,664,600,1264,"6 de julio de 1997"
7,1,76,1112,606,602,1208,"6 de julio de 1997"
7,1,96,1464,438,449,887,"6 de julio de 1997"
7,1,96,1465,540,550,1090,"6 de julio de 1997"
7,1,96,1466,374,388,762,"6 de julio de 1997"
7,1,96,1467,377,364,741,"6 de julio de 1997"
7,1,96,1468,572,558,1130,"6 de julio de 1997"
7,1,96,1469,326,307,633,"6 de julio de 1997"
7,1,96,1470,659,659,1318,"6 de julio de 1997"
7,1,96,1471,622,584,1206,"6 de julio de 1997"
7,1,96,1472,565,553,1118,"6 de julio de 1997"
7,1,96,1473,524,504,1028,"6 de julio de 1997"
7,1,96,1474,700,688,1388,"6 de julio de 1997"
7,1,96,1475,775,720,1495,"6 de julio de 1997"
7,1,96,1476,669,665,1334,"6 de julio de 1997"
7,1,96,1477,574,534,1108,"6 de julio de 1997"
7,1,96,1478,535,512,1047,"6 de julio de 1997"
7,1,96,1479,671,672,1343,"6 de julio de 1997"
7,1,96,1480,728,703,1431,"6 de julio de 1997"
7,1,96,1481,708,727,1435,"6 de julio de 1997"
7,1,96,1482,519,597,1116,"6 de julio de 1997"
7,1,96,1483,512,509,1021,"6 de julio de 1997"
7,1,96,1484,845,845,1690,"6 de julio de 1997"
7,1,96,1485,706,695,1401,"6 de julio de 1997"
7,1,100,1568,450,465,915,"6 de julio de 1997"
7,1,100,1569,511,459,970,"6 de julio de 1997"
7,1,100,1570,451,473,924,"6 de julio de 1997"
7,1,100,1571,505,517,1022,"6 de julio de 1997"
7,1,100,1572,791,849,1640,"6 de julio de 1997"
7,1,100,1573,315,310,625,"6 de julio de 1997"
7,1,100,1574,422,454,876,"6 de julio de 1997"
7,1,100,1575,457,550,1007,"6 de julio de 1997"
7,1,100,1576,535,534,1069,"6 de julio de 1997"
7,1,100,1577,285,320,605,"6 de julio de 1997"
7,1,100,1578,767,799,1566,"6 de julio de 1997"
7,1,100,1579,529,558,1087,"6 de julio de 1997"
7,1,110,1902,716,783,1499,"6 de julio de 1997"
7,1,110,1903,665,625,1290,"6 de julio de 1997"
7,1,110,1904,896,860,1756,"6 de julio de 1997"
7,1,110,1905,545,600,1145,"6 de julio de 1997"
7,1,110,1906,572,570,1142,"6 de julio de 1997"
7,1,110,1907,409,374,783,"6 de julio de 1997"
7,1,110,1908,625,696,1321,"6 de julio de 1997"
7,1,110,1909,402,435,837,"6 de julio de 1997"
7,1,110,1910,404,387,791,"6 de julio de 1997"
7,1,110,1911,415,361,776,"6 de julio de 1997"
7,1,110,1912,343,329,672,"6 de julio de 1997"
7,1,110,1913,450,466,916,"6 de julio de 1997"
7,1,110,1914,366,390,756,"6 de julio de 1997"
7,2,5,44,916,826,1742,"6 de julio de 1997"
7,2,5,45,290,232,522,"6 de julio de 1997"
7,2,5,46,263,213,476,"6 de julio de 1997"
7,2,5,47,165,131,296,"6 de julio de 1997"
7,2,5,48,544,486,1030,"6 de julio de 1997"
7,2,5,49,365,317,682,"6 de julio de 1997"
7,2,5,50,459,383,842,"6 de julio de 1997"
7,2,5,51,278,220,498,"6 de julio de 1997"
7,2,5,52,387,297,684,"6 de julio de 1997"
7,2,5,53,480,411,891,"6 de julio de 1997"
7,2,14,155,545,624,1169,"6 de julio de 1997"
7,2,14,156,493,461,954,"6 de julio de 1997"
7,2,14,157,411,391,802,"6 de julio de 1997"
7,2,14,158,404,373,777,"6 de julio de 1997"
7,2,14,159,393,384,777,"6 de julio de 1997"
7,2,14,160,670,633,1303,"6 de julio de 1997"
7,2,14,161,272,262,534,"6 de julio de 1997"
7,2,14,162,470,486,956,"6 de julio de 1997"
7,2,25,381,539,540,1079,"6 de julio de 1997"
7,2,25,382,340,308,648,"6 de julio de 1997"
7,2,25,383,613,619,1232,"6 de julio de 1997"
7,2,33,502,700,615,1315,"6 de julio de 1997"
7,2,33,503,478,391,869,"6 de julio de 1997"
7,2,38,556,510,502,1012,"6 de julio de 1997"
7,2,38,557,399,384,783,"6 de julio de 1997"
7,2,38,558,453,378,831,"6 de julio de 1997"
7,2,38,559,396,321,717,"6 de julio de 1997"
7,2,38,560,545,474,1019,"6 de julio de 1997"
7,2,38,561,531,458,989,"6 de julio de 1997"
7,2,38,562,334,250,584,"6 de julio de 1997"
7,2,38,563,463,426,889,"6 de julio de 1997"
7,2,38,564,238,208,446,"6 de julio de 1997"
7,2,38,565,362,319,681,"6 de julio de 1997"
7,2,42,617,389,386,775,"6 de julio de 1997"
7,2,42,618,725,669,1394,"6 de julio de 1997"
7,2,42,619,378,371,749,"6 de julio de 1997"
7,2,42,620,525,489,1014,"6 de julio de 1997"
7,2,43,621,529,479,1008,"6 de julio de 1997"
7,2,43,622,597,593,1190,"6 de julio de 1997"
7,2,43,623,368,353,721,"6 de julio de 1997"
7,2,43,624,258,241,499,"6 de julio de 1997"
7,2,43,625,147,129,276,"6 de julio de 1997"
7,2,43,626,425,416,841,"6 de julio de 1997"
7,2,45,636,525,462,987,"6 de julio de 1997"
7,2,45,637,668,628,1296,"6 de julio de 1997"
7,2,47,662,455,438,893,"6 de julio de 1997"
7,2,47,663,586,588,1174,"6 de julio de 1997"
7,2,47,664,352,299,651,"6 de julio de 1997"
7,2,47,665,205,178,383,"6 de julio de 1997"
7,2,47,666,331,293,624,"6 de julio de 1997"
7,2,47,667,576,590,1166,"6 de julio de 1997"
7,2,47,668,185,172,357,"6 de julio de 1997"
7,2,48,669,598,625,1223,"6 de julio de 1997"
7,2,48,670,660,671,1331,"6 de julio de 1997"
7,2,48,671,721,708,1429,"6 de julio de 1997"
7,2,48,672,608,571,1179,"6 de julio de 1997"
7,2,48,673,413,351,764,"6 de julio de 1997"
7,2,48,674,487,477,964,"6 de julio de 1997"
7,2,48,675,180,136,316,"6 de julio de 1997"
7,2,48,676,546,484,1030,"6 de julio de 1997"
7,2,48,677,291,258,549,"6 de julio de 1997"
7,2,48,678,483,406,889,"6 de julio de 1997"
7,2,48,679,409,373,782,"6 de julio de 1997"
7,2,48,680,380,354,734,"6 de julio de 1997"
7,2,48,681,399,368,767,"6 de julio de 1997"
7,2,62,913,692,602,1294,"6 de julio de 1997"
7,2,62,914,565,447,1012,"6 de julio de 1997"
7,2,62,915,371,332,703,"6 de julio de 1997"
7,2,62,916,627,564,1191,"6 de julio de 1997"
7,2,62,917,237,221,458,"6 de julio de 1997"
7,2,62,918,415,365,780,"6 de julio de 1997"
7,2,62,919,294,280,574,"6 de julio de 1997"
7,2,62,920,564,497,1061,"6 de julio de 1997"
7,2,62,921,289,264,553,"6 de julio de 1997"
7,2,62,922,209,209,418,"6 de julio de 1997"
7,2,67,985,667,657,1324,"6 de julio de 1997"
7,2,67,986,401,424,825,"6 de julio de 1997"
7,2,67,987,267,238,505,"6 de julio de 1997"
7,2,67,988,272,255,527,"6 de julio de 1997"
7,2,67,989,268,316,584,"6 de julio de 1997"
7,2,68,990,1068,1003,2071,"6 de julio de 1997"
7,2,68,991,608,642,1250,"6 de julio de 1997"
7,2,68,992,391,432,823,"6 de julio de 1997"
7,2,68,993,530,560,1090,"6 de julio de 1997"
7,2,68,994,516,571,1087,"6 de julio de 1997"
7,2,68,995,674,663,1337,"6 de julio de 1997"
7,2,68,996,431,371,802,"6 de julio de 1997"
7,2,68,997,486,402,888,"6 de julio de 1997"
7,2,68,998,440,369,809,"6 de julio de 1997"
7,2,68,999,483,405,888,"6 de julio de 1997"
7,2,68,1000,345,301,646,"6 de julio de 1997"
7,2,68,1001,311,262,573,"6 de julio de 1997"
7,2,68,1002,515,467,982,"6 de julio de 1997"
7,2,68,1003,419,380,799,"6 de julio de 1997"
7,2,68,1004,286,260,546,"6 de julio de 1997"
7,2,68,1005,153,123,276,"6 de julio de 1997"
7,2,68,1006,177,147,324,"6 de julio de 1997"
7,2,68,1007,495,431,926,"6 de julio de 1997"
7,2,71,1039,434,465,899,"6 de julio de 1997"
7,2,71,1040,333,318,651,"6 de julio de 1997"
7,2,71,1041,744,759,1503,"6 de julio de 1997"
7,2,71,1042,426,402,828,"6 de julio de 1997"
7,2,71,1043,343,258,601,"6 de julio de 1997"
7,2,71,1044,520,543,1063,"6 de julio de 1997"
7,2,71,1045,576,583,1159,"6 de julio de 1997"
7,2,71,1046,221,256,477,"6 de julio de 1997"
7,2,71,1047,636,560,1196,"6 de julio de 1997"
7,2,71,1048,562,509,1071,"6 de julio de 1997"
7,2,72,1049,506,474,980,"6 de julio de 1997"
7,2,72,1050,655,633,1288,"6 de julio de 1997"
7,2,72,1051,369,354,723,"6 de julio de 1997"
7,2,73,1052,700,681,1381,"6 de julio de 1997"
7,2,73,1053,532,554,1086,"6 de julio de 1997"
7,2,73,1054,485,427,912,"6 de julio de 1997"
7,2,73,1055,406,393,799,"6 de julio de 1997"
7,2,73,1056,492,500,992,"6 de julio de 1997"
7,2,73,1057,534,558,1092,"6 de julio de 1997"
7,2,73,1058,435,393,828,"6 de julio de 1997"
7,2,73,1059,447,418,865,"6 de julio de 1997"
7,2,73,1060,532,554,1086,"6 de julio de 1997"
7,2,73,1061,534,515,1049,"6 de julio de 1997"
7,2,73,1062,632,619,1251,"6 de julio de 1997"
7,2,73,1063,354,298,652,"6 de julio de 1997"
7,2,73,1064,536,441,977,"6 de julio de 1997"
7,2,73,1065,399,349,748,"6 de julio de 1997"
7,2,73,1066,518,512,1030,"6 de julio de 1997"
7,2,73,1067,365,326,691,"6 de julio de 1997"
7,2,73,1068,368,371,739,"6 de julio de 1997"
7,2,73,1069,542,505,1047,"6 de julio de 1997"
7,2,82,1207,547,545,1092,"6 de julio de 1997"
7,2,82,1208,606,609,1215,"6 de julio de 1997"
7,2,82,1209,633,541,1174,"6 de julio de 1997"
7,2,82,1210,549,503,1052,"6 de julio de 1997"
7,2,82,1211,219,188,407,"6 de julio de 1997"
7,2,82,1212,266,234,500,"6 de julio de 1997"
7,2,82,1213,575,561,1136,"6 de julio de 1997"
7,2,82,1214,428,420,848,"6 de julio de 1997"
7,2,82,1215,689,640,1329,"6 de julio de 1997"
7,2,82,1216,367,339,706,"6 de julio de 1997"
7,2,82,1217,362,369,731,"6 de julio de 1997"
7,2,82,1218,636,601,1237,"6 de julio de 1997"
7,2,82,1219,535,567,1102,"6 de julio de 1997"
7,2,82,1220,495,520,1015,"6 de julio de 1997"
7,2,82,1221,315,286,601,"6 de julio de 1997"
7,2,85,1233,763,730,1493,"6 de julio de 1997"
7,2,85,1234,425,383,808,"6 de julio de 1997"
7,2,85,1235,651,616,1267,"6 de julio de 1997"
7,2,89,1264,513,479,992,"6 de julio de 1997"
7,2,91,1404,532,555,1087,"6 de julio de 1997"
7,2,91,1405,365,394,759,"6 de julio de 1997"
7,2,92,1406,649,618,1267,"6 de julio de 1997"
7,2,92,1407,330,349,679,"6 de julio de 1997"
7,2,92,1408,344,345,689,"6 de julio de 1997"
7,2,92,1409,432,472,904,"6 de julio de 1997"
7,2,92,1410,578,509,1087,"6 de julio de 1997"
7,3,4,35,703,632,1335,"6 de julio de 1997"
7,3,4,36,535,542,1077,"6 de julio de 1997"
7,3,4,37,545,489,1034,"6 de julio de 1997"
7,3,4,38,347,280,627,"6 de julio de 1997"
7,3,4,39,459,435,894,"6 de julio de 1997"
7,3,4,40,772,742,1514,"6 de julio de 1997"
7,3,4,41,524,503,1027,"6 de julio de 1997"
7,3,4,42,658,624,1282,"6 de julio de 1997"
7,3,4,43,372,346,718,"6 de julio de 1997"
7,3,52,718,542,598,1140,"6 de julio de 1997"
7,3,52,719,778,838,1616,"6 de julio de 1997"
7,3,52,720,663,678,1341,"6 de julio de 1997"
7,3,52,721,745,826,1571,"6 de julio de 1997"
7,3,52,722,453,458,911,"6 de julio de 1997"
7,3,52,723,667,662,1329,"6 de julio de 1997"
7,3,52,724,716,724,1440,"6 de julio de 1997"
7,3,52,725,806,804,1610,"6 de julio de 1997"
7,3,52,726,355,326,681,"6 de julio de 1997"
7,3,52,727,327,342,669,"6 de julio de 1997"
7,3,52,728,357,306,663,"6 de julio de 1997"
7,3,52,729,437,341,778,"6 de julio de 1997"
7,3,52,730,603,461,1064,"6 de julio de 1997"
7,3,52,731,625,570,1195,"6 de julio de 1997"
7,3,52,732,644,643,1287,"6 de julio de 1997"
7,3,52,733,752,691,1443,"6 de julio de 1997"
7,3,52,734,679,680,1359,"6 de julio de 1997"
7,3,52,735,630,608,1238,"6 de julio de 1997"
7,3,52,736,657,726,1383,"6 de julio de 1997"
7,3,52,737,679,663,1342,"6 de julio de 1997"
7,3,52,738,446,406,852,"6 de julio de 1997"
7,3,52,739,539,530,1069,"6 de julio de 1997"
7,3,52,740,518,533,1051,"6 de julio de 1997"
7,3,52,741,527,571,1098,"6 de julio de 1997"
7,3,52,742,515,440,955,"6 de julio de 1997"
7,3,52,743,562,519,1081,"6 de julio de 1997"
7,3,52,744,653,613,1266,"6 de julio de 1997"
7,3,52,745,430,384,814,"6 de julio de 1997"
7,3,52,746,206,205,411,"6 de julio de 1997"
7,3,52,747,93,70,163,"6 de julio de 1997"
7,3,52,748,345,311,656,"6 de julio de 1997"
7,3,52,749,420,372,792,"6 de julio de 1997"
7,3,52,750,379,328,707,"6 de julio de 1997"
7,3,52,751,612,553,1165,"6 de julio de 1997"
7,3,52,752,322,315,637,"6 de julio de 1997"
7,3,52,753,198,197,395,"6 de julio de 1997"
7,3,52,754,184,169,353,"6 de julio de 1997"
7,3,52,755,299,249,548,"6 de julio de 1997"
7,3,52,756,155,156,311,"6 de julio de 1997"
7,3,52,757,289,250,539,"6 de julio de 1997"
7,3,52,758,324,293,617,"6 de julio de 1997"
7,3,52,759,442,390,832,"6 de julio de 1997"
7,3,59,815,684,691,1375,"6 de julio de 1997"
7,3,59,816,1207,1192,2399,"6 de julio de 1997"
7,3,59,817,854,858,1712,"6 de julio de 1997"
7,3,59,818,836,837,1673,"6 de julio de 1997"
7,3,59,819,840,846,1686,"6 de julio de 1997"
7,3,59,820,1062,960,2022,"6 de julio de 1997"
7,3,59,821,218,188,406,"6 de julio de 1997"
7,3,59,822,403,385,788,"6 de julio de 1997"
7,3,59,823,445,380,825,"6 de julio de 1997"
7,3,59,824,327,283,610,"6 de julio de 1997"
7,3,59,825,553,531,1084,"6 de julio de 1997"
7,3,59,826,673,653,1326,"6 de julio de 1997"
7,3,59,827,437,399,836,"6 de julio de 1997"
7,3,59,828,550,460,1010,"6 de julio de 1997"
7,3,59,829,504,468,972,"6 de julio de 1997"
7,3,59,830,501,416,917,"6 de julio de 1997"
7,3,59,831,459,415,874,"6 de julio de 1997"
7,3,59,832,385,341,726,"6 de julio de 1997"
7,3,59,833,512,457,969,"6 de julio de 1997"
7,3,59,834,361,383,744,"6 de julio de 1997"
7,3,59,835,762,492,1254,"6 de julio de 1997"
7,3,59,836,535,569,1104,"6 de julio de 1997"
7,3,59,837,474,449,923,"6 de julio de 1997"
7,3,59,838,364,363,727,"6 de julio de 1997"
7,3,59,839,630,641,1271,"6 de julio de 1997"
7,3,59,840,476,445,921,"6 de julio de 1997"
7,3,59,841,464,405,869,"6 de julio de 1997"
7,3,59,842,770,641,1411,"6 de julio de 1997"
7,3,59,843,865,809,1674,"6 de julio de 1997"
7,3,59,844,580,523,1103,"6 de julio de 1997"
7,3,59,845,549,489,1038,"6 de julio de 1997"
7,3,59,846,622,577,1199,"6 de julio de 1997"
7,3,59,847,468,433,901,"6 de julio de 1997"
7,3,59,848,955,852,1807,"6 de julio de 1997"
7,3,59,849,726,675,1401,"6 de julio de 1997"
7,3,59,850,531,449,980,"6 de julio de 1997"
7,3,59,851,234,205,439,"6 de julio de 1997"
7,3,59,852,113,120,233,"6 de julio de 1997"
7,3,59,853,473,431,904,"6 de julio de 1997"
7,3,59,854,419,359,778,"6 de julio de 1997"
7,3,59,855,622,570,1192,"6 de julio de 1997"
7,3,59,856,447,411,858,"6 de julio de 1997"
7,3,59,857,922,771,1693,"6 de julio de 1997"
7,3,59,858,685,626,1311,"6 de julio de 1997"
7,3,59,859,560,513,1073,"6 de julio de 1997"
7,3,59,860,385,343,728,"6 de julio de 1997"
7,3,59,861,519,509,1028,"6 de julio de 1997"
7,3,59,862,579,460,1039,"6 de julio de 1997"
7,3,59,863,548,495,1043,"6 de julio de 1997"
7,3,59,864,683,657,1340,"6 de julio de 1997"
7,3,59,865,430,384,814,"6 de julio de 1997"
7,3,59,866,411,386,797,"6 de julio de 1997"
7,3,59,867,484,376,860,"6 de julio de 1997"
7,3,59,868,550,428,978,"6 de julio de 1997"
7,3,59,869,392,301,693,"6 de julio de 1997"
7,3,59,870,678,620,1298,"6 de julio de 1997"
7,3,59,871,483,466,949,"6 de julio de 1997"
7,3,59,872,794,685,1479,"6 de julio de 1997"
7,3,59,873,342,282,624,"6 de julio de 1997"
7,3,59,874,376,274,650,"6 de julio de 1997"
7,3,59,875,360,275,635,"6 de julio de 1997"
7,3,59,876,626,505,1131,"6 de julio de 1997"
7,3,59,877,195,162,357,"6 de julio de 1997"
7,3,59,878,552,454,1006,"6 de julio de 1997"
7,3,59,879,668,526,1194,"6 de julio de 1997"
7,3,59,880,184,135,319,"6 de julio de 1997"
7,3,59,881,383,273,656,"6 de julio de 1997"
7,3,64,925,406,483,889,"6 de julio de 1997"
7,3,64,926,368,416,784,"6 de julio de 1997"
7,3,64,927,282,303,585,"6 de julio de 1997"
7,3,64,928,347,322,669,"6 de julio de 1997"
7,3,64,929,477,427,904,"6 de julio de 1997"
7,3,64,930,516,502,1018,"6 de julio de 1997"
7,3,64,931,695,610,1305,"6 de julio de 1997"
7,3,64,932,452,440,892,"6 de julio de 1997"
7,3,64,933,398,400,798,"6 de julio de 1997"
7,3,64,934,411,379,790,"6 de julio de 1997"
7,3,64,935,643,683,1326,"6 de julio de 1997"
7,3,64,936,478,468,946,"6 de julio de 1997"
7,3,64,937,260,271,531,"6 de julio de 1997"
7,3,64,938,539,527,1066,"6 de julio de 1997"
7,3,64,939,468,470,938,"6 de julio de 1997"
7,3,64,940,751,739,1490,"6 de julio de 1997"
7,3,64,941,280,249,529,"6 de julio de 1997"
7,3,64,942,372,351,723,"6 de julio de 1997"
7,3,64,943,449,412,861,"6 de julio de 1997"
7,3,79,1178,588,641,1229,"6 de julio de 1997"
7,3,79,1179,648,605,1253,"6 de julio de 1997"
7,3,79,1180,572,539,1111,"6 de julio de 1997"
7,3,79,1181,505,460,965,"6 de julio de 1997"
7,3,79,1182,545,511,1056,"6 de julio de 1997"
7,3,79,1183,615,618,1233,"6 de julio de 1997"
7,3,79,1184,440,469,909,"6 de julio de 1997"
7,3,79,1185,677,674,1351,"6 de julio de 1997"
7,3,79,1186,340,345,685,"6 de julio de 1997"
7,3,83,1222,418,420,838,"6 de julio de 1997"
7,3,83,1223,383,356,739,"6 de julio de 1997"
7,3,83,1224,460,435,895,"6 de julio de 1997"
7,3,83,1225,741,644,1385,"6 de julio de 1997"
7,4,12,130,664,622,1286,"6 de julio de 1997"
7,4,12,131,756,752,1508,"6 de julio de 1997"
7,4,12,132,584,582,1166,"6 de julio de 1997"
7,4,12,133,359,344,703,"6 de julio de 1997"
7,4,12,134,707,711,1418,"6 de julio de 1997"
7,4,12,135,732,753,1485,"6 de julio de 1997"
7,4,12,136,1180,648,1828,"6 de julio de 1997"
7,4,12,137,365,309,674,"6 de julio de 1997"
7,4,12,138,370,283,653,"6 de julio de 1997"
7,4,12,139,150,128,278,"6 de julio de 1997"
7,4,12,140,152,116,268,"6 de julio de 1997"
7,4,12,141,163,145,308,"6 de julio de 1997"
7,4,12,142,424,375,799,"6 de julio de 1997"
7,4,12,143,161,143,304,"6 de julio de 1997"
7,4,18,234,379,359,738,"6 de julio de 1997"
7,4,18,235,325,363,688,"6 de julio de 1997"
7,4,18,236,245,230,475,"6 de julio de 1997"
7,4,18,237,380,335,715,"6 de julio de 1997"
7,4,18,238,329,279,608,"6 de julio de 1997"
7,4,21,317,387,386,773,"6 de julio de 1997"
7,4,21,318,370,397,767,"6 de julio de 1997"
7,4,21,319,385,382,767,"6 de julio de 1997"
7,4,21,320,380,361,741,"6 de julio de 1997"
7,4,21,321,489,418,907,"6 de julio de 1997"
7,4,21,322,295,254,549,"6 de julio de 1997"
7,4,21,323,163,131,294,"6 de julio de 1997"
7,4,21,324,263,229,492,"6 de julio de 1997"
7,4,21,325,283,229,512,"6 de julio de 1997"
7,4,21,326,324,287,611,"6 de julio de 1997"
7,4,21,327,333,307,640,"6 de julio de 1997"
7,4,21,328,315,282,597,"6 de julio de 1997"
7,4,21,329,404,364,768,"6 de julio de 1997"
7,4,21,330,347,272,619,"6 de julio de 1997"
7,4,29,436,412,380,792,"6 de julio de 1997"
7,4,29,437,919,444,1363,"6 de julio de 1997"
7,4,29,438,198,172,370,"6 de julio de 1997"
7,4,60,882,721,715,1436,"6 de julio de 1997"
7,4,60,883,571,553,1124,"6 de julio de 1997"
7,4,60,884,608,592,1200,"6 de julio de 1997"
7,4,61,885,501,444,945,"6 de julio de 1997"
7,4,61,886,516,563,1079,"6 de julio de 1997"
7,4,61,887,788,734,1522,"6 de julio de 1997"
7,4,61,888,704,742,1446,"6 de julio de 1997"
7,4,61,889,636,702,1338,"6 de julio de 1997"
7,4,61,890,450,453,903,"6 de julio de 1997"
7,4,61,891,546,547,1093,"6 de julio de 1997"
7,4,61,892,678,713,1391,"6 de julio de 1997"
7,4,61,893,737,776,1513,"6 de julio de 1997"
7,4,61,894,663,660,1323,"6 de julio de 1997"
7,4,61,895,755,702,1457,"6 de julio de 1997"
7,4,61,896,275,243,518,"6 de julio de 1997"
7,4,61,897,790,705,1495,"6 de julio de 1997"
7,4,61,898,725,638,1363,"6 de julio de 1997"
7,4,61,899,374,315,689,"6 de julio de 1997"
7,4,61,900,879,735,1614,"6 de julio de 1997"
7,4,61,901,852,772,1624,"6 de julio de 1997"
7,4,61,902,183,175,358,"6 de julio de 1997"
7,4,61,903,228,216,444,"6 de julio de 1997"
7,4,61,904,198,170,368,"6 de julio de 1997"
7,4,61,905,493,468,961,"6 de julio de 1997"
7,4,61,906,229,190,419,"6 de julio de 1997"
7,4,61,907,269,248,517,"6 de julio de 1997"
7,4,61,908,221,194,415,"6 de julio de 1997"
7,4,61,909,590,577,1167,"6 de julio de 1997"
7,4,61,910,427,387,814,"6 de julio de 1997"
7,4,61,911,352,323,675,"6 de julio de 1997"
7,4,61,912,625,477,1102,"6 de julio de 1997"
7,4,63,923,416,460,876,"6 de julio de 1997"
7,4,63,924,268,260,528,"6 de julio de 1997"
7,4,78,1165,671,604,1275,"6 de julio de 1997"
7,4,78,1166,488,477,965,"6 de julio de 1997"
7,4,78,1167,609,511,1120,"6 de julio de 1997"
7,4,78,1168,714,688,1402,"6 de julio de 1997"
7,4,78,1169,269,225,494,"6 de julio de 1997"
7,4,78,1170,460,426,886,"6 de julio de 1997"
7,4,78,1171,175,181,356,"6 de julio de 1997"
7,4,78,1172,500,436,936,"6 de julio de 1997"
7,4,78,1173,365,323,688,"6 de julio de 1997"
7,4,78,1174,405,367,772,"6 de julio de 1997"
7,4,78,1175,635,550,1185,"6 de julio de 1997"
7,4,78,1176,515,489,1004,"6 de julio de 1997"
7,4,78,1177,612,559,1171,"6 de julio de 1997"
7,4,87,1240,541,518,1059,"6 de julio de 1997"
7,4,87,1241,602,586,1188,"6 de julio de 1997"
7,4,87,1242,631,601,1232,"6 de julio de 1997"
7,4,87,1243,682,712,1394,"6 de julio de 1997"
7,4,87,1244,526,519,1045,"6 de julio de 1997"
7,4,87,1245,503,461,964,"6 de julio de 1997"
7,4,87,1246,503,471,974,"6 de julio de 1997"
7,4,93,1411,467,451,918,"6 de julio de 1997"
7,4,93,1412,277,257,534,"6 de julio de 1997"
7,4,93,1413,375,357,732,"6 de julio de 1997"
7,4,93,1414,404,406,810,"6 de julio de 1997"
7,4,93,1415,229,226,455,"6 de julio de 1997"
7,4,93,1416,344,294,638,"6 de julio de 1997"
7,4,93,1417,496,408,904,"6 de julio de 1997"
7,4,93,1418,269,244,513,"6 de julio de 1997"
7,4,93,1419,343,342,685,"6 de julio de 1997"
7,4,93,1420,244,232,476,"6 de julio de 1997"
7,4,93,1421,334,307,641,"6 de julio de 1997"
7,4,93,1422,378,319,697,"6 de julio de 1997"
7,4,93,1423,336,324,660,"6 de julio de 1997"
7,4,93,1424,405,334,739,"6 de julio de 1997"
7,4,93,1425,219,193,412,"6 de julio de 1997"
7,4,93,1426,499,432,931,"6 de julio de 1997"
7,4,93,1427,327,309,636,"6 de julio de 1997"
7,4,93,1428,261,199,460,"6 de julio de 1997"
7,4,93,1429,485,494,979,"6 de julio de 1997"
7,4,93,1430,345,378,723,"6 de julio de 1997"
7,4,93,1431,399,360,759,"6 de julio de 1997"
7,4,93,1432,491,461,952,"6 de julio de 1997"
7,4,93,1433,445,415,860,"6 de julio de 1997"
7,4,93,1434,434,385,819,"6 de julio de 1997"
7,4,93,1435,347,266,613,"6 de julio de 1997"
7,4,93,1436,71,60,131,"6 de julio de 1997"
7,4,93,1437,330,259,589,"6 de julio de 1997"
7,4,109,1856,447,434,881,"6 de julio de 1997"
7,4,109,1857,459,468,927,"6 de julio de 1997"
7,4,109,1858,608,610,1218,"6 de julio de 1997"
7,4,109,1859,384,403,787,"6 de julio de 1997"
7,4,109,1860,704,813,1517,"6 de julio de 1997"
7,4,109,1861,309,345,654,"6 de julio de 1997"
7,4,109,1862,409,463,872,"6 de julio de 1997"
7,4,109,1863,355,380,735,"6 de julio de 1997"
7,4,109,1864,510,532,1042,"6 de julio de 1997"
7,4,109,1865,647,707,1354,"6 de julio de 1997"
7,4,109,1866,350,330,680,"6 de julio de 1997"
7,4,109,1867,635,707,1342,"6 de julio de 1997"
7,4,109,1868,653,703,1356,"6 de julio de 1997"
7,4,109,1869,555,597,1152,"6 de julio de 1997"
7,4,109,1870,405,409,814,"6 de julio de 1997"
7,4,109,1871,502,527,1029,"6 de julio de 1997"
7,4,109,1872,380,364,744,"6 de julio de 1997"
7,4,109,1873,378,368,746,"6 de julio de 1997"
7,4,109,1874,577,531,1108,"6 de julio de 1997"
7,4,109,1875,114,102,216,"6 de julio de 1997"
7,4,109,1876,362,271,633,"6 de julio de 1997"
7,4,109,1877,452,430,882,"6 de julio de 1997"
7,4,109,1878,520,492,1012,"6 de julio de 1997"
7,4,109,1879,423,392,815,"6 de julio de 1997"
7,4,109,1880,356,262,618,"6 de julio de 1997"
7,4,109,1881,609,615,1224,"6 de julio de 1997"
7,4,109,1882,613,599,1212,"6 de julio de 1997"
7,4,109,1883,550,494,1044,"6 de julio de 1997"
7,4,109,1884,471,414,885,"6 de julio de 1997"
7,4,109,1885,481,447,928,"6 de julio de 1997"
7,4,109,1886,625,625,1250,"6 de julio de 1997"
7,4,109,1887,315,260,575,"6 de julio de 1997"
7,4,109,1888,579,479,1058,"6 de julio de 1997"
7,4,109,1889,303,261,564,"6 de julio de 1997"
7,4,109,1890,752,725,1477,"6 de julio de 1997"
7,4,109,1891,526,491,1017,"6 de julio de 1997"
7,4,109,1892,528,464,992,"6 de julio de 1997"
7,4,109,1893,487,471,958,"6 de julio de 1997"
7,4,109,1894,498,432,930,"6 de julio de 1997"
7,4,109,1895,652,505,1157,"6 de julio de 1997"
7,4,109,1896,579,443,1022,"6 de julio de 1997"
7,4,109,1897,347,311,658,"6 de julio de 1997"
7,4,109,1898,612,580,1192,"6 de julio de 1997"
7,4,109,1899,428,383,811,"6 de julio de 1997"
7,4,109,1900,188,163,351,"6 de julio de 1997"
7,4,109,1901,688,632,1320,"6 de julio de 1997"
7,5,22,331,135,137,272,"6 de julio de 1997"
7,5,22,332,524,440,964,"6 de julio de 1997"
7,5,22,333,588,553,1141,"6 de julio de 1997"
7,5,22,334,591,528,1119,"6 de julio de 1997"
7,5,22,335,490,469,959,"6 de julio de 1997"
7,5,23,336,187,190,377,"6 de julio de 1997"
7,5,23,337,220,285,505,"6 de julio de 1997"
7,5,23,338,241,258,499,"6 de julio de 1997"
7,5,23,339,393,446,839,"6 de julio de 1997"
7,5,23,340,241,277,518,"6 de julio de 1997"
7,5,23,341,274,335,609,"6 de julio de 1997"
7,5,23,342,303,331,634,"6 de julio de 1997"
7,5,23,343,367,444,811,"6 de julio de 1997"
7,5,23,344,424,478,902,"6 de julio de 1997"
7,5,23,345,368,382,750,"6 de julio de 1997"
7,5,23,346,319,350,669,"6 de julio de 1997"
7,5,23,347,321,401,722,"6 de julio de 1997"
7,5,23,348,244,328,572,"6 de julio de 1997"
7,5,23,349,318,366,684,"6 de julio de 1997"
7,5,23,350,312,371,683,"6 de julio de 1997"
7,5,23,351,381,435,816,"6 de julio de 1997"
7,5,23,352,261,320,581,"6 de julio de 1997"
7,5,23,353,300,395,695,"6 de julio de 1997"
7,5,23,354,215,255,470,"6 de julio de 1997"
7,5,23,355,331,408,739,"6 de julio de 1997"
7,5,23,356,331,379,710,"6 de julio de 1997"
7,5,23,357,387,418,805,"6 de julio de 1997"
7,5,23,358,511,580,1091,"6 de julio de 1997"
7,5,23,359,385,413,798,"6 de julio de 1997"
7,5,23,360,353,391,744,"6 de julio de 1997"
7,5,23,361,315,373,688,"6 de julio de 1997"
7,5,23,362,396,507,903,"6 de julio de 1997"
7,5,23,363,308,345,653,"6 de julio de 1997"
7,5,23,364,387,496,883,"6 de julio de 1997"
7,5,23,365,279,379,658,"6 de julio de 1997"
7,5,23,366,270,398,668,"6 de julio de 1997"
7,5,23,367,263,384,647,"6 de julio de 1997"
7,5,23,368,382,455,837,"6 de julio de 1997"
7,5,23,369,178,235,413,"6 de julio de 1997"
7,5,23,370,401,470,871,"6 de julio de 1997"
7,5,23,371,295,338,633,"6 de julio de 1997"
7,5,23,372,136,189,325,"6 de julio de 1997"
7,5,23,373,276,319,595,"6 de julio de 1997"
7,5,23,374,302,409,711,"6 de julio de 1997"
7,5,26,384,456,493,949,"6 de julio de 1997"
7,5,26,385,196,173,369,"6 de julio de 1997"
7,5,26,386,527,457,984,"6 de julio de 1997"
7,5,26,387,351,330,681,"6 de julio de 1997"
7,5,26,388,424,407,831,"6 de julio de 1997"
7,5,26,389,541,511,1052,"6 de julio de 1997"
7,5,26,390,379,345,724,"6 de julio de 1997"
7,5,26,391,464,496,960,"6 de julio de 1997"
7,5,26,392,373,354,727,"6 de julio de 1997"
7,5,26,393,633,676,1309,"6 de julio de 1997"
7,5,26,394,416,405,821,"6 de julio de 1997"
7,5,26,395,342,350,692,"6 de julio de 1997"
7,5,26,396,336,344,680,"6 de julio de 1997"
7,5,26,397,391,392,783,"6 de julio de 1997"
7,5,26,398,309,322,631,"6 de julio de 1997"
7,5,26,399,449,488,937,"6 de julio de 1997"
7,5,26,400,414,433,847,"6 de julio de 1997"
7,5,26,401,344,354,698,"6 de julio de 1997"
7,5,39,566,341,370,711,"6 de julio de 1997"
7,5,39,567,274,314,588,"6 de julio de 1997"
7,5,39,568,427,458,885,"6 de julio de 1997"
7,5,39,569,391,435,826,"6 de julio de 1997"
7,5,39,570,490,498,988,"6 de julio de 1997"
7,5,39,571,439,446,885,"6 de julio de 1997"
7,5,39,572,282,310,592,"6 de julio de 1997"
7,5,39,573,324,313,637,"6 de julio de 1997"
7,5,39,574,433,435,868,"6 de julio de 1997"
7,5,39,575,485,526,1011,"6 de julio de 1997"
7,5,39,576,449,492,941,"6 de julio de 1997"
7,5,49,682,422,439,861,"6 de julio de 1997"
7,5,49,683,618,644,1262,"6 de julio de 1997"
7,5,49,684,384,389,773,"6 de julio de 1997"
7,5,49,685,436,426,862,"6 de julio de 1997"
7,5,49,686,420,417,837,"6 de julio de 1997"
7,5,49,687,377,381,758,"6 de julio de 1997"
7,5,49,688,280,287,567,"6 de julio de 1997"
7,5,49,689,424,415,839,"6 de julio de 1997"
7,5,49,690,511,549,1060,"6 de julio de 1997"
7,5,49,691,258,256,514,"6 de julio de 1997"
7,5,56,782,182,183,365,"6 de julio de 1997"
7,5,56,783,186,202,388,"6 de julio de 1997"
7,5,56,784,363,397,760,"6 de julio de 1997"
7,5,56,785,304,332,636,"6 de julio de 1997"
7,5,56,786,287,317,604,"6 de julio de 1997"
7,5,66,977,219,210,429,"6 de julio de 1997"
7,5,66,978,503,478,981,"6 de julio de 1997"
7,5,66,979,533,535,1068,"6 de julio de 1997"
7,5,66,980,327,357,684,"6 de julio de 1997"
7,5,66,981,404,405,809,"6 de julio de 1997"
7,5,66,982,508,466,974,"6 de julio de 1997"
7,5,66,983,412,355,767,"6 de julio de 1997"
7,5,66,984,483,434,917,"6 de julio de 1997"
7,5,77,1113,448,490,938,"6 de julio de 1997"
7,5,77,1114,816,877,1693,"6 de julio de 1997"
7,5,77,1115,520,542,1062,"6 de julio de 1997"
7,5,77,1116,805,856,1661,"6 de julio de 1997"
7,5,77,1117,471,573,1044,"6 de julio de 1997"
7,5,77,1118,456,462,918,"6 de julio de 1997"
7,5,77,1119,359,353,712,"6 de julio de 1997"
7,5,77,1120,881,865,1746,"6 de julio de 1997"
7,5,77,1121,708,764,1472,"6 de julio de 1997"
7,5,77,1122,665,747,1412,"6 de julio de 1997"
7,5,77,1123,557,600,1157,"6 de julio de 1997"
7,5,77,1124,700,832,1532,"6 de julio de 1997"
7,5,77,1125,791,876,1667,"6 de julio de 1997"
7,5,77,1126,550,648,1198,"6 de julio de 1997"
7,5,77,1127,776,888,1664,"6 de julio de 1997"
7,5,77,1128,881,965,1846,"6 de julio de 1997"
7,5,77,1129,607,673,1280,"6 de julio de 1997"
7,5,77,1130,721,521,1242,"6 de julio de 1997"
7,5,77,1131,747,796,1543,"6 de julio de 1997"
7,5,77,1132,454,504,958,"6 de julio de 1997"
7,5,77,1133,542,735,1277,"6 de julio de 1997"
7,5,77,1134,459,599,1058,"6 de julio de 1997"
7,5,77,1135,674,771,1445,"6 de julio de 1997"
7,5,77,1136,454,476,930,"6 de julio de 1997"
7,5,77,1137,719,782,1501,"6 de julio de 1997"
7,5,77,1138,469,588,1057,"6 de julio de 1997"
7,5,77,1139,421,540,961,"6 de julio de 1997"
7,5,77,1140,304,366,670,"6 de julio de 1997"
7,5,77,1141,574,647,1221,"6 de julio de 1997"
7,5,77,1142,755,872,1627,"6 de julio de 1997"
7,5,77,1143,818,884,1702,"6 de julio de 1997"
7,5,77,1144,897,996,1893,"6 de julio de 1997"
7,5,77,1145,935,1057,1992,"6 de julio de 1997"
7,5,77,1146,787,989,1776,"6 de julio de 1997"
7,5,77,1147,509,571,1080,"6 de julio de 1997"
7,5,77,1148,385,404,789,"6 de julio de 1997"
7,5,77,1149,682,788,1470,"6 de julio de 1997"
7,5,77,1150,630,651,1281,"6 de julio de 1997"
7,5,77,1151,1083,1123,2206,"6 de julio de 1997"
7,5,77,1152,317,358,675,"6 de julio de 1997"
7,5,77,1153,314,390,704,"6 de julio de 1997"
7,5,77,1154,396,496,892,"6 de julio de 1997"
7,5,77,1155,331,352,683,"6 de julio de 1997"
7,5,77,1156,165,207,372,"6 de julio de 1997"
7,5,77,1157,369,397,766,"6 de julio de 1997"
7,5,77,1158,259,244,503,"6 de julio de 1997"
7,5,77,1159,284,298,582,"6 de julio de 1997"
7,5,77,1160,907,446,1353,"6 de julio de 1997"
7,5,77,1161,316,328,644,"6 de julio de 1997"
7,5,77,1162,209,196,405,"6 de julio de 1997"
7,5,77,1163,333,327,660,"6 de julio de 1997"
7,5,77,1164,91,104,195,"6 de julio de 1997"
7,5,94,1438,369,424,793,"6 de julio de 1997"
7,5,94,1439,380,405,785,"6 de julio de 1997"
7,5,94,1440,377,362,739,"6 de julio de 1997"
7,5,94,1441,437,514,951,"6 de julio de 1997"
7,5,94,1442,378,423,801,"6 de julio de 1997"
7,5,94,1443,457,512,969,"6 de julio de 1997"
7,5,94,1444,364,369,733,"6 de julio de 1997"
7,5,94,1445,376,379,755,"6 de julio de 1997"
7,5,94,1446,370,359,729,"6 de julio de 1997"
7,5,94,1447,412,389,801,"6 de julio de 1997"
7,5,94,1448,347,361,708,"6 de julio de 1997"
7,5,94,1449,452,455,907,"6 de julio de 1997"
7,5,94,1450,476,547,1023,"6 de julio de 1997"
7,5,94,1451,356,331,687,"6 de julio de 1997"
7,5,94,1452,576,585,1161,"6 de julio de 1997"
7,5,94,1453,323,321,644,"6 de julio de 1997"
7,5,111,1915,333,395,728,"6 de julio de 1997"
7,5,111,1916,343,374,717,"6 de julio de 1997"
7,5,111,1917,246,211,457,"6 de julio de 1997"
7,5,111,1918,406,451,857,"6 de julio de 1997"
7,5,111,1919,252,288,540,"6 de julio de 1997"
7,5,111,1920,648,703,1351,"6 de julio de 1997"
7,5,111,1921,316,352,668,"6 de julio de 1997"
7,5,111,1922,432,525,957,"6 de julio de 1997"
7,5,111,1923,476,587,1063,"6 de julio de 1997"
7,5,111,1924,358,339,697,"6 de julio de 1997"
7,5,111,1925,425,453,878,"6 de julio de 1997"
7,5,111,1926,267,302,569,"6 de julio de 1997"
7,5,111,1927,694,696,1390,"6 de julio de 1997"
7,5,111,1928,298,320,618,"6 de julio de 1997"
7,5,111,1929,360,322,682,"6 de julio de 1997"
7,6,2,7,650,627,1277,"6 de julio de 1997"
7,6,2,8,469,467,936,"6 de julio de 1997"
7,6,2,9,595,545,1140,"6 de julio de 1997"
7,6,2,10,765,734,1499,"6 de julio de 1997"
7,6,2,11,537,540,1077,"6 de julio de 1997"
7,6,2,12,478,461,939,"6 de julio de 1997"
7,6,2,13,424,413,837,"6 de julio de 1997"
7,6,2,14,291,259,550,"6 de julio de 1997"
7,6,2,15,261,207,468,"6 de julio de 1997"
7,6,2,16,426,438,864,"6 de julio de 1997"
7,6,2,17,743,747,1490,"6 de julio de 1997"
7,6,2,18,182,145,327,"6 de julio de 1997"
7,6,2,19,626,509,1135,"6 de julio de 1997"
7,6,2,20,423,354,777,"6 de julio de 1997"
7,6,13,144,513,563,1076,"6 de julio de 1997"
7,6,13,145,591,590,1181,"6 de julio de 1997"
7,6,13,146,407,436,843,"6 de julio de 1997"
7,6,13,147,574,583,1157,"6 de julio de 1997"
7,6,13,148,256,231,487,"6 de julio de 1997"
7,6,13,149,468,414,882,"6 de julio de 1997"
7,6,13,150,294,291,585,"6 de julio de 1997"
7,6,13,151,384,396,780,"6 de julio de 1997"
7,6,13,152,457,434,891,"6 de julio de 1997"
7,6,13,153,246,194,440,"6 de julio de 1997"
7,6,13,154,368,356,724,"6 de julio de 1997"
7,6,20,293,620,588,1208,"6 de julio de 1997"
7,6,20,294,689,663,1352,"6 de julio de 1997"
7,6,20,295,383,372,755,"6 de julio de 1997"
7,6,20,296,342,331,673,"6 de julio de 1997"
7,6,20,297,137,103,240,"6 de julio de 1997"
7,6,20,298,392,365,757,"6 de julio de 1997"
7,6,20,299,822,672,1494,"6 de julio de 1997"
7,6,20,300,565,501,1066,"6 de julio de 1997"
7,6,20,301,437,397,834,"6 de julio de 1997"
7,6,20,302,426,386,812,"6 de julio de 1997"
7,6,20,303,266,226,492,"6 de julio de 1997"
7,6,20,304,105,79,184,"6 de julio de 1997"
7,6,20,305,280,254,534,"6 de julio de 1997"
7,6,20,306,347,306,653,"6 de julio de 1997"
7,6,20,307,372,344,716,"6 de julio de 1997"
7,6,20,308,417,363,780,"6 de julio de 1997"
7,6,20,309,226,178,404,"6 de julio de 1997"
7,6,20,310,383,323,706,"6 de julio de 1997"
7,6,20,311,543,511,1054,"6 de julio de 1997"
7,6,20,312,652,561,1213,"6 de julio de 1997"
7,6,20,313,325,246,571,"6 de julio de 1997"
7,6,20,314,342,244,586,"6 de julio de 1997"
7,6,20,315,637,458,1095,"6 de julio de 1997"
7,6,20,316,349,261,610,"6 de julio de 1997"
7,6,27,402,989,1133,2122,"6 de julio de 1997"
7,6,27,403,507,481,988,"6 de julio de 1997"
7,6,27,404,539,544,1083,"6 de julio de 1997"
7,6,27,405,573,518,1091,"6 de julio de 1997"
7,6,27,406,426,421,847,"6 de julio de 1997"
7,6,27,407,692,717,1409,"6 de julio de 1997"
7,6,27,408,477,553,1030,"6 de julio de 1997"
7,6,27,409,534,602,1136,"6 de julio de 1997"
7,6,27,410,555,627,1182,"6 de julio de 1997"
7,6,27,411,758,770,1528,"6 de julio de 1997"
7,6,27,412,852,811,1663,"6 de julio de 1997"
7,6,27,413,612,517,1129,"6 de julio de 1997"
7,6,27,414,548,510,1058,"6 de julio de 1997"
7,6,27,415,486,395,881,"6 de julio de 1997"
7,6,27,416,546,493,1039,"6 de julio de 1997"
7,6,27,417,424,414,838,"6 de julio de 1997"
7,6,27,418,208,140,348,"6 de julio de 1997"
7,6,27,419,336,317,653,"6 de julio de 1997"
7,6,27,420,235,258,493,"6 de julio de 1997"
7,6,27,421,324,281,605,"6 de julio de 1997"
7,6,27,422,289,268,557,"6 de julio de 1997"
7,6,27,423,421,318,739,"6 de julio de 1997"
7,6,27,424,433,399,832,"6 de julio de 1997"
7,6,27,425,532,470,1002,"6 de julio de 1997"
7,6,27,426,384,372,756,"6 de julio de 1997"
7,6,27,427,330,326,656,"6 de julio de 1997"
7,6,27,428,384,396,780,"6 de julio de 1997"
7,6,27,429,485,437,922,"6 de julio de 1997"
7,6,27,430,360,331,691,"6 de julio de 1997"
7,6,27,431,712,679,1391,"6 de julio de 1997"
7,6,27,432,402,358,760,"6 de julio de 1997"
7,6,28,433,590,530,1120,"6 de julio de 1997"
7,6,28,434,655,621,1276,"6 de julio de 1997"
7,6,28,435,236,217,453,"6 de julio de 1997"
7,6,44,627,552,551,1103,"6 de julio de 1997"
7,6,44,628,567,550,1117,"6 de julio de 1997"
7,6,44,629,459,425,884,"6 de julio de 1997"
7,6,44,630,351,267,618,"6 de julio de 1997"
7,6,44,631,609,536,1145,"6 de julio de 1997"
7,6,44,632,352,340,692,"6 de julio de 1997"
7,6,44,633,311,271,582,"6 de julio de 1997"
7,6,44,634,417,383,800,"6 de julio de 1997"
7,6,44,635,450,441,891,"6 de julio de 1997"
7,6,58,814,836,764,1600,"6 de julio de 1997"
7,6,80,1187,668,613,1281,"6 de julio de 1997"
7,6,80,1188,650,597,1247,"6 de julio de 1997"
7,6,86,1236,594,582,1176,"6 de julio de 1997"
7,6,86,1237,468,445,913,"6 de julio de 1997"
7,6,86,1238,164,160,324,"6 de julio de 1997"
7,6,86,1239,695,628,1323,"6 de julio de 1997"
7,6,98,1530,601,536,1137,"6 de julio de 1997"
7,6,98,1531,652,612,1264,"6 de julio de 1997"
7,6,106,1786,518,461,979,"6 de julio de 1997"
7,6,106,1787,488,477,965,"6 de julio de 1997"
7,6,106,1788,584,540,1124,"6 de julio de 1997"
7,6,106,1789,548,505,1053,"6 de julio de 1997"
7,6,106,1790,583,567,1150,"6 de julio de 1997"
7,6,106,1791,534,512,1046,"6 de julio de 1997"
7,6,106,1792,582,531,1113,"6 de julio de 1997"
7,6,106,1793,651,600,1251,"6 de julio de 1997"
7,6,106,1794,442,383,825,"6 de julio de 1997"
7,6,106,1795,552,442,994,"6 de julio de 1997"
7,6,106,1796,717,665,1382,"6 de julio de 1997"
7,6,106,1797,659,684,1343,"6 de julio de 1997"
7,6,106,1798,839,779,1618,"6 de julio de 1997"
7,6,106,1799,531,530,1061,"6 de julio de 1997"
7,6,106,1800,441,481,922,"6 de julio de 1997"
7,6,106,1801,549,543,1092,"6 de julio de 1997"
7,6,106,1802,647,576,1223,"6 de julio de 1997"
7,6,106,1803,154,106,260,"6 de julio de 1997"
7,6,106,1804,529,479,1008,"6 de julio de 1997"
7,6,106,1805,570,519,1089,"6 de julio de 1997"
7,6,106,1806,561,504,1065,"6 de julio de 1997"
7,6,106,1807,521,477,998,"6 de julio de 1997"
7,6,106,1808,427,354,781,"6 de julio de 1997"
7,6,106,1809,159,127,286,"6 de julio de 1997"
7,6,106,1810,372,322,694,"6 de julio de 1997"
7,6,106,1811,377,318,695,"6 de julio de 1997"
7,6,108,1828,743,693,1436,"6 de julio de 1997"
7,6,108,1829,514,550,1064,"6 de julio de 1997"
7,6,108,1830,501,530,1031,"6 de julio de 1997"
7,6,108,1831,671,648,1319,"6 de julio de 1997"
7,6,108,1832,807,685,1492,"6 de julio de 1997"
7,6,108,1833,706,674,1380,"6 de julio de 1997"
7,6,108,1834,606,586,1192,"6 de julio de 1997"
7,6,108,1835,701,694,1395,"6 de julio de 1997"
7,6,108,1836,289,255,544,"6 de julio de 1997"
7,6,108,1837,757,691,1448,"6 de julio de 1997"
7,6,108,1838,218,178,396,"6 de julio de 1997"
7,6,108,1839,587,562,1149,"6 de julio de 1997"
7,6,108,1840,950,907,1857,"6 de julio de 1997"
7,6,108,1841,942,869,1811,"6 de julio de 1997"
7,6,108,1842,182,123,305,"6 de julio de 1997"
7,6,108,1843,534,473,1007,"6 de julio de 1997"
7,6,108,1844,724,684,1408,"6 de julio de 1997"
7,6,108,1845,958,926,1884,"6 de julio de 1997"
7,6,108,1846,1152,990,2142,"6 de julio de 1997"
7,6,108,1847,421,305,726,"6 de julio de 1997"
7,6,108,1848,440,447,887,"6 de julio de 1997"
7,6,108,1849,534,599,1133,"6 de julio de 1997"
7,6,108,1850,446,438,884,"6 de julio de 1997"
7,6,108,1851,516,420,936,"6 de julio de 1997"
7,6,108,1852,762,439,1201,"6 de julio de 1997"
7,6,108,1853,608,499,1107,"6 de julio de 1997"
7,6,108,1854,600,448,1048,"6 de julio de 1997"
7,6,108,1855,615,409,1024,"6 de julio de 1997"
7,7,9,88,523,516,1039,"6 de julio de 1997"
7,7,9,89,366,452,818,"6 de julio de 1997"
7,7,9,90,391,446,837,"6 de julio de 1997"
7,7,9,91,834,890,1724,"6 de julio de 1997"
7,7,9,92,276,278,554,"6 de julio de 1997"
7,7,9,93,406,450,856,"6 de julio de 1997"
7,7,9,94,375,417,792,"6 de julio de 1997"
7,7,9,95,539,573,1112,"6 de julio de 1997"
7,7,9,96,577,674,1251,"6 de julio de 1997"
7,7,9,97,599,628,1227,"6 de julio de 1997"
7,7,9,98,698,761,1459,"6 de julio de 1997"
7,7,9,99,589,679,1268,"6 de julio de 1997"
7,7,9,100,501,536,1037,"6 de julio de 1997"
7,7,9,101,132,96,228,"6 de julio de 1997"
7,7,9,102,180,147,327,"6 de julio de 1997"
7,7,9,103,449,394,843,"6 de julio de 1997"
7,7,9,104,396,346,742,"6 de julio de 1997"
7,7,9,105,315,257,572,"6 de julio de 1997"
7,7,9,106,583,644,1227,"6 de julio de 1997"
7,7,9,107,167,113,280,"6 de julio de 1997"
7,7,9,108,43,26,69,"6 de julio de 1997"
7,7,9,109,436,388,824,"6 de julio de 1997"
7,7,9,110,420,328,748,"6 de julio de 1997"
7,7,9,111,397,352,749,"6 de julio de 1997"
7,7,9,112,850,742,1592,"6 de julio de 1997"
7,7,17,197,404,379,783,"6 de julio de 1997"
7,7,17,198,459,514,973,"6 de julio de 1997"
7,7,17,199,688,736,1424,"6 de julio de 1997"
7,7,17,200,656,717,1373,"6 de julio de 1997"
7,7,17,201,530,548,1078,"6 de julio de 1997"
7,7,17,202,658,661,1319,"6 de julio de 1997"
7,7,17,203,634,636,1270,"6 de julio de 1997"
7,7,17,204,501,614,1115,"6 de julio de 1997"
7,7,17,205,641,717,1358,"6 de julio de 1997"
7,7,17,206,590,662,1252,"6 de julio de 1997"
7,7,17,207,799,868,1667,"6 de julio de 1997"
7,7,17,208,699,729,1428,"6 de julio de 1997"
7,7,17,209,458,458,916,"6 de julio de 1997"
7,7,17,210,545,594,1139,"6 de julio de 1997"
7,7,17,211,560,613,1173,"6 de julio de 1997"
7,7,17,212,517,578,1095,"6 de julio de 1997"
7,7,17,213,609,406,1015,"6 de julio de 1997"
7,7,17,214,521,432,953,"6 de julio de 1997"
7,7,17,215,527,445,972,"6 de julio de 1997"
7,7,17,216,118,101,219,"6 de julio de 1997"
7,7,17,217,517,393,910,"6 de julio de 1997"
7,7,17,218,353,337,690,"6 de julio de 1997"
7,7,17,219,301,255,556,"6 de julio de 1997"
7,7,17,220,248,208,456,"6 de julio de 1997"
7,7,17,221,282,211,493,"6 de julio de 1997"
7,7,17,222,206,183,389,"6 de julio de 1997"
7,7,17,223,805,722,1527,"6 de julio de 1997"
7,7,17,224,406,385,791,"6 de julio de 1997"
7,7,17,225,487,444,931,"6 de julio de 1997"
7,7,17,226,187,167,354,"6 de julio de 1997"
7,7,17,227,97,69,166,"6 de julio de 1997"
7,7,17,228,254,216,470,"6 de julio de 1997"
7,7,17,229,302,242,544,"6 de julio de 1997"
7,7,17,230,664,568,1232,"6 de julio de 1997"
7,7,17,231,458,416,874,"6 de julio de 1997"
7,7,17,232,610,614,1224,"6 de julio de 1997"
7,7,17,233,427,377,804,"6 de julio de 1997"
7,7,46,638,231,233,464,"6 de julio de 1997"
7,7,46,639,650,670,1320,"6 de julio de 1997"
7,7,46,640,556,578,1134,"6 de julio de 1997"
7,7,46,641,693,683,1376,"6 de julio de 1997"
7,7,46,642,308,312,620,"6 de julio de 1997"
7,7,46,643,366,292,658,"6 de julio de 1997"
7,7,46,644,579,530,1109,"6 de julio de 1997"
7,7,46,645,195,168,363,"6 de julio de 1997"
7,7,46,646,285,264,549,"6 de julio de 1997"
7,7,46,647,552,495,1047,"6 de julio de 1997"
7,7,46,648,363,336,699,"6 de julio de 1997"
7,7,46,649,429,334,763,"6 de julio de 1997"
7,7,46,650,415,382,797,"6 de julio de 1997"
7,7,46,651,667,641,1308,"6 de julio de 1997"
7,7,46,652,728,610,1338,"6 de julio de 1997"
7,7,46,653,480,426,906,"6 de julio de 1997"
7,7,46,654,495,468,963,"6 de julio de 1997"
7,7,46,655,417,402,819,"6 de julio de 1997"
7,7,46,656,211,172,383,"6 de julio de 1997"
7,7,46,657,391,370,761,"6 de julio de 1997"
7,7,46,658,592,565,1157,"6 de julio de 1997"
7,7,46,659,442,434,876,"6 de julio de 1997"
7,7,46,660,382,371,753,"6 de julio de 1997"
7,7,46,661,353,292,645,"6 de julio de 1997"
7,7,69,1008,805,738,1543,"6 de julio de 1997"
7,7,69,1009,502,512,1014,"6 de julio de 1997"
7,7,69,1010,789,847,1636,"6 de julio de 1997"
7,7,69,1011,674,670,1344,"6 de julio de 1997"
7,7,69,1012,463,541,1004,"6 de julio de 1997"
7,7,69,1013,365,415,780,"6 de julio de 1997"
7,7,69,1014,577,595,1172,"6 de julio de 1997"
7,7,69,1015,298,251,549,"6 de julio de 1997"
7,7,69,1016,436,372,808,"6 de julio de 1997"
7,7,69,1017,528,464,992,"6 de julio de 1997"
7,7,69,1018,682,629,1311,"6 de julio de 1997"
7,7,69,1019,370,295,665,"6 de julio de 1997"
7,7,69,1020,350,292,642,"6 de julio de 1997"
7,7,69,1021,706,600,1306,"6 de julio de 1997"
7,7,69,1022,535,475,1010,"6 de julio de 1997"
7,7,69,1023,213,207,420,"6 de julio de 1997"
7,7,69,1024,423,357,780,"6 de julio de 1997"
7,7,69,1025,350,329,679,"6 de julio de 1997"
7,7,69,1026,530,484,1014,"6 de julio de 1997"
7,7,69,1027,232,193,425,"6 de julio de 1997"
7,7,69,1028,613,522,1135,"6 de julio de 1997"
7,7,69,1029,410,346,756,"6 de julio de 1997"
7,7,69,1030,524,441,965,"6 de julio de 1997"
7,7,69,1031,395,285,680,"6 de julio de 1997"
7,7,69,1032,603,519,1122,"6 de julio de 1997"
7,7,69,1033,497,511,1008,"6 de julio de 1997"
7,7,97,1486,385,448,833,"6 de julio de 1997"
7,7,97,1487,573,615,1188,"6 de julio de 1997"
7,7,97,1488,511,565,1076,"6 de julio de 1997"
7,7,97,1489,581,688,1269,"6 de julio de 1997"
7,7,97,1490,800,914,1714,"6 de julio de 1997"
7,7,97,1491,576,669,1245,"6 de julio de 1997"
7,7,97,1492,491,554,1045,"6 de julio de 1997"
7,7,97,1493,496,580,1076,"6 de julio de 1997"
7,7,97,1494,393,464,857,"6 de julio de 1997"
7,7,97,1495,440,589,1029,"6 de julio de 1997"
7,7,97,1496,741,819,1560,"6 de julio de 1997"
7,7,97,1497,382,417,799,"6 de julio de 1997"
7,7,97,1498,536,566,1102,"6 de julio de 1997"
7,7,97,1499,551,597,1148,"6 de julio de 1997"
7,7,97,1500,438,514,952,"6 de julio de 1997"
7,7,97,1501,561,622,1183,"6 de julio de 1997"
7,7,97,1502,512,536,1048,"6 de julio de 1997"
7,7,97,1503,237,205,442,"6 de julio de 1997"
7,7,97,1504,349,319,668,"6 de julio de 1997"
7,7,97,1505,209,131,340,"6 de julio de 1997"
7,7,97,1506,457,406,863,"6 de julio de 1997"
7,7,97,1507,326,293,619,"6 de julio de 1997"
7,7,97,1508,764,737,1501,"6 de julio de 1997"
7,7,97,1509,743,722,1465,"6 de julio de 1997"
7,7,97,1510,782,648,1430,"6 de julio de 1997"
7,7,97,1511,554,500,1054,"6 de julio de 1997"
7,7,97,1512,783,675,1458,"6 de julio de 1997"
7,7,97,1513,332,302,634,"6 de julio de 1997"
7,7,97,1514,251,202,453,"6 de julio de 1997"
7,7,97,1515,403,338,741,"6 de julio de 1997"
7,7,97,1516,853,801,1654,"6 de julio de 1997"
7,7,97,1517,634,531,1165,"6 de julio de 1997"
7,7,97,1518,717,597,1314,"6 de julio de 1997"
7,7,97,1519,247,197,444,"6 de julio de 1997"
7,7,97,1520,601,581,1182,"6 de julio de 1997"
7,7,97,1521,643,657,1300,"6 de julio de 1997"
7,7,97,1522,153,100,253,"6 de julio de 1997"
7,7,97,1523,573,445,1018,"6 de julio de 1997"
7,7,97,1524,199,172,371,"6 de julio de 1997"
7,7,97,1525,545,469,1014,"6 de julio de 1997"
7,7,97,1526,169,142,311,"6 de julio de 1997"
7,7,97,1527,426,390,816,"6 de julio de 1997"
7,7,97,1528,242,229,471,"6 de julio de 1997"
7,7,97,1529,445,35,480,"6 de julio de 1997"
7,8,7,68,466,565,1031,"6 de julio de 1997"
7,8,7,69,282,311,593,"6 de julio de 1997"
7,8,7,70,479,492,971,"6 de julio de 1997"
7,8,7,71,387,398,785,"6 de julio de 1997"
7,8,19,239,736,763,1499,"6 de julio de 1997"
7,8,19,240,738,851,1589,"6 de julio de 1997"
7,8,19,241,365,443,808,"6 de julio de 1997"
7,8,19,242,716,796,1512,"6 de julio de 1997"
7,8,19,243,452,517,969,"6 de julio de 1997"
7,8,19,244,680,716,1396,"6 de julio de 1997"
7,8,19,245,512,590,1102,"6 de julio de 1997"
7,8,19,246,487,625,1112,"6 de julio de 1997"
7,8,19,247,571,669,1240,"6 de julio de 1997"
7,8,19,248,748,867,1615,"6 de julio de 1997"
7,8,19,249,461,476,937,"6 de julio de 1997"
7,8,19,250,595,732,1327,"6 de julio de 1997"
7,8,19,251,566,705,1271,"6 de julio de 1997"
7,8,19,252,352,451,803,"6 de julio de 1997"
7,8,19,253,373,426,799,"6 de julio de 1997"
7,8,19,254,628,764,1392,"6 de julio de 1997"
7,8,19,255,436,442,878,"6 de julio de 1997"
7,8,19,256,565,627,1192,"6 de julio de 1997"
7,8,19,257,701,815,1516,"6 de julio de 1997"
7,8,19,258,378,526,904,"6 de julio de 1997"
7,8,19,259,656,788,1444,"6 de julio de 1997"
7,8,19,260,666,720,1386,"6 de julio de 1997"
7,8,19,261,476,565,1041,"6 de julio de 1997"
7,8,19,262,813,879,1692,"6 de julio de 1997"
7,8,19,263,676,783,1459,"6 de julio de 1997"
7,8,19,264,381,374,755,"6 de julio de 1997"
7,8,19,265,474,510,984,"6 de julio de 1997"
7,8,19,266,767,873,1640,"6 de julio de 1997"
7,8,19,267,246,220,466,"6 de julio de 1997"
7,8,19,268,313,304,617,"6 de julio de 1997"
7,8,19,269,200,185,385,"6 de julio de 1997"
7,8,19,270,425,356,781,"6 de julio de 1997"
7,8,19,271,368,344,712,"6 de julio de 1997"
7,8,19,272,303,274,577,"6 de julio de 1997"
7,8,19,273,462,411,873,"6 de julio de 1997"
7,8,19,274,190,155,345,"6 de julio de 1997"
7,8,19,275,383,370,753,"6 de julio de 1997"
7,8,19,276,277,293,570,"6 de julio de 1997"
7,8,19,277,331,322,653,"6 de julio de 1997"
7,8,19,278,214,184,398,"6 de julio de 1997"
7,8,19,279,537,506,1043,"6 de julio de 1997"
7,8,19,280,359,353,712,"6 de julio de 1997"
7,8,19,281,382,345,727,"6 de julio de 1997"
7,8,19,282,458,446,904,"6 de julio de 1997"
7,8,19,283,398,364,762,"6 de julio de 1997"
7,8,19,284,350,378,728,"6 de julio de 1997"
7,8,19,285,245,272,517,"6 de julio de 1997"
7,8,19,286,342,373,715,"6 de julio de 1997"
7,8,19,287,377,432,809,"6 de julio de 1997"
7,8,19,288,544,206,750,"6 de julio de 1997"
7,8,19,289,500,520,1020,"6 de julio de 1997"
7,8,19,290,430,415,845,"6 de julio de 1997"
7,8,19,291,344,326,670,"6 de julio de 1997"
7,8,19,292,554,61,615,"6 de julio de 1997"
7,8,24,375,304,324,628,"6 de julio de 1997"
7,8,24,376,370,394,764,"6 de julio de 1997"
7,8,24,377,207,175,382,"6 de julio de 1997"
7,8,24,378,147,162,309,"6 de julio de 1997"
7,8,24,379,149,144,293,"6 de julio de 1997"
7,8,24,380,532,514,1046,"6 de julio de 1997"
7,8,41,602,683,714,1397,"6 de julio de 1997"
7,8,41,603,359,425,784,"6 de julio de 1997"
7,8,41,604,598,596,1194,"6 de julio de 1997"
7,8,41,605,486,484,970,"6 de julio de 1997"
7,8,41,606,531,519,1050,"6 de julio de 1997"
7,8,41,607,612,605,1217,"6 de julio de 1997"
7,8,41,608,902,817,1719,"6 de julio de 1997"
7,8,41,609,354,323,677,"6 de julio de 1997"
7,8,41,610,361,336,697,"6 de julio de 1997"
7,8,41,611,184,187,371,"6 de julio de 1997"
7,8,41,612,652,620,1272,"6 de julio de 1997"
7,8,41,613,510,472,982,"6 de julio de 1997"
7,8,41,614,609,560,1169,"6 de julio de 1997"
7,8,41,615,463,428,891,"6 de julio de 1997"
7,8,41,616,423,406,829,"6 de julio de 1997"
7,8,74,1070,346,339,685,"6 de julio de 1997"
7,8,74,1071,392,369,761,"6 de julio de 1997"
7,8,74,1072,300,301,601,"6 de julio de 1997"
7,8,74,1073,335,329,664,"6 de julio de 1997"
7,8,74,1074,495,488,983,"6 de julio de 1997"
7,8,74,1075,345,369,714,"6 de julio de 1997"
7,8,74,1076,498,460,958,"6 de julio de 1997"
7,8,74,1077,405,428,833,"6 de julio de 1997"
7,8,74,1078,517,526,1043,"6 de julio de 1997"
7,8,74,1079,466,409,875,"6 de julio de 1997"
7,8,74,1080,345,305,650,"6 de julio de 1997"
7,8,74,1081,332,274,606,"6 de julio de 1997"
7,8,84,1226,670,660,1330,"6 de julio de 1997"
7,8,84,1227,682,638,1320,"6 de julio de 1997"
7,8,84,1228,406,336,742,"6 de julio de 1997"
7,8,84,1229,253,225,478,"6 de julio de 1997"
7,8,84,1230,459,421,880,"6 de julio de 1997"
7,8,84,1231,549,452,1001,"6 de julio de 1997"
7,8,84,1232,627,533,1160,"6 de julio de 1997"
7,8,95,1454,607,561,1168,"6 de julio de 1997"
7,8,95,1455,618,607,1225,"6 de julio de 1997"
7,8,95,1456,604,601,1205,"6 de julio de 1997"
7,8,95,1457,467,451,918,"6 de julio de 1997"
7,8,95,1458,412,417,829,"6 de julio de 1997"
7,8,95,1459,357,365,722,"6 de julio de 1997"
7,8,95,1460,480,556,1036,"6 de julio de 1997"
7,8,95,1461,500,525,1025,"6 de julio de 1997"
7,8,95,1462,555,590,1145,"6 de julio de 1997"
7,8,95,1463,712,616,1328,"6 de julio de 1997"
7,8,99,1532,88,88,176,"6 de julio de 1997"
7,8,99,1533,528,542,1070,"6 de julio de 1997"
7,8,99,1534,283,295,578,"6 de julio de 1997"
7,8,99,1535,419,391,810,"6 de julio de 1997"
7,8,99,1536,732,780,1512,"6 de julio de 1997"
7,8,99,1537,503,479,982,"6 de julio de 1997"
7,8,99,1538,357,375,732,"6 de julio de 1997"
7,8,99,1539,627,630,1257,"6 de julio de 1997"
7,8,99,1540,420,423,843,"6 de julio de 1997"
7,8,99,1541,551,503,1054,"6 de julio de 1997"
7,8,99,1542,555,554,1109,"6 de julio de 1997"
7,8,99,1543,450,407,857,"6 de julio de 1997"
7,8,99,1544,498,504,1002,"6 de julio de 1997"
7,8,99,1545,295,247,542,"6 de julio de 1997"
7,8,99,1546,309,281,590,"6 de julio de 1997"
7,8,99,1547,231,197,428,"6 de julio de 1997"
7,8,99,1548,291,246,537,"6 de julio de 1997"
7,8,99,1549,210,180,390,"6 de julio de 1997"
7,8,99,1550,293,271,564,"6 de julio de 1997"
7,8,99,1551,471,429,900,"6 de julio de 1997"
7,8,99,1552,522,464,986,"6 de julio de 1997"
7,8,99,1553,285,269,554,"6 de julio de 1997"
7,8,99,1554,468,471,939,"6 de julio de 1997"
7,8,99,1555,231,220,451,"6 de julio de 1997"
7,8,99,1556,462,398,860,"6 de julio de 1997"
7,8,99,1557,328,316,644,"6 de julio de 1997"
7,8,99,1558,36,32,68,"6 de julio de 1997"
7,8,99,1559,547,657,1204,"6 de julio de 1997"
7,8,99,1560,208,233,441,"6 de julio de 1997"
7,8,99,1561,437,464,901,"6 de julio de 1997"
7,8,99,1562,365,371,736,"6 de julio de 1997"
7,8,99,1563,103,81,184,"6 de julio de 1997"
7,8,99,1564,479,441,920,"6 de julio de 1997"
7,8,99,1565,542,474,1016,"6 de julio de 1997"
7,8,99,1566,449,451,900,"6 de julio de 1997"
7,8,99,1567,397,395,792,"6 de julio de 1997"
7,8,104,1771,601,672,1273,"6 de julio de 1997"
7,8,104,1772,232,254,486,"6 de julio de 1997"
7,8,104,1773,302,307,609,"6 de julio de 1997"
7,8,104,1774,350,341,691,"6 de julio de 1997"
7,8,104,1775,622,616,1238,"6 de julio de 1997"
7,8,104,1776,432,381,813,"6 de julio de 1997"
7,8,104,1777,486,455,941,"6 de julio de 1997"
7,9,102,1602,482,475,957,"6 de julio de 1997"
7,9,102,1603,627,672,1299,"6 de julio de 1997"
7,9,102,1604,696,746,1442,"6 de julio de 1997"
7,9,102,1605,575,652,1227,"6 de julio de 1997"
7,9,102,1606,1255,1379,2634,"6 de julio de 1997"
7,9,102,1607,428,488,916,"6 de julio de 1997"
7,9,102,1608,1016,1094,2110,"6 de julio de 1997"
7,9,102,1609,691,736,1427,"6 de julio de 1997"
7,9,102,1610,895,974,1869,"6 de julio de 1997"
7,9,102,1611,735,840,1575,"6 de julio de 1997"
7,9,102,1612,818,928,1746,"6 de julio de 1997"
7,9,102,1613,863,880,1743,"6 de julio de 1997"
7,9,102,1614,756,814,1570,"6 de julio de 1997"
7,9,102,1615,781,789,1570,"6 de julio de 1997"
7,9,102,1616,935,1002,1937,"6 de julio de 1997"
7,9,102,1617,887,904,1791,"6 de julio de 1997"
7,9,102,1618,700,864,1564,"6 de julio de 1997"
7,9,102,1619,593,700,1293,"6 de julio de 1997"
7,9,102,1620,673,835,1508,"6 de julio de 1997"
7,9,102,1621,331,426,757,"6 de julio de 1997"
7,9,102,1622,801,880,1681,"6 de julio de 1997"
7,9,102,1623,520,539,1059,"6 de julio de 1997"
7,9,102,1624,766,803,1569,"6 de julio de 1997"
7,9,102,1625,871,843,1714,"6 de julio de 1997"
7,9,102,1626,595,732,1327,"6 de julio de 1997"
7,9,102,1627,592,727,1319,"6 de julio de 1997"
7,9,102,1628,529,676,1205,"6 de julio de 1997"
7,9,102,1629,823,943,1766,"6 de julio de 1997"
7,9,102,1630,710,797,1507,"6 de julio de 1997"
7,9,102,1631,709,778,1487,"6 de julio de 1997"
7,9,102,1632,328,351,679,"6 de julio de 1997"
7,9,102,1633,695,863,1558,"6 de julio de 1997"
7,9,102,1634,430,530,960,"6 de julio de 1997"
7,9,102,1635,270,271,541,"6 de julio de 1997"
7,9,102,1636,724,794,1518,"6 de julio de 1997"
7,9,102,1637,781,883,1664,"6 de julio de 1997"
7,9,102,1638,746,615,1361,"6 de julio de 1997"
7,9,102,1639,731,682,1413,"6 de julio de 1997"
7,9,102,1640,1210,1275,2485,"6 de julio de 1997"
7,9,102,1641,614,774,1388,"6 de julio de 1997"
7,9,102,1642,414,482,896,"6 de julio de 1997"
7,9,102,1643,518,637,1155,"6 de julio de 1997"
7,9,102,1644,478,567,1045,"6 de julio de 1997"
7,9,102,1645,618,735,1353,"6 de julio de 1997"
7,9,102,1646,684,812,1496,"6 de julio de 1997"
7,9,102,1647,792,852,1644,"6 de julio de 1997"
7,9,102,1648,594,687,1281,"6 de julio de 1997"
7,9,102,1649,631,765,1396,"6 de julio de 1997"
7,9,102,1650,421,428,849,"6 de julio de 1997"
7,9,102,1651,738,810,1548,"6 de julio de 1997"
7,9,102,1652,596,667,1263,"6 de julio de 1997"
7,9,102,1653,634,755,1389,"6 de julio de 1997"
7,9,102,1654,546,642,1188,"6 de julio de 1997"
7,9,102,1655,706,849,1555,"6 de julio de 1997"
7,9,102,1656,548,678,1226,"6 de julio de 1997"
7,9,102,1657,764,901,1665,"6 de julio de 1997"
7,9,102,1658,986,1050,2036,"6 de julio de 1997"
7,9,102,1659,614,668,1282,"6 de julio de 1997"
7,9,102,1660,784,800,1584,"6 de julio de 1997"
7,9,102,1661,759,864,1623,"6 de julio de 1997"
7,9,102,1662,684,802,1486,"6 de julio de 1997"
7,9,102,1663,836,907,1743,"6 de julio de 1997"
7,9,102,1664,704,870,1574,"6 de julio de 1997"
7,9,102,1665,511,558,1069,"6 de julio de 1997"
7,9,102,1666,773,785,1558,"6 de julio de 1997"
7,9,102,1667,442,489,931,"6 de julio de 1997"
7,9,102,1668,699,811,1510,"6 de julio de 1997"
7,9,102,1669,661,828,1489,"6 de julio de 1997"
7,9,102,1670,480,593,1073,"6 de julio de 1997"
7,9,102,1671,593,655,1248,"6 de julio de 1997"
7,9,102,1672,577,664,1241,"6 de julio de 1997"
7,9,102,1673,729,790,1519,"6 de julio de 1997"
7,9,102,1674,517,589,1106,"6 de julio de 1997"
7,9,102,1675,354,433,787,"6 de julio de 1997"
7,9,102,1676,498,618,1116,"6 de julio de 1997"
7,9,102,1677,335,408,743,"6 de julio de 1997"
7,9,102,1678,437,513,950,"6 de julio de 1997"
7,9,102,1679,529,625,1154,"6 de julio de 1997"
7,9,102,1680,620,752,1372,"6 de julio de 1997"
7,9,102,1681,506,675,1181,"6 de julio de 1997"
7,9,102,1682,705,791,1496,"6 de julio de 1997"
7,9,102,1683,711,826,1537,"6 de julio de 1997"
7,9,102,1684,696,762,1458,"6 de julio de 1997"
7,9,102,1685,849,1048,1897,"6 de julio de 1997"
7,9,102,1686,854,969,1823,"6 de julio de 1997"
7,9,102,1687,514,541,1055,"6 de julio de 1997"
7,9,102,1688,526,605,1131,"6 de julio de 1997"
7,9,102,1689,775,871,1646,"6 de julio de 1997"
7,9,102,1690,715,806,1521,"6 de julio de 1997"
7,9,102,1691,617,771,1388,"6 de julio de 1997"
7,9,102,1692,561,600,1161,"6 de julio de 1997"
7,9,102,1693,498,599,1097,"6 de julio de 1997"
7,9,102,1694,554,624,1178,"6 de julio de 1997"
7,9,102,1695,590,649,1239,"6 de julio de 1997"
7,9,102,1696,387,498,885,"6 de julio de 1997"
7,9,102,1697,411,479,890,"6 de julio de 1997"
7,9,102,1698,800,943,1743,"6 de julio de 1997"
7,9,102,1699,641,735,1376,"6 de julio de 1997"
7,9,102,1700,877,1004,1881,"6 de julio de 1997"
7,9,102,1701,542,573,1115,"6 de julio de 1997"
7,9,102,1702,638,653,1291,"6 de julio de 1997"
7,9,102,1703,843,895,1738,"6 de julio de 1997"
7,9,102,1704,782,790,1572,"6 de julio de 1997"
7,9,102,1705,678,712,1390,"6 de julio de 1997"
7,9,102,1706,771,841,1612,"6 de julio de 1997"
7,9,102,1707,961,1073,2034,"6 de julio de 1997"
7,9,102,1708,846,876,1722,"6 de julio de 1997"
7,9,102,1709,758,902,1660,"6 de julio de 1997"
7,9,102,1710,361,430,791,"6 de julio de 1997"
7,9,102,1711,436,475,911,"6 de julio de 1997"
7,9,102,1712,644,768,1412,"6 de julio de 1997"
7,9,102,1713,736,804,1540,"6 de julio de 1997"
7,9,102,1714,777,886,1663,"6 de julio de 1997"
7,9,102,1715,680,756,1436,"6 de julio de 1997"
7,9,102,1716,723,817,1540,"6 de julio de 1997"
7,9,102,1717,1009,1060,2069,"6 de julio de 1997"
7,9,102,1718,478,547,1025,"6 de julio de 1997"
7,9,102,1719,423,478,901,"6 de julio de 1997"
7,9,102,1720,631,756,1387,"6 de julio de 1997"
7,9,102,1721,703,848,1551,"6 de julio de 1997"
7,9,102,1722,509,510,1019,"6 de julio de 1997"
7,9,102,1723,796,902,1698,"6 de julio de 1997"
7,9,102,1724,691,797,1488,"6 de julio de 1997"
7,9,102,1725,714,824,1538,"6 de julio de 1997"
7,9,102,1726,772,820,1592,"6 de julio de 1997"
7,9,102,1727,634,727,1361,"6 de julio de 1997"
7,9,102,1728,434,484,918,"6 de julio de 1997"
7,9,102,1729,999,1083,2082,"6 de julio de 1997"
7,9,102,1730,974,1007,1981,"6 de julio de 1997"
7,9,102,1731,795,917,1712,"6 de julio de 1997"
7,9,102,1732,769,850,1619,"6 de julio de 1997"
7,9,102,1733,765,866,1631,"6 de julio de 1997"
7,9,102,1734,653,667,1320,"6 de julio de 1997"
7,9,102,1735,1085,1155,2240,"6 de julio de 1997"
7,9,102,1736,1032,1144,2176,"6 de julio de 1997"
7,9,102,1737,755,703,1458,"6 de julio de 1997"
7,9,102,1738,703,649,1352,"6 de julio de 1997"
7,9,102,1739,502,568,1070,"6 de julio de 1997"
7,9,102,1740,585,651,1236,"6 de julio de 1997"
7,9,102,1741,662,739,1401,"6 de julio de 1997"
7,9,102,1742,896,857,1753,"6 de julio de 1997"
7,9,102,1743,682,710,1392,"6 de julio de 1997"
7,9,102,1744,739,743,1482,"6 de julio de 1997"
7,9,102,1745,609,599,1208,"6 de julio de 1997"
7,9,102,1746,440,419,859,"6 de julio de 1997"
7,9,102,1747,718,713,1431,"6 de julio de 1997"
7,9,102,1748,214,175,389,"6 de julio de 1997"
7,9,102,1749,581,625,1206,"6 de julio de 1997"
7,9,102,1750,598,673,1271,"6 de julio de 1997"
7,9,102,1751,550,584,1134,"6 de julio de 1997"
7,9,102,1752,579,140,719,"6 de julio de 1997"
7,9,102,1753,403,77,480,"6 de julio de 1997"
7,9,102,1754,183,247,430,"6 de julio de 1997"
7,10,6,54,568,543,1111,"6 de julio de 1997"
7,10,6,55,271,266,537,"6 de julio de 1997"
7,10,6,56,281,256,537,"6 de julio de 1997"
7,10,6,57,417,395,812,"6 de julio de 1997"
7,10,6,58,206,188,394,"6 de julio de 1997"
7,10,6,59,357,304,661,"6 de julio de 1997"
7,10,6,60,445,455,900,"6 de julio de 1997"
7,10,6,61,555,482,1037,"6 de julio de 1997"
7,10,6,62,572,539,1111,"6 de julio de 1997"
7,10,6,63,171,168,339,"6 de julio de 1997"
7,10,6,64,551,507,1058,"6 de julio de 1997"
7,10,6,65,423,403,826,"6 de julio de 1997"
7,10,6,66,504,469,973,"6 de julio de 1997"
7,10,6,67,422,367,789,"6 de julio de 1997"
7,10,8,72,538,525,1063,"6 de julio de 1997"
7,10,8,73,583,544,1127,"6 de julio de 1997"
7,10,8,74,435,415,850,"6 de julio de 1997"
7,10,8,75,466,400,866,"6 de julio de 1997"
7,10,8,76,498,428,926,"6 de julio de 1997"
7,10,8,77,486,403,889,"6 de julio de 1997"
7,10,8,78,721,591,1312,"6 de julio de 1997"
7,10,8,79,320,205,525,"6 de julio de 1997"
7,10,8,80,386,278,664,"6 de julio de 1997"
7,10,8,81,209,164,373,"6 de julio de 1997"
7,10,8,82,365,322,687,"6 de julio de 1997"
7,10,8,83,451,365,816,"6 de julio de 1997"
7,10,8,84,339,275,614,"6 de julio de 1997"
7,10,8,85,50,34,84,"6 de julio de 1997"
7,10,8,86,291,215,506,"6 de julio de 1997"
7,10,8,87,350,278,628,"6 de julio de 1997"
7,10,10,113,438,425,863,"6 de julio de 1997"
7,10,10,114,644,610,1254,"6 de julio de 1997"
7,10,10,115,442,415,857,"6 de julio de 1997"
7,10,11,116,236,236,472,"6 de julio de 1997"
7,10,11,117,470,428,898,"6 de julio de 1997"
7,10,11,118,224,217,441,"6 de julio de 1997"
7,10,11,119,146,140,286,"6 de julio de 1997"
7,10,11,120,267,271,538,"6 de julio de 1997"
7,10,11,121,373,377,750,"6 de julio de 1997"
7,10,11,122,220,219,439,"6 de julio de 1997"
7,10,11,123,334,271,605,"6 de julio de 1997"
7,10,11,124,427,343,770,"6 de julio de 1997"
7,10,11,125,154,153,307,"6 de julio de 1997"
7,10,11,126,417,377,794,"6 de julio de 1997"
7,10,11,127,222,204,426,"6 de julio de 1997"
7,10,11,128,573,507,1080,"6 de julio de 1997"
7,10,11,129,111,114,225,"6 de julio de 1997"
7,10,30,439,342,339,681,"6 de julio de 1997"
7,10,30,440,493,486,979,"6 de julio de 1997"
7,10,30,441,375,376,751,"6 de julio de 1997"
7,10,30,442,296,245,541,"6 de julio de 1997"
7,10,30,443,168,154,322,"6 de julio de 1997"
7,10,30,444,741,647,1388,"6 de julio de 1997"
7,10,30,445,318,227,545,"6 de julio de 1997"
7,10,30,446,285,233,518,"6 de julio de 1997"
7,10,30,447,520,423,943,"6 de julio de 1997"
7,10,30,448,425,375,800,"6 de julio de 1997"
7,10,30,449,398,332,730,"6 de julio de 1997"
7,10,30,450,319,294,613,"6 de julio de 1997"
7,10,30,451,370,327,697,"6 de julio de 1997"
7,10,30,452,351,330,681,"6 de julio de 1997"
7,10,30,453,248,233,481,"6 de julio de 1997"
7,10,30,454,509,439,948,"6 de julio de 1997"
7,10,30,455,301,271,572,"6 de julio de 1997"
7,10,34,504,672,635,1307,"6 de julio de 1997"
7,10,34,505,649,658,1307,"6 de julio de 1997"
7,10,34,506,789,728,1517,"6 de julio de 1997"
7,10,34,507,1008,848,1856,"6 de julio de 1997"
7,10,34,508,559,530,1089,"6 de julio de 1997"
7,10,34,509,354,324,678,"6 de julio de 1997"
7,10,34,510,187,155,342,"6 de julio de 1997"
7,10,34,511,616,580,1196,"6 de julio de 1997"
7,10,34,512,508,481,989,"6 de julio de 1997"
7,10,34,513,320,290,610,"6 de julio de 1997"
7,10,34,514,440,427,867,"6 de julio de 1997"
7,10,34,515,97,88,185,"6 de julio de 1997"
7,10,34,516,259,232,491,"6 de julio de 1997"
7,10,34,517,420,384,804,"6 de julio de 1997"
7,10,34,518,180,176,356,"6 de julio de 1997"
7,10,34,519,55,51,106,"6 de julio de 1997"
7,10,34,520,605,524,1129,"6 de julio de 1997"
7,10,34,521,452,410,862,"6 de julio de 1997"
7,10,34,522,132,127,259,"6 de julio de 1997"
7,10,34,523,278,253,531,"6 de julio de 1997"
7,10,34,524,276,239,515,"6 de julio de 1997"
7,10,34,525,323,284,607,"6 de julio de 1997"
7,10,34,526,306,261,567,"6 de julio de 1997"
7,10,34,527,349,282,631,"6 de julio de 1997"
7,10,34,528,181,158,339,"6 de julio de 1997"
7,10,34,529,661,583,1244,"6 de julio de 1997"
7,10,34,530,463,442,905,"6 de julio de 1997"
7,10,34,531,320,311,631,"6 de julio de 1997"
7,10,36,537,515,493,1008,"6 de julio de 1997"
7,10,36,538,347,346,693,"6 de julio de 1997"
7,10,36,539,410,428,838,"6 de julio de 1997"
7,10,53,760,486,464,950,"6 de julio de 1997"
7,10,53,761,313,295,608,"6 de julio de 1997"
7,10,53,762,418,368,786,"6 de julio de 1997"
7,10,53,763,346,286,632,"6 de julio de 1997"
7,10,53,764,312,284,596,"6 de julio de 1997"
7,10,57,787,346,298,644,"6 de julio de 1997"
7,10,57,788,527,549,1076,"6 de julio de 1997"
7,10,57,789,542,607,1149,"6 de julio de 1997"
7,10,57,790,642,624,1266,"6 de julio de 1997"
7,10,57,791,457,399,856,"6 de julio de 1997"
7,10,57,792,604,573,1177,"6 de julio de 1997"
7,10,57,793,671,717,1388,"6 de julio de 1997"
7,10,57,794,529,485,1014,"6 de julio de 1997"
7,10,57,795,379,295,674,"6 de julio de 1997"
7,10,57,796,426,353,779,"6 de julio de 1997"
7,10,57,797,641,517,1158,"6 de julio de 1997"
7,10,57,798,436,391,827,"6 de julio de 1997"
7,10,57,799,450,352,802,"6 de julio de 1997"
7,10,57,800,280,235,515,"6 de julio de 1997"
7,10,57,801,330,261,591,"6 de julio de 1997"
7,10,57,802,562,452,1014,"6 de julio de 1997"
7,10,57,803,296,268,564,"6 de julio de 1997"
7,10,57,804,318,315,633,"6 de julio de 1997"
7,10,57,805,617,458,1075,"6 de julio de 1997"
7,10,57,806,1037,893,1930,"6 de julio de 1997"
7,10,57,807,356,255,611,"6 de julio de 1997"
7,10,57,808,416,363,779,"6 de julio de 1997"
7,10,57,809,474,402,876,"6 de julio de 1997"
7,10,57,810,731,562,1293,"6 de julio de 1997"
7,10,57,811,456,381,837,"6 de julio de 1997"
7,10,57,812,396,354,750,"6 de julio de 1997"
7,10,57,813,671,536,1207,"6 de julio de 1997"
7,10,70,1034,695,646,1341,"6 de julio de 1997"
7,10,70,1035,433,513,946,"6 de julio de 1997"
7,10,70,1036,458,472,930,"6 de julio de 1997"
7,10,70,1037,577,562,1139,"6 de julio de 1997"
7,10,70,1038,549,498,1047,"6 de julio de 1997"
7,10,81,1189,611,531,1142,"6 de julio de 1997"
7,10,81,1190,620,586,1206,"6 de julio de 1997"
7,10,81,1191,179,137,316,"6 de julio de 1997"
7,10,81,1192,336,261,597,"6 de julio de 1997"
7,10,81,1193,395,309,704,"6 de julio de 1997"
7,10,81,1194,442,397,839,"6 de julio de 1997"
7,10,81,1195,469,385,854,"6 de julio de 1997"
7,10,81,1196,352,238,590,"6 de julio de 1997"
7,10,81,1197,424,322,746,"6 de julio de 1997"
7,10,81,1198,360,298,658,"6 de julio de 1997"
7,10,81,1199,428,378,806,"6 de julio de 1997"
7,10,81,1200,533,480,1013,"6 de julio de 1997"
7,10,81,1201,349,349,698,"6 de julio de 1997"
7,10,81,1202,318,312,630,"6 de julio de 1997"
7,10,81,1203,482,463,945,"6 de julio de 1997"
7,10,81,1204,425,353,778,"6 de julio de 1997"
7,10,81,1205,575,455,1030,"6 de julio de 1997"
7,10,81,1206,407,323,730,"6 de julio de 1997"
7,11,1,1,697,623,1320,"6 de julio de 1997"
7,11,1,2,647,633,1280,"6 de julio de 1997"
7,11,1,3,641,589,1230,"6 de julio de 1997"
7,11,1,4,227,169,396,"6 de julio de 1997"
7,11,1,5,407,306,713,"6 de julio de 1997"
7,11,1,6,662,582,1244,"6 de julio de 1997"
7,11,3,21,302,321,623,"6 de julio de 1997"
7,11,3,22,386,375,761,"6 de julio de 1997"
7,11,3,23,362,392,754,"6 de julio de 1997"
7,11,3,24,510,538,1048,"6 de julio de 1997"
7,11,3,25,678,550,1228,"6 de julio de 1997"
7,11,3,26,673,691,1364,"6 de julio de 1997"
7,11,3,27,605,546,1151,"6 de julio de 1997"
7,11,3,28,593,480,1073,"6 de julio de 1997"
7,11,3,29,448,369,817,"6 de julio de 1997"
7,11,3,30,338,295,633,"6 de julio de 1997"
7,11,3,31,408,343,751,"6 de julio de 1997"
7,11,3,32,411,336,747,"6 de julio de 1997"
7,11,3,33,228,175,403,"6 de julio de 1997"
7,11,3,34,777,665,1442,"6 de julio de 1997"
7,11,32,489,479,443,922,"6 de julio de 1997"
7,11,32,490,740,715,1455,"6 de julio de 1997"
7,11,32,491,740,824,1564,"6 de julio de 1997"
7,11,32,492,342,268,610,"6 de julio de 1997"
7,11,32,493,464,379,843,"6 de julio de 1997"
7,11,32,494,517,357,874,"6 de julio de 1997"
7,11,32,495,315,281,596,"6 de julio de 1997"
7,11,32,496,654,638,1292,"6 de julio de 1997"
7,11,32,497,510,432,942,"6 de julio de 1997"
7,11,32,498,519,481,1000,"6 de julio de 1997"
7,11,32,499,390,315,705,"6 de julio de 1997"
7,11,32,500,533,468,1001,"6 de julio de 1997"
7,11,32,501,430,430,860,"6 de julio de 1997"
7,11,37,540,738,696,1434,"6 de julio de 1997"
7,11,37,541,581,610,1191,"6 de julio de 1997"
7,11,37,542,596,580,1176,"6 de julio de 1997"
7,11,37,543,697,692,1389,"6 de julio de 1997"
7,11,37,544,345,305,650,"6 de julio de 1997"
7,11,37,545,530,483,1013,"6 de julio de 1997"
7,11,37,546,451,416,867,"6 de julio de 1997"
7,11,37,547,457,382,839,"6 de julio de 1997"
7,11,37,548,744,782,1526,"6 de julio de 1997"
7,11,37,549,309,275,584,"6 de julio de 1997"
7,11,37,550,318,268,586,"6 de julio de 1997"
7,11,37,551,245,223,468,"6 de julio de 1997"
7,11,37,552,654,558,1212,"6 de julio de 1997"
7,11,37,553,682,751,1433,"6 de julio de 1997"
7,11,37,554,525,497,1022,"6 de julio de 1997"
7,11,37,555,342,362,704,"6 de julio de 1997"
7,11,40,577,611,595,1206,"6 de julio de 1997"
7,11,40,578,772,738,1510,"6 de julio de 1997"
7,11,40,579,514,557,1071,"6 de julio de 1997"
7,11,40,580,753,790,1543,"6 de julio de 1997"
7,11,40,581,298,309,607,"6 de julio de 1997"
7,11,40,582,557,680,1237,"6 de julio de 1997"
7,11,40,583,454,532,986,"6 de julio de 1997"
7,11,40,584,721,811,1532,"6 de julio de 1997"
7,11,40,585,448,557,1005,"6 de julio de 1997"
7,11,40,586,695,745,1440,"6 de julio de 1997"
7,11,40,587,715,806,1521,"6 de julio de 1997"
7,11,40,588,601,703,1304,"6 de julio de 1997"
7,11,40,589,728,709,1437,"6 de julio de 1997"
7,11,40,590,405,392,797,"6 de julio de 1997"
7,11,40,591,378,311,689,"6 de julio de 1997"
7,11,40,592,339,236,575,"6 de julio de 1997"
7,11,40,593,505,413,918,"6 de julio de 1997"
7,11,40,594,494,435,929,"6 de julio de 1997"
7,11,40,595,459,443,902,"6 de julio de 1997"
7,11,40,596,473,452,925,"6 de julio de 1997"
7,11,40,597,554,474,1028,"6 de julio de 1997"
7,11,40,598,612,560,1172,"6 de julio de 1997"
7,11,40,599,541,477,1018,"6 de julio de 1997"
7,11,40,600,348,316,664,"6 de julio de 1997"
7,11,40,601,122,93,215,"6 de julio de 1997"
7,11,51,697,516,545,1061,"6 de julio de 1997"
7,11,51,698,563,589,1152,"6 de julio de 1997"
7,11,51,699,428,510,938,"6 de julio de 1997"
7,11,51,700,565,583,1148,"6 de julio de 1997"
7,11,51,701,518,536,1054,"6 de julio de 1997"
7,11,51,702,328,400,728,"6 de julio de 1997"
7,11,51,703,398,415,813,"6 de julio de 1997"
7,11,51,704,416,467,883,"6 de julio de 1997"
7,11,51,705,684,515,1199,"6 de julio de 1997"
7,11,51,706,669,484,1153,"6 de julio de 1997"
7,11,51,707,177,143,320,"6 de julio de 1997"
7,11,51,708,556,510,1066,"6 de julio de 1997"
7,11,51,709,470,391,861,"6 de julio de 1997"
7,11,51,710,474,362,836,"6 de julio de 1997"
7,11,51,711,134,114,248,"6 de julio de 1997"
7,11,51,712,498,413,911,"6 de julio de 1997"
7,11,51,713,624,493,1117,"6 de julio de 1997"
7,11,51,714,711,626,1337,"6 de julio de 1997"
7,11,51,715,442,360,802,"6 de julio de 1997"
7,11,51,716,408,310,718,"6 de julio de 1997"
7,11,51,717,327,272,599,"6 de julio de 1997"
7,11,54,765,798,794,1592,"6 de julio de 1997"
7,11,54,766,717,715,1432,"6 de julio de 1997"
7,11,54,767,753,731,1484,"6 de julio de 1997"
7,11,54,768,168,135,303,"6 de julio de 1997"
7,11,54,769,409,359,768,"6 de julio de 1997"
7,11,54,770,380,354,734,"6 de julio de 1997"
7,11,54,771,250,249,499,"6 de julio de 1997"
7,11,54,772,573,527,1100,"6 de julio de 1997"
7,11,54,773,551,550,1101,"6 de julio de 1997"
7,11,54,774,540,495,1035,"6 de julio de 1997"
7,11,54,775,228,187,415,"6 de julio de 1997"
7,11,54,776,318,280,598,"6 de julio de 1997"
7,11,54,777,334,309,643,"6 de julio de 1997"
7,11,54,778,379,304,683,"6 de julio de 1997"
7,11,54,779,195,153,348,"6 de julio de 1997"
7,11,103,1755,573,642,1215,"6 de julio de 1997"
7,11,103,1756,276,250,526,"6 de julio de 1997"
7,11,103,1757,324,290,614,"6 de julio de 1997"
7,11,103,1758,298,279,577,"6 de julio de 1997"
7,11,103,1759,519,421,940,"6 de julio de 1997"
7,11,103,1760,321,282,603,"6 de julio de 1997"
7,11,103,1761,222,191,413,"6 de julio de 1997"
7,11,103,1762,299,296,595,"6 de julio de 1997"
7,11,103,1763,178,204,382,"6 de julio de 1997"
7,11,103,1764,526,500,1026,"6 de julio de 1997"
7,11,103,1765,370,348,718,"6 de julio de 1997"
7,11,103,1766,307,288,595,"6 de julio de 1997"
7,11,103,1767,418,368,786,"6 de julio de 1997"
7,11,103,1768,201,175,376,"6 de julio de 1997"
7,11,103,1769,448,406,854,"6 de julio de 1997"
7,11,103,1770,545,514,1059,"6 de julio de 1997"
7,11,107,1812,573,546,1119,"6 de julio de 1997"
7,11,107,1813,598,568,1166,"6 de julio de 1997"
7,11,107,1814,661,636,1297,"6 de julio de 1997"
7,11,107,1815,779,749,1528,"6 de julio de 1997"
7,11,107,1816,256,213,469,"6 de julio de 1997"
7,11,107,1817,424,346,770,"6 de julio de 1997"
7,11,107,1818,228,170,398,"6 de julio de 1997"
7,11,107,1819,536,433,969,"6 de julio de 1997"
7,11,107,1820,286,217,503,"6 de julio de 1997"
7,11,107,1821,712,611,1323,"6 de julio de 1997"
7,11,107,1822,343,281,624,"6 de julio de 1997"
7,11,107,1823,383,385,768,"6 de julio de 1997"
7,11,107,1824,251,194,445,"6 de julio de 1997"
7,11,107,1825,431,397,828,"6 de julio de 1997"
7,11,107,1826,392,319,711,"6 de julio de 1997"
7,11,107,1827,243,213,456,"6 de julio de 1997"
7,12,15,163,400,391,791,"6 de julio de 1997"
7,12,15,164,718,755,1473,"6 de julio de 1997"
7,12,15,165,365,445,810,"6 de julio de 1997"
7,12,15,166,417,410,827,"6 de julio de 1997"
7,12,15,167,436,438,874,"6 de julio de 1997"
7,12,15,168,316,342,658,"6 de julio de 1997"
7,12,15,169,369,385,754,"6 de julio de 1997"
7,12,15,170,343,268,611,"6 de julio de 1997"
7,12,15,171,249,197,446,"6 de julio de 1997"
7,12,15,172,228,192,420,"6 de julio de 1997"
7,12,15,173,433,381,814,"6 de julio de 1997"
7,12,15,174,236,212,448,"6 de julio de 1997"
7,12,15,175,374,335,709,"6 de julio de 1997"
7,12,15,176,584,574,1158,"6 de julio de 1997"
7,12,15,177,278,246,524,"6 de julio de 1997"
7,12,15,178,514,497,1011,"6 de julio de 1997"
7,12,15,179,363,322,685,"6 de julio de 1997"
7,12,15,180,438,397,835,"6 de julio de 1997"
7,12,15,181,531,477,1008,"6 de julio de 1997"
7,12,15,182,495,456,951,"6 de julio de 1997"
7,12,15,183,401,424,825,"6 de julio de 1997"
7,12,15,184,699,689,1388,"6 de julio de 1997"
7,12,15,185,283,244,527,"6 de julio de 1997"
7,12,35,532,782,773,1555,"6 de julio de 1997"
7,12,35,533,524,505,1029,"6 de julio de 1997"
7,12,35,534,337,308,645,"6 de julio de 1997"
7,12,35,535,440,410,850,"6 de julio de 1997"
7,12,35,536,503,546,1049,"6 de julio de 1997"
7,12,55,780,721,780,1501,"6 de julio de 1997"
7,12,55,781,467,478,945,"6 de julio de 1997"
7,12,88,1247,335,344,679,"6 de julio de 1997"
7,12,88,1248,561,574,1135,"6 de julio de 1997"
7,12,88,1249,564,569,1133,"6 de julio de 1997"
7,12,88,1250,497,524,1021,"6 de julio de 1997"
7,12,88,1251,463,485,948,"6 de julio de 1997"
7,12,88,1252,449,399,848,"6 de julio de 1997"
7,12,88,1253,333,293,626,"6 de julio de 1997"
7,12,88,1254,393,327,720,"6 de julio de 1997"
7,12,88,1255,198,162,360,"6 de julio de 1997"
7,12,88,1256,276,249,525,"6 de julio de 1997"
7,12,88,1257,346,270,616,"6 de julio de 1997"
7,12,88,1258,349,352,701,"6 de julio de 1997"
7,12,88,1259,467,468,935,"6 de julio de 1997"
7,12,88,1260,370,375,745,"6 de julio de 1997"
7,12,88,1261,223,198,421,"6 de julio de 1997"
7,12,88,1262,217,174,391,"6 de julio de 1997"
7,12,88,1263,228,223,451,"6 de julio de 1997"
7,12,90,1265,690,690,1380,"6 de julio de 1997"
7,12,90,1266,603,672,1275,"6 de julio de 1997"
7,12,90,1267,520,576,1096,"6 de julio de 1997"
7,12,90,1268,774,868,1642,"6 de julio de 1997"
7,12,90,1269,515,563,1078,"6 de julio de 1997"
7,12,90,1270,771,846,1617,"6 de julio de 1997"
7,12,90,1271,583,706,1289,"6 de julio de 1997"
7,12,90,1272,693,725,1418,"6 de julio de 1997"
7,12,90,1273,597,620,1217,"6 de julio de 1997"
7,12,90,1274,519,598,1117,"6 de julio de 1997"
7,12,90,1275,560,671,1231,"6 de julio de 1997"
7,12,90,1276,375,384,759,"6 de julio de 1997"
7,12,90,1277,597,691,1288,"6 de julio de 1997"
7,12,90,1278,594,649,1243,"6 de julio de 1997"
7,12,90,1279,559,650,1209,"6 de julio de 1997"
7,12,90,1280,704,788,1492,"6 de julio de 1997"
7,12,90,1281,695,745,1440,"6 de julio de 1997"
7,12,90,1282,619,712,1331,"6 de julio de 1997"
7,12,90,1283,485,564,1049,"6 de julio de 1997"
7,12,90,1284,347,408,755,"6 de julio de 1997"
7,12,90,1285,452,480,932,"6 de julio de 1997"
7,12,90,1286,519,593,1112,"6 de julio de 1997"
7,12,90,1287,454,514,968,"6 de julio de 1997"
7,12,90,1288,267,310,577,"6 de julio de 1997"
7,12,90,1289,322,432,754,"6 de julio de 1997"
7,12,90,1290,365,470,835,"6 de julio de 1997"
7,12,90,1291,434,567,1001,"6 de julio de 1997"
7,12,90,1292,442,551,993,"6 de julio de 1997"
7,12,90,1293,630,740,1370,"6 de julio de 1997"
7,12,90,1294,577,715,1292,"6 de julio de 1997"
7,12,90,1295,558,694,1252,"6 de julio de 1997"
7,12,90,1296,538,655,1193,"6 de julio de 1997"
7,12,90,1297,380,431,811,"6 de julio de 1997"
7,12,90,1298,288,353,641,"6 de julio de 1997"
7,12,90,1299,282,319,601,"6 de julio de 1997"
7,12,90,1300,404,509,913,"6 de julio de 1997"
7,12,90,1301,479,588,1067,"6 de julio de 1997"
7,12,90,1302,449,491,940,"6 de julio de 1997"
7,12,90,1303,302,324,626,"6 de julio de 1997"
7,12,90,1304,602,692,1294,"6 de julio de 1997"
7,12,90,1305,230,252,482,"6 de julio de 1997"
7,12,90,1306,299,366,665,"6 de julio de 1997"
7,12,90,1307,450,495,945,"6 de julio de 1997"
7,12,90,1308,272,359,631,"6 de julio de 1997"
7,12,90,1309,549,688,1237,"6 de julio de 1997"
7,12,90,1310,525,590,1115,"6 de julio de 1997"
7,12,90,1311,579,718,1297,"6 de julio de 1997"
7,12,90,1312,368,386,754,"6 de julio de 1997"
7,12,90,1313,406,480,886,"6 de julio de 1997"
7,12,90,1314,426,509,935,"6 de julio de 1997"
7,12,90,1315,343,409,752,"6 de julio de 1997"
7,12,90,1316,253,337,590,"6 de julio de 1997"
7,12,90,1317,395,505,900,"6 de julio de 1997"
7,12,90,1318,246,287,533,"6 de julio de 1997"
7,12,90,1319,224,271,495,"6 de julio de 1997"
7,12,90,1320,522,558,1080,"6 de julio de 1997"
7,12,90,1321,494,571,1065,"6 de julio de 1997"
7,12,90,1322,420,497,917,"6 de julio de 1997"
7,12,90,1323,591,636,1227,"6 de julio de 1997"
7,12,90,1324,547,595,1142,"6 de julio de 1997"
7,12,90,1325,333,398,731,"6 de julio de 1997"
7,12,90,1326,462,521,983,"6 de julio de 1997"
7,12,90,1327,696,762,1458,"6 de julio de 1997"
7,12,90,1328,506,584,1090,"6 de julio de 1997"
7,12,90,1329,548,666,1214,"6 de julio de 1997"
7,12,90,1330,495,594,1089,"6 de julio de 1997"
7,12,90,1331,606,694,1300,"6 de julio de 1997"
7,12,90,1332,589,645,1234,"6 de julio de 1997"
7,12,90,1333,663,752,1415,"6 de julio de 1997"
7,12,90,1334,628,720,1348,"6 de julio de 1997"
7,12,90,1335,348,429,777,"6 de julio de 1997"
7,12,90,1336,803,876,1679,"6 de julio de 1997"
7,12,90,1337,502,523,1025,"6 de julio de 1997"
7,12,90,1338,681,773,1454,"6 de julio de 1997"
7,12,90,1339,605,673,1278,"6 de julio de 1997"
7,12,90,1340,833,902,1735,"6 de julio de 1997"
7,12,90,1341,663,722,1385,"6 de julio de 1997"
7,12,90,1342,293,329,622,"6 de julio de 1997"
7,12,90,1343,539,586,1125,"6 de julio de 1997"
7,12,90,1344,631,493,1124,"6 de julio de 1997"
7,12,90,1345,265,200,465,"6 de julio de 1997"
7,12,90,1346,748,698,1446,"6 de julio de 1997"
7,12,90,1347,284,234,518,"6 de julio de 1997"
7,12,90,1348,133,108,241,"6 de julio de 1997"
7,12,90,1349,280,223,503,"6 de julio de 1997"
7,12,90,1350,288,266,554,"6 de julio de 1997"
7,12,90,1351,531,473,1004,"6 de julio de 1997"
7,12,90,1352,437,400,837,"6 de julio de 1997"
7,12,90,1353,241,195,436,"6 de julio de 1997"
7,12,90,1354,378,325,703,"6 de julio de 1997"
7,12,90,1355,383,327,710,"6 de julio de 1997"
7,12,90,1356,258,215,473,"6 de julio de 1997"
7,12,90,1357,209,160,369,"6 de julio de 1997"
7,12,90,1358,438,355,793,"6 de julio de 1997"
7,12,90,1359,382,368,750,"6 de julio de 1997"
7,12,90,1360,310,292,602,"6 de julio de 1997"
7,12,90,1361,425,345,770,"6 de julio de 1997"
7,12,90,1362,377,360,737,"6 de julio de 1997"
7,12,90,1363,326,286,612,"6 de julio de 1997"
7,12,90,1364,287,253,540,"6 de julio de 1997"
7,12,90,1365,297,279,576,"6 de julio de 1997"
7,12,90,1366,265,255,520,"6 de julio de 1997"
7,12,90,1367,405,394,799,"6 de julio de 1997"
7,12,90,1368,201,179,380,"6 de julio de 1997"
7,12,90,1369,326,259,585,"6 de julio de 1997"
7,12,90,1370,639,686,1325,"6 de julio de 1997"
7,12,90,1371,315,305,620,"6 de julio de 1997"
7,12,90,1372,323,308,631,"6 de julio de 1997"
7,12,90,1373,429,414,843,"6 de julio de 1997"
7,12,90,1374,362,334,696,"6 de julio de 1997"
7,12,90,1375,263,214,477,"6 de julio de 1997"
7,12,90,1376,226,222,448,"6 de julio de 1997"
7,12,90,1377,331,307,638,"6 de julio de 1997"
7,12,90,1378,464,497,961,"6 de julio de 1997"
7,12,90,1379,518,542,1060,"6 de julio de 1997"
7,12,90,1380,218,230,448,"6 de julio de 1997"
7,12,90,1381,480,478,958,"6 de julio de 1997"
7,12,90,1382,231,209,440,"6 de julio de 1997"
7,12,90,1383,343,305,648,"6 de julio de 1997"
7,12,90,1384,483,483,966,"6 de julio de 1997"
7,12,90,1385,375,410,785,"6 de julio de 1997"
7,12,90,1386,399,379,778,"6 de julio de 1997"
7,12,90,1387,656,639,1295,"6 de julio de 1997"
7,12,90,1388,302,295,597,"6 de julio de 1997"
7,12,90,1389,335,284,619,"6 de julio de 1997"
7,12,90,1390,429,399,828,"6 de julio de 1997"
7,12,90,1391,308,326,634,"6 de julio de 1997"
7,12,90,1392,333,296,629,"6 de julio de 1997"
7,12,90,1393,488,449,937,"6 de julio de 1997"
7,12,90,1394,18,22,40,"6 de julio de 1997"
7,12,90,1395,513,494,1007,"6 de julio de 1997"
7,12,90,1396,496,509,1005,"6 de julio de 1997"
7,12,90,1397,454,477,931,"6 de julio de 1997"
7,12,90,1398,404,348,752,"6 de julio de 1997"
7,12,90,1399,433,378,811,"6 de julio de 1997"
7,12,90,1400,332,291,623,"6 de julio de 1997"
7,12,90,1401,658,54,712,"6 de julio de 1997"
7,12,90,1402,474,30,504,"6 de julio de 1997"
7,12,90,1403,852,915,1767,"6 de julio de 1997"
7,12,101,1580,237,262,499,"6 de julio de 1997"
7,12,101,1581,424,486,910,"6 de julio de 1997"
7,12,101,1582,411,426,837,"6 de julio de 1997"
7,12,101,1583,422,462,884,"6 de julio de 1997"
7,12,101,1584,368,401,769,"6 de julio de 1997"
7,12,101,1585,345,326,671,"6 de julio de 1997"
7,12,101,1586,446,388,834,"6 de julio de 1997"
7,12,101,1587,237,257,494,"6 de julio de 1997"
7,12,101,1588,309,278,587,"6 de julio de 1997"
7,12,101,1589,305,257,562,"6 de julio de 1997"
7,12,101,1590,464,454,918,"6 de julio de 1997"
7,12,101,1591,686,696,1382,"6 de julio de 1997"
7,12,101,1592,627,595,1222,"6 de julio de 1997"
7,12,101,1593,412,397,809,"6 de julio de 1997"
7,12,101,1594,620,639,1259,"6 de julio de 1997"
7,12,101,1595,244,257,501,"6 de julio de 1997"
7,12,101,1596,338,370,708,"6 de julio de 1997"
7,12,101,1597,355,379,734,"6 de julio de 1997"
7,12,101,1598,380,387,767,"6 de julio de 1997"
7,12,101,1599,197,183,380,"6 de julio de 1997"
7,12,101,1600,303,298,601,"6 de julio de 1997"
7,12,101,1601,321,312,633,"6 de julio de 1997"
7,12,105,1778,629,626,1255,"6 de julio de 1997"
7,12,105,1779,452,389,841,"6 de julio de 1997"
7,12,105,1780,330,294,624,"6 de julio de 1997"
7,12,105,1781,431,442,873,"6 de julio de 1997"
7,12,105,1782,404,378,782,"6 de julio de 1997"
7,12,105,1783,244,275,519,"6 de julio de 1997"
7,12,105,1784,523,531,1054,"6 de julio de 1997"
7,12,105,1785,383,389,772,"6 de julio de 1997"
8,1,1,1,271,245,516,"6 de julio de 1997"
8,1,1,2,338,297,635,"6 de julio de 1997"
8,1,1,3,318,328,646,"6 de julio de 1997"
8,1,1,4,418,420,838,"6 de julio de 1997"
8,1,1,5,504,466,970,"6 de julio de 1997"
8,1,1,6,356,333,689,"6 de julio de 1997"
8,1,1,7,218,210,428,"6 de julio de 1997"
8,1,1,8,301,270,571,"6 de julio de 1997"
8,1,1,9,17,11,28,"6 de julio de 1997"
8,1,1,10,111,85,196,"6 de julio de 1997"
8,1,1,11,76,70,146,"6 de julio de 1997"
8,1,1,12,229,146,375,"6 de julio de 1997"
8,1,1,13,261,192,453,"6 de julio de 1997"
8,1,1,14,180,149,329,"6 de julio de 1997"
8,1,1,15,123,102,225,"6 de julio de 1997"
8,1,1,16,88,76,164,"6 de julio de 1997"
8,1,5,60,332,314,646,"6 de julio de 1997"
8,1,5,61,232,230,462,"6 de julio de 1997"
8,1,5,62,258,246,504,"6 de julio de 1997"
8,1,5,63,363,380,743,"6 de julio de 1997"
8,1,5,64,209,220,429,"6 de julio de 1997"
8,1,5,65,201,219,420,"6 de julio de 1997"
8,1,5,66,249,242,491,"6 de julio de 1997"
8,1,5,67,261,302,563,"6 de julio de 1997"
8,1,5,68,264,286,550,"6 de julio de 1997"
8,1,5,69,231,229,460,"6 de julio de 1997"
8,1,5,70,203,211,414,"6 de julio de 1997"
8,1,5,71,237,230,467,"6 de julio de 1997"
8,1,5,72,267,269,536,"6 de julio de 1997"
8,1,5,73,254,251,505,"6 de julio de 1997"
8,1,5,74,301,273,574,"6 de julio de 1997"
8,1,5,75,200,200,400,"6 de julio de 1997"
8,1,5,76,294,263,557,"6 de julio de 1997"
8,1,5,77,121,87,208,"6 de julio de 1997"
8,1,5,78,468,423,891,"6 de julio de 1997"
8,1,5,79,338,258,596,"6 de julio de 1997"
8,1,5,80,101,56,157,"6 de julio de 1997"
8,1,5,81,355,227,582,"6 de julio de 1997"
8,1,10,149,260,244,504,"6 de julio de 1997"
8,1,10,150,204,199,403,"6 de julio de 1997"
8,1,10,151,259,293,552,"6 de julio de 1997"
8,1,10,152,276,250,526,"6 de julio de 1997"
8,1,10,153,274,276,550,"6 de julio de 1997"
8,1,10,154,112,96,208,"6 de julio de 1997"
8,1,10,155,138,124,262,"6 de julio de 1997"
8,1,10,156,140,141,281,"6 de julio de 1997"
8,1,10,157,305,252,557,"6 de julio de 1997"
8,1,10,158,234,226,460,"6 de julio de 1997"
8,1,10,159,246,235,481,"6 de julio de 1997"
8,1,10,160,307,296,603,"6 de julio de 1997"
8,1,10,161,299,284,583,"6 de julio de 1997"
8,1,10,162,280,240,520,"6 de julio de 1997"
8,1,10,163,274,260,534,"6 de julio de 1997"
8,1,10,164,194,199,393,"6 de julio de 1997"
8,1,10,165,121,113,234,"6 de julio de 1997"
8,1,10,166,270,257,527,"6 de julio de 1997"
8,1,10,167,341,313,654,"6 de julio de 1997"
8,1,10,168,424,376,800,"6 de julio de 1997"
8,1,10,169,79,52,131,"6 de julio de 1997"
8,1,10,170,36,24,60,"6 de julio de 1997"
8,1,10,171,176,138,314,"6 de julio de 1997"
8,1,10,172,386,348,734,"6 de julio de 1997"
8,1,10,173,278,290,568,"6 de julio de 1997"
8,1,10,174,360,305,665,"6 de julio de 1997"
8,1,13,238,151,140,291,"6 de julio de 1997"
8,1,13,239,206,208,414,"6 de julio de 1997"
8,1,13,240,481,485,966,"6 de julio de 1997"
8,1,13,241,313,329,642,"6 de julio de 1997"
8,1,13,242,269,215,484,"6 de julio de 1997"
8,1,13,243,294,256,550,"6 de julio de 1997"
8,1,13,244,189,175,364,"6 de julio de 1997"
8,1,13,245,521,437,958,"6 de julio de 1997"
8,1,13,246,61,40,101,"6 de julio de 1997"
8,1,13,247,84,53,137,"6 de julio de 1997"
8,1,13,248,150,111,261,"6 de julio de 1997"
8,1,13,249,147,102,249,"6 de julio de 1997"
8,1,13,250,170,125,295,"6 de julio de 1997"
8,1,13,251,365,312,677,"6 de julio de 1997"
8,1,13,252,64,37,101,"6 de julio de 1997"
8,1,23,1042,210,215,425,"6 de julio de 1997"
8,1,23,1043,39,22,61,"6 de julio de 1997"
8,1,23,1044,305,343,648,"6 de julio de 1997"
8,1,23,1045,484,483,967,"6 de julio de 1997"
8,1,25,1053,295,329,624,"6 de julio de 1997"
8,1,25,1054,280,275,555,"6 de julio de 1997"
8,1,25,1055,104,100,204,"6 de julio de 1997"
8,1,25,1056,116,107,223,"6 de julio de 1997"
8,1,25,1057,313,318,631,"6 de julio de 1997"
8,1,25,1058,386,396,782,"6 de julio de 1997"
8,1,25,1059,225,211,436,"6 de julio de 1997"
8,1,25,1060,217,215,432,"6 de julio de 1997"
8,1,25,1061,225,222,447,"6 de julio de 1997"
8,1,25,1062,127,124,251,"6 de julio de 1997"
8,1,25,1063,127,142,269,"6 de julio de 1997"
8,1,25,1064,144,151,295,"6 de julio de 1997"
8,1,25,1065,318,308,626,"6 de julio de 1997"
8,1,25,1066,85,86,171,"6 de julio de 1997"
8,1,25,1067,276,249,525,"6 de julio de 1997"
8,1,25,1068,20,15,35,"6 de julio de 1997"
8,1,28,1126,615,621,1236,"6 de julio de 1997"
8,1,28,1127,556,538,1094,"6 de julio de 1997"
8,1,28,1128,214,208,422,"6 de julio de 1997"
8,1,28,1129,323,241,564,"6 de julio de 1997"
8,1,28,1130,572,571,1143,"6 de julio de 1997"
8,1,28,1131,294,243,537,"6 de julio de 1997"
8,1,28,1132,203,186,389,"6 de julio de 1997"
8,1,28,1133,80,56,136,"6 de julio de 1997"
8,1,28,1134,562,545,1107,"6 de julio de 1997"
8,1,34,1357,167,172,339,"6 de julio de 1997"
8,1,34,1358,447,437,884,"6 de julio de 1997"
8,1,34,1359,380,386,766,"6 de julio de 1997"
8,1,34,1360,99,97,196,"6 de julio de 1997"
8,1,34,1361,113,97,210,"6 de julio de 1997"
8,1,34,1362,96,87,183,"6 de julio de 1997"
8,1,34,1363,116,99,215,"6 de julio de 1997"
8,1,34,1364,47,27,74,"6 de julio de 1997"
8,1,34,1365,85,58,143,"6 de julio de 1997"
8,1,34,1366,143,122,265,"6 de julio de 1997"
8,1,34,1367,149,130,279,"6 de julio de 1997"
8,1,34,1368,268,261,529,"6 de julio de 1997"
8,1,34,1369,225,177,402,"6 de julio de 1997"
8,1,34,1370,32,20,52,"6 de julio de 1997"
8,1,34,1371,119,98,217,"6 de julio de 1997"
8,1,34,1372,85,83,168,"6 de julio de 1997"
8,1,34,1373,73,49,122,"6 de julio de 1997"
8,1,34,1374,172,163,335,"6 de julio de 1997"
8,1,35,1375,261,266,527,"6 de julio de 1997"
8,1,35,1376,273,258,531,"6 de julio de 1997"
8,1,35,1377,303,274,577,"6 de julio de 1997"
8,1,35,1378,81,43,124,"6 de julio de 1997"
8,1,35,1379,381,306,687,"6 de julio de 1997"
8,1,35,1380,165,150,315,"6 de julio de 1997"
8,1,35,1381,267,235,502,"6 de julio de 1997"
8,1,35,1382,40,25,65,"6 de julio de 1997"
8,1,35,1383,286,240,526,"6 de julio de 1997"
8,1,35,1384,231,201,432,"6 de julio de 1997"
8,1,35,1385,64,58,122,"6 de julio de 1997"
8,1,35,1386,144,113,257,"6 de julio de 1997"
8,1,40,2214,188,167,355,"6 de julio de 1997"
8,1,40,2215,316,317,633,"6 de julio de 1997"
8,1,40,2216,239,232,471,"6 de julio de 1997"
8,1,40,2217,256,257,513,"6 de julio de 1997"
8,1,40,2218,206,213,419,"6 de julio de 1997"
8,1,40,2219,335,299,634,"6 de julio de 1997"
8,1,40,2220,236,257,493,"6 de julio de 1997"
8,1,40,2221,230,265,495,"6 de julio de 1997"
8,1,40,2222,171,192,363,"6 de julio de 1997"
8,1,40,2223,315,335,650,"6 de julio de 1997"
8,1,40,2224,252,271,523,"6 de julio de 1997"
8,1,40,2225,306,382,688,"6 de julio de 1997"
8,1,40,2226,433,404,837,"6 de julio de 1997"
8,1,40,2227,331,297,628,"6 de julio de 1997"
8,1,40,2228,152,183,335,"6 de julio de 1997"
8,1,40,2229,255,267,522,"6 de julio de 1997"
8,1,40,2230,239,253,492,"6 de julio de 1997"
8,1,40,2231,225,223,448,"6 de julio de 1997"
8,1,40,2232,210,208,418,"6 de julio de 1997"
8,1,40,2233,211,221,432,"6 de julio de 1997"
8,1,40,2234,206,192,398,"6 de julio de 1997"
8,1,40,2235,174,172,346,"6 de julio de 1997"
8,1,40,2236,134,117,251,"6 de julio de 1997"
8,1,40,2237,224,191,415,"6 de julio de 1997"
8,1,40,2238,229,211,440,"6 de julio de 1997"
8,1,40,2239,326,314,640,"6 de julio de 1997"
8,1,40,2240,313,253,566,"6 de julio de 1997"
8,1,40,2241,286,280,566,"6 de julio de 1997"
8,1,40,2242,218,203,421,"6 de julio de 1997"
8,1,40,2243,228,189,417,"6 de julio de 1997"
8,1,40,2244,159,129,288,"6 de julio de 1997"
8,1,40,2245,154,145,299,"6 de julio de 1997"
8,1,40,2246,216,192,408,"6 de julio de 1997"
8,1,40,2247,225,214,439,"6 de julio de 1997"
8,1,40,2248,106,72,178,"6 de julio de 1997"
8,1,40,2249,91,56,147,"6 de julio de 1997"
8,1,40,2250,365,300,665,"6 de julio de 1997"
8,1,40,2251,267,209,476,"6 de julio de 1997"
8,1,40,2252,112,93,205,"6 de julio de 1997"
8,1,40,2253,217,202,419,"6 de julio de 1997"
8,1,40,2254,150,121,271,"6 de julio de 1997"
8,1,40,2255,352,318,670,"6 de julio de 1997"
8,1,40,2256,239,188,427,"6 de julio de 1997"
8,1,40,2257,81,61,142,"6 de julio de 1997"
8,1,40,2258,217,186,403,"6 de julio de 1997"
8,1,40,2259,223,187,410,"6 de julio de 1997"
8,1,40,2260,82,64,146,"6 de julio de 1997"
8,1,43,2271,103,106,209,"6 de julio de 1997"
8,1,43,2272,438,453,891,"6 de julio de 1997"
8,1,43,2273,229,212,441,"6 de julio de 1997"
8,1,43,2274,140,125,265,"6 de julio de 1997"
8,1,43,2275,80,58,138,"6 de julio de 1997"
8,1,43,2276,178,205,383,"6 de julio de 1997"
8,1,43,2277,109,94,203,"6 de julio de 1997"
8,1,48,2339,295,310,605,"6 de julio de 1997"
8,1,48,2340,185,173,358,"6 de julio de 1997"
8,1,48,2341,130,106,236,"6 de julio de 1997"
8,1,48,2342,430,415,845,"6 de julio de 1997"
8,1,48,2343,437,383,820,"6 de julio de 1997"
8,1,48,2344,306,270,576,"6 de julio de 1997"
8,1,48,2345,121,109,230,"6 de julio de 1997"
8,1,48,2346,160,160,320,"6 de julio de 1997"
8,1,48,2347,206,223,429,"6 de julio de 1997"
8,1,48,2348,202,199,401,"6 de julio de 1997"
8,1,48,2349,311,297,608,"6 de julio de 1997"
8,1,48,2350,358,380,738,"6 de julio de 1997"
8,1,48,2351,249,238,487,"6 de julio de 1997"
8,1,48,2352,252,278,530,"6 de julio de 1997"
8,1,48,2353,348,324,672,"6 de julio de 1997"
8,1,48,2354,351,373,724,"6 de julio de 1997"
8,1,48,2355,78,66,144,"6 de julio de 1997"
8,1,48,2356,66,66,132,"6 de julio de 1997"
8,1,48,2357,83,67,150,"6 de julio de 1997"
8,1,48,2358,169,104,273,"6 de julio de 1997"
8,1,48,2359,57,51,108,"6 de julio de 1997"
8,1,48,2360,99,98,197,"6 de julio de 1997"
8,1,48,2361,169,153,322,"6 de julio de 1997"
8,1,48,2362,124,77,201,"6 de julio de 1997"
8,1,48,2363,120,103,223,"6 de julio de 1997"
8,1,48,2364,107,95,202,"6 de julio de 1997"
8,1,48,2365,265,263,528,"6 de julio de 1997"
8,1,48,2366,48,39,87,"6 de julio de 1997"
8,1,48,2367,181,158,339,"6 de julio de 1997"
8,1,48,2368,89,85,174,"6 de julio de 1997"
8,1,48,2369,35,27,62,"6 de julio de 1997"
8,1,48,2370,22,24,46,"6 de julio de 1997"
8,1,48,2371,37,36,73,"6 de julio de 1997"
8,1,48,2372,36,26,62,"6 de julio de 1997"
8,1,48,2373,45,45,90,"6 de julio de 1997"
8,1,48,2374,52,49,101,"6 de julio de 1997"
8,1,48,2375,141,131,272,"6 de julio de 1997"
8,1,48,2376,31,34,65,"6 de julio de 1997"
8,1,48,2377,32,32,64,"6 de julio de 1997"
8,1,48,2378,96,98,194,"6 de julio de 1997"
8,1,48,2379,126,127,253,"6 de julio de 1997"
8,1,48,2380,158,151,309,"6 de julio de 1997"
8,1,48,2381,357,319,676,"6 de julio de 1997"
8,1,48,2382,163,136,299,"6 de julio de 1997"
8,1,48,2383,67,63,130,"6 de julio de 1997"
8,1,48,2384,199,185,384,"6 de julio de 1997"
8,1,48,2385,212,189,401,"6 de julio de 1997"
8,1,48,2386,61,53,114,"6 de julio de 1997"
8,1,48,2387,98,94,192,"6 de julio de 1997"
8,1,48,2388,211,200,411,"6 de julio de 1997"
8,1,48,2389,171,164,335,"6 de julio de 1997"
8,1,50,2396,349,434,783,"6 de julio de 1997"
8,1,50,2397,485,513,998,"6 de julio de 1997"
8,1,50,2398,589,601,1190,"6 de julio de 1997"
8,1,50,2399,450,238,688,"6 de julio de 1997"
8,1,50,2400,318,357,675,"6 de julio de 1997"
8,1,50,2401,221,244,465,"6 de julio de 1997"
8,1,50,2402,256,280,536,"6 de julio de 1997"
8,1,50,2403,169,193,362,"6 de julio de 1997"
8,1,50,2404,189,209,398,"6 de julio de 1997"
8,1,50,2405,179,202,381,"6 de julio de 1997"
8,1,50,2406,258,247,505,"6 de julio de 1997"
8,1,50,2407,220,258,478,"6 de julio de 1997"
8,1,50,2408,301,334,635,"6 de julio de 1997"
8,1,50,2409,213,202,415,"6 de julio de 1997"
8,1,50,2410,273,276,549,"6 de julio de 1997"
8,1,50,2411,178,223,401,"6 de julio de 1997"
8,1,50,2412,240,242,482,"6 de julio de 1997"
8,1,50,2413,269,315,584,"6 de julio de 1997"
8,1,50,2414,322,345,667,"6 de julio de 1997"
8,1,50,2415,293,337,630,"6 de julio de 1997"
8,1,50,2416,324,353,677,"6 de julio de 1997"
8,1,50,2417,284,310,594,"6 de julio de 1997"
8,1,50,2418,258,308,566,"6 de julio de 1997"
8,1,50,2419,267,288,555,"6 de julio de 1997"
8,1,50,2420,198,214,412,"6 de julio de 1997"
8,1,50,2421,213,267,480,"6 de julio de 1997"
8,1,50,2422,259,310,569,"6 de julio de 1997"
8,1,50,2423,282,299,581,"6 de julio de 1997"
8,1,50,2424,259,292,551,"6 de julio de 1997"
8,1,50,2425,289,295,584,"6 de julio de 1997"
8,1,50,2426,357,374,731,"6 de julio de 1997"
8,1,50,2427,229,251,480,"6 de julio de 1997"
8,1,50,2428,258,248,506,"6 de julio de 1997"
8,1,50,2429,313,321,634,"6 de julio de 1997"
8,1,50,2430,639,644,1283,"6 de julio de 1997"
8,1,50,2431,380,412,792,"6 de julio de 1997"
8,1,50,2432,257,271,528,"6 de julio de 1997"
8,1,50,2433,154,161,315,"6 de julio de 1997"
8,1,50,2434,230,264,494,"6 de julio de 1997"
8,1,50,2435,287,332,619,"6 de julio de 1997"
8,1,50,2436,204,229,433,"6 de julio de 1997"
8,1,50,2437,195,206,401,"6 de julio de 1997"
8,1,50,2438,397,419,816,"6 de julio de 1997"
8,1,50,2439,367,464,831,"6 de julio de 1997"
8,1,50,2440,308,318,626,"6 de julio de 1997"
8,1,50,2441,149,163,312,"6 de julio de 1997"
8,1,50,2442,210,244,454,"6 de julio de 1997"
8,1,50,2443,170,182,352,"6 de julio de 1997"
8,1,50,2444,218,233,451,"6 de julio de 1997"
8,1,50,2445,197,225,422,"6 de julio de 1997"
8,1,50,2446,372,375,747,"6 de julio de 1997"
8,1,50,2447,218,234,452,"6 de julio de 1997"
8,1,50,2448,80,108,188,"6 de julio de 1997"
8,1,50,2449,104,91,195,"6 de julio de 1997"
8,1,50,2450,273,260,533,"6 de julio de 1997"
8,1,50,2451,280,256,536,"6 de julio de 1997"
8,1,50,2452,307,287,594,"6 de julio de 1997"
8,1,50,2453,174,153,327,"6 de julio de 1997"
8,1,50,2454,291,300,591,"6 de julio de 1997"
8,1,50,2455,102,50,152,"6 de julio de 1997"
8,1,50,2456,158,142,300,"6 de julio de 1997"
8,1,50,2457,242,241,483,"6 de julio de 1997"
8,1,50,2458,192,169,361,"6 de julio de 1997"
8,1,50,2459,209,183,392,"6 de julio de 1997"
8,1,53,2509,354,337,691,"6 de julio de 1997"
8,1,53,2510,474,457,931,"6 de julio de 1997"
8,1,53,2511,458,440,898,"6 de julio de 1997"
8,1,53,2512,210,251,461,"6 de julio de 1997"
8,1,53,2513,379,353,732,"6 de julio de 1997"
8,1,53,2514,224,203,427,"6 de julio de 1997"
8,1,53,2515,271,256,527,"6 de julio de 1997"
8,1,53,2516,465,437,902,"6 de julio de 1997"
8,1,53,2517,273,239,512,"6 de julio de 1997"
8,1,63,2648,230,228,458,"6 de julio de 1997"
8,1,63,2649,461,462,923,"6 de julio de 1997"
8,1,63,2650,130,133,263,"6 de julio de 1997"
8,1,63,2651,98,93,191,"6 de julio de 1997"
8,1,63,2652,150,137,287,"6 de julio de 1997"
8,1,63,2653,282,267,549,"6 de julio de 1997"
8,1,63,2654,110,85,195,"6 de julio de 1997"
8,1,63,2655,192,151,343,"6 de julio de 1997"
8,1,63,2656,199,174,373,"6 de julio de 1997"
8,1,63,2657,124,101,225,"6 de julio de 1997"
8,1,63,2658,72,50,122,"6 de julio de 1997"
8,1,63,2659,325,236,561,"6 de julio de 1997"
8,1,63,2660,190,154,344,"6 de julio de 1997"
8,2,37,1424,461,427,888,"6 de julio de 1997"
8,2,37,1425,608,597,1205,"6 de julio de 1997"
8,2,37,1426,416,437,853,"6 de julio de 1997"
8,2,37,1427,221,269,490,"6 de julio de 1997"
8,2,37,1428,463,522,985,"6 de julio de 1997"
8,2,37,1429,447,444,891,"6 de julio de 1997"
8,2,37,1430,517,523,1040,"6 de julio de 1997"
8,2,37,1431,286,309,595,"6 de julio de 1997"
8,2,37,1432,397,457,854,"6 de julio de 1997"
8,2,37,1433,331,322,653,"6 de julio de 1997"
8,2,37,1434,291,323,614,"6 de julio de 1997"
8,2,37,1435,315,312,627,"6 de julio de 1997"
8,2,37,1436,372,398,770,"6 de julio de 1997"
8,2,37,1437,395,416,811,"6 de julio de 1997"
8,2,37,1438,461,469,930,"6 de julio de 1997"
8,2,37,1439,153,182,335,"6 de julio de 1997"
8,2,37,1440,288,313,601,"6 de julio de 1997"
8,2,37,1441,230,272,502,"6 de julio de 1997"
8,2,37,1442,300,364,664,"6 de julio de 1997"
8,2,37,1443,229,172,401,"6 de julio de 1997"
8,2,37,1444,325,276,601,"6 de julio de 1997"
8,2,37,1445,236,266,502,"6 de julio de 1997"
8,2,37,1446,348,369,717,"6 de julio de 1997"
8,2,37,1447,277,321,598,"6 de julio de 1997"
8,2,37,1448,304,385,689,"6 de julio de 1997"
8,2,37,1449,275,293,568,"6 de julio de 1997"
8,2,37,1450,298,338,636,"6 de julio de 1997"
8,2,37,1451,367,320,687,"6 de julio de 1997"
8,2,37,1452,230,247,477,"6 de julio de 1997"
8,2,37,1453,257,270,527,"6 de julio de 1997"
8,2,37,1454,266,276,542,"6 de julio de 1997"
8,2,37,1455,342,384,726,"6 de julio de 1997"
8,2,37,1456,271,261,532,"6 de julio de 1997"
8,2,37,1457,301,312,613,"6 de julio de 1997"
8,2,37,1458,466,502,968,"6 de julio de 1997"
8,2,37,1459,304,315,619,"6 de julio de 1997"
8,2,37,1460,322,345,667,"6 de julio de 1997"
8,2,37,1461,458,489,947,"6 de julio de 1997"
8,2,37,1462,349,397,746,"6 de julio de 1997"
8,2,37,1463,429,434,863,"6 de julio de 1997"
8,2,37,1464,402,407,809,"6 de julio de 1997"
8,2,37,1465,277,300,577,"6 de julio de 1997"
8,2,37,1466,367,370,737,"6 de julio de 1997"
8,2,37,1467,262,257,519,"6 de julio de 1997"
8,2,37,1468,231,262,493,"6 de julio de 1997"
8,2,37,1469,582,516,1098,"6 de julio de 1997"
8,2,37,1470,340,357,697,"6 de julio de 1997"
8,2,37,1471,291,297,588,"6 de julio de 1997"
8,2,37,1472,386,388,774,"6 de julio de 1997"
8,2,37,1473,278,294,572,"6 de julio de 1997"
8,2,37,1474,300,306,606,"6 de julio de 1997"
8,2,37,1475,266,268,534,"6 de julio de 1997"
8,2,37,1476,322,322,644,"6 de julio de 1997"
8,2,37,1477,292,309,601,"6 de julio de 1997"
8,2,37,1478,457,499,956,"6 de julio de 1997"
8,2,37,1479,339,344,683,"6 de julio de 1997"
8,2,37,1480,255,300,555,"6 de julio de 1997"
8,2,37,1481,302,321,623,"6 de julio de 1997"
8,2,37,1482,334,305,639,"6 de julio de 1997"
8,2,37,1483,392,414,806,"6 de julio de 1997"
8,2,37,1484,443,457,900,"6 de julio de 1997"
8,2,37,1485,335,378,713,"6 de julio de 1997"
8,2,37,1486,295,322,617,"6 de julio de 1997"
8,2,37,1487,266,295,561,"6 de julio de 1997"
8,2,37,1488,351,373,724,"6 de julio de 1997"
8,2,37,1489,302,286,588,"6 de julio de 1997"
8,2,37,1490,274,313,587,"6 de julio de 1997"
8,2,37,1491,241,246,487,"6 de julio de 1997"
8,2,37,1492,288,326,614,"6 de julio de 1997"
8,2,37,1493,367,305,672,"6 de julio de 1997"
8,2,37,1494,358,328,686,"6 de julio de 1997"
8,2,37,1495,207,193,400,"6 de julio de 1997"
8,2,37,1496,315,301,616,"6 de julio de 1997"
8,2,37,1497,313,279,592,"6 de julio de 1997"
8,2,37,1498,133,94,227,"6 de julio de 1997"
8,2,37,1499,300,259,559,"6 de julio de 1997"
8,2,37,1500,199,233,432,"6 de julio de 1997"
8,2,37,1501,206,197,403,"6 de julio de 1997"
8,2,37,1502,263,296,559,"6 de julio de 1997"
8,2,37,1503,398,390,788,"6 de julio de 1997"
8,2,37,1504,537,591,1128,"6 de julio de 1997"
8,2,37,1505,481,465,946,"6 de julio de 1997"
8,2,37,1506,505,504,1009,"6 de julio de 1997"
8,2,37,1507,514,553,1067,"6 de julio de 1997"
8,2,37,1508,470,478,948,"6 de julio de 1997"
8,2,37,1509,514,571,1085,"6 de julio de 1997"
8,2,37,1510,722,713,1435,"6 de julio de 1997"
8,2,37,1511,457,439,896,"6 de julio de 1997"
8,2,37,1512,336,335,671,"6 de julio de 1997"
8,2,37,1513,295,348,643,"6 de julio de 1997"
8,2,37,1514,357,355,712,"6 de julio de 1997"
8,2,37,1515,254,297,551,"6 de julio de 1997"
8,2,37,1516,275,290,565,"6 de julio de 1997"
8,2,37,1517,358,377,735,"6 de julio de 1997"
8,2,37,1518,343,371,714,"6 de julio de 1997"
8,2,37,1519,460,472,932,"6 de julio de 1997"
8,2,37,1520,252,275,527,"6 de julio de 1997"
8,2,37,1521,309,278,587,"6 de julio de 1997"
8,2,37,1522,245,248,493,"6 de julio de 1997"
8,2,37,1523,370,322,692,"6 de julio de 1997"
8,2,37,1524,185,198,383,"6 de julio de 1997"
8,2,37,1525,236,244,480,"6 de julio de 1997"
8,2,37,1526,268,267,535,"6 de julio de 1997"
8,2,37,1527,383,399,782,"6 de julio de 1997"
8,2,37,1528,203,199,402,"6 de julio de 1997"
8,2,37,1529,244,256,500,"6 de julio de 1997"
8,2,37,1530,234,236,470,"6 de julio de 1997"
8,2,37,1531,409,407,816,"6 de julio de 1997"
8,2,37,1532,150,137,287,"6 de julio de 1997"
8,2,37,1533,189,185,374,"6 de julio de 1997"
8,2,37,1534,214,206,420,"6 de julio de 1997"
8,2,37,1535,303,319,622,"6 de julio de 1997"
8,2,37,1536,383,380,763,"6 de julio de 1997"
8,2,37,1537,360,378,738,"6 de julio de 1997"
8,2,37,1538,575,618,1193,"6 de julio de 1997"
8,2,37,1539,263,270,533,"6 de julio de 1997"
8,2,37,1540,234,251,485,"6 de julio de 1997"
8,2,37,1541,287,288,575,"6 de julio de 1997"
8,2,37,1542,450,440,890,"6 de julio de 1997"
8,2,37,1543,202,205,407,"6 de julio de 1997"
8,2,37,1544,301,297,598,"6 de julio de 1997"
8,2,37,1545,261,260,521,"6 de julio de 1997"
8,2,37,1546,368,369,737,"6 de julio de 1997"
8,2,37,1547,557,540,1097,"6 de julio de 1997"
8,2,37,1548,386,365,751,"6 de julio de 1997"
8,2,37,1549,455,453,908,"6 de julio de 1997"
8,2,37,1550,229,210,439,"6 de julio de 1997"
8,2,37,1551,230,225,455,"6 de julio de 1997"
8,2,37,1552,211,226,437,"6 de julio de 1997"
8,2,37,1553,260,285,545,"6 de julio de 1997"
8,2,37,1554,389,414,803,"6 de julio de 1997"
8,2,37,1555,222,264,486,"6 de julio de 1997"
8,2,37,1556,504,527,1031,"6 de julio de 1997"
8,2,37,1557,292,288,580,"6 de julio de 1997"
8,2,37,1558,354,331,685,"6 de julio de 1997"
8,2,37,1559,572,556,1128,"6 de julio de 1997"
8,2,37,1560,1002,947,1949,"6 de julio de 1997"
8,2,37,1561,259,253,512,"6 de julio de 1997"
8,2,37,1563,351,311,662,"6 de julio de 1997"
8,2,37,1564,233,248,481,"6 de julio de 1997"
8,2,37,1565,314,357,671,"6 de julio de 1997"
8,2,37,1566,193,190,383,"6 de julio de 1997"
8,2,37,1567,707,779,1486,"6 de julio de 1997"
8,2,37,1568,423,449,872,"6 de julio de 1997"
8,2,37,1569,269,321,590,"6 de julio de 1997"
8,2,37,1570,593,647,1240,"6 de julio de 1997"
8,2,37,1571,322,350,672,"6 de julio de 1997"
8,2,37,1572,376,359,735,"6 de julio de 1997"
8,2,37,1573,390,444,834,"6 de julio de 1997"
8,2,37,1579,587,670,1257,"6 de julio de 1997"
8,2,37,1580,137,152,289,"6 de julio de 1997"
8,2,37,1581,287,304,591,"6 de julio de 1997"
8,2,37,1582,430,480,910,"6 de julio de 1997"
8,2,37,1583,437,451,888,"6 de julio de 1997"
8,2,37,1584,297,286,583,"6 de julio de 1997"
8,2,37,1585,425,405,830,"6 de julio de 1997"
8,2,37,1586,256,316,572,"6 de julio de 1997"
8,2,37,1587,424,441,865,"6 de julio de 1997"
8,2,37,1588,314,364,678,"6 de julio de 1997"
8,2,37,1589,217,233,450,"6 de julio de 1997"
8,2,37,1590,192,209,401,"6 de julio de 1997"
8,2,37,1591,313,324,637,"6 de julio de 1997"
8,2,37,1592,319,377,696,"6 de julio de 1997"
8,2,37,1593,289,326,615,"6 de julio de 1997"
8,2,37,1594,424,437,861,"6 de julio de 1997"
8,2,37,1604,197,205,402,"6 de julio de 1997"
8,2,37,1605,221,269,490,"6 de julio de 1997"
8,2,37,1606,224,229,453,"6 de julio de 1997"
8,2,37,1607,248,294,542,"6 de julio de 1997"
8,2,37,1608,317,324,641,"6 de julio de 1997"
8,2,37,1609,267,310,577,"6 de julio de 1997"
8,2,37,1610,314,349,663,"6 de julio de 1997"
8,2,37,1611,276,311,587,"6 de julio de 1997"
8,2,37,1612,395,429,824,"6 de julio de 1997"
8,2,37,1613,382,396,778,"6 de julio de 1997"
8,2,37,1614,319,373,692,"6 de julio de 1997"
8,2,37,1615,124,109,233,"6 de julio de 1997"
8,2,37,1616,518,546,1064,"6 de julio de 1997"
8,2,37,1617,299,348,647,"6 de julio de 1997"
8,2,37,1618,641,740,1381,"6 de julio de 1997"
8,2,37,1619,315,347,662,"6 de julio de 1997"
8,2,37,1620,204,241,445,"6 de julio de 1997"
8,2,37,1624,286,315,601,"6 de julio de 1997"
8,2,37,1625,262,301,563,"6 de julio de 1997"
8,2,37,1626,293,326,619,"6 de julio de 1997"
8,2,37,1627,113,131,244,"6 de julio de 1997"
8,2,37,1628,450,476,926,"6 de julio de 1997"
8,2,37,1629,410,429,839,"6 de julio de 1997"
8,2,37,1630,315,397,712,"6 de julio de 1997"
8,2,37,1631,446,512,958,"6 de julio de 1997"
8,2,37,1632,483,538,1021,"6 de julio de 1997"
8,2,37,1633,408,451,859,"6 de julio de 1997"
8,2,37,1634,332,388,720,"6 de julio de 1997"
8,2,37,1635,425,497,922,"6 de julio de 1997"
8,2,37,1636,487,571,1058,"6 de julio de 1997"
8,2,37,1637,385,430,815,"6 de julio de 1997"
8,2,37,1643,494,496,990,"6 de julio de 1997"
8,2,37,1644,168,184,352,"6 de julio de 1997"
8,2,37,1645,283,316,599,"6 de julio de 1997"
8,2,37,1646,570,646,1216,"6 de julio de 1997"
8,2,37,1647,226,290,516,"6 de julio de 1997"
8,2,37,1648,249,316,565,"6 de julio de 1997"
8,2,37,1649,463,513,976,"6 de julio de 1997"
8,2,37,1650,313,372,685,"6 de julio de 1997"
8,2,37,1651,430,475,905,"6 de julio de 1997"
8,2,37,1652,276,311,587,"6 de julio de 1997"
8,2,37,1653,393,415,808,"6 de julio de 1997"
8,2,37,1654,489,585,1074,"6 de julio de 1997"
8,2,37,1655,500,565,1065,"6 de julio de 1997"
8,2,37,1656,263,272,535,"6 de julio de 1997"
8,2,37,1657,493,538,1031,"6 de julio de 1997"
8,2,37,1658,320,372,692,"6 de julio de 1997"
8,2,37,1659,405,397,802,"6 de julio de 1997"
8,2,37,1660,367,351,718,"6 de julio de 1997"
8,2,37,1661,310,334,644,"6 de julio de 1997"
8,2,37,1662,295,337,632,"6 de julio de 1997"
8,2,37,1663,375,421,796,"6 de julio de 1997"
8,2,37,1664,351,425,776,"6 de julio de 1997"
8,2,37,1665,589,618,1207,"6 de julio de 1997"
8,2,37,1670,284,293,577,"6 de julio de 1997"
8,2,37,1671,227,260,487,"6 de julio de 1997"
8,2,37,1672,412,482,894,"6 de julio de 1997"
8,2,37,1673,654,700,1354,"6 de julio de 1997"
8,2,37,1950,595,637,1232,"6 de julio de 1997"
8,2,37,1951,346,384,730,"6 de julio de 1997"
8,2,37,1952,254,225,479,"6 de julio de 1997"
8,2,37,1953,250,282,532,"6 de julio de 1997"
8,2,37,1954,225,259,484,"6 de julio de 1997"
8,2,37,1955,355,379,734,"6 de julio de 1997"
8,2,37,1956,291,325,616,"6 de julio de 1997"
8,2,37,1957,197,210,407,"6 de julio de 1997"
8,2,37,1958,216,290,506,"6 de julio de 1997"
8,2,37,1959,254,292,546,"6 de julio de 1997"
8,2,37,1960,252,281,533,"6 de julio de 1997"
8,2,37,1961,296,305,601,"6 de julio de 1997"
8,2,37,1962,243,252,495,"6 de julio de 1997"
8,2,37,1963,200,210,410,"6 de julio de 1997"
8,2,37,1964,230,258,488,"6 de julio de 1997"
8,2,37,1965,258,271,529,"6 de julio de 1997"
8,2,37,1966,207,240,447,"6 de julio de 1997"
8,2,37,1967,256,268,524,"6 de julio de 1997"
8,2,37,1968,314,327,641,"6 de julio de 1997"
8,2,37,1969,252,287,539,"6 de julio de 1997"
8,2,37,1970,172,204,376,"6 de julio de 1997"
8,2,37,1971,296,315,611,"6 de julio de 1997"
8,2,37,1972,285,306,591,"6 de julio de 1997"
8,2,37,1973,285,293,578,"6 de julio de 1997"
8,2,37,1974,483,586,1069,"6 de julio de 1997"
8,2,37,1975,292,293,585,"6 de julio de 1997"
8,2,37,1976,372,363,735,"6 de julio de 1997"
8,2,37,1977,269,304,573,"6 de julio de 1997"
8,2,37,1978,481,508,989,"6 de julio de 1997"
8,2,37,1979,373,407,780,"6 de julio de 1997"
8,2,37,1980,246,255,501,"6 de julio de 1997"
8,2,37,1981,303,277,580,"6 de julio de 1997"
8,2,37,1982,282,289,571,"6 de julio de 1997"
8,2,37,1983,287,293,580,"6 de julio de 1997"
8,2,37,1984,269,316,585,"6 de julio de 1997"
8,2,37,1985,311,358,669,"6 de julio de 1997"
8,2,37,1986,503,563,1066,"6 de julio de 1997"
8,2,37,1987,404,431,835,"6 de julio de 1997"
8,2,37,1988,409,426,835,"6 de julio de 1997"
8,2,37,1995,333,434,767,"6 de julio de 1997"
8,2,37,1996,306,336,642,"6 de julio de 1997"
8,2,37,1997,284,335,619,"6 de julio de 1997"
8,2,37,1998,255,282,537,"6 de julio de 1997"
8,2,37,1999,267,287,554,"6 de julio de 1997"
8,2,37,2000,504,488,992,"6 de julio de 1997"
8,2,37,2001,386,403,789,"6 de julio de 1997"
8,2,37,2002,336,373,709,"6 de julio de 1997"
8,2,37,2003,349,358,707,"6 de julio de 1997"
8,2,37,2004,243,266,509,"6 de julio de 1997"
8,2,37,2005,270,276,546,"6 de julio de 1997"
8,2,37,2006,251,280,531,"6 de julio de 1997"
8,2,37,2007,318,344,662,"6 de julio de 1997"
8,2,37,2008,420,434,854,"6 de julio de 1997"
8,2,37,2009,294,325,619,"6 de julio de 1997"
8,2,37,2010,459,459,918,"6 de julio de 1997"
8,2,37,2011,298,305,603,"6 de julio de 1997"
8,2,37,2012,464,510,974,"6 de julio de 1997"
8,3,37,1574,333,387,720,"6 de julio de 1997"
8,3,37,1575,554,638,1192,"6 de julio de 1997"
8,3,37,1576,462,580,1042,"6 de julio de 1997"
8,3,37,1577,327,386,713,"6 de julio de 1997"
8,3,37,1578,568,607,1175,"6 de julio de 1997"
8,3,37,1595,556,601,1157,"6 de julio de 1997"
8,3,37,1596,302,385,687,"6 de julio de 1997"
8,3,37,1597,317,363,680,"6 de julio de 1997"
8,3,37,1598,601,635,1236,"6 de julio de 1997"
8,3,37,1599,354,373,727,"6 de julio de 1997"
8,3,37,1600,318,364,682,"6 de julio de 1997"
8,3,37,1601,256,285,541,"6 de julio de 1997"
8,3,37,1602,329,397,726,"6 de julio de 1997"
8,3,37,1603,645,663,1308,"6 de julio de 1997"
8,3,37,1621,736,811,1547,"6 de julio de 1997"
8,3,37,1622,178,209,387,"6 de julio de 1997"
8,3,37,1623,529,594,1123,"6 de julio de 1997"
8,3,37,1638,411,459,870,"6 de julio de 1997"
8,3,37,1639,425,469,894,"6 de julio de 1997"
8,3,37,1640,200,230,430,"6 de julio de 1997"
8,3,37,1641,617,690,1307,"6 de julio de 1997"
8,3,37,1642,407,434,841,"6 de julio de 1997"
8,3,37,1666,709,809,1518,"6 de julio de 1997"
8,3,37,1667,279,262,541,"6 de julio de 1997"
8,3,37,1668,263,274,537,"6 de julio de 1997"
8,3,37,1669,182,200,382,"6 de julio de 1997"
8,3,37,1677,213,268,481,"6 de julio de 1997"
8,3,37,1678,484,530,1014,"6 de julio de 1997"
8,3,37,1679,406,450,856,"6 de julio de 1997"
8,3,37,1680,423,519,942,"6 de julio de 1997"
8,3,37,1681,283,328,611,"6 de julio de 1997"
8,3,37,1682,438,491,929,"6 de julio de 1997"
8,3,37,1683,147,120,267,"6 de julio de 1997"
8,3,37,1684,518,632,1150,"6 de julio de 1997"
8,3,37,1685,261,287,548,"6 de julio de 1997"
8,3,37,1686,324,350,674,"6 de julio de 1997"
8,3,37,1691,165,194,359,"6 de julio de 1997"
8,3,37,1692,338,364,702,"6 de julio de 1997"
8,3,37,1693,448,483,931,"6 de julio de 1997"
8,3,37,1694,552,569,1121,"6 de julio de 1997"
8,3,37,1695,238,257,495,"6 de julio de 1997"
8,3,37,1696,368,405,773,"6 de julio de 1997"
8,3,37,1698,288,316,604,"6 de julio de 1997"
8,3,37,1699,260,298,558,"6 de julio de 1997"
8,3,37,1700,409,472,881,"6 de julio de 1997"
8,3,37,1701,486,594,1080,"6 de julio de 1997"
8,3,37,1702,504,555,1059,"6 de julio de 1997"
8,3,37,1703,445,540,985,"6 de julio de 1997"
8,3,37,1704,566,578,1144,"6 de julio de 1997"
8,3,37,1705,451,505,956,"6 de julio de 1997"
8,3,37,1706,634,650,1284,"6 de julio de 1997"
8,3,37,1707,434,553,987,"6 de julio de 1997"
8,3,37,1708,377,445,822,"6 de julio de 1997"
8,3,37,1709,286,311,597,"6 de julio de 1997"
8,3,37,1710,396,476,872,"6 de julio de 1997"
8,3,37,1711,709,755,1464,"6 de julio de 1997"
8,3,37,1715,401,444,845,"6 de julio de 1997"
8,3,37,1716,587,640,1227,"6 de julio de 1997"
8,3,37,1717,612,631,1243,"6 de julio de 1997"
8,3,37,1718,261,310,571,"6 de julio de 1997"
8,3,37,1719,229,257,486,"6 de julio de 1997"
8,3,37,1720,459,558,1017,"6 de julio de 1997"
8,3,37,1721,270,314,584,"6 de julio de 1997"
8,3,37,1722,210,240,450,"6 de julio de 1997"
8,3,37,1723,324,338,662,"6 de julio de 1997"
8,3,37,1724,421,479,900,"6 de julio de 1997"
8,3,37,1727,247,256,503,"6 de julio de 1997"
8,3,37,1728,130,131,261,"6 de julio de 1997"
8,3,37,1729,578,648,1226,"6 de julio de 1997"
8,3,37,1730,319,375,694,"6 de julio de 1997"
8,3,37,1731,233,286,519,"6 de julio de 1997"
8,3,37,1732,688,729,1417,"6 de julio de 1997"
8,3,37,1733,315,326,641,"6 de julio de 1997"
8,3,37,1734,857,750,1607,"6 de julio de 1997"
8,3,37,1735,340,386,726,"6 de julio de 1997"
8,3,37,1736,295,285,580,"6 de julio de 1997"
8,3,37,1737,272,249,521,"6 de julio de 1997"
8,3,37,1738,351,410,761,"6 de julio de 1997"
8,3,37,1739,228,265,493,"6 de julio de 1997"
8,3,37,1740,258,296,554,"6 de julio de 1997"
8,3,37,1741,106,114,220,"6 de julio de 1997"
8,3,37,1742,115,109,224,"6 de julio de 1997"
8,3,37,1743,196,189,385,"6 de julio de 1997"
8,3,37,1744,427,470,897,"6 de julio de 1997"
8,3,37,1745,980,1003,1983,"6 de julio de 1997"
8,3,37,1746,365,422,787,"6 de julio de 1997"
8,3,37,1747,178,180,358,"6 de julio de 1997"
8,3,37,1750,393,385,778,"6 de julio de 1997"
8,3,37,1751,233,252,485,"6 de julio de 1997"
8,3,37,1752,212,195,407,"6 de julio de 1997"
8,3,37,1753,395,461,856,"6 de julio de 1997"
8,3,37,1754,301,349,650,"6 de julio de 1997"
8,3,37,1755,377,398,775,"6 de julio de 1997"
8,3,37,1756,419,437,856,"6 de julio de 1997"
8,3,37,1757,564,577,1141,"6 de julio de 1997"
8,3,37,1758,1467,1530,2997,"6 de julio de 1997"
8,3,37,1759,253,273,526,"6 de julio de 1997"
8,3,37,1760,370,396,766,"6 de julio de 1997"
8,3,37,1765,282,303,585,"6 de julio de 1997"
8,3,37,1766,484,519,1003,"6 de julio de 1997"
8,3,37,1771,152,156,308,"6 de julio de 1997"
8,3,37,1772,615,666,1281,"6 de julio de 1997"
8,3,37,1773,255,290,545,"6 de julio de 1997"
8,3,37,1774,387,416,803,"6 de julio de 1997"
8,3,37,1775,488,486,974,"6 de julio de 1997"
8,3,37,1785,304,308,612,"6 de julio de 1997"
8,3,37,1786,310,317,627,"6 de julio de 1997"
8,3,37,1787,502,566,1068,"6 de julio de 1997"
8,3,37,1788,200,213,413,"6 de julio de 1997"
8,3,37,1789,247,277,524,"6 de julio de 1997"
8,3,37,1790,312,361,673,"6 de julio de 1997"
8,3,37,1791,264,285,549,"6 de julio de 1997"
8,3,37,1792,129,173,302,"6 de julio de 1997"
8,3,37,1793,319,374,693,"6 de julio de 1997"
8,3,37,1794,401,463,864,"6 de julio de 1997"
8,3,37,1795,279,337,616,"6 de julio de 1997"
8,3,37,1796,398,455,853,"6 de julio de 1997"
8,3,37,1797,321,358,679,"6 de julio de 1997"
8,3,37,1798,273,308,581,"6 de julio de 1997"
8,3,37,1799,472,517,989,"6 de julio de 1997"
8,3,37,1800,286,344,630,"6 de julio de 1997"
8,3,37,1801,250,278,528,"6 de julio de 1997"
8,3,37,1804,195,206,401,"6 de julio de 1997"
8,3,37,1805,287,312,599,"6 de julio de 1997"
8,3,37,1806,296,302,598,"6 de julio de 1997"
8,3,37,1807,323,341,664,"6 de julio de 1997"
8,3,37,1808,371,382,753,"6 de julio de 1997"
8,3,37,1809,252,271,523,"6 de julio de 1997"
8,3,37,1810,267,318,585,"6 de julio de 1997"
8,3,37,1811,300,338,638,"6 de julio de 1997"
8,3,37,1812,363,401,764,"6 de julio de 1997"
8,3,37,1813,272,318,590,"6 de julio de 1997"
8,3,37,1814,346,395,741,"6 de julio de 1997"
8,3,37,1815,454,435,889,"6 de julio de 1997"
8,3,37,1816,271,246,517,"6 de julio de 1997"
8,3,37,1822,295,328,623,"6 de julio de 1997"
8,3,37,1823,325,324,649,"6 de julio de 1997"
8,3,37,1824,351,346,697,"6 de julio de 1997"
8,3,37,1825,379,391,770,"6 de julio de 1997"
8,3,37,1826,1362,1412,2774,"6 de julio de 1997"
8,3,37,1827,561,600,1161,"6 de julio de 1997"
8,3,37,1828,431,456,887,"6 de julio de 1997"
8,3,37,1829,400,448,848,"6 de julio de 1997"
8,3,37,1830,341,360,701,"6 de julio de 1997"
8,3,37,1831,292,281,573,"6 de julio de 1997"
8,3,37,1832,350,350,700,"6 de julio de 1997"
8,3,37,1833,229,251,480,"6 de julio de 1997"
8,3,37,1834,374,384,758,"6 de julio de 1997"
8,3,37,1841,340,368,708,"6 de julio de 1997"
8,3,37,1842,344,402,746,"6 de julio de 1997"
8,3,37,1843,319,360,679,"6 de julio de 1997"
8,3,37,1844,357,379,736,"6 de julio de 1997"
8,3,37,1845,384,366,750,"6 de julio de 1997"
8,3,37,1846,340,325,665,"6 de julio de 1997"
8,3,37,1847,288,346,634,"6 de julio de 1997"
8,3,37,1848,260,291,551,"6 de julio de 1997"
8,3,37,1849,261,305,566,"6 de julio de 1997"
8,3,37,1852,262,299,561,"6 de julio de 1997"
8,3,37,1853,320,332,652,"6 de julio de 1997"
8,3,37,1854,375,374,749,"6 de julio de 1997"
8,3,37,1855,367,382,749,"6 de julio de 1997"
8,3,37,1856,264,261,525,"6 de julio de 1997"
8,3,37,1857,419,409,828,"6 de julio de 1997"
8,3,37,1858,385,403,788,"6 de julio de 1997"
8,3,37,1859,286,291,577,"6 de julio de 1997"
8,3,37,1860,505,541,1046,"6 de julio de 1997"
8,3,37,1861,199,219,418,"6 de julio de 1997"
8,3,37,1862,273,284,557,"6 de julio de 1997"
8,3,37,1863,376,354,730,"6 de julio de 1997"
8,3,37,1864,196,168,364,"6 de julio de 1997"
8,3,37,1865,283,330,613,"6 de julio de 1997"
8,3,37,1866,360,381,741,"6 de julio de 1997"
8,3,37,1867,218,269,487,"6 de julio de 1997"
8,3,37,1868,437,465,902,"6 de julio de 1997"
8,3,37,1869,442,434,876,"6 de julio de 1997"
8,3,37,1870,314,336,650,"6 de julio de 1997"
8,3,37,1871,411,445,856,"6 de julio de 1997"
8,3,37,1872,368,455,823,"6 de julio de 1997"
8,3,37,1873,226,250,476,"6 de julio de 1997"
8,3,37,1874,295,300,595,"6 de julio de 1997"
8,3,37,1875,214,229,443,"6 de julio de 1997"
8,3,37,1876,282,266,548,"6 de julio de 1997"
8,3,37,1877,687,691,1378,"6 de julio de 1997"
8,3,37,1878,665,755,1420,"6 de julio de 1997"
8,3,37,1879,802,742,1544,"6 de julio de 1997"
8,3,37,1880,412,434,846,"6 de julio de 1997"
8,3,37,1881,253,296,549,"6 de julio de 1997"
8,3,37,1882,334,315,649,"6 de julio de 1997"
8,3,37,1883,483,473,956,"6 de julio de 1997"
8,3,37,1885,1925,1849,3774,"6 de julio de 1997"
8,3,37,1886,443,452,895,"6 de julio de 1997"
8,3,37,1887,1049,1130,2179,"6 de julio de 1997"
8,3,37,1888,734,704,1438,"6 de julio de 1997"
8,3,37,1889,1591,1452,3043,"6 de julio de 1997"
8,3,37,1891,481,482,963,"6 de julio de 1997"
8,3,37,1892,567,537,1104,"6 de julio de 1997"
8,3,37,1893,314,277,591,"6 de julio de 1997"
8,3,37,1894,280,271,551,"6 de julio de 1997"
8,3,37,1898,409,377,786,"6 de julio de 1997"
8,3,37,1899,321,301,622,"6 de julio de 1997"
8,3,37,1900,352,327,679,"6 de julio de 1997"
8,3,37,1901,331,330,661,"6 de julio de 1997"
8,3,37,1902,433,419,852,"6 de julio de 1997"
8,3,37,1903,346,356,702,"6 de julio de 1997"
8,3,37,1904,361,364,725,"6 de julio de 1997"
8,3,37,1905,184,191,375,"6 de julio de 1997"
8,3,37,1906,349,352,701,"6 de julio de 1997"
8,3,37,1907,648,634,1282,"6 de julio de 1997"
8,3,37,1908,440,450,890,"6 de julio de 1997"
8,3,37,1909,326,293,619,"6 de julio de 1997"
8,3,37,1910,373,350,723,"6 de julio de 1997"
8,3,37,1912,325,330,655,"6 de julio de 1997"
8,3,37,1916,585,615,1200,"6 de julio de 1997"
8,3,37,1917,271,280,551,"6 de julio de 1997"
8,3,37,1918,309,361,670,"6 de julio de 1997"
8,3,37,1919,385,424,809,"6 de julio de 1997"
8,3,37,1920,338,385,723,"6 de julio de 1997"
8,3,37,1921,336,406,742,"6 de julio de 1997"
8,3,37,1922,282,350,632,"6 de julio de 1997"
8,3,37,1923,303,355,658,"6 de julio de 1997"
8,3,37,1924,212,276,488,"6 de julio de 1997"
8,3,37,1925,335,394,729,"6 de julio de 1997"
8,3,37,1926,334,366,700,"6 de julio de 1997"
8,3,37,1927,350,393,743,"6 de julio de 1997"
8,3,37,1928,286,318,604,"6 de julio de 1997"
8,3,37,1929,883,896,1779,"6 de julio de 1997"
8,3,37,1930,826,849,1675,"6 de julio de 1997"
8,3,37,1931,369,343,712,"6 de julio de 1997"
8,3,37,1932,535,553,1088,"6 de julio de 1997"
8,3,37,1933,727,803,1530,"6 de julio de 1997"
8,3,37,1934,262,321,583,"6 de julio de 1997"
8,3,37,1935,307,333,640,"6 de julio de 1997"
8,3,37,1936,554,597,1151,"6 de julio de 1997"
8,3,37,1937,189,212,401,"6 de julio de 1997"
8,3,37,1938,194,241,435,"6 de julio de 1997"
8,3,37,1939,383,399,782,"6 de julio de 1997"
8,3,37,1940,603,694,1297,"6 de julio de 1997"
8,3,37,1941,186,215,401,"6 de julio de 1997"
8,3,37,1942,673,682,1355,"6 de julio de 1997"
8,3,37,1943,473,453,926,"6 de julio de 1997"
8,3,37,1944,263,287,550,"6 de julio de 1997"
8,3,37,1945,360,282,642,"6 de julio de 1997"
8,3,37,1946,327,347,674,"6 de julio de 1997"
8,3,37,1947,540,574,1114,"6 de julio de 1997"
8,3,37,1948,550,578,1128,"6 de julio de 1997"
8,3,37,1949,193,177,370,"6 de julio de 1997"
8,4,37,1562,128,140,268,"6 de julio de 1997"
8,4,37,1674,432,508,940,"6 de julio de 1997"
8,4,37,1675,617,663,1280,"6 de julio de 1997"
8,4,37,1676,464,520,984,"6 de julio de 1997"
8,4,37,1687,496,499,995,"6 de julio de 1997"
8,4,37,1688,367,402,769,"6 de julio de 1997"
8,4,37,1689,399,434,833,"6 de julio de 1997"
8,4,37,1690,383,402,785,"6 de julio de 1997"
8,4,37,1697,446,493,939,"6 de julio de 1997"
8,4,37,1712,487,525,1012,"6 de julio de 1997"
8,4,37,1713,204,239,443,"6 de julio de 1997"
8,4,37,1714,311,290,601,"6 de julio de 1997"
8,4,37,1725,277,300,577,"6 de julio de 1997"
8,4,37,1726,401,451,852,"6 de julio de 1997"
8,4,37,1748,311,332,643,"6 de julio de 1997"
8,4,37,1749,502,523,1025,"6 de julio de 1997"
8,4,37,1761,281,282,563,"6 de julio de 1997"
8,4,37,1762,252,257,509,"6 de julio de 1997"
8,4,37,1763,983,874,1857,"6 de julio de 1997"
8,4,37,1764,577,593,1170,"6 de julio de 1997"
8,4,37,1767,375,374,749,"6 de julio de 1997"
8,4,37,1768,435,463,898,"6 de julio de 1997"
8,4,37,1769,520,543,1063,"6 de julio de 1997"
8,4,37,1770,308,303,611,"6 de julio de 1997"
8,4,37,1776,313,325,638,"6 de julio de 1997"
8,4,37,1777,303,318,621,"6 de julio de 1997"
8,4,37,1778,504,542,1046,"6 de julio de 1997"
8,4,37,1779,492,518,1010,"6 de julio de 1997"
8,4,37,1780,173,169,342,"6 de julio de 1997"
8,4,37,1781,281,320,601,"6 de julio de 1997"
8,4,37,1782,410,394,804,"6 de julio de 1997"
8,4,37,1783,432,482,914,"6 de julio de 1997"
8,4,37,1784,482,486,968,"6 de julio de 1997"
8,4,37,1802,210,198,408,"6 de julio de 1997"
8,4,37,1803,239,237,476,"6 de julio de 1997"
8,4,37,1817,285,278,563,"6 de julio de 1997"
8,4,37,1818,292,321,613,"6 de julio de 1997"
8,4,37,1819,347,364,711,"6 de julio de 1997"
8,4,37,1820,278,308,586,"6 de julio de 1997"
8,4,37,1821,453,533,986,"6 de julio de 1997"
8,4,37,1835,327,311,638,"6 de julio de 1997"
8,4,37,1836,361,343,704,"6 de julio de 1997"
8,4,37,1837,682,667,1349,"6 de julio de 1997"
8,4,37,1838,459,463,922,"6 de julio de 1997"
8,4,37,1839,310,333,643,"6 de julio de 1997"
8,4,37,1840,380,393,773,"6 de julio de 1997"
8,4,37,1850,261,289,550,"6 de julio de 1997"
8,4,37,1851,511,465,976,"6 de julio de 1997"
8,4,37,1884,50,41,91,"6 de julio de 1997"
8,4,37,1890,33,26,59,"6 de julio de 1997"
8,4,37,1895,303,300,603,"6 de julio de 1997"
8,4,37,1896,351,329,680,"6 de julio de 1997"
8,4,37,1897,280,301,581,"6 de julio de 1997"
8,4,37,1911,308,277,585,"6 de julio de 1997"
8,4,37,1913,1167,1098,2265,"6 de julio de 1997"
8,4,37,1914,255,223,478,"6 de julio de 1997"
8,4,37,1915,28,30,58,"6 de julio de 1997"
8,4,37,1989,294,344,638,"6 de julio de 1997"
8,4,37,1990,412,367,779,"6 de julio de 1997"
8,4,37,1991,411,388,799,"6 de julio de 1997"
8,4,37,1992,439,467,906,"6 de julio de 1997"
8,4,37,1993,405,482,887,"6 de julio de 1997"
8,4,37,1994,473,528,1001,"6 de julio de 1997"
8,4,37,2013,419,418,837,"6 de julio de 1997"
8,4,37,2014,401,427,828,"6 de julio de 1997"
8,4,37,2015,307,337,644,"6 de julio de 1997"
8,4,37,2016,306,335,641,"6 de julio de 1997"
8,4,37,2017,415,417,832,"6 de julio de 1997"
8,4,37,2018,349,336,685,"6 de julio de 1997"
8,4,37,2019,445,470,915,"6 de julio de 1997"
8,4,37,2020,329,339,668,"6 de julio de 1997"
8,4,37,2021,283,297,580,"6 de julio de 1997"
8,4,37,2022,335,402,737,"6 de julio de 1997"
8,4,37,2023,284,309,593,"6 de julio de 1997"
8,4,37,2024,438,499,937,"6 de julio de 1997"
8,4,37,2025,454,493,947,"6 de julio de 1997"
8,4,37,2026,496,487,983,"6 de julio de 1997"
8,4,37,2027,355,400,755,"6 de julio de 1997"
8,4,37,2028,545,576,1121,"6 de julio de 1997"
8,4,37,2029,487,540,1027,"6 de julio de 1997"
8,4,37,2030,281,284,565,"6 de julio de 1997"
8,4,37,2031,563,552,1115,"6 de julio de 1997"
8,4,37,2032,323,332,655,"6 de julio de 1997"
8,4,37,2033,453,473,926,"6 de julio de 1997"
8,4,37,2034,313,366,679,"6 de julio de 1997"
8,4,37,2035,320,306,626,"6 de julio de 1997"
8,4,37,2036,382,404,786,"6 de julio de 1997"
8,4,37,2037,385,424,809,"6 de julio de 1997"
8,4,37,2038,643,713,1356,"6 de julio de 1997"
8,4,37,2039,303,344,647,"6 de julio de 1997"
8,4,37,2040,296,298,594,"6 de julio de 1997"
8,4,37,2041,481,515,996,"6 de julio de 1997"
8,4,37,2042,414,428,842,"6 de julio de 1997"
8,4,37,2043,253,273,526,"6 de julio de 1997"
8,4,37,2044,358,366,724,"6 de julio de 1997"
8,4,37,2045,391,392,783,"6 de julio de 1997"
8,4,37,2046,212,224,436,"6 de julio de 1997"
8,4,37,2047,302,319,621,"6 de julio de 1997"
8,4,37,2048,455,489,944,"6 de julio de 1997"
8,4,37,2049,401,384,785,"6 de julio de 1997"
8,4,37,2050,274,279,553,"6 de julio de 1997"
8,4,37,2051,269,280,549,"6 de julio de 1997"
8,4,37,2052,661,670,1331,"6 de julio de 1997"
8,4,37,2053,650,666,1316,"6 de julio de 1997"
8,4,37,2054,600,564,1164,"6 de julio de 1997"
8,4,37,2055,714,669,1383,"6 de julio de 1997"
8,4,37,2056,612,609,1221,"6 de julio de 1997"
8,4,37,2057,707,695,1402,"6 de julio de 1997"
8,4,37,2058,382,385,767,"6 de julio de 1997"
8,4,37,2059,178,184,362,"6 de julio de 1997"
8,4,37,2060,434,497,931,"6 de julio de 1997"
8,4,37,2061,373,402,775,"6 de julio de 1997"
8,4,37,2062,332,338,670,"6 de julio de 1997"
8,4,37,2063,193,189,382,"6 de julio de 1997"
8,4,37,2064,253,297,550,"6 de julio de 1997"
8,4,37,2065,517,504,1021,"6 de julio de 1997"
8,4,37,2066,390,411,801,"6 de julio de 1997"
8,4,37,2067,352,375,727,"6 de julio de 1997"
8,4,37,2068,496,523,1019,"6 de julio de 1997"
8,4,37,2069,523,557,1080,"6 de julio de 1997"
8,4,37,2070,502,574,1076,"6 de julio de 1997"
8,4,37,2071,254,272,526,"6 de julio de 1997"
8,4,37,2072,285,318,603,"6 de julio de 1997"
8,4,37,2073,386,378,764,"6 de julio de 1997"
8,4,37,2074,585,600,1185,"6 de julio de 1997"
8,4,37,2075,365,383,748,"6 de julio de 1997"
8,4,37,2076,282,295,577,"6 de julio de 1997"
8,4,37,2077,510,490,1000,"6 de julio de 1997"
8,4,37,2078,645,623,1268,"6 de julio de 1997"
8,4,37,2079,451,408,859,"6 de julio de 1997"
8,4,37,2080,284,282,566,"6 de julio de 1997"
8,4,37,2081,332,342,674,"6 de julio de 1997"
8,4,37,2082,369,364,733,"6 de julio de 1997"
8,4,37,2083,385,403,788,"6 de julio de 1997"
8,4,37,2084,257,270,527,"6 de julio de 1997"
8,4,37,2085,322,344,666,"6 de julio de 1997"
8,4,37,2086,477,497,974,"6 de julio de 1997"
8,4,37,2087,249,250,499,"6 de julio de 1997"
8,4,37,2088,293,323,616,"6 de julio de 1997"
8,4,37,2089,398,415,813,"6 de julio de 1997"
8,4,37,2090,351,363,714,"6 de julio de 1997"
8,4,37,2091,266,296,562,"6 de julio de 1997"
8,4,37,2092,220,233,453,"6 de julio de 1997"
8,4,37,2093,391,394,785,"6 de julio de 1997"
8,4,37,2094,603,609,1212,"6 de julio de 1997"
8,4,37,2095,298,310,608,"6 de julio de 1997"
8,4,37,2096,270,253,523,"6 de julio de 1997"
8,4,37,2097,473,538,1011,"6 de julio de 1997"
8,4,37,2098,422,384,806,"6 de julio de 1997"
8,4,37,2099,218,221,439,"6 de julio de 1997"
8,4,37,2100,351,320,671,"6 de julio de 1997"
8,4,37,2101,407,439,846,"6 de julio de 1997"
8,4,37,2102,794,827,1621,"6 de julio de 1997"
8,4,37,2103,649,641,1290,"6 de julio de 1997"
8,4,37,2104,561,600,1161,"6 de julio de 1997"
8,4,37,2105,343,363,706,"6 de julio de 1997"
8,4,37,2106,519,453,972,"6 de julio de 1997"
8,4,37,2107,419,457,876,"6 de julio de 1997"
8,4,37,2108,442,432,874,"6 de julio de 1997"
8,4,37,2109,467,472,939,"6 de julio de 1997"
8,4,37,2110,120,101,221,"6 de julio de 1997"
8,4,37,2111,487,527,1014,"6 de julio de 1997"
8,4,37,2112,445,442,887,"6 de julio de 1997"
8,4,37,2113,351,329,680,"6 de julio de 1997"
8,4,37,2114,560,589,1149,"6 de julio de 1997"
8,4,37,2115,229,252,481,"6 de julio de 1997"
8,4,37,2116,406,397,803,"6 de julio de 1997"
8,4,37,2117,123,146,269,"6 de julio de 1997"
8,4,37,2118,298,334,632,"6 de julio de 1997"
8,4,37,2119,394,411,805,"6 de julio de 1997"
8,4,37,2120,401,387,788,"6 de julio de 1997"
8,4,37,2121,603,630,1233,"6 de julio de 1997"
8,4,37,2122,324,285,609,"6 de julio de 1997"
8,4,37,2123,601,583,1184,"6 de julio de 1997"
8,4,37,2124,257,248,505,"6 de julio de 1997"
8,4,37,2125,203,205,408,"6 de julio de 1997"
8,4,37,2126,278,267,545,"6 de julio de 1997"
8,4,37,2127,381,386,767,"6 de julio de 1997"
8,4,37,2128,277,276,553,"6 de julio de 1997"
8,4,37,2129,437,407,844,"6 de julio de 1997"
8,4,37,2130,924,807,1731,"6 de julio de 1997"
8,4,37,2131,876,896,1772,"6 de julio de 1997"
8,4,37,2132,354,369,723,"6 de julio de 1997"
8,4,37,2133,544,587,1131,"6 de julio de 1997"
8,4,37,2134,666,757,1423,"6 de julio de 1997"
8,4,37,2135,633,645,1278,"6 de julio de 1997"
8,4,37,2136,377,356,733,"6 de julio de 1997"
8,4,37,2137,462,483,945,"6 de julio de 1997"
8,4,37,2138,200,178,378,"6 de julio de 1997"
8,4,37,2139,268,273,541,"6 de julio de 1997"
8,4,37,2140,600,550,1150,"6 de julio de 1997"
8,4,37,2141,446,493,939,"6 de julio de 1997"
8,4,37,2142,490,513,1003,"6 de julio de 1997"
8,4,37,2143,307,296,603,"6 de julio de 1997"
8,4,37,2144,276,283,559,"6 de julio de 1997"
8,4,37,2145,537,596,1133,"6 de julio de 1997"
8,4,37,2146,277,343,620,"6 de julio de 1997"
8,4,37,2147,283,286,569,"6 de julio de 1997"
8,4,37,2148,292,320,612,"6 de julio de 1997"
8,4,37,2149,449,479,928,"6 de julio de 1997"
8,4,37,2150,239,261,500,"6 de julio de 1997"
8,4,37,2151,329,369,698,"6 de julio de 1997"
8,4,37,2152,551,593,1144,"6 de julio de 1997"
8,4,37,2153,527,543,1070,"6 de julio de 1997"
8,4,37,2154,456,450,906,"6 de julio de 1997"
8,4,37,2155,852,879,1731,"6 de julio de 1997"
8,4,37,2156,353,340,693,"6 de julio de 1997"
8,4,37,2157,195,211,406,"6 de julio de 1997"
8,4,37,2158,433,457,890,"6 de julio de 1997"
8,4,37,2159,332,345,677,"6 de julio de 1997"
8,4,37,2160,293,281,574,"6 de julio de 1997"
8,4,37,2161,298,321,619,"6 de julio de 1997"
8,4,37,2162,224,205,429,"6 de julio de 1997"
8,4,37,2163,295,301,596,"6 de julio de 1997"
8,4,37,2164,249,260,509,"6 de julio de 1997"
8,4,37,2165,396,426,822,"6 de julio de 1997"
8,4,37,2166,463,459,922,"6 de julio de 1997"
8,4,37,2167,355,360,715,"6 de julio de 1997"
8,4,37,2168,187,215,402,"6 de julio de 1997"
8,4,37,2169,219,207,426,"6 de julio de 1997"
8,4,37,2170,215,214,429,"6 de julio de 1997"
8,4,37,2171,333,331,664,"6 de julio de 1997"
8,4,37,2172,559,596,1155,"6 de julio de 1997"
8,4,37,2173,588,595,1183,"6 de julio de 1997"
8,4,37,2174,513,565,1078,"6 de julio de 1997"
8,4,37,2175,257,249,506,"6 de julio de 1997"
8,4,37,2176,291,315,606,"6 de julio de 1997"
8,4,37,2177,463,476,939,"6 de julio de 1997"
8,4,37,2178,476,467,943,"6 de julio de 1997"
8,4,37,2179,509,493,1002,"6 de julio de 1997"
8,4,37,2180,539,547,1086,"6 de julio de 1997"
8,4,37,2181,257,275,532,"6 de julio de 1997"
8,4,37,2182,308,308,616,"6 de julio de 1997"
8,4,37,2183,238,267,505,"6 de julio de 1997"
8,4,37,2184,290,294,584,"6 de julio de 1997"
8,4,37,2185,291,318,609,"6 de julio de 1997"
8,4,37,2186,355,354,709,"6 de julio de 1997"
8,4,37,2187,553,541,1094,"6 de julio de 1997"
8,4,37,2188,891,951,1842,"6 de julio de 1997"
8,4,37,2189,499,487,986,"6 de julio de 1997"
8,4,37,2190,167,163,330,"6 de julio de 1997"
8,4,37,2191,517,514,1031,"6 de julio de 1997"
8,4,37,2192,611,608,1219,"6 de julio de 1997"
8,4,37,2193,466,479,945,"6 de julio de 1997"
8,4,37,2194,271,298,569,"6 de julio de 1997"
8,4,37,2195,580,396,976,"6 de julio de 1997"
8,4,37,2196,141,82,223,"6 de julio de 1997"
8,4,37,2197,406,338,744,"6 de julio de 1997"
8,4,37,2198,1029,1072,2101,"6 de julio de 1997"
8,5,2,17,441,480,921,"6 de julio de 1997"
8,5,2,18,451,466,917,"6 de julio de 1997"
8,5,2,19,340,341,681,"6 de julio de 1997"
8,5,2,20,495,514,1009,"6 de julio de 1997"
8,5,2,21,339,371,710,"6 de julio de 1997"
8,5,2,22,452,462,914,"6 de julio de 1997"
8,5,2,23,456,528,984,"6 de julio de 1997"
8,5,2,24,405,452,857,"6 de julio de 1997"
8,5,2,25,276,284,560,"6 de julio de 1997"
8,5,2,26,259,313,572,"6 de julio de 1997"
8,5,2,27,471,512,983,"6 de julio de 1997"
8,5,2,28,402,409,811,"6 de julio de 1997"
8,5,2,29,46,31,77,"6 de julio de 1997"
8,5,2,30,167,131,298,"6 de julio de 1997"
8,5,2,31,137,122,259,"6 de julio de 1997"
8,5,2,32,254,197,451,"6 de julio de 1997"
8,5,2,33,70,46,116,"6 de julio de 1997"
8,5,2,34,537,459,996,"6 de julio de 1997"
8,5,2,35,201,141,342,"6 de julio de 1997"
8,5,2,36,118,85,203,"6 de julio de 1997"
8,5,2,37,106,59,165,"6 de julio de 1997"
8,5,4,56,725,683,1408,"6 de julio de 1997"
8,5,4,57,255,206,461,"6 de julio de 1997"
8,5,4,58,123,91,214,"6 de julio de 1997"
8,5,4,59,277,253,530,"6 de julio de 1997"
8,5,11,175,183,190,373,"6 de julio de 1997"
8,5,11,176,423,417,840,"6 de julio de 1997"
8,5,11,177,298,345,643,"6 de julio de 1997"
8,5,11,178,295,386,681,"6 de julio de 1997"
8,5,11,179,181,227,408,"6 de julio de 1997"
8,5,11,180,263,281,544,"6 de julio de 1997"
8,5,11,181,249,282,531,"6 de julio de 1997"
8,5,11,182,209,280,489,"6 de julio de 1997"
8,5,11,183,364,357,721,"6 de julio de 1997"
8,5,11,184,287,303,590,"6 de julio de 1997"
8,5,11,185,560,574,1134,"6 de julio de 1997"
8,5,11,186,528,543,1071,"6 de julio de 1997"
8,5,11,187,304,304,608,"6 de julio de 1997"
8,5,11,188,263,292,555,"6 de julio de 1997"
8,5,11,189,400,398,798,"6 de julio de 1997"
8,5,11,190,377,417,794,"6 de julio de 1997"
8,5,11,191,664,721,1385,"6 de julio de 1997"
8,5,11,192,404,464,868,"6 de julio de 1997"
8,5,11,193,373,422,795,"6 de julio de 1997"
8,5,11,194,308,334,642,"6 de julio de 1997"
8,5,11,195,274,280,554,"6 de julio de 1997"
8,5,11,196,523,546,1069,"6 de julio de 1997"
8,5,11,197,455,464,919,"6 de julio de 1997"
8,5,11,198,70,77,147,"6 de julio de 1997"
8,5,11,199,637,602,1239,"6 de julio de 1997"
8,5,11,200,382,394,776,"6 de julio de 1997"
8,5,11,201,370,394,764,"6 de julio de 1997"
8,5,11,202,471,476,947,"6 de julio de 1997"
8,5,11,203,480,485,965,"6 de julio de 1997"
8,5,11,204,591,616,1207,"6 de julio de 1997"
8,5,11,205,414,424,838,"6 de julio de 1997"
8,5,11,206,392,404,796,"6 de julio de 1997"
8,5,11,207,97,86,183,"6 de julio de 1997"
8,5,11,208,97,100,197,"6 de julio de 1997"
8,5,11,209,44,40,84,"6 de julio de 1997"
8,5,11,210,56,43,99,"6 de julio de 1997"
8,5,11,211,71,38,109,"6 de julio de 1997"
8,5,11,212,84,70,154,"6 de julio de 1997"
8,5,11,213,22,17,39,"6 de julio de 1997"
8,5,11,214,159,167,326,"6 de julio de 1997"
8,5,11,215,425,407,832,"6 de julio de 1997"
8,5,11,216,440,407,847,"6 de julio de 1997"
8,5,11,217,268,217,485,"6 de julio de 1997"
8,5,11,218,217,175,392,"6 de julio de 1997"
8,5,11,219,375,285,660,"6 de julio de 1997"
8,5,11,220,118,87,205,"6 de julio de 1997"
8,5,15,261,330,274,604,"6 de julio de 1997"
8,5,15,262,44,18,62,"6 de julio de 1997"
8,5,15,263,85,61,146,"6 de julio de 1997"
8,5,15,264,123,107,230,"6 de julio de 1997"
8,5,15,265,231,181,412,"6 de julio de 1997"
8,5,16,266,300,302,602,"6 de julio de 1997"
8,5,16,267,223,215,438,"6 de julio de 1997"
8,5,16,268,164,142,306,"6 de julio de 1997"
8,5,16,269,294,258,552,"6 de julio de 1997"
8,5,16,270,307,307,614,"6 de julio de 1997"
8,5,21,921,409,434,843,"6 de julio de 1997"
8,5,21,922,429,465,894,"6 de julio de 1997"
8,5,21,923,466,552,1018,"6 de julio de 1997"
8,5,21,924,302,337,639,"6 de julio de 1997"
8,5,21,925,413,375,788,"6 de julio de 1997"
8,5,21,926,349,387,736,"6 de julio de 1997"
8,5,21,927,299,351,650,"6 de julio de 1997"
8,5,21,928,215,259,474,"6 de julio de 1997"
8,5,21,929,335,390,725,"6 de julio de 1997"
8,5,21,930,306,355,661,"6 de julio de 1997"
8,5,21,931,234,267,501,"6 de julio de 1997"
8,5,21,932,332,373,705,"6 de julio de 1997"
8,5,21,933,387,412,799,"6 de julio de 1997"
8,5,21,934,308,356,664,"6 de julio de 1997"
8,5,21,935,314,350,664,"6 de julio de 1997"
8,5,21,936,222,244,466,"6 de julio de 1997"
8,5,21,937,310,336,646,"6 de julio de 1997"
8,5,21,938,207,230,437,"6 de julio de 1997"
8,5,21,939,348,387,735,"6 de julio de 1997"
8,5,21,940,213,239,452,"6 de julio de 1997"
8,5,21,941,246,261,507,"6 de julio de 1997"
8,5,21,942,231,260,491,"6 de julio de 1997"
8,5,21,943,238,258,496,"6 de julio de 1997"
8,5,21,944,315,329,644,"6 de julio de 1997"
8,5,21,945,226,255,481,"6 de julio de 1997"
8,5,21,946,468,487,955,"6 de julio de 1997"
8,5,21,947,274,296,570,"6 de julio de 1997"
8,5,21,948,248,303,551,"6 de julio de 1997"
8,5,21,949,281,274,555,"6 de julio de 1997"
8,5,21,950,338,367,705,"6 de julio de 1997"
8,5,21,951,289,336,625,"6 de julio de 1997"
8,5,21,952,222,232,454,"6 de julio de 1997"
8,5,21,953,343,371,714,"6 de julio de 1997"
8,5,21,954,403,450,853,"6 de julio de 1997"
8,5,21,955,252,312,564,"6 de julio de 1997"
8,5,21,956,240,252,492,"6 de julio de 1997"
8,5,21,957,417,447,864,"6 de julio de 1997"
8,5,21,958,437,481,918,"6 de julio de 1997"
8,5,21,959,334,403,737,"6 de julio de 1997"
8,5,21,960,388,445,833,"6 de julio de 1997"
8,5,21,961,288,328,616,"6 de julio de 1997"
8,5,21,962,421,451,872,"6 de julio de 1997"
8,5,21,963,488,516,1004,"6 de julio de 1997"
8,5,21,964,276,289,565,"6 de julio de 1997"
8,5,21,965,380,437,817,"6 de julio de 1997"
8,5,21,966,291,312,603,"6 de julio de 1997"
8,5,21,967,317,320,637,"6 de julio de 1997"
8,5,21,968,338,383,721,"6 de julio de 1997"
8,5,21,969,404,479,883,"6 de julio de 1997"
8,5,21,970,347,410,757,"6 de julio de 1997"
8,5,21,971,268,340,608,"6 de julio de 1997"
8,5,21,972,444,477,921,"6 de julio de 1997"
8,5,21,973,560,535,1095,"6 de julio de 1997"
8,5,21,974,377,434,811,"6 de julio de 1997"
8,5,21,975,308,334,642,"6 de julio de 1997"
8,5,21,976,297,293,590,"6 de julio de 1997"
8,5,21,977,290,328,618,"6 de julio de 1997"
8,5,21,978,292,333,625,"6 de julio de 1997"
8,5,21,979,285,303,588,"6 de julio de 1997"
8,5,21,980,317,357,674,"6 de julio de 1997"
8,5,21,981,386,431,817,"6 de julio de 1997"
8,5,21,982,308,324,632,"6 de julio de 1997"
8,5,21,983,364,402,766,"6 de julio de 1997"
8,5,21,984,523,632,1155,"6 de julio de 1997"
8,5,21,985,279,313,592,"6 de julio de 1997"
8,5,21,986,235,255,490,"6 de julio de 1997"
8,5,21,987,353,388,741,"6 de julio de 1997"
8,5,21,988,343,358,701,"6 de julio de 1997"
8,5,21,989,424,426,850,"6 de julio de 1997"
8,5,21,990,347,331,678,"6 de julio de 1997"
8,5,21,991,557,608,1165,"6 de julio de 1997"
8,5,21,992,331,364,695,"6 de julio de 1997"
8,5,21,993,259,269,528,"6 de julio de 1997"
8,5,21,994,350,359,709,"6 de julio de 1997"
8,5,21,995,288,340,628,"6 de julio de 1997"
8,5,21,996,374,415,789,"6 de julio de 1997"
8,5,21,997,277,306,583,"6 de julio de 1997"
8,5,21,998,144,141,285,"6 de julio de 1997"
8,5,21,999,184,232,416,"6 de julio de 1997"
8,5,21,1000,345,385,730,"6 de julio de 1997"
8,5,21,1001,885,993,1878,"6 de julio de 1997"
8,5,21,1002,421,465,886,"6 de julio de 1997"
8,5,21,1003,202,235,437,"6 de julio de 1997"
8,5,21,1004,217,232,449,"6 de julio de 1997"
8,5,21,1005,141,157,298,"6 de julio de 1997"
8,5,21,1006,625,638,1263,"6 de julio de 1997"
8,5,21,1007,219,242,461,"6 de julio de 1997"
8,5,21,1008,296,326,622,"6 de julio de 1997"
8,5,21,1009,189,193,382,"6 de julio de 1997"
8,5,21,1010,111,107,218,"6 de julio de 1997"
8,5,21,1011,263,242,505,"6 de julio de 1997"
8,5,21,1012,107,97,204,"6 de julio de 1997"
8,5,21,1013,343,363,706,"6 de julio de 1997"
8,5,21,1014,98,104,202,"6 de julio de 1997"
8,5,21,1015,323,329,652,"6 de julio de 1997"
8,5,21,1016,240,230,470,"6 de julio de 1997"
8,5,21,1017,90,93,183,"6 de julio de 1997"
8,5,21,1018,190,171,361,"6 de julio de 1997"
8,5,21,1019,170,161,331,"6 de julio de 1997"
8,5,21,1020,390,378,768,"6 de julio de 1997"
8,5,21,1021,222,199,421,"6 de julio de 1997"
8,5,21,1022,97,95,192,"6 de julio de 1997"
8,5,21,1023,408,411,819,"6 de julio de 1997"
8,5,21,1024,478,514,992,"6 de julio de 1997"
8,5,21,1025,67,48,115,"6 de julio de 1997"
8,5,21,1026,325,176,501,"6 de julio de 1997"
8,5,21,1027,241,217,458,"6 de julio de 1997"
8,5,21,1028,273,235,508,"6 de julio de 1997"
8,5,21,1029,239,213,452,"6 de julio de 1997"
8,5,21,1030,479,458,937,"6 de julio de 1997"
8,5,38,2199,329,311,640,"6 de julio de 1997"
8,5,38,2200,375,376,751,"6 de julio de 1997"
8,5,38,2201,234,201,435,"6 de julio de 1997"
8,5,38,2202,43,21,64,"6 de julio de 1997"
8,5,38,2203,475,469,944,"6 de julio de 1997"
8,5,38,2204,244,239,483,"6 de julio de 1997"
8,5,38,2205,250,263,513,"6 de julio de 1997"
8,5,42,2266,262,233,495,"6 de julio de 1997"
8,5,42,2267,235,191,426,"6 de julio de 1997"
8,5,42,2268,197,150,347,"6 de julio de 1997"
8,5,42,2269,94,87,181,"6 de julio de 1997"
8,5,42,2270,191,157,348,"6 de julio de 1997"
8,5,45,2288,323,346,669,"6 de julio de 1997"
8,5,45,2289,374,374,748,"6 de julio de 1997"
8,5,45,2290,416,402,818,"6 de julio de 1997"
8,5,45,2291,317,348,665,"6 de julio de 1997"
8,5,45,2292,398,437,835,"6 de julio de 1997"
8,5,45,2293,300,335,635,"6 de julio de 1997"
8,5,45,2294,496,512,1008,"6 de julio de 1997"
8,5,45,2295,278,314,592,"6 de julio de 1997"
8,5,45,2296,377,424,801,"6 de julio de 1997"
8,5,45,2297,372,413,785,"6 de julio de 1997"
8,5,45,2298,295,313,608,"6 de julio de 1997"
8,5,45,2299,375,393,768,"6 de julio de 1997"
8,5,45,2300,437,500,937,"6 de julio de 1997"
8,5,45,2301,427,431,858,"6 de julio de 1997"
8,5,45,2302,521,486,1007,"6 de julio de 1997"
8,5,45,2303,308,284,592,"6 de julio de 1997"
8,5,45,2304,345,322,667,"6 de julio de 1997"
8,5,45,2305,478,484,962,"6 de julio de 1997"
8,5,45,2306,259,267,526,"6 de julio de 1997"
8,5,45,2307,253,256,509,"6 de julio de 1997"
8,5,45,2308,315,314,629,"6 de julio de 1997"
8,5,45,2309,318,304,622,"6 de julio de 1997"
8,5,45,2310,157,145,302,"6 de julio de 1997"
8,5,45,2311,385,386,771,"6 de julio de 1997"
8,5,45,2312,306,283,589,"6 de julio de 1997"
8,5,45,2313,128,130,258,"6 de julio de 1997"
8,5,45,2314,572,518,1090,"6 de julio de 1997"
8,5,45,2315,341,296,637,"6 de julio de 1997"
8,5,45,2316,369,351,720,"6 de julio de 1997"
8,5,45,2317,204,217,421,"6 de julio de 1997"
8,5,45,2318,217,233,450,"6 de julio de 1997"
8,5,45,2319,404,425,829,"6 de julio de 1997"
8,5,45,2320,172,166,338,"6 de julio de 1997"
8,5,45,2321,581,612,1193,"6 de julio de 1997"
8,5,45,2322,459,384,843,"6 de julio de 1997"
8,5,52,2477,378,403,781,"6 de julio de 1997"
8,5,52,2478,207,215,422,"6 de julio de 1997"
8,5,52,2479,358,401,759,"6 de julio de 1997"
8,5,52,2480,298,318,616,"6 de julio de 1997"
8,5,52,2481,461,482,943,"6 de julio de 1997"
8,5,52,2482,275,286,561,"6 de julio de 1997"
8,5,52,2483,297,358,655,"6 de julio de 1997"
8,5,52,2484,265,253,518,"6 de julio de 1997"
8,5,52,2485,329,318,647,"6 de julio de 1997"
8,5,52,2486,383,408,791,"6 de julio de 1997"
8,5,52,2487,369,423,792,"6 de julio de 1997"
8,5,52,2488,317,320,637,"6 de julio de 1997"
8,5,52,2489,293,331,624,"6 de julio de 1997"
8,5,52,2490,349,376,725,"6 de julio de 1997"
8,5,52,2491,331,323,654,"6 de julio de 1997"
8,5,52,2492,434,448,882,"6 de julio de 1997"
8,5,52,2493,516,515,1031,"6 de julio de 1997"
8,5,52,2494,46,32,78,"6 de julio de 1997"
8,5,52,2495,88,73,161,"6 de julio de 1997"
8,5,52,2496,66,61,127,"6 de julio de 1997"
8,5,52,2497,75,69,144,"6 de julio de 1997"
8,5,52,2498,177,125,302,"6 de julio de 1997"
8,5,52,2499,180,156,336,"6 de julio de 1997"
8,5,52,2500,302,266,568,"6 de julio de 1997"
8,5,52,2501,221,205,426,"6 de julio de 1997"
8,5,52,2502,31,26,57,"6 de julio de 1997"
8,5,52,2503,92,66,158,"6 de julio de 1997"
8,5,52,2504,240,212,452,"6 de julio de 1997"
8,5,52,2505,182,137,319,"6 de julio de 1997"
8,5,52,2506,49,32,81,"6 de julio de 1997"
8,5,52,2507,122,98,220,"6 de julio de 1997"
8,5,52,2508,110,98,208,"6 de julio de 1997"
8,5,55,2528,392,436,828,"6 de julio de 1997"
8,5,55,2529,393,389,782,"6 de julio de 1997"
8,5,55,2530,343,338,681,"6 de julio de 1997"
8,5,55,2531,444,470,914,"6 de julio de 1997"
8,5,55,2532,90,70,160,"6 de julio de 1997"
8,5,55,2533,254,192,446,"6 de julio de 1997"
8,5,55,2534,260,244,504,"6 de julio de 1997"
8,5,55,2535,153,146,299,"6 de julio de 1997"
8,5,55,2536,73,33,106,"6 de julio de 1997"
8,5,55,2537,457,407,864,"6 de julio de 1997"
8,5,55,2538,346,376,722,"6 de julio de 1997"
8,5,55,2539,131,115,246,"6 de julio de 1997"
8,5,55,2540,117,116,233,"6 de julio de 1997"
8,5,55,2541,285,265,550,"6 de julio de 1997"
8,5,55,2542,614,568,1182,"6 de julio de 1997"
8,5,55,2543,285,282,567,"6 de julio de 1997"
8,5,55,2544,297,270,567,"6 de julio de 1997"
8,5,58,2559,259,233,492,"6 de julio de 1997"
8,5,58,2560,218,201,419,"6 de julio de 1997"
8,5,58,2561,351,333,684,"6 de julio de 1997"
8,5,58,2562,65,70,135,"6 de julio de 1997"
8,5,58,2563,45,37,82,"6 de julio de 1997"
8,5,58,2564,86,80,166,"6 de julio de 1997"
8,5,58,2565,47,36,83,"6 de julio de 1997"
8,5,62,2615,430,431,861,"6 de julio de 1997"
8,5,62,2616,330,335,665,"6 de julio de 1997"
8,5,62,2617,196,193,389,"6 de julio de 1997"
8,5,62,2618,179,177,356,"6 de julio de 1997"
8,5,62,2619,308,294,602,"6 de julio de 1997"
8,5,62,2620,517,547,1064,"6 de julio de 1997"
8,5,62,2621,246,334,580,"6 de julio de 1997"
8,5,62,2622,329,353,682,"6 de julio de 1997"
8,5,62,2623,324,351,675,"6 de julio de 1997"
8,5,62,2624,375,384,759,"6 de julio de 1997"
8,5,62,2625,269,306,575,"6 de julio de 1997"
8,5,62,2626,342,332,674,"6 de julio de 1997"
8,5,62,2627,449,446,895,"6 de julio de 1997"
8,5,62,2628,389,399,788,"6 de julio de 1997"
8,5,62,2629,236,192,428,"6 de julio de 1997"
8,5,62,2630,167,184,351,"6 de julio de 1997"
8,5,62,2631,251,250,501,"6 de julio de 1997"
8,5,62,2632,310,321,631,"6 de julio de 1997"
8,5,62,2633,275,257,532,"6 de julio de 1997"
8,5,62,2634,407,372,779,"6 de julio de 1997"
8,5,62,2635,329,316,645,"6 de julio de 1997"
8,5,62,2636,417,428,845,"6 de julio de 1997"
8,5,62,2637,235,226,461,"6 de julio de 1997"
8,5,62,2638,397,396,793,"6 de julio de 1997"
8,5,62,2639,294,261,555,"6 de julio de 1997"
8,5,62,2640,414,394,808,"6 de julio de 1997"
8,5,62,2641,246,250,496,"6 de julio de 1997"
8,5,62,2642,184,176,360,"6 de julio de 1997"
8,5,62,2643,282,287,569,"6 de julio de 1997"
8,5,62,2644,252,233,485,"6 de julio de 1997"
8,5,62,2645,189,184,373,"6 de julio de 1997"
8,5,62,2646,208,205,413,"6 de julio de 1997"
8,5,62,2647,335,154,489,"6 de julio de 1997"
8,6,19,608,794,901,1695,"6 de julio de 1997"
8,6,19,609,72,57,129,"6 de julio de 1997"
8,6,19,610,1470,1683,3153,"6 de julio de 1997"
8,6,19,611,871,907,1778,"6 de julio de 1997"
8,6,19,612,623,717,1340,"6 de julio de 1997"
8,6,19,613,598,655,1253,"6 de julio de 1997"
8,6,19,614,425,456,881,"6 de julio de 1997"
8,6,19,615,286,294,580,"6 de julio de 1997"
8,6,19,616,479,477,956,"6 de julio de 1997"
8,6,19,617,500,552,1052,"6 de julio de 1997"
8,6,19,618,273,294,567,"6 de julio de 1997"
8,6,19,619,281,312,593,"6 de julio de 1997"
8,6,19,620,319,367,686,"6 de julio de 1997"
8,6,19,621,733,736,1469,"6 de julio de 1997"
8,6,19,622,149,176,325,"6 de julio de 1997"
8,6,19,623,331,395,726,"6 de julio de 1997"
8,6,19,624,285,376,661,"6 de julio de 1997"
8,6,19,625,253,259,512,"6 de julio de 1997"
8,6,19,626,442,466,908,"6 de julio de 1997"
8,6,19,627,318,372,690,"6 de julio de 1997"
8,6,19,628,297,293,590,"6 de julio de 1997"
8,6,19,629,272,293,565,"6 de julio de 1997"
8,6,19,630,262,264,526,"6 de julio de 1997"
8,6,19,631,264,331,595,"6 de julio de 1997"
8,6,19,632,265,283,548,"6 de julio de 1997"
8,6,19,633,506,536,1042,"6 de julio de 1997"
8,6,19,634,213,246,459,"6 de julio de 1997"
8,6,19,635,189,232,421,"6 de julio de 1997"
8,6,19,636,303,333,636,"6 de julio de 1997"
8,6,19,637,308,314,622,"6 de julio de 1997"
8,6,19,638,298,308,606,"6 de julio de 1997"
8,6,19,639,168,188,356,"6 de julio de 1997"
8,6,19,640,302,311,613,"6 de julio de 1997"
8,6,19,641,1069,1210,2279,"6 de julio de 1997"
8,6,19,642,289,325,614,"6 de julio de 1997"
8,6,19,643,256,284,540,"6 de julio de 1997"
8,6,19,644,309,306,615,"6 de julio de 1997"
8,6,19,645,262,270,532,"6 de julio de 1997"
8,6,19,646,444,466,910,"6 de julio de 1997"
8,6,19,647,502,533,1035,"6 de julio de 1997"
8,6,19,648,317,327,644,"6 de julio de 1997"
8,6,19,649,452,460,912,"6 de julio de 1997"
8,6,19,650,326,315,641,"6 de julio de 1997"
8,6,19,651,402,446,848,"6 de julio de 1997"
8,6,19,652,296,312,608,"6 de julio de 1997"
8,6,19,653,422,495,917,"6 de julio de 1997"
8,6,19,654,327,366,693,"6 de julio de 1997"
8,6,19,655,236,297,533,"6 de julio de 1997"
8,6,19,656,241,267,508,"6 de julio de 1997"
8,6,19,657,374,441,815,"6 de julio de 1997"
8,6,19,658,279,332,611,"6 de julio de 1997"
8,6,19,659,288,348,636,"6 de julio de 1997"
8,6,19,660,360,363,723,"6 de julio de 1997"
8,6,19,661,815,902,1717,"6 de julio de 1997"
8,6,19,662,327,350,677,"6 de julio de 1997"
8,6,19,663,325,331,656,"6 de julio de 1997"
8,6,19,664,301,299,600,"6 de julio de 1997"
8,6,19,665,231,259,490,"6 de julio de 1997"
8,6,19,666,399,428,827,"6 de julio de 1997"
8,6,19,667,284,298,582,"6 de julio de 1997"
8,6,19,668,481,480,961,"6 de julio de 1997"
8,6,19,669,670,690,1360,"6 de julio de 1997"
8,6,19,670,27,27,54,"6 de julio de 1997"
8,6,19,671,603,637,1240,"6 de julio de 1997"
8,6,19,672,376,389,765,"6 de julio de 1997"
8,6,19,673,374,388,762,"6 de julio de 1997"
8,6,19,674,576,624,1200,"6 de julio de 1997"
8,6,19,675,273,308,581,"6 de julio de 1997"
8,6,19,676,331,380,711,"6 de julio de 1997"
8,6,19,677,374,400,774,"6 de julio de 1997"
8,6,19,678,345,407,752,"6 de julio de 1997"
8,6,19,679,470,526,996,"6 de julio de 1997"
8,6,19,680,376,435,811,"6 de julio de 1997"
8,6,19,681,344,392,736,"6 de julio de 1997"
8,6,19,682,283,320,603,"6 de julio de 1997"
8,6,19,683,366,381,747,"6 de julio de 1997"
8,6,19,684,510,548,1058,"6 de julio de 1997"
8,6,19,685,317,358,675,"6 de julio de 1997"
8,6,19,686,385,422,807,"6 de julio de 1997"
8,6,19,687,348,399,747,"6 de julio de 1997"
8,6,19,688,497,529,1026,"6 de julio de 1997"
8,6,19,689,603,621,1224,"6 de julio de 1997"
8,6,19,690,476,487,963,"6 de julio de 1997"
8,6,19,691,354,410,764,"6 de julio de 1997"
8,6,19,692,564,667,1231,"6 de julio de 1997"
8,6,19,693,364,394,758,"6 de julio de 1997"
8,6,19,694,231,299,530,"6 de julio de 1997"
8,6,19,695,553,639,1192,"6 de julio de 1997"
8,6,19,696,618,696,1314,"6 de julio de 1997"
8,6,19,697,636,709,1345,"6 de julio de 1997"
8,6,19,698,263,310,573,"6 de julio de 1997"
8,6,19,699,349,400,749,"6 de julio de 1997"
8,6,19,700,319,377,696,"6 de julio de 1997"
8,6,19,701,174,217,391,"6 de julio de 1997"
8,6,19,702,262,285,547,"6 de julio de 1997"
8,6,19,703,478,566,1044,"6 de julio de 1997"
8,6,19,704,424,477,901,"6 de julio de 1997"
8,6,19,705,523,591,1114,"6 de julio de 1997"
8,6,19,706,328,337,665,"6 de julio de 1997"
8,6,19,707,347,428,775,"6 de julio de 1997"
8,6,19,708,326,380,706,"6 de julio de 1997"
8,6,19,709,416,433,849,"6 de julio de 1997"
8,6,19,710,493,540,1033,"6 de julio de 1997"
8,6,19,711,77,73,150,"6 de julio de 1997"
8,6,19,712,385,396,781,"6 de julio de 1997"
8,6,19,713,444,472,916,"6 de julio de 1997"
8,6,19,714,590,621,1211,"6 de julio de 1997"
8,6,19,715,241,279,520,"6 de julio de 1997"
8,6,19,716,393,430,823,"6 de julio de 1997"
8,6,19,717,384,446,830,"6 de julio de 1997"
8,6,19,718,971,1139,2110,"6 de julio de 1997"
8,6,19,719,485,513,998,"6 de julio de 1997"
8,6,19,720,650,721,1371,"6 de julio de 1997"
8,6,19,721,355,388,743,"6 de julio de 1997"
8,6,19,722,314,381,695,"6 de julio de 1997"
8,6,19,723,376,398,774,"6 de julio de 1997"
8,6,19,724,359,413,772,"6 de julio de 1997"
8,6,19,725,526,572,1098,"6 de julio de 1997"
8,6,19,726,457,559,1016,"6 de julio de 1997"
8,6,19,727,208,229,437,"6 de julio de 1997"
8,6,19,728,232,256,488,"6 de julio de 1997"
8,6,19,729,177,225,402,"6 de julio de 1997"
8,6,19,730,290,345,635,"6 de julio de 1997"
8,6,19,731,227,267,494,"6 de julio de 1997"
8,6,19,732,206,246,452,"6 de julio de 1997"
8,6,19,733,217,247,464,"6 de julio de 1997"
8,6,19,734,467,520,987,"6 de julio de 1997"
8,6,19,735,278,308,586,"6 de julio de 1997"
8,6,19,736,436,490,926,"6 de julio de 1997"
8,6,19,737,325,349,674,"6 de julio de 1997"
8,6,19,738,259,297,556,"6 de julio de 1997"
8,6,19,739,287,303,590,"6 de julio de 1997"
8,6,19,740,529,614,1143,"6 de julio de 1997"
8,6,19,741,346,360,706,"6 de julio de 1997"
8,6,19,742,240,300,540,"6 de julio de 1997"
8,6,19,743,350,395,745,"6 de julio de 1997"
8,6,19,744,339,405,744,"6 de julio de 1997"
8,6,19,745,480,501,981,"6 de julio de 1997"
8,6,19,746,411,458,869,"6 de julio de 1997"
8,6,19,747,288,308,596,"6 de julio de 1997"
8,6,19,748,415,425,840,"6 de julio de 1997"
8,6,19,749,223,269,492,"6 de julio de 1997"
8,6,19,750,250,272,522,"6 de julio de 1997"
8,6,19,751,253,268,521,"6 de julio de 1997"
8,6,19,752,252,303,555,"6 de julio de 1997"
8,6,19,753,384,438,822,"6 de julio de 1997"
8,6,19,754,309,355,664,"6 de julio de 1997"
8,6,19,755,140,176,316,"6 de julio de 1997"
8,6,19,756,368,423,791,"6 de julio de 1997"
8,6,19,757,349,415,764,"6 de julio de 1997"
8,6,19,758,340,379,719,"6 de julio de 1997"
8,6,19,759,386,459,845,"6 de julio de 1997"
8,6,19,760,491,584,1075,"6 de julio de 1997"
8,6,19,761,497,549,1046,"6 de julio de 1997"
8,6,19,762,396,461,857,"6 de julio de 1997"
8,6,19,763,443,507,950,"6 de julio de 1997"
8,6,19,764,337,422,759,"6 de julio de 1997"
8,6,19,765,249,288,537,"6 de julio de 1997"
8,6,19,766,318,407,725,"6 de julio de 1997"
8,6,19,767,428,509,937,"6 de julio de 1997"
8,6,19,768,368,386,754,"6 de julio de 1997"
8,6,19,769,356,388,744,"6 de julio de 1997"
8,6,19,770,293,379,672,"6 de julio de 1997"
8,6,19,771,497,593,1090,"6 de julio de 1997"
8,6,19,772,503,572,1075,"6 de julio de 1997"
8,6,19,773,478,554,1032,"6 de julio de 1997"
8,6,19,774,438,541,979,"6 de julio de 1997"
8,6,19,775,504,611,1115,"6 de julio de 1997"
8,6,19,776,156,152,308,"6 de julio de 1997"
8,6,19,777,514,606,1120,"6 de julio de 1997"
8,6,19,778,573,692,1265,"6 de julio de 1997"
8,6,19,779,562,666,1228,"6 de julio de 1997"
8,6,19,780,394,477,871,"6 de julio de 1997"
8,6,19,781,309,351,660,"6 de julio de 1997"
8,6,19,782,441,576,1017,"6 de julio de 1997"
8,6,19,783,320,362,682,"6 de julio de 1997"
8,6,19,784,317,409,726,"6 de julio de 1997"
8,6,19,785,362,390,752,"6 de julio de 1997"
8,6,19,786,217,191,408,"6 de julio de 1997"
8,6,19,787,582,624,1206,"6 de julio de 1997"
8,6,19,788,442,477,919,"6 de julio de 1997"
8,6,19,789,371,397,768,"6 de julio de 1997"
8,6,19,790,306,317,623,"6 de julio de 1997"
8,6,19,791,332,364,696,"6 de julio de 1997"
8,6,19,792,614,689,1303,"6 de julio de 1997"
8,6,19,793,468,524,992,"6 de julio de 1997"
8,6,19,794,228,276,504,"6 de julio de 1997"
8,6,19,795,469,591,1060,"6 de julio de 1997"
8,6,19,796,255,354,609,"6 de julio de 1997"
8,6,19,797,338,416,754,"6 de julio de 1997"
8,6,19,798,330,379,709,"6 de julio de 1997"
8,6,19,799,272,330,602,"6 de julio de 1997"
8,6,19,800,474,573,1047,"6 de julio de 1997"
8,6,19,801,523,606,1129,"6 de julio de 1997"
8,6,19,802,150,186,336,"6 de julio de 1997"
8,6,19,803,318,289,607,"6 de julio de 1997"
8,6,19,804,425,449,874,"6 de julio de 1997"
8,6,19,805,837,942,1779,"6 de julio de 1997"
8,6,19,806,410,479,889,"6 de julio de 1997"
8,6,19,807,463,594,1057,"6 de julio de 1997"
8,6,19,808,479,603,1082,"6 de julio de 1997"
8,6,19,809,431,525,956,"6 de julio de 1997"
8,6,19,810,435,482,917,"6 de julio de 1997"
8,6,19,811,188,197,385,"6 de julio de 1997"
8,6,19,812,283,312,595,"6 de julio de 1997"
8,6,19,813,413,459,872,"6 de julio de 1997"
8,6,19,814,371,403,774,"6 de julio de 1997"
8,6,19,815,277,326,603,"6 de julio de 1997"
8,6,19,816,327,412,739,"6 de julio de 1997"
8,6,19,817,495,588,1083,"6 de julio de 1997"
8,6,19,818,350,390,740,"6 de julio de 1997"
8,6,19,819,505,549,1054,"6 de julio de 1997"
8,6,19,820,262,311,573,"6 de julio de 1997"
8,6,19,821,125,122,247,"6 de julio de 1997"
8,6,19,822,245,293,538,"6 de julio de 1997"
8,6,19,823,557,631,1188,"6 de julio de 1997"
8,6,19,824,303,344,647,"6 de julio de 1997"
8,6,19,825,365,450,815,"6 de julio de 1997"
8,6,19,826,534,701,1235,"6 de julio de 1997"
8,6,19,827,402,449,851,"6 de julio de 1997"
8,6,19,828,347,351,698,"6 de julio de 1997"
8,6,19,829,469,491,960,"6 de julio de 1997"
8,6,19,830,292,318,610,"6 de julio de 1997"
8,6,19,831,269,309,578,"6 de julio de 1997"
8,6,19,832,309,319,628,"6 de julio de 1997"
8,6,19,833,317,354,671,"6 de julio de 1997"
8,6,19,834,209,241,450,"6 de julio de 1997"
8,6,19,835,217,250,467,"6 de julio de 1997"
8,6,19,836,353,431,784,"6 de julio de 1997"
8,6,19,837,405,452,857,"6 de julio de 1997"
8,6,19,838,506,544,1050,"6 de julio de 1997"
8,6,19,839,565,679,1244,"6 de julio de 1997"
8,6,19,840,468,525,993,"6 de julio de 1997"
8,6,19,841,400,448,848,"6 de julio de 1997"
8,6,19,842,404,450,854,"6 de julio de 1997"
8,6,19,843,164,230,394,"6 de julio de 1997"
8,6,19,844,359,398,757,"6 de julio de 1997"
8,6,19,845,451,482,933,"6 de julio de 1997"
8,6,19,846,351,418,769,"6 de julio de 1997"
8,6,19,847,267,336,603,"6 de julio de 1997"
8,6,19,886,153,123,276,"6 de julio de 1997"
8,6,19,887,173,128,301,"6 de julio de 1997"
8,6,19,888,54,38,92,"6 de julio de 1997"
8,6,19,889,379,372,751,"6 de julio de 1997"
8,6,19,890,286,228,514,"6 de julio de 1997"
8,6,19,891,288,230,518,"6 de julio de 1997"
8,6,19,892,59,53,112,"6 de julio de 1997"
8,6,19,893,256,170,426,"6 de julio de 1997"
8,6,19,894,262,219,481,"6 de julio de 1997"
8,6,19,895,443,342,785,"6 de julio de 1997"
8,6,19,896,267,263,530,"6 de julio de 1997"
8,6,19,897,211,194,405,"6 de julio de 1997"
8,6,19,898,268,170,438,"6 de julio de 1997"
8,6,19,906,344,388,732,"6 de julio de 1997"
8,6,19,907,2507,2937,5444,"6 de julio de 1997"
8,6,19,910,395,445,840,"6 de julio de 1997"
8,6,19,911,408,470,878,"6 de julio de 1997"
8,7,6,82,243,229,472,"6 de julio de 1997"
8,7,6,83,178,171,349,"6 de julio de 1997"
8,7,6,84,147,127,274,"6 de julio de 1997"
8,7,6,85,152,155,307,"6 de julio de 1997"
8,7,6,86,74,62,136,"6 de julio de 1997"
8,7,6,87,264,235,499,"6 de julio de 1997"
8,7,6,88,164,130,294,"6 de julio de 1997"
8,7,6,89,118,106,224,"6 de julio de 1997"
8,7,6,90,124,104,228,"6 de julio de 1997"
8,7,6,91,73,64,137,"6 de julio de 1997"
8,7,6,92,65,55,120,"6 de julio de 1997"
8,7,6,93,42,46,88,"6 de julio de 1997"
8,7,6,94,85,72,157,"6 de julio de 1997"
8,7,6,95,139,147,286,"6 de julio de 1997"
8,7,6,96,23,23,46,"6 de julio de 1997"
8,7,6,97,83,69,152,"6 de julio de 1997"
8,7,6,98,84,79,163,"6 de julio de 1997"
8,7,6,99,155,149,304,"6 de julio de 1997"
8,7,6,100,207,172,379,"6 de julio de 1997"
8,7,6,101,162,162,324,"6 de julio de 1997"
8,7,8,116,505,372,877,"6 de julio de 1997"
8,7,8,117,272,118,390,"6 de julio de 1997"
8,7,8,118,92,59,151,"6 de julio de 1997"
8,7,8,119,337,232,569,"6 de julio de 1997"
8,7,8,120,152,43,195,"6 de julio de 1997"
8,7,8,121,408,326,734,"6 de julio de 1997"
8,7,8,122,212,66,278,"6 de julio de 1997"
8,7,8,123,235,149,384,"6 de julio de 1997"
8,7,8,124,118,61,179,"6 de julio de 1997"
8,7,8,125,245,146,391,"6 de julio de 1997"
8,7,8,126,214,135,349,"6 de julio de 1997"
8,7,9,127,104,94,198,"6 de julio de 1997"
8,7,9,128,277,271,548,"6 de julio de 1997"
8,7,9,129,433,487,920,"6 de julio de 1997"
8,7,9,130,466,460,926,"6 de julio de 1997"
8,7,9,131,339,372,711,"6 de julio de 1997"
8,7,9,132,482,532,1014,"6 de julio de 1997"
8,7,9,133,399,425,824,"6 de julio de 1997"
8,7,9,134,301,323,624,"6 de julio de 1997"
8,7,9,135,425,431,856,"6 de julio de 1997"
8,7,9,136,638,629,1267,"6 de julio de 1997"
8,7,9,137,692,566,1258,"6 de julio de 1997"
8,7,9,138,252,164,416,"6 de julio de 1997"
8,7,9,139,346,262,608,"6 de julio de 1997"
8,7,9,140,302,198,500,"6 de julio de 1997"
8,7,9,141,277,181,458,"6 de julio de 1997"
8,7,9,142,150,125,275,"6 de julio de 1997"
8,7,9,143,179,151,330,"6 de julio de 1997"
8,7,9,144,457,412,869,"6 de julio de 1997"
8,7,9,145,361,298,659,"6 de julio de 1997"
8,7,9,146,416,305,721,"6 de julio de 1997"
8,7,9,147,301,230,531,"6 de julio de 1997"
8,7,9,148,163,133,296,"6 de julio de 1997"
8,7,12,221,388,353,741,"6 de julio de 1997"
8,7,12,222,222,211,433,"6 de julio de 1997"
8,7,12,223,139,134,273,"6 de julio de 1997"
8,7,12,224,87,76,163,"6 de julio de 1997"
8,7,12,225,245,222,467,"6 de julio de 1997"
8,7,12,226,86,69,155,"6 de julio de 1997"
8,7,12,227,129,94,223,"6 de julio de 1997"
8,7,12,228,57,39,96,"6 de julio de 1997"
8,7,12,229,77,50,127,"6 de julio de 1997"
8,7,12,230,62,42,104,"6 de julio de 1997"
8,7,12,231,103,65,168,"6 de julio de 1997"
8,7,12,232,103,69,172,"6 de julio de 1997"
8,7,12,233,101,66,167,"6 de julio de 1997"
8,7,12,234,289,150,439,"6 de julio de 1997"
8,7,12,235,178,120,298,"6 de julio de 1997"
8,7,12,236,128,50,178,"6 de julio de 1997"
8,7,12,237,172,39,211,"6 de julio de 1997"
8,7,17,271,183,200,383,"6 de julio de 1997"
8,7,17,272,273,212,485,"6 de julio de 1997"
8,7,17,273,204,238,442,"6 de julio de 1997"
8,7,17,274,221,275,496,"6 de julio de 1997"
8,7,17,275,361,421,782,"6 de julio de 1997"
8,7,17,276,206,241,447,"6 de julio de 1997"
8,7,17,277,411,481,892,"6 de julio de 1997"
8,7,17,278,524,613,1137,"6 de julio de 1997"
8,7,17,279,907,592,1499,"6 de julio de 1997"
8,7,17,280,261,319,580,"6 de julio de 1997"
8,7,17,281,368,426,794,"6 de julio de 1997"
8,7,17,282,299,312,611,"6 de julio de 1997"
8,7,17,283,374,439,813,"6 de julio de 1997"
8,7,17,284,460,520,980,"6 de julio de 1997"
8,7,17,285,213,273,486,"6 de julio de 1997"
8,7,17,286,438,532,970,"6 de julio de 1997"
8,7,17,287,214,279,493,"6 de julio de 1997"
8,7,17,288,477,550,1027,"6 de julio de 1997"
8,7,17,289,337,336,673,"6 de julio de 1997"
8,7,17,290,325,389,714,"6 de julio de 1997"
8,7,17,291,307,317,624,"6 de julio de 1997"
8,7,17,292,286,298,584,"6 de julio de 1997"
8,7,17,293,197,200,397,"6 de julio de 1997"
8,7,17,294,217,265,482,"6 de julio de 1997"
8,7,17,295,207,279,486,"6 de julio de 1997"
8,7,17,296,254,332,586,"6 de julio de 1997"
8,7,17,297,657,820,1477,"6 de julio de 1997"
8,7,17,298,214,233,447,"6 de julio de 1997"
8,7,17,299,284,337,621,"6 de julio de 1997"
8,7,17,300,247,306,553,"6 de julio de 1997"
8,7,17,301,230,289,519,"6 de julio de 1997"
8,7,17,302,350,419,769,"6 de julio de 1997"
8,7,17,303,213,252,465,"6 de julio de 1997"
8,7,17,304,198,260,458,"6 de julio de 1997"
8,7,17,305,212,263,475,"6 de julio de 1997"
8,7,17,306,415,502,917,"6 de julio de 1997"
8,7,17,307,446,514,960,"6 de julio de 1997"
8,7,17,308,323,397,720,"6 de julio de 1997"
8,7,17,309,225,266,491,"6 de julio de 1997"
8,7,17,310,465,517,982,"6 de julio de 1997"
8,7,17,311,340,368,708,"6 de julio de 1997"
8,7,17,312,429,486,915,"6 de julio de 1997"
8,7,17,313,270,362,632,"6 de julio de 1997"
8,7,17,314,376,451,827,"6 de julio de 1997"
8,7,17,315,237,286,523,"6 de julio de 1997"
8,7,17,316,172,203,375,"6 de julio de 1997"
8,7,17,317,255,324,579,"6 de julio de 1997"
8,7,17,318,230,265,495,"6 de julio de 1997"
8,7,17,319,241,300,541,"6 de julio de 1997"
8,7,17,320,263,326,589,"6 de julio de 1997"
8,7,17,321,484,532,1016,"6 de julio de 1997"
8,7,17,322,179,199,378,"6 de julio de 1997"
8,7,17,323,285,316,601,"6 de julio de 1997"
8,7,17,324,239,284,523,"6 de julio de 1997"
8,7,17,325,337,367,704,"6 de julio de 1997"
8,7,17,326,613,720,1333,"6 de julio de 1997"
8,7,17,327,572,676,1248,"6 de julio de 1997"
8,7,17,328,250,311,561,"6 de julio de 1997"
8,7,17,329,223,267,490,"6 de julio de 1997"
8,7,17,330,295,328,623,"6 de julio de 1997"
8,7,17,331,298,366,664,"6 de julio de 1997"
8,7,17,332,491,560,1051,"6 de julio de 1997"
8,7,17,333,253,297,550,"6 de julio de 1997"
8,7,17,334,601,640,1241,"6 de julio de 1997"
8,7,17,335,363,417,780,"6 de julio de 1997"
8,7,17,336,274,306,580,"6 de julio de 1997"
8,7,17,337,336,380,716,"6 de julio de 1997"
8,7,17,338,618,679,1297,"6 de julio de 1997"
8,7,17,339,333,376,709,"6 de julio de 1997"
8,7,17,340,472,534,1006,"6 de julio de 1997"
8,7,17,341,382,418,800,"6 de julio de 1997"
8,7,17,342,407,420,827,"6 de julio de 1997"
8,7,17,343,521,564,1085,"6 de julio de 1997"
8,7,17,344,366,411,777,"6 de julio de 1997"
8,7,17,345,134,171,305,"6 de julio de 1997"
8,7,17,346,190,201,391,"6 de julio de 1997"
8,7,17,347,167,196,363,"6 de julio de 1997"
8,7,17,348,439,478,917,"6 de julio de 1997"
8,7,17,349,400,405,805,"6 de julio de 1997"
8,7,17,350,373,432,805,"6 de julio de 1997"
8,7,17,351,223,239,462,"6 de julio de 1997"
8,7,17,352,118,117,235,"6 de julio de 1997"
8,7,17,353,211,214,425,"6 de julio de 1997"
8,7,17,354,20,13,33,"6 de julio de 1997"
8,7,17,355,83,80,163,"6 de julio de 1997"
8,7,17,356,379,348,727,"6 de julio de 1997"
8,7,17,357,52,26,78,"6 de julio de 1997"
8,7,17,358,61,57,118,"6 de julio de 1997"
8,7,17,359,289,286,575,"6 de julio de 1997"
8,7,17,360,57,45,102,"6 de julio de 1997"
8,7,17,361,58,45,103,"6 de julio de 1997"
8,7,17,362,88,91,179,"6 de julio de 1997"
8,7,17,363,166,169,335,"6 de julio de 1997"
8,7,17,364,434,261,695,"6 de julio de 1997"
8,7,17,365,227,230,457,"6 de julio de 1997"
8,7,17,366,34,31,65,"6 de julio de 1997"
8,7,17,367,84,72,156,"6 de julio de 1997"
8,7,17,368,332,191,523,"6 de julio de 1997"
8,7,17,369,263,113,376,"6 de julio de 1997"
8,7,17,370,156,140,296,"6 de julio de 1997"
8,7,17,371,52,48,100,"6 de julio de 1997"
8,7,17,372,49,39,88,"6 de julio de 1997"
8,7,17,373,441,237,678,"6 de julio de 1997"
8,7,17,374,109,97,206,"6 de julio de 1997"
8,7,17,375,58,56,114,"6 de julio de 1997"
8,7,17,376,59,59,118,"6 de julio de 1997"
8,7,17,377,66,63,129,"6 de julio de 1997"
8,7,17,378,71,67,138,"6 de julio de 1997"
8,7,17,379,54,36,90,"6 de julio de 1997"
8,7,17,380,123,121,244,"6 de julio de 1997"
8,7,17,381,84,76,160,"6 de julio de 1997"
8,7,17,382,94,88,182,"6 de julio de 1997"
8,7,17,383,218,219,437,"6 de julio de 1997"
8,7,17,384,80,81,161,"6 de julio de 1997"
8,7,17,385,162,107,269,"6 de julio de 1997"
8,7,17,386,126,111,237,"6 de julio de 1997"
8,7,17,387,43,39,82,"6 de julio de 1997"
8,7,18,388,152,81,233,"6 de julio de 1997"
8,7,18,389,121,113,234,"6 de julio de 1997"
8,7,18,390,46,31,77,"6 de julio de 1997"
8,7,18,391,77,68,145,"6 de julio de 1997"
8,7,18,392,24,12,36,"6 de julio de 1997"
8,7,18,393,135,137,272,"6 de julio de 1997"
8,7,18,394,241,216,457,"6 de julio de 1997"
8,7,18,395,178,165,343,"6 de julio de 1997"
8,7,18,396,249,214,463,"6 de julio de 1997"
8,7,18,397,124,121,245,"6 de julio de 1997"
8,7,18,398,276,242,518,"6 de julio de 1997"
8,7,18,399,96,61,157,"6 de julio de 1997"
8,7,18,400,76,58,134,"6 de julio de 1997"
8,7,18,401,118,84,202,"6 de julio de 1997"
8,7,20,912,409,355,764,"6 de julio de 1997"
8,7,20,913,193,146,339,"6 de julio de 1997"
8,7,20,914,403,326,729,"6 de julio de 1997"
8,7,20,915,130,96,226,"6 de julio de 1997"
8,7,20,916,149,93,242,"6 de julio de 1997"
8,7,20,917,190,154,344,"6 de julio de 1997"
8,7,20,918,177,119,296,"6 de julio de 1997"
8,7,20,919,321,239,560,"6 de julio de 1997"
8,7,20,920,29,20,49,"6 de julio de 1997"
8,7,22,1031,434,398,832,"6 de julio de 1997"
8,7,22,1032,195,179,374,"6 de julio de 1997"
8,7,22,1033,197,191,388,"6 de julio de 1997"
8,7,22,1034,160,148,308,"6 de julio de 1997"
8,7,22,1035,129,124,253,"6 de julio de 1997"
8,7,22,1036,174,184,358,"6 de julio de 1997"
8,7,22,1037,30,24,54,"6 de julio de 1997"
8,7,22,1038,48,47,95,"6 de julio de 1997"
8,7,22,1039,88,59,147,"6 de julio de 1997"
8,7,22,1040,34,24,58,"6 de julio de 1997"
8,7,22,1041,197,183,380,"6 de julio de 1997"
8,7,24,1046,365,384,749,"6 de julio de 1997"
8,7,24,1047,439,375,814,"6 de julio de 1997"
8,7,24,1048,244,244,488,"6 de julio de 1997"
8,7,24,1049,172,165,337,"6 de julio de 1997"
8,7,24,1050,331,260,591,"6 de julio de 1997"
8,7,24,1051,128,101,229,"6 de julio de 1997"
8,7,24,1052,139,150,289,"6 de julio de 1997"
8,7,26,1069,205,194,399,"6 de julio de 1997"
8,7,26,1070,167,159,326,"6 de julio de 1997"
8,7,26,1071,94,99,193,"6 de julio de 1997"
8,7,26,1072,102,105,207,"6 de julio de 1997"
8,7,26,1073,124,124,248,"6 de julio de 1997"
8,7,26,1074,90,92,182,"6 de julio de 1997"
8,7,26,1075,109,86,195,"6 de julio de 1997"
8,7,26,1076,90,76,166,"6 de julio de 1997"
8,7,26,1077,121,86,207,"6 de julio de 1997"
8,7,26,1078,73,73,146,"6 de julio de 1997"
8,7,26,1079,284,300,584,"6 de julio de 1997"
8,7,26,1080,177,180,357,"6 de julio de 1997"
8,7,26,1081,82,77,159,"6 de julio de 1997"
8,7,30,1167,247,226,473,"6 de julio de 1997"
8,7,30,1168,233,220,453,"6 de julio de 1997"
8,7,30,1169,269,201,470,"6 de julio de 1997"
8,7,30,1170,120,99,219,"6 de julio de 1997"
8,7,30,1171,294,206,500,"6 de julio de 1997"
8,7,30,1172,109,101,210,"6 de julio de 1997"
8,7,30,1173,169,104,273,"6 de julio de 1997"
8,7,30,1174,242,227,469,"6 de julio de 1997"
8,7,30,1175,140,98,238,"6 de julio de 1997"
8,7,30,1176,70,56,126,"6 de julio de 1997"
8,7,30,1177,180,144,324,"6 de julio de 1997"
8,7,30,1178,91,73,164,"6 de julio de 1997"
8,7,30,1179,62,45,107,"6 de julio de 1997"
8,7,30,1180,93,77,170,"6 de julio de 1997"
8,7,30,1181,120,102,222,"6 de julio de 1997"
8,7,31,1182,369,369,738,"6 de julio de 1997"
8,7,31,1183,263,268,531,"6 de julio de 1997"
8,7,31,1184,333,389,722,"6 de julio de 1997"
8,7,31,1185,296,267,563,"6 de julio de 1997"
8,7,31,1186,400,472,872,"6 de julio de 1997"
8,7,31,1187,349,394,743,"6 de julio de 1997"
8,7,31,1188,185,181,366,"6 de julio de 1997"
8,7,31,1189,190,197,387,"6 de julio de 1997"
8,7,31,1190,210,227,437,"6 de julio de 1997"
8,7,31,1191,111,122,233,"6 de julio de 1997"
8,7,31,1192,125,119,244,"6 de julio de 1997"
8,7,31,1193,133,129,262,"6 de julio de 1997"
8,7,31,1194,245,271,516,"6 de julio de 1997"
8,7,31,1195,348,405,753,"6 de julio de 1997"
8,7,31,1196,319,298,617,"6 de julio de 1997"
8,7,31,1197,134,137,271,"6 de julio de 1997"
8,7,31,1198,309,363,672,"6 de julio de 1997"
8,7,31,1199,323,326,649,"6 de julio de 1997"
8,7,31,1200,342,353,695,"6 de julio de 1997"
8,7,31,1201,202,171,373,"6 de julio de 1997"
8,7,31,1202,119,103,222,"6 de julio de 1997"
8,7,31,1203,79,73,152,"6 de julio de 1997"
8,7,31,1204,115,105,220,"6 de julio de 1997"
8,7,31,1205,95,81,176,"6 de julio de 1997"
8,7,31,1206,61,48,109,"6 de julio de 1997"
8,7,31,1207,53,48,101,"6 de julio de 1997"
8,7,31,1208,80,62,142,"6 de julio de 1997"
8,7,31,1209,110,85,195,"6 de julio de 1997"
8,7,31,1210,206,209,415,"6 de julio de 1997"
8,7,31,1211,155,168,323,"6 de julio de 1997"
8,7,31,1212,192,157,349,"6 de julio de 1997"
8,7,31,1213,208,177,385,"6 de julio de 1997"
8,7,31,1214,149,135,284,"6 de julio de 1997"
8,7,31,1215,290,220,510,"6 de julio de 1997"
8,7,31,1216,85,80,165,"6 de julio de 1997"
8,7,31,1217,123,111,234,"6 de julio de 1997"
8,7,31,1218,453,478,931,"6 de julio de 1997"
8,7,31,1219,208,170,378,"6 de julio de 1997"
8,7,31,1220,38,42,80,"6 de julio de 1997"
8,7,31,1221,168,161,329,"6 de julio de 1997"
8,7,31,1222,88,78,166,"6 de julio de 1997"
8,7,31,1223,75,77,152,"6 de julio de 1997"
8,7,31,1224,158,126,284,"6 de julio de 1997"
8,7,31,1225,172,105,277,"6 de julio de 1997"
8,7,31,1226,120,95,215,"6 de julio de 1997"
8,7,31,1227,71,52,123,"6 de julio de 1997"
8,7,31,1228,201,169,370,"6 de julio de 1997"
8,7,31,1229,212,209,421,"6 de julio de 1997"
8,7,31,1230,117,97,214,"6 de julio de 1997"
8,7,31,1231,97,74,171,"6 de julio de 1997"
8,7,31,1232,93,79,172,"6 de julio de 1997"
8,7,31,1233,46,36,82,"6 de julio de 1997"
8,7,31,1234,37,31,68,"6 de julio de 1997"
8,7,31,1235,213,211,424,"6 de julio de 1997"
8,7,31,1236,48,32,80,"6 de julio de 1997"
8,7,31,1237,457,406,863,"6 de julio de 1997"
8,7,31,1238,50,32,82,"6 de julio de 1997"
8,7,31,1239,97,66,163,"6 de julio de 1997"
8,7,31,1240,29,26,55,"6 de julio de 1997"
8,7,31,1241,55,50,105,"6 de julio de 1997"
8,7,31,1242,293,282,575,"6 de julio de 1997"
8,7,31,1243,67,50,117,"6 de julio de 1997"
8,7,31,1244,387,357,744,"6 de julio de 1997"
8,7,31,1245,199,176,375,"6 de julio de 1997"
8,7,31,1246,79,50,129,"6 de julio de 1997"
8,7,31,1247,46,36,82,"6 de julio de 1997"
8,7,31,1248,294,277,571,"6 de julio de 1997"
8,7,31,1249,114,89,203,"6 de julio de 1997"
8,7,31,1250,157,165,322,"6 de julio de 1997"
8,7,31,1251,50,34,84,"6 de julio de 1997"
8,7,31,1252,24,21,45,"6 de julio de 1997"
8,7,31,1253,43,40,83,"6 de julio de 1997"
8,7,31,1254,40,17,57,"6 de julio de 1997"
8,7,31,1255,66,49,115,"6 de julio de 1997"
8,7,31,1256,19,24,43,"6 de julio de 1997"
8,7,31,1257,262,213,475,"6 de julio de 1997"
8,7,31,1258,79,66,145,"6 de julio de 1997"
8,7,31,1259,41,32,73,"6 de julio de 1997"
8,7,31,1260,86,68,154,"6 de julio de 1997"
8,7,31,1261,94,59,153,"6 de julio de 1997"
8,7,31,1262,34,15,49,"6 de julio de 1997"
8,7,31,1263,51,38,89,"6 de julio de 1997"
8,7,31,1264,97,76,173,"6 de julio de 1997"
8,7,31,1265,71,60,131,"6 de julio de 1997"
8,7,41,2261,172,156,328,"6 de julio de 1997"
8,7,41,2262,94,50,144,"6 de julio de 1997"
8,7,41,2263,56,46,102,"6 de julio de 1997"
8,7,41,2264,65,44,109,"6 de julio de 1997"
8,7,41,2265,125,79,204,"6 de julio de 1997"
8,7,47,2331,379,290,669,"6 de julio de 1997"
8,7,47,2332,85,60,145,"6 de julio de 1997"
8,7,47,2333,196,158,354,"6 de julio de 1997"
8,7,47,2334,67,47,114,"6 de julio de 1997"
8,7,47,2335,411,320,731,"6 de julio de 1997"
8,7,47,2336,120,91,211,"6 de julio de 1997"
8,7,47,2337,139,122,261,"6 de julio de 1997"
8,7,47,2338,120,97,217,"6 de julio de 1997"
8,7,49,2390,434,381,815,"6 de julio de 1997"
8,7,49,2391,77,56,133,"6 de julio de 1997"
8,7,49,2392,113,78,191,"6 de julio de 1997"
8,7,49,2393,205,160,365,"6 de julio de 1997"
8,7,49,2394,18,17,35,"6 de julio de 1997"
8,7,49,2395,145,101,246,"6 de julio de 1997"
8,7,51,2460,186,144,330,"6 de julio de 1997"
8,7,51,2461,79,68,147,"6 de julio de 1997"
8,7,51,2462,66,56,122,"6 de julio de 1997"
8,7,51,2463,89,74,163,"6 de julio de 1997"
8,7,51,2464,82,58,140,"6 de julio de 1997"
8,7,51,2465,17,20,37,"6 de julio de 1997"
8,7,51,2466,235,186,421,"6 de julio de 1997"
8,7,51,2467,277,216,493,"6 de julio de 1997"
8,7,51,2468,10,1,11,"6 de julio de 1997"
8,7,51,2469,95,73,168,"6 de julio de 1997"
8,7,51,2470,104,72,176,"6 de julio de 1997"
8,7,51,2471,96,72,168,"6 de julio de 1997"
8,7,51,2472,297,198,495,"6 de julio de 1997"
8,7,51,2473,158,138,296,"6 de julio de 1997"
8,7,51,2474,101,82,183,"6 de julio de 1997"
8,7,51,2475,138,115,253,"6 de julio de 1997"
8,7,51,2476,112,80,192,"6 de julio de 1997"
8,7,54,2518,230,200,430,"6 de julio de 1997"
8,7,54,2519,303,188,491,"6 de julio de 1997"
8,7,54,2520,482,291,773,"6 de julio de 1997"
8,7,54,2521,74,56,130,"6 de julio de 1997"
8,7,54,2522,63,40,103,"6 de julio de 1997"
8,7,54,2523,118,129,247,"6 de julio de 1997"
8,7,54,2524,64,54,118,"6 de julio de 1997"
8,7,54,2525,41,31,72,"6 de julio de 1997"
8,7,54,2526,51,32,83,"6 de julio de 1997"
8,7,54,2527,37,29,66,"6 de julio de 1997"
8,7,57,2549,292,254,546,"6 de julio de 1997"
8,7,57,2550,221,217,438,"6 de julio de 1997"
8,7,57,2551,32,20,52,"6 de julio de 1997"
8,7,57,2552,74,47,121,"6 de julio de 1997"
8,7,57,2553,30,19,49,"6 de julio de 1997"
8,7,57,2554,127,95,222,"6 de julio de 1997"
8,7,57,2555,67,46,113,"6 de julio de 1997"
8,7,57,2556,39,26,65,"6 de julio de 1997"
8,7,57,2557,101,82,183,"6 de julio de 1997"
8,7,57,2558,97,85,182,"6 de julio de 1997"
8,7,61,2601,159,109,268,"6 de julio de 1997"
8,7,61,2602,277,228,505,"6 de julio de 1997"
8,7,61,2603,67,58,125,"6 de julio de 1997"
8,7,61,2604,124,108,232,"6 de julio de 1997"
8,7,61,2605,70,81,151,"6 de julio de 1997"
8,7,61,2606,226,227,453,"6 de julio de 1997"
8,7,61,2607,128,104,232,"6 de julio de 1997"
8,7,61,2608,246,230,476,"6 de julio de 1997"
8,7,61,2609,125,97,222,"6 de julio de 1997"
8,7,61,2610,67,56,123,"6 de julio de 1997"
8,7,61,2611,161,132,293,"6 de julio de 1997"
8,7,61,2612,91,67,158,"6 de julio de 1997"
8,7,61,2613,240,171,411,"6 de julio de 1997"
8,7,61,2614,76,61,137,"6 de julio de 1997"
8,7,65,2668,387,348,735,"6 de julio de 1997"
8,7,65,2669,263,233,496,"6 de julio de 1997"
8,7,65,2670,134,91,225,"6 de julio de 1997"
8,7,65,2671,571,499,1070,"6 de julio de 1997"
8,7,65,2672,136,123,259,"6 de julio de 1997"
8,7,65,2673,262,249,511,"6 de julio de 1997"
8,7,65,2674,142,137,279,"6 de julio de 1997"
8,7,65,2675,140,120,260,"6 de julio de 1997"
8,7,65,2676,387,336,723,"6 de julio de 1997"
8,7,65,2677,204,151,355,"6 de julio de 1997"
8,7,65,2678,237,191,428,"6 de julio de 1997"
8,7,65,2679,390,271,661,"6 de julio de 1997"
8,7,65,2680,91,78,169,"6 de julio de 1997"
8,7,65,2681,208,175,383,"6 de julio de 1997"
8,7,65,2682,600,431,1031,"6 de julio de 1997"
8,7,65,2683,213,170,383,"6 de julio de 1997"
8,7,66,2684,239,236,475,"6 de julio de 1997"
8,7,66,2685,471,344,815,"6 de julio de 1997"
8,7,66,2686,188,122,310,"6 de julio de 1997"
8,7,66,2687,121,99,220,"6 de julio de 1997"
8,7,66,2688,49,21,70,"6 de julio de 1997"
8,7,66,2689,190,164,354,"6 de julio de 1997"
8,7,66,2690,159,120,279,"6 de julio de 1997"
8,7,66,2691,128,113,241,"6 de julio de 1997"
8,7,66,2692,208,157,365,"6 de julio de 1997"
8,7,66,2693,122,100,222,"6 de julio de 1997"
8,7,66,2694,112,83,195,"6 de julio de 1997"
8,7,66,2695,165,133,298,"6 de julio de 1997"
8,7,66,2696,71,41,112,"6 de julio de 1997"
8,8,19,402,246,303,549,"6 de julio de 1997"
8,8,19,403,291,284,575,"6 de julio de 1997"
8,8,19,404,203,239,442,"6 de julio de 1997"
8,8,19,405,305,335,640,"6 de julio de 1997"
8,8,19,406,276,291,567,"6 de julio de 1997"
8,8,19,407,299,304,603,"6 de julio de 1997"
8,8,19,408,336,380,716,"6 de julio de 1997"
8,8,19,409,289,353,642,"6 de julio de 1997"
8,8,19,410,392,460,852,"6 de julio de 1997"
8,8,19,411,229,243,472,"6 de julio de 1997"
8,8,19,412,239,255,494,"6 de julio de 1997"
8,8,19,413,431,449,880,"6 de julio de 1997"
8,8,19,414,495,547,1042,"6 de julio de 1997"
8,8,19,415,463,495,958,"6 de julio de 1997"
8,8,19,416,460,553,1013,"6 de julio de 1997"
8,8,19,417,374,417,791,"6 de julio de 1997"
8,8,19,418,452,526,978,"6 de julio de 1997"
8,8,19,419,367,453,820,"6 de julio de 1997"
8,8,19,420,611,680,1291,"6 de julio de 1997"
8,8,19,421,351,419,770,"6 de julio de 1997"
8,8,19,422,455,524,979,"6 de julio de 1997"
8,8,19,423,356,440,796,"6 de julio de 1997"
8,8,19,424,388,398,786,"6 de julio de 1997"
8,8,19,425,485,537,1022,"6 de julio de 1997"
8,8,19,426,320,363,683,"6 de julio de 1997"
8,8,19,427,263,316,579,"6 de julio de 1997"
8,8,19,428,320,385,705,"6 de julio de 1997"
8,8,19,429,392,449,841,"6 de julio de 1997"
8,8,19,430,180,219,399,"6 de julio de 1997"
8,8,19,431,285,336,621,"6 de julio de 1997"
8,8,19,432,267,316,583,"6 de julio de 1997"
8,8,19,433,316,361,677,"6 de julio de 1997"
8,8,19,434,386,342,728,"6 de julio de 1997"
8,8,19,435,300,301,601,"6 de julio de 1997"
8,8,19,436,358,392,750,"6 de julio de 1997"
8,8,19,437,340,419,759,"6 de julio de 1997"
8,8,19,438,366,430,796,"6 de julio de 1997"
8,8,19,439,445,507,952,"6 de julio de 1997"
8,8,19,440,529,545,1074,"6 de julio de 1997"
8,8,19,441,369,354,723,"6 de julio de 1997"
8,8,19,442,259,286,545,"6 de julio de 1997"
8,8,19,443,312,334,646,"6 de julio de 1997"
8,8,19,444,271,349,620,"6 de julio de 1997"
8,8,19,445,243,272,515,"6 de julio de 1997"
8,8,19,446,314,379,693,"6 de julio de 1997"
8,8,19,447,318,378,696,"6 de julio de 1997"
8,8,19,448,283,367,650,"6 de julio de 1997"
8,8,19,449,217,280,497,"6 de julio de 1997"
8,8,19,450,450,511,961,"6 de julio de 1997"
8,8,19,451,212,243,455,"6 de julio de 1997"
8,8,19,452,412,469,881,"6 de julio de 1997"
8,8,19,453,263,266,529,"6 de julio de 1997"
8,8,19,454,277,306,583,"6 de julio de 1997"
8,8,19,455,414,467,881,"6 de julio de 1997"
8,8,19,456,216,274,490,"6 de julio de 1997"
8,8,19,457,369,412,781,"6 de julio de 1997"
8,8,19,458,218,243,461,"6 de julio de 1997"
8,8,19,459,320,447,767,"6 de julio de 1997"
8,8,19,460,396,474,870,"6 de julio de 1997"
8,8,19,461,311,407,718,"6 de julio de 1997"
8,8,19,462,305,360,665,"6 de julio de 1997"
8,8,19,463,318,419,737,"6 de julio de 1997"
8,8,19,464,572,634,1206,"6 de julio de 1997"
8,8,19,465,392,451,843,"6 de julio de 1997"
8,8,19,466,466,538,1004,"6 de julio de 1997"
8,8,19,467,594,234,828,"6 de julio de 1997"
8,8,19,468,503,656,1159,"6 de julio de 1997"
8,8,19,469,303,354,657,"6 de julio de 1997"
8,8,19,470,304,367,671,"6 de julio de 1997"
8,8,19,471,308,325,633,"6 de julio de 1997"
8,8,19,472,345,397,742,"6 de julio de 1997"
8,8,19,473,379,436,815,"6 de julio de 1997"
8,8,19,474,314,330,644,"6 de julio de 1997"
8,8,19,475,304,349,653,"6 de julio de 1997"
8,8,19,476,441,502,943,"6 de julio de 1997"
8,8,19,477,373,427,800,"6 de julio de 1997"
8,8,19,478,346,437,783,"6 de julio de 1997"
8,8,19,479,309,347,656,"6 de julio de 1997"
8,8,19,480,470,547,1017,"6 de julio de 1997"
8,8,19,481,417,495,912,"6 de julio de 1997"
8,8,19,482,351,433,784,"6 de julio de 1997"
8,8,19,483,317,382,699,"6 de julio de 1997"
8,8,19,484,231,268,499,"6 de julio de 1997"
8,8,19,485,348,384,732,"6 de julio de 1997"
8,8,19,486,376,422,798,"6 de julio de 1997"
8,8,19,487,418,484,902,"6 de julio de 1997"
8,8,19,488,323,374,697,"6 de julio de 1997"
8,8,19,489,254,296,550,"6 de julio de 1997"
8,8,19,490,354,439,793,"6 de julio de 1997"
8,8,19,491,202,245,447,"6 de julio de 1997"
8,8,19,492,336,388,724,"6 de julio de 1997"
8,8,19,493,421,435,856,"6 de julio de 1997"
8,8,19,494,434,524,958,"6 de julio de 1997"
8,8,19,495,560,562,1122,"6 de julio de 1997"
8,8,19,496,415,449,864,"6 de julio de 1997"
8,8,19,497,380,422,802,"6 de julio de 1997"
8,8,19,498,247,262,509,"6 de julio de 1997"
8,8,19,499,336,369,705,"6 de julio de 1997"
8,8,19,500,399,479,878,"6 de julio de 1997"
8,8,19,501,287,303,590,"6 de julio de 1997"
8,8,19,502,423,538,961,"6 de julio de 1997"
8,8,19,503,174,211,385,"6 de julio de 1997"
8,8,19,504,324,366,690,"6 de julio de 1997"
8,8,19,505,355,406,761,"6 de julio de 1997"
8,8,19,506,366,419,785,"6 de julio de 1997"
8,8,19,507,328,379,707,"6 de julio de 1997"
8,8,19,508,323,393,716,"6 de julio de 1997"
8,8,19,509,614,621,1235,"6 de julio de 1997"
8,8,19,510,321,373,694,"6 de julio de 1997"
8,8,19,511,232,262,494,"6 de julio de 1997"
8,8,19,512,329,344,673,"6 de julio de 1997"
8,8,19,513,476,480,956,"6 de julio de 1997"
8,8,19,514,497,517,1014,"6 de julio de 1997"
8,8,19,515,547,562,1109,"6 de julio de 1997"
8,8,19,516,258,298,556,"6 de julio de 1997"
8,8,19,517,366,408,774,"6 de julio de 1997"
8,8,19,518,426,526,952,"6 de julio de 1997"
8,8,19,519,359,453,812,"6 de julio de 1997"
8,8,19,520,338,454,792,"6 de julio de 1997"
8,8,19,521,425,515,940,"6 de julio de 1997"
8,8,19,522,376,440,816,"6 de julio de 1997"
8,8,19,523,291,323,614,"6 de julio de 1997"
8,8,19,524,354,415,769,"6 de julio de 1997"
8,8,19,525,284,344,628,"6 de julio de 1997"
8,8,19,526,218,270,488,"6 de julio de 1997"
8,8,19,527,511,551,1062,"6 de julio de 1997"
8,8,19,528,511,554,1065,"6 de julio de 1997"
8,8,19,529,337,371,708,"6 de julio de 1997"
8,8,19,530,544,639,1183,"6 de julio de 1997"
8,8,19,531,335,362,697,"6 de julio de 1997"
8,8,19,532,331,387,718,"6 de julio de 1997"
8,8,19,533,304,379,683,"6 de julio de 1997"
8,8,19,534,606,641,1247,"6 de julio de 1997"
8,8,19,535,282,298,580,"6 de julio de 1997"
8,8,19,536,330,385,715,"6 de julio de 1997"
8,8,19,537,241,251,492,"6 de julio de 1997"
8,8,19,538,542,635,1177,"6 de julio de 1997"
8,8,19,539,265,270,535,"6 de julio de 1997"
8,8,19,540,224,245,469,"6 de julio de 1997"
8,8,19,541,611,681,1292,"6 de julio de 1997"
8,8,19,542,270,307,577,"6 de julio de 1997"
8,8,19,543,732,792,1524,"6 de julio de 1997"
8,8,19,544,516,571,1087,"6 de julio de 1997"
8,8,19,545,378,422,800,"6 de julio de 1997"
8,8,19,546,361,389,750,"6 de julio de 1997"
8,8,19,547,257,291,548,"6 de julio de 1997"
8,8,19,548,409,508,917,"6 de julio de 1997"
8,8,19,549,322,348,670,"6 de julio de 1997"
8,8,19,550,492,565,1057,"6 de julio de 1997"
8,8,19,551,554,644,1198,"6 de julio de 1997"
8,8,19,552,382,393,775,"6 de julio de 1997"
8,8,19,553,409,476,885,"6 de julio de 1997"
8,8,19,554,567,642,1209,"6 de julio de 1997"
8,8,19,555,274,358,632,"6 de julio de 1997"
8,8,19,556,374,368,742,"6 de julio de 1997"
8,8,19,557,473,513,986,"6 de julio de 1997"
8,8,19,558,406,469,875,"6 de julio de 1997"
8,8,19,559,246,281,527,"6 de julio de 1997"
8,8,19,560,429,473,902,"6 de julio de 1997"
8,8,19,561,322,347,669,"6 de julio de 1997"
8,8,19,562,419,450,869,"6 de julio de 1997"
8,8,19,563,347,377,724,"6 de julio de 1997"
8,8,19,564,407,439,846,"6 de julio de 1997"
8,8,19,565,273,306,579,"6 de julio de 1997"
8,8,19,566,446,456,902,"6 de julio de 1997"
8,8,19,567,286,299,585,"6 de julio de 1997"
8,8,19,568,340,343,683,"6 de julio de 1997"
8,8,19,569,399,431,830,"6 de julio de 1997"
8,8,19,570,413,491,904,"6 de julio de 1997"
8,8,19,571,405,451,856,"6 de julio de 1997"
8,8,19,572,315,344,659,"6 de julio de 1997"
8,8,19,573,403,461,864,"6 de julio de 1997"
8,8,19,574,601,655,1256,"6 de julio de 1997"
8,8,19,575,487,527,1014,"6 de julio de 1997"
8,8,19,576,426,450,876,"6 de julio de 1997"
8,8,19,577,255,283,538,"6 de julio de 1997"
8,8,19,578,441,464,905,"6 de julio de 1997"
8,8,19,579,212,247,459,"6 de julio de 1997"
8,8,19,580,362,448,810,"6 de julio de 1997"
8,8,19,581,265,318,583,"6 de julio de 1997"
8,8,19,582,292,298,590,"6 de julio de 1997"
8,8,19,583,450,478,928,"6 de julio de 1997"
8,8,19,584,282,302,584,"6 de julio de 1997"
8,8,19,585,324,362,686,"6 de julio de 1997"
8,8,19,586,305,337,642,"6 de julio de 1997"
8,8,19,587,314,367,681,"6 de julio de 1997"
8,8,19,588,204,218,422,"6 de julio de 1997"
8,8,19,589,200,222,422,"6 de julio de 1997"
8,8,19,590,365,387,752,"6 de julio de 1997"
8,8,19,591,407,440,847,"6 de julio de 1997"
8,8,19,592,288,329,617,"6 de julio de 1997"
8,8,19,593,559,614,1173,"6 de julio de 1997"
8,8,19,594,309,373,682,"6 de julio de 1997"
8,8,19,595,290,340,630,"6 de julio de 1997"
8,8,19,596,367,423,790,"6 de julio de 1997"
8,8,19,597,286,379,665,"6 de julio de 1997"
8,8,19,598,319,401,720,"6 de julio de 1997"
8,8,19,599,400,476,876,"6 de julio de 1997"
8,8,19,600,523,581,1104,"6 de julio de 1997"
8,8,19,601,384,449,833,"6 de julio de 1997"
8,8,19,602,244,291,535,"6 de julio de 1997"
8,8,19,603,300,345,645,"6 de julio de 1997"
8,8,19,604,526,603,1129,"6 de julio de 1997"
8,8,19,605,547,590,1137,"6 de julio de 1997"
8,8,19,606,301,356,657,"6 de julio de 1997"
8,8,19,607,295,354,649,"6 de julio de 1997"
8,8,19,848,367,380,747,"6 de julio de 1997"
8,8,19,849,655,705,1360,"6 de julio de 1997"
8,8,19,850,249,288,537,"6 de julio de 1997"
8,8,19,851,293,299,592,"6 de julio de 1997"
8,8,19,852,219,188,407,"6 de julio de 1997"
8,8,19,853,145,145,290,"6 de julio de 1997"
8,8,19,854,239,218,457,"6 de julio de 1997"
8,8,19,855,114,100,214,"6 de julio de 1997"
8,8,19,856,64,64,128,"6 de julio de 1997"
8,8,19,857,281,340,621,"6 de julio de 1997"
8,8,19,858,388,429,817,"6 de julio de 1997"
8,8,19,859,268,250,518,"6 de julio de 1997"
8,8,19,860,388,407,795,"6 de julio de 1997"
8,8,19,861,236,242,478,"6 de julio de 1997"
8,8,19,862,465,479,944,"6 de julio de 1997"
8,8,19,863,441,523,964,"6 de julio de 1997"
8,8,19,864,254,266,520,"6 de julio de 1997"
8,8,19,865,439,456,895,"6 de julio de 1997"
8,8,19,866,239,262,501,"6 de julio de 1997"
8,8,19,867,443,531,974,"6 de julio de 1997"
8,8,19,868,446,485,931,"6 de julio de 1997"
8,8,19,869,521,521,1042,"6 de julio de 1997"
8,8,19,870,612,647,1259,"6 de julio de 1997"
8,8,19,871,723,707,1430,"6 de julio de 1997"
8,8,19,872,579,630,1209,"6 de julio de 1997"
8,8,19,873,535,603,1138,"6 de julio de 1997"
8,8,19,874,548,614,1162,"6 de julio de 1997"
8,8,19,875,544,595,1139,"6 de julio de 1997"
8,8,19,876,659,721,1380,"6 de julio de 1997"
8,8,19,877,307,336,643,"6 de julio de 1997"
8,8,19,878,311,368,679,"6 de julio de 1997"
8,8,19,879,369,386,755,"6 de julio de 1997"
8,8,19,880,516,574,1090,"6 de julio de 1997"
8,8,19,881,367,384,751,"6 de julio de 1997"
8,8,19,882,297,341,638,"6 de julio de 1997"
8,8,19,883,453,487,940,"6 de julio de 1997"
8,8,19,884,350,392,742,"6 de julio de 1997"
8,8,19,885,302,313,615,"6 de julio de 1997"
8,8,19,899,185,153,338,"6 de julio de 1997"
8,8,19,900,87,55,142,"6 de julio de 1997"
8,8,19,901,139,115,254,"6 de julio de 1997"
8,8,19,902,129,95,224,"6 de julio de 1997"
8,8,19,903,202,169,371,"6 de julio de 1997"
8,8,19,904,148,127,275,"6 de julio de 1997"
8,8,19,905,309,281,590,"6 de julio de 1997"
8,8,19,908,121,128,249,"6 de julio de 1997"
8,8,19,909,71,64,135,"6 de julio de 1997"
8,9,3,38,331,337,668,"6 de julio de 1997"
8,9,3,39,390,393,783,"6 de julio de 1997"
8,9,3,40,264,302,566,"6 de julio de 1997"
8,9,3,41,290,285,575,"6 de julio de 1997"
8,9,3,42,67,42,109,"6 de julio de 1997"
8,9,3,43,180,160,340,"6 de julio de 1997"
8,9,3,44,46,46,92,"6 de julio de 1997"
8,9,3,45,74,62,136,"6 de julio de 1997"
8,9,3,46,81,69,150,"6 de julio de 1997"
8,9,3,47,85,64,149,"6 de julio de 1997"
8,9,3,48,111,103,214,"6 de julio de 1997"
8,9,3,49,79,71,150,"6 de julio de 1997"
8,9,3,50,101,90,191,"6 de julio de 1997"
8,9,3,51,78,60,138,"6 de julio de 1997"
8,9,3,52,128,96,224,"6 de julio de 1997"
8,9,3,53,325,277,602,"6 de julio de 1997"
8,9,3,54,275,222,497,"6 de julio de 1997"
8,9,3,55,215,187,402,"6 de julio de 1997"
8,9,7,102,378,311,689,"6 de julio de 1997"
8,9,7,103,413,391,804,"6 de julio de 1997"
8,9,7,104,117,73,190,"6 de julio de 1997"
8,9,7,105,297,264,561,"6 de julio de 1997"
8,9,7,106,435,324,759,"6 de julio de 1997"
8,9,7,107,272,263,535,"6 de julio de 1997"
8,9,7,108,230,207,437,"6 de julio de 1997"
8,9,7,109,155,118,273,"6 de julio de 1997"
8,9,7,110,342,242,584,"6 de julio de 1997"
8,9,7,111,323,222,545,"6 de julio de 1997"
8,9,7,112,218,141,359,"6 de julio de 1997"
8,9,7,113,641,345,986,"6 de julio de 1997"
8,9,7,114,574,442,1016,"6 de julio de 1997"
8,9,7,115,448,316,764,"6 de julio de 1997"
8,9,14,253,391,350,741,"6 de julio de 1997"
8,9,14,254,57,43,100,"6 de julio de 1997"
8,9,14,255,29,22,51,"6 de julio de 1997"
8,9,14,256,126,113,239,"6 de julio de 1997"
8,9,14,257,69,53,122,"6 de julio de 1997"
8,9,14,258,65,45,110,"6 de julio de 1997"
8,9,14,259,87,63,150,"6 de julio de 1997"
8,9,14,260,46,42,88,"6 de julio de 1997"
8,9,27,1082,170,174,344,"6 de julio de 1997"
8,9,27,1083,322,357,679,"6 de julio de 1997"
8,9,27,1084,222,236,458,"6 de julio de 1997"
8,9,27,1085,269,335,604,"6 de julio de 1997"
8,9,27,1086,196,222,418,"6 de julio de 1997"
8,9,27,1087,279,321,600,"6 de julio de 1997"
8,9,27,1088,230,256,486,"6 de julio de 1997"
8,9,27,1089,255,256,511,"6 de julio de 1997"
8,9,27,1090,199,227,426,"6 de julio de 1997"
8,9,27,1091,365,376,741,"6 de julio de 1997"
8,9,27,1092,300,209,509,"6 de julio de 1997"
8,9,27,1093,257,171,428,"6 de julio de 1997"
8,9,27,1094,234,116,350,"6 de julio de 1997"
8,9,27,1095,245,157,402,"6 de julio de 1997"
8,9,27,1096,121,31,152,"6 de julio de 1997"
8,9,27,1097,430,306,736,"6 de julio de 1997"
8,9,27,1098,618,352,970,"6 de julio de 1997"
8,9,27,1099,99,63,162,"6 de julio de 1997"
8,9,27,1100,361,203,564,"6 de julio de 1997"
8,9,27,1101,420,255,675,"6 de julio de 1997"
8,9,27,1102,224,149,373,"6 de julio de 1997"
8,9,27,1103,131,80,211,"6 de julio de 1997"
8,9,27,1104,230,168,398,"6 de julio de 1997"
8,9,27,1105,165,115,280,"6 de julio de 1997"
8,9,27,1106,117,82,199,"6 de julio de 1997"
8,9,27,1107,696,527,1223,"6 de julio de 1997"
8,9,27,1108,209,137,346,"6 de julio de 1997"
8,9,27,1109,96,74,170,"6 de julio de 1997"
8,9,27,1110,126,73,199,"6 de julio de 1997"
8,9,27,1111,196,167,363,"6 de julio de 1997"
8,9,27,1112,90,63,153,"6 de julio de 1997"
8,9,27,1113,118,83,201,"6 de julio de 1997"
8,9,27,1114,442,191,633,"6 de julio de 1997"
8,9,27,1115,96,68,164,"6 de julio de 1997"
8,9,27,1116,121,81,202,"6 de julio de 1997"
8,9,27,1117,267,168,435,"6 de julio de 1997"
8,9,27,1118,464,439,903,"6 de julio de 1997"
8,9,27,1119,153,135,288,"6 de julio de 1997"
8,9,27,1120,197,170,367,"6 de julio de 1997"
8,9,27,1121,40,18,58,"6 de julio de 1997"
8,9,27,1122,135,104,239,"6 de julio de 1997"
8,9,27,1123,246,202,448,"6 de julio de 1997"
8,9,27,1124,95,75,170,"6 de julio de 1997"
8,9,27,1125,105,101,206,"6 de julio de 1997"
8,9,29,1135,347,364,711,"6 de julio de 1997"
8,9,29,1136,573,564,1137,"6 de julio de 1997"
8,9,29,1137,120,72,192,"6 de julio de 1997"
8,9,29,1138,257,166,423,"6 de julio de 1997"
8,9,29,1139,399,342,741,"6 de julio de 1997"
8,9,29,1140,579,435,1014,"6 de julio de 1997"
8,9,29,1141,53,33,86,"6 de julio de 1997"
8,9,29,1142,203,183,386,"6 de julio de 1997"
8,9,29,1143,673,623,1296,"6 de julio de 1997"
8,9,29,1144,353,255,608,"6 de julio de 1997"
8,9,29,1145,206,176,382,"6 de julio de 1997"
8,9,29,1146,396,285,681,"6 de julio de 1997"
8,9,29,1147,450,326,776,"6 de julio de 1997"
8,9,29,1148,534,461,995,"6 de julio de 1997"
8,9,29,1149,141,123,264,"6 de julio de 1997"
8,9,29,1150,109,68,177,"6 de julio de 1997"
8,9,29,1151,93,37,130,"6 de julio de 1997"
8,9,29,1152,142,110,252,"6 de julio de 1997"
8,9,29,1153,300,226,526,"6 de julio de 1997"
8,9,29,1154,280,227,507,"6 de julio de 1997"
8,9,29,1155,500,390,890,"6 de julio de 1997"
8,9,29,1156,281,195,476,"6 de julio de 1997"
8,9,29,1157,124,94,218,"6 de julio de 1997"
8,9,29,1158,329,285,614,"6 de julio de 1997"
8,9,29,1159,709,532,1241,"6 de julio de 1997"
8,9,29,1160,358,316,674,"6 de julio de 1997"
8,9,29,1161,140,128,268,"6 de julio de 1997"
8,9,29,1162,181,149,330,"6 de julio de 1997"
8,9,29,1163,339,270,609,"6 de julio de 1997"
8,9,29,1164,416,378,794,"6 de julio de 1997"
8,9,29,1165,682,616,1298,"6 de julio de 1997"
8,9,29,1166,82,68,150,"6 de julio de 1997"
8,9,32,1266,227,264,491,"6 de julio de 1997"
8,9,32,1267,210,229,439,"6 de julio de 1997"
8,9,32,1268,354,370,724,"6 de julio de 1997"
8,9,32,1269,275,315,590,"6 de julio de 1997"
8,9,32,1270,143,175,318,"6 de julio de 1997"
8,9,32,1271,215,252,467,"6 de julio de 1997"
8,9,32,1272,340,389,729,"6 de julio de 1997"
8,9,32,1273,458,512,970,"6 de julio de 1997"
8,9,32,1274,189,212,401,"6 de julio de 1997"
8,9,32,1275,464,490,954,"6 de julio de 1997"
8,9,32,1276,367,381,748,"6 de julio de 1997"
8,9,32,1277,328,414,742,"6 de julio de 1997"
8,9,32,1278,402,418,820,"6 de julio de 1997"
8,9,32,1279,263,260,523,"6 de julio de 1997"
8,9,32,1280,307,345,652,"6 de julio de 1997"
8,9,32,1281,847,931,1778,"6 de julio de 1997"
8,9,32,1282,321,327,648,"6 de julio de 1997"
8,9,32,1283,322,364,686,"6 de julio de 1997"
8,9,32,1284,458,483,941,"6 de julio de 1997"
8,9,32,1285,351,413,764,"6 de julio de 1997"
8,9,32,1286,171,212,383,"6 de julio de 1997"
8,9,32,1287,232,275,507,"6 de julio de 1997"
8,9,32,1288,500,500,1000,"6 de julio de 1997"
8,9,32,1289,476,513,989,"6 de julio de 1997"
8,9,32,1290,520,560,1080,"6 de julio de 1997"
8,9,32,1291,245,278,523,"6 de julio de 1997"
8,9,32,1292,359,443,802,"6 de julio de 1997"
8,9,32,1293,415,469,884,"6 de julio de 1997"
8,9,32,1294,382,398,780,"6 de julio de 1997"
8,9,32,1295,246,244,490,"6 de julio de 1997"
8,9,32,1296,421,483,904,"6 de julio de 1997"
8,9,32,1297,363,421,784,"6 de julio de 1997"
8,9,32,1298,731,317,1048,"6 de julio de 1997"
8,9,32,1299,264,288,552,"6 de julio de 1997"
8,9,32,1300,312,340,652,"6 de julio de 1997"
8,9,32,1301,339,379,718,"6 de julio de 1997"
8,9,32,1302,302,348,650,"6 de julio de 1997"
8,9,32,1303,266,292,558,"6 de julio de 1997"
8,9,32,1304,229,271,500,"6 de julio de 1997"
8,9,32,1305,227,248,475,"6 de julio de 1997"
8,9,32,1306,435,494,929,"6 de julio de 1997"
8,9,32,1307,198,213,411,"6 de julio de 1997"
8,9,32,1308,445,524,969,"6 de julio de 1997"
8,9,32,1309,367,425,792,"6 de julio de 1997"
8,9,32,1310,177,240,417,"6 de julio de 1997"
8,9,32,1311,287,313,600,"6 de julio de 1997"
8,9,32,1312,504,584,1088,"6 de julio de 1997"
8,9,32,1313,312,371,683,"6 de julio de 1997"
8,9,32,1314,221,249,470,"6 de julio de 1997"
8,9,32,1315,302,385,687,"6 de julio de 1997"
8,9,32,1316,216,270,486,"6 de julio de 1997"
8,9,32,1317,344,416,760,"6 de julio de 1997"
8,9,32,1318,448,509,957,"6 de julio de 1997"
8,9,32,1319,379,399,778,"6 de julio de 1997"
8,9,32,1320,181,183,364,"6 de julio de 1997"
8,9,32,1321,210,267,477,"6 de julio de 1997"
8,9,32,1322,359,411,770,"6 de julio de 1997"
8,9,32,1323,319,429,748,"6 de julio de 1997"
8,9,32,1324,296,342,638,"6 de julio de 1997"
8,9,32,1325,361,388,749,"6 de julio de 1997"
8,9,32,1326,236,277,513,"6 de julio de 1997"
8,9,32,1327,379,448,827,"6 de julio de 1997"
8,9,32,1328,525,584,1109,"6 de julio de 1997"
8,9,32,1329,307,362,669,"6 de julio de 1997"
8,9,32,1330,230,238,468,"6 de julio de 1997"
8,9,32,1331,379,393,772,"6 de julio de 1997"
8,9,32,1332,380,432,812,"6 de julio de 1997"
8,9,32,1333,391,450,841,"6 de julio de 1997"
8,9,32,1334,525,533,1058,"6 de julio de 1997"
8,9,32,1335,237,266,503,"6 de julio de 1997"
8,9,32,1336,348,385,733,"6 de julio de 1997"
8,9,32,1337,457,504,961,"6 de julio de 1997"
8,9,32,1338,361,401,762,"6 de julio de 1997"
8,9,32,1339,291,287,578,"6 de julio de 1997"
8,9,32,1340,466,536,1002,"6 de julio de 1997"
8,9,32,1341,365,415,780,"6 de julio de 1997"
8,9,32,1342,476,537,1013,"6 de julio de 1997"
8,9,32,1343,251,294,545,"6 de julio de 1997"
8,9,32,1344,233,249,482,"6 de julio de 1997"
8,9,32,1345,665,759,1424,"6 de julio de 1997"
8,9,32,1346,390,436,826,"6 de julio de 1997"
8,9,32,1347,291,316,607,"6 de julio de 1997"
8,9,32,1348,366,367,733,"6 de julio de 1997"
8,9,32,1349,83,47,130,"6 de julio de 1997"
8,9,32,1350,58,28,86,"6 de julio de 1997"
8,9,32,1351,69,38,107,"6 de julio de 1997"
8,9,32,1352,28,22,50,"6 de julio de 1997"
8,9,32,1353,308,249,557,"6 de julio de 1997"
8,9,32,1354,170,128,298,"6 de julio de 1997"
8,9,33,1355,236,255,491,"6 de julio de 1997"
8,9,33,1356,241,205,446,"6 de julio de 1997"
8,9,36,1387,309,295,604,"6 de julio de 1997"
8,9,36,1388,292,285,577,"6 de julio de 1997"
8,9,36,1389,415,420,835,"6 de julio de 1997"
8,9,36,1390,422,459,881,"6 de julio de 1997"
8,9,36,1391,318,355,673,"6 de julio de 1997"
8,9,36,1392,246,245,491,"6 de julio de 1997"
8,9,36,1393,370,387,757,"6 de julio de 1997"
8,9,36,1394,229,246,475,"6 de julio de 1997"
8,9,36,1395,394,430,824,"6 de julio de 1997"
8,9,36,1396,341,375,716,"6 de julio de 1997"
8,9,36,1397,307,283,590,"6 de julio de 1997"
8,9,36,1398,519,576,1095,"6 de julio de 1997"
8,9,36,1399,464,495,959,"6 de julio de 1997"
8,9,36,1400,431,505,936,"6 de julio de 1997"
8,9,36,1401,270,308,578,"6 de julio de 1997"
8,9,36,1402,357,338,695,"6 de julio de 1997"
8,9,36,1403,336,366,702,"6 de julio de 1997"
8,9,36,1404,254,314,568,"6 de julio de 1997"
8,9,36,1405,190,216,406,"6 de julio de 1997"
8,9,36,1406,579,621,1200,"6 de julio de 1997"
8,9,36,1407,490,491,981,"6 de julio de 1997"
8,9,36,1408,233,260,493,"6 de julio de 1997"
8,9,36,1409,286,274,560,"6 de julio de 1997"
8,9,36,1410,261,267,528,"6 de julio de 1997"
8,9,36,1411,428,477,905,"6 de julio de 1997"
8,9,36,1412,337,401,738,"6 de julio de 1997"
8,9,36,1413,314,247,561,"6 de julio de 1997"
8,9,36,1414,212,193,405,"6 de julio de 1997"
8,9,36,1415,242,225,467,"6 de julio de 1997"
8,9,36,1416,243,208,451,"6 de julio de 1997"
8,9,36,1417,188,150,338,"6 de julio de 1997"
8,9,36,1418,291,215,506,"6 de julio de 1997"
8,9,36,1419,307,304,611,"6 de julio de 1997"
8,9,36,1420,41,20,61,"6 de julio de 1997"
8,9,36,1421,322,218,540,"6 de julio de 1997"
8,9,36,1422,185,196,381,"6 de julio de 1997"
8,9,36,1423,164,140,304,"6 de julio de 1997"
8,9,39,2206,410,369,779,"6 de julio de 1997"
8,9,39,2207,362,354,716,"6 de julio de 1997"
8,9,39,2208,112,102,214,"6 de julio de 1997"
8,9,39,2209,95,72,167,"6 de julio de 1997"
8,9,39,2210,44,38,82,"6 de julio de 1997"
8,9,39,2211,204,194,398,"6 de julio de 1997"
8,9,39,2212,190,181,371,"6 de julio de 1997"
8,9,39,2213,61,38,99,"6 de julio de 1997"
8,9,44,2278,439,440,879,"6 de julio de 1997"
8,9,44,2279,309,343,652,"6 de julio de 1997"
8,9,44,2280,208,162,370,"6 de julio de 1997"
8,9,44,2281,122,103,225,"6 de julio de 1997"
8,9,44,2282,96,85,181,"6 de julio de 1997"
8,9,44,2283,72,58,130,"6 de julio de 1997"
8,9,44,2284,63,39,102,"6 de julio de 1997"
8,9,44,2285,38,32,70,"6 de julio de 1997"
8,9,44,2286,202,152,354,"6 de julio de 1997"
8,9,44,2287,108,103,211,"6 de julio de 1997"
8,9,46,2323,342,232,574,"6 de julio de 1997"
8,9,46,2324,93,60,153,"6 de julio de 1997"
8,9,46,2325,166,133,299,"6 de julio de 1997"
8,9,46,2326,111,68,179,"6 de julio de 1997"
8,9,46,2327,171,116,287,"6 de julio de 1997"
8,9,46,2328,203,159,362,"6 de julio de 1997"
8,9,46,2329,439,391,830,"6 de julio de 1997"
8,9,46,2330,99,86,185,"6 de julio de 1997"
8,9,56,2545,355,325,680,"6 de julio de 1997"
8,9,56,2546,300,264,564,"6 de julio de 1997"
8,9,56,2547,127,117,244,"6 de julio de 1997"
8,9,56,2548,245,221,466,"6 de julio de 1997"
8,9,59,2566,325,345,670,"6 de julio de 1997"
8,9,59,2567,250,260,510,"6 de julio de 1997"
8,9,59,2568,136,129,265,"6 de julio de 1997"
8,9,59,2569,186,211,397,"6 de julio de 1997"
8,9,59,2570,146,161,307,"6 de julio de 1997"
8,9,59,2571,156,162,318,"6 de julio de 1997"
8,9,59,2572,240,250,490,"6 de julio de 1997"
8,9,59,2573,230,259,489,"6 de julio de 1997"
8,9,59,2574,256,251,507,"6 de julio de 1997"
8,9,59,2575,153,138,291,"6 de julio de 1997"
8,9,59,2576,63,57,120,"6 de julio de 1997"
8,9,59,2577,54,36,90,"6 de julio de 1997"
8,9,60,2578,37,28,65,"6 de julio de 1997"
8,9,60,2579,205,187,392,"6 de julio de 1997"
8,9,60,2580,116,154,270,"6 de julio de 1997"
8,9,60,2581,215,207,422,"6 de julio de 1997"
8,9,60,2582,189,195,384,"6 de julio de 1997"
8,9,60,2583,293,303,596,"6 de julio de 1997"
8,9,60,2584,252,278,530,"6 de julio de 1997"
8,9,60,2585,307,321,628,"6 de julio de 1997"
8,9,60,2586,230,261,491,"6 de julio de 1997"
8,9,60,2587,293,284,577,"6 de julio de 1997"
8,9,60,2588,309,356,665,"6 de julio de 1997"
8,9,60,2589,154,173,327,"6 de julio de 1997"
8,9,60,2590,267,271,538,"6 de julio de 1997"
8,9,60,2591,419,421,840,"6 de julio de 1997"
8,9,60,2592,150,153,303,"6 de julio de 1997"
8,9,60,2593,187,182,369,"6 de julio de 1997"
8,9,60,2594,82,64,146,"6 de julio de 1997"
8,9,60,2595,239,237,476,"6 de julio de 1997"
8,9,60,2596,47,31,78,"6 de julio de 1997"
8,9,60,2597,54,50,104,"6 de julio de 1997"
8,9,60,2598,47,31,78,"6 de julio de 1997"
8,9,60,2599,72,50,122,"6 de julio de 1997"
8,9,60,2600,27,20,47,"6 de julio de 1997"
8,9,64,2661,202,215,417,"6 de julio de 1997"
8,9,64,2662,124,134,258,"6 de julio de 1997"
8,9,64,2663,181,178,359,"6 de julio de 1997"
8,9,64,2664,81,76,157,"6 de julio de 1997"
8,9,64,2665,93,88,181,"6 de julio de 1997"
8,9,64,2666,36,44,80,"6 de julio de 1997"
8,9,64,2667,69,66,135,"6 de julio de 1997"
8,9,67,2697,394,367,761,"6 de julio de 1997"
8,9,67,2698,211,218,429,"6 de julio de 1997"
8,9,67,2699,176,141,317,"6 de julio de 1997"
8,9,67,2700,100,86,186,"6 de julio de 1997"
8,9,67,2701,161,132,293,"6 de julio de 1997"
8,9,67,2702,113,117,230,"6 de julio de 1997"
8,9,67,2703,90,84,174,"6 de julio de 1997"
8,9,67,2704,77,64,141,"6 de julio de 1997"
8,9,67,2705,56,50,106,"6 de julio de 1997"
8,9,67,2706,271,290,561,"6 de julio de 1997"
8,9,67,2707,120,92,212,"6 de julio de 1997"
8,9,67,2708,31,31,62,"6 de julio de 1997"
8,9,67,2709,126,117,243,"6 de julio de 1997"
8,9,67,2710,160,121,281,"6 de julio de 1997"
9,1,5,821,564,596,1160,"6 de julio de 1997"
9,1,5,822,517,486,1003,"6 de julio de 1997"
9,1,5,823,591,616,1207,"6 de julio de 1997"
9,1,5,824,741,768,1509,"6 de julio de 1997"
9,1,5,825,503,525,1028,"6 de julio de 1997"
9,1,5,826,412,415,827,"6 de julio de 1997"
9,1,5,827,748,780,1528,"6 de julio de 1997"
9,1,5,828,601,597,1198,"6 de julio de 1997"
9,1,5,829,530,536,1066,"6 de julio de 1997"
9,1,5,830,478,519,997,"6 de julio de 1997"
9,1,5,831,597,581,1178,"6 de julio de 1997"
9,1,5,832,535,548,1083,"6 de julio de 1997"
9,1,5,833,555,638,1193,"6 de julio de 1997"
9,1,5,834,462,470,932,"6 de julio de 1997"
9,1,5,835,663,644,1307,"6 de julio de 1997"
9,1,5,836,420,432,852,"6 de julio de 1997"
9,1,5,837,515,557,1072,"6 de julio de 1997"
9,1,5,838,495,523,1018,"6 de julio de 1997"
9,1,5,839,562,603,1165,"6 de julio de 1997"
9,1,5,840,527,549,1076,"6 de julio de 1997"
9,1,5,841,640,711,1351,"6 de julio de 1997"
9,1,5,842,676,689,1365,"6 de julio de 1997"
9,1,5,843,659,689,1348,"6 de julio de 1997"
9,1,5,844,568,621,1189,"6 de julio de 1997"
9,1,5,845,460,512,972,"6 de julio de 1997"
9,1,5,846,555,626,1181,"6 de julio de 1997"
9,1,5,847,316,318,634,"6 de julio de 1997"
9,1,5,848,611,604,1215,"6 de julio de 1997"
9,1,5,849,661,651,1312,"6 de julio de 1997"
9,1,5,850,633,679,1312,"6 de julio de 1997"
9,1,5,851,488,570,1058,"6 de julio de 1997"
9,1,5,852,1091,1143,2234,"6 de julio de 1997"
9,1,5,853,511,544,1055,"6 de julio de 1997"
9,1,5,854,631,693,1324,"6 de julio de 1997"
9,1,5,855,490,585,1075,"6 de julio de 1997"
9,1,5,856,551,592,1143,"6 de julio de 1997"
9,1,5,857,548,630,1178,"6 de julio de 1997"
9,1,5,858,457,516,973,"6 de julio de 1997"
9,1,5,859,762,785,1547,"6 de julio de 1997"
9,1,5,860,720,758,1478,"6 de julio de 1997"
9,1,5,861,499,523,1022,"6 de julio de 1997"
9,1,5,862,245,297,542,"6 de julio de 1997"
9,1,5,863,508,507,1015,"6 de julio de 1997"
9,1,5,864,513,521,1034,"6 de julio de 1997"
9,1,5,865,1101,1277,2378,"6 de julio de 1997"
9,1,5,866,515,560,1075,"6 de julio de 1997"
9,1,5,867,456,508,964,"6 de julio de 1997"
9,1,5,868,440,490,930,"6 de julio de 1997"
9,1,5,869,459,578,1037,"6 de julio de 1997"
9,1,5,870,491,480,971,"6 de julio de 1997"
9,1,5,871,579,623,1202,"6 de julio de 1997"
9,1,5,872,489,499,988,"6 de julio de 1997"
9,1,5,873,525,591,1116,"6 de julio de 1997"
9,1,5,874,521,574,1095,"6 de julio de 1997"
9,1,5,875,654,699,1353,"6 de julio de 1997"
9,1,5,876,620,683,1303,"6 de julio de 1997"
9,1,5,877,721,740,1461,"6 de julio de 1997"
9,1,5,878,539,543,1082,"6 de julio de 1997"
9,1,5,879,449,465,914,"6 de julio de 1997"
9,1,5,880,435,429,864,"6 de julio de 1997"
9,1,5,881,641,651,1292,"6 de julio de 1997"
9,1,5,882,506,560,1066,"6 de julio de 1997"
9,1,5,883,470,530,1000,"6 de julio de 1997"
9,1,5,884,554,574,1128,"6 de julio de 1997"
9,1,5,885,526,577,1103,"6 de julio de 1997"
9,1,5,886,443,467,910,"6 de julio de 1997"
9,1,5,887,612,621,1233,"6 de julio de 1997"
9,1,5,888,742,728,1470,"6 de julio de 1997"
9,1,5,889,528,619,1147,"6 de julio de 1997"
9,1,5,890,600,605,1205,"6 de julio de 1997"
9,1,5,891,584,592,1176,"6 de julio de 1997"
9,1,5,892,468,546,1014,"6 de julio de 1997"
9,1,5,893,545,573,1118,"6 de julio de 1997"
9,1,5,894,511,544,1055,"6 de julio de 1997"
9,1,5,895,583,593,1176,"6 de julio de 1997"
9,1,5,896,571,629,1200,"6 de julio de 1997"
9,1,5,897,501,573,1074,"6 de julio de 1997"
9,1,5,898,417,443,860,"6 de julio de 1997"
9,1,5,899,520,584,1104,"6 de julio de 1997"
9,1,5,900,603,655,1258,"6 de julio de 1997"
9,1,5,901,540,541,1081,"6 de julio de 1997"
9,1,5,902,521,569,1090,"6 de julio de 1997"
9,1,5,903,520,539,1059,"6 de julio de 1997"
9,1,5,904,582,618,1200,"6 de julio de 1997"
9,1,5,905,659,658,1317,"6 de julio de 1997"
9,1,5,906,548,541,1089,"6 de julio de 1997"
9,1,5,907,448,494,942,"6 de julio de 1997"
9,1,5,908,533,588,1121,"6 de julio de 1997"
9,1,5,909,558,551,1109,"6 de julio de 1997"
9,1,5,910,672,700,1372,"6 de julio de 1997"
9,1,5,911,469,522,991,"6 de julio de 1997"
9,1,5,912,549,532,1081,"6 de julio de 1997"
9,1,5,913,617,657,1274,"6 de julio de 1997"
9,1,5,914,559,612,1171,"6 de julio de 1997"
9,1,5,915,629,664,1293,"6 de julio de 1997"
9,1,5,916,557,599,1156,"6 de julio de 1997"
9,1,5,917,590,588,1178,"6 de julio de 1997"
9,1,5,918,560,615,1175,"6 de julio de 1997"
9,1,5,919,549,554,1103,"6 de julio de 1997"
9,1,5,920,542,583,1125,"6 de julio de 1997"
9,1,5,921,504,562,1066,"6 de julio de 1997"
9,1,5,922,569,538,1107,"6 de julio de 1997"
9,1,5,923,584,530,1114,"6 de julio de 1997"
9,1,5,924,482,496,978,"6 de julio de 1997"
9,1,5,925,461,448,909,"6 de julio de 1997"
9,1,5,926,545,585,1130,"6 de julio de 1997"
9,1,5,927,613,578,1191,"6 de julio de 1997"
9,1,5,928,642,747,1389,"6 de julio de 1997"
9,1,5,929,541,579,1120,"6 de julio de 1997"
9,1,5,930,395,468,863,"6 de julio de 1997"
9,1,5,931,518,575,1093,"6 de julio de 1997"
9,1,5,932,336,381,717,"6 de julio de 1997"
9,1,5,933,543,680,1223,"6 de julio de 1997"
9,1,5,934,352,362,714,"6 de julio de 1997"
9,1,5,935,344,455,799,"6 de julio de 1997"
9,1,5,936,494,534,1028,"6 de julio de 1997"
9,1,5,937,529,554,1083,"6 de julio de 1997"
9,1,5,938,496,521,1017,"6 de julio de 1997"
9,1,5,939,590,624,1214,"6 de julio de 1997"
9,1,5,940,511,539,1050,"6 de julio de 1997"
9,1,5,941,529,574,1103,"6 de julio de 1997"
9,1,5,942,340,395,735,"6 de julio de 1997"
9,1,5,943,591,611,1202,"6 de julio de 1997"
9,1,5,944,489,581,1070,"6 de julio de 1997"
9,1,5,945,446,477,923,"6 de julio de 1997"
9,1,5,946,549,589,1138,"6 de julio de 1997"
9,1,5,947,338,330,668,"6 de julio de 1997"
9,1,5,948,481,519,1000,"6 de julio de 1997"
9,1,5,949,494,546,1040,"6 de julio de 1997"
9,1,5,950,417,446,863,"6 de julio de 1997"
9,1,5,951,435,489,924,"6 de julio de 1997"
9,1,5,952,371,397,768,"6 de julio de 1997"
9,1,5,953,627,677,1304,"6 de julio de 1997"
9,1,5,954,472,541,1013,"6 de julio de 1997"
9,1,5,955,574,706,1280,"6 de julio de 1997"
9,1,5,956,415,445,860,"6 de julio de 1997"
9,1,5,957,331,344,675,"6 de julio de 1997"
9,1,5,958,449,525,974,"6 de julio de 1997"
9,1,5,959,455,566,1021,"6 de julio de 1997"
9,1,5,960,316,370,686,"6 de julio de 1997"
9,1,5,961,424,554,978,"6 de julio de 1997"
9,1,5,962,345,428,773,"6 de julio de 1997"
9,1,5,963,333,392,725,"6 de julio de 1997"
9,1,5,964,375,445,820,"6 de julio de 1997"
9,1,5,965,311,318,629,"6 de julio de 1997"
9,1,5,966,599,642,1241,"6 de julio de 1997"
9,1,5,967,541,554,1095,"6 de julio de 1997"
9,1,5,968,468,493,961,"6 de julio de 1997"
9,1,5,969,533,560,1093,"6 de julio de 1997"
9,1,5,970,507,542,1049,"6 de julio de 1997"
9,1,5,971,574,578,1152,"6 de julio de 1997"
9,1,5,972,543,523,1066,"6 de julio de 1997"
9,1,5,973,326,349,675,"6 de julio de 1997"
9,1,5,974,481,553,1034,"6 de julio de 1997"
9,1,5,975,543,572,1115,"6 de julio de 1997"
9,1,5,976,453,479,932,"6 de julio de 1997"
9,1,5,977,432,484,916,"6 de julio de 1997"
9,1,5,978,292,334,626,"6 de julio de 1997"
9,1,5,979,304,322,626,"6 de julio de 1997"
9,1,5,980,411,444,855,"6 de julio de 1997"
9,1,5,981,292,372,664,"6 de julio de 1997"
9,1,5,982,470,494,964,"6 de julio de 1997"
9,1,5,983,344,421,765,"6 de julio de 1997"
9,1,5,984,362,437,799,"6 de julio de 1997"
9,1,5,985,281,308,589,"6 de julio de 1997"
9,1,5,986,383,421,804,"6 de julio de 1997"
9,1,5,987,527,570,1097,"6 de julio de 1997"
9,1,5,988,330,355,685,"6 de julio de 1997"
9,1,5,989,401,448,849,"6 de julio de 1997"
9,1,5,990,413,465,878,"6 de julio de 1997"
9,1,5,991,405,511,916,"6 de julio de 1997"
9,1,5,992,304,315,619,"6 de julio de 1997"
9,1,5,993,371,380,751,"6 de julio de 1997"
9,1,5,994,499,527,1026,"6 de julio de 1997"
9,1,5,995,484,550,1034,"6 de julio de 1997"
9,1,5,996,505,532,1037,"6 de julio de 1997"
9,1,5,997,208,230,438,"6 de julio de 1997"
9,1,5,998,586,647,1233,"6 de julio de 1997"
9,1,5,999,573,593,1166,"6 de julio de 1997"
9,1,5,1000,521,524,1045,"6 de julio de 1997"
9,1,5,1001,489,531,1020,"6 de julio de 1997"
9,1,5,1002,801,874,1675,"6 de julio de 1997"
9,1,5,1003,503,530,1033,"6 de julio de 1997"
9,1,5,1004,514,592,1106,"6 de julio de 1997"
9,1,5,1005,395,419,814,"6 de julio de 1997"
9,1,5,1006,422,472,894,"6 de julio de 1997"
9,1,5,1007,287,329,616,"6 de julio de 1997"
9,1,5,1008,446,495,941,"6 de julio de 1997"
9,1,5,1009,529,551,1080,"6 de julio de 1997"
9,1,5,1010,372,413,785,"6 de julio de 1997"
9,1,5,1011,337,379,716,"6 de julio de 1997"
9,1,5,1012,273,302,575,"6 de julio de 1997"
9,1,5,1013,404,430,834,"6 de julio de 1997"
9,1,5,1014,640,686,1326,"6 de julio de 1997"
9,1,5,1015,533,629,1162,"6 de julio de 1997"
9,1,5,1016,529,558,1087,"6 de julio de 1997"
9,1,5,1017,468,514,982,"6 de julio de 1997"
9,1,5,1018,298,290,588,"6 de julio de 1997"
9,1,5,1019,409,472,881,"6 de julio de 1997"
9,1,5,1020,373,432,805,"6 de julio de 1997"
9,1,5,1021,363,408,771,"6 de julio de 1997"
9,1,5,1022,439,437,876,"6 de julio de 1997"
9,1,5,1023,411,454,865,"6 de julio de 1997"
9,1,5,1024,421,453,874,"6 de julio de 1997"
9,1,5,1025,422,502,924,"6 de julio de 1997"
9,1,5,1026,442,548,990,"6 de julio de 1997"
9,1,5,1027,530,547,1077,"6 de julio de 1997"
9,1,5,1071,308,344,652,"6 de julio de 1997"
9,1,5,1072,157,165,322,"6 de julio de 1997"
9,1,5,1073,305,294,599,"6 de julio de 1997"
9,1,5,1074,444,479,923,"6 de julio de 1997"
9,1,5,1075,254,302,556,"6 de julio de 1997"
9,1,5,1076,321,410,731,"6 de julio de 1997"
9,1,5,1077,367,429,796,"6 de julio de 1997"
9,1,5,1078,282,305,587,"6 de julio de 1997"
9,2,2,1,459,492,951,"6 de julio de 1997"
9,2,2,2,555,621,1176,"6 de julio de 1997"
9,2,2,3,504,518,1022,"6 de julio de 1997"
9,2,2,4,494,567,1061,"6 de julio de 1997"
9,2,2,5,440,467,907,"6 de julio de 1997"
9,2,2,6,482,507,989,"6 de julio de 1997"
9,2,2,7,410,466,876,"6 de julio de 1997"
9,2,2,8,604,600,1204,"6 de julio de 1997"
9,2,2,9,430,444,874,"6 de julio de 1997"
9,2,2,10,578,648,1226,"6 de julio de 1997"
9,2,2,18,464,497,961,"6 de julio de 1997"
9,2,2,19,460,487,947,"6 de julio de 1997"
9,2,2,20,414,454,868,"6 de julio de 1997"
9,2,2,21,486,509,995,"6 de julio de 1997"
9,2,2,22,547,575,1122,"6 de julio de 1997"
9,2,2,23,404,425,829,"6 de julio de 1997"
9,2,2,24,466,480,946,"6 de julio de 1997"
9,2,2,25,352,405,757,"6 de julio de 1997"
9,2,2,26,428,461,889,"6 de julio de 1997"
9,2,2,27,513,548,1061,"6 de julio de 1997"
9,2,2,28,593,600,1193,"6 de julio de 1997"
9,2,2,29,463,526,989,"6 de julio de 1997"
9,2,2,308,640,718,1358,"6 de julio de 1997"
9,2,2,309,255,270,525,"6 de julio de 1997"
9,2,2,310,410,385,795,"6 de julio de 1997"
9,2,2,311,324,368,692,"6 de julio de 1997"
9,2,2,312,522,500,1022,"6 de julio de 1997"
9,2,2,313,625,622,1247,"6 de julio de 1997"
9,2,2,314,597,661,1258,"6 de julio de 1997"
9,2,2,315,610,666,1276,"6 de julio de 1997"
9,2,2,316,494,473,967,"6 de julio de 1997"
9,2,2,317,447,484,931,"6 de julio de 1997"
9,2,2,318,598,633,1231,"6 de julio de 1997"
9,2,2,319,555,568,1123,"6 de julio de 1997"
9,2,2,320,583,588,1171,"6 de julio de 1997"
9,2,2,321,500,593,1093,"6 de julio de 1997"
9,2,2,322,516,557,1073,"6 de julio de 1997"
9,2,2,323,537,548,1085,"6 de julio de 1997"
9,2,2,324,426,468,894,"6 de julio de 1997"
9,2,2,325,453,510,963,"6 de julio de 1997"
9,2,2,326,636,728,1364,"6 de julio de 1997"
9,2,2,327,388,487,875,"6 de julio de 1997"
9,2,2,328,445,492,937,"6 de julio de 1997"
9,2,2,329,507,569,1076,"6 de julio de 1997"
9,2,2,330,402,434,836,"6 de julio de 1997"
9,2,2,331,450,513,963,"6 de julio de 1997"
9,2,2,332,469,538,1007,"6 de julio de 1997"
9,2,2,333,475,530,1005,"6 de julio de 1997"
9,2,2,334,557,694,1251,"6 de julio de 1997"
9,2,2,335,383,446,829,"6 de julio de 1997"
9,2,2,336,502,535,1037,"6 de julio de 1997"
9,2,2,337,413,457,870,"6 de julio de 1997"
9,2,2,338,443,471,914,"6 de julio de 1997"
9,2,2,339,455,506,961,"6 de julio de 1997"
9,2,2,340,483,531,1014,"6 de julio de 1997"
9,2,2,341,502,577,1079,"6 de julio de 1997"
9,2,2,342,454,470,924,"6 de julio de 1997"
9,2,2,343,424,467,891,"6 de julio de 1997"
9,2,2,344,682,726,1408,"6 de julio de 1997"
9,2,5,1028,502,605,1107,"6 de julio de 1997"
9,2,5,1029,686,790,1476,"6 de julio de 1997"
9,2,5,1030,417,485,902,"6 de julio de 1997"
9,2,5,1031,457,533,990,"6 de julio de 1997"
9,2,5,1032,360,429,789,"6 de julio de 1997"
9,2,5,1033,409,476,885,"6 de julio de 1997"
9,2,5,1034,365,455,820,"6 de julio de 1997"
9,2,5,1035,171,195,366,"6 de julio de 1997"
9,2,5,1036,329,372,701,"6 de julio de 1997"
9,2,5,1037,251,296,547,"6 de julio de 1997"
9,2,5,1038,544,583,1127,"6 de julio de 1997"
9,2,5,1039,334,406,740,"6 de julio de 1997"
9,2,5,1040,530,588,1118,"6 de julio de 1997"
9,2,5,1041,793,883,1676,"6 de julio de 1997"
9,2,5,1042,557,539,1096,"6 de julio de 1997"
9,2,5,1043,451,502,953,"6 de julio de 1997"
9,2,5,1044,431,471,902,"6 de julio de 1997"
9,2,5,1045,500,546,1046,"6 de julio de 1997"
9,2,5,1046,265,361,626,"6 de julio de 1997"
9,2,5,1047,496,536,1032,"6 de julio de 1997"
9,2,5,1048,345,431,776,"6 de julio de 1997"
9,2,5,1049,253,333,586,"6 de julio de 1997"
9,2,5,1050,374,470,844,"6 de julio de 1997"
9,2,5,1051,500,599,1099,"6 de julio de 1997"
9,2,5,1052,379,435,814,"6 de julio de 1997"
9,2,5,1053,365,456,821,"6 de julio de 1997"
9,2,5,1054,322,377,699,"6 de julio de 1997"
9,2,5,1055,309,373,682,"6 de julio de 1997"
9,2,5,1056,578,612,1190,"6 de julio de 1997"
9,2,5,1057,306,386,692,"6 de julio de 1997"
9,2,5,1058,306,354,660,"6 de julio de 1997"
9,2,5,1059,451,583,1034,"6 de julio de 1997"
9,2,5,1060,461,568,1029,"6 de julio de 1997"
9,2,5,1061,525,611,1136,"6 de julio de 1997"
9,2,5,1062,577,675,1252,"6 de julio de 1997"
9,2,5,1063,508,573,1081,"6 de julio de 1997"
9,2,5,1064,557,584,1141,"6 de julio de 1997"
9,2,5,1065,438,498,936,"6 de julio de 1997"
9,2,5,1066,393,444,837,"6 de julio de 1997"
9,2,5,1067,334,454,788,"6 de julio de 1997"
9,2,5,1068,421,542,963,"6 de julio de 1997"
9,2,5,1069,474,514,988,"6 de julio de 1997"
9,2,5,1070,327,402,729,"6 de julio de 1997"
9,2,5,1214,839,899,1738,"6 de julio de 1997"
9,2,5,1215,445,458,903,"6 de julio de 1997"
9,2,5,1216,554,613,1167,"6 de julio de 1997"
9,2,5,1217,656,778,1434,"6 de julio de 1997"
9,2,5,1218,636,716,1352,"6 de julio de 1997"
9,2,5,1251,369,453,822,"6 de julio de 1997"
9,2,5,1252,485,532,1017,"6 de julio de 1997"
9,2,5,1253,602,710,1312,"6 de julio de 1997"
9,2,5,1254,282,313,595,"6 de julio de 1997"
9,2,5,1255,475,533,1008,"6 de julio de 1997"
9,2,5,1256,313,387,700,"6 de julio de 1997"
9,2,5,1257,377,441,818,"6 de julio de 1997"
9,2,5,1258,433,543,976,"6 de julio de 1997"
9,2,5,1259,360,491,851,"6 de julio de 1997"
9,2,5,1260,424,494,918,"6 de julio de 1997"
9,2,5,1261,381,465,846,"6 de julio de 1997"
9,2,5,1263,411,520,931,"6 de julio de 1997"
9,2,5,1289,686,921,1607,"6 de julio de 1997"
9,2,5,1290,450,588,1038,"6 de julio de 1997"
9,2,5,1291,327,443,770,"6 de julio de 1997"
9,2,5,1292,594,824,1418,"6 de julio de 1997"
9,2,5,1293,593,861,1454,"6 de julio de 1997"
9,2,5,1295,604,701,1305,"6 de julio de 1997"
9,2,5,1296,287,285,572,"6 de julio de 1997"
9,2,5,1297,286,397,683,"6 de julio de 1997"
9,2,5,1325,414,532,946,"6 de julio de 1997"
9,2,5,1451,598,698,1296,"6 de julio de 1997"
9,2,5,1452,325,421,746,"6 de julio de 1997"
9,2,5,1453,354,419,773,"6 de julio de 1997"
9,2,5,1454,389,445,834,"6 de julio de 1997"
9,2,5,1455,411,464,875,"6 de julio de 1997"
9,2,5,1456,433,505,938,"6 de julio de 1997"
9,2,5,1457,344,435,779,"6 de julio de 1997"
9,2,5,1458,514,598,1112,"6 de julio de 1997"
9,2,5,1459,362,482,844,"6 de julio de 1997"
9,2,5,1460,416,515,931,"6 de julio de 1997"
9,2,5,1461,277,351,628,"6 de julio de 1997"
9,2,5,1462,421,480,901,"6 de julio de 1997"
9,2,5,1463,663,710,1373,"6 de julio de 1997"
9,2,5,1464,559,636,1195,"6 de julio de 1997"
9,2,5,1465,419,549,968,"6 de julio de 1997"
9,2,5,1466,447,534,981,"6 de julio de 1997"
9,2,5,1467,408,472,880,"6 de julio de 1997"
9,2,5,1468,458,500,958,"6 de julio de 1997"
9,2,5,1469,673,683,1356,"6 de julio de 1997"
9,2,5,1470,429,533,962,"6 de julio de 1997"
9,2,5,1471,660,686,1346,"6 de julio de 1997"
9,2,5,1472,626,624,1250,"6 de julio de 1997"
9,2,5,1473,448,544,992,"6 de julio de 1997"
9,2,5,1474,576,613,1189,"6 de julio de 1997"
9,2,5,1475,549,590,1139,"6 de julio de 1997"
9,2,5,1476,473,520,993,"6 de julio de 1997"
9,2,5,1477,585,660,1245,"6 de julio de 1997"
9,2,5,1478,430,473,903,"6 de julio de 1997"
9,2,5,1479,441,491,932,"6 de julio de 1997"
9,2,5,1480,212,250,462,"6 de julio de 1997"
9,2,5,1481,594,598,1192,"6 de julio de 1997"
9,2,5,1482,480,531,1011,"6 de julio de 1997"
9,2,5,1483,568,626,1194,"6 de julio de 1997"
9,2,5,1484,622,676,1298,"6 de julio de 1997"
9,2,5,1485,535,576,1111,"6 de julio de 1997"
9,2,5,1486,425,497,922,"6 de julio de 1997"
9,2,5,1487,474,542,1016,"6 de julio de 1997"
9,2,5,1488,277,299,576,"6 de julio de 1997"
9,2,5,1489,430,419,849,"6 de julio de 1997"
9,2,5,1490,497,577,1074,"6 de julio de 1997"
9,2,5,1491,685,746,1431,"6 de julio de 1997"
9,2,5,1492,525,580,1105,"6 de julio de 1997"
9,2,5,1493,520,534,1054,"6 de julio de 1997"
9,2,5,1494,483,560,1043,"6 de julio de 1997"
9,2,5,1495,190,238,428,"6 de julio de 1997"
9,3,2,11,414,457,871,"6 de julio de 1997"
9,3,2,12,339,442,781,"6 de julio de 1997"
9,3,2,13,533,681,1214,"6 de julio de 1997"
9,3,2,14,364,498,862,"6 de julio de 1997"
9,3,2,15,413,534,947,"6 de julio de 1997"
9,3,2,16,558,684,1242,"6 de julio de 1997"
9,3,2,17,430,454,884,"6 de julio de 1997"
9,3,2,30,565,591,1156,"6 de julio de 1997"
9,3,2,31,558,620,1178,"6 de julio de 1997"
9,3,2,32,452,535,987,"6 de julio de 1997"
9,3,2,33,427,501,928,"6 de julio de 1997"
9,3,2,34,402,449,851,"6 de julio de 1997"
9,3,2,35,441,522,963,"6 de julio de 1997"
9,3,2,36,422,544,966,"6 de julio de 1997"
9,3,2,37,446,570,1016,"6 de julio de 1997"
9,3,2,38,456,482,938,"6 de julio de 1997"
9,3,2,39,475,568,1043,"6 de julio de 1997"
9,3,2,40,410,449,859,"6 de julio de 1997"
9,3,2,41,416,512,928,"6 de julio de 1997"
9,3,2,42,430,516,946,"6 de julio de 1997"
9,3,2,43,428,408,836,"6 de julio de 1997"
9,3,2,44,368,487,855,"6 de julio de 1997"
9,3,2,45,447,584,1031,"6 de julio de 1997"
9,3,2,46,318,413,731,"6 de julio de 1997"
9,3,2,47,525,593,1118,"6 de julio de 1997"
9,3,2,48,627,707,1334,"6 de julio de 1997"
9,3,2,49,428,476,904,"6 de julio de 1997"
9,3,2,50,461,550,1011,"6 de julio de 1997"
9,3,2,51,625,662,1287,"6 de julio de 1997"
9,3,2,52,426,538,964,"6 de julio de 1997"
9,3,2,53,391,463,854,"6 de julio de 1997"
9,3,2,54,605,631,1236,"6 de julio de 1997"
9,3,2,55,436,518,954,"6 de julio de 1997"
9,3,2,56,659,631,1290,"6 de julio de 1997"
9,3,2,57,549,613,1162,"6 de julio de 1997"
9,3,2,58,633,625,1258,"6 de julio de 1997"
9,3,2,59,489,517,1006,"6 de julio de 1997"
9,3,2,60,522,528,1050,"6 de julio de 1997"
9,3,2,61,541,570,1111,"6 de julio de 1997"
9,3,2,62,598,617,1215,"6 de julio de 1997"
9,3,2,63,412,409,821,"6 de julio de 1997"
9,3,2,64,625,631,1256,"6 de julio de 1997"
9,3,2,65,657,695,1352,"6 de julio de 1997"
9,3,2,66,539,577,1116,"6 de julio de 1997"
9,3,2,67,649,659,1308,"6 de julio de 1997"
9,3,2,68,535,560,1095,"6 de julio de 1997"
9,3,2,69,549,568,1117,"6 de julio de 1997"
9,3,2,70,639,640,1279,"6 de julio de 1997"
9,3,2,71,531,581,1112,"6 de julio de 1997"
9,3,2,72,659,708,1367,"6 de julio de 1997"
9,3,2,73,569,629,1198,"6 de julio de 1997"
9,3,2,74,538,566,1104,"6 de julio de 1997"
9,3,2,75,515,551,1066,"6 de julio de 1997"
9,3,2,76,650,701,1351,"6 de julio de 1997"
9,3,2,77,571,689,1260,"6 de julio de 1997"
9,3,2,78,545,598,1143,"6 de julio de 1997"
9,3,2,79,521,532,1053,"6 de julio de 1997"
9,3,2,80,490,486,976,"6 de julio de 1997"
9,3,2,81,402,446,848,"6 de julio de 1997"
9,3,2,82,451,523,974,"6 de julio de 1997"
9,3,2,83,337,378,715,"6 de julio de 1997"
9,3,2,84,484,570,1054,"6 de julio de 1997"
9,3,2,85,423,494,917,"6 de julio de 1997"
9,3,2,86,563,668,1231,"6 de julio de 1997"
9,3,2,87,529,590,1119,"6 de julio de 1997"
9,3,2,88,546,627,1173,"6 de julio de 1997"
9,3,2,89,328,369,697,"6 de julio de 1997"
9,3,2,90,590,653,1243,"6 de julio de 1997"
9,3,2,91,481,575,1056,"6 de julio de 1997"
9,3,2,92,523,580,1103,"6 de julio de 1997"
9,3,2,93,415,455,870,"6 de julio de 1997"
9,3,2,94,426,456,882,"6 de julio de 1997"
9,3,2,95,617,706,1323,"6 de julio de 1997"
9,3,2,96,589,658,1247,"6 de julio de 1997"
9,3,2,97,735,750,1485,"6 de julio de 1997"
9,3,2,98,310,359,669,"6 de julio de 1997"
9,3,2,99,429,535,964,"6 de julio de 1997"
9,3,2,100,562,677,1239,"6 de julio de 1997"
9,3,2,101,523,670,1193,"6 de julio de 1997"
9,3,2,102,532,611,1143,"6 de julio de 1997"
9,3,2,103,522,567,1089,"6 de julio de 1997"
9,3,2,104,468,513,981,"6 de julio de 1997"
9,3,2,105,474,578,1052,"6 de julio de 1997"
9,3,2,106,271,313,584,"6 de julio de 1997"
9,3,2,107,405,494,899,"6 de julio de 1997"
9,3,2,108,498,592,1090,"6 de julio de 1997"
9,3,2,109,744,787,1531,"6 de julio de 1997"
9,3,2,110,385,444,829,"6 de julio de 1997"
9,3,2,111,678,751,1429,"6 de julio de 1997"
9,3,2,112,373,430,803,"6 de julio de 1997"
9,3,2,113,357,429,786,"6 de julio de 1997"
9,3,2,114,291,350,641,"6 de julio de 1997"
9,3,2,115,369,432,801,"6 de julio de 1997"
9,3,2,116,346,471,817,"6 de julio de 1997"
9,3,2,117,312,423,735,"6 de julio de 1997"
9,3,2,118,345,415,760,"6 de julio de 1997"
9,3,2,119,694,792,1486,"6 de julio de 1997"
9,3,2,120,332,473,805,"6 de julio de 1997"
9,3,2,121,389,505,894,"6 de julio de 1997"
9,3,2,122,419,491,910,"6 de julio de 1997"
9,3,2,123,464,554,1018,"6 de julio de 1997"
9,3,2,124,480,639,1119,"6 de julio de 1997"
9,3,2,125,579,650,1229,"6 de julio de 1997"
9,3,2,126,475,579,1054,"6 de julio de 1997"
9,3,2,127,519,593,1112,"6 de julio de 1997"
9,3,2,128,471,540,1011,"6 de julio de 1997"
9,3,2,129,530,674,1204,"6 de julio de 1997"
9,3,2,130,163,174,337,"6 de julio de 1997"
9,3,2,131,391,495,886,"6 de julio de 1997"
9,3,2,132,419,529,948,"6 de julio de 1997"
9,3,2,133,549,681,1230,"6 de julio de 1997"
9,3,2,134,360,430,790,"6 de julio de 1997"
9,3,2,135,318,395,713,"6 de julio de 1997"
9,3,2,136,444,583,1027,"6 de julio de 1997"
9,3,2,137,330,411,741,"6 de julio de 1997"
9,3,2,138,360,437,797,"6 de julio de 1997"
9,3,2,139,314,385,699,"6 de julio de 1997"
9,3,2,140,284,323,607,"6 de julio de 1997"
9,3,2,141,291,355,646,"6 de julio de 1997"
9,3,2,142,430,531,961,"6 de julio de 1997"
9,3,2,143,389,438,827,"6 de julio de 1997"
9,3,2,144,390,471,861,"6 de julio de 1997"
9,3,2,145,378,475,853,"6 de julio de 1997"
9,3,2,146,423,527,950,"6 de julio de 1997"
9,3,2,147,436,542,978,"6 de julio de 1997"
9,3,2,148,484,572,1056,"6 de julio de 1997"
9,3,2,149,240,273,513,"6 de julio de 1997"
9,3,2,150,223,266,489,"6 de julio de 1997"
9,3,2,151,194,224,418,"6 de julio de 1997"
9,3,2,152,303,363,666,"6 de julio de 1997"
9,3,2,153,316,315,631,"6 de julio de 1997"
9,3,2,154,522,585,1107,"6 de julio de 1997"
9,3,2,155,572,595,1167,"6 de julio de 1997"
9,3,2,156,589,616,1205,"6 de julio de 1997"
9,3,2,157,265,322,587,"6 de julio de 1997"
9,3,2,158,268,308,576,"6 de julio de 1997"
9,3,2,159,554,577,1131,"6 de julio de 1997"
9,3,2,160,533,626,1159,"6 de julio de 1997"
9,3,2,161,585,601,1186,"6 de julio de 1997"
9,3,2,162,686,736,1422,"6 de julio de 1997"
9,3,2,163,571,577,1148,"6 de julio de 1997"
9,3,2,164,749,749,1498,"6 de julio de 1997"
9,3,2,165,765,819,1584,"6 de julio de 1997"
9,3,2,166,776,778,1554,"6 de julio de 1997"
9,3,2,167,544,550,1094,"6 de julio de 1997"
9,3,2,168,722,814,1536,"6 de julio de 1997"
9,3,2,169,705,751,1456,"6 de julio de 1997"
9,3,2,170,590,697,1287,"6 de julio de 1997"
9,3,2,171,662,709,1371,"6 de julio de 1997"
9,3,2,172,569,549,1118,"6 de julio de 1997"
9,3,2,173,406,400,806,"6 de julio de 1997"
9,3,2,174,433,452,885,"6 de julio de 1997"
9,3,2,175,467,510,977,"6 de julio de 1997"
9,3,2,176,633,684,1317,"6 de julio de 1997"
9,3,2,177,661,681,1342,"6 de julio de 1997"
9,3,2,178,282,307,589,"6 de julio de 1997"
9,3,2,179,586,625,1211,"6 de julio de 1997"
9,3,2,186,617,624,1241,"6 de julio de 1997"
9,3,2,187,293,365,658,"6 de julio de 1997"
9,3,2,188,522,570,1092,"6 de julio de 1997"
9,3,2,189,609,634,1243,"6 de julio de 1997"
9,3,2,190,474,512,986,"6 de julio de 1997"
9,3,2,191,561,574,1135,"6 de julio de 1997"
9,3,2,197,429,454,883,"6 de julio de 1997"
9,3,2,198,547,581,1128,"6 de julio de 1997"
9,3,2,199,498,543,1041,"6 de julio de 1997"
9,3,2,200,542,642,1184,"6 de julio de 1997"
9,3,2,201,450,462,912,"6 de julio de 1997"
9,3,2,202,557,548,1105,"6 de julio de 1997"
9,3,2,203,614,667,1281,"6 de julio de 1997"
9,3,2,221,393,478,871,"6 de julio de 1997"
9,3,2,223,247,291,538,"6 de julio de 1997"
9,3,2,224,401,534,935,"6 de julio de 1997"
9,3,2,225,487,585,1072,"6 de julio de 1997"
9,3,2,288,447,468,915,"6 de julio de 1997"
9,3,2,289,260,287,547,"6 de julio de 1997"
9,3,2,291,267,246,513,"6 de julio de 1997"
9,3,2,292,255,282,537,"6 de julio de 1997"
9,3,2,293,387,460,847,"6 de julio de 1997"
9,3,2,294,275,303,578,"6 de julio de 1997"
9,3,2,295,259,286,545,"6 de julio de 1997"
9,3,2,296,292,287,579,"6 de julio de 1997"
9,3,2,297,320,344,664,"6 de julio de 1997"
9,3,2,298,293,312,605,"6 de julio de 1997"
9,3,2,299,339,365,704,"6 de julio de 1997"
9,3,2,301,264,316,580,"6 de julio de 1997"
9,3,2,302,112,151,263,"6 de julio de 1997"
9,3,2,303,183,214,397,"6 de julio de 1997"
9,3,2,304,211,240,451,"6 de julio de 1997"
9,3,2,305,260,286,546,"6 de julio de 1997"
9,3,2,306,155,187,342,"6 de julio de 1997"
9,3,2,307,129,156,285,"6 de julio de 1997"
9,3,2,5512,202,252,454,"6 de julio de 1997"
9,3,2,5513,189,203,392,"6 de julio de 1997"
9,3,2,5514,213,246,459,"6 de julio de 1997"
9,4,5,1079,420,547,967,"6 de julio de 1997"
9,4,5,1080,359,470,829,"6 de julio de 1997"
9,4,5,1081,368,402,770,"6 de julio de 1997"
9,4,5,1082,343,434,777,"6 de julio de 1997"
9,4,5,1083,417,481,898,"6 de julio de 1997"
9,4,5,1084,395,510,905,"6 de julio de 1997"
9,4,5,1085,440,468,908,"6 de julio de 1997"
9,4,5,1086,461,568,1029,"6 de julio de 1997"
9,4,5,1087,403,472,875,"6 de julio de 1997"
9,4,5,1088,365,451,816,"6 de julio de 1997"
9,4,5,1089,337,451,788,"6 de julio de 1997"
9,4,5,1090,421,517,938,"6 de julio de 1997"
9,4,5,1091,557,680,1237,"6 de julio de 1997"
9,4,5,1092,477,578,1055,"6 de julio de 1997"
9,4,5,1093,436,568,1004,"6 de julio de 1997"
9,4,5,1094,406,534,940,"6 de julio de 1997"
9,4,5,1095,371,493,864,"6 de julio de 1997"
9,4,5,1096,326,483,809,"6 de julio de 1997"
9,4,5,1097,409,531,940,"6 de julio de 1997"
9,4,5,1098,492,645,1137,"6 de julio de 1997"
9,4,5,1099,454,557,1011,"6 de julio de 1997"
9,4,5,1100,460,602,1062,"6 de julio de 1997"
9,4,5,1101,441,482,923,"6 de julio de 1997"
9,4,5,1102,360,455,815,"6 de julio de 1997"
9,4,5,1103,389,532,921,"6 de julio de 1997"
9,4,5,1104,329,410,739,"6 de julio de 1997"
9,4,5,1105,415,516,931,"6 de julio de 1997"
9,4,5,1106,510,586,1096,"6 de julio de 1997"
9,4,5,1107,363,438,801,"6 de julio de 1997"
9,4,5,1108,378,493,871,"6 de julio de 1997"
9,4,5,1109,384,515,899,"6 de julio de 1997"
9,4,5,1110,371,445,816,"6 de julio de 1997"
9,4,5,1111,274,349,623,"6 de julio de 1997"
9,4,5,1112,404,520,924,"6 de julio de 1997"
9,4,5,1113,334,435,769,"6 de julio de 1997"
9,4,5,1114,442,530,972,"6 de julio de 1997"
9,4,5,1115,325,438,763,"6 de julio de 1997"
9,4,5,1116,291,344,635,"6 de julio de 1997"
9,4,5,1117,427,478,905,"6 de julio de 1997"
9,4,5,1118,416,542,958,"6 de julio de 1997"
9,4,5,1119,446,506,952,"6 de julio de 1997"
9,4,5,1120,383,497,880,"6 de julio de 1997"
9,4,5,1121,370,468,838,"6 de julio de 1997"
9,4,5,1122,342,444,786,"6 de julio de 1997"
9,4,5,1123,347,419,766,"6 de julio de 1997"
9,4,5,1124,314,401,715,"6 de julio de 1997"
9,4,5,1125,324,409,733,"6 de julio de 1997"
9,4,5,1126,427,486,913,"6 de julio de 1997"
9,4,5,1127,338,423,761,"6 de julio de 1997"
9,4,5,1128,381,495,876,"6 de julio de 1997"
9,4,5,1129,301,394,695,"6 de julio de 1997"
9,4,5,1130,260,376,636,"6 de julio de 1997"
9,4,5,1131,424,554,978,"6 de julio de 1997"
9,4,5,1132,346,409,755,"6 de julio de 1997"
9,4,5,1133,342,381,723,"6 de julio de 1997"
9,4,5,1134,452,524,976,"6 de julio de 1997"
9,4,5,1135,456,514,970,"6 de julio de 1997"
9,4,5,1136,591,658,1249,"6 de julio de 1997"
9,4,5,1137,569,638,1207,"6 de julio de 1997"
9,4,5,1138,428,465,893,"6 de julio de 1997"
9,4,5,1139,283,327,610,"6 de julio de 1997"
9,4,5,1140,322,404,726,"6 de julio de 1997"
9,4,5,1141,559,660,1219,"6 de julio de 1997"
9,4,5,1142,495,546,1041,"6 de julio de 1997"
9,4,5,1143,531,620,1151,"6 de julio de 1997"
9,4,5,1144,487,559,1046,"6 de julio de 1997"
9,4,5,1145,725,820,1545,"6 de julio de 1997"
9,4,5,1146,331,376,707,"6 de julio de 1997"
9,4,5,1147,316,326,642,"6 de julio de 1997"
9,4,5,1219,512,560,1072,"6 de julio de 1997"
9,4,5,1220,484,531,1015,"6 de julio de 1997"
9,4,5,1221,560,643,1203,"6 de julio de 1997"
9,4,5,1222,594,645,1239,"6 de julio de 1997"
9,4,5,1223,579,636,1215,"6 de julio de 1997"
9,4,5,1224,446,508,954,"6 de julio de 1997"
9,4,5,1225,508,547,1055,"6 de julio de 1997"
9,4,5,1226,632,709,1341,"6 de julio de 1997"
9,4,5,1227,537,643,1180,"6 de julio de 1997"
9,4,5,1228,484,593,1077,"6 de julio de 1997"
9,4,5,1229,690,814,1504,"6 de julio de 1997"
9,4,5,1230,619,737,1356,"6 de julio de 1997"
9,4,5,1231,683,732,1415,"6 de julio de 1997"
9,4,5,1232,529,551,1080,"6 de julio de 1997"
9,4,5,1233,557,634,1191,"6 de julio de 1997"
9,4,5,1234,552,583,1135,"6 de julio de 1997"
9,4,5,1235,570,607,1177,"6 de julio de 1997"
9,4,5,1236,575,609,1184,"6 de julio de 1997"
9,4,5,1237,634,737,1371,"6 de julio de 1997"
9,4,5,1238,564,663,1227,"6 de julio de 1997"
9,4,5,1239,445,490,935,"6 de julio de 1997"
9,4,5,1240,527,552,1079,"6 de julio de 1997"
9,4,5,1241,461,572,1033,"6 de julio de 1997"
9,4,5,1242,467,538,1005,"6 de julio de 1997"
9,4,5,1243,513,590,1103,"6 de julio de 1997"
9,4,5,1244,652,691,1343,"6 de julio de 1997"
9,4,5,1245,437,481,918,"6 de julio de 1997"
9,4,5,1246,679,742,1421,"6 de julio de 1997"
9,4,5,1247,340,412,752,"6 de julio de 1997"
9,4,5,1248,573,611,1184,"6 de julio de 1997"
9,4,5,1249,406,478,884,"6 de julio de 1997"
9,4,5,1250,474,538,1012,"6 de julio de 1997"
9,4,5,1262,381,429,810,"6 de julio de 1997"
9,4,5,1264,406,430,836,"6 de julio de 1997"
9,4,5,1265,550,571,1121,"6 de julio de 1997"
9,4,5,1266,592,633,1225,"6 de julio de 1997"
9,4,5,1267,608,609,1217,"6 de julio de 1997"
9,4,5,1268,441,474,915,"6 de julio de 1997"
9,4,5,1269,496,513,1009,"6 de julio de 1997"
9,4,5,1270,593,679,1272,"6 de julio de 1997"
9,4,5,1271,652,698,1350,"6 de julio de 1997"
9,4,5,1272,613,622,1235,"6 de julio de 1997"
9,4,5,1273,557,613,1170,"6 de julio de 1997"
9,4,5,1274,603,723,1326,"6 de julio de 1997"
9,4,5,1275,736,752,1488,"6 de julio de 1997"
9,4,5,1276,459,488,947,"6 de julio de 1997"
9,4,5,1277,570,622,1192,"6 de julio de 1997"
9,4,5,1278,512,562,1074,"6 de julio de 1997"
9,4,5,1279,403,439,842,"6 de julio de 1997"
9,4,5,1280,434,453,887,"6 de julio de 1997"
9,4,5,1281,493,529,1022,"6 de julio de 1997"
9,4,5,1282,526,589,1115,"6 de julio de 1997"
9,4,5,1283,424,497,921,"6 de julio de 1997"
9,4,5,1284,460,492,952,"6 de julio de 1997"
9,4,5,1285,512,577,1089,"6 de julio de 1997"
9,4,5,1286,320,378,698,"6 de julio de 1997"
9,4,5,1287,486,504,990,"6 de julio de 1997"
9,4,5,1288,405,459,864,"6 de julio de 1997"
9,4,5,1294,409,476,885,"6 de julio de 1997"
9,4,5,1298,405,529,934,"6 de julio de 1997"
9,4,5,1299,530,656,1186,"6 de julio de 1997"
9,4,5,1300,421,482,903,"6 de julio de 1997"
9,4,5,1301,475,534,1009,"6 de julio de 1997"
9,4,5,1302,472,524,996,"6 de julio de 1997"
9,4,5,1303,243,312,555,"6 de julio de 1997"
9,4,5,1304,275,331,606,"6 de julio de 1997"
9,4,5,1305,655,723,1378,"6 de julio de 1997"
9,4,5,1306,531,616,1147,"6 de julio de 1997"
9,4,5,1307,603,671,1274,"6 de julio de 1997"
9,4,5,1308,497,629,1126,"6 de julio de 1997"
9,4,5,1309,519,573,1092,"6 de julio de 1997"
9,4,5,1310,511,545,1056,"6 de julio de 1997"
9,4,5,1311,645,734,1379,"6 de julio de 1997"
9,4,5,1312,447,526,973,"6 de julio de 1997"
9,4,5,1313,531,598,1129,"6 de julio de 1997"
9,4,5,1314,535,593,1128,"6 de julio de 1997"
9,4,5,1315,486,562,1048,"6 de julio de 1997"
9,4,5,1316,556,625,1181,"6 de julio de 1997"
9,4,5,1317,461,517,978,"6 de julio de 1997"
9,4,5,1318,530,584,1114,"6 de julio de 1997"
9,4,5,1319,493,584,1077,"6 de julio de 1997"
9,4,5,1320,385,426,811,"6 de julio de 1997"
9,4,5,1321,401,456,857,"6 de julio de 1997"
9,4,5,1322,546,592,1138,"6 de julio de 1997"
9,4,5,1323,448,500,948,"6 de julio de 1997"
9,4,5,1324,406,383,789,"6 de julio de 1997"
9,4,5,1326,292,496,788,"6 de julio de 1997"
9,4,5,1508,703,775,1478,"6 de julio de 1997"
9,4,5,1509,498,517,1015,"6 de julio de 1997"
9,4,5,1510,461,472,933,"6 de julio de 1997"
9,4,5,1511,582,633,1215,"6 de julio de 1997"
9,4,5,1512,657,673,1330,"6 de julio de 1997"
9,4,5,1513,530,542,1072,"6 de julio de 1997"
9,4,5,1514,216,220,436,"6 de julio de 1997"
9,4,5,1515,492,547,1039,"6 de julio de 1997"
9,4,5,1516,633,671,1304,"6 de julio de 1997"
9,4,5,1529,509,599,1108,"6 de julio de 1997"
9,4,5,1530,540,620,1160,"6 de julio de 1997"
9,4,5,1531,490,527,1017,"6 de julio de 1997"
9,4,5,1532,501,562,1063,"6 de julio de 1997"
9,4,5,1533,513,483,996,"6 de julio de 1997"
9,4,5,1534,572,633,1205,"6 de julio de 1997"
9,4,5,1535,575,671,1246,"6 de julio de 1997"
9,4,5,1537,532,682,1214,"6 de julio de 1997"
9,4,5,1538,412,455,867,"6 de julio de 1997"
9,4,5,1539,517,530,1047,"6 de julio de 1997"
9,4,5,1540,630,714,1344,"6 de julio de 1997"
9,4,5,1541,584,631,1215,"6 de julio de 1997"
9,4,5,1542,505,524,1029,"6 de julio de 1997"
9,4,5,1543,457,501,958,"6 de julio de 1997"
9,4,5,1587,301,344,645,"6 de julio de 1997"
9,5,2,180,464,527,991,"6 de julio de 1997"
9,5,2,181,278,340,618,"6 de julio de 1997"
9,5,2,182,344,379,723,"6 de julio de 1997"
9,5,2,183,577,651,1228,"6 de julio de 1997"
9,5,2,184,399,422,821,"6 de julio de 1997"
9,5,2,185,382,457,839,"6 de julio de 1997"
9,5,2,192,224,235,459,"6 de julio de 1997"
9,5,2,193,546,622,1168,"6 de julio de 1997"
9,5,2,194,593,694,1287,"6 de julio de 1997"
9,5,2,195,540,566,1106,"6 de julio de 1997"
9,5,2,196,537,573,1110,"6 de julio de 1997"
9,5,2,204,593,692,1285,"6 de julio de 1997"
9,5,2,205,711,777,1488,"6 de julio de 1997"
9,5,2,206,609,634,1243,"6 de julio de 1997"
9,5,2,207,705,744,1449,"6 de julio de 1997"
9,5,2,208,720,824,1544,"6 de julio de 1997"
9,5,2,209,399,449,848,"6 de julio de 1997"
9,5,2,210,405,500,905,"6 de julio de 1997"
9,5,2,211,362,424,786,"6 de julio de 1997"
9,5,2,212,390,398,788,"6 de julio de 1997"
9,5,2,213,574,540,1114,"6 de julio de 1997"
9,5,2,214,501,559,1060,"6 de julio de 1997"
9,5,2,215,482,510,992,"6 de julio de 1997"
9,5,2,216,585,594,1179,"6 de julio de 1997"
9,5,2,217,509,562,1071,"6 de julio de 1997"
9,5,2,218,615,651,1266,"6 de julio de 1997"
9,5,2,219,788,817,1605,"6 de julio de 1997"
9,5,2,220,480,527,1007,"6 de julio de 1997"
9,5,2,222,687,714,1401,"6 de julio de 1997"
9,5,2,226,578,700,1278,"6 de julio de 1997"
9,5,2,227,513,543,1056,"6 de julio de 1997"
9,5,2,228,547,588,1135,"6 de julio de 1997"
9,5,2,229,607,632,1239,"6 de julio de 1997"
9,5,2,230,559,611,1170,"6 de julio de 1997"
9,5,2,231,518,554,1072,"6 de julio de 1997"
9,5,2,232,516,627,1143,"6 de julio de 1997"
9,5,2,233,425,444,869,"6 de julio de 1997"
9,5,2,234,183,233,416,"6 de julio de 1997"
9,5,2,235,287,320,607,"6 de julio de 1997"
9,5,2,236,588,622,1210,"6 de julio de 1997"
9,5,2,237,745,855,1600,"6 de julio de 1997"
9,5,2,238,566,626,1192,"6 de julio de 1997"
9,5,2,239,513,542,1055,"6 de julio de 1997"
9,5,2,240,451,485,936,"6 de julio de 1997"
9,5,2,241,607,658,1265,"6 de julio de 1997"
9,5,2,242,532,620,1152,"6 de julio de 1997"
9,5,2,243,177,194,371,"6 de julio de 1997"
9,5,2,244,398,472,870,"6 de julio de 1997"
9,5,2,245,550,658,1208,"6 de julio de 1997"
9,5,2,246,600,637,1237,"6 de julio de 1997"
9,5,2,247,561,650,1211,"6 de julio de 1997"
9,5,2,248,521,579,1100,"6 de julio de 1997"
9,5,2,249,248,279,527,"6 de julio de 1997"
9,5,2,250,491,532,1023,"6 de julio de 1997"
9,5,2,251,443,447,890,"6 de julio de 1997"
9,5,2,252,487,516,1003,"6 de julio de 1997"
9,5,2,253,489,550,1039,"6 de julio de 1997"
9,5,2,254,606,661,1267,"6 de julio de 1997"
9,5,2,255,478,540,1018,"6 de julio de 1997"
9,5,2,256,524,527,1051,"6 de julio de 1997"
9,5,2,257,633,716,1349,"6 de julio de 1997"
9,5,2,258,617,654,1271,"6 de julio de 1997"
9,5,2,259,544,594,1138,"6 de julio de 1997"
9,5,2,260,441,473,914,"6 de julio de 1997"
9,5,2,261,541,592,1133,"6 de julio de 1997"
9,5,2,262,454,475,929,"6 de julio de 1997"
9,5,2,263,569,639,1208,"6 de julio de 1997"
9,5,2,264,535,630,1165,"6 de julio de 1997"
9,5,2,265,478,562,1040,"6 de julio de 1997"
9,5,2,266,576,658,1234,"6 de julio de 1997"
9,5,2,267,395,438,833,"6 de julio de 1997"
9,5,2,268,409,494,903,"6 de julio de 1997"
9,5,2,269,519,572,1091,"6 de julio de 1997"
9,5,2,270,480,541,1021,"6 de julio de 1997"
9,5,2,271,508,528,1036,"6 de julio de 1997"
9,5,2,272,495,514,1009,"6 de julio de 1997"
9,5,2,273,672,650,1322,"6 de julio de 1997"
9,5,2,274,529,557,1086,"6 de julio de 1997"
9,5,2,275,517,586,1103,"6 de julio de 1997"
9,5,2,276,441,447,888,"6 de julio de 1997"
9,5,2,277,431,448,879,"6 de julio de 1997"
9,5,2,278,439,432,871,"6 de julio de 1997"
9,5,2,279,442,436,878,"6 de julio de 1997"
9,5,2,280,350,344,694,"6 de julio de 1997"
9,5,2,281,454,493,947,"6 de julio de 1997"
9,5,2,282,563,606,1169,"6 de julio de 1997"
9,5,2,283,536,577,1113,"6 de julio de 1997"
9,5,2,284,484,528,1012,"6 de julio de 1997"
9,5,2,285,542,592,1134,"6 de julio de 1997"
9,5,2,286,405,454,859,"6 de julio de 1997"
9,5,2,287,597,593,1190,"6 de julio de 1997"
9,5,2,290,396,458,854,"6 de julio de 1997"
9,5,2,300,276,379,655,"6 de julio de 1997"
9,5,16,4995,429,483,912,"6 de julio de 1997"
9,5,16,4996,319,391,710,"6 de julio de 1997"
9,5,16,4997,622,739,1361,"6 de julio de 1997"
9,5,16,4998,438,551,989,"6 de julio de 1997"
9,5,16,4999,628,760,1388,"6 de julio de 1997"
9,5,16,5000,449,525,974,"6 de julio de 1997"
9,5,16,5001,619,661,1280,"6 de julio de 1997"
9,5,16,5002,466,560,1026,"6 de julio de 1997"
9,5,16,5003,589,658,1247,"6 de julio de 1997"
9,5,16,5004,394,472,866,"6 de julio de 1997"
9,5,16,5005,425,569,994,"6 de julio de 1997"
9,5,16,5006,565,619,1184,"6 de julio de 1997"
9,5,16,5007,695,758,1453,"6 de julio de 1997"
9,5,16,5008,563,678,1241,"6 de julio de 1997"
9,5,16,5009,495,513,1008,"6 de julio de 1997"
9,5,16,5010,289,343,632,"6 de julio de 1997"
9,5,16,5011,349,28,377,"6 de julio de 1997"
9,5,16,5012,245,305,550,"6 de julio de 1997"
9,5,16,5037,683,783,1466,"6 de julio de 1997"
9,5,16,5038,610,653,1263,"6 de julio de 1997"
9,5,16,5039,668,793,1461,"6 de julio de 1997"
9,5,16,5040,538,668,1206,"6 de julio de 1997"
9,5,16,5041,523,619,1142,"6 de julio de 1997"
9,5,16,5042,613,684,1297,"6 de julio de 1997"
9,5,16,5043,663,810,1473,"6 de julio de 1997"
9,5,16,5044,597,689,1286,"6 de julio de 1997"
9,5,16,5045,639,711,1350,"6 de julio de 1997"
9,5,16,5046,610,618,1228,"6 de julio de 1997"
9,5,16,5047,485,545,1030,"6 de julio de 1997"
9,5,16,5048,581,639,1220,"6 de julio de 1997"
9,5,16,5049,699,780,1479,"6 de julio de 1997"
9,5,16,5050,608,676,1284,"6 de julio de 1997"
9,5,16,5051,751,812,1563,"6 de julio de 1997"
9,5,16,5052,582,674,1256,"6 de julio de 1997"
9,5,16,5053,407,445,852,"6 de julio de 1997"
9,5,16,5054,473,507,980,"6 de julio de 1997"
9,5,16,5055,777,853,1630,"6 de julio de 1997"
9,5,16,5058,576,620,1196,"6 de julio de 1997"
9,5,16,5059,434,528,962,"6 de julio de 1997"
9,5,16,5063,750,808,1558,"6 de julio de 1997"
9,5,16,5064,724,771,1495,"6 de julio de 1997"
9,5,16,5065,482,549,1031,"6 de julio de 1997"
9,5,16,5100,252,286,538,"6 de julio de 1997"
9,5,16,5101,371,412,783,"6 de julio de 1997"
9,5,16,5103,300,339,639,"6 de julio de 1997"
9,5,16,5104,491,501,992,"6 de julio de 1997"
9,5,16,5105,570,643,1213,"6 de julio de 1997"
9,5,16,5106,577,702,1279,"6 de julio de 1997"
9,5,16,5107,704,826,1530,"6 de julio de 1997"
9,5,16,5108,657,696,1353,"6 de julio de 1997"
9,5,16,5109,586,694,1280,"6 de julio de 1997"
9,5,16,5110,517,569,1086,"6 de julio de 1997"
9,5,16,5111,411,427,838,"6 de julio de 1997"
9,5,16,5112,645,731,1376,"6 de julio de 1997"
9,5,16,5113,555,615,1170,"6 de julio de 1997"
9,5,16,5114,731,728,1459,"6 de julio de 1997"
9,5,16,5115,189,227,416,"6 de julio de 1997"
9,5,16,5116,149,200,349,"6 de julio de 1997"
9,5,16,5120,587,688,1275,"6 de julio de 1997"
9,5,16,5121,640,753,1393,"6 de julio de 1997"
9,5,16,5122,462,536,998,"6 de julio de 1997"
9,5,16,5123,557,615,1172,"6 de julio de 1997"
9,5,16,5124,640,804,1444,"6 de julio de 1997"
9,5,16,5125,318,372,690,"6 de julio de 1997"
9,5,16,5137,413,521,934,"6 de julio de 1997"
9,5,16,5138,700,768,1468,"6 de julio de 1997"
9,5,16,5139,528,590,1118,"6 de julio de 1997"
9,5,16,5140,670,731,1401,"6 de julio de 1997"
9,5,16,5141,649,782,1431,"6 de julio de 1997"
9,5,16,5142,567,648,1215,"6 de julio de 1997"
9,5,16,5151,616,731,1347,"6 de julio de 1997"
9,5,16,5152,617,712,1329,"6 de julio de 1997"
9,5,16,5153,493,532,1025,"6 de julio de 1997"
9,5,16,5154,502,597,1099,"6 de julio de 1997"
9,5,16,5182,340,408,748,"6 de julio de 1997"
9,6,5,1327,533,560,1093,"6 de julio de 1997"
9,6,5,1328,467,491,958,"6 de julio de 1997"
9,6,5,1329,395,472,867,"6 de julio de 1997"
9,6,5,1330,580,633,1213,"6 de julio de 1997"
9,6,5,1331,581,641,1222,"6 de julio de 1997"
9,6,5,1332,517,558,1075,"6 de julio de 1997"
9,6,5,1333,563,586,1149,"6 de julio de 1997"
9,6,5,1334,544,580,1124,"6 de julio de 1997"
9,6,5,1335,555,565,1120,"6 de julio de 1997"
9,6,5,1336,654,722,1376,"6 de julio de 1997"
9,6,5,1337,518,587,1105,"6 de julio de 1997"
9,6,5,1338,757,811,1568,"6 de julio de 1997"
9,6,5,1339,484,526,1010,"6 de julio de 1997"
9,6,5,1340,619,667,1286,"6 de julio de 1997"
9,6,5,1341,524,546,1070,"6 de julio de 1997"
9,6,5,1342,657,723,1380,"6 de julio de 1997"
9,6,5,1343,541,525,1066,"6 de julio de 1997"
9,6,5,1344,514,617,1131,"6 de julio de 1997"
9,6,5,1345,553,624,1177,"6 de julio de 1997"
9,6,5,1346,585,634,1219,"6 de julio de 1997"
9,6,5,1347,478,558,1036,"6 de julio de 1997"
9,6,5,1348,672,695,1367,"6 de julio de 1997"
9,6,5,1349,336,347,683,"6 de julio de 1997"
9,6,5,1350,425,452,877,"6 de julio de 1997"
9,6,5,1351,505,530,1035,"6 de julio de 1997"
9,6,5,1352,419,488,907,"6 de julio de 1997"
9,6,5,1353,430,493,923,"6 de julio de 1997"
9,6,5,1354,419,486,905,"6 de julio de 1997"
9,6,5,1355,533,539,1072,"6 de julio de 1997"
9,6,5,1356,445,501,946,"6 de julio de 1997"
9,6,5,1357,489,499,988,"6 de julio de 1997"
9,6,5,1358,564,571,1135,"6 de julio de 1997"
9,6,5,1359,502,563,1065,"6 de julio de 1997"
9,6,5,1360,521,565,1086,"6 de julio de 1997"
9,6,5,1361,609,658,1267,"6 de julio de 1997"
9,6,5,1362,576,630,1206,"6 de julio de 1997"
9,6,5,1363,498,521,1019,"6 de julio de 1997"
9,6,5,1364,533,544,1077,"6 de julio de 1997"
9,6,5,1365,621,638,1259,"6 de julio de 1997"
9,6,5,1366,575,631,1206,"6 de julio de 1997"
9,6,5,1367,645,688,1333,"6 de julio de 1997"
9,6,5,1368,467,506,973,"6 de julio de 1997"
9,6,5,1369,612,650,1262,"6 de julio de 1997"
9,6,5,1370,543,599,1142,"6 de julio de 1997"
9,6,5,1371,784,788,1572,"6 de julio de 1997"
9,6,5,1372,514,546,1060,"6 de julio de 1997"
9,6,5,1373,534,585,1119,"6 de julio de 1997"
9,6,5,1374,542,601,1143,"6 de julio de 1997"
9,6,5,1375,600,653,1253,"6 de julio de 1997"
9,6,5,1376,572,640,1212,"6 de julio de 1997"
9,6,5,1377,695,770,1465,"6 de julio de 1997"
9,6,5,1378,484,558,1042,"6 de julio de 1997"
9,6,5,1379,482,513,995,"6 de julio de 1997"
9,6,5,1380,489,545,1034,"6 de julio de 1997"
9,6,5,1381,535,611,1146,"6 de julio de 1997"
9,6,5,1382,378,424,802,"6 de julio de 1997"
9,6,5,1383,634,664,1298,"6 de julio de 1997"
9,6,5,1384,671,656,1327,"6 de julio de 1997"
9,6,5,1385,779,891,1670,"6 de julio de 1997"
9,6,5,1386,444,555,999,"6 de julio de 1997"
9,6,5,1387,453,487,940,"6 de julio de 1997"
9,6,5,1388,461,489,950,"6 de julio de 1997"
9,6,5,1389,503,541,1044,"6 de julio de 1997"
9,6,5,1390,494,554,1048,"6 de julio de 1997"
9,6,5,1391,521,578,1099,"6 de julio de 1997"
9,6,5,1392,506,558,1064,"6 de julio de 1997"
9,6,5,1393,478,546,1024,"6 de julio de 1997"
9,6,5,1394,555,601,1156,"6 de julio de 1997"
9,6,5,1395,697,729,1426,"6 de julio de 1997"
9,6,5,1396,513,504,1017,"6 de julio de 1997"
9,6,5,1397,627,647,1274,"6 de julio de 1997"
9,6,5,1398,519,604,1123,"6 de julio de 1997"
9,6,5,1399,559,620,1179,"6 de julio de 1997"
9,6,5,1400,585,546,1131,"6 de julio de 1997"
9,6,5,1401,683,783,1466,"6 de julio de 1997"
9,6,5,1402,532,574,1106,"6 de julio de 1997"
9,6,5,1403,629,693,1322,"6 de julio de 1997"
9,6,5,1404,563,630,1193,"6 de julio de 1997"
9,6,5,1405,520,529,1049,"6 de julio de 1997"
9,6,5,1406,628,708,1336,"6 de julio de 1997"
9,6,5,1407,517,590,1107,"6 de julio de 1997"
9,6,5,1408,462,473,935,"6 de julio de 1997"
9,6,5,1409,554,642,1196,"6 de julio de 1997"
9,6,5,1410,635,699,1334,"6 de julio de 1997"
9,6,5,1411,662,704,1366,"6 de julio de 1997"
9,6,5,1412,471,545,1016,"6 de julio de 1997"
9,6,5,1413,568,646,1214,"6 de julio de 1997"
9,6,5,1414,495,544,1039,"6 de julio de 1997"
9,6,5,1415,472,530,1002,"6 de julio de 1997"
9,6,5,1416,571,607,1178,"6 de julio de 1997"
9,6,5,1417,506,566,1072,"6 de julio de 1997"
9,6,5,1418,572,627,1199,"6 de julio de 1997"
9,6,5,1419,596,683,1279,"6 de julio de 1997"
9,6,5,1420,542,645,1187,"6 de julio de 1997"
9,6,5,1421,659,732,1391,"6 de julio de 1997"
9,6,5,1422,556,665,1221,"6 de julio de 1997"
9,6,5,1423,692,753,1445,"6 de julio de 1997"
9,6,5,1424,458,476,934,"6 de julio de 1997"
9,6,5,1425,711,826,1537,"6 de julio de 1997"
9,6,5,1426,615,682,1297,"6 de julio de 1997"
9,6,5,1427,583,646,1229,"6 de julio de 1997"
9,6,5,1428,528,607,1135,"6 de julio de 1997"
9,6,5,1429,586,638,1224,"6 de julio de 1997"
9,6,5,1430,725,753,1478,"6 de julio de 1997"
9,6,5,1431,771,863,1634,"6 de julio de 1997"
9,6,5,1432,658,738,1396,"6 de julio de 1997"
9,6,5,1433,637,703,1340,"6 de julio de 1997"
9,6,5,1434,817,829,1646,"6 de julio de 1997"
9,6,5,1435,739,756,1495,"6 de julio de 1997"
9,6,5,1436,391,450,841,"6 de julio de 1997"
9,6,5,1437,597,705,1302,"6 de julio de 1997"
9,6,5,1438,511,530,1041,"6 de julio de 1997"
9,6,5,1439,563,548,1111,"6 de julio de 1997"
9,6,5,1440,716,815,1531,"6 de julio de 1997"
9,6,5,1441,646,687,1333,"6 de julio de 1997"
9,6,5,1442,778,816,1594,"6 de julio de 1997"
9,6,5,1443,748,789,1537,"6 de julio de 1997"
9,6,5,1444,459,547,1006,"6 de julio de 1997"
9,6,5,1445,469,521,990,"6 de julio de 1997"
9,6,5,1446,424,505,929,"6 de julio de 1997"
9,6,5,1447,516,554,1070,"6 de julio de 1997"
9,6,5,1448,464,513,977,"6 de julio de 1997"
9,6,5,1449,537,576,1113,"6 de julio de 1997"
9,6,5,1450,227,215,442,"6 de julio de 1997"
9,6,5,1496,693,741,1434,"6 de julio de 1997"
9,6,5,1497,604,662,1266,"6 de julio de 1997"
9,6,5,1498,480,528,1008,"6 de julio de 1997"
9,6,5,1499,662,727,1389,"6 de julio de 1997"
9,6,5,1500,669,780,1449,"6 de julio de 1997"
9,6,5,1501,297,341,638,"6 de julio de 1997"
9,6,5,1502,573,675,1248,"6 de julio de 1997"
9,6,5,1503,508,536,1044,"6 de julio de 1997"
9,6,5,1504,584,698,1282,"6 de julio de 1997"
9,6,5,1505,469,540,1009,"6 de julio de 1997"
9,6,5,1506,415,459,874,"6 de julio de 1997"
9,6,5,1507,537,567,1104,"6 de julio de 1997"
9,6,5,1517,498,575,1073,"6 de julio de 1997"
9,6,5,1518,633,686,1319,"6 de julio de 1997"
9,6,5,1519,563,660,1223,"6 de julio de 1997"
9,6,5,1520,489,559,1048,"6 de julio de 1997"
9,6,5,1521,621,687,1308,"6 de julio de 1997"
9,6,5,1522,590,632,1222,"6 de julio de 1997"
9,6,5,1523,618,637,1255,"6 de julio de 1997"
9,6,5,1524,385,457,842,"6 de julio de 1997"
9,6,5,1525,644,675,1319,"6 de julio de 1997"
9,6,5,1526,446,475,921,"6 de julio de 1997"
9,6,5,1527,524,563,1087,"6 de julio de 1997"
9,6,5,1528,510,583,1093,"6 de julio de 1997"
9,6,5,1536,593,648,1241,"6 de julio de 1997"
9,6,5,1544,631,700,1331,"6 de julio de 1997"
9,6,5,1545,412,491,903,"6 de julio de 1997"
9,6,5,1546,455,542,997,"6 de julio de 1997"
9,6,5,1547,370,428,798,"6 de julio de 1997"
9,6,5,1557,348,398,746,"6 de julio de 1997"
9,6,5,1558,275,355,630,"6 de julio de 1997"
9,6,5,1570,556,621,1177,"6 de julio de 1997"
9,6,5,1571,380,480,860,"6 de julio de 1997"
9,6,5,1572,409,443,852,"6 de julio de 1997"
9,6,5,1573,470,514,984,"6 de julio de 1997"
9,6,5,1574,541,603,1144,"6 de julio de 1997"
9,6,5,1575,419,429,848,"6 de julio de 1997"
9,6,5,1576,531,566,1097,"6 de julio de 1997"
9,6,5,1577,631,633,1264,"6 de julio de 1997"
9,6,5,1578,759,836,1595,"6 de julio de 1997"
9,6,5,1579,724,713,1437,"6 de julio de 1997"
9,6,5,1580,394,423,817,"6 de julio de 1997"
9,6,5,1581,621,656,1277,"6 de julio de 1997"
9,6,5,1585,423,443,866,"6 de julio de 1997"
9,6,5,1586,402,465,867,"6 de julio de 1997"
9,6,5,1588,401,424,825,"6 de julio de 1997"
9,6,5,5537,463,543,1006,"6 de julio de 1997"
9,6,5,5538,624,631,1255,"6 de julio de 1997"
9,6,5,5539,516,577,1093,"6 de julio de 1997"
9,6,5,5540,525,569,1094,"6 de julio de 1997"
9,6,5,5541,526,561,1087,"6 de julio de 1997"
9,6,5,5542,544,590,1134,"6 de julio de 1997"
9,6,5,5543,533,625,1158,"6 de julio de 1997"
9,7,5,1148,492,575,1067,"6 de julio de 1997"
9,7,5,1149,483,539,1022,"6 de julio de 1997"
9,7,5,1150,542,581,1123,"6 de julio de 1997"
9,7,5,1151,507,576,1083,"6 de julio de 1997"
9,7,5,1152,544,620,1164,"6 de julio de 1997"
9,7,5,1153,515,594,1109,"6 de julio de 1997"
9,7,5,1154,569,619,1188,"6 de julio de 1997"
9,7,5,1155,496,577,1073,"6 de julio de 1997"
9,7,5,1156,512,545,1057,"6 de julio de 1997"
9,7,5,1157,439,450,889,"6 de julio de 1997"
9,7,5,1158,523,597,1120,"6 de julio de 1997"
9,7,5,1159,509,560,1069,"6 de julio de 1997"
9,7,5,1160,571,623,1194,"6 de julio de 1997"
9,7,5,1161,425,513,938,"6 de julio de 1997"
9,7,5,1162,572,618,1190,"6 de julio de 1997"
9,7,5,1163,468,565,1033,"6 de julio de 1997"
9,7,5,1164,418,433,851,"6 de julio de 1997"
9,7,5,1165,604,645,1249,"6 de julio de 1997"
9,7,5,1166,535,614,1149,"6 de julio de 1997"
9,7,5,1167,413,498,911,"6 de julio de 1997"
9,7,5,1168,511,607,1118,"6 de julio de 1997"
9,7,5,1169,476,564,1040,"6 de julio de 1997"
9,7,5,1170,590,624,1214,"6 de julio de 1997"
9,7,5,1171,506,548,1054,"6 de julio de 1997"
9,7,5,1172,420,441,861,"6 de julio de 1997"
9,7,5,1173,424,508,932,"6 de julio de 1997"
9,7,5,1174,459,501,960,"6 de julio de 1997"
9,7,5,1175,433,454,887,"6 de julio de 1997"
9,7,5,1176,530,559,1089,"6 de julio de 1997"
9,7,5,1177,583,641,1224,"6 de julio de 1997"
9,7,5,1178,541,604,1145,"6 de julio de 1997"
9,7,5,1179,596,642,1238,"6 de julio de 1997"
9,7,5,1180,544,548,1092,"6 de julio de 1997"
9,7,5,1181,596,707,1303,"6 de julio de 1997"
9,7,5,1182,477,579,1056,"6 de julio de 1997"
9,7,5,1183,545,650,1195,"6 de julio de 1997"
9,7,5,1184,622,693,1315,"6 de julio de 1997"
9,7,5,1185,599,648,1247,"6 de julio de 1997"
9,7,5,1186,557,589,1146,"6 de julio de 1997"
9,7,5,1187,471,560,1031,"6 de julio de 1997"
9,7,5,1188,490,527,1017,"6 de julio de 1997"
9,7,5,1189,533,622,1155,"6 de julio de 1997"
9,7,5,1190,523,575,1098,"6 de julio de 1997"
9,7,5,1191,487,541,1028,"6 de julio de 1997"
9,7,5,1192,387,456,843,"6 de julio de 1997"
9,7,5,1193,324,354,678,"6 de julio de 1997"
9,7,5,1194,484,543,1027,"6 de julio de 1997"
9,7,5,1195,548,617,1165,"6 de julio de 1997"
9,7,5,1196,421,515,936,"6 de julio de 1997"
9,7,5,1197,454,507,961,"6 de julio de 1997"
9,7,5,1198,643,734,1377,"6 de julio de 1997"
9,7,5,1199,509,598,1107,"6 de julio de 1997"
9,7,5,1200,521,551,1072,"6 de julio de 1997"
9,7,5,1201,654,750,1404,"6 de julio de 1997"
9,7,5,1202,511,602,1113,"6 de julio de 1997"
9,7,5,1203,530,550,1080,"6 de julio de 1997"
9,7,5,1204,582,623,1205,"6 de julio de 1997"
9,7,5,1205,516,560,1076,"6 de julio de 1997"
9,7,5,1206,396,465,861,"6 de julio de 1997"
9,7,5,1207,423,489,912,"6 de julio de 1997"
9,7,5,1208,497,587,1084,"6 de julio de 1997"
9,7,5,1209,511,570,1081,"6 de julio de 1997"
9,7,5,1210,599,668,1267,"6 de julio de 1997"
9,7,5,1211,424,529,953,"6 de julio de 1997"
9,7,5,1212,573,636,1209,"6 de julio de 1997"
9,7,5,1213,494,592,1086,"6 de julio de 1997"
9,7,5,1548,482,549,1031,"6 de julio de 1997"
9,7,5,1549,486,529,1015,"6 de julio de 1997"
9,7,5,1550,456,482,938,"6 de julio de 1997"
9,7,5,1551,416,447,863,"6 de julio de 1997"
9,7,5,1552,870,994,1864,"6 de julio de 1997"
9,7,5,1553,375,407,782,"6 de julio de 1997"
9,7,5,1554,404,479,883,"6 de julio de 1997"
9,7,5,1555,505,578,1083,"6 de julio de 1997"
9,7,5,1556,571,621,1192,"6 de julio de 1997"
9,7,5,1559,257,259,516,"6 de julio de 1997"
9,7,5,1560,592,615,1207,"6 de julio de 1997"
9,7,5,1561,445,502,947,"6 de julio de 1997"
9,7,5,1562,461,484,945,"6 de julio de 1997"
9,7,5,1563,506,570,1076,"6 de julio de 1997"
9,7,5,1564,599,678,1277,"6 de julio de 1997"
9,7,5,1565,578,675,1253,"6 de julio de 1997"
9,7,5,1566,480,582,1062,"6 de julio de 1997"
9,7,5,1567,416,486,902,"6 de julio de 1997"
9,7,5,1568,521,637,1158,"6 de julio de 1997"
9,7,5,1569,772,850,1622,"6 de julio de 1997"
9,7,5,1582,502,508,1010,"6 de julio de 1997"
9,7,5,1583,660,700,1360,"6 de julio de 1997"
9,7,5,1584,877,915,1792,"6 de julio de 1997"
9,7,5,1589,768,824,1592,"6 de julio de 1997"
9,7,5,1590,402,439,841,"6 de julio de 1997"
9,7,5,1591,709,822,1531,"6 de julio de 1997"
9,7,5,1592,704,753,1457,"6 de julio de 1997"
9,7,5,1593,532,596,1128,"6 de julio de 1997"
9,7,5,1594,557,660,1217,"6 de julio de 1997"
9,7,5,1595,563,655,1218,"6 de julio de 1997"
9,7,5,1596,674,717,1391,"6 de julio de 1997"
9,7,5,1597,561,618,1179,"6 de julio de 1997"
9,7,5,1598,558,649,1207,"6 de julio de 1997"
9,7,5,1599,422,459,881,"6 de julio de 1997"
9,7,5,1600,492,549,1041,"6 de julio de 1997"
9,7,5,1601,447,542,989,"6 de julio de 1997"
9,7,5,1602,728,850,1578,"6 de julio de 1997"
9,7,5,1603,485,518,1003,"6 de julio de 1997"
9,7,5,1604,752,860,1612,"6 de julio de 1997"
9,7,5,1605,645,730,1375,"6 de julio de 1997"
9,7,5,1606,589,659,1248,"6 de julio de 1997"
9,7,5,1607,526,553,1079,"6 de julio de 1997"
9,7,5,1608,675,792,1467,"6 de julio de 1997"
9,7,5,1609,616,714,1330,"6 de julio de 1997"
9,7,5,1610,649,731,1380,"6 de julio de 1997"
9,7,5,1611,643,744,1387,"6 de julio de 1997"
9,7,5,1612,597,730,1327,"6 de julio de 1997"
9,7,5,1613,641,677,1318,"6 de julio de 1997"
9,7,5,1614,736,878,1614,"6 de julio de 1997"
9,7,5,1615,718,817,1535,"6 de julio de 1997"
9,7,5,1616,563,579,1142,"6 de julio de 1997"
9,7,5,1617,355,404,759,"6 de julio de 1997"
9,7,5,1618,619,694,1313,"6 de julio de 1997"
9,7,5,1619,662,722,1384,"6 de julio de 1997"
9,7,5,1620,503,567,1070,"6 de julio de 1997"
9,7,5,1621,649,714,1363,"6 de julio de 1997"
9,7,5,1622,617,679,1296,"6 de julio de 1997"
9,7,5,1623,556,640,1196,"6 de julio de 1997"
9,7,5,1624,590,620,1210,"6 de julio de 1997"
9,7,5,1625,603,645,1248,"6 de julio de 1997"
9,7,5,1626,626,724,1350,"6 de julio de 1997"
9,7,5,1627,618,692,1310,"6 de julio de 1997"
9,7,5,1628,536,602,1138,"6 de julio de 1997"
9,7,5,1629,623,670,1293,"6 de julio de 1997"
9,7,5,1630,495,580,1075,"6 de julio de 1997"
9,7,5,1631,727,770,1497,"6 de julio de 1997"
9,7,5,1632,717,812,1529,"6 de julio de 1997"
9,7,5,1633,639,693,1332,"6 de julio de 1997"
9,7,5,1634,526,594,1120,"6 de julio de 1997"
9,7,5,1635,658,763,1421,"6 de julio de 1997"
9,7,5,1636,625,684,1309,"6 de julio de 1997"
9,7,5,1637,673,750,1423,"6 de julio de 1997"
9,7,5,1638,559,654,1213,"6 de julio de 1997"
9,7,5,1639,497,555,1052,"6 de julio de 1997"
9,7,5,1640,431,530,961,"6 de julio de 1997"
9,7,5,1641,643,663,1306,"6 de julio de 1997"
9,7,5,1642,491,530,1021,"6 de julio de 1997"
9,7,5,1643,539,592,1131,"6 de julio de 1997"
9,7,5,1644,591,676,1267,"6 de julio de 1997"
9,7,5,1645,412,522,934,"6 de julio de 1997"
9,7,5,1646,436,520,956,"6 de julio de 1997"
9,7,5,1647,605,648,1253,"6 de julio de 1997"
9,7,5,1648,571,680,1251,"6 de julio de 1997"
9,7,5,1649,540,526,1066,"6 de julio de 1997"
9,7,5,1650,405,488,893,"6 de julio de 1997"
9,7,5,1651,605,627,1232,"6 de julio de 1997"
9,7,5,1652,646,670,1316,"6 de julio de 1997"
9,7,5,1653,454,504,958,"6 de julio de 1997"
9,7,5,1654,669,719,1388,"6 de julio de 1997"
9,7,5,1655,619,641,1260,"6 de julio de 1997"
9,7,5,1656,593,671,1264,"6 de julio de 1997"
9,7,5,1657,621,670,1291,"6 de julio de 1997"
9,7,5,1658,422,467,889,"6 de julio de 1997"
9,7,5,1659,605,604,1209,"6 de julio de 1997"
9,7,5,1660,489,566,1055,"6 de julio de 1997"
9,7,5,1661,519,574,1093,"6 de julio de 1997"
9,7,5,1662,429,434,863,"6 de julio de 1997"
9,7,5,1663,326,357,683,"6 de julio de 1997"
9,7,5,1664,366,427,793,"6 de julio de 1997"
9,7,5,1665,352,396,748,"6 de julio de 1997"
9,7,5,1666,540,640,1180,"6 de julio de 1997"
9,7,5,1667,531,599,1130,"6 de julio de 1997"
9,7,5,1668,389,410,799,"6 de julio de 1997"
9,7,5,1669,423,479,902,"6 de julio de 1997"
9,7,5,1670,337,373,710,"6 de julio de 1997"
9,7,5,1671,397,462,859,"6 de julio de 1997"
9,8,15,4586,363,483,846,"6 de julio de 1997"
9,8,15,4587,250,263,513,"6 de julio de 1997"
9,8,15,4588,629,739,1368,"6 de julio de 1997"
9,8,15,4589,609,679,1288,"6 de julio de 1997"
9,8,15,4590,528,588,1116,"6 de julio de 1997"
9,8,15,4591,629,640,1269,"6 de julio de 1997"
9,8,15,4592,274,346,620,"6 de julio de 1997"
9,8,15,4593,676,753,1429,"6 de julio de 1997"
9,8,15,4594,460,574,1034,"6 de julio de 1997"
9,8,15,4595,634,765,1399,"6 de julio de 1997"
9,8,15,4596,588,707,1295,"6 de julio de 1997"
9,8,15,4597,597,745,1342,"6 de julio de 1997"
9,8,15,4598,431,537,968,"6 de julio de 1997"
9,8,15,4599,488,642,1130,"6 de julio de 1997"
9,8,15,4600,448,497,945,"6 de julio de 1997"
9,8,15,4601,423,584,1007,"6 de julio de 1997"
9,8,15,4602,516,660,1176,"6 de julio de 1997"
9,8,15,4603,367,457,824,"6 de julio de 1997"
9,8,15,4604,536,685,1221,"6 de julio de 1997"
9,8,15,4605,591,666,1257,"6 de julio de 1997"
9,8,15,4606,646,824,1470,"6 de julio de 1997"
9,8,15,4607,522,646,1168,"6 de julio de 1997"
9,8,15,4608,503,651,1154,"6 de julio de 1997"
9,8,15,4609,724,830,1554,"6 de julio de 1997"
9,8,15,4610,516,656,1172,"6 de julio de 1997"
9,8,15,4611,534,679,1213,"6 de julio de 1997"
9,8,15,4612,647,749,1396,"6 de julio de 1997"
9,8,15,4613,576,692,1268,"6 de julio de 1997"
9,8,15,4614,632,690,1322,"6 de julio de 1997"
9,8,15,4615,499,577,1076,"6 de julio de 1997"
9,8,15,4616,566,682,1248,"6 de julio de 1997"
9,8,15,4617,609,740,1349,"6 de julio de 1997"
9,8,15,4618,619,742,1361,"6 de julio de 1997"
9,8,15,4619,531,598,1129,"6 de julio de 1997"
9,8,15,4620,583,660,1243,"6 de julio de 1997"
9,8,15,4621,726,840,1566,"6 de julio de 1997"
9,8,15,4622,660,742,1402,"6 de julio de 1997"
9,8,15,4623,522,671,1193,"6 de julio de 1997"
9,8,15,4624,499,558,1057,"6 de julio de 1997"
9,8,15,4625,579,766,1345,"6 de julio de 1997"
9,8,15,4626,497,628,1125,"6 de julio de 1997"
9,8,15,4627,495,621,1116,"6 de julio de 1997"
9,8,15,4628,512,695,1207,"6 de julio de 1997"
9,8,15,4630,292,389,681,"6 de julio de 1997"
9,8,15,4633,611,593,1204,"6 de julio de 1997"
9,8,15,4634,565,673,1238,"6 de julio de 1997"
9,8,15,4635,681,788,1469,"6 de julio de 1997"
9,8,15,4636,651,699,1350,"6 de julio de 1997"
9,8,15,4637,799,741,1540,"6 de julio de 1997"
9,8,15,4638,355,422,777,"6 de julio de 1997"
9,8,15,4646,426,485,911,"6 de julio de 1997"
9,8,15,4647,429,489,918,"6 de julio de 1997"
9,8,15,4648,326,385,711,"6 de julio de 1997"
9,8,15,4649,371,409,780,"6 de julio de 1997"
9,8,15,4650,258,264,522,"6 de julio de 1997"
9,8,15,4651,279,295,574,"6 de julio de 1997"
9,8,15,4653,226,240,466,"6 de julio de 1997"
9,8,15,4654,602,708,1310,"6 de julio de 1997"
9,8,15,4655,669,738,1407,"6 de julio de 1997"
9,8,15,4656,727,811,1538,"6 de julio de 1997"
9,8,15,4657,638,707,1345,"6 de julio de 1997"
9,8,15,4658,744,846,1590,"6 de julio de 1997"
9,8,15,4659,654,822,1476,"6 de julio de 1997"
9,8,15,4660,560,639,1199,"6 de julio de 1997"
9,8,15,4661,601,643,1244,"6 de julio de 1997"
9,8,15,4662,719,942,1661,"6 de julio de 1997"
9,8,15,4663,700,776,1476,"6 de julio de 1997"
9,8,15,4664,657,789,1446,"6 de julio de 1997"
9,8,15,4665,478,546,1024,"6 de julio de 1997"
9,8,15,4666,634,701,1335,"6 de julio de 1997"
9,8,15,4667,588,612,1200,"6 de julio de 1997"
9,8,15,4668,694,718,1412,"6 de julio de 1997"
9,8,15,4669,696,830,1526,"6 de julio de 1997"
9,8,15,4670,258,323,581,"6 de julio de 1997"
9,8,15,4671,477,622,1099,"6 de julio de 1997"
9,8,15,4672,615,735,1350,"6 de julio de 1997"
9,8,15,4673,498,626,1124,"6 de julio de 1997"
9,8,15,4674,305,385,690,"6 de julio de 1997"
9,8,15,4675,276,329,605,"6 de julio de 1997"
9,8,15,4676,424,531,955,"6 de julio de 1997"
9,8,15,4677,540,657,1197,"6 de julio de 1997"
9,8,15,4678,213,245,458,"6 de julio de 1997"
9,8,15,4679,459,505,964,"6 de julio de 1997"
9,8,15,4680,663,749,1412,"6 de julio de 1997"
9,8,15,4681,189,190,379,"6 de julio de 1997"
9,8,15,4682,521,549,1070,"6 de julio de 1997"
9,8,15,4683,579,639,1218,"6 de julio de 1997"
9,8,15,4684,422,473,895,"6 de julio de 1997"
9,8,15,4685,484,536,1020,"6 de julio de 1997"
9,8,15,4686,461,539,1000,"6 de julio de 1997"
9,8,15,4687,684,827,1511,"6 de julio de 1997"
9,8,15,4688,427,494,921,"6 de julio de 1997"
9,8,15,4689,453,515,968,"6 de julio de 1997"
9,8,15,4690,528,627,1155,"6 de julio de 1997"
9,8,15,4691,738,782,1520,"6 de julio de 1997"
9,8,15,4692,599,632,1231,"6 de julio de 1997"
9,8,15,4693,641,729,1370,"6 de julio de 1997"
9,8,15,4694,606,734,1340,"6 de julio de 1997"
9,8,15,4695,440,476,916,"6 de julio de 1997"
9,8,15,4696,625,691,1316,"6 de julio de 1997"
9,8,15,4697,473,509,982,"6 de julio de 1997"
9,8,15,4698,605,651,1256,"6 de julio de 1997"
9,8,15,4699,625,715,1340,"6 de julio de 1997"
9,8,15,4700,726,770,1496,"6 de julio de 1997"
9,8,15,4701,397,463,860,"6 de julio de 1997"
9,8,15,4702,690,726,1416,"6 de julio de 1997"
9,8,15,4703,511,517,1028,"6 de julio de 1997"
9,8,15,4704,691,659,1350,"6 de julio de 1997"
9,8,15,4705,495,561,1056,"6 de julio de 1997"
9,8,15,4706,257,295,552,"6 de julio de 1997"
9,8,15,4707,522,571,1093,"6 de julio de 1997"
9,8,15,4708,663,693,1356,"6 de julio de 1997"
9,8,15,4709,762,740,1502,"6 de julio de 1997"
9,8,15,4710,670,756,1426,"6 de julio de 1997"
9,8,15,4711,632,636,1268,"6 de julio de 1997"
9,8,15,4712,403,489,892,"6 de julio de 1997"
9,8,15,4713,309,373,682,"6 de julio de 1997"
9,8,15,4714,420,460,880,"6 de julio de 1997"
9,8,15,4715,278,284,562,"6 de julio de 1997"
9,8,15,4716,375,417,792,"6 de julio de 1997"
9,8,15,4717,505,629,1134,"6 de julio de 1997"
9,8,15,4718,286,285,571,"6 de julio de 1997"
9,8,15,4719,251,298,549,"6 de julio de 1997"
9,8,15,4720,374,417,791,"6 de julio de 1997"
9,8,15,4721,349,334,683,"6 de julio de 1997"
9,8,15,4722,403,431,834,"6 de julio de 1997"
9,8,15,4723,329,346,675,"6 de julio de 1997"
9,8,15,4724,545,602,1147,"6 de julio de 1997"
9,8,15,4725,450,528,978,"6 de julio de 1997"
9,8,15,4726,252,296,548,"6 de julio de 1997"
9,8,15,4727,664,676,1340,"6 de julio de 1997"
9,8,15,4728,465,471,936,"6 de julio de 1997"
9,8,15,4729,501,524,1025,"6 de julio de 1997"
9,8,15,4730,525,489,1014,"6 de julio de 1997"
9,8,15,4731,743,828,1571,"6 de julio de 1997"
9,8,15,4732,647,644,1291,"6 de julio de 1997"
9,8,15,4733,518,522,1040,"6 de julio de 1997"
9,8,15,4734,646,739,1385,"6 de julio de 1997"
9,8,15,4735,631,681,1312,"6 de julio de 1997"
9,8,15,4736,630,696,1326,"6 de julio de 1997"
9,8,15,4737,788,801,1589,"6 de julio de 1997"
9,8,15,4738,688,706,1394,"6 de julio de 1997"
9,8,15,4739,547,620,1167,"6 de julio de 1997"
9,8,15,4740,518,560,1078,"6 de julio de 1997"
9,8,15,4741,605,614,1219,"6 de julio de 1997"
9,8,15,4742,512,550,1062,"6 de julio de 1997"
9,8,15,4743,593,670,1263,"6 de julio de 1997"
9,8,15,4744,483,514,997,"6 de julio de 1997"
9,8,15,4745,521,511,1032,"6 de julio de 1997"
9,8,15,4746,493,533,1026,"6 de julio de 1997"
9,8,15,4747,397,398,795,"6 de julio de 1997"
9,8,15,4748,629,487,1116,"6 de julio de 1997"
9,8,15,4749,402,379,781,"6 de julio de 1997"
9,8,15,4750,483,533,1016,"6 de julio de 1997"
9,8,15,4751,657,696,1353,"6 de julio de 1997"
9,8,15,4752,568,544,1112,"6 de julio de 1997"
9,8,15,4753,699,678,1377,"6 de julio de 1997"
9,8,15,4754,773,750,1523,"6 de julio de 1997"
9,8,15,4755,542,549,1091,"6 de julio de 1997"
9,8,15,4756,483,520,1003,"6 de julio de 1997"
9,8,15,4757,539,613,1152,"6 de julio de 1997"
9,8,15,4758,513,472,985,"6 de julio de 1997"
9,8,15,4759,378,463,841,"6 de julio de 1997"
9,8,15,4821,429,503,932,"6 de julio de 1997"
9,8,15,4822,769,900,1669,"6 de julio de 1997"
9,8,15,4823,682,772,1454,"6 de julio de 1997"
9,8,15,4824,450,464,914,"6 de julio de 1997"
9,8,15,4825,469,542,1011,"6 de julio de 1997"
9,8,15,4826,656,777,1433,"6 de julio de 1997"
9,8,15,4827,743,890,1633,"6 de julio de 1997"
9,8,15,4828,654,672,1326,"6 de julio de 1997"
9,8,15,4829,385,461,846,"6 de julio de 1997"
9,8,15,4830,373,398,771,"6 de julio de 1997"
9,8,15,4837,291,295,586,"6 de julio de 1997"
9,8,15,4838,381,335,716,"6 de julio de 1997"
9,8,15,4839,424,460,884,"6 de julio de 1997"
9,8,15,4840,590,546,1136,"6 de julio de 1997"
9,8,15,4841,521,566,1087,"6 de julio de 1997"
9,8,15,4842,471,514,985,"6 de julio de 1997"
9,8,15,4843,546,614,1160,"6 de julio de 1997"
9,8,15,4844,535,599,1134,"6 de julio de 1997"
9,8,15,4845,501,535,1036,"6 de julio de 1997"
9,8,15,4846,542,609,1151,"6 de julio de 1997"
9,8,15,4847,295,322,617,"6 de julio de 1997"
9,8,15,4848,551,552,1103,"6 de julio de 1997"
9,8,15,4849,413,423,836,"6 de julio de 1997"
9,8,15,4850,753,776,1529,"6 de julio de 1997"
9,8,15,4851,625,665,1290,"6 de julio de 1997"
9,8,15,4866,406,464,870,"6 de julio de 1997"
9,8,15,4867,441,479,920,"6 de julio de 1997"
9,8,15,4868,378,395,773,"6 de julio de 1997"
9,8,15,4869,457,523,980,"6 de julio de 1997"
9,8,15,4887,211,197,408,"6 de julio de 1997"
9,8,15,4888,461,411,872,"6 de julio de 1997"
9,8,15,4890,242,241,483,"6 de julio de 1997"
9,9,17,5183,564,631,1195,"6 de julio de 1997"
9,9,17,5184,618,634,1252,"6 de julio de 1997"
9,9,17,5185,580,572,1152,"6 de julio de 1997"
9,9,17,5186,651,744,1395,"6 de julio de 1997"
9,9,17,5187,573,703,1276,"6 de julio de 1997"
9,9,17,5188,134,169,303,"6 de julio de 1997"
9,9,17,5189,623,696,1319,"6 de julio de 1997"
9,9,17,5190,491,573,1064,"6 de julio de 1997"
9,9,17,5191,475,558,1033,"6 de julio de 1997"
9,9,17,5192,519,581,1100,"6 de julio de 1997"
9,9,17,5193,570,590,1160,"6 de julio de 1997"
9,9,17,5194,349,393,742,"6 de julio de 1997"
9,9,17,5195,559,661,1220,"6 de julio de 1997"
9,9,17,5196,659,755,1414,"6 de julio de 1997"
9,9,17,5197,673,750,1423,"6 de julio de 1997"
9,9,17,5198,481,554,1035,"6 de julio de 1997"
9,9,17,5199,636,745,1381,"6 de julio de 1997"
9,9,17,5200,526,676,1202,"6 de julio de 1997"
9,9,17,5201,647,731,1378,"6 de julio de 1997"
9,9,17,5202,680,715,1395,"6 de julio de 1997"
9,9,17,5203,290,365,655,"6 de julio de 1997"
9,9,17,5204,505,653,1158,"6 de julio de 1997"
9,9,17,5205,547,667,1214,"6 de julio de 1997"
9,9,17,5206,442,475,917,"6 de julio de 1997"
9,9,17,5207,424,482,906,"6 de julio de 1997"
9,9,17,5208,465,510,975,"6 de julio de 1997"
9,9,17,5209,794,833,1627,"6 de julio de 1997"
9,9,17,5210,541,549,1090,"6 de julio de 1997"
9,9,17,5211,532,517,1049,"6 de julio de 1997"
9,9,17,5212,363,382,745,"6 de julio de 1997"
9,9,17,5213,657,714,1371,"6 de julio de 1997"
9,9,17,5214,297,366,663,"6 de julio de 1997"
9,9,17,5215,547,622,1169,"6 de julio de 1997"
9,9,17,5216,509,601,1110,"6 de julio de 1997"
9,9,17,5217,551,585,1136,"6 de julio de 1997"
9,9,17,5218,716,746,1462,"6 de julio de 1997"
9,9,17,5219,686,777,1463,"6 de julio de 1997"
9,9,17,5220,514,589,1103,"6 de julio de 1997"
9,9,17,5221,604,667,1271,"6 de julio de 1997"
9,9,17,5222,390,421,811,"6 de julio de 1997"
9,9,17,5223,514,583,1097,"6 de julio de 1997"
9,9,17,5224,778,827,1605,"6 de julio de 1997"
9,9,17,5225,563,617,1180,"6 de julio de 1997"
9,9,17,5226,751,823,1574,"6 de julio de 1997"
9,9,17,5227,587,589,1176,"6 de julio de 1997"
9,9,17,5228,575,632,1207,"6 de julio de 1997"
9,9,17,5229,747,826,1573,"6 de julio de 1997"
9,9,17,5230,652,685,1337,"6 de julio de 1997"
9,9,17,5231,613,626,1239,"6 de julio de 1997"
9,9,17,5232,693,756,1449,"6 de julio de 1997"
9,9,17,5233,472,541,1013,"6 de julio de 1997"
9,9,17,5234,593,635,1228,"6 de julio de 1997"
9,9,17,5235,520,513,1033,"6 de julio de 1997"
9,9,17,5236,629,664,1293,"6 de julio de 1997"
9,9,17,5237,606,662,1268,"6 de julio de 1997"
9,9,17,5238,477,516,993,"6 de julio de 1997"
9,9,17,5239,473,503,976,"6 de julio de 1997"
9,9,17,5240,343,368,711,"6 de julio de 1997"
9,9,17,5241,405,440,845,"6 de julio de 1997"
9,9,17,5242,312,359,671,"6 de julio de 1997"
9,9,17,5243,595,708,1303,"6 de julio de 1997"
9,9,17,5244,334,370,704,"6 de julio de 1997"
9,9,17,5245,389,465,854,"6 de julio de 1997"
9,9,17,5246,499,550,1049,"6 de julio de 1997"
9,9,17,5247,365,411,776,"6 de julio de 1997"
9,9,17,5248,246,263,509,"6 de julio de 1997"
9,9,17,5249,580,619,1199,"6 de julio de 1997"
9,9,17,5250,633,650,1283,"6 de julio de 1997"
9,9,17,5251,476,465,941,"6 de julio de 1997"
9,9,17,5252,431,461,892,"6 de julio de 1997"
9,9,17,5253,717,758,1475,"6 de julio de 1997"
9,9,17,5254,555,577,1132,"6 de julio de 1997"
9,9,17,5255,460,540,1000,"6 de julio de 1997"
9,9,17,5256,545,550,1095,"6 de julio de 1997"
9,9,17,5257,502,620,1122,"6 de julio de 1997"
9,9,17,5258,562,584,1146,"6 de julio de 1997"
9,9,17,5259,569,646,1215,"6 de julio de 1997"
9,9,17,5260,538,512,1050,"6 de julio de 1997"
9,9,17,5261,483,513,996,"6 de julio de 1997"
9,9,17,5262,518,582,1100,"6 de julio de 1997"
9,9,17,5263,540,557,1097,"6 de julio de 1997"
9,9,17,5264,516,507,1023,"6 de julio de 1997"
9,9,17,5265,564,488,1052,"6 de julio de 1997"
9,9,17,5266,443,473,916,"6 de julio de 1997"
9,9,17,5267,533,552,1085,"6 de julio de 1997"
9,9,17,5268,669,695,1364,"6 de julio de 1997"
9,9,17,5269,587,702,1289,"6 de julio de 1997"
9,9,17,5270,425,474,899,"6 de julio de 1997"
9,9,17,5271,323,346,669,"6 de julio de 1997"
9,9,17,5272,436,454,890,"6 de julio de 1997"
9,9,17,5273,401,464,865,"6 de julio de 1997"
9,9,17,5338,256,289,545,"6 de julio de 1997"
9,9,17,5340,486,559,1045,"6 de julio de 1997"
9,9,17,5341,370,463,833,"6 de julio de 1997"
9,9,17,5342,430,500,930,"6 de julio de 1997"
9,9,17,5343,657,815,1472,"6 de julio de 1997"
9,9,17,5344,494,650,1144,"6 de julio de 1997"
9,9,17,5345,615,666,1281,"6 de julio de 1997"
9,9,17,5346,530,687,1217,"6 de julio de 1997"
9,9,17,5347,562,703,1265,"6 de julio de 1997"
9,9,17,5348,573,688,1261,"6 de julio de 1997"
9,9,17,5349,458,611,1069,"6 de julio de 1997"
9,9,17,5350,553,708,1261,"6 de julio de 1997"
9,9,17,5351,458,586,1044,"6 de julio de 1997"
9,9,17,5352,520,627,1147,"6 de julio de 1997"
9,9,17,5353,487,592,1079,"6 de julio de 1997"
9,9,17,5354,439,502,941,"6 de julio de 1997"
9,9,17,5355,351,424,775,"6 de julio de 1997"
9,9,17,5356,419,551,970,"6 de julio de 1997"
9,9,17,5357,439,545,984,"6 de julio de 1997"
9,9,17,5358,473,596,1069,"6 de julio de 1997"
9,9,17,5359,511,621,1132,"6 de julio de 1997"
9,9,17,5360,418,595,1013,"6 de julio de 1997"
9,9,17,5361,590,802,1392,"6 de julio de 1997"
9,9,17,5362,551,661,1212,"6 de julio de 1997"
9,9,17,5363,652,773,1425,"6 de julio de 1997"
9,9,17,5364,623,806,1429,"6 de julio de 1997"
9,9,17,5365,518,741,1259,"6 de julio de 1997"
9,9,17,5366,622,847,1469,"6 de julio de 1997"
9,9,17,5367,451,608,1059,"6 de julio de 1997"
9,9,17,5368,551,690,1241,"6 de julio de 1997"
9,9,17,5369,661,821,1482,"6 de julio de 1997"
9,9,17,5370,315,422,737,"6 de julio de 1997"
9,9,17,5371,528,709,1237,"6 de julio de 1997"
9,9,17,5372,748,813,1561,"6 de julio de 1997"
9,9,17,5373,605,744,1349,"6 de julio de 1997"
9,9,17,5374,478,596,1074,"6 de julio de 1997"
9,9,17,5375,666,746,1412,"6 de julio de 1997"
9,9,17,5376,716,816,1532,"6 de julio de 1997"
9,9,17,5377,512,624,1136,"6 de julio de 1997"
9,9,17,5378,439,557,996,"6 de julio de 1997"
9,9,17,5379,539,706,1245,"6 de julio de 1997"
9,9,17,5380,484,638,1122,"6 de julio de 1997"
9,9,17,5381,595,701,1296,"6 de julio de 1997"
9,9,17,5382,612,664,1276,"6 de julio de 1997"
9,9,17,5383,731,791,1522,"6 de julio de 1997"
9,9,17,5384,555,662,1217,"6 de julio de 1997"
9,9,17,5385,716,721,1437,"6 de julio de 1997"
9,9,17,5386,519,546,1065,"6 de julio de 1997"
9,9,17,5387,698,784,1482,"6 de julio de 1997"
9,9,17,5388,461,630,1091,"6 de julio de 1997"
9,9,17,5389,429,509,938,"6 de julio de 1997"
9,9,17,5390,388,470,858,"6 de julio de 1997"
9,9,17,5391,315,402,717,"6 de julio de 1997"
9,9,17,5395,244,275,519,"6 de julio de 1997"
9,9,17,5396,277,262,539,"6 de julio de 1997"
9,9,17,5399,242,315,557,"6 de julio de 1997"
9,9,17,5503,550,631,1181,"6 de julio de 1997"
9,9,17,5504,395,487,882,"6 de julio de 1997"
9,9,17,5505,423,459,882,"6 de julio de 1997"
9,9,17,5506,738,745,1483,"6 de julio de 1997"
9,9,17,5507,742,780,1522,"6 de julio de 1997"
9,9,17,5508,723,773,1496,"6 de julio de 1997"
9,9,17,5509,496,599,1095,"6 de julio de 1997"
9,9,17,5510,481,555,1036,"6 de julio de 1997"
9,9,17,5511,414,436,850,"6 de julio de 1997"
9,10,16,4912,129,258,387,"6 de julio de 1997"
9,10,16,4913,308,469,777,"6 de julio de 1997"
9,10,16,4914,321,500,821,"6 de julio de 1997"
9,10,16,4915,370,492,862,"6 de julio de 1997"
9,10,16,4916,305,379,684,"6 de julio de 1997"
9,10,16,4917,267,367,634,"6 de julio de 1997"
9,10,16,4918,370,528,898,"6 de julio de 1997"
9,10,16,4919,255,333,588,"6 de julio de 1997"
9,10,16,4920,415,505,920,"6 de julio de 1997"
9,10,16,4921,659,786,1445,"6 de julio de 1997"
9,10,16,4922,660,808,1468,"6 de julio de 1997"
9,10,16,4923,371,562,933,"6 de julio de 1997"
9,10,16,4924,245,371,616,"6 de julio de 1997"
9,10,16,4925,286,386,672,"6 de julio de 1997"
9,10,16,4926,289,368,657,"6 de julio de 1997"
9,10,16,4927,290,401,691,"6 de julio de 1997"
9,10,16,4928,243,362,605,"6 de julio de 1997"
9,10,16,4929,272,351,623,"6 de julio de 1997"
9,10,16,4930,320,395,715,"6 de julio de 1997"
9,10,16,4931,299,415,714,"6 de julio de 1997"
9,10,16,4932,386,525,911,"6 de julio de 1997"
9,10,16,4933,340,547,887,"6 de julio de 1997"
9,10,16,4934,374,588,962,"6 de julio de 1997"
9,10,16,4935,513,726,1239,"6 de julio de 1997"
9,10,16,4936,279,379,658,"6 de julio de 1997"
9,10,16,4937,488,645,1133,"6 de julio de 1997"
9,10,16,4938,375,586,961,"6 de julio de 1997"
9,10,16,4939,443,709,1152,"6 de julio de 1997"
9,10,16,4940,371,530,901,"6 de julio de 1997"
9,10,16,4941,239,378,617,"6 de julio de 1997"
9,10,16,4942,320,424,744,"6 de julio de 1997"
9,10,16,4943,349,479,828,"6 de julio de 1997"
9,10,16,4944,501,682,1183,"6 de julio de 1997"
9,10,16,4945,451,577,1028,"6 de julio de 1997"
9,10,16,4946,472,601,1073,"6 de julio de 1997"
9,10,16,4947,475,514,989,"6 de julio de 1997"
9,10,16,4948,167,243,410,"6 de julio de 1997"
9,10,16,4949,374,457,831,"6 de julio de 1997"
9,10,16,4950,363,470,833,"6 de julio de 1997"
9,10,16,4951,502,608,1110,"6 de julio de 1997"
9,10,16,4952,731,797,1528,"6 de julio de 1997"
9,10,16,4953,462,563,1025,"6 de julio de 1997"
9,10,16,4954,616,801,1417,"6 de julio de 1997"
9,10,16,4955,379,488,867,"6 de julio de 1997"
9,10,16,4956,590,692,1282,"6 de julio de 1997"
9,10,16,4957,463,493,956,"6 de julio de 1997"
9,10,16,4958,633,693,1326,"6 de julio de 1997"
9,10,16,4959,762,803,1565,"6 de julio de 1997"
9,10,16,4960,703,757,1460,"6 de julio de 1997"
9,10,16,4961,487,582,1069,"6 de julio de 1997"
9,10,16,4962,614,784,1398,"6 de julio de 1997"
9,10,16,4963,517,683,1200,"6 de julio de 1997"
9,10,16,4964,440,499,939,"6 de julio de 1997"
9,10,16,4965,517,674,1191,"6 de julio de 1997"
9,10,16,4966,425,505,930,"6 de julio de 1997"
9,10,16,4967,208,273,481,"6 de julio de 1997"
9,10,16,4968,483,610,1093,"6 de julio de 1997"
9,10,16,4969,610,678,1288,"6 de julio de 1997"
9,10,16,4970,719,941,1660,"6 de julio de 1997"
9,10,16,4971,504,753,1257,"6 de julio de 1997"
9,10,16,4972,725,773,1498,"6 de julio de 1997"
9,10,16,4973,504,569,1073,"6 de julio de 1997"
9,10,16,4974,542,648,1190,"6 de julio de 1997"
9,10,16,4975,523,549,1072,"6 de julio de 1997"
9,10,16,4976,600,682,1282,"6 de julio de 1997"
9,10,16,4977,590,600,1190,"6 de julio de 1997"
9,10,16,4978,453,522,975,"6 de julio de 1997"
9,10,16,4979,533,658,1191,"6 de julio de 1997"
9,10,16,4980,118,192,310,"6 de julio de 1997"
9,10,16,4981,763,161,924,"6 de julio de 1997"
9,10,16,4982,315,399,714,"6 de julio de 1997"
9,10,16,4983,155,234,389,"6 de julio de 1997"
9,10,16,4984,221,288,509,"6 de julio de 1997"
9,10,16,4985,487,532,1019,"6 de julio de 1997"
9,10,16,4986,190,239,429,"6 de julio de 1997"
9,10,16,4987,228,319,547,"6 de julio de 1997"
9,10,16,4988,229,12,241,"6 de julio de 1997"
9,10,16,4989,1195,0,1195,"6 de julio de 1997"
9,10,16,4990,456,97,553,"6 de julio de 1997"
9,10,16,4991,470,11,481,"6 de julio de 1997"
9,10,16,4992,425,539,964,"6 de julio de 1997"
9,10,16,4993,349,205,554,"6 de julio de 1997"
9,10,16,4994,342,377,719,"6 de julio de 1997"
9,10,16,5013,399,517,916,"6 de julio de 1997"
9,10,16,5014,455,577,1032,"6 de julio de 1997"
9,10,16,5015,450,492,942,"6 de julio de 1997"
9,10,16,5016,403,483,886,"6 de julio de 1997"
9,10,16,5017,538,641,1179,"6 de julio de 1997"
9,10,16,5018,511,685,1196,"6 de julio de 1997"
9,10,16,5019,476,571,1047,"6 de julio de 1997"
9,10,16,5020,396,542,938,"6 de julio de 1997"
9,10,16,5021,514,705,1219,"6 de julio de 1997"
9,10,16,5022,681,835,1516,"6 de julio de 1997"
9,10,16,5023,579,699,1278,"6 de julio de 1997"
9,10,16,5024,584,677,1261,"6 de julio de 1997"
9,10,16,5025,485,590,1075,"6 de julio de 1997"
9,10,16,5026,525,643,1168,"6 de julio de 1997"
9,10,16,5027,384,508,892,"6 de julio de 1997"
9,10,16,5028,559,680,1239,"6 de julio de 1997"
9,10,16,5029,514,597,1111,"6 de julio de 1997"
9,10,16,5030,605,635,1240,"6 de julio de 1997"
9,10,16,5031,456,524,980,"6 de julio de 1997"
9,10,16,5032,371,450,821,"6 de julio de 1997"
9,10,16,5033,493,586,1079,"6 de julio de 1997"
9,10,16,5034,459,523,982,"6 de julio de 1997"
9,10,16,5035,519,635,1154,"6 de julio de 1997"
9,10,16,5036,504,613,1117,"6 de julio de 1997"
9,10,16,5056,751,776,1527,"6 de julio de 1997"
9,10,16,5057,413,459,872,"6 de julio de 1997"
9,10,16,5060,563,619,1182,"6 de julio de 1997"
9,10,16,5061,607,674,1281,"6 de julio de 1997"
9,10,16,5062,592,662,1254,"6 de julio de 1997"
9,10,16,5066,641,850,1491,"6 de julio de 1997"
9,10,16,5067,403,495,898,"6 de julio de 1997"
9,10,16,5068,660,749,1409,"6 de julio de 1997"
9,10,16,5069,727,825,1552,"6 de julio de 1997"
9,10,16,5070,638,688,1326,"6 de julio de 1997"
9,10,16,5071,632,685,1317,"6 de julio de 1997"
9,10,16,5072,585,676,1261,"6 de julio de 1997"
9,10,16,5073,426,458,884,"6 de julio de 1997"
9,10,16,5074,567,624,1191,"6 de julio de 1997"
9,10,16,5075,557,615,1172,"6 de julio de 1997"
9,10,16,5076,456,483,939,"6 de julio de 1997"
9,10,16,5077,599,671,1270,"6 de julio de 1997"
9,10,16,5078,556,627,1183,"6 de julio de 1997"
9,10,16,5079,358,494,852,"6 de julio de 1997"
9,10,16,5080,362,489,851,"6 de julio de 1997"
9,10,16,5081,369,502,871,"6 de julio de 1997"
9,10,16,5082,482,370,852,"6 de julio de 1997"
9,10,16,5083,436,548,984,"6 de julio de 1997"
9,10,16,5084,310,409,719,"6 de julio de 1997"
9,10,16,5085,396,521,917,"6 de julio de 1997"
9,10,16,5086,354,448,802,"6 de julio de 1997"
9,10,16,5087,341,452,793,"6 de julio de 1997"
9,10,16,5088,383,516,899,"6 de julio de 1997"
9,10,16,5089,379,535,914,"6 de julio de 1997"
9,10,16,5090,388,497,885,"6 de julio de 1997"
9,10,16,5091,523,17,540,"6 de julio de 1997"
9,10,16,5092,303,0,303,"6 de julio de 1997"
9,10,16,5093,607,0,607,"6 de julio de 1997"
9,10,16,5094,276,13,289,"6 de julio de 1997"
9,10,16,5095,1039,29,1068,"6 de julio de 1997"
9,10,16,5096,529,3,532,"6 de julio de 1997"
9,10,16,5097,1096,8,1104,"6 de julio de 1997"
9,10,16,5098,345,413,758,"6 de julio de 1997"
9,10,16,5099,380,427,807,"6 de julio de 1997"
9,10,16,5102,169,266,435,"6 de julio de 1997"
9,10,16,5117,796,878,1674,"6 de julio de 1997"
9,10,16,5118,634,686,1320,"6 de julio de 1997"
9,10,16,5119,581,641,1222,"6 de julio de 1997"
9,10,16,5126,382,430,812,"6 de julio de 1997"
9,10,16,5127,539,628,1167,"6 de julio de 1997"
9,10,16,5128,697,742,1439,"6 de julio de 1997"
9,10,16,5129,697,815,1512,"6 de julio de 1997"
9,10,16,5130,683,747,1430,"6 de julio de 1997"
9,10,16,5131,603,671,1274,"6 de julio de 1997"
9,10,16,5132,685,772,1457,"6 de julio de 1997"
9,10,16,5133,598,658,1256,"6 de julio de 1997"
9,10,16,5134,574,654,1228,"6 de julio de 1997"
9,10,16,5135,602,658,1260,"6 de julio de 1997"
9,10,16,5136,444,530,974,"6 de julio de 1997"
9,10,16,5143,692,790,1482,"6 de julio de 1997"
9,10,16,5144,569,608,1177,"6 de julio de 1997"
9,10,16,5145,644,766,1410,"6 de julio de 1997"
9,10,16,5146,528,599,1127,"6 de julio de 1997"
9,10,16,5147,474,566,1040,"6 de julio de 1997"
9,10,16,5148,465,575,1040,"6 de julio de 1997"
9,10,16,5149,447,524,971,"6 de julio de 1997"
9,10,16,5150,630,656,1286,"6 de julio de 1997"
9,10,16,5155,526,687,1213,"6 de julio de 1997"
9,10,16,5156,441,467,908,"6 de julio de 1997"
9,10,16,5157,753,792,1545,"6 de julio de 1997"
9,10,16,5158,528,593,1121,"6 de julio de 1997"
9,10,16,5159,371,523,894,"6 de julio de 1997"
9,10,16,5160,318,488,806,"6 de julio de 1997"
9,10,16,5161,242,297,539,"6 de julio de 1997"
9,10,16,5162,524,782,1306,"6 de julio de 1997"
9,10,16,5163,309,380,689,"6 de julio de 1997"
9,10,16,5164,349,472,821,"6 de julio de 1997"
9,10,16,5165,465,594,1059,"6 de julio de 1997"
9,10,16,5166,414,519,933,"6 de julio de 1997"
9,10,16,5167,395,534,929,"6 de julio de 1997"
9,10,16,5168,297,445,742,"6 de julio de 1997"
9,10,16,5169,366,591,957,"6 de julio de 1997"
9,10,16,5170,321,484,805,"6 de julio de 1997"
9,10,16,5171,344,531,875,"6 de julio de 1997"
9,10,16,5172,349,500,849,"6 de julio de 1997"
9,10,16,5173,294,416,710,"6 de julio de 1997"
9,10,16,5174,304,445,749,"6 de julio de 1997"
9,10,16,5175,328,530,858,"6 de julio de 1997"
9,10,16,5176,332,375,707,"6 de julio de 1997"
9,10,16,5177,367,531,898,"6 de julio de 1997"
9,10,16,5178,388,503,891,"6 de julio de 1997"
9,10,16,5179,208,315,523,"6 de julio de 1997"
9,10,16,5180,338,491,829,"6 de julio de 1997"
9,10,16,5181,294,454,748,"6 de julio de 1997"
9,11,17,5274,561,633,1194,"6 de julio de 1997"
9,11,17,5275,688,732,1420,"6 de julio de 1997"
9,11,17,5276,710,806,1516,"6 de julio de 1997"
9,11,17,5277,675,795,1470,"6 de julio de 1997"
9,11,17,5278,544,598,1142,"6 de julio de 1997"
9,11,17,5279,495,533,1028,"6 de julio de 1997"
9,11,17,5280,587,612,1199,"6 de julio de 1997"
9,11,17,5281,558,583,1141,"6 de julio de 1997"
9,11,17,5282,285,316,601,"6 de julio de 1997"
9,11,17,5283,502,514,1016,"6 de julio de 1997"
9,11,17,5284,483,513,996,"6 de julio de 1997"
9,11,17,5285,498,570,1068,"6 de julio de 1997"
9,11,17,5286,530,590,1120,"6 de julio de 1997"
9,11,17,5287,613,699,1312,"6 de julio de 1997"
9,11,17,5288,454,520,974,"6 de julio de 1997"
9,11,17,5289,738,822,1560,"6 de julio de 1997"
9,11,17,5290,422,505,927,"6 de julio de 1997"
9,11,17,5291,591,637,1228,"6 de julio de 1997"
9,11,17,5292,732,795,1527,"6 de julio de 1997"
9,11,17,5293,679,740,1419,"6 de julio de 1997"
9,11,17,5294,630,709,1339,"6 de julio de 1997"
9,11,17,5295,530,627,1157,"6 de julio de 1997"
9,11,17,5296,535,595,1130,"6 de julio de 1997"
9,11,17,5297,666,763,1429,"6 de julio de 1997"
9,11,17,5298,530,626,1156,"6 de julio de 1997"
9,11,17,5299,661,758,1419,"6 de julio de 1997"
9,11,17,5300,642,706,1348,"6 de julio de 1997"
9,11,17,5301,506,569,1075,"6 de julio de 1997"
9,11,17,5302,639,734,1373,"6 de julio de 1997"
9,11,17,5303,666,746,1412,"6 de julio de 1997"
9,11,17,5304,214,222,436,"6 de julio de 1997"
9,11,17,5305,601,679,1280,"6 de julio de 1997"
9,11,17,5306,629,730,1359,"6 de julio de 1997"
9,11,17,5307,458,529,987,"6 de julio de 1997"
9,11,17,5308,678,776,1454,"6 de julio de 1997"
9,11,17,5309,649,717,1366,"6 de julio de 1997"
9,11,17,5310,531,644,1175,"6 de julio de 1997"
9,11,17,5311,446,485,931,"6 de julio de 1997"
9,11,17,5312,555,677,1232,"6 de julio de 1997"
9,11,17,5313,449,519,968,"6 de julio de 1997"
9,11,17,5314,319,410,729,"6 de julio de 1997"
9,11,17,5315,441,522,963,"6 de julio de 1997"
9,11,17,5316,507,514,1021,"6 de julio de 1997"
9,11,17,5317,459,557,1016,"6 de julio de 1997"
9,11,17,5318,537,622,1159,"6 de julio de 1997"
9,11,17,5319,530,623,1153,"6 de julio de 1997"
9,11,17,5320,544,582,1126,"6 de julio de 1997"
9,11,17,5321,611,663,1274,"6 de julio de 1997"
9,11,17,5322,593,658,1251,"6 de julio de 1997"
9,11,17,5323,543,701,1244,"6 de julio de 1997"
9,11,17,5324,618,710,1328,"6 de julio de 1997"
9,11,17,5325,397,426,823,"6 de julio de 1997"
9,11,17,5326,388,454,842,"6 de julio de 1997"
9,11,17,5327,395,490,885,"6 de julio de 1997"
9,11,17,5328,748,830,1578,"6 de julio de 1997"
9,11,17,5329,595,711,1306,"6 de julio de 1997"
9,11,17,5330,410,501,911,"6 de julio de 1997"
9,11,17,5331,308,339,647,"6 de julio de 1997"
9,11,17,5332,465,515,980,"6 de julio de 1997"
9,11,17,5333,200,235,435,"6 de julio de 1997"
9,11,17,5334,295,376,671,"6 de julio de 1997"
9,11,17,5335,353,468,821,"6 de julio de 1997"
9,11,17,5336,358,403,761,"6 de julio de 1997"
9,11,17,5337,262,332,594,"6 de julio de 1997"
9,11,17,5339,564,674,1238,"6 de julio de 1997"
9,11,17,5392,617,698,1315,"6 de julio de 1997"
9,11,17,5393,353,422,775,"6 de julio de 1997"
9,11,17,5394,668,727,1395,"6 de julio de 1997"
9,11,17,5397,233,262,495,"6 de julio de 1997"
9,11,17,5398,267,281,548,"6 de julio de 1997"
9,11,17,5400,649,714,1363,"6 de julio de 1997"
9,11,17,5401,568,640,1208,"6 de julio de 1997"
9,11,17,5402,554,638,1192,"6 de julio de 1997"
9,11,17,5403,697,764,1461,"6 de julio de 1997"
9,11,17,5404,403,481,884,"6 de julio de 1997"
9,11,17,5405,469,498,967,"6 de julio de 1997"
9,11,17,5406,412,397,809,"6 de julio de 1997"
9,11,17,5407,745,656,1401,"6 de julio de 1997"
9,11,17,5408,596,646,1242,"6 de julio de 1997"
9,11,17,5409,598,681,1279,"6 de julio de 1997"
9,11,17,5410,608,663,1271,"6 de julio de 1997"
9,11,17,5411,630,722,1352,"6 de julio de 1997"
9,11,17,5412,673,708,1381,"6 de julio de 1997"
9,11,17,5413,496,579,1075,"6 de julio de 1997"
9,11,17,5414,604,671,1275,"6 de julio de 1997"
9,11,17,5415,686,704,1390,"6 de julio de 1997"
9,11,17,5416,677,769,1446,"6 de julio de 1997"
9,11,17,5417,593,720,1313,"6 de julio de 1997"
9,11,17,5418,678,697,1375,"6 de julio de 1997"
9,11,17,5419,654,640,1294,"6 de julio de 1997"
9,11,17,5420,558,650,1208,"6 de julio de 1997"
9,11,17,5421,442,492,934,"6 de julio de 1997"
9,11,17,5422,553,575,1128,"6 de julio de 1997"
9,11,17,5423,446,462,908,"6 de julio de 1997"
9,11,17,5424,460,482,942,"6 de julio de 1997"
9,11,17,5425,458,475,933,"6 de julio de 1997"
9,11,17,5426,360,390,750,"6 de julio de 1997"
9,11,17,5427,338,363,701,"6 de julio de 1997"
9,11,17,5428,677,795,1472,"6 de julio de 1997"
9,11,17,5429,694,709,1403,"6 de julio de 1997"
9,11,17,5430,325,358,683,"6 de julio de 1997"
9,11,17,5431,818,870,1688,"6 de julio de 1997"
9,11,17,5432,329,384,713,"6 de julio de 1997"
9,11,17,5433,392,450,842,"6 de julio de 1997"
9,11,17,5434,388,493,881,"6 de julio de 1997"
9,11,17,5435,350,362,712,"6 de julio de 1997"
9,11,17,5436,689,772,1461,"6 de julio de 1997"
9,11,17,5437,513,560,1073,"6 de julio de 1997"
9,11,17,5438,400,442,842,"6 de julio de 1997"
9,11,17,5439,734,775,1509,"6 de julio de 1997"
9,11,17,5440,732,781,1513,"6 de julio de 1997"
9,11,17,5441,662,719,1381,"6 de julio de 1997"
9,11,17,5442,360,446,806,"6 de julio de 1997"
9,11,17,5443,566,593,1159,"6 de julio de 1997"
9,11,17,5444,664,728,1392,"6 de julio de 1997"
9,11,17,5445,525,554,1079,"6 de julio de 1997"
9,11,17,5446,688,774,1462,"6 de julio de 1997"
9,11,17,5447,764,868,1632,"6 de julio de 1997"
9,11,17,5448,502,553,1055,"6 de julio de 1997"
9,11,17,5449,444,483,927,"6 de julio de 1997"
9,11,17,5450,540,620,1160,"6 de julio de 1997"
9,11,17,5451,734,800,1534,"6 de julio de 1997"
9,11,17,5452,578,655,1233,"6 de julio de 1997"
9,11,17,5453,652,709,1361,"6 de julio de 1997"
9,11,17,5454,514,583,1097,"6 de julio de 1997"
9,11,17,5455,405,512,917,"6 de julio de 1997"
9,11,17,5456,693,758,1451,"6 de julio de 1997"
9,11,17,5457,664,713,1377,"6 de julio de 1997"
9,11,17,5458,268,281,549,"6 de julio de 1997"
9,11,17,5459,309,369,678,"6 de julio de 1997"
9,11,17,5460,573,582,1155,"6 de julio de 1997"
9,11,17,5461,554,578,1132,"6 de julio de 1997"
9,11,17,5462,459,538,997,"6 de julio de 1997"
9,11,17,5463,451,509,960,"6 de julio de 1997"
9,11,17,5464,616,731,1347,"6 de julio de 1997"
9,11,17,5465,749,838,1587,"6 de julio de 1997"
9,11,17,5466,491,560,1051,"6 de julio de 1997"
9,11,17,5467,376,419,795,"6 de julio de 1997"
9,11,17,5468,499,584,1083,"6 de julio de 1997"
9,11,17,5469,615,655,1270,"6 de julio de 1997"
9,11,17,5470,679,712,1391,"6 de julio de 1997"
9,11,17,5471,534,606,1140,"6 de julio de 1997"
9,11,17,5472,502,534,1036,"6 de julio de 1997"
9,11,17,5473,478,550,1028,"6 de julio de 1997"
9,11,17,5474,590,683,1273,"6 de julio de 1997"
9,11,17,5475,557,607,1164,"6 de julio de 1997"
9,11,17,5476,407,474,881,"6 de julio de 1997"
9,11,17,5477,569,630,1199,"6 de julio de 1997"
9,11,17,5478,729,777,1506,"6 de julio de 1997"
9,11,17,5479,367,407,774,"6 de julio de 1997"
9,11,17,5480,483,525,1008,"6 de julio de 1997"
9,11,17,5481,612,709,1321,"6 de julio de 1997"
9,11,17,5482,488,542,1030,"6 de julio de 1997"
9,11,17,5483,370,400,770,"6 de julio de 1997"
9,11,17,5484,636,696,1332,"6 de julio de 1997"
9,11,17,5485,588,660,1248,"6 de julio de 1997"
9,11,17,5486,493,581,1074,"6 de julio de 1997"
9,11,17,5487,547,621,1168,"6 de julio de 1997"
9,11,17,5488,538,610,1148,"6 de julio de 1997"
9,11,17,5489,661,708,1369,"6 de julio de 1997"
9,11,17,5490,469,528,997,"6 de julio de 1997"
9,11,17,5491,585,685,1270,"6 de julio de 1997"
9,11,17,5492,566,661,1227,"6 de julio de 1997"
9,11,17,5493,178,220,398,"6 de julio de 1997"
9,11,17,5494,249,252,501,"6 de julio de 1997"
9,11,17,5495,411,483,894,"6 de julio de 1997"
9,11,17,5496,269,278,547,"6 de julio de 1997"
9,11,17,5497,492,550,1042,"6 de julio de 1997"
9,11,17,5498,425,529,954,"6 de julio de 1997"
9,11,17,5499,360,378,738,"6 de julio de 1997"
9,11,17,5500,364,391,755,"6 de julio de 1997"
9,11,17,5501,811,11,822,"6 de julio de 1997"
9,11,17,5502,390,436,826,"6 de julio de 1997"
9,11,17,5520,87,116,203,"6 de julio de 1997"
9,11,17,5521,82,108,190,"6 de julio de 1997"
9,11,17,5522,86,118,204,"6 de julio de 1997"
9,11,17,5523,88,125,213,"6 de julio de 1997"
9,11,17,5524,146,177,323,"6 de julio de 1997"
9,11,17,5525,79,82,161,"6 de julio de 1997"
9,11,17,5526,100,127,227,"6 de julio de 1997"
9,11,17,5527,102,121,223,"6 de julio de 1997"
9,12,15,4523,616,716,1332,"6 de julio de 1997"
9,12,15,4524,382,440,822,"6 de julio de 1997"
9,12,15,4525,541,643,1184,"6 de julio de 1997"
9,12,15,4526,347,386,733,"6 de julio de 1997"
9,12,15,4527,538,592,1130,"6 de julio de 1997"
9,12,15,4528,461,502,963,"6 de julio de 1997"
9,12,15,4529,363,451,814,"6 de julio de 1997"
9,12,15,4530,390,471,861,"6 de julio de 1997"
9,12,15,4531,419,551,970,"6 de julio de 1997"
9,12,15,4532,634,710,1344,"6 de julio de 1997"
9,12,15,4533,352,469,821,"6 de julio de 1997"
9,12,15,4534,344,379,723,"6 de julio de 1997"
9,12,15,4535,440,550,990,"6 de julio de 1997"
9,12,15,4536,360,431,791,"6 de julio de 1997"
9,12,15,4537,237,287,524,"6 de julio de 1997"
9,12,15,4538,493,636,1129,"6 de julio de 1997"
9,12,15,4539,407,515,922,"6 de julio de 1997"
9,12,15,4540,460,561,1021,"6 de julio de 1997"
9,12,15,4541,505,646,1151,"6 de julio de 1997"
9,12,15,4542,380,442,822,"6 de julio de 1997"
9,12,15,4543,668,768,1436,"6 de julio de 1997"
9,12,15,4544,407,559,966,"6 de julio de 1997"
9,12,15,4545,584,583,1167,"6 de julio de 1997"
9,12,15,4546,329,364,693,"6 de julio de 1997"
9,12,15,4547,355,476,831,"6 de julio de 1997"
9,12,15,4548,316,373,689,"6 de julio de 1997"
9,12,15,4549,339,450,789,"6 de julio de 1997"
9,12,15,4550,477,652,1129,"6 de julio de 1997"
9,12,15,4551,593,771,1364,"6 de julio de 1997"
9,12,15,4552,437,593,1030,"6 de julio de 1997"
9,12,15,4553,415,498,913,"6 de julio de 1997"
9,12,15,4554,457,537,994,"6 de julio de 1997"
9,12,15,4555,538,632,1170,"6 de julio de 1997"
9,12,15,4556,540,682,1222,"6 de julio de 1997"
9,12,15,4557,586,629,1215,"6 de julio de 1997"
9,12,15,4558,609,759,1368,"6 de julio de 1997"
9,12,15,4559,475,577,1052,"6 de julio de 1997"
9,12,15,4560,568,737,1305,"6 de julio de 1997"
9,12,15,4561,265,349,614,"6 de julio de 1997"
9,12,15,4562,313,417,730,"6 de julio de 1997"
9,12,15,4563,415,543,958,"6 de julio de 1997"
9,12,15,4564,424,543,967,"6 de julio de 1997"
9,12,15,4565,423,520,943,"6 de julio de 1997"
9,12,15,4566,232,313,545,"6 de julio de 1997"
9,12,15,4567,234,313,547,"6 de julio de 1997"
9,12,15,4568,367,526,893,"6 de julio de 1997"
9,12,15,4569,271,317,588,"6 de julio de 1997"
9,12,15,4570,478,620,1098,"6 de julio de 1997"
9,12,15,4571,229,282,511,"6 de julio de 1997"
9,12,15,4572,334,450,784,"6 de julio de 1997"
9,12,15,4573,571,665,1236,"6 de julio de 1997"
9,12,15,4574,461,600,1061,"6 de julio de 1997"
9,12,15,4575,596,711,1307,"6 de julio de 1997"
9,12,15,4576,448,616,1064,"6 de julio de 1997"
9,12,15,4577,397,505,902,"6 de julio de 1997"
9,12,15,4578,506,599,1105,"6 de julio de 1997"
9,12,15,4579,399,513,912,"6 de julio de 1997"
9,12,15,4580,409,568,977,"6 de julio de 1997"
9,12,15,4581,417,553,970,"6 de julio de 1997"
9,12,15,4582,390,523,913,"6 de julio de 1997"
9,12,15,4583,411,589,1000,"6 de julio de 1997"
9,12,15,4584,326,462,788,"6 de julio de 1997"
9,12,15,4585,346,471,817,"6 de julio de 1997"
9,12,15,4629,396,501,897,"6 de julio de 1997"
9,12,15,4631,473,569,1042,"6 de julio de 1997"
9,12,15,4632,653,738,1391,"6 de julio de 1997"
9,12,15,4639,454,493,947,"6 de julio de 1997"
9,12,15,4640,542,651,1193,"6 de julio de 1997"
9,12,15,4641,543,621,1164,"6 de julio de 1997"
9,12,15,4642,493,613,1106,"6 de julio de 1997"
9,12,15,4643,544,749,1293,"6 de julio de 1997"
9,12,15,4644,729,810,1539,"6 de julio de 1997"
9,12,15,4645,501,566,1067,"6 de julio de 1997"
9,12,15,4652,260,285,545,"6 de julio de 1997"
9,12,15,4760,239,273,512,"6 de julio de 1997"
9,12,15,4761,721,851,1572,"6 de julio de 1997"
9,12,15,4762,542,670,1212,"6 de julio de 1997"
9,12,15,4763,416,540,956,"6 de julio de 1997"
9,12,15,4764,344,449,793,"6 de julio de 1997"
9,12,15,4765,549,586,1135,"6 de julio de 1997"
9,12,15,4766,459,552,1011,"6 de julio de 1997"
9,12,15,4767,579,631,1210,"6 de julio de 1997"
9,12,15,4768,571,657,1228,"6 de julio de 1997"
9,12,15,4769,480,607,1087,"6 de julio de 1997"
9,12,15,4770,684,858,1542,"6 de julio de 1997"
9,12,15,4771,635,737,1372,"6 de julio de 1997"
9,12,15,4772,516,630,1146,"6 de julio de 1997"
9,12,15,4773,340,415,755,"6 de julio de 1997"
9,12,15,4774,455,503,958,"6 de julio de 1997"
9,12,15,4775,587,691,1278,"6 de julio de 1997"
9,12,15,4776,666,780,1446,"6 de julio de 1997"
9,12,15,4777,497,566,1063,"6 de julio de 1997"
9,12,15,4778,501,527,1028,"6 de julio de 1997"
9,12,15,4779,496,601,1097,"6 de julio de 1997"
9,12,15,4780,568,658,1226,"6 de julio de 1997"
9,12,15,4781,670,772,1442,"6 de julio de 1997"
9,12,15,4782,490,555,1045,"6 de julio de 1997"
9,12,15,4783,361,399,760,"6 de julio de 1997"
9,12,15,4784,536,660,1196,"6 de julio de 1997"
9,12,15,4785,455,530,985,"6 de julio de 1997"
9,12,15,4786,513,621,1134,"6 de julio de 1997"
9,12,15,4787,621,713,1334,"6 de julio de 1997"
9,12,15,4788,367,460,827,"6 de julio de 1997"
9,12,15,4789,552,712,1264,"6 de julio de 1997"
9,12,15,4790,491,552,1043,"6 de julio de 1997"
9,12,15,4791,503,560,1063,"6 de julio de 1997"
9,12,15,4792,502,587,1089,"6 de julio de 1997"
9,12,15,4793,536,619,1155,"6 de julio de 1997"
9,12,15,4794,443,500,943,"6 de julio de 1997"
9,12,15,4795,616,771,1387,"6 de julio de 1997"
9,12,15,4796,695,770,1465,"6 de julio de 1997"
9,12,15,4797,835,921,1756,"6 de julio de 1997"
9,12,15,4798,669,768,1437,"6 de julio de 1997"
9,12,15,4799,425,507,932,"6 de julio de 1997"
9,12,15,4800,640,701,1341,"6 de julio de 1997"
9,12,15,4801,733,828,1561,"6 de julio de 1997"
9,12,15,4802,605,668,1273,"6 de julio de 1997"
9,12,15,4803,468,583,1051,"6 de julio de 1997"
9,12,15,4804,460,525,985,"6 de julio de 1997"
9,12,15,4805,407,490,897,"6 de julio de 1997"
9,12,15,4806,341,413,754,"6 de julio de 1997"
9,12,15,4807,834,922,1756,"6 de julio de 1997"
9,12,15,4808,436,573,1009,"6 de julio de 1997"
9,12,15,4809,619,714,1333,"6 de julio de 1997"
9,12,15,4810,523,622,1145,"6 de julio de 1997"
9,12,15,4811,484,625,1109,"6 de julio de 1997"
9,12,15,4812,391,467,858,"6 de julio de 1997"
9,12,15,4813,367,364,731,"6 de julio de 1997"
9,12,15,4814,298,364,662,"6 de julio de 1997"
9,12,15,4815,248,328,576,"6 de julio de 1997"
9,12,15,4816,278,343,621,"6 de julio de 1997"
9,12,15,4817,327,358,685,"6 de julio de 1997"
9,12,15,4818,610,702,1312,"6 de julio de 1997"
9,12,15,4819,501,556,1057,"6 de julio de 1997"
9,12,15,4820,576,619,1195,"6 de julio de 1997"
9,12,15,4831,452,557,1009,"6 de julio de 1997"
9,12,15,4832,524,635,1159,"6 de julio de 1997"
9,12,15,4833,461,579,1040,"6 de julio de 1997"
9,12,15,4834,439,553,992,"6 de julio de 1997"
9,12,15,4835,544,613,1157,"6 de julio de 1997"
9,12,15,4836,484,526,1010,"6 de julio de 1997"
9,12,15,4852,519,556,1075,"6 de julio de 1997"
9,12,15,4853,450,491,941,"6 de julio de 1997"
9,12,15,4854,544,537,1081,"6 de julio de 1997"
9,12,15,4855,491,563,1054,"6 de julio de 1997"
9,12,15,4856,493,617,1110,"6 de julio de 1997"
9,12,15,4857,506,659,1165,"6 de julio de 1997"
9,12,15,4858,444,512,956,"6 de julio de 1997"
9,12,15,4859,472,619,1091,"6 de julio de 1997"
9,12,15,4860,486,527,1013,"6 de julio de 1997"
9,12,15,4861,387,523,910,"6 de julio de 1997"
9,12,15,4862,494,570,1064,"6 de julio de 1997"
9,12,15,4863,431,506,937,"6 de julio de 1997"
9,12,15,4864,396,424,820,"6 de julio de 1997"
9,12,15,4865,395,478,873,"6 de julio de 1997"
9,12,15,4870,547,625,1172,"6 de julio de 1997"
9,12,15,4871,502,579,1081,"6 de julio de 1997"
9,12,15,4872,604,692,1296,"6 de julio de 1997"
9,12,15,4873,196,150,346,"6 de julio de 1997"
9,12,15,4874,363,416,779,"6 de julio de 1997"
9,12,15,4875,398,449,847,"6 de julio de 1997"
9,12,15,4876,339,436,775,"6 de julio de 1997"
9,12,15,4877,312,399,711,"6 de julio de 1997"
9,12,15,4878,303,365,668,"6 de julio de 1997"
9,12,15,4879,362,422,784,"6 de julio de 1997"
9,12,15,4880,274,296,570,"6 de julio de 1997"
9,12,15,4881,335,397,732,"6 de julio de 1997"
9,12,15,4882,267,279,546,"6 de julio de 1997"
9,12,15,4883,229,233,462,"6 de julio de 1997"
9,12,15,4884,250,304,554,"6 de julio de 1997"
9,12,15,4885,411,494,905,"6 de julio de 1997"
9,12,15,4886,381,432,813,"6 de julio de 1997"
9,12,15,4889,222,348,570,"6 de julio de 1997"
9,12,15,4891,568,649,1217,"6 de julio de 1997"
9,12,15,4892,654,731,1385,"6 de julio de 1997"
9,12,15,4893,739,773,1512,"6 de julio de 1997"
9,12,15,4894,681,725,1406,"6 de julio de 1997"
9,12,15,4895,627,632,1259,"6 de julio de 1997"
9,12,15,4896,389,464,853,"6 de julio de 1997"
9,12,15,4897,529,618,1147,"6 de julio de 1997"
9,12,15,4898,493,577,1070,"6 de julio de 1997"
9,12,15,4899,557,697,1254,"6 de julio de 1997"
9,12,15,4900,494,566,1060,"6 de julio de 1997"
9,12,15,4901,424,523,947,"6 de julio de 1997"
9,12,15,4902,435,488,923,"6 de julio de 1997"
9,12,15,4903,503,545,1048,"6 de julio de 1997"
9,12,15,4904,532,657,1189,"6 de julio de 1997"
9,12,15,4905,1004,511,1515,"6 de julio de 1997"
9,12,15,4906,526,610,1136,"6 de julio de 1997"
9,12,15,4907,602,735,1337,"6 de julio de 1997"
9,12,15,4908,565,686,1251,"6 de julio de 1997"
9,12,15,4909,366,407,773,"6 de julio de 1997"
9,12,15,4910,436,483,919,"6 de julio de 1997"
9,12,15,4911,396,439,835,"6 de julio de 1997"
9,13,6,1672,459,482,941,"6 de julio de 1997"
9,13,6,1673,459,519,978,"6 de julio de 1997"
9,13,6,1674,398,414,812,"6 de julio de 1997"
9,13,6,1675,661,737,1398,"6 de julio de 1997"
9,13,6,1676,558,575,1133,"6 de julio de 1997"
9,13,6,1677,345,355,700,"6 de julio de 1997"
9,13,6,1678,614,671,1285,"6 de julio de 1997"
9,13,6,1679,452,514,966,"6 de julio de 1997"
9,13,6,1680,460,499,959,"6 de julio de 1997"
9,13,6,1681,536,561,1097,"6 de julio de 1997"
9,13,6,1682,349,406,755,"6 de julio de 1997"
9,13,6,1683,526,585,1111,"6 de julio de 1997"
9,13,6,1684,474,466,940,"6 de julio de 1997"
9,13,6,1685,330,369,699,"6 de julio de 1997"
9,13,6,1686,321,377,698,"6 de julio de 1997"
9,13,6,1687,494,503,997,"6 de julio de 1997"
9,13,6,1688,478,546,1024,"6 de julio de 1997"
9,13,6,1689,358,393,751,"6 de julio de 1997"
9,13,6,1695,252,269,521,"6 de julio de 1997"
9,13,6,1701,582,640,1222,"6 de julio de 1997"
9,13,6,1702,564,651,1215,"6 de julio de 1997"
9,13,6,1703,606,643,1249,"6 de julio de 1997"
9,13,6,1704,500,601,1101,"6 de julio de 1997"
9,13,6,1705,590,660,1250,"6 de julio de 1997"
9,13,6,1706,481,502,983,"6 de julio de 1997"
9,13,6,1707,551,591,1142,"6 de julio de 1997"
9,13,6,1708,530,603,1133,"6 de julio de 1997"
9,13,6,1709,471,529,1000,"6 de julio de 1997"
9,13,6,1710,435,531,966,"6 de julio de 1997"
9,13,6,1711,422,454,876,"6 de julio de 1997"
9,13,6,1712,482,517,999,"6 de julio de 1997"
9,13,6,1713,435,478,913,"6 de julio de 1997"
9,13,6,1714,455,483,938,"6 de julio de 1997"
9,13,6,1715,371,448,819,"6 de julio de 1997"
9,13,6,1716,515,548,1063,"6 de julio de 1997"
9,13,6,1717,559,598,1157,"6 de julio de 1997"
9,13,6,1718,568,646,1214,"6 de julio de 1997"
9,13,6,1719,510,552,1062,"6 de julio de 1997"
9,13,6,1720,624,674,1298,"6 de julio de 1997"
9,13,6,1721,494,541,1035,"6 de julio de 1997"
9,13,6,1722,434,501,935,"6 de julio de 1997"
9,13,6,1723,570,622,1192,"6 de julio de 1997"
9,13,6,1724,517,577,1094,"6 de julio de 1997"
9,13,6,1725,518,585,1103,"6 de julio de 1997"
9,13,6,1726,552,600,1152,"6 de julio de 1997"
9,13,6,1727,566,579,1145,"6 de julio de 1997"
9,13,6,1728,452,491,943,"6 de julio de 1997"
9,13,6,1739,302,321,623,"6 de julio de 1997"
9,13,6,1740,619,650,1269,"6 de julio de 1997"
9,13,6,1741,491,554,1045,"6 de julio de 1997"
9,13,6,1742,606,674,1280,"6 de julio de 1997"
9,13,6,1743,610,653,1263,"6 de julio de 1997"
9,13,6,1744,508,576,1084,"6 de julio de 1997"
9,13,6,1745,441,488,929,"6 de julio de 1997"
9,13,6,1746,499,498,997,"6 de julio de 1997"
9,13,6,1747,413,465,878,"6 de julio de 1997"
9,13,6,1748,491,544,1035,"6 de julio de 1997"
9,13,6,1749,529,594,1123,"6 de julio de 1997"
9,13,6,1750,469,527,996,"6 de julio de 1997"
9,13,6,1751,496,553,1049,"6 de julio de 1997"
9,13,6,1752,561,596,1157,"6 de julio de 1997"
9,13,6,1753,625,625,1250,"6 de julio de 1997"
9,13,6,1754,734,777,1511,"6 de julio de 1997"
9,13,6,1755,602,656,1258,"6 de julio de 1997"
9,13,6,1756,440,479,919,"6 de julio de 1997"
9,13,6,1757,440,459,899,"6 de julio de 1997"
9,13,6,1758,499,484,983,"6 de julio de 1997"
9,13,6,1759,365,393,758,"6 de julio de 1997"
9,13,6,1760,103,123,226,"6 de julio de 1997"
9,13,6,1761,409,437,846,"6 de julio de 1997"
9,13,6,1762,621,710,1331,"6 de julio de 1997"
9,13,6,1763,503,578,1081,"6 de julio de 1997"
9,13,6,1764,471,572,1043,"6 de julio de 1997"
9,13,6,1765,497,578,1075,"6 de julio de 1997"
9,13,6,1766,522,574,1096,"6 de julio de 1997"
9,13,6,1767,536,577,1113,"6 de julio de 1997"
9,13,6,1768,734,831,1565,"6 de julio de 1997"
9,13,6,1793,524,543,1067,"6 de julio de 1997"
9,13,6,1794,549,580,1129,"6 de julio de 1997"
9,13,6,1795,409,443,852,"6 de julio de 1997"
9,13,6,1796,616,592,1208,"6 de julio de 1997"
9,13,6,1797,519,540,1059,"6 de julio de 1997"
9,13,6,1798,477,518,995,"6 de julio de 1997"
9,13,6,1827,331,321,652,"6 de julio de 1997"
9,13,6,1831,549,577,1126,"6 de julio de 1997"
9,13,6,1832,553,636,1189,"6 de julio de 1997"
9,13,6,1833,616,666,1282,"6 de julio de 1997"
9,13,6,1834,471,510,981,"6 de julio de 1997"
9,13,6,1835,448,495,943,"6 de julio de 1997"
9,13,6,1836,551,620,1171,"6 de julio de 1997"
9,13,6,1837,521,595,1116,"6 de julio de 1997"
9,13,6,1838,504,559,1063,"6 de julio de 1997"
9,13,6,1839,687,779,1466,"6 de julio de 1997"
9,13,6,1840,483,550,1033,"6 de julio de 1997"
9,13,6,1841,566,589,1155,"6 de julio de 1997"
9,13,6,1842,585,604,1189,"6 de julio de 1997"
9,13,6,1843,352,417,769,"6 de julio de 1997"
9,13,6,1844,335,432,767,"6 de julio de 1997"
9,13,6,1845,639,740,1379,"6 de julio de 1997"
9,13,6,1846,469,564,1033,"6 de julio de 1997"
9,13,6,1847,456,492,948,"6 de julio de 1997"
9,13,6,1848,438,437,875,"6 de julio de 1997"
9,13,6,1849,463,508,971,"6 de julio de 1997"
9,13,6,1850,483,476,959,"6 de julio de 1997"
9,13,6,1851,556,625,1181,"6 de julio de 1997"
9,13,6,1852,453,492,945,"6 de julio de 1997"
9,13,6,1853,514,582,1096,"6 de julio de 1997"
9,13,6,1854,439,498,937,"6 de julio de 1997"
9,13,6,1855,491,555,1046,"6 de julio de 1997"
9,13,6,1856,383,418,801,"6 de julio de 1997"
9,13,6,1857,441,479,920,"6 de julio de 1997"
9,13,6,1858,628,725,1353,"6 de julio de 1997"
9,13,6,1859,551,626,1177,"6 de julio de 1997"
9,13,6,1860,520,564,1084,"6 de julio de 1997"
9,13,6,1861,559,670,1229,"6 de julio de 1997"
9,13,6,1862,617,673,1290,"6 de julio de 1997"
9,13,6,1863,395,438,833,"6 de julio de 1997"
9,13,6,1864,400,468,868,"6 de julio de 1997"
9,13,6,1865,427,420,847,"6 de julio de 1997"
9,13,6,1866,342,385,727,"6 de julio de 1997"
9,13,6,1867,476,573,1049,"6 de julio de 1997"
9,13,6,1868,526,589,1115,"6 de julio de 1997"
9,13,6,1869,689,767,1456,"6 de julio de 1997"
9,13,6,1870,626,699,1325,"6 de julio de 1997"
9,13,6,1871,446,479,925,"6 de julio de 1997"
9,13,6,1872,265,298,563,"6 de julio de 1997"
9,13,6,1873,420,457,877,"6 de julio de 1997"
9,13,6,1874,541,627,1168,"6 de julio de 1997"
9,13,6,1875,563,647,1210,"6 de julio de 1997"
9,13,6,1876,559,660,1219,"6 de julio de 1997"
9,13,6,1877,462,489,951,"6 de julio de 1997"
9,13,6,1878,510,575,1085,"6 de julio de 1997"
9,13,6,1879,652,756,1408,"6 de julio de 1997"
9,13,6,1880,570,570,1140,"6 de julio de 1997"
9,13,6,1881,544,588,1132,"6 de julio de 1997"
9,13,6,1882,385,394,779,"6 de julio de 1997"
9,13,6,1883,598,690,1288,"6 de julio de 1997"
9,13,6,1884,526,597,1123,"6 de julio de 1997"
9,13,6,1885,587,640,1227,"6 de julio de 1997"
9,13,6,1886,217,236,453,"6 de julio de 1997"
9,13,6,1887,492,512,1004,"6 de julio de 1997"
9,13,6,1888,523,552,1075,"6 de julio de 1997"
9,13,6,1889,670,771,1441,"6 de julio de 1997"
9,13,6,1890,572,609,1181,"6 de julio de 1997"
9,13,6,1891,666,772,1438,"6 de julio de 1997"
9,13,6,1892,593,650,1243,"6 de julio de 1997"
9,13,6,1893,538,649,1187,"6 de julio de 1997"
9,13,6,1894,416,461,877,"6 de julio de 1997"
9,13,6,1895,516,605,1121,"6 de julio de 1997"
9,13,6,1896,583,618,1201,"6 de julio de 1997"
9,13,6,1897,449,508,957,"6 de julio de 1997"
9,13,6,1898,583,652,1235,"6 de julio de 1997"
9,13,6,1899,459,474,933,"6 de julio de 1997"
9,13,6,1900,442,476,918,"6 de julio de 1997"
9,13,6,1901,300,351,651,"6 de julio de 1997"
9,13,6,1902,620,684,1304,"6 de julio de 1997"
9,13,6,1903,433,492,925,"6 de julio de 1997"
9,13,6,1904,622,662,1284,"6 de julio de 1997"
9,13,6,1905,488,552,1040,"6 de julio de 1997"
9,13,6,1906,556,599,1155,"6 de julio de 1997"
9,13,6,1907,497,573,1070,"6 de julio de 1997"
9,13,6,1908,382,422,804,"6 de julio de 1997"
9,13,6,1909,469,538,1007,"6 de julio de 1997"
9,13,6,1910,408,450,858,"6 de julio de 1997"
9,13,6,1911,451,464,915,"6 de julio de 1997"
9,13,6,1912,412,431,843,"6 de julio de 1997"
9,13,6,1913,638,679,1317,"6 de julio de 1997"
9,13,6,1914,386,445,831,"6 de julio de 1997"
9,13,6,1915,350,393,743,"6 de julio de 1997"
9,13,6,1916,576,635,1211,"6 de julio de 1997"
9,13,6,1917,367,429,796,"6 de julio de 1997"
9,13,6,1918,541,589,1130,"6 de julio de 1997"
9,13,6,1919,363,394,757,"6 de julio de 1997"
9,13,6,1920,353,343,696,"6 de julio de 1997"
9,13,6,1921,689,741,1430,"6 de julio de 1997"
9,13,6,1922,513,507,1020,"6 de julio de 1997"
9,13,6,1923,388,439,827,"6 de julio de 1997"
9,13,6,1924,601,671,1272,"6 de julio de 1997"
9,13,6,1925,366,436,802,"6 de julio de 1997"
9,13,6,1926,529,558,1087,"6 de julio de 1997"
9,13,6,1927,469,530,999,"6 de julio de 1997"
9,13,6,1928,491,521,1012,"6 de julio de 1997"
9,13,6,1929,453,503,956,"6 de julio de 1997"
9,13,6,1930,382,484,866,"6 de julio de 1997"
9,13,6,1931,574,576,1150,"6 de julio de 1997"
9,13,6,1932,412,427,839,"6 de julio de 1997"
9,13,6,1933,367,377,744,"6 de julio de 1997"
9,13,6,1934,448,509,957,"6 de julio de 1997"
9,13,6,1935,298,322,620,"6 de julio de 1997"
9,13,6,1936,556,627,1183,"6 de julio de 1997"
9,13,6,1937,656,748,1404,"6 de julio de 1997"
9,13,6,1938,550,604,1154,"6 de julio de 1997"
9,13,6,1939,518,536,1054,"6 de julio de 1997"
9,13,6,1940,378,395,773,"6 de julio de 1997"
9,13,6,1941,384,480,864,"6 de julio de 1997"
9,13,6,1942,563,565,1128,"6 de julio de 1997"
9,13,6,1943,698,753,1451,"6 de julio de 1997"
9,13,6,1944,520,550,1070,"6 de julio de 1997"
9,14,6,1690,464,482,946,"6 de julio de 1997"
9,14,6,1691,546,572,1118,"6 de julio de 1997"
9,14,6,1692,529,561,1090,"6 de julio de 1997"
9,14,6,1693,313,385,698,"6 de julio de 1997"
9,14,6,1694,448,619,1067,"6 de julio de 1997"
9,14,6,1696,690,776,1466,"6 de julio de 1997"
9,14,6,1697,618,756,1374,"6 de julio de 1997"
9,14,6,1698,595,647,1242,"6 de julio de 1997"
9,14,6,1699,475,483,958,"6 de julio de 1997"
9,14,6,1700,192,219,411,"6 de julio de 1997"
9,14,6,1729,493,522,1015,"6 de julio de 1997"
9,14,6,1730,669,710,1379,"6 de julio de 1997"
9,14,6,1731,650,746,1396,"6 de julio de 1997"
9,14,6,1732,465,512,977,"6 de julio de 1997"
9,14,6,1733,488,534,1022,"6 de julio de 1997"
9,14,6,1734,617,678,1295,"6 de julio de 1997"
9,14,6,1735,454,515,969,"6 de julio de 1997"
9,14,6,1736,541,602,1143,"6 de julio de 1997"
9,14,6,1737,542,610,1152,"6 de julio de 1997"
9,14,6,1738,495,504,999,"6 de julio de 1997"
9,14,6,1769,635,636,1271,"6 de julio de 1997"
9,14,6,1770,620,687,1307,"6 de julio de 1997"
9,14,6,1771,676,721,1397,"6 de julio de 1997"
9,14,6,1772,717,780,1497,"6 de julio de 1997"
9,14,6,1773,403,509,912,"6 de julio de 1997"
9,14,6,1774,438,534,972,"6 de julio de 1997"
9,14,6,1775,284,412,696,"6 de julio de 1997"
9,14,6,1776,566,676,1242,"6 de julio de 1997"
9,14,6,1777,423,494,917,"6 de julio de 1997"
9,14,6,1778,381,477,858,"6 de julio de 1997"
9,14,6,1779,479,503,982,"6 de julio de 1997"
9,14,6,1780,773,760,1533,"6 de julio de 1997"
9,14,6,1781,620,672,1292,"6 de julio de 1997"
9,14,6,1782,588,615,1203,"6 de julio de 1997"
9,14,6,1783,678,744,1422,"6 de julio de 1997"
9,14,6,1784,643,742,1385,"6 de julio de 1997"
9,14,6,1785,612,645,1257,"6 de julio de 1997"
9,14,6,1786,730,798,1528,"6 de julio de 1997"
9,14,6,1787,697,770,1467,"6 de julio de 1997"
9,14,6,1788,562,607,1169,"6 de julio de 1997"
9,14,6,1789,675,743,1418,"6 de julio de 1997"
9,14,6,1790,546,630,1176,"6 de julio de 1997"
9,14,6,1791,782,817,1599,"6 de julio de 1997"
9,14,6,1792,664,681,1345,"6 de julio de 1997"
9,14,6,1799,556,645,1201,"6 de julio de 1997"
9,14,6,1800,606,635,1241,"6 de julio de 1997"
9,14,6,1801,666,719,1385,"6 de julio de 1997"
9,14,6,1802,704,775,1479,"6 de julio de 1997"
9,14,6,1803,741,854,1595,"6 de julio de 1997"
9,14,6,1804,674,726,1400,"6 de julio de 1997"
9,14,6,1805,587,635,1222,"6 de julio de 1997"
9,14,6,1806,562,576,1138,"6 de julio de 1997"
9,14,6,1807,515,608,1123,"6 de julio de 1997"
9,14,6,1808,641,719,1360,"6 de julio de 1997"
9,14,6,1809,607,679,1286,"6 de julio de 1997"
9,14,6,1810,712,739,1451,"6 de julio de 1997"
9,14,6,1811,817,853,1670,"6 de julio de 1997"
9,14,6,1812,604,681,1285,"6 de julio de 1997"
9,14,6,1813,616,734,1350,"6 de julio de 1997"
9,14,6,1814,420,530,950,"6 de julio de 1997"
9,14,6,1815,540,674,1214,"6 de julio de 1997"
9,14,6,1816,252,333,585,"6 de julio de 1997"
9,14,6,1817,375,451,826,"6 de julio de 1997"
9,14,6,1818,137,197,334,"6 de julio de 1997"
9,14,6,1819,537,681,1218,"6 de julio de 1997"
9,14,6,1820,440,570,1010,"6 de julio de 1997"
9,14,6,1821,406,547,953,"6 de julio de 1997"
9,14,6,1822,432,580,1012,"6 de julio de 1997"
9,14,6,1823,456,550,1006,"6 de julio de 1997"
9,14,6,1824,445,589,1034,"6 de julio de 1997"
9,14,6,1825,360,432,792,"6 de julio de 1997"
9,14,6,1826,489,644,1133,"6 de julio de 1997"
9,14,6,1828,198,198,396,"6 de julio de 1997"
9,14,6,1829,220,239,459,"6 de julio de 1997"
9,14,6,1830,565,733,1298,"6 de julio de 1997"
9,14,6,1945,398,481,879,"6 de julio de 1997"
9,14,6,1946,307,337,644,"6 de julio de 1997"
9,14,6,1947,385,425,810,"6 de julio de 1997"
9,14,6,1948,565,690,1255,"6 de julio de 1997"
9,14,6,1949,240,333,573,"6 de julio de 1997"
9,14,6,1950,508,613,1121,"6 de julio de 1997"
9,14,6,1951,291,374,665,"6 de julio de 1997"
9,14,6,1952,354,383,737,"6 de julio de 1997"
9,14,6,1953,322,390,712,"6 de julio de 1997"
9,14,6,1954,235,277,512,"6 de julio de 1997"
9,14,6,1955,308,377,685,"6 de julio de 1997"
9,14,6,1956,236,293,529,"6 de julio de 1997"
9,14,6,1957,492,563,1055,"6 de julio de 1997"
9,14,6,1958,371,437,808,"6 de julio de 1997"
9,14,6,1959,450,532,982,"6 de julio de 1997"
9,14,6,1960,708,834,1542,"6 de julio de 1997"
9,14,6,1961,444,467,911,"6 de julio de 1997"
9,14,6,1962,462,490,952,"6 de julio de 1997"
9,14,6,1963,248,269,517,"6 de julio de 1997"
9,14,6,1964,602,673,1275,"6 de julio de 1997"
9,14,6,1965,298,279,577,"6 de julio de 1997"
9,14,6,1966,260,299,559,"6 de julio de 1997"
9,14,6,1967,514,573,1087,"6 de julio de 1997"
9,14,6,1968,436,463,899,"6 de julio de 1997"
9,14,6,1969,669,770,1439,"6 de julio de 1997"
9,14,6,1970,410,485,895,"6 de julio de 1997"
9,14,14,4269,494,691,1185,"6 de julio de 1997"
9,14,14,4282,483,631,1114,"6 de julio de 1997"
9,14,14,4283,556,729,1285,"6 de julio de 1997"
9,14,14,4284,624,730,1354,"6 de julio de 1997"
9,14,14,4285,531,665,1196,"6 de julio de 1997"
9,14,14,4286,490,605,1095,"6 de julio de 1997"
9,14,14,4287,451,562,1013,"6 de julio de 1997"
9,14,14,4288,504,606,1110,"6 de julio de 1997"
9,14,14,4289,444,564,1008,"6 de julio de 1997"
9,14,14,4299,389,547,936,"6 de julio de 1997"
9,14,14,4300,542,621,1163,"6 de julio de 1997"
9,14,14,4301,553,686,1239,"6 de julio de 1997"
9,14,14,4302,649,832,1481,"6 de julio de 1997"
9,14,14,4303,637,807,1444,"6 de julio de 1997"
9,14,14,4304,529,664,1193,"6 de julio de 1997"
9,14,14,4316,631,717,1348,"6 de julio de 1997"
9,14,14,4317,361,424,785,"6 de julio de 1997"
9,14,14,4318,454,505,959,"6 de julio de 1997"
9,14,14,4319,338,381,719,"6 de julio de 1997"
9,14,14,4327,605,708,1313,"6 de julio de 1997"
9,14,14,4328,257,293,550,"6 de julio de 1997"
9,14,14,4329,382,477,859,"6 de julio de 1997"
9,14,14,4357,619,769,1388,"6 de julio de 1997"
9,14,14,4358,691,897,1588,"6 de julio de 1997"
9,14,14,4359,627,746,1373,"6 de julio de 1997"
9,14,14,4360,603,726,1329,"6 de julio de 1997"
9,14,14,4361,652,733,1385,"6 de julio de 1997"
9,14,14,4375,624,704,1328,"6 de julio de 1997"
9,14,14,4376,665,789,1454,"6 de julio de 1997"
9,14,14,4377,726,806,1532,"6 de julio de 1997"
9,14,14,4378,558,694,1252,"6 de julio de 1997"
9,14,14,4379,745,861,1606,"6 de julio de 1997"
9,14,14,4380,530,656,1186,"6 de julio de 1997"
9,14,14,4381,652,803,1455,"6 de julio de 1997"
9,14,14,4382,576,684,1260,"6 de julio de 1997"
9,14,14,4400,207,270,477,"6 de julio de 1997"
9,14,14,4401,545,647,1192,"6 de julio de 1997"
9,14,14,4402,378,462,840,"6 de julio de 1997"
9,14,14,4403,217,272,489,"6 de julio de 1997"
9,14,14,4404,610,750,1360,"6 de julio de 1997"
9,14,14,4405,699,859,1558,"6 de julio de 1997"
9,14,14,4406,609,659,1268,"6 de julio de 1997"
9,14,14,4407,347,385,732,"6 de julio de 1997"
9,14,14,4430,656,767,1423,"6 de julio de 1997"
9,14,14,4431,571,641,1212,"6 de julio de 1997"
9,14,14,4432,656,780,1436,"6 de julio de 1997"
9,14,14,4433,657,744,1401,"6 de julio de 1997"
9,14,14,4434,717,823,1540,"6 de julio de 1997"
9,14,14,4435,607,769,1376,"6 de julio de 1997"
9,14,14,4436,631,745,1376,"6 de julio de 1997"
9,14,14,4437,671,885,1556,"6 de julio de 1997"
9,14,14,4438,382,471,853,"6 de julio de 1997"
9,14,14,4439,566,705,1271,"6 de julio de 1997"
9,14,14,4440,705,858,1563,"6 de julio de 1997"
9,14,14,4441,582,721,1303,"6 de julio de 1997"
9,14,14,4442,577,736,1313,"6 de julio de 1997"
9,14,14,4443,561,721,1282,"6 de julio de 1997"
9,14,14,4444,706,832,1538,"6 de julio de 1997"
9,14,14,4445,359,446,805,"6 de julio de 1997"
9,14,14,4482,603,736,1339,"6 de julio de 1997"
9,14,14,4483,434,589,1023,"6 de julio de 1997"
9,14,14,4488,647,735,1382,"6 de julio de 1997"
9,14,14,4489,650,830,1480,"6 de julio de 1997"
9,14,14,4502,643,786,1429,"6 de julio de 1997"
9,15,14,4270,565,668,1233,"6 de julio de 1997"
9,15,14,4271,595,669,1264,"6 de julio de 1997"
9,15,14,4272,424,571,995,"6 de julio de 1997"
9,15,14,4273,693,799,1492,"6 de julio de 1997"
9,15,14,4274,398,496,894,"6 de julio de 1997"
9,15,14,4275,407,549,956,"6 de julio de 1997"
9,15,14,4276,485,647,1132,"6 de julio de 1997"
9,15,14,4277,483,680,1163,"6 de julio de 1997"
9,15,14,4278,527,628,1155,"6 de julio de 1997"
9,15,14,4279,519,645,1164,"6 de julio de 1997"
9,15,14,4280,559,667,1226,"6 de julio de 1997"
9,15,14,4281,608,718,1326,"6 de julio de 1997"
9,15,14,4290,547,689,1236,"6 de julio de 1997"
9,15,14,4291,661,829,1490,"6 de julio de 1997"
9,15,14,4292,399,516,915,"6 de julio de 1997"
9,15,14,4293,275,434,709,"6 de julio de 1997"
9,15,14,4294,270,373,643,"6 de julio de 1997"
9,15,14,4295,338,487,825,"6 de julio de 1997"
9,15,14,4296,523,680,1203,"6 de julio de 1997"
9,15,14,4297,518,686,1204,"6 de julio de 1997"
9,15,14,4298,436,589,1025,"6 de julio de 1997"
9,15,14,4305,543,700,1243,"6 de julio de 1997"
9,15,14,4306,465,617,1082,"6 de julio de 1997"
9,15,14,4307,500,673,1173,"6 de julio de 1997"
9,15,14,4308,575,767,1342,"6 de julio de 1997"
9,15,14,4309,572,759,1331,"6 de julio de 1997"
9,15,14,4310,433,536,969,"6 de julio de 1997"
9,15,14,4311,659,875,1534,"6 de julio de 1997"
9,15,14,4312,430,552,982,"6 de julio de 1997"
9,15,14,4313,390,499,889,"6 de julio de 1997"
9,15,14,4314,442,569,1011,"6 de julio de 1997"
9,15,14,4315,520,712,1232,"6 de julio de 1997"
9,15,14,4320,477,662,1139,"6 de julio de 1997"
9,15,14,4321,673,934,1607,"6 de julio de 1997"
9,15,14,4322,345,468,813,"6 de julio de 1997"
9,15,14,4323,547,773,1320,"6 de julio de 1997"
9,15,14,4324,388,530,918,"6 de julio de 1997"
9,15,14,4325,447,576,1023,"6 de julio de 1997"
9,15,14,4326,207,273,480,"6 de julio de 1997"
9,15,14,4330,228,272,500,"6 de julio de 1997"
9,15,14,4331,450,618,1068,"6 de julio de 1997"
9,15,14,4332,264,369,633,"6 de julio de 1997"
9,15,14,4333,343,518,861,"6 de julio de 1997"
9,15,14,4334,562,743,1305,"6 de julio de 1997"
9,15,14,4335,453,671,1124,"6 de julio de 1997"
9,15,14,4336,520,701,1221,"6 de julio de 1997"
9,15,14,4337,390,532,922,"6 de julio de 1997"
9,15,14,4338,471,687,1158,"6 de julio de 1997"
9,15,14,4339,536,699,1235,"6 de julio de 1997"
9,15,14,4340,444,654,1098,"6 de julio de 1997"
9,15,14,4341,401,532,933,"6 de julio de 1997"
9,15,14,4342,473,641,1114,"6 de julio de 1997"
9,15,14,4343,417,562,979,"6 de julio de 1997"
9,15,14,4344,409,616,1025,"6 de julio de 1997"
9,15,14,4345,465,735,1200,"6 de julio de 1997"
9,15,14,4346,383,492,875,"6 de julio de 1997"
9,15,14,4347,564,720,1284,"6 de julio de 1997"
9,15,14,4348,555,703,1258,"6 de julio de 1997"
9,15,14,4349,369,548,917,"6 de julio de 1997"
9,15,14,4350,453,623,1076,"6 de julio de 1997"
9,15,14,4351,417,612,1029,"6 de julio de 1997"
9,15,14,4352,467,671,1138,"6 de julio de 1997"
9,15,14,4353,409,579,988,"6 de julio de 1997"
9,15,14,4354,511,675,1186,"6 de julio de 1997"
9,15,14,4355,605,746,1351,"6 de julio de 1997"
9,15,14,4356,534,675,1209,"6 de julio de 1997"
9,15,14,4362,624,788,1412,"6 de julio de 1997"
9,15,14,4363,521,674,1195,"6 de julio de 1997"
9,15,14,4364,426,545,971,"6 de julio de 1997"
9,15,14,4365,596,845,1441,"6 de julio de 1997"
9,15,14,4366,458,687,1145,"6 de julio de 1997"
9,15,14,4367,431,633,1064,"6 de julio de 1997"
9,15,14,4368,471,668,1139,"6 de julio de 1997"
9,15,14,4369,464,600,1064,"6 de julio de 1997"
9,15,14,4370,567,757,1324,"6 de julio de 1997"
9,15,14,4371,455,600,1055,"6 de julio de 1997"
9,15,14,4372,414,600,1014,"6 de julio de 1997"
9,15,14,4373,505,712,1217,"6 de julio de 1997"
9,15,14,4374,623,868,1491,"6 de julio de 1997"
9,15,14,4383,520,663,1183,"6 de julio de 1997"
9,15,14,4384,530,722,1252,"6 de julio de 1997"
9,15,14,4385,574,736,1310,"6 de julio de 1997"
9,15,14,4386,645,857,1502,"6 de julio de 1997"
9,15,14,4387,617,856,1473,"6 de julio de 1997"
9,15,14,4388,458,575,1033,"6 de julio de 1997"
9,15,14,4389,664,869,1533,"6 de julio de 1997"
9,15,14,4390,475,727,1202,"6 de julio de 1997"
9,15,14,4391,567,773,1340,"6 de julio de 1997"
9,15,14,4392,436,642,1078,"6 de julio de 1997"
9,15,14,4393,354,482,836,"6 de julio de 1997"
9,15,14,4394,484,659,1143,"6 de julio de 1997"
9,15,14,4395,388,533,921,"6 de julio de 1997"
9,15,14,4396,477,671,1148,"6 de julio de 1997"
9,15,14,4397,535,714,1249,"6 de julio de 1997"
9,15,14,4398,445,621,1066,"6 de julio de 1997"
9,15,14,4399,605,803,1408,"6 de julio de 1997"
9,15,14,4408,435,522,957,"6 de julio de 1997"
9,15,14,4409,421,583,1004,"6 de julio de 1997"
9,15,14,4410,478,624,1102,"6 de julio de 1997"
9,15,14,4411,601,757,1358,"6 de julio de 1997"
9,15,14,4412,624,835,1459,"6 de julio de 1997"
9,15,14,4413,471,568,1039,"6 de julio de 1997"
9,15,14,4414,654,834,1488,"6 de julio de 1997"
9,15,14,4415,293,460,753,"6 de julio de 1997"
9,15,14,4416,310,424,734,"6 de julio de 1997"
9,15,14,4417,454,555,1009,"6 de julio de 1997"
9,15,14,4418,389,522,911,"6 de julio de 1997"
9,15,14,4419,650,832,1482,"6 de julio de 1997"
9,15,14,4420,699,832,1531,"6 de julio de 1997"
9,15,14,4421,549,635,1184,"6 de julio de 1997"
9,15,14,4422,723,892,1615,"6 de julio de 1997"
9,15,14,4423,394,513,907,"6 de julio de 1997"
9,15,14,4424,439,651,1090,"6 de julio de 1997"
9,15,14,4425,385,468,853,"6 de julio de 1997"
9,15,14,4426,370,439,809,"6 de julio de 1997"
9,15,14,4427,548,648,1196,"6 de julio de 1997"
9,15,14,4428,511,657,1168,"6 de julio de 1997"
9,15,14,4429,350,491,841,"6 de julio de 1997"
9,15,14,4446,719,870,1589,"6 de julio de 1997"
9,15,14,4447,348,454,802,"6 de julio de 1997"
9,15,14,4448,645,823,1468,"6 de julio de 1997"
9,15,14,4449,584,773,1357,"6 de julio de 1997"
9,15,14,4450,324,525,849,"6 de julio de 1997"
9,15,14,4451,322,431,753,"6 de julio de 1997"
9,15,14,4452,610,796,1406,"6 de julio de 1997"
9,15,14,4453,671,792,1463,"6 de julio de 1997"
9,15,14,4454,635,774,1409,"6 de julio de 1997"
9,15,14,4455,337,439,776,"6 de julio de 1997"
9,15,14,4456,481,610,1091,"6 de julio de 1997"
9,15,14,4457,456,649,1105,"6 de julio de 1997"
9,15,14,4458,437,581,1018,"6 de julio de 1997"
9,15,14,4459,285,442,727,"6 de julio de 1997"
9,15,14,4460,475,700,1175,"6 de julio de 1997"
9,15,14,4461,584,856,1440,"6 de julio de 1997"
9,15,14,4462,457,657,1114,"6 de julio de 1997"
9,15,14,4463,462,692,1154,"6 de julio de 1997"
9,15,14,4464,508,793,1301,"6 de julio de 1997"
9,15,14,4465,396,542,938,"6 de julio de 1997"
9,15,14,4466,643,897,1540,"6 de julio de 1997"
9,15,14,4467,281,369,650,"6 de julio de 1997"
9,15,14,4468,474,648,1122,"6 de julio de 1997"
9,15,14,4469,234,413,647,"6 de julio de 1997"
9,15,14,4470,488,688,1176,"6 de julio de 1997"
9,15,14,4471,688,867,1555,"6 de julio de 1997"
9,15,14,4472,586,747,1333,"6 de julio de 1997"
9,15,14,4473,509,648,1157,"6 de julio de 1997"
9,15,14,4474,279,346,625,"6 de julio de 1997"
9,15,14,4475,565,805,1370,"6 de julio de 1997"
9,15,14,4476,427,595,1022,"6 de julio de 1997"
9,15,14,4477,486,621,1107,"6 de julio de 1997"
9,15,14,4478,332,485,817,"6 de julio de 1997"
9,15,14,4479,356,444,800,"6 de julio de 1997"
9,15,14,4480,271,444,715,"6 de julio de 1997"
9,15,14,4481,286,417,703,"6 de julio de 1997"
9,15,14,4484,724,818,1542,"6 de julio de 1997"
9,15,14,4485,553,619,1172,"6 de julio de 1997"
9,15,14,4486,620,721,1341,"6 de julio de 1997"
9,15,14,4487,623,752,1375,"6 de julio de 1997"
9,15,14,4490,553,692,1245,"6 de julio de 1997"
9,15,14,4491,570,687,1257,"6 de julio de 1997"
9,15,14,4492,678,767,1445,"6 de julio de 1997"
9,15,14,4493,639,780,1419,"6 de julio de 1997"
9,15,14,4494,378,455,833,"6 de julio de 1997"
9,15,14,4495,484,651,1135,"6 de julio de 1997"
9,15,14,4496,390,500,890,"6 de julio de 1997"
9,15,14,4497,245,337,582,"6 de julio de 1997"
9,15,14,4498,510,629,1139,"6 de julio de 1997"
9,15,14,4499,470,561,1031,"6 de julio de 1997"
9,15,14,4500,546,635,1181,"6 de julio de 1997"
9,15,14,4501,569,708,1277,"6 de julio de 1997"
9,15,14,4503,685,786,1471,"6 de julio de 1997"
9,15,14,4504,573,790,1363,"6 de julio de 1997"
9,15,14,4505,545,677,1222,"6 de julio de 1997"
9,15,14,4506,421,497,918,"6 de julio de 1997"
9,15,14,4507,715,1017,1732,"6 de julio de 1997"
9,15,14,4508,674,844,1518,"6 de julio de 1997"
9,15,14,4509,291,387,678,"6 de julio de 1997"
9,15,14,4510,546,675,1221,"6 de julio de 1997"
9,15,14,4511,674,866,1540,"6 de julio de 1997"
9,15,14,4512,626,787,1413,"6 de julio de 1997"
9,15,14,4513,427,558,985,"6 de julio de 1997"
9,15,14,4514,591,779,1370,"6 de julio de 1997"
9,15,14,4515,415,492,907,"6 de julio de 1997"
9,15,14,4516,440,503,943,"6 de julio de 1997"
9,15,14,4517,215,299,514,"6 de julio de 1997"
9,15,14,4518,356,416,772,"6 de julio de 1997"
9,15,14,4519,658,873,1531,"6 de julio de 1997"
9,15,14,4520,334,434,768,"6 de julio de 1997"
9,15,14,4521,398,460,858,"6 de julio de 1997"
9,15,14,4522,349,500,849,"6 de julio de 1997"
9,16,10,3163,546,537,1083,"6 de julio de 1997"
9,16,10,3164,487,553,1040,"6 de julio de 1997"
9,16,10,3165,555,623,1178,"6 de julio de 1997"
9,16,10,3166,430,494,924,"6 de julio de 1997"
9,16,10,3167,356,430,786,"6 de julio de 1997"
9,16,10,3168,569,676,1245,"6 de julio de 1997"
9,16,10,3169,481,543,1024,"6 de julio de 1997"
9,16,10,3170,182,213,395,"6 de julio de 1997"
9,16,10,3179,730,771,1501,"6 de julio de 1997"
9,16,10,3180,443,476,919,"6 de julio de 1997"
9,16,10,3181,368,484,852,"6 de julio de 1997"
9,16,10,3182,516,665,1181,"6 de julio de 1997"
9,16,10,3183,603,680,1283,"6 de julio de 1997"
9,16,10,3184,495,548,1043,"6 de julio de 1997"
9,16,10,3185,565,613,1178,"6 de julio de 1997"
9,16,10,3186,524,552,1076,"6 de julio de 1997"
9,16,10,3187,526,543,1069,"6 de julio de 1997"
9,16,10,3188,590,655,1245,"6 de julio de 1997"
9,16,10,3189,703,794,1497,"6 de julio de 1997"
9,16,10,3190,421,485,906,"6 de julio de 1997"
9,16,10,3191,551,655,1206,"6 de julio de 1997"
9,16,10,3192,568,595,1163,"6 de julio de 1997"
9,16,10,3193,579,638,1217,"6 de julio de 1997"
9,16,10,3194,664,708,1372,"6 de julio de 1997"
9,16,10,3195,725,754,1479,"6 de julio de 1997"
9,16,10,3196,562,610,1172,"6 de julio de 1997"
9,16,10,3197,502,573,1075,"6 de julio de 1997"
9,16,10,3198,412,473,885,"6 de julio de 1997"
9,16,10,3199,426,482,908,"6 de julio de 1997"
9,16,10,3200,403,452,855,"6 de julio de 1997"
9,16,10,3201,385,418,803,"6 de julio de 1997"
9,16,10,3202,591,619,1210,"6 de julio de 1997"
9,16,10,3203,421,503,924,"6 de julio de 1997"
9,16,10,3204,475,559,1034,"6 de julio de 1997"
9,16,10,3205,421,486,907,"6 de julio de 1997"
9,16,10,3206,400,457,857,"6 de julio de 1997"
9,16,10,3207,418,452,870,"6 de julio de 1997"
9,16,10,3208,374,431,805,"6 de julio de 1997"
9,16,10,3209,384,421,805,"6 de julio de 1997"
9,16,10,3210,670,717,1387,"6 de julio de 1997"
9,16,10,3211,428,459,887,"6 de julio de 1997"
9,16,10,3212,779,814,1593,"6 de julio de 1997"
9,16,10,3213,668,684,1352,"6 de julio de 1997"
9,16,10,3214,535,624,1159,"6 de julio de 1997"
9,16,10,3215,380,442,822,"6 de julio de 1997"
9,16,10,3216,472,540,1012,"6 de julio de 1997"
9,16,10,3249,601,654,1255,"6 de julio de 1997"
9,16,10,3250,534,580,1114,"6 de julio de 1997"
9,16,10,3251,489,565,1054,"6 de julio de 1997"
9,16,10,3252,436,472,908,"6 de julio de 1997"
9,16,10,3253,723,831,1554,"6 de julio de 1997"
9,16,10,3254,723,803,1526,"6 de julio de 1997"
9,16,10,3255,461,567,1028,"6 de julio de 1997"
9,16,10,3256,511,646,1157,"6 de julio de 1997"
9,16,10,3257,386,502,888,"6 de julio de 1997"
9,16,10,3258,392,501,893,"6 de julio de 1997"
9,16,10,3259,383,447,830,"6 de julio de 1997"
9,16,10,3260,544,559,1103,"6 de julio de 1997"
9,16,10,3261,451,557,1008,"6 de julio de 1997"
9,16,10,3262,435,475,910,"6 de julio de 1997"
9,16,10,3263,701,746,1447,"6 de julio de 1997"
9,16,10,3264,565,660,1225,"6 de julio de 1997"
9,16,10,3265,604,601,1205,"6 de julio de 1997"
9,16,10,3266,535,581,1116,"6 de julio de 1997"
9,16,10,3267,563,624,1187,"6 de julio de 1997"
9,16,10,3285,453,503,956,"6 de julio de 1997"
9,16,10,3286,666,707,1373,"6 de julio de 1997"
9,16,10,3287,454,513,967,"6 de julio de 1997"
9,16,10,3288,474,501,975,"6 de julio de 1997"
9,16,10,3289,611,653,1264,"6 de julio de 1997"
9,16,10,3290,413,436,849,"6 de julio de 1997"
9,16,10,3291,673,742,1415,"6 de julio de 1997"
9,16,10,3292,412,415,827,"6 de julio de 1997"
9,16,10,3293,483,582,1065,"6 de julio de 1997"
9,16,10,3294,405,528,933,"6 de julio de 1997"
9,16,10,3295,317,406,723,"6 de julio de 1997"
9,16,10,3296,645,718,1363,"6 de julio de 1997"
9,16,10,3297,510,556,1066,"6 de julio de 1997"
9,16,10,3298,774,844,1618,"6 de julio de 1997"
9,16,10,3299,483,547,1030,"6 de julio de 1997"
9,16,10,3300,594,626,1220,"6 de julio de 1997"
9,16,10,3301,623,697,1320,"6 de julio de 1997"
9,16,10,3302,627,672,1299,"6 de julio de 1997"
9,16,10,3303,513,576,1089,"6 de julio de 1997"
9,16,10,3304,361,400,761,"6 de julio de 1997"
9,16,10,3305,641,631,1272,"6 de julio de 1997"
9,16,10,3306,563,634,1197,"6 de julio de 1997"
9,16,10,3307,511,556,1067,"6 de julio de 1997"
9,16,10,3308,484,548,1032,"6 de julio de 1997"
9,16,10,3309,543,573,1116,"6 de julio de 1997"
9,16,10,3310,548,606,1154,"6 de julio de 1997"
9,16,10,3311,579,663,1242,"6 de julio de 1997"
9,16,10,3312,492,543,1035,"6 de julio de 1997"
9,16,10,3313,444,513,957,"6 de julio de 1997"
9,16,10,3314,622,655,1277,"6 de julio de 1997"
9,16,10,3315,760,882,1642,"6 de julio de 1997"
9,16,10,3316,571,654,1225,"6 de julio de 1997"
9,16,10,3320,468,523,991,"6 de julio de 1997"
9,16,10,3321,696,744,1440,"6 de julio de 1997"
9,16,10,3322,600,672,1272,"6 de julio de 1997"
9,16,10,3323,776,865,1641,"6 de julio de 1997"
9,16,10,3324,528,548,1076,"6 de julio de 1997"
9,16,10,3325,464,532,996,"6 de julio de 1997"
9,16,10,3326,502,543,1045,"6 de julio de 1997"
9,16,10,3327,459,528,987,"6 de julio de 1997"
9,16,10,3328,562,614,1176,"6 de julio de 1997"
9,16,10,3329,558,615,1173,"6 de julio de 1997"
9,16,10,3330,639,606,1245,"6 de julio de 1997"
9,16,10,3331,356,374,730,"6 de julio de 1997"
9,16,10,3332,490,551,1041,"6 de julio de 1997"
9,16,10,3333,580,588,1168,"6 de julio de 1997"
9,16,10,3334,475,559,1034,"6 de julio de 1997"
9,16,10,3335,406,419,825,"6 de julio de 1997"
9,16,10,3336,473,500,973,"6 de julio de 1997"
9,16,10,3337,648,658,1306,"6 de julio de 1997"
9,16,10,3338,624,700,1324,"6 de julio de 1997"
9,16,10,3339,399,436,835,"6 de julio de 1997"
9,16,10,3340,520,566,1086,"6 de julio de 1997"
9,16,10,3341,644,726,1370,"6 de julio de 1997"
9,16,10,3342,333,420,753,"6 de julio de 1997"
9,16,10,3343,474,500,974,"6 de julio de 1997"
9,16,10,3344,548,600,1148,"6 de julio de 1997"
9,16,10,3345,481,520,1001,"6 de julio de 1997"
9,16,10,3346,406,470,876,"6 de julio de 1997"
9,16,10,3347,496,588,1084,"6 de julio de 1997"
9,16,10,3348,594,692,1286,"6 de julio de 1997"
9,16,10,3349,550,626,1176,"6 de julio de 1997"
9,16,10,3350,620,707,1327,"6 de julio de 1997"
9,16,10,3351,676,778,1454,"6 de julio de 1997"
9,16,10,3352,638,709,1347,"6 de julio de 1997"
9,16,10,3353,301,338,639,"6 de julio de 1997"
9,16,10,3354,629,699,1328,"6 de julio de 1997"
9,16,10,3365,354,424,778,"6 de julio de 1997"
9,16,10,3366,269,335,604,"6 de julio de 1997"
9,16,10,3367,307,392,699,"6 de julio de 1997"
9,16,10,3368,318,373,691,"6 de julio de 1997"
9,16,10,3369,397,472,869,"6 de julio de 1997"
9,16,10,3384,457,524,981,"6 de julio de 1997"
9,16,10,3385,490,543,1033,"6 de julio de 1997"
9,16,10,3399,289,285,574,"6 de julio de 1997"
9,16,10,3400,197,204,401,"6 de julio de 1997"
9,16,10,3403,358,433,791,"6 de julio de 1997"
9,16,10,3404,485,505,990,"6 de julio de 1997"
9,16,10,3405,410,453,863,"6 de julio de 1997"
9,16,10,3406,355,424,779,"6 de julio de 1997"
9,16,10,3407,471,539,1010,"6 de julio de 1997"
9,16,10,3408,262,349,611,"6 de julio de 1997"
9,16,10,3409,501,639,1140,"6 de julio de 1997"
9,16,10,3410,495,546,1041,"6 de julio de 1997"
9,16,10,3411,544,647,1191,"6 de julio de 1997"
9,16,10,3412,464,508,972,"6 de julio de 1997"
9,16,10,3413,412,502,914,"6 de julio de 1997"
9,16,10,3414,400,467,867,"6 de julio de 1997"
9,16,10,3415,453,521,974,"6 de julio de 1997"
9,16,10,3416,618,711,1329,"6 de julio de 1997"
9,16,10,3417,521,615,1136,"6 de julio de 1997"
9,16,10,3418,768,853,1621,"6 de julio de 1997"
9,16,10,3419,555,617,1172,"6 de julio de 1997"
9,16,10,3473,416,495,911,"6 de julio de 1997"
9,16,10,3477,337,387,724,"6 de julio de 1997"
9,17,4,747,435,428,863,"6 de julio de 1997"
9,17,4,748,797,934,1731,"6 de julio de 1997"
9,17,4,749,309,389,698,"6 de julio de 1997"
9,17,4,750,406,415,821,"6 de julio de 1997"
9,17,4,751,372,472,844,"6 de julio de 1997"
9,17,4,752,379,417,796,"6 de julio de 1997"
9,17,4,753,473,525,998,"6 de julio de 1997"
9,17,4,754,834,874,1708,"6 de julio de 1997"
9,17,4,755,549,552,1101,"6 de julio de 1997"
9,17,4,756,321,343,664,"6 de julio de 1997"
9,17,4,757,682,706,1388,"6 de julio de 1997"
9,17,4,758,687,718,1405,"6 de julio de 1997"
9,17,4,759,539,696,1235,"6 de julio de 1997"
9,17,4,760,319,417,736,"6 de julio de 1997"
9,17,4,761,581,639,1220,"6 de julio de 1997"
9,17,4,762,457,507,964,"6 de julio de 1997"
9,17,4,763,625,706,1331,"6 de julio de 1997"
9,17,4,764,639,628,1267,"6 de julio de 1997"
9,17,4,765,749,778,1527,"6 de julio de 1997"
9,17,4,766,395,486,881,"6 de julio de 1997"
9,17,4,767,695,743,1438,"6 de julio de 1997"
9,17,4,768,275,289,564,"6 de julio de 1997"
9,17,4,769,473,569,1042,"6 de julio de 1997"
9,17,4,770,613,656,1269,"6 de julio de 1997"
9,17,4,771,511,534,1045,"6 de julio de 1997"
9,17,4,772,480,587,1067,"6 de julio de 1997"
9,17,4,773,600,622,1222,"6 de julio de 1997"
9,17,4,774,213,215,428,"6 de julio de 1997"
9,17,4,775,581,604,1185,"6 de julio de 1997"
9,17,4,776,572,611,1183,"6 de julio de 1997"
9,17,4,777,422,460,882,"6 de julio de 1997"
9,17,4,778,623,688,1311,"6 de julio de 1997"
9,17,4,779,425,508,933,"6 de julio de 1997"
9,17,4,780,441,470,911,"6 de julio de 1997"
9,17,4,781,645,722,1367,"6 de julio de 1997"
9,17,4,782,506,517,1023,"6 de julio de 1997"
9,17,4,783,491,531,1022,"6 de julio de 1997"
9,17,4,784,419,506,925,"6 de julio de 1997"
9,17,4,785,416,465,881,"6 de julio de 1997"
9,17,4,786,551,579,1130,"6 de julio de 1997"
9,17,4,787,521,509,1030,"6 de julio de 1997"
9,17,4,788,573,605,1178,"6 de julio de 1997"
9,17,4,789,440,451,891,"6 de julio de 1997"
9,17,4,790,683,732,1415,"6 de julio de 1997"
9,17,4,791,683,785,1468,"6 de julio de 1997"
9,17,4,792,578,652,1230,"6 de julio de 1997"
9,17,4,793,698,747,1445,"6 de julio de 1997"
9,17,4,794,602,690,1292,"6 de julio de 1997"
9,17,4,795,701,800,1501,"6 de julio de 1997"
9,17,4,796,640,691,1331,"6 de julio de 1997"
9,17,4,797,776,864,1640,"6 de julio de 1997"
9,17,4,798,580,597,1177,"6 de julio de 1997"
9,17,4,799,719,794,1513,"6 de julio de 1997"
9,17,4,800,447,500,947,"6 de julio de 1997"
9,17,4,801,582,693,1275,"6 de julio de 1997"
9,17,4,802,465,512,977,"6 de julio de 1997"
9,17,4,803,392,433,825,"6 de julio de 1997"
9,17,4,804,434,505,939,"6 de julio de 1997"
9,17,4,805,533,567,1100,"6 de julio de 1997"
9,17,4,806,739,754,1493,"6 de julio de 1997"
9,17,4,807,525,607,1132,"6 de julio de 1997"
9,17,4,808,339,388,727,"6 de julio de 1997"
9,17,4,809,597,612,1209,"6 de julio de 1997"
9,17,4,810,528,576,1104,"6 de julio de 1997"
9,17,4,811,645,652,1297,"6 de julio de 1997"
9,17,4,812,511,573,1084,"6 de julio de 1997"
9,17,4,813,202,198,400,"6 de julio de 1997"
9,17,4,814,732,816,1548,"6 de julio de 1997"
9,17,4,815,511,557,1068,"6 de julio de 1997"
9,17,4,816,606,689,1295,"6 de julio de 1997"
9,17,4,817,272,286,558,"6 de julio de 1997"
9,17,4,818,268,300,568,"6 de julio de 1997"
9,17,4,819,502,510,1012,"6 de julio de 1997"
9,17,4,820,332,341,673,"6 de julio de 1997"
9,17,4,5536,239,276,515,"6 de julio de 1997"
9,17,10,3171,467,505,972,"6 de julio de 1997"
9,17,10,3172,426,501,927,"6 de julio de 1997"
9,17,10,3173,569,688,1257,"6 de julio de 1997"
9,17,10,3174,1105,543,1648,"6 de julio de 1997"
9,17,10,3175,961,704,1665,"6 de julio de 1997"
9,17,10,3176,653,703,1356,"6 de julio de 1997"
9,17,10,3177,544,560,1104,"6 de julio de 1997"
9,17,10,3178,310,137,447,"6 de julio de 1997"
9,17,10,3235,319,393,712,"6 de julio de 1997"
9,17,10,3236,735,807,1542,"6 de julio de 1997"
9,17,10,3237,454,522,976,"6 de julio de 1997"
9,17,10,3238,444,543,987,"6 de julio de 1997"
9,17,10,3239,625,660,1285,"6 de julio de 1997"
9,17,10,3240,444,480,924,"6 de julio de 1997"
9,17,10,3241,606,629,1235,"6 de julio de 1997"
9,17,10,3242,640,721,1361,"6 de julio de 1997"
9,17,10,3243,240,261,501,"6 de julio de 1997"
9,17,10,3244,436,551,987,"6 de julio de 1997"
9,17,10,3245,611,679,1290,"6 de julio de 1997"
9,17,10,3246,386,412,798,"6 de julio de 1997"
9,17,10,3247,327,340,667,"6 de julio de 1997"
9,17,10,3248,506,576,1082,"6 de julio de 1997"
9,17,10,3268,585,605,1190,"6 de julio de 1997"
9,17,10,3269,644,660,1304,"6 de julio de 1997"
9,17,10,3270,558,568,1126,"6 de julio de 1997"
9,17,10,3271,625,631,1256,"6 de julio de 1997"
9,17,10,3272,574,595,1169,"6 de julio de 1997"
9,17,10,3273,365,379,744,"6 de julio de 1997"
9,17,10,3274,585,660,1245,"6 de julio de 1997"
9,17,10,3275,437,497,934,"6 de julio de 1997"
9,17,10,3276,615,614,1229,"6 de julio de 1997"
9,17,10,3277,635,683,1318,"6 de julio de 1997"
9,17,10,3278,644,716,1360,"6 de julio de 1997"
9,17,10,3279,660,690,1350,"6 de julio de 1997"
9,17,10,3280,393,407,800,"6 de julio de 1997"
9,17,10,3281,535,603,1138,"6 de julio de 1997"
9,17,10,3282,429,462,891,"6 de julio de 1997"
9,17,10,3283,568,644,1212,"6 de julio de 1997"
9,17,10,3284,444,450,894,"6 de julio de 1997"
9,17,10,3317,507,589,1096,"6 de julio de 1997"
9,17,10,3318,636,649,1285,"6 de julio de 1997"
9,17,10,3319,449,421,870,"6 de julio de 1997"
9,17,10,3355,200,225,425,"6 de julio de 1997"
9,17,10,3356,524,578,1102,"6 de julio de 1997"
9,17,10,3357,437,506,943,"6 de julio de 1997"
9,17,10,3358,610,732,1342,"6 de julio de 1997"
9,17,10,3359,439,492,931,"6 de julio de 1997"
9,17,10,3360,440,489,929,"6 de julio de 1997"
9,17,10,3361,397,403,800,"6 de julio de 1997"
9,17,10,3362,502,531,1033,"6 de julio de 1997"
9,17,10,3363,380,389,769,"6 de julio de 1997"
9,17,10,3364,580,631,1211,"6 de julio de 1997"
9,17,10,3370,450,471,921,"6 de julio de 1997"
9,17,10,3371,631,714,1345,"6 de julio de 1997"
9,17,10,3372,295,276,571,"6 de julio de 1997"
9,17,10,3373,232,233,465,"6 de julio de 1997"
9,17,10,3374,527,596,1123,"6 de julio de 1997"
9,17,10,3375,615,680,1295,"6 de julio de 1997"
9,17,10,3376,294,272,566,"6 de julio de 1997"
9,17,10,3377,569,642,1211,"6 de julio de 1997"
9,17,10,3378,511,621,1132,"6 de julio de 1997"
9,17,10,3379,603,635,1238,"6 de julio de 1997"
9,17,10,3380,707,734,1441,"6 de julio de 1997"
9,17,10,3381,509,525,1034,"6 de julio de 1997"
9,17,10,3382,526,585,1111,"6 de julio de 1997"
9,17,10,3383,384,436,820,"6 de julio de 1997"
9,17,10,3386,547,611,1158,"6 de julio de 1997"
9,17,10,3387,503,548,1051,"6 de julio de 1997"
9,17,10,3388,645,706,1351,"6 de julio de 1997"
9,17,10,3389,646,700,1346,"6 de julio de 1997"
9,17,10,3390,598,677,1275,"6 de julio de 1997"
9,17,10,3391,944,1042,1986,"6 de julio de 1997"
9,17,10,3392,440,488,928,"6 de julio de 1997"
9,17,10,3393,567,683,1250,"6 de julio de 1997"
9,17,10,3394,522,559,1081,"6 de julio de 1997"
9,17,10,3395,430,467,897,"6 de julio de 1997"
9,17,10,3396,557,563,1120,"6 de julio de 1997"
9,17,10,3397,536,672,1208,"6 de julio de 1997"
9,17,10,3398,344,385,729,"6 de julio de 1997"
9,17,10,3401,248,275,523,"6 de julio de 1997"
9,17,10,3402,245,276,521,"6 de julio de 1997"
9,18,7,1971,497,525,1022,"6 de julio de 1997"
9,18,7,1972,389,478,867,"6 de julio de 1997"
9,18,7,1973,334,433,767,"6 de julio de 1997"
9,18,7,1974,560,699,1259,"6 de julio de 1997"
9,18,7,1975,524,587,1111,"6 de julio de 1997"
9,18,7,1976,673,715,1388,"6 de julio de 1997"
9,18,7,1977,206,205,411,"6 de julio de 1997"
9,18,7,1978,367,411,778,"6 de julio de 1997"
9,18,7,1979,458,573,1031,"6 de julio de 1997"
9,18,7,1980,441,540,981,"6 de julio de 1997"
9,18,7,1981,462,513,975,"6 de julio de 1997"
9,18,7,1982,460,553,1013,"6 de julio de 1997"
9,18,7,1983,448,482,930,"6 de julio de 1997"
9,18,7,1984,377,454,831,"6 de julio de 1997"
9,18,7,1985,350,424,774,"6 de julio de 1997"
9,18,7,1986,384,484,868,"6 de julio de 1997"
9,18,7,1987,441,495,936,"6 de julio de 1997"
9,18,7,1988,327,306,633,"6 de julio de 1997"
9,18,7,1989,547,671,1218,"6 de julio de 1997"
9,18,7,1990,525,532,1057,"6 de julio de 1997"
9,18,7,1991,515,511,1026,"6 de julio de 1997"
9,18,7,1992,471,511,982,"6 de julio de 1997"
9,18,7,1993,548,549,1097,"6 de julio de 1997"
9,18,7,1994,450,490,940,"6 de julio de 1997"
9,18,7,1995,455,465,920,"6 de julio de 1997"
9,18,7,1996,389,424,813,"6 de julio de 1997"
9,18,7,1997,494,541,1035,"6 de julio de 1997"
9,18,7,1998,534,540,1074,"6 de julio de 1997"
9,18,7,1999,494,536,1030,"6 de julio de 1997"
9,18,7,2000,533,551,1084,"6 de julio de 1997"
9,18,7,2001,516,519,1035,"6 de julio de 1997"
9,18,7,2002,594,610,1204,"6 de julio de 1997"
9,18,7,2003,497,482,979,"6 de julio de 1997"
9,18,7,2004,534,545,1079,"6 de julio de 1997"
9,18,7,2005,559,612,1171,"6 de julio de 1997"
9,18,7,2006,481,461,942,"6 de julio de 1997"
9,18,7,2007,453,554,1007,"6 de julio de 1997"
9,18,7,2008,350,346,696,"6 de julio de 1997"
9,18,7,2009,285,289,574,"6 de julio de 1997"
9,18,7,2010,623,676,1299,"6 de julio de 1997"
9,18,7,2011,463,549,1012,"6 de julio de 1997"
9,18,7,2012,427,504,931,"6 de julio de 1997"
9,18,7,2013,616,653,1269,"6 de julio de 1997"
9,18,7,2014,540,554,1094,"6 de julio de 1997"
9,18,7,2015,519,521,1040,"6 de julio de 1997"
9,18,7,2016,533,560,1093,"6 de julio de 1997"
9,18,7,2017,512,608,1120,"6 de julio de 1997"
9,18,7,2018,601,655,1256,"6 de julio de 1997"
9,18,7,2019,463,473,936,"6 de julio de 1997"
9,18,7,2020,482,486,968,"6 de julio de 1997"
9,18,7,2021,463,509,972,"6 de julio de 1997"
9,18,7,2027,666,730,1396,"6 de julio de 1997"
9,18,7,2028,661,657,1318,"6 de julio de 1997"
9,18,7,2029,557,598,1155,"6 de julio de 1997"
9,18,7,2030,709,738,1447,"6 de julio de 1997"
9,18,7,2031,466,545,1011,"6 de julio de 1997"
9,18,7,2032,482,544,1026,"6 de julio de 1997"
9,18,7,2033,400,447,847,"6 de julio de 1997"
9,18,7,2034,395,432,827,"6 de julio de 1997"
9,18,7,2035,593,670,1263,"6 de julio de 1997"
9,18,7,2036,267,335,602,"6 de julio de 1997"
9,18,7,2037,242,297,539,"6 de julio de 1997"
9,18,7,2038,429,489,918,"6 de julio de 1997"
9,18,7,2039,575,623,1198,"6 de julio de 1997"
9,18,7,2040,487,538,1025,"6 de julio de 1997"
9,18,7,2041,370,429,799,"6 de julio de 1997"
9,18,7,2042,657,662,1319,"6 de julio de 1997"
9,18,7,2043,566,540,1106,"6 de julio de 1997"
9,18,7,2044,745,867,1612,"6 de julio de 1997"
9,18,7,2045,377,409,786,"6 de julio de 1997"
9,18,7,2046,447,492,939,"6 de julio de 1997"
9,18,7,2047,596,666,1262,"6 de julio de 1997"
9,18,7,2048,629,718,1347,"6 de julio de 1997"
9,18,7,2049,489,578,1067,"6 de julio de 1997"
9,18,7,2050,789,879,1668,"6 de julio de 1997"
9,18,7,2051,603,698,1301,"6 de julio de 1997"
9,18,7,2052,567,605,1172,"6 de julio de 1997"
9,18,7,2053,705,780,1485,"6 de julio de 1997"
9,18,7,2054,226,279,505,"6 de julio de 1997"
9,18,7,2056,883,960,1843,"6 de julio de 1997"
9,18,7,2057,659,739,1398,"6 de julio de 1997"
9,18,7,2058,596,642,1238,"6 de julio de 1997"
9,18,7,2059,206,231,437,"6 de julio de 1997"
9,18,7,2060,271,280,551,"6 de julio de 1997"
9,18,7,2061,189,178,367,"6 de julio de 1997"
9,18,7,2062,357,381,738,"6 de julio de 1997"
9,18,7,2063,395,415,810,"6 de julio de 1997"
9,18,7,2064,205,284,489,"6 de julio de 1997"
9,18,7,2065,614,642,1256,"6 de julio de 1997"
9,18,7,2066,331,377,708,"6 de julio de 1997"
9,18,7,2067,633,680,1313,"6 de julio de 1997"
9,18,7,2068,568,648,1216,"6 de julio de 1997"
9,18,7,2069,536,562,1098,"6 de julio de 1997"
9,18,7,2070,440,478,918,"6 de julio de 1997"
9,18,7,2071,528,603,1131,"6 de julio de 1997"
9,18,7,2072,592,715,1307,"6 de julio de 1997"
9,18,7,2073,490,585,1075,"6 de julio de 1997"
9,18,7,2074,266,317,583,"6 de julio de 1997"
9,18,7,2075,313,388,701,"6 de julio de 1997"
9,18,7,2076,488,529,1017,"6 de julio de 1997"
9,18,7,2077,492,542,1034,"6 de julio de 1997"
9,18,7,2078,459,488,947,"6 de julio de 1997"
9,18,7,2079,573,614,1187,"6 de julio de 1997"
9,18,7,2080,959,1158,2117,"6 de julio de 1997"
9,18,7,2081,567,630,1197,"6 de julio de 1997"
9,18,7,2082,569,676,1245,"6 de julio de 1997"
9,18,7,2083,282,323,605,"6 de julio de 1997"
9,18,7,2084,478,506,984,"6 de julio de 1997"
9,18,7,2085,162,168,330,"6 de julio de 1997"
9,18,7,2086,437,471,908,"6 de julio de 1997"
9,18,7,2087,386,414,800,"6 de julio de 1997"
9,18,7,2088,509,541,1050,"6 de julio de 1997"
9,18,7,2089,525,565,1090,"6 de julio de 1997"
9,18,7,2090,362,445,807,"6 de julio de 1997"
9,18,7,2091,603,684,1287,"6 de julio de 1997"
9,18,7,2092,514,587,1101,"6 de julio de 1997"
9,18,7,2093,650,737,1387,"6 de julio de 1997"
9,18,7,2094,671,769,1440,"6 de julio de 1997"
9,18,7,2095,327,352,679,"6 de julio de 1997"
9,18,7,2096,308,405,713,"6 de julio de 1997"
9,18,7,2097,362,386,748,"6 de julio de 1997"
9,18,7,2098,275,349,624,"6 de julio de 1997"
9,18,7,2099,409,458,867,"6 de julio de 1997"
9,18,7,2100,428,452,880,"6 de julio de 1997"
9,18,7,2101,594,674,1268,"6 de julio de 1997"
9,18,7,2102,620,674,1294,"6 de julio de 1997"
9,18,7,2103,342,366,708,"6 de julio de 1997"
9,18,7,2104,434,514,948,"6 de julio de 1997"
9,18,7,2105,451,474,925,"6 de julio de 1997"
9,18,7,2157,608,698,1306,"6 de julio de 1997"
9,18,7,2158,504,599,1103,"6 de julio de 1997"
9,18,7,2159,530,551,1081,"6 de julio de 1997"
9,18,7,2160,367,407,774,"6 de julio de 1997"
9,18,7,2161,517,594,1111,"6 de julio de 1997"
9,18,7,2162,591,662,1253,"6 de julio de 1997"
9,18,7,2199,607,709,1316,"6 de julio de 1997"
9,18,7,2200,377,435,812,"6 de julio de 1997"
9,18,7,2201,573,703,1276,"6 de julio de 1997"
9,18,7,2202,552,630,1182,"6 de julio de 1997"
9,18,7,2203,526,588,1114,"6 de julio de 1997"
9,18,7,2204,384,444,828,"6 de julio de 1997"
9,18,7,2205,499,532,1031,"6 de julio de 1997"
9,18,7,2206,672,750,1422,"6 de julio de 1997"
9,18,7,2207,1133,1320,2453,"6 de julio de 1997"
9,18,7,2208,572,598,1170,"6 de julio de 1997"
9,18,7,2209,433,474,907,"6 de julio de 1997"
9,18,7,2210,490,579,1069,"6 de julio de 1997"
9,18,7,2211,534,622,1156,"6 de julio de 1997"
9,18,7,2212,573,581,1154,"6 de julio de 1997"
9,18,7,2213,381,491,872,"6 de julio de 1997"
9,18,7,2214,610,791,1401,"6 de julio de 1997"
9,18,7,2215,306,329,635,"6 de julio de 1997"
9,18,7,2216,256,321,577,"6 de julio de 1997"
9,18,7,2217,283,334,617,"6 de julio de 1997"
9,18,7,2218,1035,1258,2293,"6 de julio de 1997"
9,18,7,2219,408,459,867,"6 de julio de 1997"
9,18,7,2220,923,1040,1963,"6 de julio de 1997"
9,18,7,2221,565,609,1174,"6 de julio de 1997"
9,18,7,2222,527,569,1096,"6 de julio de 1997"
9,18,7,2244,605,682,1287,"6 de julio de 1997"
9,18,7,2245,729,785,1514,"6 de julio de 1997"
9,18,7,2246,599,638,1237,"6 de julio de 1997"
9,18,7,2247,409,440,849,"6 de julio de 1997"
9,18,7,2248,366,432,798,"6 de julio de 1997"
9,18,7,2249,535,621,1156,"6 de julio de 1997"
9,18,7,2250,410,406,816,"6 de julio de 1997"
9,18,7,2262,522,600,1122,"6 de julio de 1997"
9,18,7,2263,559,633,1192,"6 de julio de 1997"
9,18,7,2264,306,392,698,"6 de julio de 1997"
9,18,7,2265,347,399,746,"6 de julio de 1997"
9,18,7,2266,347,416,763,"6 de julio de 1997"
9,18,7,2267,387,441,828,"6 de julio de 1997"
9,18,7,2268,608,680,1288,"6 de julio de 1997"
9,18,7,2269,468,536,1004,"6 de julio de 1997"
9,18,7,2270,624,739,1363,"6 de julio de 1997"
9,18,7,2271,398,500,898,"6 de julio de 1997"
9,18,7,2302,664,784,1448,"6 de julio de 1997"
9,18,7,2303,582,664,1246,"6 de julio de 1997"
9,18,7,2304,578,642,1220,"6 de julio de 1997"
9,18,7,2305,483,589,1072,"6 de julio de 1997"
9,18,7,2306,684,777,1461,"6 de julio de 1997"
9,18,7,2312,390,441,831,"6 de julio de 1997"
9,18,7,2327,138,191,329,"6 de julio de 1997"
9,18,7,2328,186,245,431,"6 de julio de 1997"
9,18,7,2329,359,406,765,"6 de julio de 1997"
9,18,7,2330,409,507,916,"6 de julio de 1997"
9,18,7,2332,350,410,760,"6 de julio de 1997"
9,18,7,2334,393,448,841,"6 de julio de 1997"
9,18,7,2336,232,290,522,"6 de julio de 1997"
9,18,7,2337,87,135,222,"6 de julio de 1997"
9,18,7,2501,603,685,1288,"6 de julio de 1997"
9,18,7,2502,558,600,1158,"6 de julio de 1997"
9,18,7,2503,228,253,481,"6 de julio de 1997"
9,18,7,2504,566,612,1178,"6 de julio de 1997"
9,18,7,2505,687,746,1433,"6 de julio de 1997"
9,18,7,2506,428,466,894,"6 de julio de 1997"
9,18,7,2507,533,560,1093,"6 de julio de 1997"
9,18,7,2508,218,251,469,"6 de julio de 1997"
9,18,7,2509,402,467,869,"6 de julio de 1997"
9,18,7,2968,249,292,541,"6 de julio de 1997"
9,18,7,2969,222,257,479,"6 de julio de 1997"
9,18,7,2970,368,413,781,"6 de julio de 1997"
9,18,7,2971,121,114,235,"6 de julio de 1997"
9,18,7,5516,141,177,318,"6 de julio de 1997"
9,19,7,2106,492,577,1069,"6 de julio de 1997"
9,19,7,2107,601,628,1229,"6 de julio de 1997"
9,19,7,2108,617,676,1293,"6 de julio de 1997"
9,19,7,2109,438,479,917,"6 de julio de 1997"
9,19,7,2110,486,526,1012,"6 de julio de 1997"
9,19,7,2111,568,604,1172,"6 de julio de 1997"
9,19,7,2112,597,638,1235,"6 de julio de 1997"
9,19,7,2113,601,604,1205,"6 de julio de 1997"
9,19,7,2114,526,560,1086,"6 de julio de 1997"
9,19,7,2115,599,632,1231,"6 de julio de 1997"
9,19,7,2116,613,677,1290,"6 de julio de 1997"
9,19,7,2117,559,622,1181,"6 de julio de 1997"
9,19,7,2118,517,595,1112,"6 de julio de 1997"
9,19,7,2119,313,349,662,"6 de julio de 1997"
9,19,7,2120,529,577,1106,"6 de julio de 1997"
9,19,7,2121,635,699,1334,"6 de julio de 1997"
9,19,7,2122,369,420,789,"6 de julio de 1997"
9,19,7,2123,460,530,990,"6 de julio de 1997"
9,19,7,2124,308,360,668,"6 de julio de 1997"
9,19,7,2125,541,610,1151,"6 de julio de 1997"
9,19,7,2126,405,438,843,"6 de julio de 1997"
9,19,7,2127,557,567,1124,"6 de julio de 1997"
9,19,7,2128,559,630,1189,"6 de julio de 1997"
9,19,7,2129,568,627,1195,"6 de julio de 1997"
9,19,7,2130,417,526,943,"6 de julio de 1997"
9,19,7,2131,431,496,927,"6 de julio de 1997"
9,19,7,2132,660,730,1390,"6 de julio de 1997"
9,19,7,2133,679,741,1420,"6 de julio de 1997"
9,19,7,2134,663,698,1361,"6 de julio de 1997"
9,19,7,2135,567,632,1199,"6 de julio de 1997"
9,19,7,2136,441,489,930,"6 de julio de 1997"
9,19,7,2137,497,523,1020,"6 de julio de 1997"
9,19,7,2138,617,688,1305,"6 de julio de 1997"
9,19,7,2139,571,629,1200,"6 de julio de 1997"
9,19,7,2140,597,665,1262,"6 de julio de 1997"
9,19,7,2141,585,653,1238,"6 de julio de 1997"
9,19,7,2142,475,488,963,"6 de julio de 1997"
9,19,7,2143,585,644,1229,"6 de julio de 1997"
9,19,7,2144,569,647,1216,"6 de julio de 1997"
9,19,7,2145,494,564,1058,"6 de julio de 1997"
9,19,7,2146,618,673,1291,"6 de julio de 1997"
9,19,7,2147,484,502,986,"6 de julio de 1997"
9,19,7,2148,499,533,1032,"6 de julio de 1997"
9,19,7,2149,543,621,1164,"6 de julio de 1997"
9,19,7,2150,543,528,1071,"6 de julio de 1997"
9,19,7,2151,675,735,1410,"6 de julio de 1997"
9,19,7,2152,426,459,885,"6 de julio de 1997"
9,19,7,2153,589,621,1210,"6 de julio de 1997"
9,19,7,2154,519,622,1141,"6 de julio de 1997"
9,19,7,2155,599,627,1226,"6 de julio de 1997"
9,19,7,2156,577,632,1209,"6 de julio de 1997"
9,19,7,2163,495,562,1057,"6 de julio de 1997"
9,19,7,2164,693,713,1406,"6 de julio de 1997"
9,19,7,2165,653,728,1381,"6 de julio de 1997"
9,19,7,2166,386,421,807,"6 de julio de 1997"
9,19,7,2167,621,660,1281,"6 de julio de 1997"
9,19,7,2168,482,610,1092,"6 de julio de 1997"
9,19,7,2169,329,353,682,"6 de julio de 1997"
9,19,7,2170,379,458,837,"6 de julio de 1997"
9,19,7,2171,396,456,852,"6 de julio de 1997"
9,19,7,2172,485,545,1030,"6 de julio de 1997"
9,19,7,2173,579,654,1233,"6 de julio de 1997"
9,19,7,2174,583,664,1247,"6 de julio de 1997"
9,19,7,2175,592,581,1173,"6 de julio de 1997"
9,19,7,2176,531,614,1145,"6 de julio de 1997"
9,19,7,2177,465,542,1007,"6 de julio de 1997"
9,19,7,2178,666,738,1404,"6 de julio de 1997"
9,19,7,2179,528,598,1126,"6 de julio de 1997"
9,19,7,2180,589,674,1263,"6 de julio de 1997"
9,19,7,2181,625,667,1292,"6 de julio de 1997"
9,19,7,2182,628,758,1386,"6 de julio de 1997"
9,19,7,2183,517,598,1115,"6 de julio de 1997"
9,19,7,2184,456,489,945,"6 de julio de 1997"
9,19,7,2185,646,656,1302,"6 de julio de 1997"
9,19,7,2186,512,563,1075,"6 de julio de 1997"
9,19,7,2187,640,692,1332,"6 de julio de 1997"
9,19,7,2188,617,634,1251,"6 de julio de 1997"
9,19,7,2189,625,686,1311,"6 de julio de 1997"
9,19,7,2190,579,666,1245,"6 de julio de 1997"
9,19,7,2191,550,605,1155,"6 de julio de 1997"
9,19,7,2192,525,593,1118,"6 de julio de 1997"
9,19,7,2193,661,784,1445,"6 de julio de 1997"
9,19,7,2194,561,658,1219,"6 de julio de 1997"
9,19,7,2195,497,543,1040,"6 de julio de 1997"
9,19,7,2196,486,494,980,"6 de julio de 1997"
9,19,7,2197,513,587,1100,"6 de julio de 1997"
9,19,7,2198,327,427,754,"6 de julio de 1997"
9,19,7,2223,279,308,587,"6 de julio de 1997"
9,19,7,2224,556,589,1145,"6 de julio de 1997"
9,19,7,2225,531,561,1092,"6 de julio de 1997"
9,19,7,2226,609,645,1254,"6 de julio de 1997"
9,19,7,2227,441,474,915,"6 de julio de 1997"
9,19,7,2228,495,549,1044,"6 de julio de 1997"
9,19,7,2229,538,570,1108,"6 de julio de 1997"
9,19,7,2230,535,605,1140,"6 de julio de 1997"
9,19,7,2231,493,500,993,"6 de julio de 1997"
9,19,7,2232,557,622,1179,"6 de julio de 1997"
9,19,7,2233,394,421,815,"6 de julio de 1997"
9,19,7,2234,553,607,1160,"6 de julio de 1997"
9,19,7,2235,530,587,1117,"6 de julio de 1997"
9,19,7,2236,473,465,938,"6 de julio de 1997"
9,19,7,2237,532,549,1081,"6 de julio de 1997"
9,19,7,2238,512,556,1068,"6 de julio de 1997"
9,19,7,2239,586,633,1219,"6 de julio de 1997"
9,19,7,2240,655,715,1370,"6 de julio de 1997"
9,19,7,2241,476,590,1066,"6 de julio de 1997"
9,19,7,2242,409,493,902,"6 de julio de 1997"
9,19,7,2243,432,460,892,"6 de julio de 1997"
9,19,7,2251,456,499,955,"6 de julio de 1997"
9,19,7,2252,684,746,1430,"6 de julio de 1997"
9,19,7,2253,592,643,1235,"6 de julio de 1997"
9,19,7,2254,592,658,1250,"6 de julio de 1997"
9,19,7,2255,653,724,1377,"6 de julio de 1997"
9,19,7,2256,529,528,1057,"6 de julio de 1997"
9,19,7,2257,574,627,1201,"6 de julio de 1997"
9,19,7,2258,506,587,1093,"6 de julio de 1997"
9,19,7,2259,554,614,1168,"6 de julio de 1997"
9,19,7,2260,671,758,1429,"6 de julio de 1997"
9,19,7,2261,503,593,1096,"6 de julio de 1997"
9,19,7,2272,467,529,996,"6 de julio de 1997"
9,19,7,2273,516,566,1082,"6 de julio de 1997"
9,19,7,2274,601,681,1282,"6 de julio de 1997"
9,19,7,2275,588,663,1251,"6 de julio de 1997"
9,19,7,2276,595,665,1260,"6 de julio de 1997"
9,19,7,2277,577,617,1194,"6 de julio de 1997"
9,19,7,2278,596,630,1226,"6 de julio de 1997"
9,19,7,2279,561,591,1152,"6 de julio de 1997"
9,19,7,2280,601,667,1268,"6 de julio de 1997"
9,19,7,2281,581,621,1202,"6 de julio de 1997"
9,19,7,2282,577,620,1197,"6 de julio de 1997"
9,19,7,2283,585,584,1169,"6 de julio de 1997"
9,19,7,2284,377,399,776,"6 de julio de 1997"
9,19,7,2285,85,97,182,"6 de julio de 1997"
9,19,7,2286,468,495,963,"6 de julio de 1997"
9,19,7,2287,529,523,1052,"6 de julio de 1997"
9,19,7,2288,566,561,1127,"6 de julio de 1997"
9,19,7,2289,611,659,1270,"6 de julio de 1997"
9,19,7,2290,554,626,1180,"6 de julio de 1997"
9,19,7,2291,425,492,917,"6 de julio de 1997"
9,19,7,2292,606,662,1268,"6 de julio de 1997"
9,19,7,2293,493,583,1076,"6 de julio de 1997"
9,19,7,2294,562,589,1151,"6 de julio de 1997"
9,19,7,2295,485,513,998,"6 de julio de 1997"
9,19,7,2296,540,600,1140,"6 de julio de 1997"
9,19,7,2297,587,639,1226,"6 de julio de 1997"
9,19,7,2298,715,757,1472,"6 de julio de 1997"
9,19,7,2299,482,527,1009,"6 de julio de 1997"
9,19,7,2300,395,452,847,"6 de julio de 1997"
9,19,7,2301,626,750,1376,"6 de julio de 1997"
9,19,7,2307,317,337,654,"6 de julio de 1997"
9,19,7,2308,395,436,831,"6 de julio de 1997"
9,19,7,2309,794,1003,1797,"6 de julio de 1997"
9,19,7,2310,624,716,1340,"6 de julio de 1997"
9,19,7,2311,428,508,936,"6 de julio de 1997"
9,19,7,2313,584,664,1248,"6 de julio de 1997"
9,19,7,2314,418,470,888,"6 de julio de 1997"
9,19,7,2315,570,651,1221,"6 de julio de 1997"
9,19,7,2316,719,789,1508,"6 de julio de 1997"
9,19,7,2317,592,665,1257,"6 de julio de 1997"
9,19,7,2318,438,483,921,"6 de julio de 1997"
9,19,7,2319,442,516,958,"6 de julio de 1997"
9,19,7,2320,735,813,1548,"6 de julio de 1997"
9,19,7,2321,691,743,1434,"6 de julio de 1997"
9,19,7,2322,361,421,782,"6 de julio de 1997"
9,19,7,2323,351,390,741,"6 de julio de 1997"
9,19,7,2324,386,459,845,"6 de julio de 1997"
9,19,7,2325,382,437,819,"6 de julio de 1997"
9,19,7,2326,568,644,1212,"6 de julio de 1997"
9,19,7,2331,541,663,1204,"6 de julio de 1997"
9,19,7,2333,471,552,1023,"6 de julio de 1997"
9,19,7,2335,346,388,734,"6 de julio de 1997"
9,19,7,2338,961,1090,2051,"6 de julio de 1997"
9,19,7,2339,128,148,276,"6 de julio de 1997"
9,19,7,5517,158,222,380,"6 de julio de 1997"
9,20,7,2022,342,427,769,"6 de julio de 1997"
9,20,7,2023,439,509,948,"6 de julio de 1997"
9,20,7,2024,601,654,1255,"6 de julio de 1997"
9,20,7,2025,493,525,1018,"6 de julio de 1997"
9,20,7,2026,557,654,1211,"6 de julio de 1997"
9,20,7,2055,552,632,1184,"6 de julio de 1997"
9,20,7,2340,396,435,831,"6 de julio de 1997"
9,20,7,2341,541,662,1203,"6 de julio de 1997"
9,20,7,2342,339,383,722,"6 de julio de 1997"
9,20,7,2343,494,578,1072,"6 de julio de 1997"
9,20,7,2344,406,503,909,"6 de julio de 1997"
9,20,7,2345,421,541,962,"6 de julio de 1997"
9,20,7,2346,476,597,1073,"6 de julio de 1997"
9,20,7,2347,472,575,1047,"6 de julio de 1997"
9,20,7,2348,535,615,1150,"6 de julio de 1997"
9,20,7,2349,378,462,840,"6 de julio de 1997"
9,20,7,2350,635,733,1368,"6 de julio de 1997"
9,20,7,2351,611,707,1318,"6 de julio de 1997"
9,20,7,2352,446,496,942,"6 de julio de 1997"
9,20,7,2353,500,602,1102,"6 de julio de 1997"
9,20,7,2354,518,596,1114,"6 de julio de 1997"
9,20,7,2355,592,631,1223,"6 de julio de 1997"
9,20,7,2356,500,535,1035,"6 de julio de 1997"
9,20,7,2357,465,530,995,"6 de julio de 1997"
9,20,7,2358,525,597,1122,"6 de julio de 1997"
9,20,7,2359,515,552,1067,"6 de julio de 1997"
9,20,7,2360,574,629,1203,"6 de julio de 1997"
9,20,7,2361,540,602,1142,"6 de julio de 1997"
9,20,7,2362,563,604,1167,"6 de julio de 1997"
9,20,7,2363,597,633,1230,"6 de julio de 1997"
9,20,7,2364,458,487,945,"6 de julio de 1997"
9,20,7,2365,491,549,1040,"6 de julio de 1997"
9,20,7,2366,505,530,1035,"6 de julio de 1997"
9,20,7,2367,562,555,1117,"6 de julio de 1997"
9,20,7,2368,491,535,1026,"6 de julio de 1997"
9,20,7,2369,438,487,925,"6 de julio de 1997"
9,20,7,2370,552,614,1166,"6 de julio de 1997"
9,20,7,2371,263,285,548,"6 de julio de 1997"
9,20,7,2372,355,388,743,"6 de julio de 1997"
9,20,7,2373,491,549,1040,"6 de julio de 1997"
9,20,7,2374,229,242,471,"6 de julio de 1997"
9,20,7,2375,283,330,613,"6 de julio de 1997"
9,20,7,2376,377,421,798,"6 de julio de 1997"
9,20,7,2377,343,394,737,"6 de julio de 1997"
9,20,7,2378,338,417,755,"6 de julio de 1997"
9,20,7,2379,456,522,978,"6 de julio de 1997"
9,20,7,2380,414,468,882,"6 de julio de 1997"
9,20,7,2381,657,732,1389,"6 de julio de 1997"
9,20,7,2382,415,446,861,"6 de julio de 1997"
9,20,7,2383,30,45,75,"6 de julio de 1997"
9,20,7,2384,433,481,914,"6 de julio de 1997"
9,20,7,2385,708,728,1436,"6 de julio de 1997"
9,20,7,2386,598,656,1254,"6 de julio de 1997"
9,20,7,2387,607,646,1253,"6 de julio de 1997"
9,20,7,2388,401,442,843,"6 de julio de 1997"
9,20,7,2389,569,585,1154,"6 de julio de 1997"
9,20,7,2390,433,425,858,"6 de julio de 1997"
9,20,7,2391,574,669,1243,"6 de julio de 1997"
9,20,7,2392,600,669,1269,"6 de julio de 1997"
9,20,7,2393,633,673,1306,"6 de julio de 1997"
9,20,7,2394,473,447,920,"6 de julio de 1997"
9,20,7,2395,398,354,752,"6 de julio de 1997"
9,20,7,2396,601,587,1188,"6 de julio de 1997"
9,20,7,2397,633,646,1279,"6 de julio de 1997"
9,20,7,2398,597,645,1242,"6 de julio de 1997"
9,20,7,2399,698,697,1395,"6 de julio de 1997"
9,20,7,2400,755,777,1532,"6 de julio de 1997"
9,20,7,2401,544,581,1125,"6 de julio de 1997"
9,20,7,2402,533,573,1106,"6 de julio de 1997"
9,20,7,2403,656,772,1428,"6 de julio de 1997"
9,20,7,2404,574,674,1248,"6 de julio de 1997"
9,20,7,2405,562,631,1193,"6 de julio de 1997"
9,20,7,2406,729,780,1509,"6 de julio de 1997"
9,20,7,2407,652,787,1439,"6 de julio de 1997"
9,20,7,2408,689,762,1451,"6 de julio de 1997"
9,20,7,2409,789,806,1595,"6 de julio de 1997"
9,20,7,2410,557,593,1150,"6 de julio de 1997"
9,20,7,2411,362,404,766,"6 de julio de 1997"
9,20,7,2412,227,246,473,"6 de julio de 1997"
9,20,7,2413,494,582,1076,"6 de julio de 1997"
9,20,7,2414,292,313,605,"6 de julio de 1997"
9,20,7,2415,390,442,832,"6 de julio de 1997"
9,20,7,2416,349,431,780,"6 de julio de 1997"
9,20,7,2417,310,387,697,"6 de julio de 1997"
9,20,7,2418,382,435,817,"6 de julio de 1997"
9,20,7,2419,372,428,800,"6 de julio de 1997"
9,20,7,2420,483,568,1051,"6 de julio de 1997"
9,20,7,2421,543,656,1199,"6 de julio de 1997"
9,20,7,2422,315,406,721,"6 de julio de 1997"
9,20,7,2423,347,400,747,"6 de julio de 1997"
9,20,7,2424,519,604,1123,"6 de julio de 1997"
9,20,7,2425,583,675,1258,"6 de julio de 1997"
9,20,7,2426,423,489,912,"6 de julio de 1997"
9,20,7,2427,355,426,781,"6 de julio de 1997"
9,20,7,2428,258,352,610,"6 de julio de 1997"
9,20,7,2429,494,558,1052,"6 de julio de 1997"
9,20,7,2430,580,640,1220,"6 de julio de 1997"
9,20,7,2431,387,460,847,"6 de julio de 1997"
9,20,7,2432,535,631,1166,"6 de julio de 1997"
9,20,7,2433,628,690,1318,"6 de julio de 1997"
9,20,7,2434,452,557,1009,"6 de julio de 1997"
9,20,7,2435,357,435,792,"6 de julio de 1997"
9,20,7,2436,657,781,1438,"6 de julio de 1997"
9,20,7,2437,577,599,1176,"6 de julio de 1997"
9,20,7,2438,539,591,1130,"6 de julio de 1997"
9,20,7,2439,577,622,1199,"6 de julio de 1997"
9,20,7,2440,504,577,1081,"6 de julio de 1997"
9,20,7,2441,423,466,889,"6 de julio de 1997"
9,20,7,2442,429,528,957,"6 de julio de 1997"
9,20,7,2443,369,477,846,"6 de julio de 1997"
9,20,7,2444,421,489,910,"6 de julio de 1997"
9,20,7,2445,614,717,1331,"6 de julio de 1997"
9,20,7,2446,342,369,711,"6 de julio de 1997"
9,20,7,2447,471,479,950,"6 de julio de 1997"
9,20,7,2448,448,502,950,"6 de julio de 1997"
9,20,7,2449,624,679,1303,"6 de julio de 1997"
9,20,7,2450,490,568,1058,"6 de julio de 1997"
9,20,7,2451,588,663,1251,"6 de julio de 1997"
9,20,7,2452,337,426,763,"6 de julio de 1997"
9,20,7,2453,369,511,880,"6 de julio de 1997"
9,20,7,2454,716,885,1601,"6 de julio de 1997"
9,20,7,2455,243,300,543,"6 de julio de 1997"
9,20,7,2456,354,467,821,"6 de julio de 1997"
9,20,7,2457,410,501,911,"6 de julio de 1997"
9,20,7,2458,481,557,1038,"6 de julio de 1997"
9,20,7,2459,475,562,1037,"6 de julio de 1997"
9,20,7,2460,476,510,986,"6 de julio de 1997"
9,20,7,2461,517,576,1093,"6 de julio de 1997"
9,20,7,2462,515,555,1070,"6 de julio de 1997"
9,20,7,2463,474,552,1026,"6 de julio de 1997"
9,20,7,2464,505,572,1077,"6 de julio de 1997"
9,20,7,2465,473,541,1014,"6 de julio de 1997"
9,20,7,2466,582,674,1256,"6 de julio de 1997"
9,20,7,2467,486,569,1055,"6 de julio de 1997"
9,20,7,2468,438,562,1000,"6 de julio de 1997"
9,20,7,2469,461,570,1031,"6 de julio de 1997"
9,20,7,2470,520,682,1202,"6 de julio de 1997"
9,20,7,2471,263,310,573,"6 de julio de 1997"
9,20,7,2472,383,482,865,"6 de julio de 1997"
9,20,7,2473,449,598,1047,"6 de julio de 1997"
9,20,7,2474,334,407,741,"6 de julio de 1997"
9,20,7,2475,336,472,808,"6 de julio de 1997"
9,20,7,2476,518,633,1151,"6 de julio de 1997"
9,20,7,2477,386,477,863,"6 de julio de 1997"
9,20,7,2478,199,251,450,"6 de julio de 1997"
9,20,7,2479,317,373,690,"6 de julio de 1997"
9,20,7,2480,362,503,865,"6 de julio de 1997"
9,20,7,2481,346,497,843,"6 de julio de 1997"
9,20,7,2482,554,673,1227,"6 de julio de 1997"
9,20,7,2483,557,633,1190,"6 de julio de 1997"
9,20,7,2484,538,610,1148,"6 de julio de 1997"
9,20,7,2485,545,613,1158,"6 de julio de 1997"
9,20,7,2486,584,699,1283,"6 de julio de 1997"
9,20,7,2487,495,564,1059,"6 de julio de 1997"
9,20,7,2488,433,556,989,"6 de julio de 1997"
9,20,7,2489,500,699,1199,"6 de julio de 1997"
9,20,7,2490,322,386,708,"6 de julio de 1997"
9,20,7,2491,458,521,979,"6 de julio de 1997"
9,20,7,2492,582,715,1297,"6 de julio de 1997"
9,20,7,2493,469,567,1036,"6 de julio de 1997"
9,20,7,2494,292,293,585,"6 de julio de 1997"
9,20,7,2495,255,231,486,"6 de julio de 1997"
9,20,7,2496,189,210,399,"6 de julio de 1997"
9,20,7,2497,129,148,277,"6 de julio de 1997"
9,20,7,2498,191,232,423,"6 de julio de 1997"
9,20,7,2499,339,406,745,"6 de julio de 1997"
9,20,7,2500,215,236,451,"6 de julio de 1997"
9,20,7,2510,402,519,921,"6 de julio de 1997"
9,20,7,2511,590,637,1227,"6 de julio de 1997"
9,20,7,2512,576,631,1207,"6 de julio de 1997"
9,20,7,2513,437,464,901,"6 de julio de 1997"
9,20,7,2514,709,771,1480,"6 de julio de 1997"
9,20,7,2515,388,401,789,"6 de julio de 1997"
9,20,7,2516,576,634,1210,"6 de julio de 1997"
9,20,7,2517,259,316,575,"6 de julio de 1997"
9,20,7,2536,693,813,1506,"6 de julio de 1997"
9,20,7,2537,531,578,1109,"6 de julio de 1997"
9,20,7,2538,482,487,969,"6 de julio de 1997"
9,20,7,2539,612,687,1299,"6 de julio de 1997"
9,20,7,2540,515,541,1056,"6 de julio de 1997"
9,20,7,2541,472,488,960,"6 de julio de 1997"
9,20,7,2542,264,289,553,"6 de julio de 1997"
9,20,7,2543,328,337,665,"6 de julio de 1997"
9,20,7,2544,640,660,1300,"6 de julio de 1997"
9,20,7,2545,436,499,935,"6 de julio de 1997"
9,20,7,2640,616,716,1332,"6 de julio de 1997"
9,20,7,2641,548,667,1215,"6 de julio de 1997"
9,20,7,2642,276,304,580,"6 de julio de 1997"
9,20,7,2643,608,622,1230,"6 de julio de 1997"
9,20,7,2644,407,448,855,"6 de julio de 1997"
9,20,7,2645,738,789,1527,"6 de julio de 1997"
9,20,7,2646,454,544,998,"6 de julio de 1997"
9,20,7,2647,619,726,1345,"6 de julio de 1997"
9,20,7,2648,959,1136,2095,"6 de julio de 1997"
9,20,7,2649,512,577,1089,"6 de julio de 1997"
9,20,7,2650,554,615,1169,"6 de julio de 1997"
9,20,7,2651,57,93,150,"6 de julio de 1997"
9,20,7,2652,350,410,760,"6 de julio de 1997"
9,20,7,2653,485,497,982,"6 de julio de 1997"
9,20,7,2654,635,626,1261,"6 de julio de 1997"
9,20,7,2655,538,643,1181,"6 de julio de 1997"
9,20,7,2656,501,549,1050,"6 de julio de 1997"
9,20,7,2657,555,627,1182,"6 de julio de 1997"
9,20,7,2658,461,521,982,"6 de julio de 1997"
9,20,7,2659,617,687,1304,"6 de julio de 1997"
9,20,7,2666,999,1114,2113,"6 de julio de 1997"
9,20,7,2667,702,745,1447,"6 de julio de 1997"
9,20,7,2668,326,380,706,"6 de julio de 1997"
9,20,7,2744,491,554,1045,"6 de julio de 1997"
9,20,7,2745,479,547,1026,"6 de julio de 1997"
9,20,7,2746,506,515,1021,"6 de julio de 1997"
9,20,7,2747,619,742,1361,"6 de julio de 1997"
9,21,3,359,565,669,1234,"6 de julio de 1997"
9,21,3,412,399,462,861,"6 de julio de 1997"
9,21,3,413,379,481,860,"6 de julio de 1997"
9,21,3,414,181,302,483,"6 de julio de 1997"
9,21,3,458,449,534,983,"6 de julio de 1997"
9,21,3,459,437,498,935,"6 de julio de 1997"
9,21,3,460,375,416,791,"6 de julio de 1997"
9,21,3,461,237,313,550,"6 de julio de 1997"
9,21,3,462,293,323,616,"6 de julio de 1997"
9,21,3,463,456,487,943,"6 de julio de 1997"
9,21,3,464,576,616,1192,"6 de julio de 1997"
9,21,3,465,598,666,1264,"6 de julio de 1997"
9,21,3,466,579,707,1286,"6 de julio de 1997"
9,21,3,467,493,562,1055,"6 de julio de 1997"
9,21,3,468,465,550,1015,"6 de julio de 1997"
9,21,3,469,460,590,1050,"6 de julio de 1997"
9,21,3,470,482,567,1049,"6 de julio de 1997"
9,21,3,474,509,609,1118,"6 de julio de 1997"
9,21,3,475,553,646,1199,"6 de julio de 1997"
9,21,3,476,609,718,1327,"6 de julio de 1997"
9,21,3,477,395,484,879,"6 de julio de 1997"
9,21,3,478,482,570,1052,"6 de julio de 1997"
9,21,3,480,284,364,648,"6 de julio de 1997"
9,21,3,495,327,419,746,"6 de julio de 1997"
9,21,3,512,299,383,682,"6 de julio de 1997"
9,21,3,693,119,132,251,"6 de julio de 1997"
9,21,3,727,661,841,1502,"6 de julio de 1997"
9,21,3,728,284,313,597,"6 de julio de 1997"
9,21,3,729,297,410,707,"6 de julio de 1997"
9,21,3,730,255,345,600,"6 de julio de 1997"
9,21,3,733,497,583,1080,"6 de julio de 1997"
9,21,3,734,532,723,1255,"6 de julio de 1997"
9,21,3,735,538,685,1223,"6 de julio de 1997"
9,21,3,736,273,398,671,"6 de julio de 1997"
9,21,3,737,702,942,1644,"6 de julio de 1997"
9,21,3,738,465,602,1067,"6 de julio de 1997"
9,21,3,739,278,384,662,"6 de julio de 1997"
9,21,3,740,299,383,682,"6 de julio de 1997"
9,21,3,741,369,529,898,"6 de julio de 1997"
9,21,10,3217,426,527,953,"6 de julio de 1997"
9,21,10,3218,409,446,855,"6 de julio de 1997"
9,21,10,3219,331,366,697,"6 de julio de 1997"
9,21,10,3220,132,154,286,"6 de julio de 1997"
9,21,10,3221,518,676,1194,"6 de julio de 1997"
9,21,10,3222,332,461,793,"6 de julio de 1997"
9,21,10,3223,213,330,543,"6 de julio de 1997"
9,21,10,3224,452,624,1076,"6 de julio de 1997"
9,21,10,3225,487,645,1132,"6 de julio de 1997"
9,21,10,3226,386,531,917,"6 de julio de 1997"
9,21,10,3227,445,520,965,"6 de julio de 1997"
9,21,10,3228,489,615,1104,"6 de julio de 1997"
9,21,10,3229,403,559,962,"6 de julio de 1997"
9,21,10,3230,480,613,1093,"6 de julio de 1997"
9,21,10,3231,458,577,1035,"6 de julio de 1997"
9,21,10,3232,479,598,1077,"6 de julio de 1997"
9,21,10,3233,508,703,1211,"6 de julio de 1997"
9,21,10,3234,331,404,735,"6 de julio de 1997"
9,21,10,3420,352,452,804,"6 de julio de 1997"
9,21,10,3421,599,692,1291,"6 de julio de 1997"
9,21,10,3422,250,314,564,"6 de julio de 1997"
9,21,10,3423,622,763,1385,"6 de julio de 1997"
9,21,10,3424,332,406,738,"6 de julio de 1997"
9,21,10,3425,447,503,950,"6 de julio de 1997"
9,21,10,3426,372,445,817,"6 de julio de 1997"
9,21,10,3427,322,414,736,"6 de julio de 1997"
9,21,10,3428,391,563,954,"6 de julio de 1997"
9,21,10,3429,252,339,591,"6 de julio de 1997"
9,21,10,3430,370,540,910,"6 de julio de 1997"
9,21,10,3431,376,525,901,"6 de julio de 1997"
9,21,10,3432,167,214,381,"6 de julio de 1997"
9,21,10,3433,336,435,771,"6 de julio de 1997"
9,21,10,3434,274,318,592,"6 de julio de 1997"
9,21,10,3435,144,190,334,"6 de julio de 1997"
9,21,10,3436,370,483,853,"6 de julio de 1997"
9,21,10,3437,311,363,674,"6 de julio de 1997"
9,21,10,3438,408,491,899,"6 de julio de 1997"
9,21,10,3439,324,448,772,"6 de julio de 1997"
9,21,10,3440,491,621,1112,"6 de julio de 1997"
9,21,10,3441,339,407,746,"6 de julio de 1997"
9,21,10,3442,341,438,779,"6 de julio de 1997"
9,21,10,3443,298,373,671,"6 de julio de 1997"
9,21,10,3444,422,496,918,"6 de julio de 1997"
9,21,10,3445,372,492,864,"6 de julio de 1997"
9,21,10,3446,457,559,1016,"6 de julio de 1997"
9,21,10,3447,308,387,695,"6 de julio de 1997"
9,21,10,3448,145,170,315,"6 de julio de 1997"
9,21,10,3449,608,660,1268,"6 de julio de 1997"
9,21,10,3450,426,481,907,"6 de julio de 1997"
9,21,10,3451,460,584,1044,"6 de julio de 1997"
9,21,10,3452,609,784,1393,"6 de julio de 1997"
9,21,10,3453,251,300,551,"6 de julio de 1997"
9,21,10,3454,410,537,947,"6 de julio de 1997"
9,21,10,3455,250,385,635,"6 de julio de 1997"
9,21,10,3456,428,582,1010,"6 de julio de 1997"
9,21,10,3457,579,638,1217,"6 de julio de 1997"
9,21,10,3458,468,550,1018,"6 de julio de 1997"
9,21,10,3459,357,454,811,"6 de julio de 1997"
9,21,10,3460,279,399,678,"6 de julio de 1997"
9,21,10,3461,259,376,635,"6 de julio de 1997"
9,21,10,3462,320,466,786,"6 de julio de 1997"
9,21,10,3463,527,685,1212,"6 de julio de 1997"
9,21,10,3464,295,374,669,"6 de julio de 1997"
9,21,10,3465,414,558,972,"6 de julio de 1997"
9,21,10,3466,284,412,696,"6 de julio de 1997"
9,21,10,3467,286,421,707,"6 de julio de 1997"
9,21,10,3468,341,424,765,"6 de julio de 1997"
9,21,10,3469,379,549,928,"6 de julio de 1997"
9,21,10,3470,240,400,640,"6 de julio de 1997"
9,21,10,3471,325,482,807,"6 de julio de 1997"
9,21,10,3472,395,552,947,"6 de julio de 1997"
9,21,10,3474,245,282,527,"6 de julio de 1997"
9,21,10,3475,350,415,765,"6 de julio de 1997"
9,21,10,3476,315,336,651,"6 de julio de 1997"
9,21,10,3478,475,566,1041,"6 de julio de 1997"
9,21,10,3479,496,518,1014,"6 de julio de 1997"
9,21,10,3480,703,783,1486,"6 de julio de 1997"
9,21,10,3481,363,430,793,"6 de julio de 1997"
9,21,10,3482,438,558,996,"6 de julio de 1997"
9,21,10,3483,376,466,842,"6 de julio de 1997"
9,21,10,3484,559,694,1253,"6 de julio de 1997"
9,21,10,3485,27,23,50,"6 de julio de 1997"
9,21,10,3486,787,836,1623,"6 de julio de 1997"
9,21,10,3487,379,567,946,"6 de julio de 1997"
9,21,10,3488,392,522,914,"6 de julio de 1997"
9,21,10,3489,462,604,1066,"6 de julio de 1997"
9,21,10,3490,656,744,1400,"6 de julio de 1997"
9,21,10,3491,638,746,1384,"6 de julio de 1997"
9,21,10,3492,140,177,317,"6 de julio de 1997"
9,21,10,3493,334,377,711,"6 de julio de 1997"
9,21,10,3494,553,569,1122,"6 de julio de 1997"
9,21,10,3495,391,434,825,"6 de julio de 1997"
9,21,10,3496,356,370,726,"6 de julio de 1997"
9,21,10,3497,455,508,963,"6 de julio de 1997"
9,21,10,3498,573,659,1232,"6 de julio de 1997"
9,21,10,3499,538,591,1129,"6 de julio de 1997"
9,21,10,3500,528,649,1177,"6 de julio de 1997"
9,21,10,3501,549,711,1260,"6 de julio de 1997"
9,21,10,3502,297,407,704,"6 de julio de 1997"
9,21,10,3503,412,535,947,"6 de julio de 1997"
9,21,10,3504,418,534,952,"6 de julio de 1997"
9,21,10,3505,443,602,1045,"6 de julio de 1997"
9,21,10,3506,461,531,992,"6 de julio de 1997"
9,21,10,3507,673,720,1393,"6 de julio de 1997"
9,21,10,3508,581,682,1263,"6 de julio de 1997"
9,21,10,3509,404,436,840,"6 de julio de 1997"
9,21,10,3510,576,644,1220,"6 de julio de 1997"
9,21,10,3511,463,548,1011,"6 de julio de 1997"
9,21,10,3512,360,391,751,"6 de julio de 1997"
9,21,10,3513,829,889,1718,"6 de julio de 1997"
9,21,10,3514,586,641,1227,"6 de julio de 1997"
9,21,10,3515,241,255,496,"6 de julio de 1997"
9,21,10,3516,386,486,872,"6 de julio de 1997"
9,21,10,3517,399,493,892,"6 de julio de 1997"
9,21,10,3518,452,474,926,"6 de julio de 1997"
9,21,10,3519,560,606,1166,"6 de julio de 1997"
9,21,10,3520,543,588,1131,"6 de julio de 1997"
9,21,10,3521,451,454,905,"6 de julio de 1997"
9,21,10,3522,483,510,993,"6 de julio de 1997"
9,21,10,3523,411,469,880,"6 de julio de 1997"
9,21,10,3524,389,443,832,"6 de julio de 1997"
9,21,10,3525,542,591,1133,"6 de julio de 1997"
9,21,10,3526,552,560,1112,"6 de julio de 1997"
9,21,10,3527,358,490,848,"6 de julio de 1997"
9,21,10,3528,438,569,1007,"6 de julio de 1997"
9,21,10,3529,531,594,1125,"6 de julio de 1997"
9,21,10,3530,347,437,784,"6 de julio de 1997"
9,21,10,3531,108,117,225,"6 de julio de 1997"
9,21,10,3532,565,641,1206,"6 de julio de 1997"
9,21,10,3533,506,577,1083,"6 de julio de 1997"
9,21,10,3534,352,429,781,"6 de julio de 1997"
9,21,10,3535,417,440,857,"6 de julio de 1997"
9,21,10,3536,440,497,937,"6 de julio de 1997"
9,21,10,3537,373,449,822,"6 de julio de 1997"
9,21,10,3538,319,393,712,"6 de julio de 1997"
9,21,10,3539,364,410,774,"6 de julio de 1997"
9,21,10,3540,661,749,1410,"6 de julio de 1997"
9,21,10,3541,413,459,872,"6 de julio de 1997"
9,21,10,3542,679,701,1380,"6 de julio de 1997"
9,21,10,3543,524,630,1154,"6 de julio de 1997"
9,21,10,3544,346,373,719,"6 de julio de 1997"
9,21,10,3545,462,529,991,"6 de julio de 1997"
9,21,10,3546,296,359,655,"6 de julio de 1997"
9,21,10,3547,592,689,1281,"6 de julio de 1997"
9,21,10,3548,317,382,699,"6 de julio de 1997"
9,21,10,3549,509,627,1136,"6 de julio de 1997"
9,21,10,3550,572,671,1243,"6 de julio de 1997"
9,21,10,3551,377,441,818,"6 de julio de 1997"
9,21,10,3552,419,473,892,"6 de julio de 1997"
9,21,10,3553,492,592,1084,"6 de julio de 1997"
9,21,10,3554,615,752,1367,"6 de julio de 1997"
9,21,10,3555,286,314,600,"6 de julio de 1997"
9,21,10,3556,765,894,1659,"6 de julio de 1997"
9,21,10,3557,491,654,1145,"6 de julio de 1997"
9,21,10,3562,372,450,822,"6 de julio de 1997"
9,21,10,3573,337,445,782,"6 de julio de 1997"
9,21,10,3574,349,380,729,"6 de julio de 1997"
9,21,10,3575,450,538,988,"6 de julio de 1997"
9,21,10,3576,276,341,617,"6 de julio de 1997"
9,21,10,3577,413,476,889,"6 de julio de 1997"
9,21,10,3578,700,797,1497,"6 de julio de 1997"
9,21,10,3603,116,134,250,"6 de julio de 1997"
9,21,10,3604,374,410,784,"6 de julio de 1997"
9,21,10,3605,600,626,1226,"6 de julio de 1997"
9,21,10,3608,132,161,293,"6 de julio de 1997"
9,22,7,2552,438,507,945,"6 de julio de 1997"
9,22,7,2553,456,490,946,"6 de julio de 1997"
9,22,7,2554,525,559,1084,"6 de julio de 1997"
9,22,7,2555,390,422,812,"6 de julio de 1997"
9,22,7,2556,452,463,915,"6 de julio de 1997"
9,22,7,2557,403,466,869,"6 de julio de 1997"
9,22,7,2558,485,532,1017,"6 de julio de 1997"
9,22,7,2559,508,562,1070,"6 de julio de 1997"
9,22,7,2560,475,535,1010,"6 de julio de 1997"
9,22,7,2561,469,501,970,"6 de julio de 1997"
9,22,7,2562,826,932,1758,"6 de julio de 1997"
9,22,7,2563,613,722,1335,"6 de julio de 1997"
9,22,7,2564,470,503,973,"6 de julio de 1997"
9,22,7,2565,460,516,976,"6 de julio de 1997"
9,22,7,2566,558,621,1179,"6 de julio de 1997"
9,22,7,2567,596,589,1185,"6 de julio de 1997"
9,22,7,2568,509,546,1055,"6 de julio de 1997"
9,22,7,2569,402,478,880,"6 de julio de 1997"
9,22,7,2570,680,724,1404,"6 de julio de 1997"
9,22,7,2571,704,767,1471,"6 de julio de 1997"
9,22,7,2572,600,651,1251,"6 de julio de 1997"
9,22,7,2573,499,554,1053,"6 de julio de 1997"
9,22,7,2574,596,644,1240,"6 de julio de 1997"
9,22,7,2575,597,697,1294,"6 de julio de 1997"
9,22,7,2576,452,495,947,"6 de julio de 1997"
9,22,7,2577,578,634,1212,"6 de julio de 1997"
9,22,7,2578,554,613,1167,"6 de julio de 1997"
9,22,7,2579,370,429,799,"6 de julio de 1997"
9,22,7,2580,625,674,1299,"6 de julio de 1997"
9,22,7,2581,585,596,1181,"6 de julio de 1997"
9,22,7,2582,423,486,909,"6 de julio de 1997"
9,22,7,2583,518,520,1038,"6 de julio de 1997"
9,22,7,2584,462,509,971,"6 de julio de 1997"
9,22,7,2585,416,479,895,"6 de julio de 1997"
9,22,7,2586,873,996,1869,"6 de julio de 1997"
9,22,7,2587,701,742,1443,"6 de julio de 1997"
9,22,7,2588,610,646,1256,"6 de julio de 1997"
9,22,7,2589,481,515,996,"6 de julio de 1997"
9,22,7,2590,573,584,1157,"6 de julio de 1997"
9,22,7,2591,505,548,1053,"6 de julio de 1997"
9,22,7,2592,366,408,774,"6 de julio de 1997"
9,22,7,2593,427,424,851,"6 de julio de 1997"
9,22,7,2594,543,562,1105,"6 de julio de 1997"
9,22,7,2595,540,566,1106,"6 de julio de 1997"
9,22,7,2596,530,606,1136,"6 de julio de 1997"
9,22,7,2597,578,573,1151,"6 de julio de 1997"
9,22,7,2598,477,490,967,"6 de julio de 1997"
9,22,7,2599,491,527,1018,"6 de julio de 1997"
9,22,7,2600,499,562,1061,"6 de julio de 1997"
9,22,7,2601,598,639,1237,"6 de julio de 1997"
9,22,7,2602,467,500,967,"6 de julio de 1997"
9,22,7,2603,398,466,864,"6 de julio de 1997"
9,22,7,2604,519,549,1068,"6 de julio de 1997"
9,22,7,2605,465,494,959,"6 de julio de 1997"
9,22,7,2606,424,479,903,"6 de julio de 1997"
9,22,7,2607,454,493,947,"6 de julio de 1997"
9,22,7,2608,645,696,1341,"6 de julio de 1997"
9,22,7,2609,466,491,957,"6 de julio de 1997"
9,22,7,2610,507,569,1076,"6 de julio de 1997"
9,22,7,2611,559,579,1138,"6 de julio de 1997"
9,22,7,2612,647,698,1345,"6 de julio de 1997"
9,22,7,2613,578,651,1229,"6 de julio de 1997"
9,22,7,2614,454,526,980,"6 de julio de 1997"
9,22,7,2615,550,627,1177,"6 de julio de 1997"
9,22,7,2616,722,843,1565,"6 de julio de 1997"
9,22,7,2617,683,735,1418,"6 de julio de 1997"
9,22,7,2618,491,529,1020,"6 de julio de 1997"
9,22,7,2619,602,628,1230,"6 de julio de 1997"
9,22,7,2620,576,594,1170,"6 de julio de 1997"
9,22,7,2621,534,573,1107,"6 de julio de 1997"
9,22,7,2622,407,431,838,"6 de julio de 1997"
9,22,7,2623,480,526,1006,"6 de julio de 1997"
9,22,7,2624,418,468,886,"6 de julio de 1997"
9,22,7,2625,563,560,1123,"6 de julio de 1997"
9,22,7,2626,565,581,1146,"6 de julio de 1997"
9,22,7,2627,455,509,964,"6 de julio de 1997"
9,22,7,2628,494,548,1042,"6 de julio de 1997"
9,22,7,2675,506,545,1051,"6 de julio de 1997"
9,22,7,2676,461,552,1013,"6 de julio de 1997"
9,22,7,2677,313,355,668,"6 de julio de 1997"
9,22,7,2678,532,521,1053,"6 de julio de 1997"
9,22,7,2679,623,692,1315,"6 de julio de 1997"
9,22,7,2680,523,623,1146,"6 de julio de 1997"
9,22,7,2681,488,517,1005,"6 de julio de 1997"
9,22,7,2682,498,543,1041,"6 de julio de 1997"
9,22,7,2683,507,522,1029,"6 de julio de 1997"
9,22,7,2684,561,639,1200,"6 de julio de 1997"
9,22,7,2685,668,758,1426,"6 de julio de 1997"
9,22,7,2686,483,510,993,"6 de julio de 1997"
9,22,7,2687,547,561,1108,"6 de julio de 1997"
9,22,7,2688,578,610,1188,"6 de julio de 1997"
9,22,7,2689,521,556,1077,"6 de julio de 1997"
9,22,7,2690,611,707,1318,"6 de julio de 1997"
9,22,7,2691,487,559,1046,"6 de julio de 1997"
9,22,7,2692,636,618,1254,"6 de julio de 1997"
9,22,7,2693,467,532,999,"6 de julio de 1997"
9,22,7,2694,441,525,966,"6 de julio de 1997"
9,22,7,2695,363,377,740,"6 de julio de 1997"
9,22,7,2696,463,489,952,"6 de julio de 1997"
9,22,7,2697,457,451,908,"6 de julio de 1997"
9,22,7,2698,383,430,813,"6 de julio de 1997"
9,22,7,2699,559,596,1155,"6 de julio de 1997"
9,22,7,2700,538,596,1134,"6 de julio de 1997"
9,22,7,2701,551,545,1096,"6 de julio de 1997"
9,22,7,2702,514,551,1065,"6 de julio de 1997"
9,22,7,2703,534,554,1088,"6 de julio de 1997"
9,22,7,2704,512,516,1028,"6 de julio de 1997"
9,22,7,2705,526,634,1160,"6 de julio de 1997"
9,22,7,2706,549,587,1136,"6 de julio de 1997"
9,22,7,2707,586,621,1207,"6 de julio de 1997"
9,22,7,2708,443,456,899,"6 de julio de 1997"
9,22,7,2709,465,526,991,"6 de julio de 1997"
9,22,7,2710,472,545,1017,"6 de julio de 1997"
9,22,7,2711,453,498,951,"6 de julio de 1997"
9,22,7,2712,461,558,1019,"6 de julio de 1997"
9,22,7,2713,614,604,1218,"6 de julio de 1997"
9,22,7,2714,606,655,1261,"6 de julio de 1997"
9,22,7,2715,531,572,1103,"6 de julio de 1997"
9,22,7,2716,508,584,1092,"6 de julio de 1997"
9,22,7,2717,603,629,1232,"6 de julio de 1997"
9,22,7,2718,506,559,1065,"6 de julio de 1997"
9,22,7,2719,601,638,1239,"6 de julio de 1997"
9,22,7,2720,606,704,1310,"6 de julio de 1997"
9,22,7,2721,470,546,1016,"6 de julio de 1997"
9,22,7,2722,442,477,919,"6 de julio de 1997"
9,22,7,2723,470,528,998,"6 de julio de 1997"
9,22,7,2724,582,625,1207,"6 de julio de 1997"
9,22,7,2725,566,555,1121,"6 de julio de 1997"
9,22,7,2726,527,549,1076,"6 de julio de 1997"
9,22,7,2727,534,591,1125,"6 de julio de 1997"
9,22,7,2728,700,725,1425,"6 de julio de 1997"
9,22,7,2729,466,503,969,"6 de julio de 1997"
9,22,7,2772,576,597,1173,"6 de julio de 1997"
9,22,7,2773,509,536,1045,"6 de julio de 1997"
9,22,7,2774,599,649,1248,"6 de julio de 1997"
9,22,7,2775,495,531,1026,"6 de julio de 1997"
9,22,7,2776,431,478,909,"6 de julio de 1997"
9,22,7,2777,473,528,1001,"6 de julio de 1997"
9,22,7,2778,460,521,981,"6 de julio de 1997"
9,22,7,2779,594,605,1199,"6 de julio de 1997"
9,22,7,2780,549,572,1121,"6 de julio de 1997"
9,22,7,2781,566,644,1210,"6 de julio de 1997"
9,22,7,2782,547,593,1140,"6 de julio de 1997"
9,22,7,2783,472,526,998,"6 de julio de 1997"
9,22,7,2784,524,547,1071,"6 de julio de 1997"
9,22,7,2785,532,553,1085,"6 de julio de 1997"
9,22,7,2786,697,770,1467,"6 de julio de 1997"
9,22,7,2787,445,457,902,"6 de julio de 1997"
9,22,7,2788,521,571,1092,"6 de julio de 1997"
9,22,7,2789,497,525,1022,"6 de julio de 1997"
9,22,7,2790,555,616,1171,"6 de julio de 1997"
9,22,7,2791,519,543,1062,"6 de julio de 1997"
9,22,7,2792,493,574,1067,"6 de julio de 1997"
9,22,7,2793,588,610,1198,"6 de julio de 1997"
9,22,7,2794,632,648,1280,"6 de julio de 1997"
9,22,7,2795,557,557,1114,"6 de julio de 1997"
9,22,7,2796,515,523,1038,"6 de julio de 1997"
9,22,7,2797,609,662,1271,"6 de julio de 1997"
9,22,7,2798,744,727,1471,"6 de julio de 1997"
9,22,7,2799,477,487,964,"6 de julio de 1997"
9,22,7,2800,792,815,1607,"6 de julio de 1997"
9,22,7,2801,506,563,1069,"6 de julio de 1997"
9,22,7,2802,738,789,1527,"6 de julio de 1997"
9,22,7,2803,569,624,1193,"6 de julio de 1997"
9,22,7,2804,450,474,924,"6 de julio de 1997"
9,22,7,2805,558,581,1139,"6 de julio de 1997"
9,22,7,2806,472,467,939,"6 de julio de 1997"
9,22,7,2807,386,414,800,"6 de julio de 1997"
9,22,7,2808,465,502,967,"6 de julio de 1997"
9,22,7,2809,425,497,922,"6 de julio de 1997"
9,22,7,2810,250,290,540,"6 de julio de 1997"
9,22,7,2811,525,607,1132,"6 de julio de 1997"
9,22,7,2812,593,622,1215,"6 de julio de 1997"
9,22,7,2813,379,413,792,"6 de julio de 1997"
9,22,7,2814,555,563,1118,"6 de julio de 1997"
9,22,7,2815,525,586,1111,"6 de julio de 1997"
9,22,7,2816,363,422,785,"6 de julio de 1997"
9,22,7,2817,509,534,1043,"6 de julio de 1997"
9,22,7,2818,698,726,1424,"6 de julio de 1997"
9,22,7,2819,616,660,1276,"6 de julio de 1997"
9,22,7,2820,552,597,1149,"6 de julio de 1997"
9,22,7,2821,640,675,1315,"6 de julio de 1997"
9,22,7,2822,551,592,1143,"6 de julio de 1997"
9,22,7,2823,470,504,974,"6 de julio de 1997"
9,22,7,2824,521,533,1054,"6 de julio de 1997"
9,22,7,2825,507,530,1037,"6 de julio de 1997"
9,22,7,2858,462,531,993,"6 de julio de 1997"
9,22,7,2859,521,570,1091,"6 de julio de 1997"
9,22,7,2860,435,496,931,"6 de julio de 1997"
9,22,7,2861,464,538,1002,"6 de julio de 1997"
9,22,7,2862,382,400,782,"6 de julio de 1997"
9,22,7,2863,519,584,1103,"6 de julio de 1997"
9,22,7,2864,1169,1276,2445,"6 de julio de 1997"
9,22,7,2865,533,607,1140,"6 de julio de 1997"
9,22,7,2866,748,840,1588,"6 de julio de 1997"
9,22,7,2867,598,718,1316,"6 de julio de 1997"
9,22,7,2964,286,335,621,"6 de julio de 1997"
9,22,7,2965,380,437,817,"6 de julio de 1997"
9,23,3,345,529,690,1219,"6 de julio de 1997"
9,23,3,346,140,191,331,"6 de julio de 1997"
9,23,3,347,578,771,1349,"6 de julio de 1997"
9,23,3,348,639,803,1442,"6 de julio de 1997"
9,23,3,349,476,595,1071,"6 de julio de 1997"
9,23,3,350,537,689,1226,"6 de julio de 1997"
9,23,3,351,752,832,1584,"6 de julio de 1997"
9,23,3,352,492,569,1061,"6 de julio de 1997"
9,23,3,353,690,765,1455,"6 de julio de 1997"
9,23,3,354,947,1150,2097,"6 de julio de 1997"
9,23,3,355,768,797,1565,"6 de julio de 1997"
9,23,3,356,638,706,1344,"6 de julio de 1997"
9,23,3,357,617,654,1271,"6 de julio de 1997"
9,23,3,358,461,476,937,"6 de julio de 1997"
9,23,3,360,581,640,1221,"6 de julio de 1997"
9,23,3,361,572,623,1195,"6 de julio de 1997"
9,23,3,362,540,582,1122,"6 de julio de 1997"
9,23,3,363,726,792,1518,"6 de julio de 1997"
9,23,3,364,831,854,1685,"6 de julio de 1997"
9,23,3,365,660,703,1363,"6 de julio de 1997"
9,23,3,366,715,796,1511,"6 de julio de 1997"
9,23,3,367,671,749,1420,"6 de julio de 1997"
9,23,3,368,608,746,1354,"6 de julio de 1997"
9,23,3,369,509,615,1124,"6 de julio de 1997"
9,23,3,370,204,257,461,"6 de julio de 1997"
9,23,3,371,430,488,918,"6 de julio de 1997"
9,23,3,372,498,573,1071,"6 de julio de 1997"
9,23,3,373,618,711,1329,"6 de julio de 1997"
9,23,3,374,638,689,1327,"6 de julio de 1997"
9,23,3,375,253,277,530,"6 de julio de 1997"
9,23,3,376,710,804,1514,"6 de julio de 1997"
9,23,3,377,657,729,1386,"6 de julio de 1997"
9,23,3,378,685,831,1516,"6 de julio de 1997"
9,23,3,379,605,641,1246,"6 de julio de 1997"
9,23,3,380,410,453,863,"6 de julio de 1997"
9,23,3,381,811,900,1711,"6 de julio de 1997"
9,23,3,382,795,846,1641,"6 de julio de 1997"
9,23,3,383,682,776,1458,"6 de julio de 1997"
9,23,3,384,826,932,1758,"6 de julio de 1997"
9,23,3,385,718,784,1502,"6 de julio de 1997"
9,23,3,386,648,669,1317,"6 de julio de 1997"
9,23,3,387,320,379,699,"6 de julio de 1997"
9,23,3,388,639,704,1343,"6 de julio de 1997"
9,23,3,389,498,530,1028,"6 de julio de 1997"
9,23,3,390,865,905,1770,"6 de julio de 1997"
9,23,3,391,539,568,1107,"6 de julio de 1997"
9,23,3,392,672,730,1402,"6 de julio de 1997"
9,23,3,393,861,889,1750,"6 de julio de 1997"
9,23,3,394,558,638,1196,"6 de julio de 1997"
9,23,3,395,726,756,1482,"6 de julio de 1997"
9,23,3,396,317,383,700,"6 de julio de 1997"
9,23,3,397,691,785,1476,"6 de julio de 1997"
9,23,3,398,476,545,1021,"6 de julio de 1997"
9,23,3,399,680,823,1503,"6 de julio de 1997"
9,23,3,400,565,676,1241,"6 de julio de 1997"
9,23,3,401,573,634,1207,"6 de julio de 1997"
9,23,3,402,639,747,1386,"6 de julio de 1997"
9,23,3,403,651,712,1363,"6 de julio de 1997"
9,23,3,404,831,880,1711,"6 de julio de 1997"
9,23,3,405,423,466,889,"6 de julio de 1997"
9,23,3,406,677,760,1437,"6 de julio de 1997"
9,23,3,407,567,643,1210,"6 de julio de 1997"
9,23,3,408,403,430,833,"6 de julio de 1997"
9,23,3,409,621,681,1302,"6 de julio de 1997"
9,23,3,410,474,542,1016,"6 de julio de 1997"
9,23,3,411,581,656,1237,"6 de julio de 1997"
9,23,3,415,488,532,1020,"6 de julio de 1997"
9,23,3,416,952,1031,1983,"6 de julio de 1997"
9,23,3,417,750,766,1516,"6 de julio de 1997"
9,23,3,418,713,803,1516,"6 de julio de 1997"
9,23,3,419,576,639,1215,"6 de julio de 1997"
9,23,3,420,525,531,1056,"6 de julio de 1997"
9,23,3,421,649,680,1329,"6 de julio de 1997"
9,23,3,422,588,689,1277,"6 de julio de 1997"
9,23,3,423,388,461,849,"6 de julio de 1997"
9,23,3,424,355,388,743,"6 de julio de 1997"
9,23,3,425,668,751,1419,"6 de julio de 1997"
9,23,3,426,454,499,953,"6 de julio de 1997"
9,23,3,427,723,886,1609,"6 de julio de 1997"
9,23,3,428,468,626,1094,"6 de julio de 1997"
9,23,3,429,402,497,899,"6 de julio de 1997"
9,23,3,430,756,757,1513,"6 de julio de 1997"
9,23,3,431,555,545,1100,"6 de julio de 1997"
9,23,3,432,547,603,1150,"6 de julio de 1997"
9,23,3,433,641,720,1361,"6 de julio de 1997"
9,23,3,434,740,815,1555,"6 de julio de 1997"
9,23,3,435,652,698,1350,"6 de julio de 1997"
9,23,3,436,732,827,1559,"6 de julio de 1997"
9,23,3,437,704,773,1477,"6 de julio de 1997"
9,23,3,438,702,720,1422,"6 de julio de 1997"
9,23,3,439,699,818,1517,"6 de julio de 1997"
9,23,3,440,507,493,1000,"6 de julio de 1997"
9,23,3,441,840,851,1691,"6 de julio de 1997"
9,23,3,442,468,480,948,"6 de julio de 1997"
9,23,3,443,608,640,1248,"6 de julio de 1997"
9,23,3,444,821,896,1717,"6 de julio de 1997"
9,23,3,445,664,700,1364,"6 de julio de 1997"
9,23,3,446,451,458,909,"6 de julio de 1997"
9,23,3,447,737,748,1485,"6 de julio de 1997"
9,23,3,448,484,553,1037,"6 de julio de 1997"
9,23,3,449,647,706,1353,"6 de julio de 1997"
9,23,3,450,529,558,1087,"6 de julio de 1997"
9,23,3,451,512,580,1092,"6 de julio de 1997"
9,23,3,452,754,850,1604,"6 de julio de 1997"
9,23,3,453,726,784,1510,"6 de julio de 1997"
9,23,3,454,543,616,1159,"6 de julio de 1997"
9,23,3,455,482,499,981,"6 de julio de 1997"
9,23,3,456,625,750,1375,"6 de julio de 1997"
9,23,3,457,422,451,873,"6 de julio de 1997"
9,23,3,471,871,931,1802,"6 de julio de 1997"
9,23,3,472,420,579,999,"6 de julio de 1997"
9,23,3,473,645,765,1410,"6 de julio de 1997"
9,23,3,479,170,227,397,"6 de julio de 1997"
9,23,3,481,266,263,529,"6 de julio de 1997"
9,23,3,482,591,673,1264,"6 de julio de 1997"
9,23,3,483,221,281,502,"6 de julio de 1997"
9,23,3,484,507,513,1020,"6 de julio de 1997"
9,23,3,485,678,761,1439,"6 de julio de 1997"
9,23,3,486,435,476,911,"6 de julio de 1997"
9,23,3,487,555,595,1150,"6 de julio de 1997"
9,23,3,488,472,527,999,"6 de julio de 1997"
9,23,3,489,454,498,952,"6 de julio de 1997"
9,23,3,490,556,587,1143,"6 de julio de 1997"
9,23,3,491,307,411,718,"6 de julio de 1997"
9,23,3,492,322,361,683,"6 de julio de 1997"
9,23,3,493,570,627,1197,"6 de julio de 1997"
9,23,3,494,402,428,830,"6 de julio de 1997"
9,23,3,496,399,416,815,"6 de julio de 1997"
9,23,3,497,376,376,752,"6 de julio de 1997"
9,23,3,498,372,419,791,"6 de julio de 1997"
9,23,3,499,464,529,993,"6 de julio de 1997"
9,23,3,500,434,462,896,"6 de julio de 1997"
9,23,3,501,559,598,1157,"6 de julio de 1997"
9,23,3,502,460,531,991,"6 de julio de 1997"
9,23,3,503,581,607,1188,"6 de julio de 1997"
9,23,3,504,425,443,868,"6 de julio de 1997"
9,23,3,505,313,296,609,"6 de julio de 1997"
9,23,3,506,236,285,521,"6 de julio de 1997"
9,23,3,507,342,376,718,"6 de julio de 1997"
9,23,3,508,334,347,681,"6 de julio de 1997"
9,23,3,509,296,348,644,"6 de julio de 1997"
9,23,3,510,363,377,740,"6 de julio de 1997"
9,23,3,511,229,248,477,"6 de julio de 1997"
9,23,3,513,341,351,692,"6 de julio de 1997"
9,23,3,514,394,396,790,"6 de julio de 1997"
9,23,3,515,394,463,857,"6 de julio de 1997"
9,23,3,694,759,978,1737,"6 de julio de 1997"
9,23,3,695,540,734,1274,"6 de julio de 1997"
9,23,3,696,660,842,1502,"6 de julio de 1997"
9,23,3,697,475,579,1054,"6 de julio de 1997"
9,23,3,698,526,657,1183,"6 de julio de 1997"
9,23,3,699,578,680,1258,"6 de julio de 1997"
9,23,3,700,569,653,1222,"6 de julio de 1997"
9,23,3,701,397,464,861,"6 de julio de 1997"
9,23,3,702,512,744,1256,"6 de julio de 1997"
9,23,3,703,198,249,447,"6 de julio de 1997"
9,23,3,704,488,880,1368,"6 de julio de 1997"
9,23,3,705,539,666,1205,"6 de julio de 1997"
9,23,3,706,467,702,1169,"6 de julio de 1997"
9,23,3,707,699,919,1618,"6 de julio de 1997"
9,23,3,708,594,771,1365,"6 de julio de 1997"
9,23,3,709,630,838,1468,"6 de julio de 1997"
9,23,3,710,477,589,1066,"6 de julio de 1997"
9,23,3,711,318,378,696,"6 de julio de 1997"
9,23,3,712,644,860,1504,"6 de julio de 1997"
9,23,3,713,675,920,1595,"6 de julio de 1997"
9,23,3,714,536,659,1195,"6 de julio de 1997"
9,23,3,715,386,455,841,"6 de julio de 1997"
9,23,3,716,294,367,661,"6 de julio de 1997"
9,23,3,717,509,645,1154,"6 de julio de 1997"
9,23,3,718,653,909,1562,"6 de julio de 1997"
9,23,3,719,507,618,1125,"6 de julio de 1997"
9,23,3,720,279,314,593,"6 de julio de 1997"
9,23,3,721,685,807,1492,"6 de julio de 1997"
9,23,3,722,413,439,852,"6 de julio de 1997"
9,23,3,723,574,800,1374,"6 de julio de 1997"
9,23,3,724,582,844,1426,"6 de julio de 1997"
9,23,3,725,453,612,1065,"6 de julio de 1997"
9,23,3,726,676,865,1541,"6 de julio de 1997"
9,23,3,731,499,699,1198,"6 de julio de 1997"
9,23,3,732,485,633,1118,"6 de julio de 1997"
9,23,3,742,331,398,729,"6 de julio de 1997"
9,23,3,743,267,318,585,"6 de julio de 1997"
9,23,3,744,340,432,772,"6 de julio de 1997"
9,23,3,745,455,553,1008,"6 de julio de 1997"
9,23,3,746,582,791,1373,"6 de julio de 1997"
9,23,3,5515,176,201,377,"6 de julio de 1997"
9,24,3,516,473,596,1069,"6 de julio de 1997"
9,24,3,517,252,308,560,"6 de julio de 1997"
9,24,3,518,278,368,646,"6 de julio de 1997"
9,24,3,519,718,917,1635,"6 de julio de 1997"
9,24,3,520,461,619,1080,"6 de julio de 1997"
9,24,3,521,469,635,1104,"6 de julio de 1997"
9,24,3,522,337,457,794,"6 de julio de 1997"
9,24,3,523,564,708,1272,"6 de julio de 1997"
9,24,3,524,262,362,624,"6 de julio de 1997"
9,24,3,525,380,438,818,"6 de julio de 1997"
9,24,3,526,602,757,1359,"6 de julio de 1997"
9,24,3,527,455,547,1002,"6 de julio de 1997"
9,24,3,528,595,741,1336,"6 de julio de 1997"
9,24,3,529,472,576,1048,"6 de julio de 1997"
9,24,3,530,695,832,1527,"6 de julio de 1997"
9,24,3,531,429,497,926,"6 de julio de 1997"
9,24,3,532,436,518,954,"6 de julio de 1997"
9,24,3,533,357,419,776,"6 de julio de 1997"
9,24,3,534,555,666,1221,"6 de julio de 1997"
9,24,3,535,524,667,1191,"6 de julio de 1997"
9,24,3,536,467,536,1003,"6 de julio de 1997"
9,24,3,537,358,432,790,"6 de julio de 1997"
9,24,3,538,514,552,1066,"6 de julio de 1997"
9,24,3,539,570,645,1215,"6 de julio de 1997"
9,24,3,540,593,585,1178,"6 de julio de 1997"
9,24,3,541,412,412,824,"6 de julio de 1997"
9,24,3,542,299,378,677,"6 de julio de 1997"
9,24,3,543,512,641,1153,"6 de julio de 1997"
9,24,3,544,357,410,767,"6 de julio de 1997"
9,24,3,545,550,653,1203,"6 de julio de 1997"
9,24,3,546,753,874,1627,"6 de julio de 1997"
9,24,3,547,492,655,1147,"6 de julio de 1997"
9,24,3,548,411,476,887,"6 de julio de 1997"
9,24,3,549,418,571,989,"6 de julio de 1997"
9,24,3,550,459,518,977,"6 de julio de 1997"
9,24,3,551,516,738,1254,"6 de julio de 1997"
9,24,3,552,514,616,1130,"6 de julio de 1997"
9,24,3,553,585,734,1319,"6 de julio de 1997"
9,24,3,554,545,481,1026,"6 de julio de 1997"
9,24,3,555,336,462,798,"6 de julio de 1997"
9,24,3,556,798,888,1686,"6 de julio de 1997"
9,24,3,557,588,643,1231,"6 de julio de 1997"
9,24,3,558,662,701,1363,"6 de julio de 1997"
9,24,3,559,499,554,1053,"6 de julio de 1997"
9,24,3,560,702,790,1492,"6 de julio de 1997"
9,24,3,561,541,571,1112,"6 de julio de 1997"
9,24,3,562,626,691,1317,"6 de julio de 1997"
9,24,3,563,468,568,1036,"6 de julio de 1997"
9,24,3,564,547,640,1187,"6 de julio de 1997"
9,24,3,565,450,596,1046,"6 de julio de 1997"
9,24,3,566,487,679,1166,"6 de julio de 1997"
9,24,3,567,516,698,1214,"6 de julio de 1997"
9,24,3,568,552,702,1254,"6 de julio de 1997"
9,24,3,569,545,717,1262,"6 de julio de 1997"
9,24,3,570,600,688,1288,"6 de julio de 1997"
9,24,3,571,664,687,1351,"6 de julio de 1997"
9,24,3,572,703,780,1483,"6 de julio de 1997"
9,24,3,573,595,682,1277,"6 de julio de 1997"
9,24,3,574,324,388,712,"6 de julio de 1997"
9,24,3,575,536,595,1131,"6 de julio de 1997"
9,24,3,576,882,1103,1985,"6 de julio de 1997"
9,24,3,577,598,711,1309,"6 de julio de 1997"
9,24,3,578,374,423,797,"6 de julio de 1997"
9,24,3,579,492,576,1068,"6 de julio de 1997"
9,24,3,580,604,736,1340,"6 de julio de 1997"
9,24,3,581,595,664,1259,"6 de julio de 1997"
9,24,3,582,613,715,1328,"6 de julio de 1997"
9,24,3,583,531,608,1139,"6 de julio de 1997"
9,24,3,584,398,495,893,"6 de julio de 1997"
9,24,3,585,498,611,1109,"6 de julio de 1997"
9,24,3,586,598,776,1374,"6 de julio de 1997"
9,24,3,587,718,820,1538,"6 de julio de 1997"
9,24,3,588,360,435,795,"6 de julio de 1997"
9,24,3,589,449,596,1045,"6 de julio de 1997"
9,24,3,590,539,610,1149,"6 de julio de 1997"
9,24,3,591,503,593,1096,"6 de julio de 1997"
9,24,3,592,513,681,1194,"6 de julio de 1997"
9,24,3,593,691,831,1522,"6 de julio de 1997"
9,24,3,594,657,757,1414,"6 de julio de 1997"
9,24,3,595,766,874,1640,"6 de julio de 1997"
9,24,3,596,663,760,1423,"6 de julio de 1997"
9,24,3,597,730,866,1596,"6 de julio de 1997"
9,24,3,598,642,694,1336,"6 de julio de 1997"
9,24,3,599,737,832,1569,"6 de julio de 1997"
9,24,3,600,628,718,1346,"6 de julio de 1997"
9,24,3,601,615,723,1338,"6 de julio de 1997"
9,24,3,602,646,741,1387,"6 de julio de 1997"
9,24,3,603,673,699,1372,"6 de julio de 1997"
9,24,3,604,634,719,1353,"6 de julio de 1997"
9,24,3,605,665,804,1469,"6 de julio de 1997"
9,24,3,606,650,798,1448,"6 de julio de 1997"
9,24,3,607,563,646,1209,"6 de julio de 1997"
9,24,3,608,704,812,1516,"6 de julio de 1997"
9,24,3,609,660,782,1442,"6 de julio de 1997"
9,24,3,610,727,804,1531,"6 de julio de 1997"
9,24,3,611,712,781,1493,"6 de julio de 1997"
9,24,3,612,609,702,1311,"6 de julio de 1997"
9,24,3,613,269,299,568,"6 de julio de 1997"
9,24,3,614,346,451,797,"6 de julio de 1997"
9,24,3,615,445,518,963,"6 de julio de 1997"
9,24,3,616,642,696,1338,"6 de julio de 1997"
9,24,3,617,344,374,718,"6 de julio de 1997"
9,24,3,618,844,878,1722,"6 de julio de 1997"
9,24,3,619,776,495,1271,"6 de julio de 1997"
9,24,3,620,631,844,1475,"6 de julio de 1997"
9,24,3,621,630,781,1411,"6 de julio de 1997"
9,24,3,622,691,876,1567,"6 de julio de 1997"
9,24,3,623,776,886,1662,"6 de julio de 1997"
9,24,3,624,544,649,1193,"6 de julio de 1997"
9,24,3,625,412,512,924,"6 de julio de 1997"
9,24,3,626,706,862,1568,"6 de julio de 1997"
9,24,3,627,497,650,1147,"6 de julio de 1997"
9,24,3,628,500,639,1139,"6 de julio de 1997"
9,24,3,629,636,720,1356,"6 de julio de 1997"
9,24,3,630,465,564,1029,"6 de julio de 1997"
9,24,3,631,702,888,1590,"6 de julio de 1997"
9,24,3,632,292,299,591,"6 de julio de 1997"
9,24,3,633,390,426,816,"6 de julio de 1997"
9,24,3,634,545,595,1140,"6 de julio de 1997"
9,24,3,635,516,652,1168,"6 de julio de 1997"
9,24,3,636,560,669,1229,"6 de julio de 1997"
9,24,3,637,673,736,1409,"6 de julio de 1997"
9,24,3,638,473,574,1047,"6 de julio de 1997"
9,24,3,639,501,538,1039,"6 de julio de 1997"
9,24,3,640,498,607,1105,"6 de julio de 1997"
9,24,3,641,714,870,1584,"6 de julio de 1997"
9,24,3,642,521,637,1158,"6 de julio de 1997"
9,24,3,643,480,602,1082,"6 de julio de 1997"
9,24,3,644,692,816,1508,"6 de julio de 1997"
9,24,3,645,603,710,1313,"6 de julio de 1997"
9,24,3,646,510,641,1151,"6 de julio de 1997"
9,24,3,647,356,472,828,"6 de julio de 1997"
9,24,3,648,324,400,724,"6 de julio de 1997"
9,24,3,649,375,426,801,"6 de julio de 1997"
9,24,3,650,501,574,1075,"6 de julio de 1997"
9,24,3,651,468,566,1034,"6 de julio de 1997"
9,24,3,652,737,864,1601,"6 de julio de 1997"
9,24,3,653,648,721,1369,"6 de julio de 1997"
9,24,3,654,536,589,1125,"6 de julio de 1997"
9,24,3,655,516,585,1101,"6 de julio de 1997"
9,24,3,656,523,628,1151,"6 de julio de 1997"
9,24,3,657,504,617,1121,"6 de julio de 1997"
9,24,3,658,532,613,1145,"6 de julio de 1997"
9,24,3,659,619,724,1343,"6 de julio de 1997"
9,24,3,660,528,634,1162,"6 de julio de 1997"
9,24,3,661,605,706,1311,"6 de julio de 1997"
9,24,3,662,386,453,839,"6 de julio de 1997"
9,24,3,663,472,553,1025,"6 de julio de 1997"
9,24,3,664,645,776,1421,"6 de julio de 1997"
9,24,3,665,685,816,1501,"6 de julio de 1997"
9,24,3,666,541,607,1148,"6 de julio de 1997"
9,24,3,667,507,553,1060,"6 de julio de 1997"
9,24,3,668,768,880,1648,"6 de julio de 1997"
9,24,3,669,679,805,1484,"6 de julio de 1997"
9,24,3,670,610,681,1291,"6 de julio de 1997"
9,24,3,671,395,474,869,"6 de julio de 1997"
9,24,3,672,390,475,865,"6 de julio de 1997"
9,24,3,673,553,638,1191,"6 de julio de 1997"
9,24,3,674,547,705,1252,"6 de julio de 1997"
9,24,3,675,595,701,1296,"6 de julio de 1997"
9,24,3,676,411,606,1017,"6 de julio de 1997"
9,24,3,677,685,721,1406,"6 de julio de 1997"
9,24,3,678,833,957,1790,"6 de julio de 1997"
9,24,3,679,406,497,903,"6 de julio de 1997"
9,24,3,680,292,333,625,"6 de julio de 1997"
9,24,3,681,503,596,1099,"6 de julio de 1997"
9,24,3,682,390,447,837,"6 de julio de 1997"
9,24,3,683,257,321,578,"6 de julio de 1997"
9,24,3,684,572,590,1162,"6 de julio de 1997"
9,24,3,685,347,360,707,"6 de julio de 1997"
9,24,3,686,532,624,1156,"6 de julio de 1997"
9,24,3,687,482,527,1009,"6 de julio de 1997"
9,24,3,688,788,978,1766,"6 de julio de 1997"
9,24,3,689,561,707,1268,"6 de julio de 1997"
9,24,3,690,381,453,834,"6 de julio de 1997"
9,24,3,691,365,410,775,"6 de julio de 1997"
9,24,3,692,247,315,562,"6 de julio de 1997"
9,25,7,2518,529,566,1095,"6 de julio de 1997"
9,25,7,2519,656,699,1355,"6 de julio de 1997"
9,25,7,2520,417,456,873,"6 de julio de 1997"
9,25,7,2521,460,533,993,"6 de julio de 1997"
9,25,7,2522,408,444,852,"6 de julio de 1997"
9,25,7,2523,428,449,877,"6 de julio de 1997"
9,25,7,2524,373,421,794,"6 de julio de 1997"
9,25,7,2525,378,439,817,"6 de julio de 1997"
9,25,7,2526,484,536,1020,"6 de julio de 1997"
9,25,7,2527,357,370,727,"6 de julio de 1997"
9,25,7,2528,444,525,969,"6 de julio de 1997"
9,25,7,2529,472,513,985,"6 de julio de 1997"
9,25,7,2530,578,633,1211,"6 de julio de 1997"
9,25,7,2531,603,618,1221,"6 de julio de 1997"
9,25,7,2532,433,470,903,"6 de julio de 1997"
9,25,7,2533,538,592,1130,"6 de julio de 1997"
9,25,7,2534,484,498,982,"6 de julio de 1997"
9,25,7,2535,578,604,1182,"6 de julio de 1997"
9,25,7,2546,249,301,550,"6 de julio de 1997"
9,25,7,2547,507,507,1014,"6 de julio de 1997"
9,25,7,2548,598,594,1192,"6 de julio de 1997"
9,25,7,2549,523,578,1101,"6 de julio de 1997"
9,25,7,2550,403,401,804,"6 de julio de 1997"
9,25,7,2551,512,532,1044,"6 de julio de 1997"
9,25,7,2629,679,773,1452,"6 de julio de 1997"
9,25,7,2630,563,608,1171,"6 de julio de 1997"
9,25,7,2631,475,562,1037,"6 de julio de 1997"
9,25,7,2632,534,599,1133,"6 de julio de 1997"
9,25,7,2633,432,500,932,"6 de julio de 1997"
9,25,7,2634,338,353,691,"6 de julio de 1997"
9,25,7,2635,436,436,872,"6 de julio de 1997"
9,25,7,2636,486,517,1003,"6 de julio de 1997"
9,25,7,2637,531,537,1068,"6 de julio de 1997"
9,25,7,2638,430,484,914,"6 de julio de 1997"
9,25,7,2639,322,403,725,"6 de julio de 1997"
9,25,7,2660,614,621,1235,"6 de julio de 1997"
9,25,7,2661,492,490,982,"6 de julio de 1997"
9,25,7,2662,1189,1393,2582,"6 de julio de 1997"
9,25,7,2663,371,440,811,"6 de julio de 1997"
9,25,7,2664,182,214,396,"6 de julio de 1997"
9,25,7,2665,815,1017,1832,"6 de julio de 1997"
9,25,7,2669,531,547,1078,"6 de julio de 1997"
9,25,7,2670,241,327,568,"6 de julio de 1997"
9,25,7,2671,464,517,981,"6 de julio de 1997"
9,25,7,2672,564,610,1174,"6 de julio de 1997"
9,25,7,2673,516,538,1054,"6 de julio de 1997"
9,25,7,2674,586,601,1187,"6 de julio de 1997"
9,25,7,2730,557,616,1173,"6 de julio de 1997"
9,25,7,2731,529,565,1094,"6 de julio de 1997"
9,25,7,2732,880,945,1825,"6 de julio de 1997"
9,25,7,2733,1037,1103,2140,"6 de julio de 1997"
9,25,7,2734,399,479,878,"6 de julio de 1997"
9,25,7,2735,536,587,1123,"6 de julio de 1997"
9,25,7,2736,488,554,1042,"6 de julio de 1997"
9,25,7,2737,408,475,883,"6 de julio de 1997"
9,25,7,2738,657,779,1436,"6 de julio de 1997"
9,25,7,2739,330,387,717,"6 de julio de 1997"
9,25,7,2740,201,221,422,"6 de julio de 1997"
9,25,7,2741,588,588,1176,"6 de julio de 1997"
9,25,7,2742,373,480,853,"6 de julio de 1997"
9,25,7,2743,534,597,1131,"6 de julio de 1997"
9,25,7,2748,566,643,1209,"6 de julio de 1997"
9,25,7,2749,517,617,1134,"6 de julio de 1997"
9,25,7,2750,697,783,1480,"6 de julio de 1997"
9,25,7,2751,485,554,1039,"6 de julio de 1997"
9,25,7,2752,366,450,816,"6 de julio de 1997"
9,25,7,2753,325,411,736,"6 de julio de 1997"
9,25,7,2754,919,1190,2109,"6 de julio de 1997"
9,25,7,2755,586,599,1185,"6 de julio de 1997"
9,25,7,2756,412,464,876,"6 de julio de 1997"
9,25,7,2757,703,762,1465,"6 de julio de 1997"
9,25,7,2758,547,597,1144,"6 de julio de 1997"
9,25,7,2759,689,778,1467,"6 de julio de 1997"
9,25,7,2760,740,777,1517,"6 de julio de 1997"
9,25,7,2761,708,704,1412,"6 de julio de 1997"
9,25,7,2762,515,592,1107,"6 de julio de 1997"
9,25,7,2763,246,311,557,"6 de julio de 1997"
9,25,7,2764,538,590,1128,"6 de julio de 1997"
9,25,7,2765,545,605,1150,"6 de julio de 1997"
9,25,7,2766,520,588,1108,"6 de julio de 1997"
9,25,7,2767,428,496,924,"6 de julio de 1997"
9,25,7,2768,518,570,1088,"6 de julio de 1997"
9,25,7,2769,434,472,906,"6 de julio de 1997"
9,25,7,2770,499,559,1058,"6 de julio de 1997"
9,25,7,2771,582,664,1246,"6 de julio de 1997"
9,25,7,2826,484,503,987,"6 de julio de 1997"
9,25,7,2827,524,585,1109,"6 de julio de 1997"
9,25,7,2828,405,462,867,"6 de julio de 1997"
9,25,7,2829,431,473,904,"6 de julio de 1997"
9,25,7,2830,586,634,1220,"6 de julio de 1997"
9,25,7,2831,537,568,1105,"6 de julio de 1997"
9,25,7,2832,506,563,1069,"6 de julio de 1997"
9,25,7,2833,470,525,995,"6 de julio de 1997"
9,25,7,2834,570,623,1193,"6 de julio de 1997"
9,25,7,2835,413,487,900,"6 de julio de 1997"
9,25,7,2836,409,488,897,"6 de julio de 1997"
9,25,7,2837,454,580,1034,"6 de julio de 1997"
9,25,7,2838,433,487,920,"6 de julio de 1997"
9,25,7,2839,191,234,425,"6 de julio de 1997"
9,25,7,2840,261,347,608,"6 de julio de 1997"
9,25,7,2841,421,455,876,"6 de julio de 1997"
9,25,7,2842,425,479,904,"6 de julio de 1997"
9,25,7,2843,289,357,646,"6 de julio de 1997"
9,25,7,2844,252,306,558,"6 de julio de 1997"
9,25,7,2845,280,332,612,"6 de julio de 1997"
9,25,7,2846,236,281,517,"6 de julio de 1997"
9,25,7,2847,287,338,625,"6 de julio de 1997"
9,25,7,2848,175,229,404,"6 de julio de 1997"
9,25,7,2849,478,526,1004,"6 de julio de 1997"
9,25,7,2850,450,507,957,"6 de julio de 1997"
9,25,7,2851,495,517,1012,"6 de julio de 1997"
9,25,7,2852,676,756,1432,"6 de julio de 1997"
9,25,7,2853,918,995,1913,"6 de julio de 1997"
9,25,7,2854,476,528,1004,"6 de julio de 1997"
9,25,7,2855,584,599,1183,"6 de julio de 1997"
9,25,7,2856,427,475,902,"6 de julio de 1997"
9,25,7,2857,505,567,1072,"6 de julio de 1997"
9,25,7,2868,503,596,1099,"6 de julio de 1997"
9,25,7,2869,606,653,1259,"6 de julio de 1997"
9,25,7,2870,657,731,1388,"6 de julio de 1997"
9,25,7,2871,559,604,1163,"6 de julio de 1997"
9,25,7,2872,598,638,1236,"6 de julio de 1997"
9,25,7,2873,759,819,1578,"6 de julio de 1997"
9,25,7,2874,636,684,1320,"6 de julio de 1997"
9,25,7,2875,594,604,1198,"6 de julio de 1997"
9,25,7,2876,578,601,1179,"6 de julio de 1997"
9,25,7,2877,405,467,872,"6 de julio de 1997"
9,25,7,2878,516,566,1082,"6 de julio de 1997"
9,25,7,2879,633,686,1319,"6 de julio de 1997"
9,25,7,2880,344,400,744,"6 de julio de 1997"
9,25,7,2881,312,360,672,"6 de julio de 1997"
9,25,7,2882,530,614,1144,"6 de julio de 1997"
9,25,7,2883,273,333,606,"6 de julio de 1997"
9,25,7,2884,499,560,1059,"6 de julio de 1997"
9,25,7,2885,512,611,1123,"6 de julio de 1997"
9,25,7,2886,484,534,1018,"6 de julio de 1997"
9,25,7,2887,334,377,711,"6 de julio de 1997"
9,25,7,2888,303,342,645,"6 de julio de 1997"
9,25,7,2889,247,288,535,"6 de julio de 1997"
9,25,7,2890,300,355,655,"6 de julio de 1997"
9,25,7,2891,345,382,727,"6 de julio de 1997"
9,25,7,2892,252,294,546,"6 de julio de 1997"
9,25,7,2893,376,440,816,"6 de julio de 1997"
9,25,7,2894,578,626,1204,"6 de julio de 1997"
9,25,7,2895,688,707,1395,"6 de julio de 1997"
9,25,7,2896,645,679,1324,"6 de julio de 1997"
9,25,7,2897,392,388,780,"6 de julio de 1997"
9,25,7,2898,596,660,1256,"6 de julio de 1997"
9,25,7,2899,994,1088,2082,"6 de julio de 1997"
9,25,7,2900,634,709,1343,"6 de julio de 1997"
9,25,7,2901,281,286,567,"6 de julio de 1997"
9,25,7,2902,507,528,1035,"6 de julio de 1997"
9,25,7,2903,378,405,783,"6 de julio de 1997"
9,25,7,2904,365,414,779,"6 de julio de 1997"
9,25,7,2905,444,505,949,"6 de julio de 1997"
9,25,7,2906,257,281,538,"6 de julio de 1997"
9,25,7,2907,473,528,1001,"6 de julio de 1997"
9,25,7,2908,566,634,1200,"6 de julio de 1997"
9,25,7,2909,672,785,1457,"6 de julio de 1997"
9,25,7,2910,504,540,1044,"6 de julio de 1997"
9,25,7,2911,478,535,1013,"6 de julio de 1997"
9,25,7,2912,467,463,930,"6 de julio de 1997"
9,25,7,2913,563,572,1135,"6 de julio de 1997"
9,25,7,2914,497,534,1031,"6 de julio de 1997"
9,25,7,2915,381,475,856,"6 de julio de 1997"
9,25,7,2916,553,623,1176,"6 de julio de 1997"
9,25,7,2917,505,512,1017,"6 de julio de 1997"
9,25,7,2918,550,651,1201,"6 de julio de 1997"
9,25,7,2919,558,567,1125,"6 de julio de 1997"
9,25,7,2920,531,544,1075,"6 de julio de 1997"
9,25,7,2921,538,536,1074,"6 de julio de 1997"
9,25,7,2922,591,614,1205,"6 de julio de 1997"
9,25,7,2923,286,337,623,"6 de julio de 1997"
9,25,7,2924,549,588,1137,"6 de julio de 1997"
9,25,7,2925,678,723,1401,"6 de julio de 1997"
9,25,7,2926,587,616,1203,"6 de julio de 1997"
9,25,7,2927,552,571,1123,"6 de julio de 1997"
9,25,7,2928,609,643,1252,"6 de julio de 1997"
9,25,7,2929,588,599,1187,"6 de julio de 1997"
9,25,7,2930,497,514,1011,"6 de julio de 1997"
9,25,7,2931,618,638,1256,"6 de julio de 1997"
9,25,7,2932,523,533,1056,"6 de julio de 1997"
9,25,7,2933,475,520,995,"6 de julio de 1997"
9,25,7,2934,642,736,1378,"6 de julio de 1997"
9,25,7,2935,688,722,1410,"6 de julio de 1997"
9,25,7,2936,445,505,950,"6 de julio de 1997"
9,25,7,2937,456,478,934,"6 de julio de 1997"
9,25,7,2938,454,452,906,"6 de julio de 1997"
9,25,7,2939,242,254,496,"6 de julio de 1997"
9,25,7,2940,533,602,1135,"6 de julio de 1997"
9,25,7,2941,548,613,1161,"6 de julio de 1997"
9,25,7,2942,581,654,1235,"6 de julio de 1997"
9,25,7,2943,422,478,900,"6 de julio de 1997"
9,25,7,2944,692,708,1400,"6 de julio de 1997"
9,25,7,2945,766,767,1533,"6 de julio de 1997"
9,25,7,2946,414,517,931,"6 de julio de 1997"
9,25,7,2947,634,632,1266,"6 de julio de 1997"
9,25,7,2948,620,682,1302,"6 de julio de 1997"
9,25,7,2949,317,401,718,"6 de julio de 1997"
9,25,7,2950,305,337,642,"6 de julio de 1997"
9,25,7,2951,482,509,991,"6 de julio de 1997"
9,25,7,2952,472,526,998,"6 de julio de 1997"
9,25,7,2953,445,468,913,"6 de julio de 1997"
9,25,7,2954,415,459,874,"6 de julio de 1997"
9,25,7,2955,442,496,938,"6 de julio de 1997"
9,25,7,2956,526,562,1088,"6 de julio de 1997"
9,25,7,2957,702,842,1544,"6 de julio de 1997"
9,25,7,2958,628,755,1383,"6 de julio de 1997"
9,25,7,2959,407,423,830,"6 de julio de 1997"
9,25,7,2960,298,369,667,"6 de julio de 1997"
9,25,7,2961,491,576,1067,"6 de julio de 1997"
9,25,7,2962,384,417,801,"6 de julio de 1997"
9,25,7,2963,234,245,479,"6 de julio de 1997"
9,25,7,2966,234,217,451,"6 de julio de 1997"
9,25,7,2967,369,417,786,"6 de julio de 1997"
9,26,8,2972,450,581,1031,"6 de julio de 1997"
9,26,8,2973,468,630,1098,"6 de julio de 1997"
9,26,8,2974,398,465,863,"6 de julio de 1997"
9,26,8,2975,337,419,756,"6 de julio de 1997"
9,26,8,2976,503,597,1100,"6 de julio de 1997"
9,26,8,2977,335,474,809,"6 de julio de 1997"
9,26,8,2978,450,572,1022,"6 de julio de 1997"
9,26,8,2979,448,562,1010,"6 de julio de 1997"
9,26,8,2980,282,373,655,"6 de julio de 1997"
9,26,8,2981,400,587,987,"6 de julio de 1997"
9,26,8,2982,454,617,1071,"6 de julio de 1997"
9,26,8,2983,411,552,963,"6 de julio de 1997"
9,26,8,2984,458,487,945,"6 de julio de 1997"
9,26,8,2985,436,514,950,"6 de julio de 1997"
9,26,8,2986,465,521,986,"6 de julio de 1997"
9,26,8,2987,354,403,757,"6 de julio de 1997"
9,26,8,2988,514,519,1033,"6 de julio de 1997"
9,26,8,2989,479,524,1003,"6 de julio de 1997"
9,26,8,2990,415,448,863,"6 de julio de 1997"
9,26,8,2991,513,539,1052,"6 de julio de 1997"
9,26,8,2992,534,582,1116,"6 de julio de 1997"
9,26,8,2993,574,585,1159,"6 de julio de 1997"
9,26,8,2994,578,591,1169,"6 de julio de 1997"
9,26,8,2995,296,298,594,"6 de julio de 1997"
9,26,8,2996,431,486,917,"6 de julio de 1997"
9,26,8,2997,226,244,470,"6 de julio de 1997"
9,26,8,2998,370,500,870,"6 de julio de 1997"
9,26,8,2999,453,513,966,"6 de julio de 1997"
9,26,8,3000,511,647,1158,"6 de julio de 1997"
9,26,8,3001,672,852,1524,"6 de julio de 1997"
9,26,8,3002,443,555,998,"6 de julio de 1997"
9,26,8,3003,235,344,579,"6 de julio de 1997"
9,26,8,3004,660,727,1387,"6 de julio de 1997"
9,26,8,3005,485,554,1039,"6 de julio de 1997"
9,26,8,3006,367,463,830,"6 de julio de 1997"
9,26,8,3007,460,445,905,"6 de julio de 1997"
9,26,8,3008,474,492,966,"6 de julio de 1997"
9,26,8,3009,373,397,770,"6 de julio de 1997"
9,26,8,3010,272,310,582,"6 de julio de 1997"
9,26,8,3011,479,528,1007,"6 de julio de 1997"
9,26,8,3012,463,494,957,"6 de julio de 1997"
9,26,8,3013,808,842,1650,"6 de julio de 1997"
9,26,8,3014,629,681,1310,"6 de julio de 1997"
9,26,8,3015,433,455,888,"6 de julio de 1997"
9,26,8,3016,490,532,1022,"6 de julio de 1997"
9,26,8,3017,572,605,1177,"6 de julio de 1997"
9,26,8,3018,458,464,922,"6 de julio de 1997"
9,26,8,3019,615,653,1268,"6 de julio de 1997"
9,26,8,3020,215,241,456,"6 de julio de 1997"
9,26,8,3021,296,314,610,"6 de julio de 1997"
9,26,8,3022,95,111,206,"6 de julio de 1997"
9,26,8,3023,647,705,1352,"6 de julio de 1997"
9,26,8,3024,282,332,614,"6 de julio de 1997"
9,26,8,3025,694,828,1522,"6 de julio de 1997"
9,26,8,3026,448,541,989,"6 de julio de 1997"
9,26,8,3027,360,463,823,"6 de julio de 1997"
9,26,8,3028,512,596,1108,"6 de julio de 1997"
9,26,8,3029,589,622,1211,"6 de julio de 1997"
9,26,8,3030,588,674,1262,"6 de julio de 1997"
9,26,8,3031,575,660,1235,"6 de julio de 1997"
9,26,8,3032,652,688,1340,"6 de julio de 1997"
9,26,8,3033,478,596,1074,"6 de julio de 1997"
9,26,8,3034,546,582,1128,"6 de julio de 1997"
9,26,8,3035,712,784,1496,"6 de julio de 1997"
9,26,8,3036,335,345,680,"6 de julio de 1997"
9,26,8,3037,362,383,745,"6 de julio de 1997"
9,26,8,3038,386,423,809,"6 de julio de 1997"
9,26,8,3039,698,747,1445,"6 de julio de 1997"
9,26,8,3040,743,805,1548,"6 de julio de 1997"
9,26,8,3041,424,441,865,"6 de julio de 1997"
9,26,8,3042,388,417,805,"6 de julio de 1997"
9,26,8,3043,312,359,671,"6 de julio de 1997"
9,26,8,3044,322,379,701,"6 de julio de 1997"
9,26,8,3045,467,502,969,"6 de julio de 1997"
9,26,8,3046,636,733,1369,"6 de julio de 1997"
9,26,8,3047,601,630,1231,"6 de julio de 1997"
9,26,8,3048,477,568,1045,"6 de julio de 1997"
9,26,8,3049,466,563,1029,"6 de julio de 1997"
9,26,8,3050,576,633,1209,"6 de julio de 1997"
9,26,8,3051,486,517,1003,"6 de julio de 1997"
9,26,8,3052,515,547,1062,"6 de julio de 1997"
9,26,8,3053,519,592,1111,"6 de julio de 1997"
9,26,8,3054,322,380,702,"6 de julio de 1997"
9,26,8,3055,314,546,860,"6 de julio de 1997"
9,26,8,3056,478,569,1047,"6 de julio de 1997"
9,26,8,3057,250,323,573,"6 de julio de 1997"
9,26,8,3058,540,672,1212,"6 de julio de 1997"
9,26,8,3059,662,720,1382,"6 de julio de 1997"
9,26,8,3060,611,658,1269,"6 de julio de 1997"
9,26,8,3061,685,773,1458,"6 de julio de 1997"
9,26,8,3062,656,730,1386,"6 de julio de 1997"
9,26,8,3063,401,499,900,"6 de julio de 1997"
9,26,8,3064,495,536,1031,"6 de julio de 1997"
9,26,8,3065,359,395,754,"6 de julio de 1997"
9,26,8,3066,695,751,1446,"6 de julio de 1997"
9,26,8,3067,566,617,1183,"6 de julio de 1997"
9,26,8,3068,542,618,1160,"6 de julio de 1997"
9,26,8,3069,445,481,926,"6 de julio de 1997"
9,26,8,3070,487,525,1012,"6 de julio de 1997"
9,26,8,3071,781,846,1627,"6 de julio de 1997"
9,26,8,3072,317,346,663,"6 de julio de 1997"
9,26,8,3073,356,376,732,"6 de julio de 1997"
9,26,8,3074,537,557,1094,"6 de julio de 1997"
9,26,8,3075,284,287,571,"6 de julio de 1997"
9,26,8,3076,446,474,920,"6 de julio de 1997"
9,26,8,3077,637,721,1358,"6 de julio de 1997"
9,26,8,3078,582,658,1240,"6 de julio de 1997"
9,26,8,3079,511,544,1055,"6 de julio de 1997"
9,26,8,3080,353,377,730,"6 de julio de 1997"
9,26,8,3081,476,519,995,"6 de julio de 1997"
9,26,8,3082,382,403,785,"6 de julio de 1997"
9,26,8,3083,547,628,1175,"6 de julio de 1997"
9,26,8,3084,312,330,642,"6 de julio de 1997"
9,26,8,3085,417,456,873,"6 de julio de 1997"
9,26,8,3086,562,594,1156,"6 de julio de 1997"
9,26,8,3087,678,745,1423,"6 de julio de 1997"
9,26,8,3088,655,639,1294,"6 de julio de 1997"
9,26,8,3089,489,528,1017,"6 de julio de 1997"
9,26,8,3090,587,613,1200,"6 de julio de 1997"
9,26,8,3091,705,805,1510,"6 de julio de 1997"
9,26,8,3092,549,592,1141,"6 de julio de 1997"
9,26,8,3093,534,605,1139,"6 de julio de 1997"
9,26,8,3094,316,327,643,"6 de julio de 1997"
9,26,8,3095,294,306,600,"6 de julio de 1997"
9,26,8,3096,654,703,1357,"6 de julio de 1997"
9,26,8,3097,476,504,980,"6 de julio de 1997"
9,26,8,3098,172,184,356,"6 de julio de 1997"
9,26,8,3099,283,306,589,"6 de julio de 1997"
9,26,8,3100,333,346,679,"6 de julio de 1997"
9,26,8,3101,307,400,707,"6 de julio de 1997"
9,26,8,3102,346,343,689,"6 de julio de 1997"
9,26,8,3103,368,389,757,"6 de julio de 1997"
9,26,8,3104,392,423,815,"6 de julio de 1997"
9,26,8,3105,611,656,1267,"6 de julio de 1997"
9,26,8,3106,426,457,883,"6 de julio de 1997"
9,26,8,3107,88,95,183,"6 de julio de 1997"
9,26,8,3108,211,218,429,"6 de julio de 1997"
9,26,8,3109,365,416,781,"6 de julio de 1997"
9,26,8,3110,287,321,608,"6 de julio de 1997"
9,26,8,3111,432,457,889,"6 de julio de 1997"
9,26,8,3112,378,395,773,"6 de julio de 1997"
9,26,8,3113,306,316,622,"6 de julio de 1997"
9,26,8,3114,430,480,910,"6 de julio de 1997"
9,26,8,3115,326,366,692,"6 de julio de 1997"
9,26,8,3116,340,371,711,"6 de julio de 1997"
9,26,8,3117,543,588,1131,"6 de julio de 1997"
9,26,8,3118,554,634,1188,"6 de julio de 1997"
9,26,10,3558,510,567,1077,"6 de julio de 1997"
9,26,10,3559,409,480,889,"6 de julio de 1997"
9,26,10,3560,611,641,1252,"6 de julio de 1997"
9,26,10,3561,800,893,1693,"6 de julio de 1997"
9,26,10,3563,487,513,1000,"6 de julio de 1997"
9,26,10,3564,537,574,1111,"6 de julio de 1997"
9,26,10,3565,339,367,706,"6 de julio de 1997"
9,26,10,3566,531,577,1108,"6 de julio de 1997"
9,26,10,3567,347,378,725,"6 de julio de 1997"
9,26,10,3568,739,830,1569,"6 de julio de 1997"
9,26,10,3569,219,254,473,"6 de julio de 1997"
9,26,10,3570,317,357,674,"6 de julio de 1997"
9,26,10,3571,357,413,770,"6 de julio de 1997"
9,26,10,3572,176,191,367,"6 de julio de 1997"
9,26,10,3579,402,435,837,"6 de julio de 1997"
9,26,10,3580,438,435,873,"6 de julio de 1997"
9,26,10,3581,638,700,1338,"6 de julio de 1997"
9,26,10,3582,562,655,1217,"6 de julio de 1997"
9,26,10,3583,678,752,1430,"6 de julio de 1997"
9,26,10,3584,847,859,1706,"6 de julio de 1997"
9,26,10,3585,497,523,1020,"6 de julio de 1997"
9,26,10,3586,574,629,1203,"6 de julio de 1997"
9,26,10,3587,624,700,1324,"6 de julio de 1997"
9,26,10,3588,469,503,972,"6 de julio de 1997"
9,26,10,3589,579,661,1240,"6 de julio de 1997"
9,26,10,3590,545,591,1136,"6 de julio de 1997"
9,26,10,3591,570,575,1145,"6 de julio de 1997"
9,26,10,3592,570,598,1168,"6 de julio de 1997"
9,26,10,3593,617,664,1281,"6 de julio de 1997"
9,26,10,3594,421,437,858,"6 de julio de 1997"
9,26,10,3595,726,740,1466,"6 de julio de 1997"
9,26,10,3596,689,737,1426,"6 de julio de 1997"
9,26,10,3597,521,569,1090,"6 de julio de 1997"
9,26,10,3598,599,626,1225,"6 de julio de 1997"
9,26,10,3599,470,541,1011,"6 de julio de 1997"
9,26,10,3600,692,815,1507,"6 de julio de 1997"
9,26,10,3601,477,485,962,"6 de julio de 1997"
9,26,10,3602,371,404,775,"6 de julio de 1997"
9,26,10,3606,467,488,955,"6 de julio de 1997"
9,26,10,3607,230,268,498,"6 de julio de 1997"
9,27,9,3119,468,509,977,"6 de julio de 1997"
9,27,9,3120,575,594,1169,"6 de julio de 1997"
9,27,9,3121,563,608,1171,"6 de julio de 1997"
9,27,9,3122,728,796,1524,"6 de julio de 1997"
9,27,9,3123,731,737,1468,"6 de julio de 1997"
9,27,9,3124,573,591,1164,"6 de julio de 1997"
9,27,9,3125,601,656,1257,"6 de julio de 1997"
9,27,9,3126,576,597,1173,"6 de julio de 1997"
9,27,9,3127,444,424,868,"6 de julio de 1997"
9,27,9,3128,471,510,981,"6 de julio de 1997"
9,27,9,3129,527,522,1049,"6 de julio de 1997"
9,27,9,3130,488,554,1042,"6 de julio de 1997"
9,27,9,3131,554,631,1185,"6 de julio de 1997"
9,27,9,3132,610,643,1253,"6 de julio de 1997"
9,27,9,3133,601,647,1248,"6 de julio de 1997"
9,27,9,3134,663,691,1354,"6 de julio de 1997"
9,27,9,3135,506,531,1037,"6 de julio de 1997"
9,27,9,3136,476,502,978,"6 de julio de 1997"
9,27,9,3137,517,550,1067,"6 de julio de 1997"
9,27,9,3138,583,568,1151,"6 de julio de 1997"
9,27,9,3139,481,484,965,"6 de julio de 1997"
9,27,9,3140,501,508,1009,"6 de julio de 1997"
9,27,9,3141,429,434,863,"6 de julio de 1997"
9,27,9,3142,407,434,841,"6 de julio de 1997"
9,27,9,3143,440,492,932,"6 de julio de 1997"
9,27,9,3144,428,432,860,"6 de julio de 1997"
9,27,9,3145,425,404,829,"6 de julio de 1997"
9,27,9,3146,439,434,873,"6 de julio de 1997"
9,27,9,3147,443,517,960,"6 de julio de 1997"
9,27,9,3148,427,415,842,"6 de julio de 1997"
9,27,9,3149,556,552,1108,"6 de julio de 1997"
9,27,9,3150,463,431,894,"6 de julio de 1997"
9,27,9,3151,451,466,917,"6 de julio de 1997"
9,27,9,3152,378,395,773,"6 de julio de 1997"
9,27,9,3153,547,618,1165,"6 de julio de 1997"
9,27,9,3154,493,530,1023,"6 de julio de 1997"
9,27,9,3155,512,540,1052,"6 de julio de 1997"
9,27,9,3156,471,480,951,"6 de julio de 1997"
9,27,9,3157,544,551,1095,"6 de julio de 1997"
9,27,9,3158,462,492,954,"6 de julio de 1997"
9,27,9,3159,829,876,1705,"6 de julio de 1997"
9,27,9,3160,685,761,1446,"6 de julio de 1997"
9,27,9,3161,609,618,1227,"6 de julio de 1997"
9,27,9,3162,380,444,824,"6 de julio de 1997"
9,27,11,3609,829,862,1691,"6 de julio de 1997"
9,27,11,3610,545,591,1136,"6 de julio de 1997"
9,27,11,3611,516,568,1084,"6 de julio de 1997"
9,27,11,3612,418,490,908,"6 de julio de 1997"
9,27,11,3613,423,486,909,"6 de julio de 1997"
9,27,11,3614,635,670,1305,"6 de julio de 1997"
9,27,11,3615,629,629,1258,"6 de julio de 1997"
9,27,11,3616,503,540,1043,"6 de julio de 1997"
9,27,11,3617,590,666,1256,"6 de julio de 1997"
9,27,11,3618,699,814,1513,"6 de julio de 1997"
9,27,11,3619,524,584,1108,"6 de julio de 1997"
9,27,11,3620,692,710,1402,"6 de julio de 1997"
9,27,11,3621,176,177,353,"6 de julio de 1997"
9,27,11,3622,605,653,1258,"6 de julio de 1997"
9,27,11,3623,577,613,1190,"6 de julio de 1997"
9,27,11,3624,552,661,1213,"6 de julio de 1997"
9,27,11,3625,492,544,1036,"6 de julio de 1997"
9,27,11,3626,535,607,1142,"6 de julio de 1997"
9,27,11,3627,675,806,1481,"6 de julio de 1997"
9,27,11,3628,1037,1176,2213,"6 de julio de 1997"
9,27,11,3629,546,629,1175,"6 de julio de 1997"
9,27,11,3630,464,520,984,"6 de julio de 1997"
9,27,11,3631,200,240,440,"6 de julio de 1997"
9,27,11,3632,654,682,1336,"6 de julio de 1997"
9,27,11,3633,575,629,1204,"6 de julio de 1997"
9,27,11,3634,513,567,1080,"6 de julio de 1997"
9,27,11,3635,543,600,1143,"6 de julio de 1997"
9,27,11,3636,1014,1219,2233,"6 de julio de 1997"
9,27,11,3637,836,1008,1844,"6 de julio de 1997"
9,27,11,3638,372,421,793,"6 de julio de 1997"
9,27,11,3639,498,538,1036,"6 de julio de 1997"
9,27,11,3640,538,602,1140,"6 de julio de 1997"
9,27,11,3641,563,668,1231,"6 de julio de 1997"
9,27,11,3642,637,707,1344,"6 de julio de 1997"
9,27,11,3643,622,731,1353,"6 de julio de 1997"
9,27,11,3644,533,589,1122,"6 de julio de 1997"
9,27,11,3645,587,604,1191,"6 de julio de 1997"
9,27,11,3646,424,428,852,"6 de julio de 1997"
9,27,11,3647,494,556,1050,"6 de julio de 1997"
9,27,11,3648,509,569,1078,"6 de julio de 1997"
9,27,11,3649,517,567,1084,"6 de julio de 1997"
9,27,11,3650,450,525,975,"6 de julio de 1997"
9,27,11,3651,550,607,1157,"6 de julio de 1997"
9,27,11,3652,458,513,971,"6 de julio de 1997"
9,27,11,3653,736,816,1552,"6 de julio de 1997"
9,27,11,3654,716,788,1504,"6 de julio de 1997"
9,27,11,3655,550,564,1114,"6 de julio de 1997"
9,27,11,3656,564,570,1134,"6 de julio de 1997"
9,27,11,3657,598,668,1266,"6 de julio de 1997"
9,27,11,3658,536,566,1102,"6 de julio de 1997"
9,27,11,3659,555,625,1180,"6 de julio de 1997"
9,27,11,3660,529,601,1130,"6 de julio de 1997"
9,27,11,3661,531,607,1138,"6 de julio de 1997"
9,27,11,3662,487,519,1006,"6 de julio de 1997"
9,27,11,3663,535,536,1071,"6 de julio de 1997"
9,27,11,3664,594,629,1223,"6 de julio de 1997"
9,27,11,3665,626,730,1356,"6 de julio de 1997"
9,27,11,3666,567,579,1146,"6 de julio de 1997"
9,27,11,3667,601,603,1204,"6 de julio de 1997"
9,27,11,3668,513,579,1092,"6 de julio de 1997"
9,27,11,3669,507,566,1073,"6 de julio de 1997"
9,27,11,3670,541,564,1105,"6 de julio de 1997"
9,27,11,3671,478,538,1016,"6 de julio de 1997"
9,27,11,3672,474,529,1003,"6 de julio de 1997"
9,27,11,3673,646,688,1334,"6 de julio de 1997"
9,27,11,3674,607,669,1276,"6 de julio de 1997"
9,27,11,3675,661,662,1323,"6 de julio de 1997"
9,27,11,3676,661,725,1386,"6 de julio de 1997"
9,27,11,3677,591,655,1246,"6 de julio de 1997"
9,27,11,3678,484,552,1036,"6 de julio de 1997"
9,27,11,3679,526,567,1093,"6 de julio de 1997"
9,27,11,3680,669,689,1358,"6 de julio de 1997"
9,27,11,3681,453,510,963,"6 de julio de 1997"
9,27,11,3682,657,674,1331,"6 de julio de 1997"
9,27,11,3683,574,594,1168,"6 de julio de 1997"
9,27,11,3684,901,1005,1906,"6 de julio de 1997"
9,27,11,3685,506,533,1039,"6 de julio de 1997"
9,27,11,3686,575,633,1208,"6 de julio de 1997"
9,27,11,3687,621,620,1241,"6 de julio de 1997"
9,27,11,3688,549,534,1083,"6 de julio de 1997"
9,27,11,3689,606,623,1229,"6 de julio de 1997"
9,27,11,3690,605,619,1224,"6 de julio de 1997"
9,27,11,3691,695,750,1445,"6 de julio de 1997"
9,27,11,3692,612,656,1268,"6 de julio de 1997"
9,27,11,3693,612,703,1315,"6 de julio de 1997"
9,27,11,3694,529,623,1152,"6 de julio de 1997"
9,27,11,3695,692,715,1407,"6 de julio de 1997"
9,27,11,3696,557,559,1116,"6 de julio de 1997"
9,27,11,3697,529,578,1107,"6 de julio de 1997"
9,27,11,3698,451,470,921,"6 de julio de 1997"
9,27,11,3699,501,546,1047,"6 de julio de 1997"
9,27,11,3700,657,724,1381,"6 de julio de 1997"
9,27,11,3701,598,648,1246,"6 de julio de 1997"
9,27,11,3702,590,680,1270,"6 de julio de 1997"
9,27,11,3703,693,754,1447,"6 de julio de 1997"
9,27,11,3704,591,685,1276,"6 de julio de 1997"
9,27,11,3705,562,662,1224,"6 de julio de 1997"
9,27,11,3706,569,665,1234,"6 de julio de 1997"
9,27,11,3707,459,467,926,"6 de julio de 1997"
9,27,11,3708,808,876,1684,"6 de julio de 1997"
9,27,11,3709,591,625,1216,"6 de julio de 1997"
9,27,11,3710,568,590,1158,"6 de julio de 1997"
9,27,11,3711,571,630,1201,"6 de julio de 1997"
9,27,11,3712,548,609,1157,"6 de julio de 1997"
9,27,11,3713,646,687,1333,"6 de julio de 1997"
9,27,11,3714,590,624,1214,"6 de julio de 1997"
9,27,11,3715,483,546,1029,"6 de julio de 1997"
9,27,11,3716,646,730,1376,"6 de julio de 1997"
9,27,11,3717,730,827,1557,"6 de julio de 1997"
9,27,11,3718,696,733,1429,"6 de julio de 1997"
9,27,11,3719,675,739,1414,"6 de julio de 1997"
9,27,11,3720,458,485,943,"6 de julio de 1997"
9,27,11,3721,575,624,1199,"6 de julio de 1997"
9,27,11,3722,649,702,1351,"6 de julio de 1997"
9,27,11,3723,548,581,1129,"6 de julio de 1997"
9,27,11,3724,653,659,1312,"6 de julio de 1997"
9,27,11,3725,535,556,1091,"6 de julio de 1997"
9,27,11,3726,549,548,1097,"6 de julio de 1997"
9,27,11,3727,587,657,1244,"6 de julio de 1997"
9,27,11,3728,530,605,1135,"6 de julio de 1997"
9,27,11,3729,478,531,1009,"6 de julio de 1997"
9,27,11,3730,328,360,688,"6 de julio de 1997"
9,27,11,3731,458,510,968,"6 de julio de 1997"
9,27,11,3732,327,338,665,"6 de julio de 1997"
9,27,11,3733,330,504,834,"6 de julio de 1997"
9,27,11,3734,140,162,302,"6 de julio de 1997"
9,27,11,3735,107,126,233,"6 de julio de 1997"
9,27,11,3736,139,161,300,"6 de julio de 1997"
9,27,11,3737,136,190,326,"6 de julio de 1997"
9,27,11,3738,259,345,604,"6 de julio de 1997"
9,27,11,3739,122,161,283,"6 de julio de 1997"
9,27,11,3740,276,269,545,"6 de julio de 1997"
9,27,11,3741,373,418,791,"6 de julio de 1997"
9,28,13,4095,500,588,1088,"6 de julio de 1997"
9,28,13,4096,604,687,1291,"6 de julio de 1997"
9,28,13,4097,452,540,992,"6 de julio de 1997"
9,28,13,4098,486,595,1081,"6 de julio de 1997"
9,28,13,4099,328,374,702,"6 de julio de 1997"
9,28,13,4100,461,574,1035,"6 de julio de 1997"
9,28,13,4101,504,591,1095,"6 de julio de 1997"
9,28,13,4102,449,473,922,"6 de julio de 1997"
9,28,13,4103,535,601,1136,"6 de julio de 1997"
9,28,13,4104,599,672,1271,"6 de julio de 1997"
9,28,13,4105,614,622,1236,"6 de julio de 1997"
9,28,13,4106,496,479,975,"6 de julio de 1997"
9,28,13,4107,662,721,1383,"6 de julio de 1997"
9,28,13,4108,645,662,1307,"6 de julio de 1997"
9,28,13,4109,731,738,1469,"6 de julio de 1997"
9,28,13,4110,602,660,1262,"6 de julio de 1997"
9,28,13,4111,498,560,1058,"6 de julio de 1997"
9,28,13,4112,510,550,1060,"6 de julio de 1997"
9,28,13,4113,482,530,1012,"6 de julio de 1997"
9,28,13,4114,505,557,1062,"6 de julio de 1997"
9,28,13,4115,279,313,592,"6 de julio de 1997"
9,28,13,4116,331,389,720,"6 de julio de 1997"
9,28,13,4117,386,463,849,"6 de julio de 1997"
9,28,13,4118,566,617,1183,"6 de julio de 1997"
9,28,13,4119,657,726,1383,"6 de julio de 1997"
9,28,13,4120,464,484,948,"6 de julio de 1997"
9,28,13,4121,343,368,711,"6 de julio de 1997"
9,28,13,4122,739,817,1556,"6 de julio de 1997"
9,28,13,4123,498,530,1028,"6 de julio de 1997"
9,28,13,4124,589,720,1309,"6 de julio de 1997"
9,28,13,4125,502,605,1107,"6 de julio de 1997"
9,28,13,4126,455,506,961,"6 de julio de 1997"
9,28,13,4127,549,560,1109,"6 de julio de 1997"
9,28,13,4128,598,650,1248,"6 de julio de 1997"
9,28,13,4129,513,631,1144,"6 de julio de 1997"
9,28,13,4130,555,607,1162,"6 de julio de 1997"
9,28,13,4131,418,471,889,"6 de julio de 1997"
9,28,13,4132,474,539,1013,"6 de julio de 1997"
9,28,13,4133,415,466,881,"6 de julio de 1997"
9,28,13,4134,345,374,719,"6 de julio de 1997"
9,28,13,4135,551,633,1184,"6 de julio de 1997"
9,28,13,4136,406,464,870,"6 de julio de 1997"
9,28,13,4137,510,571,1081,"6 de julio de 1997"
9,28,13,4138,559,628,1187,"6 de julio de 1997"
9,28,13,4139,582,581,1163,"6 de julio de 1997"
9,28,13,4140,705,772,1477,"6 de julio de 1997"
9,28,13,4141,498,550,1048,"6 de julio de 1997"
9,28,13,4142,645,716,1361,"6 de julio de 1997"
9,28,13,4143,523,578,1101,"6 de julio de 1997"
9,28,13,4144,574,664,1238,"6 de julio de 1997"
9,28,13,4145,463,522,985,"6 de julio de 1997"
9,28,13,4146,815,900,1715,"6 de julio de 1997"
9,28,13,4147,339,396,735,"6 de julio de 1997"
9,28,13,4148,667,741,1408,"6 de julio de 1997"
9,28,13,4149,509,563,1072,"6 de julio de 1997"
9,28,13,4150,488,530,1018,"6 de julio de 1997"
9,28,13,4151,623,696,1319,"6 de julio de 1997"
9,28,13,4152,569,649,1218,"6 de julio de 1997"
9,28,13,4153,642,680,1322,"6 de julio de 1997"
9,28,13,4154,577,665,1242,"6 de julio de 1997"
9,28,13,4155,553,609,1162,"6 de julio de 1997"
9,28,13,4156,482,566,1048,"6 de julio de 1997"
9,28,13,4157,532,606,1138,"6 de julio de 1997"
9,28,13,4158,569,650,1219,"6 de julio de 1997"
9,28,13,4159,499,556,1055,"6 de julio de 1997"
9,28,13,4160,481,516,997,"6 de julio de 1997"
9,28,13,4161,719,787,1506,"6 de julio de 1997"
9,28,13,4162,534,593,1127,"6 de julio de 1997"
9,28,13,4163,559,638,1197,"6 de julio de 1997"
9,28,13,4164,846,898,1744,"6 de julio de 1997"
9,28,13,4165,674,739,1413,"6 de julio de 1997"
9,28,13,4166,551,679,1230,"6 de julio de 1997"
9,28,13,4167,618,677,1295,"6 de julio de 1997"
9,28,13,4168,716,771,1487,"6 de julio de 1997"
9,28,13,4169,583,611,1194,"6 de julio de 1997"
9,28,13,4170,553,601,1154,"6 de julio de 1997"
9,28,13,4171,543,613,1156,"6 de julio de 1997"
9,28,13,4172,481,524,1005,"6 de julio de 1997"
9,28,13,4173,669,714,1383,"6 de julio de 1997"
9,28,13,4174,462,530,992,"6 de julio de 1997"
9,28,13,4175,578,632,1210,"6 de julio de 1997"
9,28,13,4176,478,537,1015,"6 de julio de 1997"
9,28,13,4177,713,768,1481,"6 de julio de 1997"
9,28,13,4178,667,713,1380,"6 de julio de 1997"
9,28,13,4179,586,651,1237,"6 de julio de 1997"
9,28,13,4180,366,405,771,"6 de julio de 1997"
9,28,13,4181,488,525,1013,"6 de julio de 1997"
9,28,13,4182,627,728,1355,"6 de julio de 1997"
9,28,13,4183,728,757,1485,"6 de julio de 1997"
9,28,13,4184,521,583,1104,"6 de julio de 1997"
9,28,13,4185,509,567,1076,"6 de julio de 1997"
9,28,13,4186,537,640,1177,"6 de julio de 1997"
9,28,13,4187,534,613,1147,"6 de julio de 1997"
9,28,13,4188,586,646,1232,"6 de julio de 1997"
9,28,13,4189,490,577,1067,"6 de julio de 1997"
9,28,13,4190,435,461,896,"6 de julio de 1997"
9,28,13,4191,618,676,1294,"6 de julio de 1997"
9,28,13,4192,440,441,881,"6 de julio de 1997"
9,28,13,4193,333,344,677,"6 de julio de 1997"
9,28,13,4194,434,541,975,"6 de julio de 1997"
9,28,13,4195,369,417,786,"6 de julio de 1997"
9,28,13,4196,639,695,1334,"6 de julio de 1997"
9,28,13,4197,582,639,1221,"6 de julio de 1997"
9,28,13,4198,528,604,1132,"6 de julio de 1997"
9,28,13,4199,532,576,1108,"6 de julio de 1997"
9,28,13,4200,611,679,1290,"6 de julio de 1997"
9,28,13,4201,816,925,1741,"6 de julio de 1997"
9,28,13,4202,385,436,821,"6 de julio de 1997"
9,28,13,4203,374,456,830,"6 de julio de 1997"
9,28,13,4204,437,539,976,"6 de julio de 1997"
9,28,13,4205,505,612,1117,"6 de julio de 1997"
9,28,13,4206,445,518,963,"6 de julio de 1997"
9,28,13,4207,350,480,830,"6 de julio de 1997"
9,28,13,4208,493,545,1038,"6 de julio de 1997"
9,28,13,4209,582,650,1232,"6 de julio de 1997"
9,28,13,4210,527,570,1097,"6 de julio de 1997"
9,28,13,4211,554,615,1169,"6 de julio de 1997"
9,28,13,4212,470,506,976,"6 de julio de 1997"
9,28,13,4213,677,760,1437,"6 de julio de 1997"
9,28,13,4214,446,523,969,"6 de julio de 1997"
9,28,13,4215,453,489,942,"6 de julio de 1997"
9,28,13,4216,583,632,1215,"6 de julio de 1997"
9,28,13,4217,461,523,984,"6 de julio de 1997"
9,28,13,4218,620,666,1286,"6 de julio de 1997"
9,28,13,4219,588,625,1213,"6 de julio de 1997"
9,28,13,4220,511,563,1074,"6 de julio de 1997"
9,28,13,4221,467,489,956,"6 de julio de 1997"
9,28,13,4222,659,756,1415,"6 de julio de 1997"
9,28,13,4223,760,847,1607,"6 de julio de 1997"
9,28,13,4224,656,745,1401,"6 de julio de 1997"
9,28,13,4225,737,791,1528,"6 de julio de 1997"
9,28,13,4226,635,685,1320,"6 de julio de 1997"
9,28,13,4227,618,699,1317,"6 de julio de 1997"
9,28,13,4228,832,847,1679,"6 de julio de 1997"
9,28,13,4229,635,665,1300,"6 de julio de 1997"
9,28,13,4230,453,563,1016,"6 de julio de 1997"
9,28,13,4231,532,582,1114,"6 de julio de 1997"
9,28,13,4232,379,450,829,"6 de julio de 1997"
9,28,13,4233,457,578,1035,"6 de julio de 1997"
9,28,13,4234,693,787,1480,"6 de julio de 1997"
9,28,13,4235,727,810,1537,"6 de julio de 1997"
9,28,13,4236,759,817,1576,"6 de julio de 1997"
9,28,13,4237,738,786,1524,"6 de julio de 1997"
9,28,13,4238,787,849,1636,"6 de julio de 1997"
9,28,13,4239,726,810,1536,"6 de julio de 1997"
9,28,13,4240,376,377,753,"6 de julio de 1997"
9,28,13,4241,547,620,1167,"6 de julio de 1997"
9,28,13,4242,519,614,1133,"6 de julio de 1997"
9,28,13,4243,477,555,1032,"6 de julio de 1997"
9,28,13,4244,555,636,1191,"6 de julio de 1997"
9,28,13,4245,560,594,1154,"6 de julio de 1997"
9,28,13,4246,1166,1166,2332,"6 de julio de 1997"
9,28,13,4247,434,459,893,"6 de julio de 1997"
9,28,13,4248,737,782,1519,"6 de julio de 1997"
9,28,13,4249,527,581,1108,"6 de julio de 1997"
9,28,13,4250,632,666,1298,"6 de julio de 1997"
9,28,13,4251,614,674,1288,"6 de julio de 1997"
9,28,13,4252,544,599,1143,"6 de julio de 1997"
9,28,13,4253,650,680,1330,"6 de julio de 1997"
9,28,13,4254,654,711,1365,"6 de julio de 1997"
9,28,13,4255,629,673,1302,"6 de julio de 1997"
9,28,13,4256,548,591,1139,"6 de julio de 1997"
9,28,13,4257,585,665,1250,"6 de julio de 1997"
9,28,13,4258,467,490,957,"6 de julio de 1997"
9,28,13,4259,612,665,1277,"6 de julio de 1997"
9,28,13,4260,969,988,1957,"6 de julio de 1997"
9,28,13,4261,702,780,1482,"6 de julio de 1997"
9,28,13,4262,645,677,1322,"6 de julio de 1997"
9,28,13,4263,605,659,1264,"6 de julio de 1997"
9,28,13,4264,552,569,1121,"6 de julio de 1997"
9,28,13,4265,624,630,1254,"6 de julio de 1997"
9,28,13,4266,542,557,1099,"6 de julio de 1997"
9,28,13,4267,284,330,614,"6 de julio de 1997"
9,28,13,4268,94,116,210,"6 de julio de 1997"
9,29,12,3769,472,591,1063,"6 de julio de 1997"
9,29,12,3770,319,419,738,"6 de julio de 1997"
9,29,12,3771,457,545,1002,"6 de julio de 1997"
9,29,12,3772,191,242,433,"6 de julio de 1997"
9,29,12,3773,332,459,791,"6 de julio de 1997"
9,29,12,3774,717,816,1533,"6 de julio de 1997"
9,29,12,3775,385,553,938,"6 de julio de 1997"
9,29,12,3776,421,530,951,"6 de julio de 1997"
9,29,12,3777,369,502,871,"6 de julio de 1997"
9,29,12,3778,310,371,681,"6 de julio de 1997"
9,29,12,3779,319,401,720,"6 de julio de 1997"
9,29,12,3780,547,673,1220,"6 de julio de 1997"
9,29,12,3781,477,599,1076,"6 de julio de 1997"
9,29,12,3782,267,357,624,"6 de julio de 1997"
9,29,12,3783,370,483,853,"6 de julio de 1997"
9,29,12,3784,128,160,288,"6 de julio de 1997"
9,29,12,3785,540,551,1091,"6 de julio de 1997"
9,29,12,3786,581,585,1166,"6 de julio de 1997"
9,29,12,3787,518,558,1076,"6 de julio de 1997"
9,29,12,3788,555,630,1185,"6 de julio de 1997"
9,29,12,3789,218,291,509,"6 de julio de 1997"
9,29,12,3790,515,591,1106,"6 de julio de 1997"
9,29,12,3791,554,601,1155,"6 de julio de 1997"
9,29,12,3792,533,546,1079,"6 de julio de 1997"
9,29,12,3793,449,465,914,"6 de julio de 1997"
9,29,12,3794,564,624,1188,"6 de julio de 1997"
9,29,12,3795,508,557,1065,"6 de julio de 1997"
9,29,12,3796,560,609,1169,"6 de julio de 1997"
9,29,12,3797,522,593,1115,"6 de julio de 1997"
9,29,12,3798,484,547,1031,"6 de julio de 1997"
9,29,12,3799,640,723,1363,"6 de julio de 1997"
9,29,12,3800,614,660,1274,"6 de julio de 1997"
9,29,12,3801,521,569,1090,"6 de julio de 1997"
9,29,12,3802,579,637,1216,"6 de julio de 1997"
9,29,12,3803,569,617,1186,"6 de julio de 1997"
9,29,12,3804,566,621,1187,"6 de julio de 1997"
9,29,12,3805,499,524,1023,"6 de julio de 1997"
9,29,12,3806,513,578,1091,"6 de julio de 1997"
9,29,12,3807,395,426,821,"6 de julio de 1997"
9,29,12,3808,382,456,838,"6 de julio de 1997"
9,29,12,3809,657,692,1349,"6 de julio de 1997"
9,29,12,3810,497,527,1024,"6 de julio de 1997"
9,29,12,3811,469,544,1013,"6 de julio de 1997"
9,29,12,3812,598,682,1280,"6 de julio de 1997"
9,29,12,3813,609,683,1292,"6 de julio de 1997"
9,29,12,3814,657,694,1351,"6 de julio de 1997"
9,29,12,3815,447,452,899,"6 de julio de 1997"
9,29,12,3816,729,808,1537,"6 de julio de 1997"
9,29,12,3817,733,738,1471,"6 de julio de 1997"
9,29,12,3818,656,728,1384,"6 de julio de 1997"
9,29,12,3819,455,479,934,"6 de julio de 1997"
9,29,12,3820,544,621,1165,"6 de julio de 1997"
9,29,12,3821,508,549,1057,"6 de julio de 1997"
9,29,12,3822,514,533,1047,"6 de julio de 1997"
9,29,12,3823,550,669,1219,"6 de julio de 1997"
9,29,12,3824,539,570,1109,"6 de julio de 1997"
9,29,12,3825,372,441,813,"6 de julio de 1997"
9,29,12,3826,540,562,1102,"6 de julio de 1997"
9,29,12,3827,550,610,1160,"6 de julio de 1997"
9,29,12,3828,526,582,1108,"6 de julio de 1997"
9,29,12,3829,641,711,1352,"6 de julio de 1997"
9,29,12,3830,509,583,1092,"6 de julio de 1997"
9,29,12,3831,377,407,784,"6 de julio de 1997"
9,29,12,3832,564,576,1140,"6 de julio de 1997"
9,29,12,3833,511,575,1086,"6 de julio de 1997"
9,29,12,3834,347,385,732,"6 de julio de 1997"
9,29,12,3835,475,559,1034,"6 de julio de 1997"
9,29,12,3836,442,537,979,"6 de julio de 1997"
9,29,12,3837,245,318,563,"6 de julio de 1997"
9,29,12,3838,443,521,964,"6 de julio de 1997"
9,29,12,3839,401,448,849,"6 de julio de 1997"
9,29,12,3840,624,644,1268,"6 de julio de 1997"
9,29,12,3841,512,525,1037,"6 de julio de 1997"
9,29,12,3842,352,505,857,"6 de julio de 1997"
9,29,12,3843,549,738,1287,"6 de julio de 1997"
9,29,12,3844,436,569,1005,"6 de julio de 1997"
9,29,12,3845,449,493,942,"6 de julio de 1997"
9,29,12,3846,307,386,693,"6 de julio de 1997"
9,29,12,3847,424,434,858,"6 de julio de 1997"
9,29,12,3848,483,595,1078,"6 de julio de 1997"
9,29,12,3849,360,387,747,"6 de julio de 1997"
9,29,12,3850,333,465,798,"6 de julio de 1997"
9,29,12,3851,277,334,611,"6 de julio de 1997"
9,29,12,3852,266,330,596,"6 de julio de 1997"
9,29,12,3853,258,332,590,"6 de julio de 1997"
9,29,12,3854,238,285,523,"6 de julio de 1997"
9,29,12,3855,405,427,832,"6 de julio de 1997"
9,29,12,3856,588,625,1213,"6 de julio de 1997"
9,29,12,3857,661,754,1415,"6 de julio de 1997"
9,29,12,3858,600,680,1280,"6 de julio de 1997"
9,29,12,3859,469,484,953,"6 de julio de 1997"
9,29,12,3860,551,617,1168,"6 de julio de 1997"
9,29,12,3861,672,731,1403,"6 de julio de 1997"
9,29,12,3862,469,531,1000,"6 de julio de 1997"
9,29,12,3863,518,586,1104,"6 de julio de 1997"
9,29,12,3864,434,444,878,"6 de julio de 1997"
9,29,12,3865,486,528,1014,"6 de julio de 1997"
9,29,12,3866,522,593,1115,"6 de julio de 1997"
9,29,12,3867,641,683,1324,"6 de julio de 1997"
9,29,12,3868,600,651,1251,"6 de julio de 1997"
9,29,12,3869,516,586,1102,"6 de julio de 1997"
9,29,12,3870,626,709,1335,"6 de julio de 1997"
9,29,12,3871,553,603,1156,"6 de julio de 1997"
9,29,12,3872,660,732,1392,"6 de julio de 1997"
9,29,12,3873,605,636,1241,"6 de julio de 1997"
9,29,12,3874,657,701,1358,"6 de julio de 1997"
9,29,12,3875,687,737,1424,"6 de julio de 1997"
9,29,12,3876,674,697,1371,"6 de julio de 1997"
9,29,12,3877,612,651,1263,"6 de julio de 1997"
9,29,12,3878,580,630,1210,"6 de julio de 1997"
9,29,12,3879,488,517,1005,"6 de julio de 1997"
9,29,12,3880,501,574,1075,"6 de julio de 1997"
9,29,12,3881,555,571,1126,"6 de julio de 1997"
9,29,12,3882,431,477,908,"6 de julio de 1997"
9,29,12,3883,457,505,962,"6 de julio de 1997"
9,29,12,3884,572,615,1187,"6 de julio de 1997"
9,29,12,3885,592,640,1232,"6 de julio de 1997"
9,29,12,3886,45,50,95,"6 de julio de 1997"
9,29,12,3887,98,96,194,"6 de julio de 1997"
9,29,12,3888,317,315,632,"6 de julio de 1997"
9,29,12,3889,666,748,1414,"6 de julio de 1997"
9,29,12,3890,256,348,604,"6 de julio de 1997"
9,29,12,3891,283,330,613,"6 de julio de 1997"
9,29,12,3892,403,438,841,"6 de julio de 1997"
9,29,12,3893,438,407,845,"6 de julio de 1997"
9,29,12,3894,247,314,561,"6 de julio de 1997"
9,29,12,3895,63,92,155,"6 de julio de 1997"
9,29,12,3896,69,104,173,"6 de julio de 1997"
9,29,12,3897,119,158,277,"6 de julio de 1997"
9,29,12,3898,197,208,405,"6 de julio de 1997"
9,29,12,3899,567,617,1184,"6 de julio de 1997"
9,29,12,3900,110,152,262,"6 de julio de 1997"
9,29,12,3901,218,314,532,"6 de julio de 1997"
9,29,12,3902,205,212,417,"6 de julio de 1997"
9,29,12,3903,448,489,937,"6 de julio de 1997"
9,29,12,3904,548,635,1183,"6 de julio de 1997"
9,29,12,3905,333,359,692,"6 de julio de 1997"
9,29,12,3906,763,832,1595,"6 de julio de 1997"
9,29,12,3907,284,345,629,"6 de julio de 1997"
9,29,12,3908,537,604,1141,"6 de julio de 1997"
9,29,12,3909,421,458,879,"6 de julio de 1997"
9,29,12,3910,593,654,1247,"6 de julio de 1997"
9,29,12,3911,606,591,1197,"6 de julio de 1997"
9,29,12,3912,476,500,976,"6 de julio de 1997"
9,29,12,3913,433,500,933,"6 de julio de 1997"
9,29,12,3914,498,518,1016,"6 de julio de 1997"
9,29,12,3915,556,624,1180,"6 de julio de 1997"
9,29,12,3916,486,578,1064,"6 de julio de 1997"
9,29,12,3917,445,465,910,"6 de julio de 1997"
9,29,12,3918,609,651,1260,"6 de julio de 1997"
9,29,12,3919,487,537,1024,"6 de julio de 1997"
9,29,12,3920,221,275,496,"6 de julio de 1997"
9,29,12,3921,743,829,1572,"6 de julio de 1997"
9,29,12,3922,386,425,811,"6 de julio de 1997"
9,29,12,3923,501,565,1066,"6 de julio de 1997"
9,29,12,3924,486,587,1073,"6 de julio de 1997"
9,29,12,3925,500,542,1042,"6 de julio de 1997"
9,29,12,3926,495,550,1045,"6 de julio de 1997"
9,29,12,3927,603,675,1278,"6 de julio de 1997"
9,29,12,3928,525,559,1084,"6 de julio de 1997"
9,29,12,3929,553,664,1217,"6 de julio de 1997"
9,29,12,3930,608,671,1279,"6 de julio de 1997"
9,29,12,3931,484,527,1011,"6 de julio de 1997"
9,29,12,3932,461,512,973,"6 de julio de 1997"
9,29,12,3933,293,333,626,"6 de julio de 1997"
9,29,12,3934,375,392,767,"6 de julio de 1997"
9,29,12,3935,818,853,1671,"6 de julio de 1997"
9,29,12,3936,373,394,767,"6 de julio de 1997"
9,29,12,3937,364,407,771,"6 de julio de 1997"
9,29,12,3938,540,610,1150,"6 de julio de 1997"
9,29,12,3939,514,561,1075,"6 de julio de 1997"
9,29,12,3940,300,344,644,"6 de julio de 1997"
9,29,12,3941,250,268,518,"6 de julio de 1997"
9,29,12,3943,483,613,1096,"6 de julio de 1997"
9,29,12,3995,201,228,429,"6 de julio de 1997"
9,29,12,3996,262,285,547,"6 de julio de 1997"
9,29,12,3997,279,319,598,"6 de julio de 1997"
9,29,12,3998,385,442,827,"6 de julio de 1997"
9,29,12,4001,310,328,638,"6 de julio de 1997"
9,30,12,3742,421,477,898,"6 de julio de 1997"
9,30,12,3743,409,436,845,"6 de julio de 1997"
9,30,12,3744,544,622,1166,"6 de julio de 1997"
9,30,12,3745,500,593,1093,"6 de julio de 1997"
9,30,12,3746,725,819,1544,"6 de julio de 1997"
9,30,12,3747,518,548,1066,"6 de julio de 1997"
9,30,12,3748,564,605,1169,"6 de julio de 1997"
9,30,12,3749,521,551,1072,"6 de julio de 1997"
9,30,12,3750,526,569,1095,"6 de julio de 1997"
9,30,12,3751,534,591,1125,"6 de julio de 1997"
9,30,12,3752,696,687,1383,"6 de julio de 1997"
9,30,12,3753,442,490,932,"6 de julio de 1997"
9,30,12,3754,481,506,987,"6 de julio de 1997"
9,30,12,3755,359,431,790,"6 de julio de 1997"
9,30,12,3756,370,435,805,"6 de julio de 1997"
9,30,12,3757,505,574,1079,"6 de julio de 1997"
9,30,12,3758,654,709,1363,"6 de julio de 1997"
9,30,12,3759,282,310,592,"6 de julio de 1997"
9,30,12,3760,186,196,382,"6 de julio de 1997"
9,30,12,3761,287,285,572,"6 de julio de 1997"
9,30,12,3762,639,672,1311,"6 de julio de 1997"
9,30,12,3763,537,595,1132,"6 de julio de 1997"
9,30,12,3764,321,437,758,"6 de julio de 1997"
9,30,12,3765,390,655,1045,"6 de julio de 1997"
9,30,12,3766,475,600,1075,"6 de julio de 1997"
9,30,12,3767,531,630,1161,"6 de julio de 1997"
9,30,12,3768,21,28,49,"6 de julio de 1997"
9,30,12,3942,352,381,733,"6 de julio de 1997"
9,30,12,3944,944,963,1907,"6 de julio de 1997"
9,30,12,3945,769,794,1563,"6 de julio de 1997"
9,30,12,3946,653,711,1364,"6 de julio de 1997"
9,30,12,3947,587,627,1214,"6 de julio de 1997"
9,30,12,3948,654,664,1318,"6 de julio de 1997"
9,30,12,3949,577,674,1251,"6 de julio de 1997"
9,30,12,3950,390,423,813,"6 de julio de 1997"
9,30,12,3951,793,894,1687,"6 de julio de 1997"
9,30,12,3952,937,915,1852,"6 de julio de 1997"
9,30,12,3953,679,748,1427,"6 de julio de 1997"
9,30,12,3954,432,538,970,"6 de julio de 1997"
9,30,12,3955,540,563,1103,"6 de julio de 1997"
9,30,12,3956,643,517,1160,"6 de julio de 1997"
9,30,12,3957,426,528,954,"6 de julio de 1997"
9,30,12,3958,765,788,1553,"6 de julio de 1997"
9,30,12,3959,573,622,1195,"6 de julio de 1997"
9,30,12,3960,374,422,796,"6 de julio de 1997"
9,30,12,3961,651,696,1347,"6 de julio de 1997"
9,30,12,3962,765,846,1611,"6 de julio de 1997"
9,30,12,3963,634,672,1306,"6 de julio de 1997"
9,30,12,3964,370,384,754,"6 de julio de 1997"
9,30,12,3965,428,444,872,"6 de julio de 1997"
9,30,12,3966,531,552,1083,"6 de julio de 1997"
9,30,12,3967,341,371,712,"6 de julio de 1997"
9,30,12,3968,337,355,692,"6 de julio de 1997"
9,30,12,3969,643,698,1341,"6 de julio de 1997"
9,30,12,3970,698,798,1496,"6 de julio de 1997"
9,30,12,3971,349,365,714,"6 de julio de 1997"
9,30,12,3972,662,675,1337,"6 de julio de 1997"
9,30,12,3973,643,617,1260,"6 de julio de 1997"
9,30,12,3974,530,565,1095,"6 de julio de 1997"
9,30,12,3975,639,670,1309,"6 de julio de 1997"
9,30,12,3976,378,415,793,"6 de julio de 1997"
9,30,12,3977,492,545,1037,"6 de julio de 1997"
9,30,12,3978,604,640,1244,"6 de julio de 1997"
9,30,12,3979,585,650,1235,"6 de julio de 1997"
9,30,12,3980,533,552,1085,"6 de julio de 1997"
9,30,12,3981,700,676,1376,"6 de julio de 1997"
9,30,12,3982,624,650,1274,"6 de julio de 1997"
9,30,12,3983,565,606,1171,"6 de julio de 1997"
9,30,12,3984,818,930,1748,"6 de julio de 1997"
9,30,12,3985,488,554,1042,"6 de julio de 1997"
9,30,12,3986,1009,1040,2049,"6 de julio de 1997"
9,30,12,3987,775,829,1604,"6 de julio de 1997"
9,30,12,3988,801,845,1646,"6 de julio de 1997"
9,30,12,3989,536,568,1104,"6 de julio de 1997"
9,30,12,3990,448,476,924,"6 de julio de 1997"
9,30,12,3991,772,845,1617,"6 de julio de 1997"
9,30,12,3992,666,720,1386,"6 de julio de 1997"
9,30,12,3993,523,532,1055,"6 de julio de 1997"
9,30,12,3994,81,66,147,"6 de julio de 1997"
9,30,12,3999,343,379,722,"6 de julio de 1997"
9,30,12,4000,248,269,517,"6 de julio de 1997"
9,30,12,4002,3601,218,3819,"6 de julio de 1997"
9,30,12,4003,457,512,969,"6 de julio de 1997"
9,30,12,4004,470,575,1045,"6 de julio de 1997"
9,30,12,4005,551,670,1221,"6 de julio de 1997"
9,30,12,4006,537,669,1206,"6 de julio de 1997"
9,30,12,4007,606,689,1295,"6 de julio de 1997"
9,30,12,4008,553,678,1231,"6 de julio de 1997"
9,30,12,4009,624,793,1417,"6 de julio de 1997"
9,30,12,4010,243,286,529,"6 de julio de 1997"
9,30,12,4011,291,319,610,"6 de julio de 1997"
9,30,12,4012,306,366,672,"6 de julio de 1997"
9,30,12,4013,467,526,993,"6 de julio de 1997"
9,30,12,4014,477,605,1082,"6 de julio de 1997"
9,30,12,4015,210,229,439,"6 de julio de 1997"
9,30,12,4016,495,573,1068,"6 de julio de 1997"
9,30,12,4017,470,605,1075,"6 de julio de 1997"
9,30,12,4018,368,420,788,"6 de julio de 1997"
9,30,12,4019,351,432,783,"6 de julio de 1997"
9,30,12,4020,298,342,640,"6 de julio de 1997"
9,30,12,4021,333,388,721,"6 de julio de 1997"
9,30,12,4022,331,362,693,"6 de julio de 1997"
9,30,12,4023,262,329,591,"6 de julio de 1997"
9,30,12,4024,593,688,1281,"6 de julio de 1997"
9,30,12,4025,369,445,814,"6 de julio de 1997"
9,30,12,4026,280,310,590,"6 de julio de 1997"
9,30,12,4027,536,636,1172,"6 de julio de 1997"
9,30,12,4028,399,447,846,"6 de julio de 1997"
9,30,12,4029,394,479,873,"6 de julio de 1997"
9,30,12,4030,383,466,849,"6 de julio de 1997"
9,30,12,4031,450,550,1000,"6 de julio de 1997"
9,30,12,4032,665,786,1451,"6 de julio de 1997"
9,30,12,4033,724,766,1490,"6 de julio de 1997"
9,30,12,4034,576,682,1258,"6 de julio de 1997"
9,30,12,4035,294,309,603,"6 de julio de 1997"
9,30,12,4036,544,706,1250,"6 de julio de 1997"
9,30,12,4037,391,479,870,"6 de julio de 1997"
9,30,12,4038,469,561,1030,"6 de julio de 1997"
9,30,12,4039,449,600,1049,"6 de julio de 1997"
9,30,12,4040,488,660,1148,"6 de julio de 1997"
9,30,12,4041,394,491,885,"6 de julio de 1997"
9,30,12,4042,463,570,1033,"6 de julio de 1997"
9,30,12,4043,442,557,999,"6 de julio de 1997"
9,30,12,4044,395,496,891,"6 de julio de 1997"
9,30,12,4045,346,488,834,"6 de julio de 1997"
9,30,12,4046,407,476,883,"6 de julio de 1997"
9,30,12,4047,362,385,747,"6 de julio de 1997"
9,30,12,4048,316,369,685,"6 de julio de 1997"
9,30,12,4049,563,623,1186,"6 de julio de 1997"
9,30,12,4050,542,638,1180,"6 de julio de 1997"
9,30,12,4051,567,629,1196,"6 de julio de 1997"
9,30,12,4052,426,483,909,"6 de julio de 1997"
9,30,12,4053,339,411,750,"6 de julio de 1997"
9,30,12,4054,450,520,970,"6 de julio de 1997"
9,30,12,4055,491,548,1039,"6 de julio de 1997"
9,30,12,4056,410,476,886,"6 de julio de 1997"
9,30,12,4057,584,613,1197,"6 de julio de 1997"
9,30,12,4058,572,647,1219,"6 de julio de 1997"
9,30,12,4059,365,456,821,"6 de julio de 1997"
9,30,12,4060,380,491,871,"6 de julio de 1997"
9,30,12,4061,320,413,733,"6 de julio de 1997"
9,30,12,4062,391,464,855,"6 de julio de 1997"
9,30,12,4063,326,431,757,"6 de julio de 1997"
9,30,12,4064,396,504,900,"6 de julio de 1997"
9,30,12,4065,565,636,1201,"6 de julio de 1997"
9,30,12,4066,443,583,1026,"6 de julio de 1997"
9,30,12,4067,449,549,998,"6 de julio de 1997"
9,30,12,4068,512,639,1151,"6 de julio de 1997"
9,30,12,4069,425,521,946,"6 de julio de 1997"
9,30,12,4070,462,563,1025,"6 de julio de 1997"
9,30,12,4071,673,699,1372,"6 de julio de 1997"
9,30,12,4072,347,350,697,"6 de julio de 1997"
9,30,12,4073,514,585,1099,"6 de julio de 1997"
9,30,12,4074,290,382,672,"6 de julio de 1997"
9,30,12,4075,447,518,965,"6 de julio de 1997"
9,30,12,4076,525,617,1142,"6 de julio de 1997"
9,30,12,4077,599,578,1177,"6 de julio de 1997"
9,30,12,4078,458,580,1038,"6 de julio de 1997"
9,30,12,4079,412,470,882,"6 de julio de 1997"
9,30,12,4080,453,513,966,"6 de julio de 1997"
9,30,12,4081,531,633,1164,"6 de julio de 1997"
9,30,12,4082,338,385,723,"6 de julio de 1997"
9,30,12,4083,410,587,997,"6 de julio de 1997"
9,30,12,4084,514,605,1119,"6 de julio de 1997"
9,30,12,4085,429,560,989,"6 de julio de 1997"
9,30,12,4086,630,772,1402,"6 de julio de 1997"
9,30,12,4087,553,611,1164,"6 de julio de 1997"
9,30,12,4088,219,266,485,"6 de julio de 1997"
9,30,12,4089,283,340,623,"6 de julio de 1997"
9,30,12,4090,570,680,1250,"6 de julio de 1997"
9,30,12,4091,545,606,1151,"6 de julio de 1997"
9,30,12,4092,458,609,1067,"6 de julio de 1997"
9,30,12,4093,107,138,245,"6 de julio de 1997"
9,30,12,4094,171,171,342,"6 de julio de 1997"
9,30,12,5518,177,192,369,"6 de julio de 1997"
9,30,12,5519,57,59,116,"6 de julio de 1997"
10,1,1,1,290,352,642,"6 de julio de 1997"
10,1,1,2,412,490,902,"6 de julio de 1997"
10,1,1,3,386,476,862,"6 de julio de 1997"
10,1,1,4,273,262,535,"6 de julio de 1997"
10,1,1,5,459,540,999,"6 de julio de 1997"
10,1,1,6,598,683,1281,"6 de julio de 1997"
10,1,1,7,249,280,529,"6 de julio de 1997"
10,1,1,8,418,418,836,"6 de julio de 1997"
10,1,1,9,314,324,638,"6 de julio de 1997"
10,1,1,10,90,83,173,"6 de julio de 1997"
10,1,1,11,79,72,151,"6 de julio de 1997"
10,1,1,12,86,91,177,"6 de julio de 1997"
10,1,1,13,340,321,661,"6 de julio de 1997"
10,1,1,14,214,205,419,"6 de julio de 1997"
10,1,1,15,326,339,665,"6 de julio de 1997"
10,1,1,16,134,113,247,"6 de julio de 1997"
10,1,1,17,68,54,122,"6 de julio de 1997"
10,1,1,18,33,25,58,"6 de julio de 1997"
10,1,1,19,57,46,103,"6 de julio de 1997"
10,1,1,20,131,131,262,"6 de julio de 1997"
10,1,1,21,70,65,135,"6 de julio de 1997"
10,1,1,22,457,421,878,"6 de julio de 1997"
10,1,1,23,207,183,390,"6 de julio de 1997"
10,1,1,24,165,178,343,"6 de julio de 1997"
10,1,1,25,274,229,503,"6 de julio de 1997"
10,1,1,26,490,477,967,"6 de julio de 1997"
10,1,1,27,470,443,913,"6 de julio de 1997"
10,1,1,28,229,255,484,"6 de julio de 1997"
10,1,1,29,433,427,860,"6 de julio de 1997"
10,1,1,30,445,405,850,"6 de julio de 1997"
10,1,1,31,274,259,533,"6 de julio de 1997"
10,1,1,32,196,174,370,"6 de julio de 1997"
10,1,1,33,132,111,243,"6 de julio de 1997"
10,1,1,34,96,71,167,"6 de julio de 1997"
10,1,1,35,108,85,193,"6 de julio de 1997"
10,1,1,36,44,31,75,"6 de julio de 1997"
10,1,1,37,475,514,989,"6 de julio de 1997"
10,1,1,38,257,240,497,"6 de julio de 1997"
10,1,1,39,100,81,181,"6 de julio de 1997"
10,1,1,40,220,181,401,"6 de julio de 1997"
10,1,1,41,20,11,31,"6 de julio de 1997"
10,1,2,42,221,216,437,"6 de julio de 1997"
10,1,2,43,46,18,64,"6 de julio de 1997"
10,1,2,44,78,83,161,"6 de julio de 1997"
10,1,2,45,26,26,52,"6 de julio de 1997"
10,1,2,46,40,34,74,"6 de julio de 1997"
10,1,2,47,66,63,129,"6 de julio de 1997"
10,1,2,48,85,53,138,"6 de julio de 1997"
10,1,2,49,30,12,42,"6 de julio de 1997"
10,1,2,50,43,39,82,"6 de julio de 1997"
10,1,2,51,28,14,42,"6 de julio de 1997"
10,1,2,52,48,30,78,"6 de julio de 1997"
10,1,2,53,77,74,151,"6 de julio de 1997"
10,1,2,54,36,29,65,"6 de julio de 1997"
10,1,2,55,47,37,84,"6 de julio de 1997"
10,1,2,56,116,116,232,"6 de julio de 1997"
10,1,9,638,344,355,699,"6 de julio de 1997"
10,1,9,639,199,235,434,"6 de julio de 1997"
10,1,9,640,74,46,120,"6 de julio de 1997"
10,1,9,641,138,106,244,"6 de julio de 1997"
10,1,9,642,154,124,278,"6 de julio de 1997"
10,1,9,643,118,81,199,"6 de julio de 1997"
10,1,9,644,324,246,570,"6 de julio de 1997"
10,1,9,645,63,54,117,"6 de julio de 1997"
10,1,9,646,82,51,133,"6 de julio de 1997"
10,1,9,647,50,41,91,"6 de julio de 1997"
10,1,9,648,25,32,57,"6 de julio de 1997"
10,1,9,649,53,46,99,"6 de julio de 1997"
10,1,9,650,28,37,65,"6 de julio de 1997"
10,1,9,651,65,80,145,"6 de julio de 1997"
10,1,9,652,28,35,63,"6 de julio de 1997"
10,1,9,653,139,96,235,"6 de julio de 1997"
10,1,9,654,207,111,318,"6 de julio de 1997"
10,1,9,655,86,91,177,"6 de julio de 1997"
10,1,9,656,204,140,344,"6 de julio de 1997"
10,1,9,657,44,34,78,"6 de julio de 1997"
10,1,9,658,87,65,152,"6 de julio de 1997"
10,1,9,659,132,118,250,"6 de julio de 1997"
10,1,9,660,57,57,114,"6 de julio de 1997"
10,1,9,661,249,228,477,"6 de julio de 1997"
10,1,9,662,79,67,146,"6 de julio de 1997"
10,1,9,663,77,82,159,"6 de julio de 1997"
10,1,11,672,144,165,309,"6 de julio de 1997"
10,1,11,673,93,97,190,"6 de julio de 1997"
10,1,11,674,136,145,281,"6 de julio de 1997"
10,1,11,675,107,104,211,"6 de julio de 1997"
10,1,11,676,62,59,121,"6 de julio de 1997"
10,1,11,677,66,45,111,"6 de julio de 1997"
10,1,11,678,184,205,389,"6 de julio de 1997"
10,1,11,679,80,82,162,"6 de julio de 1997"
10,1,11,680,64,64,128,"6 de julio de 1997"
10,1,11,681,146,144,290,"6 de julio de 1997"
10,1,11,682,60,63,123,"6 de julio de 1997"
10,1,11,683,104,115,219,"6 de julio de 1997"
10,1,11,684,178,189,367,"6 de julio de 1997"
10,1,11,685,114,110,224,"6 de julio de 1997"
10,1,11,686,189,212,401,"6 de julio de 1997"
10,1,11,687,200,195,395,"6 de julio de 1997"
10,1,11,688,48,47,95,"6 de julio de 1997"
10,1,17,866,323,414,737,"6 de julio de 1997"
10,1,17,867,174,217,391,"6 de julio de 1997"
10,1,17,868,397,477,874,"6 de julio de 1997"
10,1,17,869,469,575,1044,"6 de julio de 1997"
10,1,17,870,309,360,669,"6 de julio de 1997"
10,1,17,871,181,220,401,"6 de julio de 1997"
10,1,17,872,258,254,512,"6 de julio de 1997"
10,1,17,873,125,117,242,"6 de julio de 1997"
10,1,17,874,268,261,529,"6 de julio de 1997"
10,1,17,875,227,234,461,"6 de julio de 1997"
10,1,17,876,132,135,267,"6 de julio de 1997"
10,1,17,877,159,159,318,"6 de julio de 1997"
10,1,17,878,120,111,231,"6 de julio de 1997"
10,1,17,879,273,252,525,"6 de julio de 1997"
10,1,17,880,173,191,364,"6 de julio de 1997"
10,1,17,881,289,319,608,"6 de julio de 1997"
10,1,17,882,204,250,454,"6 de julio de 1997"
10,1,17,883,96,86,182,"6 de julio de 1997"
10,1,17,884,156,144,300,"6 de julio de 1997"
10,1,17,885,116,111,227,"6 de julio de 1997"
10,1,17,886,162,189,351,"6 de julio de 1997"
10,1,17,887,240,206,446,"6 de julio de 1997"
10,1,17,888,294,292,586,"6 de julio de 1997"
10,1,17,889,133,141,274,"6 de julio de 1997"
10,1,17,890,256,242,498,"6 de julio de 1997"
10,1,17,891,447,471,918,"6 de julio de 1997"
10,1,17,892,57,48,105,"6 de julio de 1997"
10,1,17,893,76,69,145,"6 de julio de 1997"
10,1,17,894,248,240,488,"6 de julio de 1997"
10,1,18,895,409,426,835,"6 de julio de 1997"
10,1,18,896,83,66,149,"6 de julio de 1997"
10,1,18,897,147,134,281,"6 de julio de 1997"
10,1,18,898,112,95,207,"6 de julio de 1997"
10,1,18,899,193,157,350,"6 de julio de 1997"
10,1,18,900,42,44,86,"6 de julio de 1997"
10,1,18,901,115,72,187,"6 de julio de 1997"
10,1,18,902,306,263,569,"6 de julio de 1997"
10,1,18,903,64,52,116,"6 de julio de 1997"
10,1,18,904,126,118,244,"6 de julio de 1997"
10,1,18,905,88,95,183,"6 de julio de 1997"
10,1,18,906,218,220,438,"6 de julio de 1997"
10,1,18,907,249,289,538,"6 de julio de 1997"
10,1,18,908,252,276,528,"6 de julio de 1997"
10,1,18,909,239,247,486,"6 de julio de 1997"
10,1,18,910,322,328,650,"6 de julio de 1997"
10,1,18,911,362,353,715,"6 de julio de 1997"
10,1,18,912,103,85,188,"6 de julio de 1997"
10,1,18,913,155,137,292,"6 de julio de 1997"
10,1,19,914,98,117,215,"6 de julio de 1997"
10,1,19,915,291,331,622,"6 de julio de 1997"
10,1,19,916,452,491,943,"6 de julio de 1997"
10,1,19,917,393,510,903,"6 de julio de 1997"
10,1,19,918,57,53,110,"6 de julio de 1997"
10,1,19,919,101,100,201,"6 de julio de 1997"
10,1,19,920,29,31,60,"6 de julio de 1997"
10,1,19,921,46,26,72,"6 de julio de 1997"
10,1,19,922,44,35,79,"6 de julio de 1997"
10,1,19,923,88,90,178,"6 de julio de 1997"
10,1,19,924,75,96,171,"6 de julio de 1997"
10,1,19,925,32,28,60,"6 de julio de 1997"
10,1,19,926,41,31,72,"6 de julio de 1997"
10,1,19,927,46,45,91,"6 de julio de 1997"
10,1,19,928,70,54,124,"6 de julio de 1997"
10,1,19,929,35,41,76,"6 de julio de 1997"
10,1,19,930,41,47,88,"6 de julio de 1997"
10,1,19,931,62,54,116,"6 de julio de 1997"
10,1,19,932,61,57,118,"6 de julio de 1997"
10,1,19,933,135,123,258,"6 de julio de 1997"
10,1,19,934,110,145,255,"6 de julio de 1997"
10,1,19,935,119,142,261,"6 de julio de 1997"
10,1,19,936,89,100,189,"6 de julio de 1997"
10,1,19,937,298,330,628,"6 de julio de 1997"
10,1,19,938,47,56,103,"6 de julio de 1997"
10,1,19,939,175,182,357,"6 de julio de 1997"
10,1,19,940,122,135,257,"6 de julio de 1997"
10,1,19,941,62,45,107,"6 de julio de 1997"
10,1,19,942,167,185,352,"6 de julio de 1997"
10,1,19,943,95,142,237,"6 de julio de 1997"
10,1,19,944,36,35,71,"6 de julio de 1997"
10,1,19,945,97,81,178,"6 de julio de 1997"
10,1,19,946,128,181,309,"6 de julio de 1997"
10,1,20,947,252,219,471,"6 de julio de 1997"
10,1,20,948,133,99,232,"6 de julio de 1997"
10,1,20,949,56,47,103,"6 de julio de 1997"
10,1,20,950,108,97,205,"6 de julio de 1997"
10,1,20,951,71,30,101,"6 de julio de 1997"
10,1,20,952,86,53,139,"6 de julio de 1997"
10,1,20,953,72,75,147,"6 de julio de 1997"
10,1,20,954,135,101,236,"6 de julio de 1997"
10,1,20,955,94,97,191,"6 de julio de 1997"
10,1,20,956,56,34,90,"6 de julio de 1997"
10,1,20,957,40,35,75,"6 de julio de 1997"
10,1,20,958,44,38,82,"6 de julio de 1997"
10,1,20,959,104,114,218,"6 de julio de 1997"
10,1,20,960,19,23,42,"6 de julio de 1997"
10,1,26,1086,269,296,565,"6 de julio de 1997"
10,1,26,1087,84,72,156,"6 de julio de 1997"
10,1,26,1088,113,97,210,"6 de julio de 1997"
10,1,26,1089,123,116,239,"6 de julio de 1997"
10,1,26,1090,85,52,137,"6 de julio de 1997"
10,1,26,1091,44,38,82,"6 de julio de 1997"
10,1,26,1092,131,121,252,"6 de julio de 1997"
10,1,26,1093,124,99,223,"6 de julio de 1997"
10,1,26,1094,145,130,275,"6 de julio de 1997"
10,1,26,1095,119,83,202,"6 de julio de 1997"
10,1,26,1096,133,143,276,"6 de julio de 1997"
10,1,26,1097,148,132,280,"6 de julio de 1997"
10,1,27,1098,329,304,633,"6 de julio de 1997"
10,1,27,1099,338,313,651,"6 de julio de 1997"
10,1,27,1100,305,242,547,"6 de julio de 1997"
10,1,27,1101,38,25,63,"6 de julio de 1997"
10,1,27,1102,114,95,209,"6 de julio de 1997"
10,1,27,1103,80,78,158,"6 de julio de 1997"
10,1,27,1104,124,115,239,"6 de julio de 1997"
10,1,27,1105,50,31,81,"6 de julio de 1997"
10,1,27,1106,57,55,112,"6 de julio de 1997"
10,1,27,1107,126,102,228,"6 de julio de 1997"
10,1,27,1108,218,214,432,"6 de julio de 1997"
10,1,27,1109,178,182,360,"6 de julio de 1997"
10,1,27,1110,176,162,338,"6 de julio de 1997"
10,1,27,1111,44,35,79,"6 de julio de 1997"
10,1,27,1112,322,285,607,"6 de julio de 1997"
10,1,27,1113,59,49,108,"6 de julio de 1997"
10,1,27,1114,149,106,255,"6 de julio de 1997"
10,1,27,1115,75,47,122,"6 de julio de 1997"
10,1,27,1116,198,178,376,"6 de julio de 1997"
10,1,27,1117,149,122,271,"6 de julio de 1997"
10,1,27,1118,80,55,135,"6 de julio de 1997"
10,1,27,1119,47,43,90,"6 de julio de 1997"
10,1,27,1120,93,57,150,"6 de julio de 1997"
10,1,27,1121,81,50,131,"6 de julio de 1997"
10,1,27,1122,188,159,347,"6 de julio de 1997"
10,1,27,1123,36,23,59,"6 de julio de 1997"
10,1,27,1124,9,6,15,"6 de julio de 1997"
10,1,27,1125,89,42,131,"6 de julio de 1997"
10,1,27,1126,134,110,244,"6 de julio de 1997"
10,1,27,1127,210,165,375,"6 de julio de 1997"
10,1,27,1128,114,73,187,"6 de julio de 1997"
10,1,27,1129,76,69,145,"6 de julio de 1997"
10,1,27,1130,129,98,227,"6 de julio de 1997"
10,1,27,1131,216,159,375,"6 de julio de 1997"
10,1,27,1132,140,112,252,"6 de julio de 1997"
10,1,27,1133,29,27,56,"6 de julio de 1997"
10,1,27,1134,98,78,176,"6 de julio de 1997"
10,1,27,1135,86,37,123,"6 de julio de 1997"
10,1,27,1136,123,89,212,"6 de julio de 1997"
10,1,27,1137,98,74,172,"6 de julio de 1997"
10,1,27,1138,90,66,156,"6 de julio de 1997"
10,1,27,1139,54,42,96,"6 de julio de 1997"
10,1,33,1200,266,294,560,"6 de julio de 1997"
10,1,33,1201,430,440,870,"6 de julio de 1997"
10,1,33,1202,347,365,712,"6 de julio de 1997"
10,1,33,1203,304,347,651,"6 de julio de 1997"
10,1,33,1204,391,451,842,"6 de julio de 1997"
10,1,33,1205,436,498,934,"6 de julio de 1997"
10,1,33,1206,212,255,467,"6 de julio de 1997"
10,1,33,1207,181,202,383,"6 de julio de 1997"
10,1,33,1208,391,413,804,"6 de julio de 1997"
10,1,33,1209,258,287,545,"6 de julio de 1997"
10,1,33,1210,246,299,545,"6 de julio de 1997"
10,1,33,1211,249,284,533,"6 de julio de 1997"
10,1,33,1212,602,633,1235,"6 de julio de 1997"
10,1,33,1213,301,307,608,"6 de julio de 1997"
10,1,33,1214,225,249,474,"6 de julio de 1997"
10,1,33,1215,79,101,180,"6 de julio de 1997"
10,1,33,1216,28,23,51,"6 de julio de 1997"
10,1,33,1217,69,75,144,"6 de julio de 1997"
10,1,33,1218,60,59,119,"6 de julio de 1997"
10,1,33,1219,320,314,634,"6 de julio de 1997"
10,1,33,1220,214,253,467,"6 de julio de 1997"
10,1,33,1221,62,57,119,"6 de julio de 1997"
10,1,33,1222,236,240,476,"6 de julio de 1997"
10,1,33,1223,30,27,57,"6 de julio de 1997"
10,1,33,1224,180,217,397,"6 de julio de 1997"
10,1,33,1225,85,129,214,"6 de julio de 1997"
10,1,33,1226,73,75,148,"6 de julio de 1997"
10,1,33,1227,98,90,188,"6 de julio de 1997"
10,1,33,1228,98,106,204,"6 de julio de 1997"
10,1,33,1229,176,208,384,"6 de julio de 1997"
10,1,33,1230,63,60,123,"6 de julio de 1997"
10,1,33,1231,133,122,255,"6 de julio de 1997"
10,1,33,1232,118,85,203,"6 de julio de 1997"
10,1,33,1233,100,87,187,"6 de julio de 1997"
10,1,33,1234,160,130,290,"6 de julio de 1997"
10,1,33,1235,189,161,350,"6 de julio de 1997"
10,1,33,1236,287,250,537,"6 de julio de 1997"
10,1,33,1237,99,123,222,"6 de julio de 1997"
10,1,33,1238,176,220,396,"6 de julio de 1997"
10,1,33,1239,525,38,563,"6 de julio de 1997"
10,1,33,1240,235,245,480,"6 de julio de 1997"
10,1,33,1241,96,93,189,"6 de julio de 1997"
10,1,33,1242,184,199,383,"6 de julio de 1997"
10,1,33,1243,168,207,375,"6 de julio de 1997"
10,1,33,1244,198,209,407,"6 de julio de 1997"
10,1,33,1245,234,249,483,"6 de julio de 1997"
10,1,33,1246,117,105,222,"6 de julio de 1997"
10,1,33,1247,72,99,171,"6 de julio de 1997"
10,1,33,1248,97,122,219,"6 de julio de 1997"
10,1,33,1249,195,246,441,"6 de julio de 1997"
10,1,33,1250,153,174,327,"6 de julio de 1997"
10,1,33,1251,67,63,130,"6 de julio de 1997"
10,1,33,1252,34,28,62,"6 de julio de 1997"
10,1,33,1253,87,64,151,"6 de julio de 1997"
10,1,33,1254,56,54,110,"6 de julio de 1997"
10,1,33,1255,82,65,147,"6 de julio de 1997"
10,1,33,1256,123,93,216,"6 de julio de 1997"
10,1,33,1257,136,117,253,"6 de julio de 1997"
10,1,33,1258,103,130,233,"6 de julio de 1997"
10,1,33,1259,132,121,253,"6 de julio de 1997"
10,1,33,1260,330,368,698,"6 de julio de 1997"
10,1,33,1261,176,174,350,"6 de julio de 1997"
10,1,33,1262,26,10,36,"6 de julio de 1997"
10,1,33,1391,164,119,283,"6 de julio de 1997"
10,1,35,1274,399,329,728,"6 de julio de 1997"
10,1,35,1275,366,293,659,"6 de julio de 1997"
10,1,35,1276,153,92,245,"6 de julio de 1997"
10,1,35,1277,260,225,485,"6 de julio de 1997"
10,1,35,1278,61,54,115,"6 de julio de 1997"
10,1,35,1279,163,131,294,"6 de julio de 1997"
10,1,35,1280,128,130,258,"6 de julio de 1997"
10,1,35,1281,264,229,493,"6 de julio de 1997"
10,1,35,1282,150,107,257,"6 de julio de 1997"
10,1,35,1283,89,66,155,"6 de julio de 1997"
10,1,35,1284,104,72,176,"6 de julio de 1997"
10,1,35,1285,200,150,350,"6 de julio de 1997"
10,1,35,1286,191,142,333,"6 de julio de 1997"
10,1,35,1287,141,93,234,"6 de julio de 1997"
10,1,35,1288,138,74,212,"6 de julio de 1997"
10,1,35,1289,201,129,330,"6 de julio de 1997"
10,1,35,1290,349,239,588,"6 de julio de 1997"
10,1,35,1291,64,38,102,"6 de julio de 1997"
10,1,35,1292,194,159,353,"6 de julio de 1997"
10,1,35,1293,193,114,307,"6 de julio de 1997"
10,1,35,1294,244,195,439,"6 de julio de 1997"
10,1,35,1295,130,102,232,"6 de julio de 1997"
10,1,35,1296,59,24,83,"6 de julio de 1997"
10,1,35,1297,90,79,169,"6 de julio de 1997"
10,1,35,1298,217,164,381,"6 de julio de 1997"
10,1,35,1299,315,179,494,"6 de julio de 1997"
10,1,35,1300,362,249,611,"6 de julio de 1997"
10,1,35,1301,72,30,102,"6 de julio de 1997"
10,1,35,1302,58,42,100,"6 de julio de 1997"
10,1,35,1303,20,11,31,"6 de julio de 1997"
10,1,35,1304,93,49,142,"6 de julio de 1997"
10,1,35,1305,35,21,56,"6 de julio de 1997"
10,1,36,1306,282,304,586,"6 de julio de 1997"
10,1,36,1307,194,213,407,"6 de julio de 1997"
10,1,36,1308,148,196,344,"6 de julio de 1997"
10,1,36,1309,352,380,732,"6 de julio de 1997"
10,1,36,1310,289,314,603,"6 de julio de 1997"
10,1,36,1311,196,185,381,"6 de julio de 1997"
10,1,36,1312,221,258,479,"6 de julio de 1997"
10,1,36,1313,84,89,173,"6 de julio de 1997"
10,1,36,1314,90,78,168,"6 de julio de 1997"
10,1,36,1315,153,111,264,"6 de julio de 1997"
10,1,36,1316,117,89,206,"6 de julio de 1997"
10,1,36,1317,92,96,188,"6 de julio de 1997"
10,1,36,1318,121,130,251,"6 de julio de 1997"
10,1,36,1319,131,133,264,"6 de julio de 1997"
10,1,36,1320,57,74,131,"6 de julio de 1997"
10,1,36,1321,147,174,321,"6 de julio de 1997"
10,1,36,1322,70,110,180,"6 de julio de 1997"
10,1,36,1323,66,103,169,"6 de julio de 1997"
10,1,36,1324,160,181,341,"6 de julio de 1997"
10,1,36,1325,105,149,254,"6 de julio de 1997"
10,1,36,1326,187,255,442,"6 de julio de 1997"
10,1,36,1327,40,50,90,"6 de julio de 1997"
10,1,36,1328,60,83,143,"6 de julio de 1997"
10,1,36,1329,120,141,261,"6 de julio de 1997"
10,1,36,1330,209,261,470,"6 de julio de 1997"
10,1,36,1331,67,78,145,"6 de julio de 1997"
10,1,36,1332,54,49,103,"6 de julio de 1997"
10,1,38,1360,249,225,474,"6 de julio de 1997"
10,1,38,1361,153,153,306,"6 de julio de 1997"
10,1,38,1362,179,198,377,"6 de julio de 1997"
10,1,38,1363,62,49,111,"6 de julio de 1997"
10,1,38,1364,58,53,111,"6 de julio de 1997"
10,1,38,1365,173,120,293,"6 de julio de 1997"
10,1,38,1366,44,21,65,"6 de julio de 1997"
10,1,38,1367,69,66,135,"6 de julio de 1997"
10,1,38,1368,93,58,151,"6 de julio de 1997"
10,1,38,1369,303,276,579,"6 de julio de 1997"
10,1,38,1370,91,76,167,"6 de julio de 1997"
10,1,38,1371,107,118,225,"6 de julio de 1997"
10,1,38,1372,148,147,295,"6 de julio de 1997"
10,1,38,1373,260,219,479,"6 de julio de 1997"
10,2,7,436,261,330,591,"6 de julio de 1997"
10,2,7,437,281,307,588,"6 de julio de 1997"
10,2,7,438,595,575,1170,"6 de julio de 1997"
10,2,7,439,1046,1221,2267,"6 de julio de 1997"
10,2,7,440,441,491,932,"6 de julio de 1997"
10,2,7,441,294,335,629,"6 de julio de 1997"
10,2,7,442,328,353,681,"6 de julio de 1997"
10,2,7,443,718,806,1524,"6 de julio de 1997"
10,2,7,444,204,214,418,"6 de julio de 1997"
10,2,7,445,323,367,690,"6 de julio de 1997"
10,2,7,446,535,614,1149,"6 de julio de 1997"
10,2,7,447,720,759,1479,"6 de julio de 1997"
10,2,7,448,395,405,800,"6 de julio de 1997"
10,2,7,449,360,381,741,"6 de julio de 1997"
10,2,7,450,363,424,787,"6 de julio de 1997"
10,2,7,451,480,536,1016,"6 de julio de 1997"
10,2,7,452,837,882,1719,"6 de julio de 1997"
10,2,7,453,677,703,1380,"6 de julio de 1997"
10,2,7,454,344,384,728,"6 de julio de 1997"
10,2,7,455,303,346,649,"6 de julio de 1997"
10,2,7,456,188,176,364,"6 de julio de 1997"
10,2,7,457,151,152,303,"6 de julio de 1997"
10,2,7,458,312,313,625,"6 de julio de 1997"
10,2,7,459,494,527,1021,"6 de julio de 1997"
10,2,7,460,487,484,971,"6 de julio de 1997"
10,2,7,461,472,551,1023,"6 de julio de 1997"
10,2,7,462,417,455,872,"6 de julio de 1997"
10,2,7,463,348,406,754,"6 de julio de 1997"
10,2,7,464,486,531,1017,"6 de julio de 1997"
10,2,7,465,233,260,493,"6 de julio de 1997"
10,2,7,466,249,266,515,"6 de julio de 1997"
10,2,7,467,524,581,1105,"6 de julio de 1997"
10,2,7,468,307,367,674,"6 de julio de 1997"
10,2,7,469,313,369,682,"6 de julio de 1997"
10,2,7,470,188,226,414,"6 de julio de 1997"
10,2,7,471,461,502,963,"6 de julio de 1997"
10,2,7,472,596,676,1272,"6 de julio de 1997"
10,2,7,473,728,756,1484,"6 de julio de 1997"
10,2,7,474,588,625,1213,"6 de julio de 1997"
10,2,7,475,492,564,1056,"6 de julio de 1997"
10,2,7,476,438,482,920,"6 de julio de 1997"
10,2,7,477,271,317,588,"6 de julio de 1997"
10,2,7,478,339,329,668,"6 de julio de 1997"
10,2,7,479,349,397,746,"6 de julio de 1997"
10,2,7,480,388,422,810,"6 de julio de 1997"
10,2,7,481,404,454,858,"6 de julio de 1997"
10,2,7,482,407,456,863,"6 de julio de 1997"
10,2,7,483,359,400,759,"6 de julio de 1997"
10,2,7,484,397,430,827,"6 de julio de 1997"
10,2,7,485,579,604,1183,"6 de julio de 1997"
10,2,7,486,633,625,1258,"6 de julio de 1997"
10,2,7,487,430,487,917,"6 de julio de 1997"
10,2,7,488,534,594,1128,"6 de julio de 1997"
10,2,7,489,304,335,639,"6 de julio de 1997"
10,2,7,490,349,390,739,"6 de julio de 1997"
10,2,7,491,662,700,1362,"6 de julio de 1997"
10,2,7,492,507,549,1056,"6 de julio de 1997"
10,2,7,493,480,569,1049,"6 de julio de 1997"
10,2,7,494,404,486,890,"6 de julio de 1997"
10,2,7,495,434,494,928,"6 de julio de 1997"
10,2,7,496,310,369,679,"6 de julio de 1997"
10,2,7,497,246,303,549,"6 de julio de 1997"
10,2,7,498,443,497,940,"6 de julio de 1997"
10,2,7,499,508,564,1072,"6 de julio de 1997"
10,2,7,500,552,607,1159,"6 de julio de 1997"
10,2,7,501,517,587,1104,"6 de julio de 1997"
10,2,7,502,597,750,1347,"6 de julio de 1997"
10,2,7,503,421,451,872,"6 de julio de 1997"
10,2,7,504,383,415,798,"6 de julio de 1997"
10,2,7,505,482,534,1016,"6 de julio de 1997"
10,2,7,506,389,484,873,"6 de julio de 1997"
10,2,7,507,373,487,860,"6 de julio de 1997"
10,2,7,508,321,346,667,"6 de julio de 1997"
10,2,7,509,306,350,656,"6 de julio de 1997"
10,2,7,510,783,864,1647,"6 de julio de 1997"
10,2,7,511,334,353,687,"6 de julio de 1997"
10,2,7,512,343,407,750,"6 de julio de 1997"
10,2,7,513,420,434,854,"6 de julio de 1997"
10,2,7,514,334,386,720,"6 de julio de 1997"
10,2,7,515,563,577,1140,"6 de julio de 1997"
10,2,7,516,267,313,580,"6 de julio de 1997"
10,2,7,517,305,386,691,"6 de julio de 1997"
10,2,7,518,231,296,527,"6 de julio de 1997"
10,2,7,519,454,559,1013,"6 de julio de 1997"
10,2,7,520,537,633,1170,"6 de julio de 1997"
10,2,7,521,516,542,1058,"6 de julio de 1997"
10,2,7,522,388,542,930,"6 de julio de 1997"
10,2,7,523,333,430,763,"6 de julio de 1997"
10,2,7,524,272,300,572,"6 de julio de 1997"
10,2,7,525,587,584,1171,"6 de julio de 1997"
10,2,7,526,383,422,805,"6 de julio de 1997"
10,2,7,527,307,357,664,"6 de julio de 1997"
10,2,7,528,389,430,819,"6 de julio de 1997"
10,2,7,529,387,454,841,"6 de julio de 1997"
10,2,7,530,569,616,1185,"6 de julio de 1997"
10,2,7,531,473,536,1009,"6 de julio de 1997"
10,2,7,532,301,358,659,"6 de julio de 1997"
10,2,7,533,355,396,751,"6 de julio de 1997"
10,2,7,534,285,346,631,"6 de julio de 1997"
10,2,7,535,631,678,1309,"6 de julio de 1997"
10,2,7,536,493,589,1082,"6 de julio de 1997"
10,2,7,537,341,405,746,"6 de julio de 1997"
10,2,7,538,300,412,712,"6 de julio de 1997"
10,2,7,539,369,398,767,"6 de julio de 1997"
10,2,7,540,293,309,602,"6 de julio de 1997"
10,2,7,541,846,915,1761,"6 de julio de 1997"
10,2,7,542,264,300,564,"6 de julio de 1997"
10,2,7,543,290,334,624,"6 de julio de 1997"
10,2,7,544,353,425,778,"6 de julio de 1997"
10,2,7,545,260,270,530,"6 de julio de 1997"
10,2,7,546,290,373,663,"6 de julio de 1997"
10,2,7,547,306,329,635,"6 de julio de 1997"
10,2,7,548,427,448,875,"6 de julio de 1997"
10,2,7,549,256,279,535,"6 de julio de 1997"
10,2,7,550,445,475,920,"6 de julio de 1997"
10,2,7,551,381,425,806,"6 de julio de 1997"
10,2,7,552,500,550,1050,"6 de julio de 1997"
10,2,7,553,413,447,860,"6 de julio de 1997"
10,2,7,554,278,308,586,"6 de julio de 1997"
10,2,7,555,258,249,507,"6 de julio de 1997"
10,2,7,556,149,152,301,"6 de julio de 1997"
10,2,7,557,66,55,121,"6 de julio de 1997"
10,2,7,558,421,367,788,"6 de julio de 1997"
10,2,7,559,370,372,742,"6 de julio de 1997"
10,2,7,560,453,438,891,"6 de julio de 1997"
10,2,7,561,642,592,1234,"6 de julio de 1997"
10,2,7,562,510,472,982,"6 de julio de 1997"
10,2,7,563,239,201,440,"6 de julio de 1997"
10,2,7,564,342,344,686,"6 de julio de 1997"
10,2,7,565,390,387,777,"6 de julio de 1997"
10,2,7,566,479,416,895,"6 de julio de 1997"
10,2,7,567,475,494,969,"6 de julio de 1997"
10,2,7,568,139,152,291,"6 de julio de 1997"
10,2,7,569,404,445,849,"6 de julio de 1997"
10,2,7,570,328,327,655,"6 de julio de 1997"
10,2,7,571,553,487,1040,"6 de julio de 1997"
10,2,7,572,352,334,686,"6 de julio de 1997"
10,2,7,573,288,279,567,"6 de julio de 1997"
10,2,7,574,733,650,1383,"6 de julio de 1997"
10,2,7,575,266,256,522,"6 de julio de 1997"
10,2,7,576,178,161,339,"6 de julio de 1997"
10,2,7,577,268,242,510,"6 de julio de 1997"
10,2,7,578,261,254,515,"6 de julio de 1997"
10,2,7,579,418,428,846,"6 de julio de 1997"
10,2,7,580,301,306,607,"6 de julio de 1997"
10,2,7,581,514,477,991,"6 de julio de 1997"
10,2,7,582,427,418,845,"6 de julio de 1997"
10,2,7,583,525,526,1051,"6 de julio de 1997"
10,2,7,584,267,267,534,"6 de julio de 1997"
10,2,7,585,681,604,1285,"6 de julio de 1997"
10,2,7,586,274,239,513,"6 de julio de 1997"
10,2,7,587,157,141,298,"6 de julio de 1997"
10,2,7,588,602,620,1222,"6 de julio de 1997"
10,2,7,589,420,437,857,"6 de julio de 1997"
10,2,7,590,454,441,895,"6 de julio de 1997"
10,2,7,591,325,311,636,"6 de julio de 1997"
10,2,7,592,355,327,682,"6 de julio de 1997"
10,2,7,593,190,185,375,"6 de julio de 1997"
10,2,7,594,260,287,547,"6 de julio de 1997"
10,2,7,595,305,311,616,"6 de julio de 1997"
10,2,7,596,239,222,461,"6 de julio de 1997"
10,2,7,597,756,712,1468,"6 de julio de 1997"
10,2,7,598,242,245,487,"6 de julio de 1997"
10,2,7,599,36,31,67,"6 de julio de 1997"
10,2,7,600,603,596,1199,"6 de julio de 1997"
10,2,7,601,627,629,1256,"6 de julio de 1997"
10,2,7,602,171,143,314,"6 de julio de 1997"
10,2,7,603,584,595,1179,"6 de julio de 1997"
10,2,7,604,330,303,633,"6 de julio de 1997"
10,2,7,605,355,339,694,"6 de julio de 1997"
10,2,7,606,62,52,114,"6 de julio de 1997"
10,2,7,607,429,458,887,"6 de julio de 1997"
10,2,7,608,427,373,800,"6 de julio de 1997"
10,2,7,609,274,274,548,"6 de julio de 1997"
10,2,7,610,149,168,317,"6 de julio de 1997"
10,2,7,611,444,531,975,"6 de julio de 1997"
10,2,10,664,243,234,477,"6 de julio de 1997"
10,2,10,665,65,48,113,"6 de julio de 1997"
10,2,10,666,125,95,220,"6 de julio de 1997"
10,2,10,667,174,148,322,"6 de julio de 1997"
10,2,10,668,450,457,907,"6 de julio de 1997"
10,2,10,669,94,90,184,"6 de julio de 1997"
10,2,10,670,172,177,349,"6 de julio de 1997"
10,2,10,671,218,207,425,"6 de julio de 1997"
10,2,13,769,732,703,1435,"6 de julio de 1997"
10,2,13,770,268,345,613,"6 de julio de 1997"
10,2,13,771,262,279,541,"6 de julio de 1997"
10,2,13,772,172,129,301,"6 de julio de 1997"
10,2,13,773,77,80,157,"6 de julio de 1997"
10,2,13,774,66,81,147,"6 de julio de 1997"
10,2,13,775,46,33,79,"6 de julio de 1997"
10,2,13,776,39,36,75,"6 de julio de 1997"
10,2,13,777,580,600,1180,"6 de julio de 1997"
10,2,13,778,441,462,903,"6 de julio de 1997"
10,2,13,779,40,26,66,"6 de julio de 1997"
10,2,13,780,342,259,601,"6 de julio de 1997"
10,2,13,781,157,114,271,"6 de julio de 1997"
10,2,13,782,145,97,242,"6 de julio de 1997"
10,2,13,783,148,115,263,"6 de julio de 1997"
10,2,13,784,43,33,76,"6 de julio de 1997"
10,2,13,785,275,233,508,"6 de julio de 1997"
10,2,13,786,329,312,641,"6 de julio de 1997"
10,2,13,787,215,232,447,"6 de julio de 1997"
10,2,13,788,652,723,1375,"6 de julio de 1997"
10,2,13,789,413,426,839,"6 de julio de 1997"
10,2,13,790,280,270,550,"6 de julio de 1997"
10,2,13,791,301,264,565,"6 de julio de 1997"
10,2,13,792,438,411,849,"6 de julio de 1997"
10,2,13,793,213,212,425,"6 de julio de 1997"
10,2,13,794,122,107,229,"6 de julio de 1997"
10,2,13,795,108,88,196,"6 de julio de 1997"
10,2,37,1333,439,492,931,"6 de julio de 1997"
10,2,37,1334,363,374,737,"6 de julio de 1997"
10,2,37,1335,410,451,861,"6 de julio de 1997"
10,2,37,1336,265,288,553,"6 de julio de 1997"
10,2,37,1337,309,333,642,"6 de julio de 1997"
10,2,37,1338,309,349,658,"6 de julio de 1997"
10,2,37,1339,369,401,770,"6 de julio de 1997"
10,2,37,1340,225,289,514,"6 de julio de 1997"
10,2,37,1341,243,273,516,"6 de julio de 1997"
10,2,37,1342,117,116,233,"6 de julio de 1997"
10,2,37,1343,58,47,105,"6 de julio de 1997"
10,2,37,1344,213,211,424,"6 de julio de 1997"
10,2,37,1345,79,55,134,"6 de julio de 1997"
10,2,37,1346,175,216,391,"6 de julio de 1997"
10,2,37,1347,392,415,807,"6 de julio de 1997"
10,2,37,1348,54,63,117,"6 de julio de 1997"
10,2,37,1349,185,168,353,"6 de julio de 1997"
10,2,37,1350,66,59,125,"6 de julio de 1997"
10,2,37,1351,24,28,52,"6 de julio de 1997"
10,2,37,1352,258,243,501,"6 de julio de 1997"
10,2,37,1353,534,510,1044,"6 de julio de 1997"
10,2,37,1354,393,414,807,"6 de julio de 1997"
10,2,37,1355,105,111,216,"6 de julio de 1997"
10,2,37,1356,137,113,250,"6 de julio de 1997"
10,2,37,1357,310,348,658,"6 de julio de 1997"
10,2,37,1358,342,369,711,"6 de julio de 1997"
10,2,37,1359,382,360,742,"6 de julio de 1997"
10,3,3,57,221,258,479,"6 de julio de 1997"
10,3,3,58,137,141,278,"6 de julio de 1997"
10,3,3,59,60,56,116,"6 de julio de 1997"
10,3,3,60,165,155,320,"6 de julio de 1997"
10,3,3,61,50,57,107,"6 de julio de 1997"
10,3,3,62,87,103,190,"6 de julio de 1997"
10,3,3,63,286,308,594,"6 de julio de 1997"
10,3,3,64,97,93,190,"6 de julio de 1997"
10,3,3,65,158,141,299,"6 de julio de 1997"
10,3,4,66,528,572,1100,"6 de julio de 1997"
10,3,4,67,331,357,688,"6 de julio de 1997"
10,3,4,68,342,382,724,"6 de julio de 1997"
10,3,4,69,614,694,1308,"6 de julio de 1997"
10,3,4,70,303,330,633,"6 de julio de 1997"
10,3,4,71,40,31,71,"6 de julio de 1997"
10,3,4,72,195,213,408,"6 de julio de 1997"
10,3,4,73,440,432,872,"6 de julio de 1997"
10,3,4,74,110,123,233,"6 de julio de 1997"
10,3,4,75,358,353,711,"6 de julio de 1997"
10,3,4,76,456,407,863,"6 de julio de 1997"
10,3,4,77,64,56,120,"6 de julio de 1997"
10,3,4,78,217,207,424,"6 de julio de 1997"
10,3,4,79,114,99,213,"6 de julio de 1997"
10,3,4,80,462,440,902,"6 de julio de 1997"
10,3,4,81,100,75,175,"6 de julio de 1997"
10,3,4,82,80,81,161,"6 de julio de 1997"
10,3,4,83,118,133,251,"6 de julio de 1997"
10,3,4,84,120,109,229,"6 de julio de 1997"
10,3,4,85,105,80,185,"6 de julio de 1997"
10,3,4,86,109,117,226,"6 de julio de 1997"
10,3,4,87,222,219,441,"6 de julio de 1997"
10,3,4,88,45,36,81,"6 de julio de 1997"
10,3,4,89,129,132,261,"6 de julio de 1997"
10,3,4,90,118,118,236,"6 de julio de 1997"
10,3,4,91,124,131,255,"6 de julio de 1997"
10,3,4,92,59,47,106,"6 de julio de 1997"
10,3,4,93,68,47,115,"6 de julio de 1997"
10,3,4,94,298,303,601,"6 de julio de 1997"
10,3,4,95,386,378,764,"6 de julio de 1997"
10,3,4,96,204,176,380,"6 de julio de 1997"
10,3,4,97,233,263,496,"6 de julio de 1997"
10,3,4,98,44,23,67,"6 de julio de 1997"
10,3,4,99,454,456,910,"6 de julio de 1997"
10,3,4,100,428,442,870,"6 de julio de 1997"
10,3,4,101,214,201,415,"6 de julio de 1997"
10,3,4,102,227,193,420,"6 de julio de 1997"
10,3,4,103,252,241,493,"6 de julio de 1997"
10,3,4,104,94,91,185,"6 de julio de 1997"
10,3,4,105,274,285,559,"6 de julio de 1997"
10,3,4,106,232,214,446,"6 de julio de 1997"
10,3,4,107,75,66,141,"6 de julio de 1997"
10,3,6,420,344,389,733,"6 de julio de 1997"
10,3,6,421,30,31,61,"6 de julio de 1997"
10,3,6,422,328,295,623,"6 de julio de 1997"
10,3,6,423,97,83,180,"6 de julio de 1997"
10,3,6,424,303,280,583,"6 de julio de 1997"
10,3,6,425,140,122,262,"6 de julio de 1997"
10,3,6,426,267,273,540,"6 de julio de 1997"
10,3,6,427,128,128,256,"6 de julio de 1997"
10,3,6,428,100,90,190,"6 de julio de 1997"
10,3,6,429,223,225,448,"6 de julio de 1997"
10,3,6,430,217,197,414,"6 de julio de 1997"
10,3,6,431,316,345,661,"6 de julio de 1997"
10,3,6,432,53,44,97,"6 de julio de 1997"
10,3,6,433,87,75,162,"6 de julio de 1997"
10,3,6,434,57,68,125,"6 de julio de 1997"
10,3,6,435,424,531,955,"6 de julio de 1997"
10,3,8,612,550,597,1147,"6 de julio de 1997"
10,3,8,613,368,419,787,"6 de julio de 1997"
10,3,8,614,586,645,1231,"6 de julio de 1997"
10,3,8,615,494,554,1048,"6 de julio de 1997"
10,3,8,616,383,443,826,"6 de julio de 1997"
10,3,8,617,325,372,697,"6 de julio de 1997"
10,3,8,618,267,283,550,"6 de julio de 1997"
10,3,8,619,397,456,853,"6 de julio de 1997"
10,3,8,620,289,325,614,"6 de julio de 1997"
10,3,8,621,343,360,703,"6 de julio de 1997"
10,3,8,622,296,245,541,"6 de julio de 1997"
10,3,8,623,46,44,90,"6 de julio de 1997"
10,3,8,624,316,365,681,"6 de julio de 1997"
10,3,8,625,448,444,892,"6 de julio de 1997"
10,3,8,626,151,155,306,"6 de julio de 1997"
10,3,8,627,190,172,362,"6 de julio de 1997"
10,3,8,628,489,466,955,"6 de julio de 1997"
10,3,8,629,470,477,947,"6 de julio de 1997"
10,3,8,630,573,565,1138,"6 de julio de 1997"
10,3,8,631,200,205,405,"6 de julio de 1997"
10,3,8,632,359,330,689,"6 de julio de 1997"
10,3,8,633,329,338,667,"6 de julio de 1997"
10,3,8,634,393,436,829,"6 de julio de 1997"
10,3,8,635,479,462,941,"6 de julio de 1997"
10,3,8,636,627,624,1251,"6 de julio de 1997"
10,3,8,637,170,158,328,"6 de julio de 1997"
10,3,12,689,567,596,1163,"6 de julio de 1997"
10,3,12,690,601,627,1228,"6 de julio de 1997"
10,3,12,691,150,156,306,"6 de julio de 1997"
10,3,12,692,342,339,681,"6 de julio de 1997"
10,3,12,693,370,406,776,"6 de julio de 1997"
10,3,12,694,324,330,654,"6 de julio de 1997"
10,3,12,695,515,573,1088,"6 de julio de 1997"
10,3,12,696,671,674,1345,"6 de julio de 1997"
10,3,12,697,678,691,1369,"6 de julio de 1997"
10,3,12,698,240,275,515,"6 de julio de 1997"
10,3,12,699,285,292,577,"6 de julio de 1997"
10,3,12,700,232,245,477,"6 de julio de 1997"
10,3,12,701,571,572,1143,"6 de julio de 1997"
10,3,12,702,279,312,591,"6 de julio de 1997"
10,3,12,703,412,461,873,"6 de julio de 1997"
10,3,12,704,525,574,1099,"6 de julio de 1997"
10,3,12,705,738,821,1559,"6 de julio de 1997"
10,3,12,706,308,333,641,"6 de julio de 1997"
10,3,12,707,223,229,452,"6 de julio de 1997"
10,3,12,708,341,369,710,"6 de julio de 1997"
10,3,12,709,299,323,622,"6 de julio de 1997"
10,3,12,710,450,470,920,"6 de julio de 1997"
10,3,12,711,495,512,1007,"6 de julio de 1997"
10,3,12,712,428,492,920,"6 de julio de 1997"
10,3,12,713,434,521,955,"6 de julio de 1997"
10,3,12,714,374,443,817,"6 de julio de 1997"
10,3,12,715,386,439,825,"6 de julio de 1997"
10,3,12,716,303,329,632,"6 de julio de 1997"
10,3,12,717,242,242,484,"6 de julio de 1997"
10,3,12,718,393,408,801,"6 de julio de 1997"
10,3,12,719,479,561,1040,"6 de julio de 1997"
10,3,12,720,502,639,1141,"6 de julio de 1997"
10,3,12,721,474,495,969,"6 de julio de 1997"
10,3,12,722,772,819,1591,"6 de julio de 1997"
10,3,12,723,656,702,1358,"6 de julio de 1997"
10,3,12,724,548,575,1123,"6 de julio de 1997"
10,3,12,725,260,257,517,"6 de julio de 1997"
10,3,12,726,327,348,675,"6 de julio de 1997"
10,3,12,727,381,410,791,"6 de julio de 1997"
10,3,12,728,209,177,386,"6 de julio de 1997"
10,3,12,729,97,88,185,"6 de julio de 1997"
10,3,12,730,546,513,1059,"6 de julio de 1997"
10,3,12,731,272,274,546,"6 de julio de 1997"
10,3,12,732,292,319,611,"6 de julio de 1997"
10,3,12,733,576,623,1199,"6 de julio de 1997"
10,3,12,734,350,359,709,"6 de julio de 1997"
10,3,12,735,601,615,1216,"6 de julio de 1997"
10,3,12,736,169,162,331,"6 de julio de 1997"
10,3,12,737,429,416,845,"6 de julio de 1997"
10,3,12,738,663,713,1376,"6 de julio de 1997"
10,3,12,739,596,589,1185,"6 de julio de 1997"
10,3,12,740,169,174,343,"6 de julio de 1997"
10,3,12,741,369,392,761,"6 de julio de 1997"
10,3,12,742,377,385,762,"6 de julio de 1997"
10,3,12,743,182,158,340,"6 de julio de 1997"
10,3,12,744,242,228,470,"6 de julio de 1997"
10,3,12,745,333,295,628,"6 de julio de 1997"
10,3,12,746,566,620,1186,"6 de julio de 1997"
10,3,12,747,527,536,1063,"6 de julio de 1997"
10,3,12,748,390,375,765,"6 de julio de 1997"
10,3,12,749,391,428,819,"6 de julio de 1997"
10,3,12,750,211,228,439,"6 de julio de 1997"
10,3,12,751,317,386,703,"6 de julio de 1997"
10,3,12,752,271,287,558,"6 de julio de 1997"
10,3,12,753,358,361,719,"6 de julio de 1997"
10,3,12,754,583,567,1150,"6 de julio de 1997"
10,3,12,755,447,432,879,"6 de julio de 1997"
10,3,12,756,387,365,752,"6 de julio de 1997"
10,3,12,757,408,400,808,"6 de julio de 1997"
10,3,12,758,134,127,261,"6 de julio de 1997"
10,3,12,759,95,101,196,"6 de julio de 1997"
10,3,12,760,402,408,810,"6 de julio de 1997"
10,3,12,761,586,616,1202,"6 de julio de 1997"
10,3,12,762,258,301,559,"6 de julio de 1997"
10,3,12,763,456,450,906,"6 de julio de 1997"
10,3,12,764,368,361,729,"6 de julio de 1997"
10,3,12,765,128,92,220,"6 de julio de 1997"
10,3,12,766,28,26,54,"6 de julio de 1997"
10,3,12,767,262,279,541,"6 de julio de 1997"
10,3,12,768,57,55,112,"6 de julio de 1997"
10,3,15,828,300,317,617,"6 de julio de 1997"
10,3,15,829,275,297,572,"6 de julio de 1997"
10,3,15,830,226,244,470,"6 de julio de 1997"
10,3,15,831,295,273,568,"6 de julio de 1997"
10,3,15,832,116,113,229,"6 de julio de 1997"
10,3,15,833,306,282,588,"6 de julio de 1997"
10,3,15,834,304,317,621,"6 de julio de 1997"
10,3,15,835,226,253,479,"6 de julio de 1997"
10,3,15,836,214,214,428,"6 de julio de 1997"
10,3,15,837,223,181,404,"6 de julio de 1997"
10,3,15,838,185,177,362,"6 de julio de 1997"
10,3,15,839,454,480,934,"6 de julio de 1997"
10,3,15,840,267,244,511,"6 de julio de 1997"
10,3,15,841,98,96,194,"6 de julio de 1997"
10,3,15,842,151,152,303,"6 de julio de 1997"
10,3,15,843,59,42,101,"6 de julio de 1997"
10,3,15,844,161,138,299,"6 de julio de 1997"
10,3,21,961,309,397,706,"6 de julio de 1997"
10,3,21,962,331,352,683,"6 de julio de 1997"
10,3,21,963,370,437,807,"6 de julio de 1997"
10,3,21,964,309,313,622,"6 de julio de 1997"
10,3,21,965,252,266,518,"6 de julio de 1997"
10,3,21,966,90,102,192,"6 de julio de 1997"
10,3,21,967,462,418,880,"6 de julio de 1997"
10,3,21,968,245,218,463,"6 de julio de 1997"
10,3,21,969,205,233,438,"6 de julio de 1997"
10,3,21,970,106,102,208,"6 de julio de 1997"
10,3,21,971,285,291,576,"6 de julio de 1997"
10,3,21,972,357,338,695,"6 de julio de 1997"
10,3,21,973,184,238,422,"6 de julio de 1997"
10,3,21,974,148,135,283,"6 de julio de 1997"
10,3,21,975,128,143,271,"6 de julio de 1997"
10,3,21,976,76,88,164,"6 de julio de 1997"
10,3,22,977,363,305,668,"6 de julio de 1997"
10,3,22,978,300,266,566,"6 de julio de 1997"
10,3,22,979,364,348,712,"6 de julio de 1997"
10,3,22,980,553,557,1110,"6 de julio de 1997"
10,3,22,981,52,38,90,"6 de julio de 1997"
10,3,22,982,84,50,134,"6 de julio de 1997"
10,3,22,983,169,147,316,"6 de julio de 1997"
10,3,22,984,28,21,49,"6 de julio de 1997"
10,3,22,985,157,105,262,"6 de julio de 1997"
10,3,22,986,220,197,417,"6 de julio de 1997"
10,3,22,987,62,59,121,"6 de julio de 1997"
10,3,22,988,62,53,115,"6 de julio de 1997"
10,3,22,989,273,284,557,"6 de julio de 1997"
10,3,22,990,301,319,620,"6 de julio de 1997"
10,3,22,991,255,280,535,"6 de julio de 1997"
10,3,25,1063,358,450,808,"6 de julio de 1997"
10,3,25,1064,332,391,723,"6 de julio de 1997"
10,3,25,1065,288,324,612,"6 de julio de 1997"
10,3,25,1066,124,99,223,"6 de julio de 1997"
10,3,25,1067,64,67,131,"6 de julio de 1997"
10,3,25,1068,369,395,764,"6 de julio de 1997"
10,3,25,1069,119,129,248,"6 de julio de 1997"
10,3,25,1070,161,138,299,"6 de julio de 1997"
10,3,25,1071,201,195,396,"6 de julio de 1997"
10,3,25,1072,44,45,89,"6 de julio de 1997"
10,3,25,1073,48,56,104,"6 de julio de 1997"
10,3,25,1074,45,44,89,"6 de julio de 1997"
10,3,25,1075,123,121,244,"6 de julio de 1997"
10,3,25,1076,47,42,89,"6 de julio de 1997"
10,3,25,1077,80,81,161,"6 de julio de 1997"
10,3,25,1078,99,84,183,"6 de julio de 1997"
10,3,25,1079,119,106,225,"6 de julio de 1997"
10,3,25,1080,256,240,496,"6 de julio de 1997"
10,3,25,1081,156,138,294,"6 de julio de 1997"
10,3,25,1082,158,143,301,"6 de julio de 1997"
10,3,25,1083,261,262,523,"6 de julio de 1997"
10,3,25,1084,85,84,169,"6 de julio de 1997"
10,3,25,1085,30,28,58,"6 de julio de 1997"
10,3,28,1140,214,239,453,"6 de julio de 1997"
10,3,28,1141,274,299,573,"6 de julio de 1997"
10,3,28,1142,36,27,63,"6 de julio de 1997"
10,3,28,1143,96,85,181,"6 de julio de 1997"
10,3,28,1144,89,70,159,"6 de julio de 1997"
10,3,28,1145,65,68,133,"6 de julio de 1997"
10,3,28,1146,42,36,78,"6 de julio de 1997"
10,3,28,1147,173,213,386,"6 de julio de 1997"
10,3,28,1148,104,117,221,"6 de julio de 1997"
10,3,28,1149,66,55,121,"6 de julio de 1997"
10,3,28,1150,120,123,243,"6 de julio de 1997"
10,3,28,1151,250,190,440,"6 de julio de 1997"
10,3,28,1152,110,121,231,"6 de julio de 1997"
10,3,28,1153,21,33,54,"6 de julio de 1997"
10,3,28,1154,61,73,134,"6 de julio de 1997"
10,3,28,1155,49,46,95,"6 de julio de 1997"
10,3,29,1156,323,345,668,"6 de julio de 1997"
10,3,29,1157,331,321,652,"6 de julio de 1997"
10,3,29,1158,229,286,515,"6 de julio de 1997"
10,3,29,1159,74,64,138,"6 de julio de 1997"
10,3,29,1160,238,233,471,"6 de julio de 1997"
10,3,29,1161,178,185,363,"6 de julio de 1997"
10,3,29,1162,108,112,220,"6 de julio de 1997"
10,3,29,1163,110,111,221,"6 de julio de 1997"
10,3,29,1164,89,75,164,"6 de julio de 1997"
10,3,29,1165,92,94,186,"6 de julio de 1997"
10,3,29,1166,87,99,186,"6 de julio de 1997"
10,3,29,1167,211,230,441,"6 de julio de 1997"
10,3,29,1168,114,112,226,"6 de julio de 1997"
10,3,29,1169,327,316,643,"6 de julio de 1997"
10,3,29,1170,66,48,114,"6 de julio de 1997"
10,3,29,1171,262,298,560,"6 de julio de 1997"
10,3,29,1172,213,216,429,"6 de julio de 1997"
10,3,29,1173,159,179,338,"6 de julio de 1997"
10,3,29,1174,189,178,367,"6 de julio de 1997"
10,3,29,1175,71,81,152,"6 de julio de 1997"
10,3,29,1176,100,77,177,"6 de julio de 1997"
10,3,29,1177,61,57,118,"6 de julio de 1997"
10,3,29,1178,44,37,81,"6 de julio de 1997"
10,3,30,1179,169,177,346,"6 de julio de 1997"
10,3,30,1180,175,213,388,"6 de julio de 1997"
10,3,30,1181,145,153,298,"6 de julio de 1997"
10,3,30,1182,159,164,323,"6 de julio de 1997"
10,3,31,1183,249,222,471,"6 de julio de 1997"
10,3,31,1184,112,102,214,"6 de julio de 1997"
10,3,31,1185,37,30,67,"6 de julio de 1997"
10,3,31,1186,50,36,86,"6 de julio de 1997"
10,3,31,1187,86,78,164,"6 de julio de 1997"
10,3,31,1188,58,51,109,"6 de julio de 1997"
10,3,31,1189,35,29,64,"6 de julio de 1997"
10,3,31,1190,70,60,130,"6 de julio de 1997"
10,3,32,1191,216,232,448,"6 de julio de 1997"
10,3,32,1192,550,556,1106,"6 de julio de 1997"
10,3,32,1193,287,319,606,"6 de julio de 1997"
10,3,32,1194,186,214,400,"6 de julio de 1997"
10,3,32,1195,159,135,294,"6 de julio de 1997"
10,3,32,1196,30,34,64,"6 de julio de 1997"
10,3,32,1197,283,267,550,"6 de julio de 1997"
10,3,32,1198,178,170,348,"6 de julio de 1997"
10,3,32,1199,328,320,648,"6 de julio de 1997"
10,4,5,108,631,641,1272,"6 de julio de 1997"
10,4,5,109,318,378,696,"6 de julio de 1997"
10,4,5,110,1353,1644,2997,"6 de julio de 1997"
10,4,5,111,856,990,1846,"6 de julio de 1997"
10,4,5,112,272,328,600,"6 de julio de 1997"
10,4,5,113,367,405,772,"6 de julio de 1997"
10,4,5,114,443,505,948,"6 de julio de 1997"
10,4,5,115,254,311,565,"6 de julio de 1997"
10,4,5,116,243,305,548,"6 de julio de 1997"
10,4,5,117,335,419,754,"6 de julio de 1997"
10,4,5,118,519,567,1086,"6 de julio de 1997"
10,4,5,119,283,338,621,"6 de julio de 1997"
10,4,5,120,344,438,782,"6 de julio de 1997"
10,4,5,121,255,290,545,"6 de julio de 1997"
10,4,5,122,211,235,446,"6 de julio de 1997"
10,4,5,123,227,268,495,"6 de julio de 1997"
10,4,5,124,482,532,1014,"6 de julio de 1997"
10,4,5,125,308,356,664,"6 de julio de 1997"
10,4,5,126,432,491,923,"6 de julio de 1997"
10,4,5,127,406,463,869,"6 de julio de 1997"
10,4,5,128,262,293,555,"6 de julio de 1997"
10,4,5,129,363,425,788,"6 de julio de 1997"
10,4,5,130,364,409,773,"6 de julio de 1997"
10,4,5,131,549,590,1139,"6 de julio de 1997"
10,4,5,132,467,575,1042,"6 de julio de 1997"
10,4,5,133,352,415,767,"6 de julio de 1997"
10,4,5,134,421,474,895,"6 de julio de 1997"
10,4,5,135,813,909,1722,"6 de julio de 1997"
10,4,5,136,689,797,1486,"6 de julio de 1997"
10,4,5,137,677,765,1442,"6 de julio de 1997"
10,4,5,138,308,378,686,"6 de julio de 1997"
10,4,5,139,443,567,1010,"6 de julio de 1997"
10,4,5,140,514,568,1082,"6 de julio de 1997"
10,4,5,141,562,638,1200,"6 de julio de 1997"
10,4,5,142,479,558,1037,"6 de julio de 1997"
10,4,5,145,823,916,1739,"6 de julio de 1997"
10,4,5,146,889,1019,1908,"6 de julio de 1997"
10,4,5,147,450,575,1025,"6 de julio de 1997"
10,4,5,148,367,454,821,"6 de julio de 1997"
10,4,5,149,326,414,740,"6 de julio de 1997"
10,4,5,152,510,548,1058,"6 de julio de 1997"
10,4,5,153,263,389,652,"6 de julio de 1997"
10,4,5,154,593,725,1318,"6 de julio de 1997"
10,4,5,155,550,628,1178,"6 de julio de 1997"
10,4,5,156,517,573,1090,"6 de julio de 1997"
10,4,5,157,710,811,1521,"6 de julio de 1997"
10,4,5,158,438,475,913,"6 de julio de 1997"
10,4,5,159,462,525,987,"6 de julio de 1997"
10,4,5,160,411,477,888,"6 de julio de 1997"
10,4,5,161,735,806,1541,"6 de julio de 1997"
10,4,5,162,702,819,1521,"6 de julio de 1997"
10,4,5,163,548,619,1167,"6 de julio de 1997"
10,4,5,164,341,361,702,"6 de julio de 1997"
10,4,5,165,107,119,226,"6 de julio de 1997"
10,4,5,166,207,229,436,"6 de julio de 1997"
10,4,5,167,534,578,1112,"6 de julio de 1997"
10,4,5,168,558,612,1170,"6 de julio de 1997"
10,4,5,169,683,744,1427,"6 de julio de 1997"
10,4,5,170,642,703,1345,"6 de julio de 1997"
10,4,5,171,359,407,766,"6 de julio de 1997"
10,4,5,172,428,547,975,"6 de julio de 1997"
10,4,5,173,330,433,763,"6 de julio de 1997"
10,4,5,181,379,476,855,"6 de julio de 1997"
10,4,5,187,437,471,908,"6 de julio de 1997"
10,4,5,195,609,673,1282,"6 de julio de 1997"
10,4,5,196,366,441,807,"6 de julio de 1997"
10,4,5,197,490,554,1044,"6 de julio de 1997"
10,4,5,198,451,556,1007,"6 de julio de 1997"
10,4,5,199,490,495,985,"6 de julio de 1997"
10,4,5,200,204,221,425,"6 de julio de 1997"
10,4,5,201,262,338,600,"6 de julio de 1997"
10,4,5,202,789,866,1655,"6 de julio de 1997"
10,4,5,204,667,817,1484,"6 de julio de 1997"
10,4,5,237,289,303,592,"6 de julio de 1997"
10,4,5,303,341,438,779,"6 de julio de 1997"
10,4,5,304,333,388,721,"6 de julio de 1997"
10,4,5,305,393,415,808,"6 de julio de 1997"
10,4,5,322,238,324,562,"6 de julio de 1997"
10,4,5,352,106,80,186,"6 de julio de 1997"
10,4,5,353,122,91,213,"6 de julio de 1997"
10,4,5,354,336,359,695,"6 de julio de 1997"
10,4,5,355,314,338,652,"6 de julio de 1997"
10,4,5,356,189,149,338,"6 de julio de 1997"
10,4,5,357,224,179,403,"6 de julio de 1997"
10,4,5,358,174,143,317,"6 de julio de 1997"
10,4,5,359,42,30,72,"6 de julio de 1997"
10,4,5,360,66,50,116,"6 de julio de 1997"
10,4,5,361,404,410,814,"6 de julio de 1997"
10,4,5,362,284,284,568,"6 de julio de 1997"
10,4,5,363,230,247,477,"6 de julio de 1997"
10,4,5,364,187,217,404,"6 de julio de 1997"
10,4,5,365,173,189,362,"6 de julio de 1997"
10,4,5,366,90,71,161,"6 de julio de 1997"
10,4,5,367,40,37,77,"6 de julio de 1997"
10,4,5,368,89,95,184,"6 de julio de 1997"
10,4,5,369,539,552,1091,"6 de julio de 1997"
10,4,5,370,811,7,818,"6 de julio de 1997"
10,4,5,371,313,326,639,"6 de julio de 1997"
10,4,5,372,178,167,345,"6 de julio de 1997"
10,4,5,373,95,59,154,"6 de julio de 1997"
10,4,5,374,239,201,440,"6 de julio de 1997"
10,4,5,375,98,89,187,"6 de julio de 1997"
10,4,5,376,436,456,892,"6 de julio de 1997"
10,4,5,377,395,406,801,"6 de julio de 1997"
10,4,5,378,285,330,615,"6 de julio de 1997"
10,4,5,379,354,364,718,"6 de julio de 1997"
10,4,5,380,321,392,713,"6 de julio de 1997"
10,4,5,381,460,478,938,"6 de julio de 1997"
10,4,5,383,326,336,662,"6 de julio de 1997"
10,4,5,386,143,99,242,"6 de julio de 1997"
10,4,5,387,77,49,126,"6 de julio de 1997"
10,4,5,401,300,238,538,"6 de julio de 1997"
10,4,5,419,62,68,130,"6 de julio de 1997"
10,4,14,796,233,296,529,"6 de julio de 1997"
10,4,14,797,234,279,513,"6 de julio de 1997"
10,4,14,798,130,134,264,"6 de julio de 1997"
10,4,14,799,139,121,260,"6 de julio de 1997"
10,4,14,800,234,333,567,"6 de julio de 1997"
10,4,14,801,85,79,164,"6 de julio de 1997"
10,4,14,802,39,39,78,"6 de julio de 1997"
10,4,14,803,89,91,180,"6 de julio de 1997"
10,4,14,804,51,48,99,"6 de julio de 1997"
10,4,14,805,122,111,233,"6 de julio de 1997"
10,4,14,806,67,82,149,"6 de julio de 1997"
10,4,14,807,98,81,179,"6 de julio de 1997"
10,4,14,808,160,154,314,"6 de julio de 1997"
10,4,14,809,213,149,362,"6 de julio de 1997"
10,4,14,810,175,113,288,"6 de julio de 1997"
10,4,14,811,427,413,840,"6 de julio de 1997"
10,4,14,812,59,43,102,"6 de julio de 1997"
10,4,14,813,121,116,237,"6 de julio de 1997"
10,4,14,814,70,56,126,"6 de julio de 1997"
10,4,14,815,67,31,98,"6 de julio de 1997"
10,4,14,816,270,243,513,"6 de julio de 1997"
10,4,14,817,194,146,340,"6 de julio de 1997"
10,4,14,818,6,3,9,"6 de julio de 1997"
10,4,14,819,16,6,22,"6 de julio de 1997"
10,4,14,820,152,108,260,"6 de julio de 1997"
10,4,14,821,304,254,558,"6 de julio de 1997"
10,4,14,822,264,180,444,"6 de julio de 1997"
10,4,14,823,113,78,191,"6 de julio de 1997"
10,4,14,824,73,33,106,"6 de julio de 1997"
10,4,14,825,187,164,351,"6 de julio de 1997"
10,4,14,826,329,345,674,"6 de julio de 1997"
10,4,14,827,203,162,365,"6 de julio de 1997"
10,4,16,845,347,363,710,"6 de julio de 1997"
10,4,16,846,537,562,1099,"6 de julio de 1997"
10,4,16,847,350,402,752,"6 de julio de 1997"
10,4,16,848,337,353,690,"6 de julio de 1997"
10,4,16,849,264,251,515,"6 de julio de 1997"
10,4,16,850,413,503,916,"6 de julio de 1997"
10,4,16,851,326,337,663,"6 de julio de 1997"
10,4,16,852,96,71,167,"6 de julio de 1997"
10,4,16,853,63,88,151,"6 de julio de 1997"
10,4,16,854,154,165,319,"6 de julio de 1997"
10,4,16,855,248,209,457,"6 de julio de 1997"
10,4,16,856,233,223,456,"6 de julio de 1997"
10,4,16,857,443,430,873,"6 de julio de 1997"
10,4,16,858,26,29,55,"6 de julio de 1997"
10,4,16,859,39,27,66,"6 de julio de 1997"
10,4,16,860,307,271,578,"6 de julio de 1997"
10,4,16,861,476,495,971,"6 de julio de 1997"
10,4,16,862,81,80,161,"6 de julio de 1997"
10,4,16,863,287,293,580,"6 de julio de 1997"
10,4,16,864,214,214,428,"6 de julio de 1997"
10,4,16,865,103,111,214,"6 de julio de 1997"
10,4,23,992,356,387,743,"6 de julio de 1997"
10,4,23,993,597,661,1258,"6 de julio de 1997"
10,4,23,994,540,561,1101,"6 de julio de 1997"
10,4,23,995,713,749,1462,"6 de julio de 1997"
10,4,23,996,406,414,820,"6 de julio de 1997"
10,4,23,997,265,292,557,"6 de julio de 1997"
10,4,23,998,228,230,458,"6 de julio de 1997"
10,4,23,999,228,235,463,"6 de julio de 1997"
10,4,23,1000,469,483,952,"6 de julio de 1997"
10,4,23,1001,290,311,601,"6 de julio de 1997"
10,4,23,1002,236,261,497,"6 de julio de 1997"
10,4,23,1003,321,318,639,"6 de julio de 1997"
10,4,23,1004,308,261,569,"6 de julio de 1997"
10,4,23,1005,358,344,702,"6 de julio de 1997"
10,4,23,1006,294,257,551,"6 de julio de 1997"
10,4,23,1007,203,218,421,"6 de julio de 1997"
10,4,23,1008,295,336,631,"6 de julio de 1997"
10,4,23,1009,189,207,396,"6 de julio de 1997"
10,4,23,1010,396,360,756,"6 de julio de 1997"
10,4,23,1011,88,79,167,"6 de julio de 1997"
10,4,23,1012,144,167,311,"6 de julio de 1997"
10,4,23,1013,276,341,617,"6 de julio de 1997"
10,4,23,1014,316,341,657,"6 de julio de 1997"
10,4,24,1015,371,356,727,"6 de julio de 1997"
10,4,24,1016,492,324,816,"6 de julio de 1997"
10,4,24,1017,396,458,854,"6 de julio de 1997"
10,4,24,1018,598,639,1237,"6 de julio de 1997"
10,4,24,1019,713,768,1481,"6 de julio de 1997"
10,4,24,1020,345,395,740,"6 de julio de 1997"
10,4,24,1021,328,330,658,"6 de julio de 1997"
10,4,24,1022,391,394,785,"6 de julio de 1997"
10,4,24,1023,544,554,1098,"6 de julio de 1997"
10,4,24,1024,455,456,911,"6 de julio de 1997"
10,4,24,1025,186,144,330,"6 de julio de 1997"
10,4,24,1026,58,54,112,"6 de julio de 1997"
10,4,24,1027,229,218,447,"6 de julio de 1997"
10,4,24,1028,225,199,424,"6 de julio de 1997"
10,4,24,1029,274,222,496,"6 de julio de 1997"
10,4,24,1030,204,187,391,"6 de julio de 1997"
10,4,24,1031,127,167,294,"6 de julio de 1997"
10,4,24,1032,154,163,317,"6 de julio de 1997"
10,4,24,1033,161,165,326,"6 de julio de 1997"
10,4,24,1034,232,267,499,"6 de julio de 1997"
10,4,24,1035,113,102,215,"6 de julio de 1997"
10,4,24,1036,71,59,130,"6 de julio de 1997"
10,4,24,1037,318,262,580,"6 de julio de 1997"
10,4,24,1038,140,113,253,"6 de julio de 1997"
10,4,24,1039,141,143,284,"6 de julio de 1997"
10,4,24,1040,266,244,510,"6 de julio de 1997"
10,4,24,1041,72,75,147,"6 de julio de 1997"
10,4,24,1042,110,96,206,"6 de julio de 1997"
10,4,24,1043,175,151,326,"6 de julio de 1997"
10,4,24,1044,202,165,367,"6 de julio de 1997"
10,4,24,1045,124,81,205,"6 de julio de 1997"
10,4,24,1046,291,214,505,"6 de julio de 1997"
10,4,24,1047,247,204,451,"6 de julio de 1997"
10,4,24,1048,123,87,210,"6 de julio de 1997"
10,4,24,1049,170,141,311,"6 de julio de 1997"
10,4,24,1050,263,204,467,"6 de julio de 1997"
10,4,24,1051,120,89,209,"6 de julio de 1997"
10,4,24,1052,34,25,59,"6 de julio de 1997"
10,4,24,1053,96,42,138,"6 de julio de 1997"
10,4,24,1054,117,87,204,"6 de julio de 1997"
10,4,24,1055,157,139,296,"6 de julio de 1997"
10,4,24,1056,30,31,61,"6 de julio de 1997"
10,4,24,1057,38,30,68,"6 de julio de 1997"
10,4,24,1058,85,35,120,"6 de julio de 1997"
10,4,24,1059,60,36,96,"6 de julio de 1997"
10,4,24,1060,61,28,89,"6 de julio de 1997"
10,4,24,1061,212,127,339,"6 de julio de 1997"
10,4,24,1062,63,38,101,"6 de julio de 1997"
10,4,34,1263,214,272,486,"6 de julio de 1997"
10,4,34,1264,242,280,522,"6 de julio de 1997"
10,4,34,1265,344,394,738,"6 de julio de 1997"
10,4,34,1266,385,406,791,"6 de julio de 1997"
10,4,34,1267,71,63,134,"6 de julio de 1997"
10,4,34,1268,174,181,355,"6 de julio de 1997"
10,4,34,1269,100,110,210,"6 de julio de 1997"
10,4,34,1270,48,44,92,"6 de julio de 1997"
10,4,34,1271,112,122,234,"6 de julio de 1997"
10,4,34,1272,61,61,122,"6 de julio de 1997"
10,4,34,1273,50,68,118,"6 de julio de 1997"
10,4,39,1374,320,351,671,"6 de julio de 1997"
10,4,39,1375,405,450,855,"6 de julio de 1997"
10,4,39,1376,351,370,721,"6 de julio de 1997"
10,4,39,1377,451,532,983,"6 de julio de 1997"
10,4,39,1378,350,360,710,"6 de julio de 1997"
10,4,39,1379,319,338,657,"6 de julio de 1997"
10,4,39,1380,449,533,982,"6 de julio de 1997"
10,4,39,1381,276,307,583,"6 de julio de 1997"
10,4,39,1382,302,302,604,"6 de julio de 1997"
10,4,39,1383,472,571,1043,"6 de julio de 1997"
10,4,39,1384,302,344,646,"6 de julio de 1997"
10,4,39,1385,246,315,561,"6 de julio de 1997"
10,4,39,1386,197,290,487,"6 de julio de 1997"
10,4,39,1387,476,521,997,"6 de julio de 1997"
10,4,39,1388,74,64,138,"6 de julio de 1997"
10,4,39,1389,157,164,321,"6 de julio de 1997"
10,4,39,1390,210,198,408,"6 de julio de 1997"
10,5,5,143,493,566,1059,"6 de julio de 1997"
10,5,5,144,578,695,1273,"6 de julio de 1997"
10,5,5,150,597,742,1339,"6 de julio de 1997"
10,5,5,151,510,611,1121,"6 de julio de 1997"
10,5,5,174,332,379,711,"6 de julio de 1997"
10,5,5,175,373,384,757,"6 de julio de 1997"
10,5,5,176,674,730,1404,"6 de julio de 1997"
10,5,5,177,501,605,1106,"6 de julio de 1997"
10,5,5,178,561,659,1220,"6 de julio de 1997"
10,5,5,179,499,524,1023,"6 de julio de 1997"
10,5,5,180,551,597,1148,"6 de julio de 1997"
10,5,5,182,432,490,922,"6 de julio de 1997"
10,5,5,183,370,464,834,"6 de julio de 1997"
10,5,5,184,549,604,1153,"6 de julio de 1997"
10,5,5,185,425,492,917,"6 de julio de 1997"
10,5,5,186,263,276,539,"6 de julio de 1997"
10,5,5,188,626,731,1357,"6 de julio de 1997"
10,5,5,189,367,429,796,"6 de julio de 1997"
10,5,5,190,359,434,793,"6 de julio de 1997"
10,5,5,191,418,535,953,"6 de julio de 1997"
10,5,5,192,430,526,956,"6 de julio de 1997"
10,5,5,193,314,379,693,"6 de julio de 1997"
10,5,5,194,449,565,1014,"6 de julio de 1997"
10,5,5,203,460,554,1014,"6 de julio de 1997"
10,5,5,205,313,447,760,"6 de julio de 1997"
10,5,5,206,327,416,743,"6 de julio de 1997"
10,5,5,207,281,340,621,"6 de julio de 1997"
10,5,5,208,400,491,891,"6 de julio de 1997"
10,5,5,209,380,408,788,"6 de julio de 1997"
10,5,5,210,456,545,1001,"6 de julio de 1997"
10,5,5,211,352,464,816,"6 de julio de 1997"
10,5,5,212,376,406,782,"6 de julio de 1997"
10,5,5,213,374,439,813,"6 de julio de 1997"
10,5,5,214,263,340,603,"6 de julio de 1997"
10,5,5,215,317,444,761,"6 de julio de 1997"
10,5,5,216,241,326,567,"6 de julio de 1997"
10,5,5,217,380,412,792,"6 de julio de 1997"
10,5,5,218,484,553,1037,"6 de julio de 1997"
10,5,5,219,44,33,77,"6 de julio de 1997"
10,5,5,220,311,323,634,"6 de julio de 1997"
10,5,5,221,281,341,622,"6 de julio de 1997"
10,5,5,222,584,718,1302,"6 de julio de 1997"
10,5,5,223,609,691,1300,"6 de julio de 1997"
10,5,5,224,638,764,1402,"6 de julio de 1997"
10,5,5,225,585,759,1344,"6 de julio de 1997"
10,5,5,226,288,363,651,"6 de julio de 1997"
10,5,5,227,503,659,1162,"6 de julio de 1997"
10,5,5,228,484,598,1082,"6 de julio de 1997"
10,5,5,229,282,338,620,"6 de julio de 1997"
10,5,5,230,235,359,594,"6 de julio de 1997"
10,5,5,231,397,431,828,"6 de julio de 1997"
10,5,5,232,242,317,559,"6 de julio de 1997"
10,5,5,233,367,387,754,"6 de julio de 1997"
10,5,5,234,253,320,573,"6 de julio de 1997"
10,5,5,235,224,252,476,"6 de julio de 1997"
10,5,5,236,331,384,715,"6 de julio de 1997"
10,5,5,238,528,571,1099,"6 de julio de 1997"
10,5,5,239,375,478,853,"6 de julio de 1997"
10,5,5,240,343,437,780,"6 de julio de 1997"
10,5,5,241,313,357,670,"6 de julio de 1997"
10,5,5,242,343,454,797,"6 de julio de 1997"
10,5,5,243,473,579,1052,"6 de julio de 1997"
10,5,5,244,293,322,615,"6 de julio de 1997"
10,5,5,245,413,539,952,"6 de julio de 1997"
10,5,5,246,163,209,372,"6 de julio de 1997"
10,5,5,247,533,649,1182,"6 de julio de 1997"
10,5,5,248,582,705,1287,"6 de julio de 1997"
10,5,5,249,642,827,1469,"6 de julio de 1997"
10,5,5,250,425,475,900,"6 de julio de 1997"
10,5,5,251,343,384,727,"6 de julio de 1997"
10,5,5,252,463,509,972,"6 de julio de 1997"
10,5,5,253,200,202,402,"6 de julio de 1997"
10,5,5,254,471,472,943,"6 de julio de 1997"
10,5,5,255,468,533,1001,"6 de julio de 1997"
10,5,5,256,509,587,1096,"6 de julio de 1997"
10,5,5,257,389,472,861,"6 de julio de 1997"
10,5,5,258,427,513,940,"6 de julio de 1997"
10,5,5,259,443,481,924,"6 de julio de 1997"
10,5,5,260,535,680,1215,"6 de julio de 1997"
10,5,5,261,401,504,905,"6 de julio de 1997"
10,5,5,262,577,690,1267,"6 de julio de 1997"
10,5,5,263,358,426,784,"6 de julio de 1997"
10,5,5,264,332,439,771,"6 de julio de 1997"
10,5,5,265,306,365,671,"6 de julio de 1997"
10,5,5,266,329,419,748,"6 de julio de 1997"
10,5,5,267,328,399,727,"6 de julio de 1997"
10,5,5,268,291,330,621,"6 de julio de 1997"
10,5,5,269,521,635,1156,"6 de julio de 1997"
10,5,5,270,597,673,1270,"6 de julio de 1997"
10,5,5,271,583,759,1342,"6 de julio de 1997"
10,5,5,272,372,434,806,"6 de julio de 1997"
10,5,5,273,434,482,916,"6 de julio de 1997"
10,5,5,274,433,476,909,"6 de julio de 1997"
10,5,5,275,388,453,841,"6 de julio de 1997"
10,5,5,276,757,915,1672,"6 de julio de 1997"
10,5,5,277,161,178,339,"6 de julio de 1997"
10,5,5,278,378,411,789,"6 de julio de 1997"
10,5,5,279,282,315,597,"6 de julio de 1997"
10,5,5,280,280,337,617,"6 de julio de 1997"
10,5,5,281,383,446,829,"6 de julio de 1997"
10,5,5,282,139,152,291,"6 de julio de 1997"
10,5,5,283,366,428,794,"6 de julio de 1997"
10,5,5,284,366,398,764,"6 de julio de 1997"
10,5,5,285,338,363,701,"6 de julio de 1997"
10,5,5,286,644,719,1363,"6 de julio de 1997"
10,5,5,287,250,317,567,"6 de julio de 1997"
10,5,5,288,432,508,940,"6 de julio de 1997"
10,5,5,289,442,527,969,"6 de julio de 1997"
10,5,5,290,462,516,978,"6 de julio de 1997"
10,5,5,291,363,432,795,"6 de julio de 1997"
10,5,5,292,442,526,968,"6 de julio de 1997"
10,5,5,293,516,599,1115,"6 de julio de 1997"
10,5,5,294,619,708,1327,"6 de julio de 1997"
10,5,5,295,485,597,1082,"6 de julio de 1997"
10,5,5,296,613,714,1327,"6 de julio de 1997"
10,5,5,297,419,467,886,"6 de julio de 1997"
10,5,5,298,265,305,570,"6 de julio de 1997"
10,5,5,299,394,471,865,"6 de julio de 1997"
10,5,5,300,308,377,685,"6 de julio de 1997"
10,5,5,301,635,760,1395,"6 de julio de 1997"
10,5,5,302,447,534,981,"6 de julio de 1997"
10,5,5,306,490,572,1062,"6 de julio de 1997"
10,5,5,307,418,567,985,"6 de julio de 1997"
10,5,5,308,446,592,1038,"6 de julio de 1997"
10,5,5,309,491,637,1128,"6 de julio de 1997"
10,5,5,310,432,503,935,"6 de julio de 1997"
10,5,5,311,333,416,749,"6 de julio de 1997"
10,5,5,312,559,716,1275,"6 de julio de 1997"
10,5,5,313,335,361,696,"6 de julio de 1997"
10,5,5,314,379,425,804,"6 de julio de 1997"
10,5,5,315,643,744,1387,"6 de julio de 1997"
10,5,5,316,631,761,1392,"6 de julio de 1997"
10,5,5,317,264,318,582,"6 de julio de 1997"
10,5,5,318,258,303,561,"6 de julio de 1997"
10,5,5,319,662,830,1492,"6 de julio de 1997"
10,5,5,320,594,676,1270,"6 de julio de 1997"
10,5,5,321,509,612,1121,"6 de julio de 1997"
10,5,5,323,411,455,866,"6 de julio de 1997"
10,5,5,324,389,443,832,"6 de julio de 1997"
10,5,5,325,609,689,1298,"6 de julio de 1997"
10,5,5,326,250,304,554,"6 de julio de 1997"
10,5,5,327,678,786,1464,"6 de julio de 1997"
10,5,5,328,546,708,1254,"6 de julio de 1997"
10,5,5,329,399,451,850,"6 de julio de 1997"
10,5,5,330,431,487,918,"6 de julio de 1997"
10,5,5,331,554,585,1139,"6 de julio de 1997"
10,5,5,332,501,560,1061,"6 de julio de 1997"
10,5,5,333,441,527,968,"6 de julio de 1997"
10,5,5,334,482,542,1024,"6 de julio de 1997"
10,5,5,335,472,567,1039,"6 de julio de 1997"
10,5,5,336,556,596,1152,"6 de julio de 1997"
10,5,5,337,405,478,883,"6 de julio de 1997"
10,5,5,338,391,499,890,"6 de julio de 1997"
10,5,5,339,311,354,665,"6 de julio de 1997"
10,5,5,340,139,178,317,"6 de julio de 1997"
10,5,5,341,275,317,592,"6 de julio de 1997"
10,5,5,342,196,243,439,"6 de julio de 1997"
10,5,5,343,301,368,669,"6 de julio de 1997"
10,5,5,344,629,705,1334,"6 de julio de 1997"
10,5,5,345,480,542,1022,"6 de julio de 1997"
10,5,5,346,463,516,979,"6 de julio de 1997"
10,5,5,347,501,517,1018,"6 de julio de 1997"
10,5,5,348,241,272,513,"6 de julio de 1997"
10,5,5,349,356,426,782,"6 de julio de 1997"
10,5,5,350,181,218,399,"6 de julio de 1997"
10,5,5,351,200,236,436,"6 de julio de 1997"
10,5,5,382,150,192,342,"6 de julio de 1997"
10,5,5,384,207,215,422,"6 de julio de 1997"
10,5,5,385,372,364,736,"6 de julio de 1997"
10,5,5,388,313,261,574,"6 de julio de 1997"
10,5,5,389,347,397,744,"6 de julio de 1997"
10,5,5,390,157,175,332,"6 de julio de 1997"
10,5,5,391,259,275,534,"6 de julio de 1997"
10,5,5,392,327,386,713,"6 de julio de 1997"
10,5,5,393,447,514,961,"6 de julio de 1997"
10,5,5,394,210,223,433,"6 de julio de 1997"
10,5,5,395,335,339,674,"6 de julio de 1997"
10,5,5,396,187,150,337,"6 de julio de 1997"
10,5,5,397,349,333,682,"6 de julio de 1997"
10,5,5,398,526,525,1051,"6 de julio de 1997"
10,5,5,399,373,401,774,"6 de julio de 1997"
10,5,5,400,303,336,639,"6 de julio de 1997"
10,5,5,402,291,305,596,"6 de julio de 1997"
10,5,5,403,328,339,667,"6 de julio de 1997"
10,5,5,404,128,109,237,"6 de julio de 1997"
10,5,5,405,319,305,624,"6 de julio de 1997"
10,5,5,406,26,32,58,"6 de julio de 1997"
10,5,5,407,126,100,226,"6 de julio de 1997"
10,5,5,408,82,72,154,"6 de julio de 1997"
10,5,5,409,623,587,1210,"6 de julio de 1997"
10,5,5,410,528,539,1067,"6 de julio de 1997"
10,5,5,411,452,458,910,"6 de julio de 1997"
10,5,5,412,399,400,799,"6 de julio de 1997"
10,5,5,413,191,172,363,"6 de julio de 1997"
10,5,5,414,227,212,439,"6 de julio de 1997"
10,5,5,415,59,49,108,"6 de julio de 1997"
10,5,5,416,237,182,419,"6 de julio de 1997"
10,5,5,417,182,128,310,"6 de julio de 1997"
10,5,5,418,99,77,176,"6 de julio de 1997"
11,1,14,752,263,341,604,"6 de julio de 1997"
11,1,14,753,485,592,1077,"6 de julio de 1997"
11,1,14,754,494,611,1105,"6 de julio de 1997"
11,1,14,755,640,770,1410,"6 de julio de 1997"
11,1,14,756,630,745,1375,"6 de julio de 1997"
11,1,14,757,396,484,880,"6 de julio de 1997"
11,1,14,758,494,618,1112,"6 de julio de 1997"
11,1,14,759,411,482,893,"6 de julio de 1997"
11,1,14,760,721,852,1573,"6 de julio de 1997"
11,1,14,761,534,689,1223,"6 de julio de 1997"
11,1,14,762,622,753,1375,"6 de julio de 1997"
11,1,14,763,419,526,945,"6 de julio de 1997"
11,1,14,764,508,589,1097,"6 de julio de 1997"
11,1,14,765,758,852,1610,"6 de julio de 1997"
11,1,14,766,441,554,995,"6 de julio de 1997"
11,1,14,767,416,463,879,"6 de julio de 1997"
11,1,14,768,402,511,913,"6 de julio de 1997"
11,1,14,769,528,639,1167,"6 de julio de 1997"
11,1,14,770,501,637,1138,"6 de julio de 1997"
11,1,14,771,194,245,439,"6 de julio de 1997"
11,1,14,772,603,724,1327,"6 de julio de 1997"
11,1,14,773,490,562,1052,"6 de julio de 1997"
11,1,14,774,364,446,810,"6 de julio de 1997"
11,1,14,775,568,639,1207,"6 de julio de 1997"
11,1,14,776,274,375,649,"6 de julio de 1997"
11,1,14,777,337,443,780,"6 de julio de 1997"
11,1,14,778,525,631,1156,"6 de julio de 1997"
11,1,14,779,348,367,715,"6 de julio de 1997"
11,1,14,780,365,425,790,"6 de julio de 1997"
11,1,14,781,429,511,940,"6 de julio de 1997"
11,1,14,782,279,350,629,"6 de julio de 1997"
11,1,14,783,210,220,430,"6 de julio de 1997"
11,1,14,784,332,374,706,"6 de julio de 1997"
11,1,14,785,297,280,577,"6 de julio de 1997"
11,1,14,786,374,483,857,"6 de julio de 1997"
11,1,14,787,323,400,723,"6 de julio de 1997"
11,1,14,788,209,235,444,"6 de julio de 1997"
11,1,14,789,137,158,295,"6 de julio de 1997"
11,1,14,790,538,630,1168,"6 de julio de 1997"
11,1,14,791,345,355,700,"6 de julio de 1997"
11,1,14,792,454,518,972,"6 de julio de 1997"
11,1,14,793,490,663,1153,"6 de julio de 1997"
11,1,14,794,273,344,617,"6 de julio de 1997"
11,1,14,795,380,441,821,"6 de julio de 1997"
11,1,14,796,313,403,716,"6 de julio de 1997"
11,1,14,797,525,564,1089,"6 de julio de 1997"
11,1,14,798,366,370,736,"6 de julio de 1997"
11,1,14,799,193,223,416,"6 de julio de 1997"
11,1,14,800,315,328,643,"6 de julio de 1997"
11,1,14,801,431,523,954,"6 de julio de 1997"
11,1,14,802,368,418,786,"6 de julio de 1997"
11,1,14,803,413,456,869,"6 de julio de 1997"
11,1,14,804,414,472,886,"6 de julio de 1997"
11,1,14,805,446,456,902,"6 de julio de 1997"
11,1,14,806,340,356,696,"6 de julio de 1997"
11,1,14,807,419,501,920,"6 de julio de 1997"
11,1,14,808,578,607,1185,"6 de julio de 1997"
11,1,14,809,568,630,1198,"6 de julio de 1997"
11,1,14,810,256,273,529,"6 de julio de 1997"
11,1,14,811,381,413,794,"6 de julio de 1997"
11,1,14,812,115,121,236,"6 de julio de 1997"
11,1,14,813,435,455,890,"6 de julio de 1997"
11,1,14,814,173,178,351,"6 de julio de 1997"
11,1,14,815,239,227,466,"6 de julio de 1997"
11,1,14,816,222,261,483,"6 de julio de 1997"
11,1,14,817,263,298,561,"6 de julio de 1997"
11,1,14,818,446,449,895,"6 de julio de 1997"
11,1,14,819,213,273,486,"6 de julio de 1997"
11,1,14,820,291,317,608,"6 de julio de 1997"
11,1,14,821,442,516,958,"6 de julio de 1997"
11,1,14,822,287,333,620,"6 de julio de 1997"
11,1,22,1894,326,403,729,"6 de julio de 1997"
11,1,22,1895,427,549,976,"6 de julio de 1997"
11,1,22,1896,337,404,741,"6 de julio de 1997"
11,1,22,1897,307,342,649,"6 de julio de 1997"
11,1,22,1898,73,86,159,"6 de julio de 1997"
11,1,22,1899,294,313,607,"6 de julio de 1997"
11,1,22,1900,161,151,312,"6 de julio de 1997"
11,1,22,1901,550,582,1132,"6 de julio de 1997"
11,1,22,1902,32,31,63,"6 de julio de 1997"
11,1,22,1903,263,309,572,"6 de julio de 1997"
11,1,22,1904,244,305,549,"6 de julio de 1997"
11,1,22,1905,306,386,692,"6 de julio de 1997"
11,1,22,1906,299,345,644,"6 de julio de 1997"
11,1,22,1907,300,344,644,"6 de julio de 1997"
11,1,22,1908,196,266,462,"6 de julio de 1997"
11,1,22,1909,103,113,216,"6 de julio de 1997"
11,1,22,1910,363,368,731,"6 de julio de 1997"
11,1,22,1911,281,313,594,"6 de julio de 1997"
11,1,29,2347,358,419,777,"6 de julio de 1997"
11,1,29,2348,373,454,827,"6 de julio de 1997"
11,1,29,2349,405,438,843,"6 de julio de 1997"
11,1,29,2350,351,406,757,"6 de julio de 1997"
11,1,29,2351,197,186,383,"6 de julio de 1997"
11,1,29,2352,319,393,712,"6 de julio de 1997"
11,1,29,2353,186,208,394,"6 de julio de 1997"
11,1,29,2354,312,324,636,"6 de julio de 1997"
11,1,29,2355,93,95,188,"6 de julio de 1997"
11,1,29,2356,460,533,993,"6 de julio de 1997"
11,1,29,2357,119,139,258,"6 de julio de 1997"
11,1,29,2358,420,467,887,"6 de julio de 1997"
11,1,29,2359,352,454,806,"6 de julio de 1997"
11,1,29,2360,360,418,778,"6 de julio de 1997"
11,1,29,2361,193,251,444,"6 de julio de 1997"
11,1,29,2362,88,111,199,"6 de julio de 1997"
11,1,29,2363,206,277,483,"6 de julio de 1997"
11,1,29,2364,168,168,336,"6 de julio de 1997"
11,1,29,2365,192,252,444,"6 de julio de 1997"
11,1,29,2366,220,287,507,"6 de julio de 1997"
11,1,29,2367,153,212,365,"6 de julio de 1997"
11,1,29,2368,286,334,620,"6 de julio de 1997"
11,1,29,2369,301,352,653,"6 de julio de 1997"
11,1,29,2370,145,183,328,"6 de julio de 1997"
11,1,29,2371,344,411,755,"6 de julio de 1997"
11,1,29,2372,212,281,493,"6 de julio de 1997"
11,1,29,2373,310,433,743,"6 de julio de 1997"
11,1,29,2374,260,349,609,"6 de julio de 1997"
11,1,30,2375,356,433,789,"6 de julio de 1997"
11,1,30,2376,260,273,533,"6 de julio de 1997"
11,1,30,2377,353,459,812,"6 de julio de 1997"
11,1,30,2378,389,495,884,"6 de julio de 1997"
11,1,30,2379,389,451,840,"6 de julio de 1997"
11,1,30,2380,471,602,1073,"6 de julio de 1997"
11,1,30,2381,374,463,837,"6 de julio de 1997"
11,1,30,2382,384,433,817,"6 de julio de 1997"
11,1,30,2383,430,568,998,"6 de julio de 1997"
11,1,30,2384,384,489,873,"6 de julio de 1997"
11,1,30,2385,416,499,915,"6 de julio de 1997"
11,1,30,2386,403,456,859,"6 de julio de 1997"
11,1,30,2387,359,429,788,"6 de julio de 1997"
11,1,30,2388,361,453,814,"6 de julio de 1997"
11,1,30,2389,237,302,539,"6 de julio de 1997"
11,1,30,2390,602,554,1156,"6 de julio de 1997"
11,1,30,2391,188,215,403,"6 de julio de 1997"
11,1,30,2392,447,424,871,"6 de julio de 1997"
11,1,30,2393,288,305,593,"6 de julio de 1997"
11,1,30,2394,350,351,701,"6 de julio de 1997"
11,1,30,2395,198,198,396,"6 de julio de 1997"
11,1,30,2396,225,264,489,"6 de julio de 1997"
11,1,30,2397,223,235,458,"6 de julio de 1997"
11,1,30,2398,432,510,942,"6 de julio de 1997"
11,1,30,2399,547,558,1105,"6 de julio de 1997"
11,1,30,2400,290,274,564,"6 de julio de 1997"
11,1,30,2401,261,250,511,"6 de julio de 1997"
11,1,30,2402,155,133,288,"6 de julio de 1997"
11,1,30,2403,218,195,413,"6 de julio de 1997"
11,1,30,2404,139,125,264,"6 de julio de 1997"
11,1,30,2405,474,495,969,"6 de julio de 1997"
11,1,30,2406,314,374,688,"6 de julio de 1997"
11,1,30,2407,353,363,716,"6 de julio de 1997"
11,1,30,2408,320,312,632,"6 de julio de 1997"
11,1,30,2409,471,516,987,"6 de julio de 1997"
11,1,30,2410,223,227,450,"6 de julio de 1997"
11,1,30,2411,212,196,408,"6 de julio de 1997"
11,1,30,2412,284,338,622,"6 de julio de 1997"
11,1,30,2413,451,533,984,"6 de julio de 1997"
11,1,30,2414,535,570,1105,"6 de julio de 1997"
11,1,30,2415,331,356,687,"6 de julio de 1997"
11,1,30,2416,161,170,331,"6 de julio de 1997"
11,1,30,2417,277,367,644,"6 de julio de 1997"
11,1,30,2418,145,180,325,"6 de julio de 1997"
11,1,30,2419,205,204,409,"6 de julio de 1997"
11,1,30,2420,318,372,690,"6 de julio de 1997"
11,1,30,2421,332,480,812,"6 de julio de 1997"
11,1,30,2422,311,367,678,"6 de julio de 1997"
11,1,30,2423,233,289,522,"6 de julio de 1997"
11,1,30,2424,267,341,608,"6 de julio de 1997"
11,1,30,2425,329,319,648,"6 de julio de 1997"
11,1,30,2426,260,299,559,"6 de julio de 1997"
11,1,30,2427,332,360,692,"6 de julio de 1997"
11,1,30,2428,133,170,303,"6 de julio de 1997"
11,1,30,2429,323,342,665,"6 de julio de 1997"
11,1,30,2430,183,193,376,"6 de julio de 1997"
11,1,30,2431,284,325,609,"6 de julio de 1997"
11,1,30,2432,251,280,531,"6 de julio de 1997"
11,1,30,2433,272,310,582,"6 de julio de 1997"
11,1,30,2434,316,323,639,"6 de julio de 1997"
11,1,30,2435,270,318,588,"6 de julio de 1997"
11,1,30,2436,353,380,733,"6 de julio de 1997"
11,1,30,2437,209,210,419,"6 de julio de 1997"
11,1,30,2438,232,297,529,"6 de julio de 1997"
11,1,30,2439,360,381,741,"6 de julio de 1997"
11,1,30,2440,377,412,789,"6 de julio de 1997"
11,1,30,2441,326,402,728,"6 de julio de 1997"
11,1,30,2442,282,277,559,"6 de julio de 1997"
11,1,30,2443,192,188,380,"6 de julio de 1997"
11,1,30,2444,211,198,409,"6 de julio de 1997"
11,1,30,2445,125,115,240,"6 de julio de 1997"
11,2,3,141,519,634,1153,"6 de julio de 1997"
11,2,3,142,277,341,618,"6 de julio de 1997"
11,2,3,143,663,772,1435,"6 de julio de 1997"
11,2,3,144,282,333,615,"6 de julio de 1997"
11,2,3,145,495,598,1093,"6 de julio de 1997"
11,2,3,146,509,623,1132,"6 de julio de 1997"
11,2,3,147,433,524,957,"6 de julio de 1997"
11,2,3,148,375,440,815,"6 de julio de 1997"
11,2,3,149,538,676,1214,"6 de julio de 1997"
11,2,3,150,361,454,815,"6 de julio de 1997"
11,2,3,151,306,369,675,"6 de julio de 1997"
11,2,3,152,392,504,896,"6 de julio de 1997"
11,2,3,153,505,627,1132,"6 de julio de 1997"
11,2,3,154,537,636,1173,"6 de julio de 1997"
11,2,3,155,594,700,1294,"6 de julio de 1997"
11,2,3,156,423,508,931,"6 de julio de 1997"
11,2,3,157,903,1076,1979,"6 de julio de 1997"
11,2,3,158,496,620,1116,"6 de julio de 1997"
11,2,3,159,507,589,1096,"6 de julio de 1997"
11,2,3,160,363,457,820,"6 de julio de 1997"
11,2,3,161,235,257,492,"6 de julio de 1997"
11,2,3,162,231,327,558,"6 de julio de 1997"
11,2,3,163,429,544,973,"6 de julio de 1997"
11,2,3,164,190,228,418,"6 de julio de 1997"
11,2,3,165,328,386,714,"6 de julio de 1997"
11,2,3,166,155,154,309,"6 de julio de 1997"
11,2,3,167,196,259,455,"6 de julio de 1997"
11,2,3,168,515,578,1093,"6 de julio de 1997"
11,2,3,169,538,641,1179,"6 de julio de 1997"
11,2,3,170,295,329,624,"6 de julio de 1997"
11,2,3,171,409,433,842,"6 de julio de 1997"
11,2,3,172,420,520,940,"6 de julio de 1997"
11,2,3,173,572,661,1233,"6 de julio de 1997"
11,2,3,174,417,471,888,"6 de julio de 1997"
11,2,3,175,463,534,997,"6 de julio de 1997"
11,2,3,176,227,252,479,"6 de julio de 1997"
11,2,3,177,350,388,738,"6 de julio de 1997"
11,2,3,178,110,128,238,"6 de julio de 1997"
11,2,3,179,246,289,535,"6 de julio de 1997"
11,2,3,180,357,392,749,"6 de julio de 1997"
11,2,3,181,169,204,373,"6 de julio de 1997"
11,2,3,182,185,229,414,"6 de julio de 1997"
11,2,3,183,381,417,798,"6 de julio de 1997"
11,2,3,184,270,333,603,"6 de julio de 1997"
11,2,3,185,358,476,834,"6 de julio de 1997"
11,2,3,186,235,290,525,"6 de julio de 1997"
11,2,3,187,155,223,378,"6 de julio de 1997"
11,2,3,188,396,431,827,"6 de julio de 1997"
11,2,3,189,324,309,633,"6 de julio de 1997"
11,2,3,190,353,421,774,"6 de julio de 1997"
11,2,3,191,241,289,530,"6 de julio de 1997"
11,2,3,192,195,269,464,"6 de julio de 1997"
11,2,3,193,172,205,377,"6 de julio de 1997"
11,2,3,194,407,395,802,"6 de julio de 1997"
11,2,3,195,107,153,260,"6 de julio de 1997"
11,2,3,196,68,77,145,"6 de julio de 1997"
11,2,3,197,385,472,857,"6 de julio de 1997"
11,2,3,198,155,196,351,"6 de julio de 1997"
11,2,3,199,90,122,212,"6 de julio de 1997"
11,2,3,200,302,319,621,"6 de julio de 1997"
11,2,3,201,223,237,460,"6 de julio de 1997"
11,2,3,202,287,308,595,"6 de julio de 1997"
11,2,3,203,200,215,415,"6 de julio de 1997"
11,2,3,204,196,232,428,"6 de julio de 1997"
11,2,3,205,210,213,423,"6 de julio de 1997"
11,2,3,206,265,372,637,"6 de julio de 1997"
11,2,3,207,161,218,379,"6 de julio de 1997"
11,2,3,208,251,278,529,"6 de julio de 1997"
11,2,3,209,115,102,217,"6 de julio de 1997"
11,2,3,210,203,268,471,"6 de julio de 1997"
11,2,3,211,105,116,221,"6 de julio de 1997"
11,2,3,212,165,175,340,"6 de julio de 1997"
11,2,3,213,303,299,602,"6 de julio de 1997"
11,2,3,214,282,289,571,"6 de julio de 1997"
11,2,3,215,135,144,279,"6 de julio de 1997"
11,2,3,216,378,428,806,"6 de julio de 1997"
11,2,3,217,114,135,249,"6 de julio de 1997"
11,2,3,218,337,390,727,"6 de julio de 1997"
11,2,3,219,298,377,675,"6 de julio de 1997"
11,2,3,220,233,320,553,"6 de julio de 1997"
11,2,3,221,57,70,127,"6 de julio de 1997"
11,2,3,222,260,321,581,"6 de julio de 1997"
11,2,3,223,189,207,396,"6 de julio de 1997"
11,2,3,224,256,257,513,"6 de julio de 1997"
11,2,3,225,168,213,381,"6 de julio de 1997"
11,2,3,226,280,348,628,"6 de julio de 1997"
11,2,3,227,353,393,746,"6 de julio de 1997"
11,2,3,228,91,110,201,"6 de julio de 1997"
11,2,3,229,211,300,511,"6 de julio de 1997"
11,2,3,230,163,212,375,"6 de julio de 1997"
11,2,3,231,175,182,357,"6 de julio de 1997"
11,2,3,232,66,73,139,"6 de julio de 1997"
11,2,3,233,182,190,372,"6 de julio de 1997"
11,2,3,234,66,56,122,"6 de julio de 1997"
11,2,3,235,231,241,472,"6 de julio de 1997"
11,2,3,236,239,295,534,"6 de julio de 1997"
11,2,3,237,200,226,426,"6 de julio de 1997"
11,2,3,238,205,207,412,"6 de julio de 1997"
11,2,3,239,107,114,221,"6 de julio de 1997"
11,2,3,240,97,111,208,"6 de julio de 1997"
11,2,3,241,161,158,319,"6 de julio de 1997"
11,2,3,242,180,186,366,"6 de julio de 1997"
11,2,3,243,117,119,236,"6 de julio de 1997"
11,2,6,331,224,194,418,"6 de julio de 1997"
11,2,6,332,193,169,362,"6 de julio de 1997"
11,2,6,333,313,311,624,"6 de julio de 1997"
11,2,6,334,152,155,307,"6 de julio de 1997"
11,2,6,335,285,298,583,"6 de julio de 1997"
11,2,13,740,552,629,1181,"6 de julio de 1997"
11,2,13,741,593,702,1295,"6 de julio de 1997"
11,2,13,742,348,443,791,"6 de julio de 1997"
11,2,13,743,174,186,360,"6 de julio de 1997"
11,2,13,744,221,238,459,"6 de julio de 1997"
11,2,13,745,173,179,352,"6 de julio de 1997"
11,2,13,746,229,264,493,"6 de julio de 1997"
11,2,13,747,629,736,1365,"6 de julio de 1997"
11,2,13,748,476,488,964,"6 de julio de 1997"
11,2,13,749,395,459,854,"6 de julio de 1997"
11,2,13,750,280,332,612,"6 de julio de 1997"
11,2,13,751,303,353,656,"6 de julio de 1997"
11,2,32,2505,346,411,757,"6 de julio de 1997"
11,2,32,2506,363,404,767,"6 de julio de 1997"
11,2,32,2507,526,692,1218,"6 de julio de 1997"
11,2,32,2508,517,626,1143,"6 de julio de 1997"
11,2,32,2509,249,325,574,"6 de julio de 1997"
11,2,32,2510,325,369,694,"6 de julio de 1997"
11,2,32,2511,355,502,857,"6 de julio de 1997"
11,2,32,2512,394,493,887,"6 de julio de 1997"
11,2,32,2513,379,481,860,"6 de julio de 1997"
11,2,32,2514,282,342,624,"6 de julio de 1997"
11,2,32,2515,401,459,860,"6 de julio de 1997"
11,2,32,2516,316,324,640,"6 de julio de 1997"
11,2,32,2517,171,198,369,"6 de julio de 1997"
11,2,32,2518,46,81,127,"6 de julio de 1997"
11,2,32,2519,259,283,542,"6 de julio de 1997"
11,2,32,2520,249,274,523,"6 de julio de 1997"
11,2,32,2521,220,353,573,"6 de julio de 1997"
11,2,32,2522,218,241,459,"6 de julio de 1997"
11,2,32,2523,442,470,912,"6 de julio de 1997"
11,2,32,2524,369,441,810,"6 de julio de 1997"
11,2,32,2525,240,270,510,"6 de julio de 1997"
11,2,32,2526,270,283,553,"6 de julio de 1997"
11,2,32,2527,289,277,566,"6 de julio de 1997"
11,2,32,2528,436,528,964,"6 de julio de 1997"
11,2,32,2529,323,342,665,"6 de julio de 1997"
11,2,32,2530,355,399,754,"6 de julio de 1997"
11,2,32,2531,436,481,917,"6 de julio de 1997"
11,2,32,2532,324,348,672,"6 de julio de 1997"
11,2,32,2533,217,273,490,"6 de julio de 1997"
11,2,32,2534,188,186,374,"6 de julio de 1997"
11,2,32,2535,323,449,772,"6 de julio de 1997"
11,2,32,2536,365,396,761,"6 de julio de 1997"
11,2,32,2537,268,330,598,"6 de julio de 1997"
11,2,32,2538,266,327,593,"6 de julio de 1997"
11,2,32,2539,176,162,338,"6 de julio de 1997"
11,2,32,2540,209,209,418,"6 de julio de 1997"
11,2,32,2541,270,355,625,"6 de julio de 1997"
11,2,32,2542,359,407,766,"6 de julio de 1997"
11,2,33,2543,332,462,794,"6 de julio de 1997"
11,2,33,2544,486,603,1089,"6 de julio de 1997"
11,2,33,2545,578,669,1247,"6 de julio de 1997"
11,2,33,2546,417,556,973,"6 de julio de 1997"
11,2,33,2547,301,394,695,"6 de julio de 1997"
11,2,33,2548,680,813,1493,"6 de julio de 1997"
11,2,33,2549,521,663,1184,"6 de julio de 1997"
11,2,33,2550,214,266,480,"6 de julio de 1997"
11,2,33,2551,473,576,1049,"6 de julio de 1997"
11,2,33,2552,469,605,1074,"6 de julio de 1997"
11,2,33,2553,541,741,1282,"6 de julio de 1997"
11,2,33,2554,579,676,1255,"6 de julio de 1997"
11,2,33,2555,346,424,770,"6 de julio de 1997"
11,2,33,2556,638,799,1437,"6 de julio de 1997"
11,2,33,2557,643,833,1476,"6 de julio de 1997"
11,2,33,2558,422,486,908,"6 de julio de 1997"
11,2,33,2559,381,471,852,"6 de julio de 1997"
11,2,33,2560,504,570,1074,"6 de julio de 1997"
11,2,33,2561,297,353,650,"6 de julio de 1997"
11,2,33,2562,15,21,36,"6 de julio de 1997"
11,2,33,2563,99,116,215,"6 de julio de 1997"
11,2,33,2564,98,104,202,"6 de julio de 1997"
11,2,33,2565,28,31,59,"6 de julio de 1997"
11,2,33,2566,93,105,198,"6 de julio de 1997"
11,2,33,2567,38,37,75,"6 de julio de 1997"
11,2,33,2568,84,86,170,"6 de julio de 1997"
11,2,33,2569,226,235,461,"6 de julio de 1997"
11,2,33,2570,87,80,167,"6 de julio de 1997"
11,2,33,2571,241,256,497,"6 de julio de 1997"
11,2,33,2572,268,301,569,"6 de julio de 1997"
11,2,33,2573,398,487,885,"6 de julio de 1997"
11,2,33,2574,460,505,965,"6 de julio de 1997"
11,2,33,2575,233,215,448,"6 de julio de 1997"
11,2,33,2576,138,136,274,"6 de julio de 1997"
11,2,33,2577,195,252,447,"6 de julio de 1997"
11,2,33,2578,212,312,524,"6 de julio de 1997"
11,2,33,2579,279,332,611,"6 de julio de 1997"
11,2,33,2580,90,88,178,"6 de julio de 1997"
11,2,33,2581,426,490,916,"6 de julio de 1997"
11,2,33,2582,324,458,782,"6 de julio de 1997"
11,2,33,2583,247,338,585,"6 de julio de 1997"
11,2,33,2584,459,591,1050,"6 de julio de 1997"
11,2,33,2585,272,311,583,"6 de julio de 1997"
11,2,33,2586,361,433,794,"6 de julio de 1997"
11,2,33,2587,643,719,1362,"6 de julio de 1997"
11,2,33,2588,291,309,600,"6 de julio de 1997"
11,2,33,2589,342,341,683,"6 de julio de 1997"
11,2,33,2590,417,443,860,"6 de julio de 1997"
11,2,33,2591,265,282,547,"6 de julio de 1997"
11,2,33,2592,370,406,776,"6 de julio de 1997"
11,2,33,2593,394,365,759,"6 de julio de 1997"
11,2,33,2594,219,216,435,"6 de julio de 1997"
11,2,33,2595,440,455,895,"6 de julio de 1997"
11,2,33,2596,143,164,307,"6 de julio de 1997"
11,2,33,2597,367,361,728,"6 de julio de 1997"
11,2,33,2598,571,648,1219,"6 de julio de 1997"
11,2,33,2599,410,434,844,"6 de julio de 1997"
11,2,33,2600,296,322,618,"6 de julio de 1997"
11,2,33,2601,436,432,868,"6 de julio de 1997"
11,2,33,2602,570,685,1255,"6 de julio de 1997"
11,2,34,2603,380,427,807,"6 de julio de 1997"
11,2,34,2604,377,464,841,"6 de julio de 1997"
11,2,34,2605,202,216,418,"6 de julio de 1997"
11,2,34,2606,46,56,102,"6 de julio de 1997"
11,2,34,2607,100,109,209,"6 de julio de 1997"
11,2,40,2778,599,610,1209,"6 de julio de 1997"
11,2,40,2779,371,422,793,"6 de julio de 1997"
11,2,40,2780,321,348,669,"6 de julio de 1997"
11,2,40,2781,346,414,760,"6 de julio de 1997"
11,2,40,2782,92,125,217,"6 de julio de 1997"
11,2,40,2783,376,382,758,"6 de julio de 1997"
11,2,40,2784,335,363,698,"6 de julio de 1997"
11,2,40,2785,409,472,881,"6 de julio de 1997"
11,2,40,2786,28,21,49,"6 de julio de 1997"
11,2,40,2787,156,167,323,"6 de julio de 1997"
11,2,40,2788,38,38,76,"6 de julio de 1997"
11,2,40,2789,72,79,151,"6 de julio de 1997"
11,2,43,2891,437,517,954,"6 de julio de 1997"
11,2,43,2892,457,524,981,"6 de julio de 1997"
11,2,43,2893,87,97,184,"6 de julio de 1997"
11,2,43,2894,220,247,467,"6 de julio de 1997"
11,2,43,2895,156,180,336,"6 de julio de 1997"
11,2,43,2896,91,108,199,"6 de julio de 1997"
11,2,43,2897,240,280,520,"6 de julio de 1997"
11,2,43,2898,200,224,424,"6 de julio de 1997"
11,2,43,2899,461,542,1003,"6 de julio de 1997"
11,2,43,2900,421,489,910,"6 de julio de 1997"
11,2,43,2901,217,216,433,"6 de julio de 1997"
11,2,43,2902,303,327,630,"6 de julio de 1997"
11,2,43,2903,453,508,961,"6 de julio de 1997"
11,2,43,2904,285,333,618,"6 de julio de 1997"
11,2,43,2905,273,324,597,"6 de julio de 1997"
11,2,45,2934,159,154,313,"6 de julio de 1997"
11,2,45,2935,377,408,785,"6 de julio de 1997"
11,2,45,2936,84,97,181,"6 de julio de 1997"
11,2,45,2937,130,132,262,"6 de julio de 1997"
11,2,45,2938,94,104,198,"6 de julio de 1997"
11,2,45,2939,107,104,211,"6 de julio de 1997"
11,2,45,2940,269,297,566,"6 de julio de 1997"
11,2,45,2941,148,167,315,"6 de julio de 1997"
11,2,45,2942,244,253,497,"6 de julio de 1997"
11,2,45,2943,258,252,510,"6 de julio de 1997"
11,2,45,2944,197,231,428,"6 de julio de 1997"
11,2,45,2945,192,183,375,"6 de julio de 1997"
11,2,45,2946,127,123,250,"6 de julio de 1997"
11,2,45,2947,29,22,51,"6 de julio de 1997"
11,2,45,2948,118,109,227,"6 de julio de 1997"
11,3,20,1261,562,613,1175,"6 de julio de 1997"
11,3,20,1262,338,387,725,"6 de julio de 1997"
11,3,20,1263,354,424,778,"6 de julio de 1997"
11,3,20,1264,282,290,572,"6 de julio de 1997"
11,3,20,1265,304,328,632,"6 de julio de 1997"
11,3,20,1266,515,520,1035,"6 de julio de 1997"
11,3,20,1267,319,368,687,"6 de julio de 1997"
11,3,20,1268,190,212,402,"6 de julio de 1997"
11,3,20,1269,590,646,1236,"6 de julio de 1997"
11,3,20,1270,317,346,663,"6 de julio de 1997"
11,3,20,1271,299,309,608,"6 de julio de 1997"
11,3,20,1272,396,423,819,"6 de julio de 1997"
11,3,20,1273,646,700,1346,"6 de julio de 1997"
11,3,20,1274,295,364,659,"6 de julio de 1997"
11,3,20,1275,141,141,282,"6 de julio de 1997"
11,3,20,1276,375,402,777,"6 de julio de 1997"
11,3,20,1277,427,441,868,"6 de julio de 1997"
11,3,20,1278,343,383,726,"6 de julio de 1997"
11,3,20,1279,425,468,893,"6 de julio de 1997"
11,3,20,1280,497,544,1041,"6 de julio de 1997"
11,3,20,1281,288,335,623,"6 de julio de 1997"
11,3,20,1282,526,526,1052,"6 de julio de 1997"
11,3,20,1283,191,219,410,"6 de julio de 1997"
11,3,20,1284,673,724,1397,"6 de julio de 1997"
11,3,20,1285,818,968,1786,"6 de julio de 1997"
11,3,20,1286,423,452,875,"6 de julio de 1997"
11,3,20,1287,399,417,816,"6 de julio de 1997"
11,3,20,1288,532,582,1114,"6 de julio de 1997"
11,3,20,1289,613,662,1275,"6 de julio de 1997"
11,3,20,1290,174,179,353,"6 de julio de 1997"
11,3,20,1291,170,189,359,"6 de julio de 1997"
11,3,20,1292,467,505,972,"6 de julio de 1997"
11,3,20,1293,420,465,885,"6 de julio de 1997"
11,3,20,1294,423,471,894,"6 de julio de 1997"
11,3,20,1295,349,429,778,"6 de julio de 1997"
11,3,20,1296,261,275,536,"6 de julio de 1997"
11,3,20,1297,572,590,1162,"6 de julio de 1997"
11,3,20,1298,717,780,1497,"6 de julio de 1997"
11,3,20,1299,290,323,613,"6 de julio de 1997"
11,3,20,1300,370,395,765,"6 de julio de 1997"
11,3,20,1301,406,450,856,"6 de julio de 1997"
11,3,20,1302,438,489,927,"6 de julio de 1997"
11,3,20,1303,417,428,845,"6 de julio de 1997"
11,3,20,1304,414,475,889,"6 de julio de 1997"
11,3,20,1305,374,389,763,"6 de julio de 1997"
11,3,20,1306,509,546,1055,"6 de julio de 1997"
11,3,20,1307,436,477,913,"6 de julio de 1997"
11,3,20,1308,827,908,1735,"6 de julio de 1997"
11,3,20,1309,720,739,1459,"6 de julio de 1997"
11,3,20,1310,737,833,1570,"6 de julio de 1997"
11,3,20,1311,222,261,483,"6 de julio de 1997"
11,3,20,1312,557,585,1142,"6 de julio de 1997"
11,3,20,1313,314,368,682,"6 de julio de 1997"
11,3,20,1314,426,499,925,"6 de julio de 1997"
11,3,20,1315,341,394,735,"6 de julio de 1997"
11,3,20,1316,428,453,881,"6 de julio de 1997"
11,3,20,1317,382,449,831,"6 de julio de 1997"
11,3,20,1318,279,303,582,"6 de julio de 1997"
11,3,20,1319,401,464,865,"6 de julio de 1997"
11,3,20,1320,605,591,1196,"6 de julio de 1997"
11,3,20,1321,406,441,847,"6 de julio de 1997"
11,3,20,1322,993,1134,2127,"6 de julio de 1997"
11,3,20,1323,734,772,1506,"6 de julio de 1997"
11,3,20,1324,466,518,984,"6 de julio de 1997"
11,3,20,1325,423,459,882,"6 de julio de 1997"
11,3,20,1326,419,442,861,"6 de julio de 1997"
11,3,20,1327,258,287,545,"6 de julio de 1997"
11,3,20,1328,456,511,967,"6 de julio de 1997"
11,3,20,1329,449,484,933,"6 de julio de 1997"
11,3,20,1330,626,697,1323,"6 de julio de 1997"
11,3,20,1331,308,334,642,"6 de julio de 1997"
11,3,20,1332,482,505,987,"6 de julio de 1997"
11,3,20,1333,565,633,1198,"6 de julio de 1997"
11,3,20,1334,497,518,1015,"6 de julio de 1997"
11,3,20,1335,551,553,1104,"6 de julio de 1997"
11,3,20,1336,449,488,937,"6 de julio de 1997"
11,3,20,1337,760,858,1618,"6 de julio de 1997"
11,3,20,1338,323,325,648,"6 de julio de 1997"
11,3,20,1339,601,618,1219,"6 de julio de 1997"
11,3,20,1340,724,711,1435,"6 de julio de 1997"
11,3,20,1341,712,768,1480,"6 de julio de 1997"
11,3,20,1342,682,739,1421,"6 de julio de 1997"
11,3,20,1343,372,411,783,"6 de julio de 1997"
11,3,20,1344,437,508,945,"6 de julio de 1997"
11,3,20,1345,346,380,726,"6 de julio de 1997"
11,3,20,1346,399,459,858,"6 de julio de 1997"
11,3,20,1347,506,558,1064,"6 de julio de 1997"
11,3,20,1348,543,553,1096,"6 de julio de 1997"
11,3,20,1349,948,1043,1991,"6 de julio de 1997"
11,3,20,1350,536,601,1137,"6 de julio de 1997"
11,3,20,1351,388,447,835,"6 de julio de 1997"
11,3,20,1352,575,669,1244,"6 de julio de 1997"
11,3,20,1353,562,599,1161,"6 de julio de 1997"
11,3,20,1354,644,705,1349,"6 de julio de 1997"
11,3,20,1355,629,635,1264,"6 de julio de 1997"
11,3,20,1356,748,820,1568,"6 de julio de 1997"
11,3,20,1357,538,643,1181,"6 de julio de 1997"
11,3,20,1358,539,534,1073,"6 de julio de 1997"
11,3,20,1359,502,544,1046,"6 de julio de 1997"
11,3,20,1360,506,544,1050,"6 de julio de 1997"
11,3,20,1361,399,417,816,"6 de julio de 1997"
11,3,20,1362,652,680,1332,"6 de julio de 1997"
11,3,20,1363,651,705,1356,"6 de julio de 1997"
11,3,20,1364,629,683,1312,"6 de julio de 1997"
11,3,20,1365,651,753,1404,"6 de julio de 1997"
11,3,20,1366,424,435,859,"6 de julio de 1997"
11,3,20,1367,278,313,591,"6 de julio de 1997"
11,3,20,1368,280,337,617,"6 de julio de 1997"
11,3,20,1369,618,667,1285,"6 de julio de 1997"
11,3,20,1370,675,733,1408,"6 de julio de 1997"
11,3,20,1371,267,322,589,"6 de julio de 1997"
11,3,20,1372,669,745,1414,"6 de julio de 1997"
11,3,20,1373,434,449,883,"6 de julio de 1997"
11,3,20,1374,505,548,1053,"6 de julio de 1997"
11,3,20,1375,373,383,756,"6 de julio de 1997"
11,3,20,1376,321,323,644,"6 de julio de 1997"
11,3,20,1385,728,752,1480,"6 de julio de 1997"
11,3,20,1388,559,600,1159,"6 de julio de 1997"
11,3,20,1389,446,485,931,"6 de julio de 1997"
11,3,20,1390,542,559,1101,"6 de julio de 1997"
11,3,20,1391,510,567,1077,"6 de julio de 1997"
11,3,20,1392,279,299,578,"6 de julio de 1997"
11,3,20,1393,508,542,1050,"6 de julio de 1997"
11,3,20,1412,407,499,906,"6 de julio de 1997"
11,3,20,1413,446,497,943,"6 de julio de 1997"
11,3,20,1414,633,700,1333,"6 de julio de 1997"
11,3,20,1436,371,406,777,"6 de julio de 1997"
11,3,20,1437,327,377,704,"6 de julio de 1997"
11,3,20,1438,500,544,1044,"6 de julio de 1997"
11,3,20,1439,498,583,1081,"6 de julio de 1997"
11,3,20,1450,479,531,1010,"6 de julio de 1997"
11,3,20,1451,510,597,1107,"6 de julio de 1997"
11,3,20,1452,529,575,1104,"6 de julio de 1997"
11,3,20,1453,460,454,914,"6 de julio de 1997"
11,3,20,1470,60,57,117,"6 de julio de 1997"
11,3,20,1471,56,59,115,"6 de julio de 1997"
11,3,20,1472,143,135,278,"6 de julio de 1997"
11,3,20,1473,319,326,645,"6 de julio de 1997"
11,3,20,1474,265,253,518,"6 de julio de 1997"
11,3,20,1475,151,148,299,"6 de julio de 1997"
11,3,20,1476,107,102,209,"6 de julio de 1997"
11,3,20,1477,558,625,1183,"6 de julio de 1997"
11,3,20,1478,152,161,313,"6 de julio de 1997"
11,3,20,1479,266,252,518,"6 de julio de 1997"
11,3,20,1480,415,457,872,"6 de julio de 1997"
11,3,20,1481,240,274,514,"6 de julio de 1997"
11,3,20,1482,169,193,362,"6 de julio de 1997"
11,3,20,1485,229,268,497,"6 de julio de 1997"
11,3,20,1486,257,291,548,"6 de julio de 1997"
11,3,20,1487,407,444,851,"6 de julio de 1997"
11,3,20,1488,89,88,177,"6 de julio de 1997"
11,3,20,1489,367,415,782,"6 de julio de 1997"
11,3,20,1495,644,643,1287,"6 de julio de 1997"
11,3,20,1496,476,467,943,"6 de julio de 1997"
11,3,20,1497,333,368,701,"6 de julio de 1997"
11,3,20,1498,389,435,824,"6 de julio de 1997"
11,3,20,1499,308,353,661,"6 de julio de 1997"
11,3,20,1500,847,1026,1873,"6 de julio de 1997"
11,3,20,1503,157,160,317,"6 de julio de 1997"
11,3,20,1504,633,836,1469,"6 de julio de 1997"
11,3,20,1505,329,448,777,"6 de julio de 1997"
11,3,20,1506,497,715,1212,"6 de julio de 1997"
11,3,20,1508,373,417,790,"6 de julio de 1997"
11,3,20,1509,478,507,985,"6 de julio de 1997"
11,3,20,1674,410,473,883,"6 de julio de 1997"
11,3,20,1675,361,426,787,"6 de julio de 1997"
11,3,20,1676,483,532,1015,"6 de julio de 1997"
11,3,20,1677,473,506,979,"6 de julio de 1997"
11,3,20,1678,386,396,782,"6 de julio de 1997"
11,3,20,1679,458,506,964,"6 de julio de 1997"
11,3,20,1680,341,361,702,"6 de julio de 1997"
11,3,20,1681,700,739,1439,"6 de julio de 1997"
11,3,20,1682,302,346,648,"6 de julio de 1997"
11,3,20,1683,401,479,880,"6 de julio de 1997"
11,3,20,1684,500,536,1036,"6 de julio de 1997"
11,3,20,1685,224,252,476,"6 de julio de 1997"
11,3,20,1686,436,485,921,"6 de julio de 1997"
11,3,20,1687,438,510,948,"6 de julio de 1997"
11,3,20,1688,290,332,622,"6 de julio de 1997"
11,3,20,1689,480,459,939,"6 de julio de 1997"
11,3,20,1690,357,371,728,"6 de julio de 1997"
11,3,20,1691,525,565,1090,"6 de julio de 1997"
11,3,20,1692,445,488,933,"6 de julio de 1997"
11,3,20,1693,355,394,749,"6 de julio de 1997"
11,3,20,1694,521,552,1073,"6 de julio de 1997"
11,3,20,1695,347,400,747,"6 de julio de 1997"
11,3,20,1696,553,600,1153,"6 de julio de 1997"
11,3,20,1697,541,614,1155,"6 de julio de 1997"
11,3,20,1698,488,565,1053,"6 de julio de 1997"
11,3,20,1699,362,396,758,"6 de julio de 1997"
11,3,20,1700,681,773,1454,"6 de julio de 1997"
11,3,20,1701,380,400,780,"6 de julio de 1997"
11,3,20,1702,447,483,930,"6 de julio de 1997"
11,3,20,1703,172,189,361,"6 de julio de 1997"
11,3,20,1704,545,596,1141,"6 de julio de 1997"
11,3,20,1705,572,635,1207,"6 de julio de 1997"
11,3,20,1706,471,537,1008,"6 de julio de 1997"
11,3,20,1707,293,324,617,"6 de julio de 1997"
11,3,20,1708,579,632,1211,"6 de julio de 1997"
11,3,20,1709,698,705,1403,"6 de julio de 1997"
11,3,20,1710,413,501,914,"6 de julio de 1997"
11,3,20,1711,269,269,538,"6 de julio de 1997"
11,3,20,1712,206,261,467,"6 de julio de 1997"
11,3,20,1713,506,564,1070,"6 de julio de 1997"
11,3,20,1714,491,568,1059,"6 de julio de 1997"
11,3,20,1715,461,509,970,"6 de julio de 1997"
11,3,20,1716,316,383,699,"6 de julio de 1997"
11,3,20,1717,439,499,938,"6 de julio de 1997"
11,3,20,1718,561,640,1201,"6 de julio de 1997"
11,3,20,1719,643,725,1368,"6 de julio de 1997"
11,3,20,1720,513,552,1065,"6 de julio de 1997"
11,3,20,1727,607,695,1302,"6 de julio de 1997"
11,3,20,1730,435,479,914,"6 de julio de 1997"
11,3,20,1743,262,339,601,"6 de julio de 1997"
11,4,15,823,412,490,902,"6 de julio de 1997"
11,4,15,824,467,525,992,"6 de julio de 1997"
11,4,15,825,310,339,649,"6 de julio de 1997"
11,4,15,826,414,459,873,"6 de julio de 1997"
11,4,15,827,474,494,968,"6 de julio de 1997"
11,4,15,828,544,533,1077,"6 de julio de 1997"
11,4,15,829,301,350,651,"6 de julio de 1997"
11,4,15,830,332,373,705,"6 de julio de 1997"
11,4,15,831,428,458,886,"6 de julio de 1997"
11,4,15,832,592,643,1235,"6 de julio de 1997"
11,4,15,833,401,488,889,"6 de julio de 1997"
11,4,15,834,642,740,1382,"6 de julio de 1997"
11,4,15,835,669,695,1364,"6 de julio de 1997"
11,4,15,836,446,560,1006,"6 de julio de 1997"
11,4,15,837,474,541,1015,"6 de julio de 1997"
11,4,15,838,426,442,868,"6 de julio de 1997"
11,4,15,839,284,327,611,"6 de julio de 1997"
11,4,15,840,132,163,295,"6 de julio de 1997"
11,4,15,841,365,430,795,"6 de julio de 1997"
11,4,15,842,386,443,829,"6 de julio de 1997"
11,4,15,843,358,377,735,"6 de julio de 1997"
11,4,15,844,406,442,848,"6 de julio de 1997"
11,4,15,845,494,592,1086,"6 de julio de 1997"
11,4,15,846,359,409,768,"6 de julio de 1997"
11,4,15,847,359,380,739,"6 de julio de 1997"
11,4,15,848,212,292,504,"6 de julio de 1997"
11,4,15,849,157,194,351,"6 de julio de 1997"
11,4,15,850,433,492,925,"6 de julio de 1997"
11,4,15,851,458,551,1009,"6 de julio de 1997"
11,4,15,852,440,556,996,"6 de julio de 1997"
11,4,15,853,669,763,1432,"6 de julio de 1997"
11,4,15,854,677,776,1453,"6 de julio de 1997"
11,4,15,855,514,589,1103,"6 de julio de 1997"
11,4,15,856,249,306,555,"6 de julio de 1997"
11,4,15,857,523,523,1046,"6 de julio de 1997"
11,4,15,858,417,469,886,"6 de julio de 1997"
11,4,15,859,240,287,527,"6 de julio de 1997"
11,4,15,860,266,317,583,"6 de julio de 1997"
11,4,15,861,453,557,1010,"6 de julio de 1997"
11,4,15,862,435,551,986,"6 de julio de 1997"
11,4,15,863,258,309,567,"6 de julio de 1997"
11,4,15,864,330,369,699,"6 de julio de 1997"
11,4,15,865,442,461,903,"6 de julio de 1997"
11,4,15,866,509,614,1123,"6 de julio de 1997"
11,4,15,867,509,615,1124,"6 de julio de 1997"
11,4,15,868,278,316,594,"6 de julio de 1997"
11,4,15,869,302,368,670,"6 de julio de 1997"
11,4,15,870,387,415,802,"6 de julio de 1997"
11,4,15,871,224,236,460,"6 de julio de 1997"
11,4,15,872,457,544,1001,"6 de julio de 1997"
11,4,15,873,742,838,1580,"6 de julio de 1997"
11,4,15,874,244,273,517,"6 de julio de 1997"
11,4,15,875,521,606,1127,"6 de julio de 1997"
11,4,15,876,519,552,1071,"6 de julio de 1997"
11,4,15,877,364,437,801,"6 de julio de 1997"
11,4,15,878,637,715,1352,"6 de julio de 1997"
11,4,15,879,51,45,96,"6 de julio de 1997"
11,4,15,880,157,130,287,"6 de julio de 1997"
11,4,15,881,228,282,510,"6 de julio de 1997"
11,4,15,882,134,177,311,"6 de julio de 1997"
11,4,15,883,215,170,385,"6 de julio de 1997"
11,4,15,884,80,87,167,"6 de julio de 1997"
11,4,15,885,295,398,693,"6 de julio de 1997"
11,4,15,886,120,193,313,"6 de julio de 1997"
11,4,15,887,254,343,597,"6 de julio de 1997"
11,4,15,888,349,395,744,"6 de julio de 1997"
11,4,15,889,366,386,752,"6 de julio de 1997"
11,4,15,890,346,326,672,"6 de julio de 1997"
11,4,15,891,92,85,177,"6 de julio de 1997"
11,4,15,892,44,57,101,"6 de julio de 1997"
11,4,15,893,225,240,465,"6 de julio de 1997"
11,4,15,894,357,371,728,"6 de julio de 1997"
11,4,15,895,244,255,499,"6 de julio de 1997"
11,4,15,896,531,559,1090,"6 de julio de 1997"
11,4,15,897,383,412,795,"6 de julio de 1997"
11,4,15,898,419,447,866,"6 de julio de 1997"
11,4,15,899,522,576,1098,"6 de julio de 1997"
11,4,15,900,231,233,464,"6 de julio de 1997"
11,4,15,901,293,316,609,"6 de julio de 1997"
11,4,15,902,463,497,960,"6 de julio de 1997"
11,4,15,903,367,376,743,"6 de julio de 1997"
11,4,15,904,340,330,670,"6 de julio de 1997"
11,4,15,905,367,356,723,"6 de julio de 1997"
11,4,15,906,202,189,391,"6 de julio de 1997"
11,4,15,907,278,286,564,"6 de julio de 1997"
11,4,15,908,469,480,949,"6 de julio de 1997"
11,4,15,909,473,510,983,"6 de julio de 1997"
11,4,15,910,402,504,906,"6 de julio de 1997"
11,4,15,911,289,272,561,"6 de julio de 1997"
11,4,15,912,518,569,1087,"6 de julio de 1997"
11,4,15,913,227,239,466,"6 de julio de 1997"
11,4,15,914,507,495,1002,"6 de julio de 1997"
11,4,15,915,510,603,1113,"6 de julio de 1997"
11,4,37,2654,602,617,1219,"6 de julio de 1997"
11,4,37,2655,530,584,1114,"6 de julio de 1997"
11,4,37,2656,264,285,549,"6 de julio de 1997"
11,4,37,2657,532,579,1111,"6 de julio de 1997"
11,4,37,2658,512,550,1062,"6 de julio de 1997"
11,4,37,2659,441,516,957,"6 de julio de 1997"
11,4,37,2660,603,613,1216,"6 de julio de 1997"
11,4,37,2661,395,456,851,"6 de julio de 1997"
11,4,37,2662,541,611,1152,"6 de julio de 1997"
11,4,37,2663,609,722,1331,"6 de julio de 1997"
11,4,37,2664,636,618,1254,"6 de julio de 1997"
11,4,37,2665,339,365,704,"6 de julio de 1997"
11,4,37,2666,516,604,1120,"6 de julio de 1997"
11,4,37,2667,307,395,702,"6 de julio de 1997"
11,4,37,2668,492,544,1036,"6 de julio de 1997"
11,4,37,2669,619,678,1297,"6 de julio de 1997"
11,4,37,2670,552,589,1141,"6 de julio de 1997"
11,4,37,2671,373,368,741,"6 de julio de 1997"
11,4,37,2672,215,217,432,"6 de julio de 1997"
11,4,37,2673,510,576,1086,"6 de julio de 1997"
11,4,37,2674,281,310,591,"6 de julio de 1997"
11,4,37,2675,499,573,1072,"6 de julio de 1997"
11,4,37,2676,533,558,1091,"6 de julio de 1997"
11,4,37,2677,291,292,583,"6 de julio de 1997"
11,4,37,2678,453,470,923,"6 de julio de 1997"
11,4,37,2679,433,486,919,"6 de julio de 1997"
11,4,37,2680,420,498,918,"6 de julio de 1997"
11,4,37,2681,663,730,1393,"6 de julio de 1997"
11,4,37,2682,743,817,1560,"6 de julio de 1997"
11,4,37,2683,732,806,1538,"6 de julio de 1997"
11,4,37,2684,641,642,1283,"6 de julio de 1997"
11,4,37,2685,508,526,1034,"6 de julio de 1997"
11,4,37,2686,268,311,579,"6 de julio de 1997"
11,4,37,2687,479,507,986,"6 de julio de 1997"
11,4,37,2688,315,329,644,"6 de julio de 1997"
11,4,37,2689,375,458,833,"6 de julio de 1997"
11,4,37,2690,604,668,1272,"6 de julio de 1997"
11,4,37,2691,312,304,616,"6 de julio de 1997"
11,4,37,2692,558,672,1230,"6 de julio de 1997"
11,4,37,2693,317,355,672,"6 de julio de 1997"
11,4,37,2694,680,693,1373,"6 de julio de 1997"
11,4,37,2695,365,390,755,"6 de julio de 1997"
11,4,37,2696,290,326,616,"6 de julio de 1997"
11,4,37,2697,159,169,328,"6 de julio de 1997"
11,4,37,2698,321,335,656,"6 de julio de 1997"
11,4,37,2699,461,532,993,"6 de julio de 1997"
11,4,37,2700,750,744,1494,"6 de julio de 1997"
11,4,37,2701,221,243,464,"6 de julio de 1997"
11,4,37,2702,311,384,695,"6 de julio de 1997"
11,4,37,2703,483,533,1016,"6 de julio de 1997"
11,4,37,2704,472,490,962,"6 de julio de 1997"
11,4,37,2705,507,562,1069,"6 de julio de 1997"
11,4,37,2706,296,338,634,"6 de julio de 1997"
11,4,37,2707,234,230,464,"6 de julio de 1997"
11,4,37,2708,117,119,236,"6 de julio de 1997"
11,4,37,2709,648,699,1347,"6 de julio de 1997"
11,4,37,2710,272,275,547,"6 de julio de 1997"
11,4,37,2711,206,210,416,"6 de julio de 1997"
11,4,37,2712,642,630,1272,"6 de julio de 1997"
11,4,37,2713,194,201,395,"6 de julio de 1997"
11,4,37,2714,367,378,745,"6 de julio de 1997"
11,4,37,2715,142,158,300,"6 de julio de 1997"
11,4,37,2716,282,303,585,"6 de julio de 1997"
11,4,37,2717,704,740,1444,"6 de julio de 1997"
11,4,37,2718,349,375,724,"6 de julio de 1997"
11,4,37,2719,539,627,1166,"6 de julio de 1997"
11,4,37,2720,679,652,1331,"6 de julio de 1997"
11,4,37,2721,377,400,777,"6 de julio de 1997"
11,4,37,2722,266,290,556,"6 de julio de 1997"
11,4,37,2723,172,189,361,"6 de julio de 1997"
11,4,37,2724,356,386,742,"6 de julio de 1997"
11,4,37,2725,713,761,1474,"6 de julio de 1997"
11,4,37,2726,486,490,976,"6 de julio de 1997"
11,4,37,2727,485,507,992,"6 de julio de 1997"
11,4,37,2728,375,374,749,"6 de julio de 1997"
11,4,37,2729,136,161,297,"6 de julio de 1997"
11,4,37,2730,502,711,1213,"6 de julio de 1997"
11,4,37,2731,149,163,312,"6 de julio de 1997"
11,5,20,1399,201,252,453,"6 de julio de 1997"
11,5,20,1400,343,439,782,"6 de julio de 1997"
11,5,20,1401,229,285,514,"6 de julio de 1997"
11,5,20,1423,161,227,388,"6 de julio de 1997"
11,5,20,1424,277,363,640,"6 de julio de 1997"
11,5,20,1425,253,329,582,"6 de julio de 1997"
11,5,20,1426,253,294,547,"6 de julio de 1997"
11,5,20,1457,162,205,367,"6 de julio de 1997"
11,5,20,1458,198,222,420,"6 de julio de 1997"
11,5,20,1459,284,378,662,"6 de julio de 1997"
11,5,20,1463,326,406,732,"6 de julio de 1997"
11,5,20,1464,215,243,458,"6 de julio de 1997"
11,5,20,1465,470,519,989,"6 de julio de 1997"
11,5,20,1466,271,307,578,"6 de julio de 1997"
11,5,20,1467,279,309,588,"6 de julio de 1997"
11,5,20,1468,518,555,1073,"6 de julio de 1997"
11,5,20,1469,285,292,577,"6 de julio de 1997"
11,5,20,1483,284,288,572,"6 de julio de 1997"
11,5,20,1484,41,42,83,"6 de julio de 1997"
11,5,20,1490,184,226,410,"6 de julio de 1997"
11,5,20,1491,472,503,975,"6 de julio de 1997"
11,5,20,1492,310,347,657,"6 de julio de 1997"
11,5,20,1493,287,335,622,"6 de julio de 1997"
11,5,20,1494,925,1081,2006,"6 de julio de 1997"
11,5,20,1501,453,501,954,"6 de julio de 1997"
11,5,20,1502,399,428,827,"6 de julio de 1997"
11,5,20,1507,193,218,411,"6 de julio de 1997"
11,5,20,1511,230,250,480,"6 de julio de 1997"
11,5,20,1522,423,529,952,"6 de julio de 1997"
11,5,20,1542,251,286,537,"6 de julio de 1997"
11,5,20,1543,441,508,949,"6 de julio de 1997"
11,5,20,1544,268,351,619,"6 de julio de 1997"
11,5,20,1545,384,476,860,"6 de julio de 1997"
11,5,20,1546,549,601,1150,"6 de julio de 1997"
11,5,20,1547,725,829,1554,"6 de julio de 1997"
11,5,20,1548,507,635,1142,"6 de julio de 1997"
11,5,20,1549,305,378,683,"6 de julio de 1997"
11,5,20,1550,344,369,713,"6 de julio de 1997"
11,5,20,1551,295,346,641,"6 de julio de 1997"
11,5,20,1573,281,321,602,"6 de julio de 1997"
11,5,20,1574,589,677,1266,"6 de julio de 1997"
11,5,20,1575,468,517,985,"6 de julio de 1997"
11,5,20,1576,351,371,722,"6 de julio de 1997"
11,5,20,1577,528,623,1151,"6 de julio de 1997"
11,5,20,1597,312,374,686,"6 de julio de 1997"
11,5,20,1599,356,406,762,"6 de julio de 1997"
11,5,20,1600,637,683,1320,"6 de julio de 1997"
11,5,20,1601,640,712,1352,"6 de julio de 1997"
11,5,20,1602,304,386,690,"6 de julio de 1997"
11,5,20,1603,518,519,1037,"6 de julio de 1997"
11,5,20,1604,709,783,1492,"6 de julio de 1997"
11,5,20,1605,262,280,542,"6 de julio de 1997"
11,5,20,1626,624,747,1371,"6 de julio de 1997"
11,5,20,1627,714,765,1479,"6 de julio de 1997"
11,5,20,1640,437,502,939,"6 de julio de 1997"
11,5,20,1648,180,190,370,"6 de julio de 1997"
11,5,20,1649,559,588,1147,"6 de julio de 1997"
11,5,20,1650,540,626,1166,"6 de julio de 1997"
11,5,20,1656,241,279,520,"6 de julio de 1997"
11,5,20,1657,406,498,904,"6 de julio de 1997"
11,5,20,1658,753,790,1543,"6 de julio de 1997"
11,5,20,1663,457,481,938,"6 de julio de 1997"
11,5,20,1721,404,435,839,"6 de julio de 1997"
11,5,20,1722,620,613,1233,"6 de julio de 1997"
11,5,20,1723,382,419,801,"6 de julio de 1997"
11,5,20,1724,424,458,882,"6 de julio de 1997"
11,5,20,1725,214,225,439,"6 de julio de 1997"
11,5,20,1726,424,466,890,"6 de julio de 1997"
11,5,20,1728,284,365,649,"6 de julio de 1997"
11,5,20,1729,444,496,940,"6 de julio de 1997"
11,5,20,1731,650,670,1320,"6 de julio de 1997"
11,5,20,1732,674,725,1399,"6 de julio de 1997"
11,5,20,1733,724,757,1481,"6 de julio de 1997"
11,5,20,1734,554,605,1159,"6 de julio de 1997"
11,5,20,1735,447,495,942,"6 de julio de 1997"
11,5,20,1736,388,407,795,"6 de julio de 1997"
11,5,20,1737,485,549,1034,"6 de julio de 1997"
11,5,20,1738,340,382,722,"6 de julio de 1997"
11,5,20,1739,533,589,1122,"6 de julio de 1997"
11,5,20,1740,498,550,1048,"6 de julio de 1997"
11,5,20,1741,807,879,1686,"6 de julio de 1997"
11,5,20,1742,525,592,1117,"6 de julio de 1997"
11,5,20,1744,392,455,847,"6 de julio de 1997"
11,5,20,1745,625,673,1298,"6 de julio de 1997"
11,5,20,1746,459,499,958,"6 de julio de 1997"
11,5,20,1747,817,894,1711,"6 de julio de 1997"
11,5,20,1748,609,655,1264,"6 de julio de 1997"
11,5,20,1749,536,585,1121,"6 de julio de 1997"
11,5,20,1750,313,347,660,"6 de julio de 1997"
11,5,20,1751,487,509,996,"6 de julio de 1997"
11,5,20,1752,473,559,1032,"6 de julio de 1997"
11,5,20,1753,689,758,1447,"6 de julio de 1997"
11,5,20,1754,620,715,1335,"6 de julio de 1997"
11,5,20,1755,396,505,901,"6 de julio de 1997"
11,5,20,1756,356,411,767,"6 de julio de 1997"
11,5,20,1757,219,241,460,"6 de julio de 1997"
11,5,20,1758,390,517,907,"6 de julio de 1997"
11,5,20,1759,579,675,1254,"6 de julio de 1997"
11,5,20,1760,630,711,1341,"6 de julio de 1997"
11,5,20,1761,393,461,854,"6 de julio de 1997"
11,5,20,1762,367,428,795,"6 de julio de 1997"
11,5,20,1763,374,430,804,"6 de julio de 1997"
11,5,20,1764,494,574,1068,"6 de julio de 1997"
11,5,20,1765,592,618,1210,"6 de julio de 1997"
11,5,20,1766,589,639,1228,"6 de julio de 1997"
11,5,20,1767,632,647,1279,"6 de julio de 1997"
11,5,20,1768,470,494,964,"6 de julio de 1997"
11,5,20,1769,505,546,1051,"6 de julio de 1997"
11,5,20,1770,675,761,1436,"6 de julio de 1997"
11,5,20,1771,485,530,1015,"6 de julio de 1997"
11,5,20,1772,380,425,805,"6 de julio de 1997"
11,5,20,1773,445,495,940,"6 de julio de 1997"
11,5,20,1774,498,569,1067,"6 de julio de 1997"
11,5,20,1775,563,619,1182,"6 de julio de 1997"
11,5,20,1776,320,372,692,"6 de julio de 1997"
11,5,20,1777,320,374,694,"6 de julio de 1997"
11,5,20,1778,310,394,704,"6 de julio de 1997"
11,5,20,1779,504,561,1065,"6 de julio de 1997"
11,5,20,1780,625,630,1255,"6 de julio de 1997"
11,5,20,1781,506,553,1059,"6 de julio de 1997"
11,5,20,1782,585,617,1202,"6 de julio de 1997"
11,5,20,1783,452,508,960,"6 de julio de 1997"
11,5,20,1784,496,577,1073,"6 de julio de 1997"
11,5,20,1785,541,627,1168,"6 de julio de 1997"
11,5,20,1786,591,662,1253,"6 de julio de 1997"
11,5,20,1787,733,798,1531,"6 de julio de 1997"
11,5,20,1788,251,311,562,"6 de julio de 1997"
11,5,20,1789,476,527,1003,"6 de julio de 1997"
11,5,20,1790,484,544,1028,"6 de julio de 1997"
11,5,20,1791,522,608,1130,"6 de julio de 1997"
11,5,20,1792,661,694,1355,"6 de julio de 1997"
11,5,20,1793,516,576,1092,"6 de julio de 1997"
11,5,20,1794,1024,1118,2142,"6 de julio de 1997"
11,5,20,1795,526,571,1097,"6 de julio de 1997"
11,5,20,1796,536,610,1146,"6 de julio de 1997"
11,5,20,1797,471,520,991,"6 de julio de 1997"
11,5,20,1798,319,389,708,"6 de julio de 1997"
11,5,20,1799,256,315,571,"6 de julio de 1997"
11,5,20,1800,450,541,991,"6 de julio de 1997"
11,5,20,1801,431,450,881,"6 de julio de 1997"
11,5,20,1802,385,420,805,"6 de julio de 1997"
11,5,20,1803,728,797,1525,"6 de julio de 1997"
11,5,20,1804,331,335,666,"6 de julio de 1997"
11,5,20,1805,365,471,836,"6 de julio de 1997"
11,5,20,1806,360,466,826,"6 de julio de 1997"
11,5,20,1807,411,381,792,"6 de julio de 1997"
11,5,20,1808,214,234,448,"6 de julio de 1997"
11,5,20,1809,546,616,1162,"6 de julio de 1997"
11,5,20,1810,538,567,1105,"6 de julio de 1997"
11,5,20,1811,362,413,775,"6 de julio de 1997"
11,5,20,1812,303,337,640,"6 de julio de 1997"
11,5,20,1813,457,514,971,"6 de julio de 1997"
11,5,20,1814,406,450,856,"6 de julio de 1997"
11,5,20,1815,223,289,512,"6 de julio de 1997"
11,5,20,1816,467,503,970,"6 de julio de 1997"
11,5,20,1817,601,659,1260,"6 de julio de 1997"
11,5,20,1818,525,600,1125,"6 de julio de 1997"
11,5,20,1819,224,279,503,"6 de julio de 1997"
11,5,20,1820,289,317,606,"6 de julio de 1997"
11,5,20,1821,357,437,794,"6 de julio de 1997"
11,5,20,1822,2643,2978,5621,"6 de julio de 1997"
11,5,20,1823,518,520,1038,"6 de julio de 1997"
11,5,20,1824,556,604,1160,"6 de julio de 1997"
11,5,20,1825,444,497,941,"6 de julio de 1997"
11,5,20,1826,684,768,1452,"6 de julio de 1997"
11,5,20,1827,580,599,1179,"6 de julio de 1997"
11,5,20,1828,582,610,1192,"6 de julio de 1997"
11,5,20,1829,508,610,1118,"6 de julio de 1997"
11,5,20,1830,425,480,905,"6 de julio de 1997"
11,5,20,1831,558,641,1199,"6 de julio de 1997"
11,5,20,1832,543,604,1147,"6 de julio de 1997"
11,5,20,1833,496,538,1034,"6 de julio de 1997"
11,5,20,1834,530,612,1142,"6 de julio de 1997"
11,5,20,1835,617,624,1241,"6 de julio de 1997"
11,5,20,1836,560,578,1138,"6 de julio de 1997"
11,5,20,1837,614,710,1324,"6 de julio de 1997"
11,5,20,1838,349,396,745,"6 de julio de 1997"
11,5,20,1839,537,609,1146,"6 de julio de 1997"
11,5,20,1840,555,672,1227,"6 de julio de 1997"
11,5,20,1841,696,725,1421,"6 de julio de 1997"
11,5,20,1842,660,797,1457,"6 de julio de 1997"
11,5,20,1843,376,437,813,"6 de julio de 1997"
11,5,20,1844,417,485,902,"6 de julio de 1997"
11,5,20,1845,556,638,1194,"6 de julio de 1997"
11,5,20,1846,444,505,949,"6 de julio de 1997"
11,5,20,1847,369,388,757,"6 de julio de 1997"
11,5,20,1848,542,605,1147,"6 de julio de 1997"
11,5,20,1849,580,629,1209,"6 de julio de 1997"
11,5,20,1850,489,563,1052,"6 de julio de 1997"
11,5,20,1851,610,689,1299,"6 de julio de 1997"
11,5,20,1852,473,539,1012,"6 de julio de 1997"
11,5,20,1853,475,497,972,"6 de julio de 1997"
11,5,20,1854,474,496,970,"6 de julio de 1997"
11,5,20,1855,529,574,1103,"6 de julio de 1997"
11,5,20,1856,700,780,1480,"6 de julio de 1997"
11,5,20,1857,502,581,1083,"6 de julio de 1997"
11,5,20,1858,698,731,1429,"6 de julio de 1997"
11,6,20,1377,348,385,733,"6 de julio de 1997"
11,6,20,1378,380,442,822,"6 de julio de 1997"
11,6,20,1379,499,531,1030,"6 de julio de 1997"
11,6,20,1380,205,199,404,"6 de julio de 1997"
11,6,20,1381,235,263,498,"6 de julio de 1997"
11,6,20,1382,510,578,1088,"6 de julio de 1997"
11,6,20,1383,286,342,628,"6 de julio de 1997"
11,6,20,1384,363,405,768,"6 de julio de 1997"
11,6,20,1386,526,578,1104,"6 de julio de 1997"
11,6,20,1387,438,497,935,"6 de julio de 1997"
11,6,20,1394,430,464,894,"6 de julio de 1997"
11,6,20,1395,587,633,1220,"6 de julio de 1997"
11,6,20,1396,734,781,1515,"6 de julio de 1997"
11,6,20,1397,666,686,1352,"6 de julio de 1997"
11,6,20,1398,548,646,1194,"6 de julio de 1997"
11,6,20,1402,207,275,482,"6 de julio de 1997"
11,6,20,1403,226,263,489,"6 de julio de 1997"
11,6,20,1404,377,441,818,"6 de julio de 1997"
11,6,20,1405,392,413,805,"6 de julio de 1997"
11,6,20,1406,233,291,524,"6 de julio de 1997"
11,6,20,1407,404,494,898,"6 de julio de 1997"
11,6,20,1408,537,582,1119,"6 de julio de 1997"
11,6,20,1409,572,602,1174,"6 de julio de 1997"
11,6,20,1410,488,535,1023,"6 de julio de 1997"
11,6,20,1411,452,484,936,"6 de julio de 1997"
11,6,20,1415,508,563,1071,"6 de julio de 1997"
11,6,20,1416,571,628,1199,"6 de julio de 1997"
11,6,20,1417,514,535,1049,"6 de julio de 1997"
11,6,20,1418,438,538,976,"6 de julio de 1997"
11,6,20,1419,231,261,492,"6 de julio de 1997"
11,6,20,1420,326,429,755,"6 de julio de 1997"
11,6,20,1421,327,421,748,"6 de julio de 1997"
11,6,20,1422,242,277,519,"6 de julio de 1997"
11,6,20,1427,224,307,531,"6 de julio de 1997"
11,6,20,1428,329,416,745,"6 de julio de 1997"
11,6,20,1429,258,322,580,"6 de julio de 1997"
11,6,20,1430,364,428,792,"6 de julio de 1997"
11,6,20,1431,217,300,517,"6 de julio de 1997"
11,6,20,1432,354,380,734,"6 de julio de 1997"
11,6,20,1433,358,422,780,"6 de julio de 1997"
11,6,20,1434,322,354,676,"6 de julio de 1997"
11,6,20,1435,334,390,724,"6 de julio de 1997"
11,6,20,1440,402,469,871,"6 de julio de 1997"
11,6,20,1441,255,246,501,"6 de julio de 1997"
11,6,20,1442,312,310,622,"6 de julio de 1997"
11,6,20,1443,258,284,542,"6 de julio de 1997"
11,6,20,1444,225,276,501,"6 de julio de 1997"
11,6,20,1445,131,196,327,"6 de julio de 1997"
11,6,20,1446,277,369,646,"6 de julio de 1997"
11,6,20,1447,331,319,650,"6 de julio de 1997"
11,6,20,1448,270,301,571,"6 de julio de 1997"
11,6,20,1449,281,340,621,"6 de julio de 1997"
11,6,20,1454,201,245,446,"6 de julio de 1997"
11,6,20,1455,245,291,536,"6 de julio de 1997"
11,6,20,1456,285,405,690,"6 de julio de 1997"
11,6,20,1460,356,472,828,"6 de julio de 1997"
11,6,20,1461,482,530,1012,"6 de julio de 1997"
11,6,20,1462,229,280,509,"6 de julio de 1997"
11,6,20,1510,538,619,1157,"6 de julio de 1997"
11,6,20,1512,330,353,683,"6 de julio de 1997"
11,6,20,1513,191,192,383,"6 de julio de 1997"
11,6,20,1514,314,322,636,"6 de julio de 1997"
11,6,20,1515,360,422,782,"6 de julio de 1997"
11,6,20,1516,431,568,999,"6 de julio de 1997"
11,6,20,1517,466,558,1024,"6 de julio de 1997"
11,6,20,1518,668,757,1425,"6 de julio de 1997"
11,6,20,1519,433,543,976,"6 de julio de 1997"
11,6,20,1520,242,268,510,"6 de julio de 1997"
11,6,20,1521,289,333,622,"6 de julio de 1997"
11,6,20,1523,398,431,829,"6 de julio de 1997"
11,6,20,1524,317,348,665,"6 de julio de 1997"
11,6,20,1525,447,502,949,"6 de julio de 1997"
11,6,20,1526,523,633,1156,"6 de julio de 1997"
11,6,20,1527,312,342,654,"6 de julio de 1997"
11,6,20,1528,302,370,672,"6 de julio de 1997"
11,6,20,1529,464,502,966,"6 de julio de 1997"
11,6,20,1530,476,597,1073,"6 de julio de 1997"
11,6,20,1531,541,606,1147,"6 de julio de 1997"
11,6,20,1532,571,656,1227,"6 de julio de 1997"
11,6,20,1533,519,592,1111,"6 de julio de 1997"
11,6,20,1534,430,441,871,"6 de julio de 1997"
11,6,20,1535,377,422,799,"6 de julio de 1997"
11,6,20,1536,314,374,688,"6 de julio de 1997"
11,6,20,1537,644,717,1361,"6 de julio de 1997"
11,6,20,1538,705,781,1486,"6 de julio de 1997"
11,6,20,1539,548,610,1158,"6 de julio de 1997"
11,6,20,1540,404,455,859,"6 de julio de 1997"
11,6,20,1541,268,343,611,"6 de julio de 1997"
11,6,20,1552,614,674,1288,"6 de julio de 1997"
11,6,20,1553,655,710,1365,"6 de julio de 1997"
11,6,20,1554,791,855,1646,"6 de julio de 1997"
11,6,20,1555,733,772,1505,"6 de julio de 1997"
11,6,20,1556,677,676,1353,"6 de julio de 1997"
11,6,20,1557,640,675,1315,"6 de julio de 1997"
11,6,20,1558,579,625,1204,"6 de julio de 1997"
11,6,20,1559,494,530,1024,"6 de julio de 1997"
11,6,20,1560,528,554,1082,"6 de julio de 1997"
11,6,20,1561,661,734,1395,"6 de julio de 1997"
11,6,20,1562,402,464,866,"6 de julio de 1997"
11,6,20,1563,323,332,655,"6 de julio de 1997"
11,6,20,1564,263,295,558,"6 de julio de 1997"
11,6,20,1565,340,386,726,"6 de julio de 1997"
11,6,20,1566,598,600,1198,"6 de julio de 1997"
11,6,20,1567,524,616,1140,"6 de julio de 1997"
11,6,20,1568,462,495,957,"6 de julio de 1997"
11,6,20,1569,689,709,1398,"6 de julio de 1997"
11,6,20,1570,406,438,844,"6 de julio de 1997"
11,6,20,1571,357,372,729,"6 de julio de 1997"
11,6,20,1572,344,355,699,"6 de julio de 1997"
11,6,20,1578,329,341,670,"6 de julio de 1997"
11,6,20,1579,324,351,675,"6 de julio de 1997"
11,6,20,1580,301,327,628,"6 de julio de 1997"
11,6,20,1581,538,552,1090,"6 de julio de 1997"
11,6,20,1582,225,269,494,"6 de julio de 1997"
11,6,20,1583,470,551,1021,"6 de julio de 1997"
11,6,20,1584,332,386,718,"6 de julio de 1997"
11,6,20,1585,433,446,879,"6 de julio de 1997"
11,6,20,1586,421,447,868,"6 de julio de 1997"
11,6,20,1587,409,428,837,"6 de julio de 1997"
11,6,20,1588,583,638,1221,"6 de julio de 1997"
11,6,20,1589,533,630,1163,"6 de julio de 1997"
11,6,20,1590,635,677,1312,"6 de julio de 1997"
11,6,20,1591,806,899,1705,"6 de julio de 1997"
11,6,20,1592,674,721,1395,"6 de julio de 1997"
11,6,20,1593,736,795,1531,"6 de julio de 1997"
11,6,20,1594,611,642,1253,"6 de julio de 1997"
11,6,20,1595,446,513,959,"6 de julio de 1997"
11,6,20,1596,520,545,1065,"6 de julio de 1997"
11,6,20,1598,568,541,1109,"6 de julio de 1997"
11,6,20,1606,521,599,1120,"6 de julio de 1997"
11,6,20,1607,310,358,668,"6 de julio de 1997"
11,6,20,1608,512,595,1107,"6 de julio de 1997"
11,6,20,1609,516,563,1079,"6 de julio de 1997"
11,6,20,1610,537,596,1133,"6 de julio de 1997"
11,6,20,1611,580,670,1250,"6 de julio de 1997"
11,6,20,1612,681,781,1462,"6 de julio de 1997"
11,6,20,1613,498,503,1001,"6 de julio de 1997"
11,6,20,1614,833,914,1747,"6 de julio de 1997"
11,6,20,1615,371,409,780,"6 de julio de 1997"
11,6,20,1616,403,443,846,"6 de julio de 1997"
11,6,20,1617,413,462,875,"6 de julio de 1997"
11,6,20,1618,309,345,654,"6 de julio de 1997"
11,6,20,1619,287,328,615,"6 de julio de 1997"
11,6,20,1620,908,1056,1964,"6 de julio de 1997"
11,6,20,1621,341,388,729,"6 de julio de 1997"
11,6,20,1622,228,240,468,"6 de julio de 1997"
11,6,20,1623,613,677,1290,"6 de julio de 1997"
11,6,20,1624,429,482,911,"6 de julio de 1997"
11,6,20,1625,374,398,772,"6 de julio de 1997"
11,6,20,1628,507,542,1049,"6 de julio de 1997"
11,6,20,1629,556,649,1205,"6 de julio de 1997"
11,6,20,1630,278,315,593,"6 de julio de 1997"
11,6,20,1631,597,694,1291,"6 de julio de 1997"
11,6,20,1632,770,882,1652,"6 de julio de 1997"
11,6,20,1633,665,765,1430,"6 de julio de 1997"
11,6,20,1634,644,703,1347,"6 de julio de 1997"
11,6,20,1635,357,416,773,"6 de julio de 1997"
11,6,20,1636,349,382,731,"6 de julio de 1997"
11,6,20,1637,399,423,822,"6 de julio de 1997"
11,6,20,1638,385,376,761,"6 de julio de 1997"
11,6,20,1639,437,491,928,"6 de julio de 1997"
11,6,20,1641,555,615,1170,"6 de julio de 1997"
11,6,20,1642,871,1001,1872,"6 de julio de 1997"
11,6,20,1643,841,941,1782,"6 de julio de 1997"
11,6,20,1644,567,642,1209,"6 de julio de 1997"
11,6,20,1645,638,729,1367,"6 de julio de 1997"
11,6,20,1646,711,787,1498,"6 de julio de 1997"
11,6,20,1647,945,1038,1983,"6 de julio de 1997"
11,6,20,1651,281,333,614,"6 de julio de 1997"
11,6,20,1652,294,279,573,"6 de julio de 1997"
11,6,20,1653,396,440,836,"6 de julio de 1997"
11,6,20,1654,574,602,1176,"6 de julio de 1997"
11,6,20,1655,406,450,856,"6 de julio de 1997"
11,6,20,1659,247,290,537,"6 de julio de 1997"
11,6,20,1660,475,485,960,"6 de julio de 1997"
11,6,20,1661,418,453,871,"6 de julio de 1997"
11,6,20,1662,547,601,1148,"6 de julio de 1997"
11,6,20,1664,513,537,1050,"6 de julio de 1997"
11,6,20,1665,588,629,1217,"6 de julio de 1997"
11,6,20,1666,136,131,267,"6 de julio de 1997"
11,6,20,1667,744,705,1449,"6 de julio de 1997"
11,6,20,1668,419,453,872,"6 de julio de 1997"
11,6,20,1669,493,480,973,"6 de julio de 1997"
11,6,20,1670,304,348,652,"6 de julio de 1997"
11,6,20,1671,422,449,871,"6 de julio de 1997"
11,6,20,1672,583,666,1249,"6 de julio de 1997"
11,6,20,1673,403,461,864,"6 de julio de 1997"
11,7,8,567,230,269,499,"6 de julio de 1997"
11,7,8,568,278,288,566,"6 de julio de 1997"
11,7,8,569,289,323,612,"6 de julio de 1997"
11,7,8,570,351,425,776,"6 de julio de 1997"
11,7,8,571,295,361,656,"6 de julio de 1997"
11,7,8,572,286,349,635,"6 de julio de 1997"
11,7,8,573,257,285,542,"6 de julio de 1997"
11,7,8,574,434,524,958,"6 de julio de 1997"
11,7,8,575,419,502,921,"6 de julio de 1997"
11,7,8,576,194,236,430,"6 de julio de 1997"
11,7,8,577,234,312,546,"6 de julio de 1997"
11,7,8,578,175,175,350,"6 de julio de 1997"
11,7,8,579,298,343,641,"6 de julio de 1997"
11,7,8,580,87,94,181,"6 de julio de 1997"
11,7,8,581,111,117,228,"6 de julio de 1997"
11,7,8,582,336,396,732,"6 de julio de 1997"
11,7,8,583,206,233,439,"6 de julio de 1997"
11,7,8,584,108,157,265,"6 de julio de 1997"
11,7,8,585,66,84,150,"6 de julio de 1997"
11,7,8,586,283,389,672,"6 de julio de 1997"
11,7,8,587,239,316,555,"6 de julio de 1997"
11,7,8,588,77,84,161,"6 de julio de 1997"
11,7,8,589,272,410,682,"6 de julio de 1997"
11,7,8,590,149,251,400,"6 de julio de 1997"
11,7,8,591,192,280,472,"6 de julio de 1997"
11,7,8,592,99,105,204,"6 de julio de 1997"
11,7,8,593,157,166,323,"6 de julio de 1997"
11,7,8,594,373,432,805,"6 de julio de 1997"
11,7,8,595,99,147,246,"6 de julio de 1997"
11,7,8,596,291,363,654,"6 de julio de 1997"
11,7,8,597,358,489,847,"6 de julio de 1997"
11,7,8,598,89,123,212,"6 de julio de 1997"
11,7,8,599,175,210,385,"6 de julio de 1997"
11,7,8,600,113,95,208,"6 de julio de 1997"
11,7,8,601,261,317,578,"6 de julio de 1997"
11,7,8,602,259,320,579,"6 de julio de 1997"
11,7,8,603,296,410,706,"6 de julio de 1997"
11,7,8,604,329,388,717,"6 de julio de 1997"
11,7,8,605,90,110,200,"6 de julio de 1997"
11,7,8,606,242,261,503,"6 de julio de 1997"
11,7,8,607,178,178,356,"6 de julio de 1997"
11,7,8,608,125,119,244,"6 de julio de 1997"
11,7,12,717,255,328,583,"6 de julio de 1997"
11,7,12,718,391,474,865,"6 de julio de 1997"
11,7,12,719,313,379,692,"6 de julio de 1997"
11,7,12,720,365,412,777,"6 de julio de 1997"
11,7,12,721,172,187,359,"6 de julio de 1997"
11,7,12,722,394,478,872,"6 de julio de 1997"
11,7,12,723,474,539,1013,"6 de julio de 1997"
11,7,12,724,368,431,799,"6 de julio de 1997"
11,7,12,725,350,394,744,"6 de julio de 1997"
11,7,12,726,423,475,898,"6 de julio de 1997"
11,7,12,727,202,211,413,"6 de julio de 1997"
11,7,12,728,204,235,439,"6 de julio de 1997"
11,7,12,729,222,249,471,"6 de julio de 1997"
11,7,12,730,45,52,97,"6 de julio de 1997"
11,7,12,731,215,245,460,"6 de julio de 1997"
11,7,12,732,254,325,579,"6 de julio de 1997"
11,7,12,733,123,179,302,"6 de julio de 1997"
11,7,12,734,96,126,222,"6 de julio de 1997"
11,7,12,735,36,29,65,"6 de julio de 1997"
11,7,12,736,516,586,1102,"6 de julio de 1997"
11,7,12,737,200,209,409,"6 de julio de 1997"
11,7,12,738,565,678,1243,"6 de julio de 1997"
11,7,12,739,440,521,961,"6 de julio de 1997"
11,7,25,2034,319,337,656,"6 de julio de 1997"
11,7,25,2035,374,379,753,"6 de julio de 1997"
11,7,25,2036,753,822,1575,"6 de julio de 1997"
11,7,25,2037,466,469,935,"6 de julio de 1997"
11,7,25,2038,616,689,1305,"6 de julio de 1997"
11,7,25,2039,458,492,950,"6 de julio de 1997"
11,7,25,2040,383,437,820,"6 de julio de 1997"
11,7,25,2041,602,648,1250,"6 de julio de 1997"
11,7,25,2042,793,891,1684,"6 de julio de 1997"
11,7,25,2043,416,464,880,"6 de julio de 1997"
11,7,25,2044,447,559,1006,"6 de julio de 1997"
11,7,25,2045,312,388,700,"6 de julio de 1997"
11,7,25,2046,164,196,360,"6 de julio de 1997"
11,7,25,2047,232,256,488,"6 de julio de 1997"
11,7,25,2048,331,422,753,"6 de julio de 1997"
11,7,25,2049,472,565,1037,"6 de julio de 1997"
11,7,25,2050,286,382,668,"6 de julio de 1997"
11,7,25,2051,317,344,661,"6 de julio de 1997"
11,7,25,2052,425,506,931,"6 de julio de 1997"
11,7,25,2053,339,439,778,"6 de julio de 1997"
11,7,25,2054,246,317,563,"6 de julio de 1997"
11,7,25,2055,336,413,749,"6 de julio de 1997"
11,7,25,2056,140,170,310,"6 de julio de 1997"
11,7,25,2057,174,218,392,"6 de julio de 1997"
11,7,25,2058,83,82,165,"6 de julio de 1997"
11,7,26,2059,229,236,465,"6 de julio de 1997"
11,7,26,2060,384,426,810,"6 de julio de 1997"
11,7,26,2061,411,494,905,"6 de julio de 1997"
11,7,26,2062,471,554,1025,"6 de julio de 1997"
11,7,26,2063,314,360,674,"6 de julio de 1997"
11,7,26,2064,503,571,1074,"6 de julio de 1997"
11,7,26,2065,334,397,731,"6 de julio de 1997"
11,7,26,2066,328,371,699,"6 de julio de 1997"
11,7,26,2067,372,424,796,"6 de julio de 1997"
11,7,26,2068,523,612,1135,"6 de julio de 1997"
11,7,26,2069,439,494,933,"6 de julio de 1997"
11,7,26,2070,279,361,640,"6 de julio de 1997"
11,7,26,2071,333,369,702,"6 de julio de 1997"
11,7,26,2072,376,381,757,"6 de julio de 1997"
11,7,26,2073,48,50,98,"6 de julio de 1997"
11,7,26,2074,271,295,566,"6 de julio de 1997"
11,7,26,2075,114,93,207,"6 de julio de 1997"
11,7,26,2076,129,152,281,"6 de julio de 1997"
11,7,26,2077,71,76,147,"6 de julio de 1997"
11,7,26,2078,126,133,259,"6 de julio de 1997"
11,7,26,2079,346,425,771,"6 de julio de 1997"
11,7,26,2080,110,109,219,"6 de julio de 1997"
11,7,26,2081,129,130,259,"6 de julio de 1997"
11,7,26,2082,115,115,230,"6 de julio de 1997"
11,7,26,2083,53,64,117,"6 de julio de 1997"
11,7,26,2084,170,161,331,"6 de julio de 1997"
11,7,26,2085,331,378,709,"6 de julio de 1997"
11,7,26,2086,527,547,1074,"6 de julio de 1997"
11,7,26,2087,231,248,479,"6 de julio de 1997"
11,7,26,2088,449,459,908,"6 de julio de 1997"
11,7,26,2089,117,137,254,"6 de julio de 1997"
11,7,26,2090,79,92,171,"6 de julio de 1997"
11,7,26,2091,58,86,144,"6 de julio de 1997"
11,7,26,2092,256,294,550,"6 de julio de 1997"
11,7,26,2093,206,238,444,"6 de julio de 1997"
11,7,26,2094,72,59,131,"6 de julio de 1997"
11,7,26,2095,447,547,994,"6 de julio de 1997"
11,7,26,2096,190,213,403,"6 de julio de 1997"
11,7,26,2097,171,172,343,"6 de julio de 1997"
11,7,26,2098,344,359,703,"6 de julio de 1997"
11,7,26,2099,262,278,540,"6 de julio de 1997"
11,7,26,2100,155,223,378,"6 de julio de 1997"
11,7,26,2101,262,305,567,"6 de julio de 1997"
11,7,26,2102,340,351,691,"6 de julio de 1997"
11,7,26,2103,78,96,174,"6 de julio de 1997"
11,7,26,2104,82,104,186,"6 de julio de 1997"
11,7,26,2105,266,281,547,"6 de julio de 1997"
11,7,26,2106,240,285,525,"6 de julio de 1997"
11,7,26,2107,180,214,394,"6 de julio de 1997"
11,7,26,2108,226,286,512,"6 de julio de 1997"
11,7,31,2446,141,172,313,"6 de julio de 1997"
11,7,31,2447,104,100,204,"6 de julio de 1997"
11,7,31,2448,515,579,1094,"6 de julio de 1997"
11,7,31,2449,635,660,1295,"6 de julio de 1997"
11,7,31,2450,408,462,870,"6 de julio de 1997"
11,7,31,2451,494,556,1050,"6 de julio de 1997"
11,7,31,2452,611,646,1257,"6 de julio de 1997"
11,7,31,2453,636,702,1338,"6 de julio de 1997"
11,7,31,2454,430,507,937,"6 de julio de 1997"
11,7,31,2455,96,140,236,"6 de julio de 1997"
11,7,31,2456,383,393,776,"6 de julio de 1997"
11,7,31,2457,475,554,1029,"6 de julio de 1997"
11,7,31,2458,393,478,871,"6 de julio de 1997"
11,7,31,2459,302,349,651,"6 de julio de 1997"
11,7,31,2460,451,522,973,"6 de julio de 1997"
11,7,31,2461,401,484,885,"6 de julio de 1997"
11,7,31,2462,317,413,730,"6 de julio de 1997"
11,7,31,2463,647,752,1399,"6 de julio de 1997"
11,7,31,2464,211,246,457,"6 de julio de 1997"
11,7,31,2465,458,490,948,"6 de julio de 1997"
11,7,31,2466,559,595,1154,"6 de julio de 1997"
11,7,31,2467,380,437,817,"6 de julio de 1997"
11,7,31,2468,591,682,1273,"6 de julio de 1997"
11,7,31,2469,389,432,821,"6 de julio de 1997"
11,7,31,2470,276,300,576,"6 de julio de 1997"
11,7,31,2471,481,589,1070,"6 de julio de 1997"
11,7,31,2472,387,474,861,"6 de julio de 1997"
11,7,31,2473,458,532,990,"6 de julio de 1997"
11,7,31,2474,669,734,1403,"6 de julio de 1997"
11,7,31,2475,502,558,1060,"6 de julio de 1997"
11,7,31,2476,554,622,1176,"6 de julio de 1997"
11,7,31,2477,812,887,1699,"6 de julio de 1997"
11,7,31,2478,260,294,554,"6 de julio de 1997"
11,7,31,2479,431,496,927,"6 de julio de 1997"
11,7,31,2480,280,328,608,"6 de julio de 1997"
11,7,31,2481,458,446,904,"6 de julio de 1997"
11,7,31,2482,485,551,1036,"6 de julio de 1997"
11,7,31,2483,292,357,649,"6 de julio de 1997"
11,7,31,2484,151,201,352,"6 de julio de 1997"
11,7,31,2485,394,528,922,"6 de julio de 1997"
11,7,31,2486,588,671,1259,"6 de julio de 1997"
11,7,31,2487,349,460,809,"6 de julio de 1997"
11,7,31,2488,277,241,518,"6 de julio de 1997"
11,7,31,2489,233,238,471,"6 de julio de 1997"
11,7,31,2490,322,378,700,"6 de julio de 1997"
11,7,31,2491,231,294,525,"6 de julio de 1997"
11,7,31,2492,334,354,688,"6 de julio de 1997"
11,7,31,2493,196,222,418,"6 de julio de 1997"
11,7,31,2494,361,366,727,"6 de julio de 1997"
11,7,31,2495,320,373,693,"6 de julio de 1997"
11,7,31,2496,429,498,927,"6 de julio de 1997"
11,7,31,2497,222,268,490,"6 de julio de 1997"
11,7,31,2498,246,283,529,"6 de julio de 1997"
11,7,31,2499,330,403,733,"6 de julio de 1997"
11,7,31,2500,247,275,522,"6 de julio de 1997"
11,7,31,2501,213,280,493,"6 de julio de 1997"
11,7,31,2502,279,398,677,"6 de julio de 1997"
11,7,31,2503,195,230,425,"6 de julio de 1997"
11,7,31,2504,198,258,456,"6 de julio de 1997"
11,8,24,2026,488,612,1100,"6 de julio de 1997"
11,8,24,2027,311,383,694,"6 de julio de 1997"
11,8,24,2028,471,618,1089,"6 de julio de 1997"
11,8,24,2029,462,577,1039,"6 de julio de 1997"
11,8,24,2030,426,562,988,"6 de julio de 1997"
11,8,24,2031,288,389,677,"6 de julio de 1997"
11,8,24,2032,268,385,653,"6 de julio de 1997"
11,8,24,2033,150,191,341,"6 de julio de 1997"
11,8,27,2109,158,152,310,"6 de julio de 1997"
11,8,27,2110,777,850,1627,"6 de julio de 1997"
11,8,27,2111,839,952,1791,"6 de julio de 1997"
11,8,27,2112,683,716,1399,"6 de julio de 1997"
11,8,27,2113,283,309,592,"6 de julio de 1997"
11,8,27,2114,374,393,767,"6 de julio de 1997"
11,8,27,2115,311,316,627,"6 de julio de 1997"
11,8,27,2116,319,381,700,"6 de julio de 1997"
11,8,27,2117,419,460,879,"6 de julio de 1997"
11,8,27,2118,410,433,843,"6 de julio de 1997"
11,8,27,2119,393,406,799,"6 de julio de 1997"
11,8,27,2120,393,441,834,"6 de julio de 1997"
11,8,27,2121,556,633,1189,"6 de julio de 1997"
11,8,27,2122,293,310,603,"6 de julio de 1997"
11,8,27,2123,473,533,1006,"6 de julio de 1997"
11,8,27,2124,322,367,689,"6 de julio de 1997"
11,8,27,2125,378,453,831,"6 de julio de 1997"
11,8,27,2126,346,425,771,"6 de julio de 1997"
11,8,27,2127,380,435,815,"6 de julio de 1997"
11,8,27,2128,352,411,763,"6 de julio de 1997"
11,8,27,2129,570,623,1193,"6 de julio de 1997"
11,8,27,2130,312,356,668,"6 de julio de 1997"
11,8,27,2131,420,452,872,"6 de julio de 1997"
11,8,27,2132,348,362,710,"6 de julio de 1997"
11,8,27,2133,456,516,972,"6 de julio de 1997"
11,8,27,2134,325,382,707,"6 de julio de 1997"
11,8,27,2135,552,611,1163,"6 de julio de 1997"
11,8,27,2136,597,660,1257,"6 de julio de 1997"
11,8,27,2137,294,342,636,"6 de julio de 1997"
11,8,27,2138,257,278,535,"6 de julio de 1997"
11,8,27,2139,382,429,811,"6 de julio de 1997"
11,8,27,2140,470,548,1018,"6 de julio de 1997"
11,8,27,2141,554,604,1158,"6 de julio de 1997"
11,8,27,2142,294,358,652,"6 de julio de 1997"
11,8,27,2143,423,430,853,"6 de julio de 1997"
11,8,27,2144,560,613,1173,"6 de julio de 1997"
11,8,27,2145,310,344,654,"6 de julio de 1997"
11,8,27,2146,516,620,1136,"6 de julio de 1997"
11,8,27,2147,444,471,915,"6 de julio de 1997"
11,8,27,2148,442,493,935,"6 de julio de 1997"
11,8,27,2149,343,398,741,"6 de julio de 1997"
11,8,27,2150,474,481,955,"6 de julio de 1997"
11,8,27,2151,475,515,990,"6 de julio de 1997"
11,8,27,2152,333,366,699,"6 de julio de 1997"
11,8,27,2153,397,437,834,"6 de julio de 1997"
11,8,27,2154,370,402,772,"6 de julio de 1997"
11,8,27,2155,315,356,671,"6 de julio de 1997"
11,8,27,2156,402,471,873,"6 de julio de 1997"
11,8,27,2157,376,486,862,"6 de julio de 1997"
11,8,27,2158,282,330,612,"6 de julio de 1997"
11,8,27,2159,516,585,1101,"6 de julio de 1997"
11,8,27,2160,583,662,1245,"6 de julio de 1997"
11,8,27,2161,346,386,732,"6 de julio de 1997"
11,8,27,2162,403,486,889,"6 de julio de 1997"
11,8,27,2163,548,601,1149,"6 de julio de 1997"
11,8,27,2164,446,478,924,"6 de julio de 1997"
11,8,27,2165,353,429,782,"6 de julio de 1997"
11,8,27,2166,565,635,1200,"6 de julio de 1997"
11,8,27,2167,456,528,984,"6 de julio de 1997"
11,8,27,2168,497,538,1035,"6 de julio de 1997"
11,8,27,2169,373,396,769,"6 de julio de 1997"
11,8,27,2170,504,585,1089,"6 de julio de 1997"
11,8,27,2171,525,592,1117,"6 de julio de 1997"
11,8,27,2172,302,386,688,"6 de julio de 1997"
11,8,27,2173,332,376,708,"6 de julio de 1997"
11,8,27,2174,299,324,623,"6 de julio de 1997"
11,8,27,2175,388,388,776,"6 de julio de 1997"
11,8,27,2176,523,560,1083,"6 de julio de 1997"
11,8,27,2177,627,674,1301,"6 de julio de 1997"
11,8,27,2178,444,510,954,"6 de julio de 1997"
11,8,27,2179,741,785,1526,"6 de julio de 1997"
11,8,27,2180,323,375,698,"6 de julio de 1997"
11,8,27,2181,628,691,1319,"6 de julio de 1997"
11,8,27,2182,497,509,1006,"6 de julio de 1997"
11,8,27,2183,522,529,1051,"6 de julio de 1997"
11,8,27,2184,661,691,1352,"6 de julio de 1997"
11,8,27,2185,506,543,1049,"6 de julio de 1997"
11,8,27,2186,564,632,1196,"6 de julio de 1997"
11,8,27,2187,594,613,1207,"6 de julio de 1997"
11,8,27,2188,512,544,1056,"6 de julio de 1997"
11,8,27,2189,195,222,417,"6 de julio de 1997"
11,8,27,2190,482,525,1007,"6 de julio de 1997"
11,8,27,2191,495,518,1013,"6 de julio de 1997"
11,8,27,2192,484,491,975,"6 de julio de 1997"
11,8,27,2193,1010,1138,2148,"6 de julio de 1997"
11,8,27,2194,501,564,1065,"6 de julio de 1997"
11,8,27,2195,488,507,995,"6 de julio de 1997"
11,8,27,2196,349,383,732,"6 de julio de 1997"
11,8,27,2197,564,641,1205,"6 de julio de 1997"
11,8,27,2198,655,661,1316,"6 de julio de 1997"
11,8,27,2199,190,195,385,"6 de julio de 1997"
11,8,27,2200,312,301,613,"6 de julio de 1997"
11,8,27,2201,209,235,444,"6 de julio de 1997"
11,8,27,2202,221,241,462,"6 de julio de 1997"
11,8,27,2203,252,291,543,"6 de julio de 1997"
11,8,27,2204,647,736,1383,"6 de julio de 1997"
11,8,27,2205,171,205,376,"6 de julio de 1997"
11,8,27,2206,248,349,597,"6 de julio de 1997"
11,8,27,2207,357,407,764,"6 de julio de 1997"
11,8,27,2208,379,398,777,"6 de julio de 1997"
11,8,27,2209,291,315,606,"6 de julio de 1997"
11,8,27,2210,331,426,757,"6 de julio de 1997"
11,8,27,2211,194,230,424,"6 de julio de 1997"
11,8,27,2212,342,403,745,"6 de julio de 1997"
11,8,27,2213,333,390,723,"6 de julio de 1997"
11,8,27,2214,145,150,295,"6 de julio de 1997"
11,8,27,2215,267,303,570,"6 de julio de 1997"
11,8,27,2216,412,424,836,"6 de julio de 1997"
11,8,27,2217,343,439,782,"6 de julio de 1997"
11,8,27,2218,413,489,902,"6 de julio de 1997"
11,8,27,2219,537,610,1147,"6 de julio de 1997"
11,8,27,2220,293,303,596,"6 de julio de 1997"
11,8,27,2221,261,346,607,"6 de julio de 1997"
11,8,27,2222,317,366,683,"6 de julio de 1997"
11,8,27,2223,563,638,1201,"6 de julio de 1997"
11,8,27,2224,435,433,868,"6 de julio de 1997"
11,8,27,2225,401,477,878,"6 de julio de 1997"
11,8,27,2226,504,543,1047,"6 de julio de 1997"
11,8,27,2227,418,495,913,"6 de julio de 1997"
11,8,27,2228,422,455,877,"6 de julio de 1997"
11,8,27,2229,266,302,568,"6 de julio de 1997"
11,8,27,2230,680,681,1361,"6 de julio de 1997"
11,8,27,2231,517,563,1080,"6 de julio de 1997"
11,8,27,2232,395,461,856,"6 de julio de 1997"
11,8,27,2233,535,581,1116,"6 de julio de 1997"
11,8,27,2234,382,447,829,"6 de julio de 1997"
11,8,27,2235,221,221,442,"6 de julio de 1997"
11,8,27,2236,441,483,924,"6 de julio de 1997"
11,8,27,2237,206,277,483,"6 de julio de 1997"
11,8,27,2238,436,527,963,"6 de julio de 1997"
11,8,27,2239,450,464,914,"6 de julio de 1997"
11,8,27,2240,345,391,736,"6 de julio de 1997"
11,8,27,2241,350,399,749,"6 de julio de 1997"
11,8,27,2242,459,483,942,"6 de julio de 1997"
11,8,27,2243,526,553,1079,"6 de julio de 1997"
11,8,27,2244,539,603,1142,"6 de julio de 1997"
11,8,27,2245,611,644,1255,"6 de julio de 1997"
11,8,27,2246,370,421,791,"6 de julio de 1997"
11,8,27,2247,281,306,587,"6 de julio de 1997"
11,8,27,2248,423,529,952,"6 de julio de 1997"
11,8,27,2249,342,410,752,"6 de julio de 1997"
11,8,27,2250,210,218,428,"6 de julio de 1997"
11,8,27,2251,391,578,969,"6 de julio de 1997"
11,8,27,2252,656,445,1101,"6 de julio de 1997"
11,8,27,2253,484,565,1049,"6 de julio de 1997"
11,8,27,2254,373,469,842,"6 de julio de 1997"
11,8,27,2255,175,228,403,"6 de julio de 1997"
11,8,27,2256,145,268,413,"6 de julio de 1997"
11,8,27,2257,358,397,755,"6 de julio de 1997"
11,8,27,2258,337,385,722,"6 de julio de 1997"
11,8,27,2259,273,377,650,"6 de julio de 1997"
11,8,27,2260,348,389,737,"6 de julio de 1997"
11,8,27,2261,347,424,771,"6 de julio de 1997"
11,8,27,2262,246,346,592,"6 de julio de 1997"
11,8,44,2906,301,306,607,"6 de julio de 1997"
11,8,44,2907,367,415,782,"6 de julio de 1997"
11,8,44,2908,308,328,636,"6 de julio de 1997"
11,8,44,2909,405,473,878,"6 de julio de 1997"
11,8,44,2910,472,511,983,"6 de julio de 1997"
11,8,44,2911,398,455,853,"6 de julio de 1997"
11,8,44,2912,515,545,1060,"6 de julio de 1997"
11,8,44,2913,591,664,1255,"6 de julio de 1997"
11,8,44,2914,282,286,568,"6 de julio de 1997"
11,8,44,2915,434,493,927,"6 de julio de 1997"
11,8,44,2916,384,477,861,"6 de julio de 1997"
11,8,44,2917,377,418,795,"6 de julio de 1997"
11,8,44,2918,450,497,947,"6 de julio de 1997"
11,8,44,2919,452,524,976,"6 de julio de 1997"
11,8,44,2920,253,305,558,"6 de julio de 1997"
11,8,44,2921,524,574,1098,"6 de julio de 1997"
11,8,44,2922,426,499,925,"6 de julio de 1997"
11,8,44,2923,561,752,1313,"6 de julio de 1997"
11,8,44,2924,454,525,979,"6 de julio de 1997"
11,8,44,2925,407,451,858,"6 de julio de 1997"
11,8,44,2926,197,196,393,"6 de julio de 1997"
11,8,44,2927,594,646,1240,"6 de julio de 1997"
11,8,44,2928,348,469,817,"6 de julio de 1997"
11,8,44,2929,689,762,1451,"6 de julio de 1997"
11,8,44,2930,407,504,911,"6 de julio de 1997"
11,8,44,2931,254,307,561,"6 de julio de 1997"
11,8,44,2932,252,317,569,"6 de julio de 1997"
11,8,44,2933,360,359,719,"6 de julio de 1997"
11,9,17,929,355,418,773,"6 de julio de 1997"
11,9,17,930,753,870,1623,"6 de julio de 1997"
11,9,17,931,166,205,371,"6 de julio de 1997"
11,9,17,932,185,223,408,"6 de julio de 1997"
11,9,17,933,442,515,957,"6 de julio de 1997"
11,9,17,934,515,548,1063,"6 de julio de 1997"
11,9,17,935,367,400,767,"6 de julio de 1997"
11,9,17,936,299,367,666,"6 de julio de 1997"
11,9,17,937,362,391,753,"6 de julio de 1997"
11,9,17,938,437,466,903,"6 de julio de 1997"
11,9,17,939,475,518,993,"6 de julio de 1997"
11,9,17,940,434,502,936,"6 de julio de 1997"
11,9,17,941,462,487,949,"6 de julio de 1997"
11,9,17,942,301,349,650,"6 de julio de 1997"
11,9,17,943,335,369,704,"6 de julio de 1997"
11,9,17,944,534,629,1163,"6 de julio de 1997"
11,9,17,945,318,351,669,"6 de julio de 1997"
11,9,17,946,295,328,623,"6 de julio de 1997"
11,9,17,947,558,680,1238,"6 de julio de 1997"
11,9,17,948,553,621,1174,"6 de julio de 1997"
11,9,17,949,462,593,1055,"6 de julio de 1997"
11,9,17,950,507,616,1123,"6 de julio de 1997"
11,9,17,951,440,491,931,"6 de julio de 1997"
11,9,17,952,438,527,965,"6 de julio de 1997"
11,9,17,953,525,613,1138,"6 de julio de 1997"
11,9,17,954,345,381,726,"6 de julio de 1997"
11,9,17,955,451,500,951,"6 de julio de 1997"
11,9,17,956,490,549,1039,"6 de julio de 1997"
11,9,17,957,489,565,1054,"6 de julio de 1997"
11,9,17,958,576,650,1226,"6 de julio de 1997"
11,9,17,959,418,434,852,"6 de julio de 1997"
11,9,17,960,557,573,1130,"6 de julio de 1997"
11,9,17,961,340,412,752,"6 de julio de 1997"
11,9,17,962,365,427,792,"6 de julio de 1997"
11,9,17,963,565,675,1240,"6 de julio de 1997"
11,9,17,964,370,444,814,"6 de julio de 1997"
11,9,17,965,203,232,435,"6 de julio de 1997"
11,9,17,966,556,631,1187,"6 de julio de 1997"
11,9,17,967,359,445,804,"6 de julio de 1997"
11,9,17,968,1895,288,2183,"6 de julio de 1997"
11,9,17,969,436,496,932,"6 de julio de 1997"
11,9,17,970,245,288,533,"6 de julio de 1997"
11,9,17,971,525,565,1090,"6 de julio de 1997"
11,9,17,972,302,341,643,"6 de julio de 1997"
11,9,17,973,569,648,1217,"6 de julio de 1997"
11,9,17,974,502,564,1066,"6 de julio de 1997"
11,9,17,975,592,699,1291,"6 de julio de 1997"
11,9,17,976,335,420,755,"6 de julio de 1997"
11,9,17,977,433,535,968,"6 de julio de 1997"
11,9,17,978,552,632,1184,"6 de julio de 1997"
11,9,17,979,468,529,997,"6 de julio de 1997"
11,9,17,980,603,799,1402,"6 de julio de 1997"
11,9,17,981,284,333,617,"6 de julio de 1997"
11,9,17,982,481,571,1052,"6 de julio de 1997"
11,9,17,983,376,487,863,"6 de julio de 1997"
11,9,17,984,369,453,822,"6 de julio de 1997"
11,9,17,985,210,280,490,"6 de julio de 1997"
11,9,17,986,218,252,470,"6 de julio de 1997"
11,9,17,987,383,429,812,"6 de julio de 1997"
11,9,17,988,307,407,714,"6 de julio de 1997"
11,9,17,989,428,512,940,"6 de julio de 1997"
11,9,17,990,271,334,605,"6 de julio de 1997"
11,9,17,991,357,474,831,"6 de julio de 1997"
11,9,17,992,419,510,929,"6 de julio de 1997"
11,9,17,993,534,663,1197,"6 de julio de 1997"
11,9,17,994,582,694,1276,"6 de julio de 1997"
11,9,17,995,413,525,938,"6 de julio de 1997"
11,9,17,996,213,310,523,"6 de julio de 1997"
11,9,17,997,464,529,993,"6 de julio de 1997"
11,9,17,998,285,338,623,"6 de julio de 1997"
11,9,17,999,417,464,881,"6 de julio de 1997"
11,9,17,1000,527,649,1176,"6 de julio de 1997"
11,9,17,1001,279,322,601,"6 de julio de 1997"
11,9,17,1002,249,355,604,"6 de julio de 1997"
11,9,17,1003,251,325,576,"6 de julio de 1997"
11,9,17,1004,284,356,640,"6 de julio de 1997"
11,9,17,1005,440,500,940,"6 de julio de 1997"
11,9,17,1006,505,593,1098,"6 de julio de 1997"
11,9,17,1007,462,501,963,"6 de julio de 1997"
11,9,17,1008,337,406,743,"6 de julio de 1997"
11,9,17,1009,495,553,1048,"6 de julio de 1997"
11,9,17,1010,458,569,1027,"6 de julio de 1997"
11,9,17,1011,273,351,624,"6 de julio de 1997"
11,9,17,1012,384,457,841,"6 de julio de 1997"
11,9,17,1013,370,458,828,"6 de julio de 1997"
11,9,17,1014,328,375,703,"6 de julio de 1997"
11,9,17,1015,346,434,780,"6 de julio de 1997"
11,9,17,1016,297,327,624,"6 de julio de 1997"
11,9,17,1017,363,422,785,"6 de julio de 1997"
11,9,17,1018,361,444,805,"6 de julio de 1997"
11,9,17,1019,445,473,918,"6 de julio de 1997"
11,9,17,1020,348,417,765,"6 de julio de 1997"
11,9,17,1021,455,547,1002,"6 de julio de 1997"
11,9,17,1022,275,347,622,"6 de julio de 1997"
11,9,17,1023,192,258,450,"6 de julio de 1997"
11,9,17,1024,381,532,913,"6 de julio de 1997"
11,9,17,1025,374,437,811,"6 de julio de 1997"
11,9,17,1026,396,434,830,"6 de julio de 1997"
11,9,17,1027,195,253,448,"6 de julio de 1997"
11,9,17,1028,272,369,641,"6 de julio de 1997"
11,9,17,1029,440,506,946,"6 de julio de 1997"
11,9,17,1030,196,271,467,"6 de julio de 1997"
11,9,17,1031,251,339,590,"6 de julio de 1997"
11,9,17,1032,356,502,858,"6 de julio de 1997"
11,9,17,1033,233,291,524,"6 de julio de 1997"
11,9,17,1034,470,611,1081,"6 de julio de 1997"
11,9,17,1035,514,603,1117,"6 de julio de 1997"
11,9,17,1036,488,570,1058,"6 de julio de 1997"
11,9,17,1037,454,521,975,"6 de julio de 1997"
11,9,17,1038,599,681,1280,"6 de julio de 1997"
11,9,17,1039,530,672,1202,"6 de julio de 1997"
11,9,17,1040,528,590,1118,"6 de julio de 1997"
11,9,17,1041,525,621,1146,"6 de julio de 1997"
11,9,17,1042,266,311,577,"6 de julio de 1997"
11,9,17,1043,281,333,614,"6 de julio de 1997"
11,9,17,1044,489,560,1049,"6 de julio de 1997"
11,9,17,1045,373,514,887,"6 de julio de 1997"
11,9,17,1046,457,538,995,"6 de julio de 1997"
11,9,17,1047,369,479,848,"6 de julio de 1997"
11,9,17,1048,315,428,743,"6 de julio de 1997"
11,9,17,1049,366,465,831,"6 de julio de 1997"
11,9,17,1050,397,484,881,"6 de julio de 1997"
11,9,17,1051,548,603,1151,"6 de julio de 1997"
11,9,17,1052,697,796,1493,"6 de julio de 1997"
11,9,17,1053,290,352,642,"6 de julio de 1997"
11,9,17,1054,488,512,1000,"6 de julio de 1997"
11,9,17,1055,338,413,751,"6 de julio de 1997"
11,9,17,1056,461,554,1015,"6 de julio de 1997"
11,9,17,1057,587,655,1242,"6 de julio de 1997"
11,9,17,1058,468,614,1082,"6 de julio de 1997"
11,9,17,1059,815,966,1781,"6 de julio de 1997"
11,9,17,1060,669,764,1433,"6 de julio de 1997"
11,9,17,1061,568,681,1249,"6 de julio de 1997"
11,9,17,1062,477,603,1080,"6 de julio de 1997"
11,9,17,1063,517,622,1139,"6 de julio de 1997"
11,9,17,1064,323,339,662,"6 de julio de 1997"
11,9,17,1065,398,513,911,"6 de julio de 1997"
11,9,17,1066,416,494,910,"6 de julio de 1997"
11,9,17,1067,571,587,1158,"6 de julio de 1997"
11,9,17,1068,483,559,1042,"6 de julio de 1997"
11,9,17,1069,353,428,781,"6 de julio de 1997"
11,9,17,1070,459,517,976,"6 de julio de 1997"
11,9,17,1071,570,596,1166,"6 de julio de 1997"
11,9,17,1072,567,647,1214,"6 de julio de 1997"
11,9,17,1073,643,734,1377,"6 de julio de 1997"
11,9,17,1074,691,776,1467,"6 de julio de 1997"
11,9,17,1075,413,484,897,"6 de julio de 1997"
11,9,17,1076,318,400,718,"6 de julio de 1997"
11,9,17,1077,767,881,1648,"6 de julio de 1997"
11,9,17,1078,458,497,955,"6 de julio de 1997"
11,9,17,1079,246,329,575,"6 de julio de 1997"
11,9,17,1080,649,725,1374,"6 de julio de 1997"
11,9,17,1081,355,399,754,"6 de julio de 1997"
11,9,17,1082,564,669,1233,"6 de julio de 1997"
11,9,17,1083,378,431,809,"6 de julio de 1997"
11,9,17,1084,402,450,852,"6 de julio de 1997"
11,9,17,1085,330,373,703,"6 de julio de 1997"
11,9,17,1086,331,368,699,"6 de julio de 1997"
11,9,17,1087,430,524,954,"6 de julio de 1997"
11,9,17,1088,270,342,612,"6 de julio de 1997"
11,9,17,1089,376,448,824,"6 de julio de 1997"
11,9,17,1090,295,340,635,"6 de julio de 1997"
11,9,17,1091,384,422,806,"6 de julio de 1997"
11,9,17,1092,272,334,606,"6 de julio de 1997"
11,9,17,1093,440,528,968,"6 de julio de 1997"
11,9,17,1094,537,619,1156,"6 de julio de 1997"
11,9,17,1095,416,494,910,"6 de julio de 1997"
11,9,17,1096,358,406,764,"6 de julio de 1997"
11,9,17,1097,309,358,667,"6 de julio de 1997"
11,9,17,1098,315,353,668,"6 de julio de 1997"
11,9,17,1099,649,722,1371,"6 de julio de 1997"
11,9,17,1100,328,374,702,"6 de julio de 1997"
11,9,17,1101,377,418,795,"6 de julio de 1997"
11,9,17,1102,357,411,768,"6 de julio de 1997"
11,9,17,1103,582,675,1257,"6 de julio de 1997"
11,9,17,1104,399,431,830,"6 de julio de 1997"
11,9,17,1105,600,721,1321,"6 de julio de 1997"
11,9,17,1106,559,629,1188,"6 de julio de 1997"
11,9,17,1107,543,565,1108,"6 de julio de 1997"
11,9,17,1108,375,446,821,"6 de julio de 1997"
11,9,17,1109,312,344,656,"6 de julio de 1997"
11,9,17,1110,201,241,442,"6 de julio de 1997"
11,9,17,1111,345,412,757,"6 de julio de 1997"
11,9,17,1112,228,260,488,"6 de julio de 1997"
11,9,17,1113,440,554,994,"6 de julio de 1997"
11,9,17,1114,441,484,925,"6 de julio de 1997"
11,9,17,1115,560,591,1151,"6 de julio de 1997"
11,9,17,1116,647,697,1344,"6 de julio de 1997"
11,9,17,1117,708,849,1557,"6 de julio de 1997"
11,9,17,1118,265,309,574,"6 de julio de 1997"
11,9,17,1119,502,591,1093,"6 de julio de 1997"
11,9,17,1120,388,489,877,"6 de julio de 1997"
11,9,17,1121,386,457,843,"6 de julio de 1997"
11,9,17,1122,588,715,1303,"6 de julio de 1997"
11,9,17,1123,462,537,999,"6 de julio de 1997"
11,9,17,1124,393,485,878,"6 de julio de 1997"
11,9,17,1125,340,352,692,"6 de julio de 1997"
11,9,17,1126,424,403,827,"6 de julio de 1997"
11,9,17,1127,236,309,545,"6 de julio de 1997"
11,9,17,1128,302,308,610,"6 de julio de 1997"
11,9,17,1129,490,584,1074,"6 de julio de 1997"
11,9,17,1130,439,442,881,"6 de julio de 1997"
11,9,17,1131,497,545,1042,"6 de julio de 1997"
11,9,17,1132,542,528,1070,"6 de julio de 1997"
11,9,17,1133,331,359,690,"6 de julio de 1997"
11,9,17,1134,344,379,723,"6 de julio de 1997"
11,9,17,1135,239,220,459,"6 de julio de 1997"
11,9,17,1136,407,458,865,"6 de julio de 1997"
11,9,17,1137,420,434,854,"6 de julio de 1997"
11,9,17,1138,485,524,1009,"6 de julio de 1997"
11,9,17,1139,582,619,1201,"6 de julio de 1997"
11,9,17,1140,561,618,1179,"6 de julio de 1997"
11,9,17,1141,478,523,1001,"6 de julio de 1997"
11,9,17,1142,453,505,958,"6 de julio de 1997"
11,9,17,1143,327,372,699,"6 de julio de 1997"
11,9,17,1144,400,426,826,"6 de julio de 1997"
11,9,17,1145,266,290,556,"6 de julio de 1997"
11,9,17,1146,144,157,301,"6 de julio de 1997"
11,9,17,1147,460,514,974,"6 de julio de 1997"
11,9,17,1148,582,647,1229,"6 de julio de 1997"
11,9,17,1149,423,455,878,"6 de julio de 1997"
11,9,17,1150,426,471,897,"6 de julio de 1997"
11,9,17,1151,414,508,922,"6 de julio de 1997"
11,9,17,1152,568,675,1243,"6 de julio de 1997"
11,9,17,1153,432,505,937,"6 de julio de 1997"
11,9,17,1154,377,472,849,"6 de julio de 1997"
11,9,17,1155,347,447,794,"6 de julio de 1997"
11,9,17,1156,143,180,323,"6 de julio de 1997"
11,9,17,1157,496,554,1050,"6 de julio de 1997"
11,9,17,1158,688,783,1471,"6 de julio de 1997"
11,9,17,1159,459,506,965,"6 de julio de 1997"
11,9,17,1160,296,383,679,"6 de julio de 1997"
11,9,17,1161,434,493,927,"6 de julio de 1997"
11,9,17,1162,584,672,1256,"6 de julio de 1997"
11,9,17,1163,473,596,1069,"6 de julio de 1997"
11,9,17,1164,686,860,1546,"6 de julio de 1997"
11,9,17,1165,715,871,1586,"6 de julio de 1997"
11,9,17,1166,575,637,1212,"6 de julio de 1997"
11,9,17,1167,627,689,1316,"6 de julio de 1997"
11,9,17,1168,482,561,1043,"6 de julio de 1997"
11,9,17,1169,495,632,1127,"6 de julio de 1997"
11,9,17,1170,420,517,937,"6 de julio de 1997"
11,9,17,1171,247,263,510,"6 de julio de 1997"
11,9,17,1172,445,512,957,"6 de julio de 1997"
11,9,17,1173,419,474,893,"6 de julio de 1997"
11,9,17,1174,527,599,1126,"6 de julio de 1997"
11,9,17,1175,420,432,852,"6 de julio de 1997"
11,9,17,1176,571,729,1300,"6 de julio de 1997"
11,9,17,1177,646,784,1430,"6 de julio de 1997"
11,10,4,244,412,494,906,"6 de julio de 1997"
11,10,4,245,415,517,932,"6 de julio de 1997"
11,10,4,246,195,220,415,"6 de julio de 1997"
11,10,4,247,486,559,1045,"6 de julio de 1997"
11,10,4,248,480,512,992,"6 de julio de 1997"
11,10,4,249,367,482,849,"6 de julio de 1997"
11,10,4,250,409,440,849,"6 de julio de 1997"
11,10,4,251,404,511,915,"6 de julio de 1997"
11,10,4,252,669,745,1414,"6 de julio de 1997"
11,10,4,253,230,302,532,"6 de julio de 1997"
11,10,4,254,388,458,846,"6 de julio de 1997"
11,10,4,255,252,347,599,"6 de julio de 1997"
11,10,4,256,373,488,861,"6 de julio de 1997"
11,10,4,257,430,543,973,"6 de julio de 1997"
11,10,4,258,365,371,736,"6 de julio de 1997"
11,10,4,259,308,361,669,"6 de julio de 1997"
11,10,4,260,239,225,464,"6 de julio de 1997"
11,10,4,261,345,383,728,"6 de julio de 1997"
11,10,4,262,280,322,602,"6 de julio de 1997"
11,10,4,263,472,471,943,"6 de julio de 1997"
11,10,4,264,442,464,906,"6 de julio de 1997"
11,10,4,265,315,350,665,"6 de julio de 1997"
11,10,4,266,192,231,423,"6 de julio de 1997"
11,10,4,267,125,130,255,"6 de julio de 1997"
11,10,4,268,254,310,564,"6 de julio de 1997"
11,10,4,269,301,329,630,"6 de julio de 1997"
11,10,4,270,176,198,374,"6 de julio de 1997"
11,10,4,271,348,435,783,"6 de julio de 1997"
11,10,4,272,210,240,450,"6 de julio de 1997"
11,10,4,273,321,365,686,"6 de julio de 1997"
11,10,4,274,183,191,374,"6 de julio de 1997"
11,10,4,275,284,359,643,"6 de julio de 1997"
11,10,4,276,276,277,553,"6 de julio de 1997"
11,10,4,277,191,311,502,"6 de julio de 1997"
11,10,4,278,182,256,438,"6 de julio de 1997"
11,10,4,279,194,260,454,"6 de julio de 1997"
11,10,4,280,253,311,564,"6 de julio de 1997"
11,10,4,281,162,236,398,"6 de julio de 1997"
11,10,4,282,147,224,371,"6 de julio de 1997"
11,10,4,283,243,359,602,"6 de julio de 1997"
11,10,4,284,158,185,343,"6 de julio de 1997"
11,10,4,285,227,298,525,"6 de julio de 1997"
11,10,4,286,345,410,755,"6 de julio de 1997"
11,10,4,287,126,147,273,"6 de julio de 1997"
11,10,5,288,519,625,1144,"6 de julio de 1997"
11,10,5,289,504,585,1089,"6 de julio de 1997"
11,10,5,290,564,673,1237,"6 de julio de 1997"
11,10,5,291,494,565,1059,"6 de julio de 1997"
11,10,5,292,387,428,815,"6 de julio de 1997"
11,10,5,293,499,601,1100,"6 de julio de 1997"
11,10,5,294,823,972,1795,"6 de julio de 1997"
11,10,5,295,388,467,855,"6 de julio de 1997"
11,10,5,296,475,574,1049,"6 de julio de 1997"
11,10,5,297,423,502,925,"6 de julio de 1997"
11,10,5,298,140,165,305,"6 de julio de 1997"
11,10,5,299,233,310,543,"6 de julio de 1997"
11,10,5,300,273,333,606,"6 de julio de 1997"
11,10,5,301,276,282,558,"6 de julio de 1997"
11,10,5,302,621,725,1346,"6 de julio de 1997"
11,10,5,303,273,333,606,"6 de julio de 1997"
11,10,5,304,498,508,1006,"6 de julio de 1997"
11,10,5,305,399,465,864,"6 de julio de 1997"
11,10,5,306,151,170,321,"6 de julio de 1997"
11,10,5,307,450,509,959,"6 de julio de 1997"
11,10,5,308,173,214,387,"6 de julio de 1997"
11,10,5,309,374,478,852,"6 de julio de 1997"
11,10,5,310,336,400,736,"6 de julio de 1997"
11,10,5,311,602,683,1285,"6 de julio de 1997"
11,10,5,312,173,207,380,"6 de julio de 1997"
11,10,5,313,316,412,728,"6 de julio de 1997"
11,10,5,314,415,489,904,"6 de julio de 1997"
11,10,5,315,332,358,690,"6 de julio de 1997"
11,10,5,316,280,339,619,"6 de julio de 1997"
11,10,5,317,172,204,376,"6 de julio de 1997"
11,10,5,318,187,226,413,"6 de julio de 1997"
11,10,5,319,347,401,748,"6 de julio de 1997"
11,10,5,320,392,418,810,"6 de julio de 1997"
11,10,5,321,222,230,452,"6 de julio de 1997"
11,10,5,322,504,561,1065,"6 de julio de 1997"
11,10,5,323,223,241,464,"6 de julio de 1997"
11,10,5,324,459,532,991,"6 de julio de 1997"
11,10,5,325,284,334,618,"6 de julio de 1997"
11,10,5,326,482,624,1106,"6 de julio de 1997"
11,10,5,327,405,565,970,"6 de julio de 1997"
11,10,5,328,402,473,875,"6 de julio de 1997"
11,10,5,329,329,411,740,"6 de julio de 1997"
11,10,5,330,355,410,765,"6 de julio de 1997"
11,10,9,609,341,454,795,"6 de julio de 1997"
11,10,9,610,313,387,700,"6 de julio de 1997"
11,10,9,611,569,703,1272,"6 de julio de 1997"
11,10,9,612,418,530,948,"6 de julio de 1997"
11,10,9,613,414,520,934,"6 de julio de 1997"
11,10,9,614,299,382,681,"6 de julio de 1997"
11,10,9,615,349,504,853,"6 de julio de 1997"
11,10,9,616,513,655,1168,"6 de julio de 1997"
11,10,9,617,559,677,1236,"6 de julio de 1997"
11,10,9,618,386,460,846,"6 de julio de 1997"
11,10,9,619,467,596,1063,"6 de julio de 1997"
11,10,9,620,383,457,840,"6 de julio de 1997"
11,10,9,621,352,396,748,"6 de julio de 1997"
11,10,9,622,237,258,495,"6 de julio de 1997"
11,10,9,623,346,398,744,"6 de julio de 1997"
11,10,9,624,182,179,361,"6 de julio de 1997"
11,10,9,625,238,255,493,"6 de julio de 1997"
11,10,9,626,197,233,430,"6 de julio de 1997"
11,10,9,627,345,435,780,"6 de julio de 1997"
11,10,9,628,226,244,470,"6 de julio de 1997"
11,10,9,629,178,233,411,"6 de julio de 1997"
11,10,9,630,601,776,1377,"6 de julio de 1997"
11,10,9,631,280,328,608,"6 de julio de 1997"
11,10,9,632,238,270,508,"6 de julio de 1997"
11,10,9,633,312,328,640,"6 de julio de 1997"
11,10,9,634,217,248,465,"6 de julio de 1997"
11,10,9,635,156,155,311,"6 de julio de 1997"
11,10,9,636,469,616,1085,"6 de julio de 1997"
11,10,9,637,385,501,886,"6 de julio de 1997"
11,10,9,638,438,424,862,"6 de julio de 1997"
11,10,9,639,405,404,809,"6 de julio de 1997"
11,10,9,640,167,198,365,"6 de julio de 1997"
11,10,9,641,432,545,977,"6 de julio de 1997"
11,10,9,642,240,242,482,"6 de julio de 1997"
11,10,9,643,435,522,957,"6 de julio de 1997"
11,10,9,644,258,289,547,"6 de julio de 1997"
11,10,9,645,538,639,1177,"6 de julio de 1997"
11,10,9,646,489,572,1061,"6 de julio de 1997"
11,10,9,647,254,285,539,"6 de julio de 1997"
11,10,9,648,370,467,837,"6 de julio de 1997"
11,10,9,649,449,501,950,"6 de julio de 1997"
11,10,9,650,290,340,630,"6 de julio de 1997"
11,10,9,651,108,127,235,"6 de julio de 1997"
11,10,35,2608,355,395,750,"6 de julio de 1997"
11,10,35,2609,431,536,967,"6 de julio de 1997"
11,10,35,2610,493,594,1087,"6 de julio de 1997"
11,10,35,2611,393,458,851,"6 de julio de 1997"
11,10,35,2612,542,631,1173,"6 de julio de 1997"
11,10,35,2613,389,424,813,"6 de julio de 1997"
11,10,35,2614,533,629,1162,"6 de julio de 1997"
11,10,35,2615,564,654,1218,"6 de julio de 1997"
11,10,35,2616,239,294,533,"6 de julio de 1997"
11,10,35,2617,459,551,1010,"6 de julio de 1997"
11,10,35,2618,399,493,892,"6 de julio de 1997"
11,10,35,2619,368,436,804,"6 de julio de 1997"
11,10,35,2620,530,638,1168,"6 de julio de 1997"
11,10,35,2621,414,495,909,"6 de julio de 1997"
11,10,35,2622,588,683,1271,"6 de julio de 1997"
11,10,35,2623,511,587,1098,"6 de julio de 1997"
11,10,35,2624,444,519,963,"6 de julio de 1997"
11,10,35,2625,653,758,1411,"6 de julio de 1997"
11,10,35,2626,568,658,1226,"6 de julio de 1997"
11,10,35,2627,248,284,532,"6 de julio de 1997"
11,10,35,2628,262,291,553,"6 de julio de 1997"
11,10,35,2629,245,265,510,"6 de julio de 1997"
11,10,35,2630,613,639,1252,"6 de julio de 1997"
11,10,35,2631,379,389,768,"6 de julio de 1997"
11,10,35,2632,372,413,785,"6 de julio de 1997"
11,10,35,2633,580,713,1293,"6 de julio de 1997"
11,10,35,2634,174,209,383,"6 de julio de 1997"
11,10,35,2635,380,400,780,"6 de julio de 1997"
11,10,35,2636,609,659,1268,"6 de julio de 1997"
11,10,35,2637,615,685,1300,"6 de julio de 1997"
11,10,35,2638,707,766,1473,"6 de julio de 1997"
11,10,35,2639,469,505,974,"6 de julio de 1997"
11,10,35,2640,514,631,1145,"6 de julio de 1997"
11,10,35,2641,281,347,628,"6 de julio de 1997"
11,10,35,2642,485,555,1040,"6 de julio de 1997"
11,10,35,2643,410,459,869,"6 de julio de 1997"
11,11,1,1,518,616,1134,"6 de julio de 1997"
11,11,1,2,655,748,1403,"6 de julio de 1997"
11,11,1,3,568,654,1222,"6 de julio de 1997"
11,11,1,4,527,608,1135,"6 de julio de 1997"
11,11,1,5,447,531,978,"6 de julio de 1997"
11,11,1,6,558,602,1160,"6 de julio de 1997"
11,11,1,7,522,594,1116,"6 de julio de 1997"
11,11,1,8,590,675,1265,"6 de julio de 1997"
11,11,1,9,603,723,1326,"6 de julio de 1997"
11,11,1,10,560,593,1153,"6 de julio de 1997"
11,11,1,11,419,494,913,"6 de julio de 1997"
11,11,1,12,482,559,1041,"6 de julio de 1997"
11,11,1,13,238,286,524,"6 de julio de 1997"
11,11,1,14,160,216,376,"6 de julio de 1997"
11,11,1,15,234,287,521,"6 de julio de 1997"
11,11,1,16,474,571,1045,"6 de julio de 1997"
11,11,1,17,356,482,838,"6 de julio de 1997"
11,11,1,18,249,333,582,"6 de julio de 1997"
11,11,1,19,343,434,777,"6 de julio de 1997"
11,11,1,20,540,666,1206,"6 de julio de 1997"
11,11,1,21,439,457,896,"6 de julio de 1997"
11,11,1,22,537,619,1156,"6 de julio de 1997"
11,11,1,23,144,182,326,"6 de julio de 1997"
11,11,1,24,577,669,1246,"6 de julio de 1997"
11,11,1,25,256,322,578,"6 de julio de 1997"
11,11,1,26,469,518,987,"6 de julio de 1997"
11,11,1,27,362,369,731,"6 de julio de 1997"
11,11,1,28,181,192,373,"6 de julio de 1997"
11,11,1,29,303,375,678,"6 de julio de 1997"
11,11,1,30,261,332,593,"6 de julio de 1997"
11,11,1,31,379,431,810,"6 de julio de 1997"
11,11,1,32,331,354,685,"6 de julio de 1997"
11,11,1,33,205,256,461,"6 de julio de 1997"
11,11,1,34,541,673,1214,"6 de julio de 1997"
11,11,1,35,285,272,557,"6 de julio de 1997"
11,11,1,36,274,291,565,"6 de julio de 1997"
11,11,1,37,374,504,878,"6 de julio de 1997"
11,11,1,38,613,671,1284,"6 de julio de 1997"
11,11,1,39,254,260,514,"6 de julio de 1997"
11,11,1,40,439,603,1042,"6 de julio de 1997"
11,11,1,41,447,702,1149,"6 de julio de 1997"
11,11,1,42,363,433,796,"6 de julio de 1997"
11,11,1,43,108,132,240,"6 de julio de 1997"
11,11,1,44,221,253,474,"6 de julio de 1997"
11,11,1,45,146,207,353,"6 de julio de 1997"
11,11,1,46,285,319,604,"6 de julio de 1997"
11,11,1,47,447,566,1013,"6 de julio de 1997"
11,11,1,48,376,450,826,"6 de julio de 1997"
11,11,1,49,212,261,473,"6 de julio de 1997"
11,11,1,50,371,501,872,"6 de julio de 1997"
11,11,16,916,391,457,848,"6 de julio de 1997"
11,11,16,917,525,591,1116,"6 de julio de 1997"
11,11,16,918,320,436,756,"6 de julio de 1997"
11,11,16,919,494,598,1092,"6 de julio de 1997"
11,11,16,920,168,197,365,"6 de julio de 1997"
11,11,16,921,287,320,607,"6 de julio de 1997"
11,11,16,922,509,670,1179,"6 de julio de 1997"
11,11,16,923,617,707,1324,"6 de julio de 1997"
11,11,16,924,242,270,512,"6 de julio de 1997"
11,11,16,925,455,567,1022,"6 de julio de 1997"
11,11,16,926,158,218,376,"6 de julio de 1997"
11,11,16,927,415,528,943,"6 de julio de 1997"
11,11,16,928,488,613,1101,"6 de julio de 1997"
11,11,23,1912,419,440,859,"6 de julio de 1997"
11,11,23,1913,604,677,1281,"6 de julio de 1997"
11,11,23,1914,248,291,539,"6 de julio de 1997"
11,11,23,1915,491,613,1104,"6 de julio de 1997"
11,11,23,1916,449,523,972,"6 de julio de 1997"
11,11,23,1917,428,521,949,"6 de julio de 1997"
11,11,23,1918,381,497,878,"6 de julio de 1997"
11,11,23,1919,301,352,653,"6 de julio de 1997"
11,11,23,1920,348,392,740,"6 de julio de 1997"
11,11,23,1921,364,400,764,"6 de julio de 1997"
11,11,23,1922,441,513,954,"6 de julio de 1997"
11,11,23,1923,350,392,742,"6 de julio de 1997"
11,11,23,1924,434,525,959,"6 de julio de 1997"
11,11,23,1925,263,358,621,"6 de julio de 1997"
11,11,23,1926,449,583,1032,"6 de julio de 1997"
11,11,23,1927,479,541,1020,"6 de julio de 1997"
11,11,23,1928,361,406,767,"6 de julio de 1997"
11,11,23,1929,476,591,1067,"6 de julio de 1997"
11,11,23,1930,438,460,898,"6 de julio de 1997"
11,11,23,1931,377,505,882,"6 de julio de 1997"
11,11,23,1932,241,280,521,"6 de julio de 1997"
11,11,23,1933,133,130,263,"6 de julio de 1997"
11,11,23,1934,102,127,229,"6 de julio de 1997"
11,11,23,1935,123,135,258,"6 de julio de 1997"
11,11,23,1936,101,107,208,"6 de julio de 1997"
11,11,23,1937,106,104,210,"6 de julio de 1997"
11,11,23,1938,66,54,120,"6 de julio de 1997"
11,11,23,1939,150,150,300,"6 de julio de 1997"
11,11,23,1940,377,478,855,"6 de julio de 1997"
11,11,23,1941,175,187,362,"6 de julio de 1997"
11,11,23,1942,289,294,583,"6 de julio de 1997"
11,11,23,1943,404,485,889,"6 de julio de 1997"
11,11,23,1944,346,404,750,"6 de julio de 1997"
11,11,23,1945,270,274,544,"6 de julio de 1997"
11,11,23,1946,131,117,248,"6 de julio de 1997"
11,11,23,1947,420,532,952,"6 de julio de 1997"
11,11,23,1948,433,483,916,"6 de julio de 1997"
11,11,23,1949,314,404,718,"6 de julio de 1997"
11,11,23,1950,123,128,251,"6 de julio de 1997"
11,11,23,1951,103,124,227,"6 de julio de 1997"
11,11,23,1952,251,365,616,"6 de julio de 1997"
11,11,23,1953,221,245,466,"6 de julio de 1997"
11,11,23,1954,237,238,475,"6 de julio de 1997"
11,11,23,1955,201,225,426,"6 de julio de 1997"
11,11,23,1956,338,420,758,"6 de julio de 1997"
11,11,23,1957,347,322,669,"6 de julio de 1997"
11,11,23,1958,131,113,244,"6 de julio de 1997"
11,11,23,1959,276,283,559,"6 de julio de 1997"
11,11,23,1960,341,445,786,"6 de julio de 1997"
11,11,23,1961,210,241,451,"6 de julio de 1997"
11,11,23,1962,330,396,726,"6 de julio de 1997"
11,11,23,1963,463,505,968,"6 de julio de 1997"
11,11,23,1964,361,426,787,"6 de julio de 1997"
11,11,23,1965,162,205,367,"6 de julio de 1997"
11,11,23,1966,289,324,613,"6 de julio de 1997"
11,11,23,1967,409,517,926,"6 de julio de 1997"
11,11,23,1968,498,598,1096,"6 de julio de 1997"
11,11,23,1969,605,687,1292,"6 de julio de 1997"
11,11,23,1970,327,373,700,"6 de julio de 1997"
11,11,23,1971,341,427,768,"6 de julio de 1997"
11,11,23,1972,318,365,683,"6 de julio de 1997"
11,11,23,1973,371,472,843,"6 de julio de 1997"
11,11,23,1974,746,841,1587,"6 de julio de 1997"
11,11,23,1975,382,429,811,"6 de julio de 1997"
11,11,23,1976,506,538,1044,"6 de julio de 1997"
11,11,23,1977,384,382,766,"6 de julio de 1997"
11,11,23,1978,131,154,285,"6 de julio de 1997"
11,11,23,1979,382,443,825,"6 de julio de 1997"
11,11,23,1980,186,214,400,"6 de julio de 1997"
11,11,23,1981,344,339,683,"6 de julio de 1997"
11,11,23,1982,681,808,1489,"6 de julio de 1997"
11,11,23,1983,381,427,808,"6 de julio de 1997"
11,11,23,1984,220,270,490,"6 de julio de 1997"
11,11,23,1985,257,304,561,"6 de julio de 1997"
11,11,23,1986,405,494,899,"6 de julio de 1997"
11,11,23,1987,514,593,1107,"6 de julio de 1997"
11,11,23,1988,443,550,993,"6 de julio de 1997"
11,11,23,1989,191,245,436,"6 de julio de 1997"
11,11,23,1990,402,531,933,"6 de julio de 1997"
11,11,23,1991,316,420,736,"6 de julio de 1997"
11,11,23,1992,262,309,571,"6 de julio de 1997"
11,11,23,1993,321,398,719,"6 de julio de 1997"
11,11,23,1994,330,394,724,"6 de julio de 1997"
11,11,23,1995,271,317,588,"6 de julio de 1997"
11,11,23,1996,406,483,889,"6 de julio de 1997"
11,11,23,1997,222,276,498,"6 de julio de 1997"
11,11,23,1998,385,492,877,"6 de julio de 1997"
11,11,23,1999,219,249,468,"6 de julio de 1997"
11,11,23,2000,88,102,190,"6 de julio de 1997"
11,11,23,2001,311,408,719,"6 de julio de 1997"
11,11,23,2002,362,478,840,"6 de julio de 1997"
11,11,23,2003,354,454,808,"6 de julio de 1997"
11,11,23,2004,225,278,503,"6 de julio de 1997"
11,11,23,2005,419,483,902,"6 de julio de 1997"
11,11,23,2006,381,478,859,"6 de julio de 1997"
11,11,23,2007,372,360,732,"6 de julio de 1997"
11,11,23,2008,407,478,885,"6 de julio de 1997"
11,11,23,2009,474,604,1078,"6 de julio de 1997"
11,11,23,2010,214,299,513,"6 de julio de 1997"
11,11,23,2011,288,357,645,"6 de julio de 1997"
11,11,23,2012,292,376,668,"6 de julio de 1997"
11,11,23,2013,283,362,645,"6 de julio de 1997"
11,11,23,2014,243,349,592,"6 de julio de 1997"
11,11,23,2015,84,143,227,"6 de julio de 1997"
11,11,23,2016,352,409,761,"6 de julio de 1997"
11,11,23,2017,439,588,1027,"6 de julio de 1997"
11,11,23,2018,562,685,1247,"6 de julio de 1997"
11,11,23,2019,227,296,523,"6 de julio de 1997"
11,11,23,2020,255,358,613,"6 de julio de 1997"
11,11,23,2021,361,498,859,"6 de julio de 1997"
11,11,23,2022,177,255,432,"6 de julio de 1997"
11,11,23,2023,284,415,699,"6 de julio de 1997"
11,11,23,2024,244,347,591,"6 de julio de 1997"
11,11,23,2025,392,517,909,"6 de julio de 1997"
11,12,7,336,125,145,270,"6 de julio de 1997"
11,12,7,337,192,220,412,"6 de julio de 1997"
11,12,7,338,281,311,592,"6 de julio de 1997"
11,12,7,339,215,263,478,"6 de julio de 1997"
11,12,7,340,558,581,1139,"6 de julio de 1997"
11,12,7,341,898,1074,1972,"6 de julio de 1997"
11,12,7,342,409,468,877,"6 de julio de 1997"
11,12,7,343,298,336,634,"6 de julio de 1997"
11,12,7,344,296,364,660,"6 de julio de 1997"
11,12,7,345,337,387,724,"6 de julio de 1997"
11,12,7,346,379,473,852,"6 de julio de 1997"
11,12,7,347,541,706,1247,"6 de julio de 1997"
11,12,7,348,454,548,1002,"6 de julio de 1997"
11,12,7,349,533,586,1119,"6 de julio de 1997"
11,12,7,350,509,590,1099,"6 de julio de 1997"
11,12,7,351,501,605,1106,"6 de julio de 1997"
11,12,7,352,586,725,1311,"6 de julio de 1997"
11,12,7,353,526,611,1137,"6 de julio de 1997"
11,12,7,354,300,324,624,"6 de julio de 1997"
11,12,7,355,662,728,1390,"6 de julio de 1997"
11,12,7,356,302,342,644,"6 de julio de 1997"
11,12,7,357,257,308,565,"6 de julio de 1997"
11,12,7,358,244,295,539,"6 de julio de 1997"
11,12,7,359,657,697,1354,"6 de julio de 1997"
11,12,7,360,583,695,1278,"6 de julio de 1997"
11,12,7,361,412,466,878,"6 de julio de 1997"
11,12,7,362,722,805,1527,"6 de julio de 1997"
11,12,7,363,404,484,888,"6 de julio de 1997"
11,12,7,364,419,505,924,"6 de julio de 1997"
11,12,7,365,303,341,644,"6 de julio de 1997"
11,12,7,366,1005,1218,2223,"6 de julio de 1997"
11,12,7,367,368,415,783,"6 de julio de 1997"
11,12,7,368,405,494,899,"6 de julio de 1997"
11,12,7,369,423,481,904,"6 de julio de 1997"
11,12,7,370,565,689,1254,"6 de julio de 1997"
11,12,7,371,512,582,1094,"6 de julio de 1997"
11,12,7,372,306,347,653,"6 de julio de 1997"
11,12,7,373,545,618,1163,"6 de julio de 1997"
11,12,7,374,366,408,774,"6 de julio de 1997"
11,12,7,375,502,483,985,"6 de julio de 1997"
11,12,7,376,285,318,603,"6 de julio de 1997"
11,12,7,377,415,466,881,"6 de julio de 1997"
11,12,7,378,444,513,957,"6 de julio de 1997"
11,12,7,379,472,524,996,"6 de julio de 1997"
11,12,7,380,312,360,672,"6 de julio de 1997"
11,12,7,381,533,619,1152,"6 de julio de 1997"
11,12,7,382,383,481,864,"6 de julio de 1997"
11,12,7,383,357,380,737,"6 de julio de 1997"
11,12,7,384,500,571,1071,"6 de julio de 1997"
11,12,7,385,267,290,557,"6 de julio de 1997"
11,12,7,386,461,543,1004,"6 de julio de 1997"
11,12,7,387,544,614,1158,"6 de julio de 1997"
11,12,7,388,516,582,1098,"6 de julio de 1997"
11,12,7,389,386,457,843,"6 de julio de 1997"
11,12,7,390,564,642,1206,"6 de julio de 1997"
11,12,7,391,446,532,978,"6 de julio de 1997"
11,12,7,392,542,631,1173,"6 de julio de 1997"
11,12,7,393,411,494,905,"6 de julio de 1997"
11,12,7,394,345,424,769,"6 de julio de 1997"
11,12,7,395,209,258,467,"6 de julio de 1997"
11,12,7,396,290,358,648,"6 de julio de 1997"
11,12,7,397,386,456,842,"6 de julio de 1997"
11,12,7,398,519,611,1130,"6 de julio de 1997"
11,12,7,399,545,614,1159,"6 de julio de 1997"
11,12,7,400,439,506,945,"6 de julio de 1997"
11,12,7,401,433,483,916,"6 de julio de 1997"
11,12,7,402,778,968,1746,"6 de julio de 1997"
11,12,7,403,289,367,656,"6 de julio de 1997"
11,12,7,404,269,303,572,"6 de julio de 1997"
11,12,7,405,295,416,711,"6 de julio de 1997"
11,12,7,406,353,431,784,"6 de julio de 1997"
11,12,7,407,509,533,1042,"6 de julio de 1997"
11,12,7,408,387,470,857,"6 de julio de 1997"
11,12,7,409,313,346,659,"6 de julio de 1997"
11,12,7,410,527,571,1098,"6 de julio de 1997"
11,12,7,411,519,581,1100,"6 de julio de 1997"
11,12,7,412,920,1113,2033,"6 de julio de 1997"
11,12,7,413,442,533,975,"6 de julio de 1997"
11,12,7,414,387,432,819,"6 de julio de 1997"
11,12,7,415,564,652,1216,"6 de julio de 1997"
11,12,7,416,549,651,1200,"6 de julio de 1997"
11,12,7,417,340,394,734,"6 de julio de 1997"
11,12,7,418,331,393,724,"6 de julio de 1997"
11,12,7,419,340,426,766,"6 de julio de 1997"
11,12,7,420,254,327,581,"6 de julio de 1997"
11,12,7,421,375,457,832,"6 de julio de 1997"
11,12,7,422,488,564,1052,"6 de julio de 1997"
11,12,7,423,351,403,754,"6 de julio de 1997"
11,12,7,424,358,449,807,"6 de julio de 1997"
11,12,7,425,295,347,642,"6 de julio de 1997"
11,12,7,426,400,417,817,"6 de julio de 1997"
11,12,7,427,352,419,771,"6 de julio de 1997"
11,12,7,428,235,277,512,"6 de julio de 1997"
11,12,7,429,219,264,483,"6 de julio de 1997"
11,12,7,430,86,107,193,"6 de julio de 1997"
11,12,7,431,486,613,1099,"6 de julio de 1997"
11,12,7,432,386,424,810,"6 de julio de 1997"
11,12,7,433,269,316,585,"6 de julio de 1997"
11,12,7,434,367,422,789,"6 de julio de 1997"
11,12,7,435,532,529,1061,"6 de julio de 1997"
11,12,7,436,492,583,1075,"6 de julio de 1997"
11,12,7,437,394,497,891,"6 de julio de 1997"
11,12,7,438,423,524,947,"6 de julio de 1997"
11,12,7,439,243,321,564,"6 de julio de 1997"
11,12,7,440,128,161,289,"6 de julio de 1997"
11,12,7,441,359,446,805,"6 de julio de 1997"
11,12,7,442,483,582,1065,"6 de julio de 1997"
11,12,7,443,524,638,1162,"6 de julio de 1997"
11,12,7,444,300,343,643,"6 de julio de 1997"
11,12,7,445,435,548,983,"6 de julio de 1997"
11,12,7,446,361,396,757,"6 de julio de 1997"
11,12,7,447,204,270,474,"6 de julio de 1997"
11,12,7,448,383,486,869,"6 de julio de 1997"
11,12,7,449,380,416,796,"6 de julio de 1997"
11,12,7,450,660,728,1388,"6 de julio de 1997"
11,12,7,451,466,512,978,"6 de julio de 1997"
11,12,7,452,487,584,1071,"6 de julio de 1997"
11,12,7,453,519,560,1079,"6 de julio de 1997"
11,12,7,454,419,511,930,"6 de julio de 1997"
11,12,7,455,471,527,998,"6 de julio de 1997"
11,12,7,456,478,538,1016,"6 de julio de 1997"
11,12,7,457,356,404,760,"6 de julio de 1997"
11,12,7,458,195,225,420,"6 de julio de 1997"
11,12,7,459,540,617,1157,"6 de julio de 1997"
11,12,7,460,308,391,699,"6 de julio de 1997"
11,12,7,461,221,240,461,"6 de julio de 1997"
11,12,7,462,172,206,378,"6 de julio de 1997"
11,12,7,463,305,322,627,"6 de julio de 1997"
11,12,7,464,242,312,554,"6 de julio de 1997"
11,12,7,465,457,517,974,"6 de julio de 1997"
11,12,7,466,588,670,1258,"6 de julio de 1997"
11,12,7,467,396,437,833,"6 de julio de 1997"
11,12,7,468,370,425,795,"6 de julio de 1997"
11,12,7,469,295,315,610,"6 de julio de 1997"
11,12,7,470,276,334,610,"6 de julio de 1997"
11,12,7,471,594,756,1350,"6 de julio de 1997"
11,12,7,472,434,487,921,"6 de julio de 1997"
11,12,7,473,541,643,1184,"6 de julio de 1997"
11,12,7,474,540,660,1200,"6 de julio de 1997"
11,12,7,475,490,557,1047,"6 de julio de 1997"
11,12,7,476,591,657,1248,"6 de julio de 1997"
11,12,7,477,592,654,1246,"6 de julio de 1997"
11,12,7,478,280,311,591,"6 de julio de 1997"
11,12,7,479,519,596,1115,"6 de julio de 1997"
11,12,7,480,526,626,1152,"6 de julio de 1997"
11,12,7,481,426,499,925,"6 de julio de 1997"
11,12,7,482,418,481,899,"6 de julio de 1997"
11,12,7,483,567,672,1239,"6 de julio de 1997"
11,12,7,484,218,298,516,"6 de julio de 1997"
11,12,7,485,244,303,547,"6 de julio de 1997"
11,12,7,486,448,551,999,"6 de julio de 1997"
11,12,7,487,369,421,790,"6 de julio de 1997"
11,12,7,488,291,319,610,"6 de julio de 1997"
11,12,7,489,414,519,933,"6 de julio de 1997"
11,12,7,490,444,597,1041,"6 de julio de 1997"
11,12,7,491,442,556,998,"6 de julio de 1997"
11,12,7,492,258,332,590,"6 de julio de 1997"
11,12,7,493,202,265,467,"6 de julio de 1997"
11,12,7,494,247,302,549,"6 de julio de 1997"
11,12,7,495,418,516,934,"6 de julio de 1997"
11,12,7,496,237,269,506,"6 de julio de 1997"
11,12,7,497,463,484,947,"6 de julio de 1997"
11,12,7,498,352,368,720,"6 de julio de 1997"
11,12,7,499,433,471,904,"6 de julio de 1997"
11,12,7,500,438,533,971,"6 de julio de 1997"
11,12,7,501,639,761,1400,"6 de julio de 1997"
11,12,7,502,333,378,711,"6 de julio de 1997"
11,12,7,503,637,753,1390,"6 de julio de 1997"
11,12,7,504,473,549,1022,"6 de julio de 1997"
11,12,7,505,590,674,1264,"6 de julio de 1997"
11,12,7,506,327,383,710,"6 de julio de 1997"
11,12,7,507,529,622,1151,"6 de julio de 1997"
11,12,7,508,193,224,417,"6 de julio de 1997"
11,12,7,509,402,442,844,"6 de julio de 1997"
11,12,7,510,356,414,770,"6 de julio de 1997"
11,12,7,511,422,517,939,"6 de julio de 1997"
11,12,7,512,422,501,923,"6 de julio de 1997"
11,12,7,513,589,679,1268,"6 de julio de 1997"
11,12,7,514,580,711,1291,"6 de julio de 1997"
11,12,7,515,61,70,131,"6 de julio de 1997"
11,12,7,516,132,172,304,"6 de julio de 1997"
11,12,7,517,289,341,630,"6 de julio de 1997"
11,12,7,518,590,690,1280,"6 de julio de 1997"
11,12,7,519,505,633,1138,"6 de julio de 1997"
11,12,7,520,488,602,1090,"6 de julio de 1997"
11,12,7,521,597,691,1288,"6 de julio de 1997"
11,12,7,522,106,121,227,"6 de julio de 1997"
11,12,7,523,393,453,846,"6 de julio de 1997"
11,12,7,524,234,275,509,"6 de julio de 1997"
11,12,7,525,251,321,572,"6 de julio de 1997"
11,12,7,526,606,641,1247,"6 de julio de 1997"
11,12,7,527,346,384,730,"6 de julio de 1997"
11,12,7,528,351,384,735,"6 de julio de 1997"
11,12,7,529,649,830,1479,"6 de julio de 1997"
11,12,7,530,505,625,1130,"6 de julio de 1997"
11,12,7,531,384,425,809,"6 de julio de 1997"
11,12,7,532,366,473,839,"6 de julio de 1997"
11,12,7,533,305,362,667,"6 de julio de 1997"
11,12,7,534,227,240,467,"6 de julio de 1997"
11,12,7,535,110,111,221,"6 de julio de 1997"
11,12,7,536,239,303,542,"6 de julio de 1997"
11,12,7,537,214,242,456,"6 de julio de 1997"
11,12,7,538,367,473,840,"6 de julio de 1997"
11,12,7,539,317,391,708,"6 de julio de 1997"
11,12,7,540,266,326,592,"6 de julio de 1997"
11,12,7,541,308,386,694,"6 de julio de 1997"
11,12,7,542,343,454,797,"6 de julio de 1997"
11,12,7,543,358,438,796,"6 de julio de 1997"
11,12,7,544,106,170,276,"6 de julio de 1997"
11,12,7,545,244,359,603,"6 de julio de 1997"
11,12,7,546,439,591,1030,"6 de julio de 1997"
11,12,7,547,428,552,980,"6 de julio de 1997"
11,12,7,548,37,57,94,"6 de julio de 1997"
11,12,7,549,133,163,296,"6 de julio de 1997"
11,12,7,550,292,439,731,"6 de julio de 1997"
11,12,7,551,337,411,748,"6 de julio de 1997"
11,12,7,552,350,436,786,"6 de julio de 1997"
11,12,7,553,226,276,502,"6 de julio de 1997"
11,12,7,554,350,390,740,"6 de julio de 1997"
11,12,7,555,289,348,637,"6 de julio de 1997"
11,12,7,556,336,446,782,"6 de julio de 1997"
11,12,7,557,298,355,653,"6 de julio de 1997"
11,12,7,558,539,686,1225,"6 de julio de 1997"
11,12,7,559,188,246,434,"6 de julio de 1997"
11,12,7,560,232,275,507,"6 de julio de 1997"
11,12,7,561,107,161,268,"6 de julio de 1997"
11,12,7,562,31,36,67,"6 de julio de 1997"
11,12,7,563,494,653,1147,"6 de julio de 1997"
11,12,7,564,309,364,673,"6 de julio de 1997"
11,12,7,565,206,237,443,"6 de julio de 1997"
11,12,7,566,124,238,362,"6 de julio de 1997"
11,13,11,662,288,335,623,"6 de julio de 1997"
11,13,11,663,392,456,848,"6 de julio de 1997"
11,13,11,664,489,575,1064,"6 de julio de 1997"
11,13,11,665,386,446,832,"6 de julio de 1997"
11,13,11,666,374,444,818,"6 de julio de 1997"
11,13,11,667,362,366,728,"6 de julio de 1997"
11,13,11,668,494,537,1031,"6 de julio de 1997"
11,13,11,669,554,590,1144,"6 de julio de 1997"
11,13,11,670,593,693,1286,"6 de julio de 1997"
11,13,11,671,684,816,1500,"6 de julio de 1997"
11,13,11,672,509,500,1009,"6 de julio de 1997"
11,13,11,673,321,383,704,"6 de julio de 1997"
11,13,11,674,308,370,678,"6 de julio de 1997"
11,13,11,675,331,395,726,"6 de julio de 1997"
11,13,11,676,646,731,1377,"6 de julio de 1997"
11,13,11,677,577,651,1228,"6 de julio de 1997"
11,13,11,678,366,444,810,"6 de julio de 1997"
11,13,11,679,547,603,1150,"6 de julio de 1997"
11,13,11,680,369,427,796,"6 de julio de 1997"
11,13,11,681,531,636,1167,"6 de julio de 1997"
11,13,11,682,627,693,1320,"6 de julio de 1997"
11,13,11,683,605,692,1297,"6 de julio de 1997"
11,13,11,684,574,656,1230,"6 de julio de 1997"
11,13,11,685,558,605,1163,"6 de julio de 1997"
11,13,11,686,326,331,657,"6 de julio de 1997"
11,13,11,687,337,380,717,"6 de julio de 1997"
11,13,11,688,505,559,1064,"6 de julio de 1997"
11,13,11,689,522,564,1086,"6 de julio de 1997"
11,13,11,690,412,457,869,"6 de julio de 1997"
11,13,11,691,462,503,965,"6 de julio de 1997"
11,13,11,692,338,418,756,"6 de julio de 1997"
11,13,11,693,78,79,157,"6 de julio de 1997"
11,13,11,694,581,621,1202,"6 de julio de 1997"
11,13,11,695,504,583,1087,"6 de julio de 1997"
11,13,11,696,340,376,716,"6 de julio de 1997"
11,13,11,697,539,661,1200,"6 de julio de 1997"
11,13,11,698,431,511,942,"6 de julio de 1997"
11,13,11,699,392,459,851,"6 de julio de 1997"
11,13,11,700,277,358,635,"6 de julio de 1997"
11,13,11,701,378,473,851,"6 de julio de 1997"
11,13,11,702,257,290,547,"6 de julio de 1997"
11,13,11,703,244,283,527,"6 de julio de 1997"
11,13,11,704,88,98,186,"6 de julio de 1997"
11,13,11,705,469,566,1035,"6 de julio de 1997"
11,13,11,706,120,139,259,"6 de julio de 1997"
11,13,11,707,297,410,707,"6 de julio de 1997"
11,13,11,708,403,494,897,"6 de julio de 1997"
11,13,11,709,317,377,694,"6 de julio de 1997"
11,13,11,710,334,381,715,"6 de julio de 1997"
11,13,11,711,147,196,343,"6 de julio de 1997"
11,13,11,712,275,370,645,"6 de julio de 1997"
11,13,11,713,360,473,833,"6 de julio de 1997"
11,13,11,714,216,312,528,"6 de julio de 1997"
11,13,11,715,336,478,814,"6 de julio de 1997"
11,13,11,716,375,444,819,"6 de julio de 1997"
11,13,18,1178,484,625,1109,"6 de julio de 1997"
11,13,18,1179,322,372,694,"6 de julio de 1997"
11,13,18,1180,260,320,580,"6 de julio de 1997"
11,13,18,1181,137,174,311,"6 de julio de 1997"
11,13,18,1182,508,546,1054,"6 de julio de 1997"
11,13,18,1183,672,707,1379,"6 de julio de 1997"
11,13,18,1184,513,574,1087,"6 de julio de 1997"
11,13,18,1185,436,472,908,"6 de julio de 1997"
11,13,18,1186,351,396,747,"6 de julio de 1997"
11,13,18,1187,194,232,426,"6 de julio de 1997"
11,13,18,1188,499,522,1021,"6 de julio de 1997"
11,13,18,1189,208,194,402,"6 de julio de 1997"
11,13,18,1190,198,202,400,"6 de julio de 1997"
11,13,18,1191,412,435,847,"6 de julio de 1997"
11,13,18,1192,527,561,1088,"6 de julio de 1997"
11,13,18,1193,326,385,711,"6 de julio de 1997"
11,13,18,1194,400,468,868,"6 de julio de 1997"
11,13,18,1195,377,426,803,"6 de julio de 1997"
11,13,18,1196,396,477,873,"6 de julio de 1997"
11,13,18,1197,363,422,785,"6 de julio de 1997"
11,13,18,1198,278,332,610,"6 de julio de 1997"
11,13,18,1199,236,361,597,"6 de julio de 1997"
11,13,18,1200,200,297,497,"6 de julio de 1997"
11,13,18,1201,182,259,441,"6 de julio de 1997"
11,13,18,1202,150,220,370,"6 de julio de 1997"
11,13,18,1203,155,197,352,"6 de julio de 1997"
11,13,42,2816,502,574,1076,"6 de julio de 1997"
11,13,42,2817,361,454,815,"6 de julio de 1997"
11,13,42,2818,514,590,1104,"6 de julio de 1997"
11,13,42,2819,436,521,957,"6 de julio de 1997"
11,13,42,2820,366,446,812,"6 de julio de 1997"
11,13,42,2821,431,578,1009,"6 de julio de 1997"
11,13,42,2822,383,511,894,"6 de julio de 1997"
11,13,42,2823,605,709,1314,"6 de julio de 1997"
11,13,42,2824,683,784,1467,"6 de julio de 1997"
11,13,42,2825,595,712,1307,"6 de julio de 1997"
11,13,42,2826,401,438,839,"6 de julio de 1997"
11,13,42,2827,240,307,547,"6 de julio de 1997"
11,13,42,2828,511,641,1152,"6 de julio de 1997"
11,13,42,2829,550,663,1213,"6 de julio de 1997"
11,13,42,2830,502,557,1059,"6 de julio de 1997"
11,13,42,2831,562,677,1239,"6 de julio de 1997"
11,13,42,2832,515,577,1092,"6 de julio de 1997"
11,13,42,2833,491,563,1054,"6 de julio de 1997"
11,13,42,2834,485,575,1060,"6 de julio de 1997"
11,13,42,2835,249,286,535,"6 de julio de 1997"
11,13,42,2836,280,344,624,"6 de julio de 1997"
11,13,42,2837,531,613,1144,"6 de julio de 1997"
11,13,42,2838,530,613,1143,"6 de julio de 1997"
11,13,42,2839,589,700,1289,"6 de julio de 1997"
11,13,42,2840,453,521,974,"6 de julio de 1997"
11,13,42,2841,345,407,752,"6 de julio de 1997"
11,13,42,2842,461,545,1006,"6 de julio de 1997"
11,13,42,2843,551,616,1167,"6 de julio de 1997"
11,13,42,2844,425,535,960,"6 de julio de 1997"
11,13,42,2845,417,483,900,"6 de julio de 1997"
11,13,42,2846,194,219,413,"6 de julio de 1997"
11,13,42,2847,470,526,996,"6 de julio de 1997"
11,13,42,2848,514,624,1138,"6 de julio de 1997"
11,13,42,2849,448,572,1020,"6 de julio de 1997"
11,13,42,2850,473,600,1073,"6 de julio de 1997"
11,13,42,2851,365,564,929,"6 de julio de 1997"
11,13,42,2852,526,721,1247,"6 de julio de 1997"
11,13,42,2853,375,530,905,"6 de julio de 1997"
11,13,42,2854,176,238,414,"6 de julio de 1997"
11,13,42,2855,465,543,1008,"6 de julio de 1997"
11,13,42,2856,447,489,936,"6 de julio de 1997"
11,13,42,2857,407,555,962,"6 de julio de 1997"
11,13,42,2858,252,327,579,"6 de julio de 1997"
11,13,42,2859,245,344,589,"6 de julio de 1997"
11,13,42,2860,553,609,1162,"6 de julio de 1997"
11,13,42,2861,360,484,844,"6 de julio de 1997"
11,13,42,2862,412,446,858,"6 de julio de 1997"
11,13,42,2863,472,579,1051,"6 de julio de 1997"
11,13,42,2864,508,569,1077,"6 de julio de 1997"
11,13,42,2865,352,450,802,"6 de julio de 1997"
11,13,42,2866,307,395,702,"6 de julio de 1997"
11,13,42,2867,537,579,1116,"6 de julio de 1997"
11,13,42,2868,517,568,1085,"6 de julio de 1997"
11,13,42,2869,474,518,992,"6 de julio de 1997"
11,13,42,2870,544,703,1247,"6 de julio de 1997"
11,13,42,2871,571,669,1240,"6 de julio de 1997"
11,13,42,2872,571,726,1297,"6 de julio de 1997"
11,13,42,2873,569,695,1264,"6 de julio de 1997"
11,13,42,2874,454,483,937,"6 de julio de 1997"
11,13,42,2875,540,728,1268,"6 de julio de 1997"
11,13,42,2876,522,615,1137,"6 de julio de 1997"
11,13,42,2877,473,574,1047,"6 de julio de 1997"
11,13,42,2878,460,526,986,"6 de julio de 1997"
11,13,42,2879,373,442,815,"6 de julio de 1997"
11,13,42,2880,443,567,1010,"6 de julio de 1997"
11,13,42,2881,324,459,783,"6 de julio de 1997"
11,13,42,2882,354,607,961,"6 de julio de 1997"
11,13,42,2883,390,793,1183,"6 de julio de 1997"
11,13,42,2884,338,429,767,"6 de julio de 1997"
11,13,42,2885,314,399,713,"6 de julio de 1997"
11,13,42,2886,358,477,835,"6 de julio de 1997"
11,13,42,2887,403,592,995,"6 de julio de 1997"
11,13,42,2888,465,541,1006,"6 de julio de 1997"
11,13,42,2889,365,489,854,"6 de julio de 1997"
11,13,42,2890,389,541,930,"6 de julio de 1997"
11,14,2,51,336,442,778,"6 de julio de 1997"
11,14,2,52,381,436,817,"6 de julio de 1997"
11,14,2,53,427,519,946,"6 de julio de 1997"
11,14,2,54,387,450,837,"6 de julio de 1997"
11,14,2,55,304,343,647,"6 de julio de 1997"
11,14,2,56,552,653,1205,"6 de julio de 1997"
11,14,2,57,286,342,628,"6 de julio de 1997"
11,14,2,58,242,289,531,"6 de julio de 1997"
11,14,2,59,493,576,1069,"6 de julio de 1997"
11,14,2,60,379,509,888,"6 de julio de 1997"
11,14,2,61,388,506,894,"6 de julio de 1997"
11,14,2,62,420,458,878,"6 de julio de 1997"
11,14,2,63,307,418,725,"6 de julio de 1997"
11,14,2,64,369,421,790,"6 de julio de 1997"
11,14,2,65,507,551,1058,"6 de julio de 1997"
11,14,2,66,385,454,839,"6 de julio de 1997"
11,14,2,67,609,670,1279,"6 de julio de 1997"
11,14,2,68,397,509,906,"6 de julio de 1997"
11,14,2,69,295,352,647,"6 de julio de 1997"
11,14,2,70,465,539,1004,"6 de julio de 1997"
11,14,2,71,387,459,846,"6 de julio de 1997"
11,14,2,72,516,591,1107,"6 de julio de 1997"
11,14,2,73,387,482,869,"6 de julio de 1997"
11,14,2,74,753,856,1609,"6 de julio de 1997"
11,14,2,75,330,361,691,"6 de julio de 1997"
11,14,2,76,409,468,877,"6 de julio de 1997"
11,14,2,77,562,699,1261,"6 de julio de 1997"
11,14,2,78,380,443,823,"6 de julio de 1997"
11,14,2,79,297,384,681,"6 de julio de 1997"
11,14,2,80,484,580,1064,"6 de julio de 1997"
11,14,2,81,503,611,1114,"6 de julio de 1997"
11,14,2,82,225,262,487,"6 de julio de 1997"
11,14,2,83,493,576,1069,"6 de julio de 1997"
11,14,2,84,454,505,959,"6 de julio de 1997"
11,14,2,85,422,490,912,"6 de julio de 1997"
11,14,2,86,610,647,1257,"6 de julio de 1997"
11,14,2,87,127,140,267,"6 de julio de 1997"
11,14,2,88,80,80,160,"6 de julio de 1997"
11,14,2,89,281,289,570,"6 de julio de 1997"
11,14,2,90,163,182,345,"6 de julio de 1997"
11,14,2,91,366,491,857,"6 de julio de 1997"
11,14,2,92,240,300,540,"6 de julio de 1997"
11,14,2,93,391,402,793,"6 de julio de 1997"
11,14,2,94,382,446,828,"6 de julio de 1997"
11,14,2,95,283,316,599,"6 de julio de 1997"
11,14,2,96,287,379,666,"6 de julio de 1997"
11,14,2,97,334,397,731,"6 de julio de 1997"
11,14,2,98,177,200,377,"6 de julio de 1997"
11,14,2,99,377,465,842,"6 de julio de 1997"
11,14,2,100,338,567,905,"6 de julio de 1997"
11,14,2,101,367,440,807,"6 de julio de 1997"
11,14,2,102,356,469,825,"6 de julio de 1997"
11,14,2,103,386,503,889,"6 de julio de 1997"
11,14,2,104,319,432,751,"6 de julio de 1997"
11,14,2,105,158,188,346,"6 de julio de 1997"
11,14,2,106,263,319,582,"6 de julio de 1997"
11,14,2,107,266,360,626,"6 de julio de 1997"
11,14,2,108,293,392,685,"6 de julio de 1997"
11,14,2,109,316,375,691,"6 de julio de 1997"
11,14,2,110,181,201,382,"6 de julio de 1997"
11,14,2,111,288,302,590,"6 de julio de 1997"
11,14,2,112,230,283,513,"6 de julio de 1997"
11,14,2,113,271,279,550,"6 de julio de 1997"
11,14,2,114,530,650,1180,"6 de julio de 1997"
11,14,2,115,472,542,1014,"6 de julio de 1997"
11,14,2,116,339,447,786,"6 de julio de 1997"
11,14,2,117,248,314,562,"6 de julio de 1997"
11,14,2,118,401,551,952,"6 de julio de 1997"
11,14,2,119,238,290,528,"6 de julio de 1997"
11,14,2,120,267,323,590,"6 de julio de 1997"
11,14,2,121,422,492,914,"6 de julio de 1997"
11,14,2,122,251,316,567,"6 de julio de 1997"
11,14,2,123,422,384,806,"6 de julio de 1997"
11,14,2,124,145,208,353,"6 de julio de 1997"
11,14,2,125,199,252,451,"6 de julio de 1997"
11,14,2,126,366,372,738,"6 de julio de 1997"
11,14,2,127,137,175,312,"6 de julio de 1997"
11,14,2,128,396,499,895,"6 de julio de 1997"
11,14,2,129,262,320,582,"6 de julio de 1997"
11,14,2,130,224,284,508,"6 de julio de 1997"
11,14,2,131,349,397,746,"6 de julio de 1997"
11,14,2,132,249,256,505,"6 de julio de 1997"
11,14,2,133,200,263,463,"6 de julio de 1997"
11,14,2,134,205,195,400,"6 de julio de 1997"
11,14,2,135,262,347,609,"6 de julio de 1997"
11,14,2,136,563,677,1240,"6 de julio de 1997"
11,14,2,137,455,625,1080,"6 de julio de 1997"
11,14,2,138,490,680,1170,"6 de julio de 1997"
11,14,2,139,182,230,412,"6 de julio de 1997"
11,14,2,140,277,321,598,"6 de julio de 1997"
11,14,10,652,278,329,607,"6 de julio de 1997"
11,14,10,653,211,267,478,"6 de julio de 1997"
11,14,10,654,403,419,822,"6 de julio de 1997"
11,14,10,655,357,411,768,"6 de julio de 1997"
11,14,10,656,248,347,595,"6 de julio de 1997"
11,14,10,657,270,279,549,"6 de julio de 1997"
11,14,10,658,239,279,518,"6 de julio de 1997"
11,14,10,659,189,196,385,"6 de julio de 1997"
11,14,10,660,395,474,869,"6 de julio de 1997"
11,14,10,661,242,288,530,"6 de julio de 1997"
11,14,19,1204,331,374,705,"6 de julio de 1997"
11,14,19,1205,378,399,777,"6 de julio de 1997"
11,14,19,1206,406,468,874,"6 de julio de 1997"
11,14,19,1207,266,307,573,"6 de julio de 1997"
11,14,19,1208,366,452,818,"6 de julio de 1997"
11,14,19,1209,277,312,589,"6 de julio de 1997"
11,14,19,1210,353,402,755,"6 de julio de 1997"
11,14,19,1211,146,162,308,"6 de julio de 1997"
11,14,19,1212,180,231,411,"6 de julio de 1997"
11,14,19,1213,134,171,305,"6 de julio de 1997"
11,14,19,1214,242,274,516,"6 de julio de 1997"
11,14,19,1215,235,233,468,"6 de julio de 1997"
11,14,19,1216,175,251,426,"6 de julio de 1997"
11,14,19,1217,161,209,370,"6 de julio de 1997"
11,14,19,1218,452,518,970,"6 de julio de 1997"
11,14,19,1219,132,182,314,"6 de julio de 1997"
11,14,19,1220,277,349,626,"6 de julio de 1997"
11,14,19,1221,145,238,383,"6 de julio de 1997"
11,14,19,1222,226,257,483,"6 de julio de 1997"
11,14,19,1223,195,233,428,"6 de julio de 1997"
11,14,19,1224,247,275,522,"6 de julio de 1997"
11,14,19,1225,364,427,791,"6 de julio de 1997"
11,14,19,1226,356,403,759,"6 de julio de 1997"
11,14,19,1227,208,225,433,"6 de julio de 1997"
11,14,19,1228,103,134,237,"6 de julio de 1997"
11,14,19,1229,274,295,569,"6 de julio de 1997"
11,14,19,1230,297,384,681,"6 de julio de 1997"
11,14,19,1231,31,32,63,"6 de julio de 1997"
11,14,19,1232,111,160,271,"6 de julio de 1997"
11,14,19,1233,244,264,508,"6 de julio de 1997"
11,14,19,1234,180,199,379,"6 de julio de 1997"
11,14,19,1235,326,457,783,"6 de julio de 1997"
11,14,19,1236,177,221,398,"6 de julio de 1997"
11,14,19,1237,103,120,223,"6 de julio de 1997"
11,14,19,1238,60,63,123,"6 de julio de 1997"
11,14,19,1239,137,151,288,"6 de julio de 1997"
11,14,19,1240,110,131,241,"6 de julio de 1997"
11,14,19,1241,381,431,812,"6 de julio de 1997"
11,14,19,1242,198,198,396,"6 de julio de 1997"
11,14,19,1243,265,272,537,"6 de julio de 1997"
11,14,19,1244,326,376,702,"6 de julio de 1997"
11,14,19,1245,165,218,383,"6 de julio de 1997"
11,14,19,1246,243,302,545,"6 de julio de 1997"
11,14,19,1247,201,204,405,"6 de julio de 1997"
11,14,19,1248,205,203,408,"6 de julio de 1997"
11,14,19,1249,160,176,336,"6 de julio de 1997"
11,14,19,1250,304,351,655,"6 de julio de 1997"
11,14,19,1251,171,199,370,"6 de julio de 1997"
11,14,19,1252,133,144,277,"6 de julio de 1997"
11,14,19,1253,25,27,52,"6 de julio de 1997"
11,14,19,1254,396,487,883,"6 de julio de 1997"
11,14,19,1255,242,291,533,"6 de julio de 1997"
11,14,19,1256,152,178,330,"6 de julio de 1997"
11,14,19,1257,301,340,641,"6 de julio de 1997"
11,14,19,1258,232,239,471,"6 de julio de 1997"
11,14,19,1259,290,281,571,"6 de julio de 1997"
11,14,19,1260,107,119,226,"6 de julio de 1997"
11,14,38,2732,301,378,679,"6 de julio de 1997"
11,14,38,2733,239,316,555,"6 de julio de 1997"
11,14,38,2734,191,256,447,"6 de julio de 1997"
11,14,38,2735,282,323,605,"6 de julio de 1997"
11,14,38,2736,377,425,802,"6 de julio de 1997"
11,14,38,2737,335,397,732,"6 de julio de 1997"
11,14,38,2738,446,512,958,"6 de julio de 1997"
11,14,38,2739,225,252,477,"6 de julio de 1997"
11,14,38,2740,222,315,537,"6 de julio de 1997"
11,14,38,2741,356,376,732,"6 de julio de 1997"
11,14,38,2742,309,351,660,"6 de julio de 1997"
11,14,38,2743,174,186,360,"6 de julio de 1997"
11,14,39,2744,342,416,758,"6 de julio de 1997"
11,14,39,2745,352,396,748,"6 de julio de 1997"
11,14,39,2746,402,472,874,"6 de julio de 1997"
11,14,39,2747,391,472,863,"6 de julio de 1997"
11,14,39,2748,110,132,242,"6 de julio de 1997"
11,14,39,2749,424,504,928,"6 de julio de 1997"
11,14,39,2750,322,431,753,"6 de julio de 1997"
11,14,39,2751,309,393,702,"6 de julio de 1997"
11,14,39,2752,378,423,801,"6 de julio de 1997"
11,14,39,2753,279,340,619,"6 de julio de 1997"
11,14,39,2754,140,227,367,"6 de julio de 1997"
11,14,39,2755,73,91,164,"6 de julio de 1997"
11,14,39,2756,148,215,363,"6 de julio de 1997"
11,14,39,2757,158,210,368,"6 de julio de 1997"
11,14,39,2758,228,331,559,"6 de julio de 1997"
11,14,39,2759,182,253,435,"6 de julio de 1997"
11,14,39,2760,115,159,274,"6 de julio de 1997"
11,14,39,2761,595,815,1410,"6 de julio de 1997"
11,14,39,2762,250,299,549,"6 de julio de 1997"
11,14,39,2763,361,470,831,"6 de julio de 1997"
11,14,39,2764,142,244,386,"6 de julio de 1997"
11,14,39,2765,389,456,845,"6 de julio de 1997"
11,14,39,2766,214,264,478,"6 de julio de 1997"
11,14,39,2767,293,337,630,"6 de julio de 1997"
11,14,39,2768,307,378,685,"6 de julio de 1997"
11,14,39,2769,238,333,571,"6 de julio de 1997"
11,14,39,2770,224,315,539,"6 de julio de 1997"
11,14,39,2771,321,408,729,"6 de julio de 1997"
11,14,39,2772,192,282,474,"6 de julio de 1997"
11,14,39,2773,308,391,699,"6 de julio de 1997"
11,14,39,2774,252,314,566,"6 de julio de 1997"
11,14,39,2775,281,321,602,"6 de julio de 1997"
11,14,39,2776,165,204,369,"6 de julio de 1997"
11,14,39,2777,454,502,956,"6 de julio de 1997"
11,15,21,1859,296,363,659,"6 de julio de 1997"
11,15,21,1860,439,528,967,"6 de julio de 1997"
11,15,21,1861,545,674,1219,"6 de julio de 1997"
11,15,21,1862,354,380,734,"6 de julio de 1997"
11,15,21,1863,376,433,809,"6 de julio de 1997"
11,15,21,1864,530,662,1192,"6 de julio de 1997"
11,15,21,1865,369,412,781,"6 de julio de 1997"
11,15,21,1866,376,378,754,"6 de julio de 1997"
11,15,21,1867,505,537,1042,"6 de julio de 1997"
11,15,21,1868,399,509,908,"6 de julio de 1997"
11,15,21,1869,582,705,1287,"6 de julio de 1997"
11,15,21,1870,573,630,1203,"6 de julio de 1997"
11,15,21,1871,289,327,616,"6 de julio de 1997"
11,15,21,1872,328,375,703,"6 de julio de 1997"
11,15,21,1873,594,685,1279,"6 de julio de 1997"
11,15,21,1874,404,577,981,"6 de julio de 1997"
11,15,21,1875,580,785,1365,"6 de julio de 1997"
11,15,21,1876,343,432,775,"6 de julio de 1997"
11,15,21,1877,397,425,822,"6 de julio de 1997"
11,15,21,1878,389,433,822,"6 de julio de 1997"
11,15,21,1879,396,543,939,"6 de julio de 1997"
11,15,21,1880,465,634,1099,"6 de julio de 1997"
11,15,21,1881,232,315,547,"6 de julio de 1997"
11,15,21,1882,254,330,584,"6 de julio de 1997"
11,15,21,1883,342,463,805,"6 de julio de 1997"
11,15,21,1884,402,549,951,"6 de julio de 1997"
11,15,21,1885,395,494,889,"6 de julio de 1997"
11,15,21,1886,273,317,590,"6 de julio de 1997"
11,15,21,1887,218,262,480,"6 de julio de 1997"
11,15,21,1888,125,212,337,"6 de julio de 1997"
11,15,21,1889,214,286,500,"6 de julio de 1997"
11,15,21,1890,282,390,672,"6 de julio de 1997"
11,15,21,1891,237,352,589,"6 de julio de 1997"
11,15,21,1892,278,446,724,"6 de julio de 1997"
11,15,21,1893,325,504,829,"6 de julio de 1997"
11,15,28,2263,512,555,1067,"6 de julio de 1997"
11,15,28,2264,406,509,915,"6 de julio de 1997"
11,15,28,2265,354,428,782,"6 de julio de 1997"
11,15,28,2266,176,209,385,"6 de julio de 1997"
11,15,28,2267,214,252,466,"6 de julio de 1997"
11,15,28,2268,492,576,1068,"6 de julio de 1997"
11,15,28,2269,425,529,954,"6 de julio de 1997"
11,15,28,2270,374,458,832,"6 de julio de 1997"
11,15,28,2271,321,384,705,"6 de julio de 1997"
11,15,28,2272,276,314,590,"6 de julio de 1997"
11,15,28,2273,396,443,839,"6 de julio de 1997"
11,15,28,2274,631,761,1392,"6 de julio de 1997"
11,15,28,2275,523,587,1110,"6 de julio de 1997"
11,15,28,2276,361,432,793,"6 de julio de 1997"
11,15,28,2277,301,359,660,"6 de julio de 1997"
11,15,28,2278,448,523,971,"6 de julio de 1997"
11,15,28,2279,337,442,779,"6 de julio de 1997"
11,15,28,2280,369,447,816,"6 de julio de 1997"
11,15,28,2281,222,270,492,"6 de julio de 1997"
11,15,28,2282,415,497,912,"6 de julio de 1997"
11,15,28,2283,338,372,710,"6 de julio de 1997"
11,15,28,2284,356,395,751,"6 de julio de 1997"
11,15,28,2285,406,428,834,"6 de julio de 1997"
11,15,28,2286,303,361,664,"6 de julio de 1997"
11,15,28,2287,515,581,1096,"6 de julio de 1997"
11,15,28,2288,455,492,947,"6 de julio de 1997"
11,15,28,2289,349,366,715,"6 de julio de 1997"
11,15,28,2290,357,390,747,"6 de julio de 1997"
11,15,28,2291,234,306,540,"6 de julio de 1997"
11,15,28,2292,222,312,534,"6 de julio de 1997"
11,15,28,2293,229,283,512,"6 de julio de 1997"
11,15,28,2294,253,314,567,"6 de julio de 1997"
11,15,28,2295,300,397,697,"6 de julio de 1997"
11,15,28,2296,187,248,435,"6 de julio de 1997"
11,15,28,2297,402,534,936,"6 de julio de 1997"
11,15,28,2298,368,480,848,"6 de julio de 1997"
11,15,28,2299,331,470,801,"6 de julio de 1997"
11,15,28,2300,187,202,389,"6 de julio de 1997"
11,15,28,2301,235,267,502,"6 de julio de 1997"
11,15,28,2302,271,385,656,"6 de julio de 1997"
11,15,28,2303,189,226,415,"6 de julio de 1997"
11,15,28,2304,249,389,638,"6 de julio de 1997"
11,15,28,2305,288,370,658,"6 de julio de 1997"
11,15,28,2306,385,460,845,"6 de julio de 1997"
11,15,28,2307,196,202,398,"6 de julio de 1997"
11,15,28,2308,320,337,657,"6 de julio de 1997"
11,15,28,2309,210,276,486,"6 de julio de 1997"
11,15,28,2310,290,395,685,"6 de julio de 1997"
11,15,28,2311,381,440,821,"6 de julio de 1997"
11,15,28,2312,320,393,713,"6 de julio de 1997"
11,15,28,2313,246,314,560,"6 de julio de 1997"
11,15,28,2314,493,567,1060,"6 de julio de 1997"
11,15,28,2315,470,529,999,"6 de julio de 1997"
11,15,28,2316,237,263,500,"6 de julio de 1997"
11,15,28,2317,293,328,621,"6 de julio de 1997"
11,15,28,2318,245,272,517,"6 de julio de 1997"
11,15,28,2319,396,454,850,"6 de julio de 1997"
11,15,28,2320,428,463,891,"6 de julio de 1997"
11,15,28,2321,201,207,408,"6 de julio de 1997"
11,15,28,2322,253,293,546,"6 de julio de 1997"
11,15,28,2323,282,341,623,"6 de julio de 1997"
11,15,28,2324,324,379,703,"6 de julio de 1997"
11,15,28,2325,346,409,755,"6 de julio de 1997"
11,15,28,2326,377,540,917,"6 de julio de 1997"
11,15,28,2327,466,616,1082,"6 de julio de 1997"
11,15,28,2328,364,454,818,"6 de julio de 1997"
11,15,28,2329,409,520,929,"6 de julio de 1997"
11,15,28,2330,356,430,786,"6 de julio de 1997"
11,15,28,2331,317,424,741,"6 de julio de 1997"
11,15,28,2332,427,562,989,"6 de julio de 1997"
11,15,28,2333,402,500,902,"6 de julio de 1997"
11,15,28,2334,279,346,625,"6 de julio de 1997"
11,15,28,2335,275,337,612,"6 de julio de 1997"
11,15,28,2336,225,284,509,"6 de julio de 1997"
11,15,28,2337,294,337,631,"6 de julio de 1997"
11,15,28,2338,399,486,885,"6 de julio de 1997"
11,15,28,2339,205,244,449,"6 de julio de 1997"
11,15,28,2340,227,266,493,"6 de julio de 1997"
11,15,28,2341,269,369,638,"6 de julio de 1997"
11,15,28,2342,286,401,687,"6 de julio de 1997"
11,15,28,2343,149,176,325,"6 de julio de 1997"
11,15,28,2344,167,258,425,"6 de julio de 1997"
11,15,28,2345,213,262,475,"6 de julio de 1997"
11,15,28,2346,113,184,297,"6 de julio de 1997"
11,15,36,2644,181,233,414,"6 de julio de 1997"
11,15,36,2645,258,367,625,"6 de julio de 1997"
11,15,36,2646,238,367,605,"6 de julio de 1997"
11,15,36,2647,209,269,478,"6 de julio de 1997"
11,15,36,2648,149,209,358,"6 de julio de 1997"
11,15,36,2649,253,326,579,"6 de julio de 1997"
11,15,36,2650,176,262,438,"6 de julio de 1997"
11,15,36,2651,92,144,236,"6 de julio de 1997"
11,15,36,2652,216,320,536,"6 de julio de 1997"
11,15,36,2653,254,321,575,"6 de julio de 1997"
11,15,41,2790,600,767,1367,"6 de julio de 1997"
11,15,41,2791,689,806,1495,"6 de julio de 1997"
11,15,41,2792,660,839,1499,"6 de julio de 1997"
11,15,41,2793,535,614,1149,"6 de julio de 1997"
11,15,41,2794,510,629,1139,"6 de julio de 1997"
11,15,41,2795,317,420,737,"6 de julio de 1997"
11,15,41,2796,423,500,923,"6 de julio de 1997"
11,15,41,2797,537,653,1190,"6 de julio de 1997"
11,15,41,2798,564,725,1289,"6 de julio de 1997"
11,15,41,2799,517,704,1221,"6 de julio de 1997"
11,15,41,2800,555,686,1241,"6 de julio de 1997"
11,15,41,2801,576,663,1239,"6 de julio de 1997"
11,15,41,2802,526,627,1153,"6 de julio de 1997"
11,15,41,2803,403,477,880,"6 de julio de 1997"
11,15,41,2804,501,646,1147,"6 de julio de 1997"
11,15,41,2805,231,324,555,"6 de julio de 1997"
11,15,41,2806,420,511,931,"6 de julio de 1997"
11,15,41,2807,590,706,1296,"6 de julio de 1997"
11,15,41,2808,463,528,991,"6 de julio de 1997"
11,15,41,2809,530,614,1144,"6 de julio de 1997"
11,15,41,2810,312,364,676,"6 de julio de 1997"
11,15,41,2811,162,333,495,"6 de julio de 1997"
11,15,41,2812,234,279,513,"6 de julio de 1997"
11,15,41,2813,370,508,878,"6 de julio de 1997"
11,15,41,2814,312,546,858,"6 de julio de 1997"
11,15,41,2815,232,326,558,"6 de julio de 1997"
11,15,46,2949,440,551,991,"6 de julio de 1997"
11,15,46,2950,311,438,749,"6 de julio de 1997"
11,15,46,2951,325,415,740,"6 de julio de 1997"
11,15,46,2952,232,277,509,"6 de julio de 1997"
11,15,46,2953,163,181,344,"6 de julio de 1997"
11,15,46,2954,471,568,1039,"6 de julio de 1997"
11,15,46,2955,463,564,1027,"6 de julio de 1997"
11,15,46,2956,574,650,1224,"6 de julio de 1997"
11,15,46,2957,290,371,661,"6 de julio de 1997"
11,15,46,2958,467,620,1087,"6 de julio de 1997"
11,15,46,2959,394,516,910,"6 de julio de 1997"
11,15,46,2960,302,359,661,"6 de julio de 1997"
11,15,46,2961,423,466,889,"6 de julio de 1997"
11,15,46,2962,347,383,730,"6 de julio de 1997"
11,15,46,2963,456,534,990,"6 de julio de 1997"
11,15,46,2964,399,585,984,"6 de julio de 1997"
11,15,46,2965,330,400,730,"6 de julio de 1997"
11,15,46,2966,342,467,809,"6 de julio de 1997"
11,15,46,2967,201,337,538,"6 de julio de 1997"
11,15,46,2968,207,311,518,"6 de julio de 1997"
11,15,46,2969,304,412,716,"6 de julio de 1997"
11,15,46,2970,201,264,465,"6 de julio de 1997"
11,15,46,2971,270,372,642,"6 de julio de 1997"
11,15,46,2972,229,311,540,"6 de julio de 1997"
11,15,46,2973,281,427,708,"6 de julio de 1997"
11,15,46,2974,230,297,527,"6 de julio de 1997"
11,15,46,2975,305,357,662,"6 de julio de 1997"
11,15,46,2976,130,182,312,"6 de julio de 1997"
11,15,46,2977,152,203,355,"6 de julio de 1997"
11,15,46,2978,210,275,485,"6 de julio de 1997"
11,15,46,2979,274,350,624,"6 de julio de 1997"
11,15,46,2980,366,508,874,"6 de julio de 1997"
11,15,46,2981,240,296,536,"6 de julio de 1997"
11,15,46,2982,202,267,469,"6 de julio de 1997"
11,15,46,2983,297,438,735,"6 de julio de 1997"
11,15,46,2984,435,552,987,"6 de julio de 1997"
11,15,46,2985,167,255,422,"6 de julio de 1997"
11,15,46,2986,269,340,609,"6 de julio de 1997"
11,15,46,2987,326,538,864,"6 de julio de 1997"
11,15,46,2988,144,237,381,"6 de julio de 1997"
11,15,46,2989,121,176,297,"6 de julio de 1997"
11,15,46,2990,299,448,747,"6 de julio de 1997"
11,15,46,2991,350,478,828,"6 de julio de 1997"
11,15,46,2992,361,464,825,"6 de julio de 1997"
11,15,46,2993,471,660,1131,"6 de julio de 1997"
11,15,46,2994,400,592,992,"6 de julio de 1997"
11,15,46,2995,174,242,416,"6 de julio de 1997"
11,15,46,2996,215,288,503,"6 de julio de 1997"
11,15,46,2997,426,517,943,"6 de julio de 1997"
11,15,46,2998,432,563,995,"6 de julio de 1997"
11,15,46,2999,411,525,936,"6 de julio de 1997"
11,15,46,3000,374,550,924,"6 de julio de 1997"
11,15,46,3001,441,685,1126,"6 de julio de 1997"
11,15,46,3002,264,389,653,"6 de julio de 1997"
11,15,46,3003,287,354,641,"6 de julio de 1997"
11,15,46,3004,320,396,716,"6 de julio de 1997"
11,15,46,3005,236,377,613,"6 de julio de 1997"
12,1,3,411,342,367,709,"6 de julio de 1997"
12,1,3,412,142,173,315,"6 de julio de 1997"
12,1,3,413,246,270,516,"6 de julio de 1997"
12,1,3,414,677,682,1359,"6 de julio de 1997"
12,1,3,415,569,687,1256,"6 de julio de 1997"
12,1,3,416,184,249,433,"6 de julio de 1997"
12,1,3,417,262,392,654,"6 de julio de 1997"
12,1,3,418,333,496,829,"6 de julio de 1997"
12,1,3,419,173,255,428,"6 de julio de 1997"
12,1,3,420,188,220,408,"6 de julio de 1997"
12,1,3,421,317,402,719,"6 de julio de 1997"
12,1,3,422,261,349,610,"6 de julio de 1997"
12,1,3,423,274,392,666,"6 de julio de 1997"
12,1,3,424,170,174,344,"6 de julio de 1997"
12,1,3,425,164,181,345,"6 de julio de 1997"
12,1,3,426,143,153,296,"6 de julio de 1997"
12,1,3,427,231,254,485,"6 de julio de 1997"
12,1,3,428,236,294,530,"6 de julio de 1997"
12,1,3,429,56,64,120,"6 de julio de 1997"
12,1,3,430,78,82,160,"6 de julio de 1997"
12,1,3,431,78,64,142,"6 de julio de 1997"
12,1,3,432,176,192,368,"6 de julio de 1997"
12,1,3,433,123,128,251,"6 de julio de 1997"
12,1,3,434,384,392,776,"6 de julio de 1997"
12,1,3,435,245,246,491,"6 de julio de 1997"
12,1,3,436,129,155,284,"6 de julio de 1997"
12,1,3,437,95,83,178,"6 de julio de 1997"
12,1,3,438,208,241,449,"6 de julio de 1997"
12,1,3,439,51,52,103,"6 de julio de 1997"
12,1,3,440,111,94,205,"6 de julio de 1997"
12,1,3,441,58,75,133,"6 de julio de 1997"
12,1,3,442,139,164,303,"6 de julio de 1997"
12,1,3,443,321,369,690,"6 de julio de 1997"
12,1,3,444,80,79,159,"6 de julio de 1997"
12,1,3,445,242,209,451,"6 de julio de 1997"
12,1,3,446,195,193,388,"6 de julio de 1997"
12,1,3,447,142,159,301,"6 de julio de 1997"
12,1,3,448,72,54,126,"6 de julio de 1997"
12,1,3,449,96,75,171,"6 de julio de 1997"
12,1,3,450,63,77,140,"6 de julio de 1997"
12,1,3,451,51,33,84,"6 de julio de 1997"
12,1,3,452,40,27,67,"6 de julio de 1997"
12,1,3,453,78,42,120,"6 de julio de 1997"
12,1,3,454,122,98,220,"6 de julio de 1997"
12,1,3,455,97,92,189,"6 de julio de 1997"
12,1,7,500,230,251,481,"6 de julio de 1997"
12,1,7,501,290,352,642,"6 de julio de 1997"
12,1,7,502,204,243,447,"6 de julio de 1997"
12,1,7,503,294,350,644,"6 de julio de 1997"
12,1,7,504,457,510,967,"6 de julio de 1997"
12,1,7,505,453,517,970,"6 de julio de 1997"
12,1,7,506,549,594,1143,"6 de julio de 1997"
12,1,7,507,297,384,681,"6 de julio de 1997"
12,1,7,508,127,166,293,"6 de julio de 1997"
12,1,7,509,144,145,289,"6 de julio de 1997"
12,1,7,510,305,337,642,"6 de julio de 1997"
12,1,7,511,381,452,833,"6 de julio de 1997"
12,1,7,512,232,256,488,"6 de julio de 1997"
12,1,7,513,154,182,336,"6 de julio de 1997"
12,1,7,514,62,77,139,"6 de julio de 1997"
12,1,7,515,52,59,111,"6 de julio de 1997"
12,1,7,516,48,42,90,"6 de julio de 1997"
12,1,7,517,81,82,163,"6 de julio de 1997"
12,1,7,518,321,377,698,"6 de julio de 1997"
12,1,7,519,46,72,118,"6 de julio de 1997"
12,1,7,520,64,42,106,"6 de julio de 1997"
12,1,7,521,67,77,144,"6 de julio de 1997"
12,1,7,522,83,87,170,"6 de julio de 1997"
12,1,7,523,71,59,130,"6 de julio de 1997"
12,1,7,524,167,155,322,"6 de julio de 1997"
12,1,7,525,30,31,61,"6 de julio de 1997"
12,1,7,526,27,17,44,"6 de julio de 1997"
12,1,7,527,59,46,105,"6 de julio de 1997"
12,1,7,528,87,57,144,"6 de julio de 1997"
12,1,7,529,62,52,114,"6 de julio de 1997"
12,1,7,530,45,42,87,"6 de julio de 1997"
12,1,7,531,59,44,103,"6 de julio de 1997"
12,1,7,532,62,61,123,"6 de julio de 1997"
12,1,7,533,142,156,298,"6 de julio de 1997"
12,1,7,534,71,64,135,"6 de julio de 1997"
12,1,7,535,209,238,447,"6 de julio de 1997"
12,1,7,536,53,61,114,"6 de julio de 1997"
12,1,7,537,59,67,126,"6 de julio de 1997"
12,1,7,538,342,338,680,"6 de julio de 1997"
12,1,7,539,90,86,176,"6 de julio de 1997"
12,1,7,540,109,96,205,"6 de julio de 1997"
12,1,7,541,47,43,90,"6 de julio de 1997"
12,1,7,542,53,45,98,"6 de julio de 1997"
12,1,7,543,59,43,102,"6 de julio de 1997"
12,1,7,544,60,34,94,"6 de julio de 1997"
12,1,7,545,40,27,67,"6 de julio de 1997"
12,1,7,546,73,49,122,"6 de julio de 1997"
12,1,7,547,179,209,388,"6 de julio de 1997"
12,1,7,548,59,59,118,"6 de julio de 1997"
12,1,7,549,237,243,480,"6 de julio de 1997"
12,1,7,550,133,115,248,"6 de julio de 1997"
12,1,7,551,75,59,134,"6 de julio de 1997"
12,1,7,552,172,189,361,"6 de julio de 1997"
12,1,22,943,386,406,792,"6 de julio de 1997"
12,1,22,944,167,162,329,"6 de julio de 1997"
12,1,22,945,554,623,1177,"6 de julio de 1997"
12,1,22,946,520,584,1104,"6 de julio de 1997"
12,1,22,947,40,65,105,"6 de julio de 1997"
12,1,22,948,39,56,95,"6 de julio de 1997"
12,1,22,949,119,113,232,"6 de julio de 1997"
12,1,22,950,106,109,215,"6 de julio de 1997"
12,1,22,951,280,317,597,"6 de julio de 1997"
12,1,22,952,79,93,172,"6 de julio de 1997"
12,1,22,953,237,254,491,"6 de julio de 1997"
12,1,22,954,299,281,580,"6 de julio de 1997"
12,1,22,955,174,218,392,"6 de julio de 1997"
12,1,22,956,172,180,352,"6 de julio de 1997"
12,1,22,957,507,516,1023,"6 de julio de 1997"
12,1,22,958,135,115,250,"6 de julio de 1997"
12,1,22,959,150,165,315,"6 de julio de 1997"
12,1,22,960,199,183,382,"6 de julio de 1997"
12,1,22,961,160,177,337,"6 de julio de 1997"
12,1,22,962,140,144,284,"6 de julio de 1997"
12,1,22,963,236,237,473,"6 de julio de 1997"
12,1,22,964,234,217,451,"6 de julio de 1997"
12,1,22,965,235,257,492,"6 de julio de 1997"
12,1,22,966,105,112,217,"6 de julio de 1997"
12,1,22,967,273,282,555,"6 de julio de 1997"
12,1,22,968,180,155,335,"6 de julio de 1997"
12,1,22,969,124,136,260,"6 de julio de 1997"
12,1,22,970,367,423,790,"6 de julio de 1997"
12,1,22,971,356,382,738,"6 de julio de 1997"
12,1,22,972,64,65,129,"6 de julio de 1997"
12,1,22,973,146,178,324,"6 de julio de 1997"
12,1,22,974,103,118,221,"6 de julio de 1997"
12,1,22,975,213,276,489,"6 de julio de 1997"
12,1,22,976,197,211,408,"6 de julio de 1997"
12,1,22,977,158,146,304,"6 de julio de 1997"
12,1,22,978,54,62,116,"6 de julio de 1997"
12,1,22,979,248,279,527,"6 de julio de 1997"
12,1,22,980,114,110,224,"6 de julio de 1997"
12,1,22,981,185,194,379,"6 de julio de 1997"
12,1,22,982,142,166,308,"6 de julio de 1997"
12,1,22,983,455,474,929,"6 de julio de 1997"
12,1,22,984,31,26,57,"6 de julio de 1997"
12,1,22,985,60,61,121,"6 de julio de 1997"
12,1,22,986,61,56,117,"6 de julio de 1997"
12,1,22,987,74,81,155,"6 de julio de 1997"
12,1,22,988,330,375,705,"6 de julio de 1997"
12,1,22,989,165,207,372,"6 de julio de 1997"
12,1,22,990,161,139,300,"6 de julio de 1997"
12,1,22,991,232,245,477,"6 de julio de 1997"
12,1,22,992,58,41,99,"6 de julio de 1997"
12,1,22,993,124,100,224,"6 de julio de 1997"
12,1,22,994,313,219,532,"6 de julio de 1997"
12,1,22,995,79,53,132,"6 de julio de 1997"
12,1,22,996,259,202,461,"6 de julio de 1997"
12,1,22,997,48,35,83,"6 de julio de 1997"
12,1,22,998,122,70,192,"6 de julio de 1997"
12,1,22,999,39,32,71,"6 de julio de 1997"
12,1,22,1000,111,86,197,"6 de julio de 1997"
12,1,27,1067,245,235,480,"6 de julio de 1997"
12,1,27,1068,321,356,677,"6 de julio de 1997"
12,1,27,1069,346,399,745,"6 de julio de 1997"
12,1,27,1070,338,350,688,"6 de julio de 1997"
12,1,27,1071,125,138,263,"6 de julio de 1997"
12,1,27,1072,139,125,264,"6 de julio de 1997"
12,1,27,1073,43,29,72,"6 de julio de 1997"
12,1,27,1074,64,45,109,"6 de julio de 1997"
12,1,27,1075,57,68,125,"6 de julio de 1997"
12,1,27,1076,65,50,115,"6 de julio de 1997"
12,1,27,1077,67,84,151,"6 de julio de 1997"
12,1,27,1078,38,53,91,"6 de julio de 1997"
12,1,27,1079,53,63,116,"6 de julio de 1997"
12,1,27,1080,65,83,148,"6 de julio de 1997"
12,1,27,1081,307,322,629,"6 de julio de 1997"
12,1,27,1082,97,112,209,"6 de julio de 1997"
12,1,27,1083,87,113,200,"6 de julio de 1997"
12,1,27,1084,351,378,729,"6 de julio de 1997"
12,1,27,1085,40,41,81,"6 de julio de 1997"
12,1,27,1086,256,322,578,"6 de julio de 1997"
12,1,27,1087,197,217,414,"6 de julio de 1997"
12,1,27,1088,91,102,193,"6 de julio de 1997"
12,1,27,1089,75,76,151,"6 de julio de 1997"
12,1,27,1090,33,33,66,"6 de julio de 1997"
12,1,27,1091,65,58,123,"6 de julio de 1997"
12,1,27,1092,143,172,315,"6 de julio de 1997"
12,1,27,1093,64,61,125,"6 de julio de 1997"
12,1,27,1094,159,249,408,"6 de julio de 1997"
12,1,27,1095,124,137,261,"6 de julio de 1997"
12,1,27,1096,81,100,181,"6 de julio de 1997"
12,1,27,1097,72,79,151,"6 de julio de 1997"
12,1,27,1098,253,321,574,"6 de julio de 1997"
12,1,27,1099,115,136,251,"6 de julio de 1997"
12,1,27,1100,183,197,380,"6 de julio de 1997"
12,1,27,1101,83,91,174,"6 de julio de 1997"
12,1,27,1102,143,159,302,"6 de julio de 1997"
12,1,27,1103,154,154,308,"6 de julio de 1997"
12,1,27,1104,404,438,842,"6 de julio de 1997"
12,1,27,1105,83,108,191,"6 de julio de 1997"
12,1,27,1106,148,171,319,"6 de julio de 1997"
12,1,27,1107,96,116,212,"6 de julio de 1997"
12,1,27,1108,94,112,206,"6 de julio de 1997"
12,1,27,1109,271,325,596,"6 de julio de 1997"
12,1,27,1110,95,95,190,"6 de julio de 1997"
12,1,27,1111,267,275,542,"6 de julio de 1997"
12,1,51,1950,261,306,567,"6 de julio de 1997"
12,1,51,1951,601,756,1357,"6 de julio de 1997"
12,1,51,1952,422,505,927,"6 de julio de 1997"
12,1,51,1953,450,532,982,"6 de julio de 1997"
12,1,51,1954,704,795,1499,"6 de julio de 1997"
12,1,51,1955,341,384,725,"6 de julio de 1997"
12,1,51,1956,327,338,665,"6 de julio de 1997"
12,1,51,1957,548,556,1104,"6 de julio de 1997"
12,1,51,1958,477,551,1028,"6 de julio de 1997"
12,1,51,1959,460,497,957,"6 de julio de 1997"
12,1,51,1960,581,677,1258,"6 de julio de 1997"
12,1,51,1961,277,302,579,"6 de julio de 1997"
12,1,51,1962,442,44,486,"6 de julio de 1997"
12,1,51,1963,120,117,237,"6 de julio de 1997"
12,1,51,1964,235,232,467,"6 de julio de 1997"
12,1,51,1965,161,177,338,"6 de julio de 1997"
12,1,51,1966,107,125,232,"6 de julio de 1997"
12,1,51,1967,182,189,371,"6 de julio de 1997"
12,1,51,1968,286,332,618,"6 de julio de 1997"
12,1,51,1969,186,198,384,"6 de julio de 1997"
12,1,51,1970,120,125,245,"6 de julio de 1997"
12,1,51,1971,709,765,1474,"6 de julio de 1997"
12,1,51,1972,303,345,648,"6 de julio de 1997"
12,1,55,2092,122,151,273,"6 de julio de 1997"
12,1,55,2093,309,328,637,"6 de julio de 1997"
12,1,55,2094,369,377,746,"6 de julio de 1997"
12,1,55,2095,193,206,399,"6 de julio de 1997"
12,1,55,2096,163,210,373,"6 de julio de 1997"
12,1,55,2097,319,322,641,"6 de julio de 1997"
12,1,55,2098,56,58,114,"6 de julio de 1997"
12,1,55,2099,86,99,185,"6 de julio de 1997"
12,1,55,2100,167,181,348,"6 de julio de 1997"
12,1,55,2101,365,371,736,"6 de julio de 1997"
12,1,55,2102,135,154,289,"6 de julio de 1997"
12,1,55,2103,111,100,211,"6 de julio de 1997"
12,1,55,2104,203,216,419,"6 de julio de 1997"
12,1,55,2105,115,119,234,"6 de julio de 1997"
12,1,55,2106,56,80,136,"6 de julio de 1997"
12,1,55,2107,64,73,137,"6 de julio de 1997"
12,1,55,2108,66,70,136,"6 de julio de 1997"
12,1,55,2109,89,83,172,"6 de julio de 1997"
12,1,55,2110,125,76,201,"6 de julio de 1997"
12,1,55,2111,60,40,100,"6 de julio de 1997"
12,1,55,2112,56,47,103,"6 de julio de 1997"
12,1,55,2113,63,38,101,"6 de julio de 1997"
12,1,55,2114,70,55,125,"6 de julio de 1997"
12,1,55,2115,149,140,289,"6 de julio de 1997"
12,1,55,2116,130,89,219,"6 de julio de 1997"
12,1,55,2117,123,109,232,"6 de julio de 1997"
12,1,55,2118,103,89,192,"6 de julio de 1997"
12,1,55,2119,108,116,224,"6 de julio de 1997"
12,1,55,2120,53,53,106,"6 de julio de 1997"
12,1,55,2121,61,49,110,"6 de julio de 1997"
12,1,55,2122,160,129,289,"6 de julio de 1997"
12,1,55,2123,101,73,174,"6 de julio de 1997"
12,1,55,2124,51,41,92,"6 de julio de 1997"
12,1,55,2125,51,45,96,"6 de julio de 1997"
12,1,55,2126,27,28,55,"6 de julio de 1997"
12,1,55,2127,17,10,27,"6 de julio de 1997"
12,1,55,2128,39,25,64,"6 de julio de 1997"
12,1,55,2129,143,89,232,"6 de julio de 1997"
12,1,55,2130,68,48,116,"6 de julio de 1997"
12,1,55,2131,148,147,295,"6 de julio de 1997"
12,1,55,2132,94,75,169,"6 de julio de 1997"
12,1,55,2133,227,192,419,"6 de julio de 1997"
12,1,65,2533,224,234,458,"6 de julio de 1997"
12,1,65,2534,393,395,788,"6 de julio de 1997"
12,1,65,2535,363,345,708,"6 de julio de 1997"
12,1,65,2536,170,172,342,"6 de julio de 1997"
12,1,65,2537,317,327,644,"6 de julio de 1997"
12,1,65,2538,51,53,104,"6 de julio de 1997"
12,1,65,2539,27,36,63,"6 de julio de 1997"
12,1,65,2540,79,84,163,"6 de julio de 1997"
12,1,65,2541,126,115,241,"6 de julio de 1997"
12,1,65,2542,488,514,1002,"6 de julio de 1997"
12,1,65,2543,32,27,59,"6 de julio de 1997"
12,1,65,2544,102,88,190,"6 de julio de 1997"
12,1,65,2545,83,111,194,"6 de julio de 1997"
12,1,65,2546,120,108,228,"6 de julio de 1997"
12,1,65,2547,89,75,164,"6 de julio de 1997"
12,1,65,2548,101,98,199,"6 de julio de 1997"
12,1,65,2549,49,64,113,"6 de julio de 1997"
12,1,65,2550,245,341,586,"6 de julio de 1997"
12,1,65,2551,356,377,733,"6 de julio de 1997"
12,1,65,2552,58,40,98,"6 de julio de 1997"
12,1,65,2553,303,396,699,"6 de julio de 1997"
12,1,68,2600,659,749,1408,"6 de julio de 1997"
12,1,68,2601,420,536,956,"6 de julio de 1997"
12,1,68,2602,418,493,911,"6 de julio de 1997"
12,1,68,2603,39,41,80,"6 de julio de 1997"
12,1,68,2604,384,473,857,"6 de julio de 1997"
12,1,68,2605,195,222,417,"6 de julio de 1997"
12,1,68,2606,165,204,369,"6 de julio de 1997"
12,1,68,2607,356,456,812,"6 de julio de 1997"
12,1,68,2608,88,83,171,"6 de julio de 1997"
12,1,68,2609,104,107,211,"6 de julio de 1997"
12,1,68,2610,188,230,418,"6 de julio de 1997"
12,1,68,2611,425,521,946,"6 de julio de 1997"
12,1,68,2612,335,393,728,"6 de julio de 1997"
12,1,68,2613,210,286,496,"6 de julio de 1997"
12,1,68,2614,344,493,837,"6 de julio de 1997"
12,1,68,2615,379,494,873,"6 de julio de 1997"
12,1,68,2616,224,257,481,"6 de julio de 1997"
12,1,68,2617,104,125,229,"6 de julio de 1997"
12,1,68,2618,64,81,145,"6 de julio de 1997"
12,1,68,2619,65,75,140,"6 de julio de 1997"
12,1,68,2620,54,58,112,"6 de julio de 1997"
12,1,68,2621,58,64,122,"6 de julio de 1997"
12,1,74,2725,437,399,836,"6 de julio de 1997"
12,1,74,2726,703,694,1397,"6 de julio de 1997"
12,1,74,2727,376,314,690,"6 de julio de 1997"
12,1,74,2728,132,118,250,"6 de julio de 1997"
12,1,74,2729,93,122,215,"6 de julio de 1997"
12,1,74,2730,306,282,588,"6 de julio de 1997"
12,1,74,2731,561,528,1089,"6 de julio de 1997"
12,1,74,2732,303,287,590,"6 de julio de 1997"
12,1,74,2733,129,72,201,"6 de julio de 1997"
12,1,74,2734,242,226,468,"6 de julio de 1997"
12,1,74,2735,321,291,612,"6 de julio de 1997"
12,1,74,2736,213,154,367,"6 de julio de 1997"
12,1,74,2737,122,97,219,"6 de julio de 1997"
12,1,74,2738,90,108,198,"6 de julio de 1997"
12,1,74,2739,60,43,103,"6 de julio de 1997"
12,1,74,2740,218,195,413,"6 de julio de 1997"
12,1,74,2741,565,591,1156,"6 de julio de 1997"
12,1,74,2742,50,40,90,"6 de julio de 1997"
12,1,74,2743,51,45,96,"6 de julio de 1997"
12,1,74,2744,121,124,245,"6 de julio de 1997"
12,1,74,2745,23,23,46,"6 de julio de 1997"
12,1,74,2746,185,154,339,"6 de julio de 1997"
12,1,74,2747,33,21,54,"6 de julio de 1997"
12,1,74,2748,287,239,526,"6 de julio de 1997"
12,1,74,2749,70,58,128,"6 de julio de 1997"
12,1,74,2750,21,13,34,"6 de julio de 1997"
12,1,74,2751,111,92,203,"6 de julio de 1997"
12,2,6,479,166,169,335,"6 de julio de 1997"
12,2,6,480,298,297,595,"6 de julio de 1997"
12,2,6,481,339,362,701,"6 de julio de 1997"
12,2,6,482,209,231,440,"6 de julio de 1997"
12,2,6,483,405,456,861,"6 de julio de 1997"
12,2,6,484,259,299,558,"6 de julio de 1997"
12,2,6,485,34,52,86,"6 de julio de 1997"
12,2,6,486,102,99,201,"6 de julio de 1997"
12,2,6,487,30,33,63,"6 de julio de 1997"
12,2,6,488,115,125,240,"6 de julio de 1997"
12,2,6,489,106,96,202,"6 de julio de 1997"
12,2,6,490,116,137,253,"6 de julio de 1997"
12,2,6,491,39,37,76,"6 de julio de 1997"
12,2,6,492,262,255,517,"6 de julio de 1997"
12,2,6,493,108,116,224,"6 de julio de 1997"
12,2,6,494,115,137,252,"6 de julio de 1997"
12,2,6,495,35,32,67,"6 de julio de 1997"
12,2,6,496,140,169,309,"6 de julio de 1997"
12,2,6,497,34,29,63,"6 de julio de 1997"
12,2,6,498,62,46,108,"6 de julio de 1997"
12,2,6,499,49,47,96,"6 de julio de 1997"
12,2,15,778,430,479,909,"6 de julio de 1997"
12,2,15,779,443,526,969,"6 de julio de 1997"
12,2,15,780,529,535,1064,"6 de julio de 1997"
12,2,15,781,551,628,1179,"6 de julio de 1997"
12,2,15,782,342,381,723,"6 de julio de 1997"
12,2,15,783,237,266,503,"6 de julio de 1997"
12,2,15,784,339,378,717,"6 de julio de 1997"
12,2,15,785,238,233,471,"6 de julio de 1997"
12,2,15,786,77,77,154,"6 de julio de 1997"
12,2,15,787,68,76,144,"6 de julio de 1997"
12,2,15,788,61,46,107,"6 de julio de 1997"
12,2,17,820,293,376,669,"6 de julio de 1997"
12,2,17,821,295,363,658,"6 de julio de 1997"
12,2,17,822,409,477,886,"6 de julio de 1997"
12,2,17,823,179,211,390,"6 de julio de 1997"
12,2,17,824,73,112,185,"6 de julio de 1997"
12,2,17,825,192,210,402,"6 de julio de 1997"
12,2,17,826,104,118,222,"6 de julio de 1997"
12,2,17,827,132,160,292,"6 de julio de 1997"
12,2,17,828,39,41,80,"6 de julio de 1997"
12,2,17,829,121,142,263,"6 de julio de 1997"
12,2,17,830,312,343,655,"6 de julio de 1997"
12,2,17,831,293,338,631,"6 de julio de 1997"
12,2,17,832,242,280,522,"6 de julio de 1997"
12,2,17,833,246,271,517,"6 de julio de 1997"
12,2,17,834,92,106,198,"6 de julio de 1997"
12,2,17,835,203,195,398,"6 de julio de 1997"
12,2,17,836,55,61,116,"6 de julio de 1997"
12,2,17,837,63,72,135,"6 de julio de 1997"
12,2,17,838,64,77,141,"6 de julio de 1997"
12,2,17,839,237,243,480,"6 de julio de 1997"
12,2,17,840,180,240,420,"6 de julio de 1997"
12,2,17,841,58,52,110,"6 de julio de 1997"
12,2,17,842,30,30,60,"6 de julio de 1997"
12,2,17,843,156,158,314,"6 de julio de 1997"
12,2,26,1050,154,150,304,"6 de julio de 1997"
12,2,26,1051,98,128,226,"6 de julio de 1997"
12,2,26,1052,150,169,319,"6 de julio de 1997"
12,2,26,1053,210,247,457,"6 de julio de 1997"
12,2,26,1054,174,187,361,"6 de julio de 1997"
12,2,26,1055,219,250,469,"6 de julio de 1997"
12,2,26,1056,143,164,307,"6 de julio de 1997"
12,2,26,1057,183,203,386,"6 de julio de 1997"
12,2,26,1058,226,247,473,"6 de julio de 1997"
12,2,26,1059,304,323,627,"6 de julio de 1997"
12,2,26,1060,52,71,123,"6 de julio de 1997"
12,2,26,1061,50,60,110,"6 de julio de 1997"
12,2,26,1062,169,177,346,"6 de julio de 1997"
12,2,26,1063,90,99,189,"6 de julio de 1997"
12,2,26,1064,47,50,97,"6 de julio de 1997"
12,2,26,1065,65,61,126,"6 de julio de 1997"
12,2,26,1066,32,26,58,"6 de julio de 1997"
12,2,32,1358,314,389,703,"6 de julio de 1997"
12,2,32,1359,134,157,291,"6 de julio de 1997"
12,2,32,1360,46,49,95,"6 de julio de 1997"
12,2,32,1361,221,244,465,"6 de julio de 1997"
12,2,32,1362,125,178,303,"6 de julio de 1997"
12,2,32,1363,58,67,125,"6 de julio de 1997"
12,2,32,1364,92,91,183,"6 de julio de 1997"
12,2,32,1365,27,25,52,"6 de julio de 1997"
12,2,32,1366,54,43,97,"6 de julio de 1997"
12,2,32,1367,76,75,151,"6 de julio de 1997"
12,2,32,1368,24,27,51,"6 de julio de 1997"
12,2,32,1369,52,61,113,"6 de julio de 1997"
12,2,32,1370,82,79,161,"6 de julio de 1997"
12,2,32,1371,53,41,94,"6 de julio de 1997"
12,2,32,1372,109,111,220,"6 de julio de 1997"
12,2,32,1373,31,31,62,"6 de julio de 1997"
12,2,32,1374,46,58,104,"6 de julio de 1997"
12,2,32,1375,84,97,181,"6 de julio de 1997"
12,2,32,1376,77,92,169,"6 de julio de 1997"
12,2,32,1377,99,117,216,"6 de julio de 1997"
12,2,32,1378,43,40,83,"6 de julio de 1997"
12,2,32,1379,28,39,67,"6 de julio de 1997"
12,2,32,1380,55,62,117,"6 de julio de 1997"
12,2,32,1381,37,37,74,"6 de julio de 1997"
12,2,38,1576,420,455,875,"6 de julio de 1997"
12,2,38,1577,266,287,553,"6 de julio de 1997"
12,2,38,1578,77,75,152,"6 de julio de 1997"
12,2,38,1579,65,65,130,"6 de julio de 1997"
12,2,38,1580,134,170,304,"6 de julio de 1997"
12,2,38,1581,40,55,95,"6 de julio de 1997"
12,2,38,1582,102,137,239,"6 de julio de 1997"
12,2,38,1583,60,67,127,"6 de julio de 1997"
12,2,38,1584,130,145,275,"6 de julio de 1997"
12,2,38,1585,115,153,268,"6 de julio de 1997"
12,2,38,1586,59,89,148,"6 de julio de 1997"
12,2,38,1587,127,183,310,"6 de julio de 1997"
12,2,38,1588,163,212,375,"6 de julio de 1997"
12,2,48,1847,320,382,702,"6 de julio de 1997"
12,2,48,1848,73,90,163,"6 de julio de 1997"
12,2,48,1849,51,55,106,"6 de julio de 1997"
12,2,48,1850,60,82,142,"6 de julio de 1997"
12,2,48,1851,60,69,129,"6 de julio de 1997"
12,2,48,1852,106,113,219,"6 de julio de 1997"
12,2,48,1853,24,32,56,"6 de julio de 1997"
12,2,48,1854,21,41,62,"6 de julio de 1997"
12,2,48,1855,72,67,139,"6 de julio de 1997"
12,2,48,1856,38,40,78,"6 de julio de 1997"
12,2,48,1857,39,39,78,"6 de julio de 1997"
12,2,48,1858,25,34,59,"6 de julio de 1997"
12,2,48,1859,50,49,99,"6 de julio de 1997"
12,2,48,1860,61,57,118,"6 de julio de 1997"
12,2,48,1861,65,70,135,"6 de julio de 1997"
12,2,48,1862,39,38,77,"6 de julio de 1997"
12,2,48,1863,38,27,65,"6 de julio de 1997"
12,2,48,1864,63,52,115,"6 de julio de 1997"
12,2,48,1865,33,42,75,"6 de julio de 1997"
12,2,48,1866,67,79,146,"6 de julio de 1997"
12,2,48,1867,77,83,160,"6 de julio de 1997"
12,2,48,1868,32,48,80,"6 de julio de 1997"
12,2,48,1869,108,132,240,"6 de julio de 1997"
12,2,48,1870,44,63,107,"6 de julio de 1997"
12,2,48,1871,41,44,85,"6 de julio de 1997"
12,2,48,1872,43,53,96,"6 de julio de 1997"
12,2,48,1873,51,40,91,"6 de julio de 1997"
12,2,48,1874,40,41,81,"6 de julio de 1997"
12,2,50,1933,509,549,1058,"6 de julio de 1997"
12,2,50,1934,299,338,637,"6 de julio de 1997"
12,2,50,1935,219,199,418,"6 de julio de 1997"
12,2,50,1936,264,277,541,"6 de julio de 1997"
12,2,50,1937,108,108,216,"6 de julio de 1997"
12,2,50,1938,95,71,166,"6 de julio de 1997"
12,2,50,1939,114,88,202,"6 de julio de 1997"
12,2,50,1940,92,113,205,"6 de julio de 1997"
12,2,50,1941,96,94,190,"6 de julio de 1997"
12,2,50,1942,73,65,138,"6 de julio de 1997"
12,2,50,1943,34,40,74,"6 de julio de 1997"
12,2,50,1944,186,174,360,"6 de julio de 1997"
12,2,50,1945,248,281,529,"6 de julio de 1997"
12,2,50,1946,59,68,127,"6 de julio de 1997"
12,2,50,1947,85,91,176,"6 de julio de 1997"
12,2,50,1948,49,40,89,"6 de julio de 1997"
12,2,50,1949,82,68,150,"6 de julio de 1997"
12,2,56,2134,364,428,792,"6 de julio de 1997"
12,2,56,2135,531,525,1056,"6 de julio de 1997"
12,2,56,2136,360,361,721,"6 de julio de 1997"
12,2,56,2137,655,694,1349,"6 de julio de 1997"
12,2,56,2138,523,557,1080,"6 de julio de 1997"
12,2,56,2139,550,616,1166,"6 de julio de 1997"
12,2,56,2140,579,671,1250,"6 de julio de 1997"
12,2,56,2141,394,434,828,"6 de julio de 1997"
12,2,56,2142,607,635,1242,"6 de julio de 1997"
12,2,56,2143,369,391,760,"6 de julio de 1997"
12,2,56,2144,430,464,894,"6 de julio de 1997"
12,2,56,2145,451,411,862,"6 de julio de 1997"
12,2,56,2146,285,327,612,"6 de julio de 1997"
12,2,56,2147,461,520,981,"6 de julio de 1997"
12,2,56,2148,477,493,970,"6 de julio de 1997"
12,2,56,2149,365,400,765,"6 de julio de 1997"
12,2,56,2150,303,307,610,"6 de julio de 1997"
12,2,56,2151,378,443,821,"6 de julio de 1997"
12,2,56,2152,304,359,663,"6 de julio de 1997"
12,2,56,2153,694,738,1432,"6 de julio de 1997"
12,2,56,2154,365,458,823,"6 de julio de 1997"
12,2,56,2155,681,797,1478,"6 de julio de 1997"
12,2,56,2156,265,311,576,"6 de julio de 1997"
12,2,56,2157,230,266,496,"6 de julio de 1997"
12,2,56,2158,510,605,1115,"6 de julio de 1997"
12,2,56,2159,505,535,1040,"6 de julio de 1997"
12,2,56,2160,402,480,882,"6 de julio de 1997"
12,2,56,2161,407,462,869,"6 de julio de 1997"
12,2,56,2162,474,503,977,"6 de julio de 1997"
12,2,56,2163,199,205,404,"6 de julio de 1997"
12,2,56,2164,719,819,1538,"6 de julio de 1997"
12,2,56,2165,108,125,233,"6 de julio de 1997"
12,2,56,2166,249,248,497,"6 de julio de 1997"
12,2,56,2167,118,101,219,"6 de julio de 1997"
12,2,56,2168,339,326,665,"6 de julio de 1997"
12,2,56,2169,488,465,953,"6 de julio de 1997"
12,2,56,2170,69,54,123,"6 de julio de 1997"
12,2,56,2171,42,36,78,"6 de julio de 1997"
12,2,56,2172,35,30,65,"6 de julio de 1997"
12,2,56,2173,48,55,103,"6 de julio de 1997"
12,2,56,2174,54,52,106,"6 de julio de 1997"
12,2,56,2175,107,100,207,"6 de julio de 1997"
12,2,56,2176,45,39,84,"6 de julio de 1997"
12,2,56,2177,199,214,413,"6 de julio de 1997"
12,2,56,2178,116,109,225,"6 de julio de 1997"
12,2,56,2179,65,63,128,"6 de julio de 1997"
12,2,56,2180,220,215,435,"6 de julio de 1997"
12,2,56,2181,140,137,277,"6 de julio de 1997"
12,2,56,2182,331,334,665,"6 de julio de 1997"
12,2,56,2183,156,167,323,"6 de julio de 1997"
12,2,56,2184,172,174,346,"6 de julio de 1997"
12,2,56,2185,151,148,299,"6 de julio de 1997"
12,2,56,2186,53,59,112,"6 de julio de 1997"
12,2,56,2187,45,39,84,"6 de julio de 1997"
12,2,56,2188,32,40,72,"6 de julio de 1997"
12,2,56,2189,51,57,108,"6 de julio de 1997"
12,2,56,2190,100,108,208,"6 de julio de 1997"
12,2,56,2191,427,404,831,"6 de julio de 1997"
12,2,56,2192,126,136,262,"6 de julio de 1997"
12,2,56,2193,147,153,300,"6 de julio de 1997"
12,2,56,2194,168,183,351,"6 de julio de 1997"
12,2,56,2195,689,665,1354,"6 de julio de 1997"
12,2,56,2196,316,322,638,"6 de julio de 1997"
12,2,56,2197,128,97,225,"6 de julio de 1997"
12,2,56,2198,156,154,310,"6 de julio de 1997"
12,2,56,2199,186,185,371,"6 de julio de 1997"
12,2,56,2200,98,104,202,"6 de julio de 1997"
12,2,56,2201,211,228,439,"6 de julio de 1997"
12,2,56,2202,37,30,67,"6 de julio de 1997"
12,2,56,2203,374,346,720,"6 de julio de 1997"
12,2,56,2204,190,202,392,"6 de julio de 1997"
12,2,56,2205,365,390,755,"6 de julio de 1997"
12,2,56,2206,275,247,522,"6 de julio de 1997"
12,2,56,2207,438,400,838,"6 de julio de 1997"
12,2,56,2208,584,406,990,"6 de julio de 1997"
12,2,56,2209,241,270,511,"6 de julio de 1997"
12,2,56,2210,212,169,381,"6 de julio de 1997"
12,2,56,2211,145,175,320,"6 de julio de 1997"
12,2,56,2212,110,93,203,"6 de julio de 1997"
12,2,56,2213,323,436,759,"6 de julio de 1997"
12,2,56,2214,32,47,79,"6 de julio de 1997"
12,2,56,2215,170,255,425,"6 de julio de 1997"
12,2,56,2216,107,155,262,"6 de julio de 1997"
12,2,56,2217,169,230,399,"6 de julio de 1997"
12,2,56,2218,126,131,257,"6 de julio de 1997"
12,2,56,2219,149,199,348,"6 de julio de 1997"
12,2,56,2220,92,120,212,"6 de julio de 1997"
12,2,56,2221,110,160,270,"6 de julio de 1997"
12,2,56,2222,489,455,944,"6 de julio de 1997"
12,2,59,2331,334,368,702,"6 de julio de 1997"
12,2,59,2332,348,420,768,"6 de julio de 1997"
12,2,59,2333,329,414,743,"6 de julio de 1997"
12,2,59,2334,314,380,694,"6 de julio de 1997"
12,2,59,2335,384,451,835,"6 de julio de 1997"
12,2,59,2336,295,337,632,"6 de julio de 1997"
12,2,59,2337,346,412,758,"6 de julio de 1997"
12,2,59,2338,483,612,1095,"6 de julio de 1997"
12,2,59,2339,354,442,796,"6 de julio de 1997"
12,2,59,2340,110,143,253,"6 de julio de 1997"
12,2,59,2341,308,372,680,"6 de julio de 1997"
12,2,59,2342,307,365,672,"6 de julio de 1997"
12,2,59,2343,250,293,543,"6 de julio de 1997"
12,2,59,2344,260,320,580,"6 de julio de 1997"
12,2,59,2345,221,282,503,"6 de julio de 1997"
12,2,59,2346,60,64,124,"6 de julio de 1997"
12,2,59,2347,120,177,297,"6 de julio de 1997"
12,2,59,2348,75,82,157,"6 de julio de 1997"
12,2,59,2349,33,45,78,"6 de julio de 1997"
12,2,59,2350,37,54,91,"6 de julio de 1997"
12,2,59,2351,22,31,53,"6 de julio de 1997"
12,2,59,2352,110,124,234,"6 de julio de 1997"
12,2,59,2353,60,72,132,"6 de julio de 1997"
12,2,59,2354,56,57,113,"6 de julio de 1997"
12,2,59,2355,49,45,94,"6 de julio de 1997"
12,2,59,2356,62,84,146,"6 de julio de 1997"
12,2,59,2357,17,20,37,"6 de julio de 1997"
12,2,59,2358,69,89,158,"6 de julio de 1997"
12,2,59,2359,53,61,114,"6 de julio de 1997"
12,2,59,2360,34,36,70,"6 de julio de 1997"
12,2,59,2361,84,109,193,"6 de julio de 1997"
12,2,59,2362,101,109,210,"6 de julio de 1997"
12,2,59,2363,64,91,155,"6 de julio de 1997"
12,2,59,2364,45,61,106,"6 de julio de 1997"
12,2,59,2365,42,53,95,"6 de julio de 1997"
12,2,59,2366,58,69,127,"6 de julio de 1997"
12,2,59,2367,41,52,93,"6 de julio de 1997"
12,2,59,2368,150,198,348,"6 de julio de 1997"
12,2,59,2369,99,141,240,"6 de julio de 1997"
12,2,59,2370,60,66,126,"6 de julio de 1997"
12,2,59,2371,46,58,104,"6 de julio de 1997"
12,2,59,2372,59,73,132,"6 de julio de 1997"
12,2,59,2373,120,134,254,"6 de julio de 1997"
12,2,59,2374,84,96,180,"6 de julio de 1997"
12,2,59,2375,106,119,225,"6 de julio de 1997"
12,2,59,2376,63,63,126,"6 de julio de 1997"
12,2,59,2377,56,68,124,"6 de julio de 1997"
12,2,59,2378,41,39,80,"6 de julio de 1997"
12,2,59,2379,243,290,533,"6 de julio de 1997"
12,2,59,2380,101,129,230,"6 de julio de 1997"
12,2,59,2381,49,48,97,"6 de julio de 1997"
12,2,59,2382,121,135,256,"6 de julio de 1997"
12,2,59,2383,68,87,155,"6 de julio de 1997"
12,2,59,2384,51,63,114,"6 de julio de 1997"
12,2,59,2385,303,375,678,"6 de julio de 1997"
12,2,59,2386,101,136,237,"6 de julio de 1997"
12,2,59,2387,153,188,341,"6 de julio de 1997"
12,2,59,2388,204,254,458,"6 de julio de 1997"
12,2,59,2389,149,183,332,"6 de julio de 1997"
12,2,59,2390,123,129,252,"6 de julio de 1997"
12,2,59,2391,68,75,143,"6 de julio de 1997"
12,2,59,2392,63,59,122,"6 de julio de 1997"
12,2,59,2393,186,243,429,"6 de julio de 1997"
12,2,59,2394,266,318,584,"6 de julio de 1997"
12,2,59,2395,23,16,39,"6 de julio de 1997"
12,2,59,2396,47,53,100,"6 de julio de 1997"
12,2,59,2397,309,355,664,"6 de julio de 1997"
12,2,59,2398,340,398,738,"6 de julio de 1997"
12,2,59,2399,62,70,132,"6 de julio de 1997"
12,2,59,2400,59,70,129,"6 de julio de 1997"
12,2,59,2401,77,114,191,"6 de julio de 1997"
12,2,59,2402,100,105,205,"6 de julio de 1997"
12,2,59,2403,87,113,200,"6 de julio de 1997"
12,2,59,2404,177,223,400,"6 de julio de 1997"
12,2,59,2405,99,140,239,"6 de julio de 1997"
12,2,59,2406,293,314,607,"6 de julio de 1997"
12,2,59,2407,108,121,229,"6 de julio de 1997"
12,2,59,2408,95,96,191,"6 de julio de 1997"
12,2,59,2409,392,429,821,"6 de julio de 1997"
12,2,59,2410,42,40,82,"6 de julio de 1997"
12,2,59,2411,78,74,152,"6 de julio de 1997"
12,2,59,2412,54,47,101,"6 de julio de 1997"
12,2,59,2413,79,76,155,"6 de julio de 1997"
12,2,59,2414,150,168,318,"6 de julio de 1997"
12,2,59,2415,89,142,231,"6 de julio de 1997"
12,2,59,2416,49,59,108,"6 de julio de 1997"
12,2,59,2417,133,121,254,"6 de julio de 1997"
12,2,59,2418,319,356,675,"6 de julio de 1997"
12,2,59,2419,357,413,770,"6 de julio de 1997"
12,2,61,2451,223,250,473,"6 de julio de 1997"
12,2,61,2452,285,274,559,"6 de julio de 1997"
12,2,61,2453,81,84,165,"6 de julio de 1997"
12,2,61,2454,52,60,112,"6 de julio de 1997"
12,2,61,2455,64,52,116,"6 de julio de 1997"
12,2,61,2456,151,148,299,"6 de julio de 1997"
12,2,61,2457,102,90,192,"6 de julio de 1997"
12,2,61,2458,79,66,145,"6 de julio de 1997"
12,2,61,2459,29,26,55,"6 de julio de 1997"
12,2,61,2460,147,130,277,"6 de julio de 1997"
12,2,61,2461,45,40,85,"6 de julio de 1997"
12,2,61,2462,36,26,62,"6 de julio de 1997"
12,2,61,2463,110,106,216,"6 de julio de 1997"
12,2,61,2464,143,139,282,"6 de julio de 1997"
12,2,61,2465,30,25,55,"6 de julio de 1997"
12,2,61,2466,72,57,129,"6 de julio de 1997"
12,2,61,2467,24,22,46,"6 de julio de 1997"
12,2,61,2468,102,99,201,"6 de julio de 1997"
12,2,61,2469,49,41,90,"6 de julio de 1997"
12,2,61,2470,37,34,71,"6 de julio de 1997"
12,2,61,2471,136,150,286,"6 de julio de 1997"
12,2,61,2472,164,142,306,"6 de julio de 1997"
12,2,61,2473,62,47,109,"6 de julio de 1997"
12,2,61,2474,319,326,645,"6 de julio de 1997"
12,2,61,2475,161,134,295,"6 de julio de 1997"
12,2,61,2476,251,277,528,"6 de julio de 1997"
12,2,61,2477,95,110,205,"6 de julio de 1997"
12,2,61,2478,66,73,139,"6 de julio de 1997"
12,3,11,596,229,230,459,"6 de julio de 1997"
12,3,11,597,159,193,352,"6 de julio de 1997"
12,3,11,598,228,273,501,"6 de julio de 1997"
12,3,11,599,429,510,939,"6 de julio de 1997"
12,3,11,600,169,211,380,"6 de julio de 1997"
12,3,11,601,251,26,277,"6 de julio de 1997"
12,3,11,602,311,358,669,"6 de julio de 1997"
12,3,11,603,227,226,453,"6 de julio de 1997"
12,3,11,604,374,492,866,"6 de julio de 1997"
12,3,11,605,252,305,557,"6 de julio de 1997"
12,3,11,606,330,400,730,"6 de julio de 1997"
12,3,11,607,336,366,702,"6 de julio de 1997"
12,3,11,608,291,347,638,"6 de julio de 1997"
12,3,11,609,326,357,683,"6 de julio de 1997"
12,3,11,610,234,241,475,"6 de julio de 1997"
12,3,11,611,296,335,631,"6 de julio de 1997"
12,3,11,612,131,105,236,"6 de julio de 1997"
12,3,11,613,143,117,260,"6 de julio de 1997"
12,3,11,614,37,34,71,"6 de julio de 1997"
12,3,11,615,83,54,137,"6 de julio de 1997"
12,3,11,616,71,56,127,"6 de julio de 1997"
12,3,11,617,38,35,73,"6 de julio de 1997"
12,3,11,618,41,27,68,"6 de julio de 1997"
12,3,11,619,179,136,315,"6 de julio de 1997"
12,3,11,620,97,78,175,"6 de julio de 1997"
12,3,11,621,280,297,577,"6 de julio de 1997"
12,3,11,622,342,289,631,"6 de julio de 1997"
12,3,11,623,277,304,581,"6 de julio de 1997"
12,3,11,624,365,367,732,"6 de julio de 1997"
12,3,11,625,42,39,81,"6 de julio de 1997"
12,3,11,626,108,89,197,"6 de julio de 1997"
12,3,11,627,297,304,601,"6 de julio de 1997"
12,3,11,628,80,78,158,"6 de julio de 1997"
12,3,11,629,50,36,86,"6 de julio de 1997"
12,3,11,630,185,180,365,"6 de julio de 1997"
12,3,11,631,148,143,291,"6 de julio de 1997"
12,3,11,632,169,149,318,"6 de julio de 1997"
12,3,11,633,166,165,331,"6 de julio de 1997"
12,3,11,634,86,83,169,"6 de julio de 1997"
12,3,11,635,31,27,58,"6 de julio de 1997"
12,3,11,636,77,71,148,"6 de julio de 1997"
12,3,11,637,227,224,451,"6 de julio de 1997"
12,3,11,638,115,115,230,"6 de julio de 1997"
12,3,11,639,245,270,515,"6 de julio de 1997"
12,3,11,640,133,129,262,"6 de julio de 1997"
12,3,11,641,175,174,349,"6 de julio de 1997"
12,3,11,642,118,86,204,"6 de julio de 1997"
12,3,11,643,71,57,128,"6 de julio de 1997"
12,3,11,644,108,92,200,"6 de julio de 1997"
12,3,11,645,153,148,301,"6 de julio de 1997"
12,3,11,646,258,339,597,"6 de julio de 1997"
12,3,11,647,378,381,759,"6 de julio de 1997"
12,3,11,648,41,32,73,"6 de julio de 1997"
12,3,11,649,59,52,111,"6 de julio de 1997"
12,3,11,650,381,338,719,"6 de julio de 1997"
12,3,11,651,45,33,78,"6 de julio de 1997"
12,3,11,652,120,92,212,"6 de julio de 1997"
12,3,11,653,178,154,332,"6 de julio de 1997"
12,3,11,654,91,87,178,"6 de julio de 1997"
12,3,11,655,68,87,155,"6 de julio de 1997"
12,3,11,656,79,69,148,"6 de julio de 1997"
12,3,11,657,522,500,1022,"6 de julio de 1997"
12,3,11,658,186,193,379,"6 de julio de 1997"
12,3,11,659,463,503,966,"6 de julio de 1997"
12,3,11,660,93,83,176,"6 de julio de 1997"
12,3,11,661,254,259,513,"6 de julio de 1997"
12,3,11,662,167,165,332,"6 de julio de 1997"
12,3,11,663,380,423,803,"6 de julio de 1997"
12,3,11,664,371,365,736,"6 de julio de 1997"
12,3,11,665,420,477,897,"6 de julio de 1997"
12,3,11,666,74,69,143,"6 de julio de 1997"
12,3,11,667,165,173,338,"6 de julio de 1997"
12,3,11,668,246,330,576,"6 de julio de 1997"
12,3,11,669,415,460,875,"6 de julio de 1997"
12,3,11,670,454,531,985,"6 de julio de 1997"
12,3,14,763,438,460,898,"6 de julio de 1997"
12,3,14,764,405,470,875,"6 de julio de 1997"
12,3,14,765,426,445,871,"6 de julio de 1997"
12,3,14,766,556,554,1110,"6 de julio de 1997"
12,3,14,767,365,398,763,"6 de julio de 1997"
12,3,14,768,80,67,147,"6 de julio de 1997"
12,3,14,769,74,73,147,"6 de julio de 1997"
12,3,14,770,392,414,806,"6 de julio de 1997"
12,3,14,771,78,68,146,"6 de julio de 1997"
12,3,14,772,179,185,364,"6 de julio de 1997"
12,3,14,773,492,514,1006,"6 de julio de 1997"
12,3,14,774,488,463,951,"6 de julio de 1997"
12,3,14,775,356,367,723,"6 de julio de 1997"
12,3,14,776,339,381,720,"6 de julio de 1997"
12,3,14,777,138,127,265,"6 de julio de 1997"
12,3,16,789,145,154,299,"6 de julio de 1997"
12,3,16,790,192,184,376,"6 de julio de 1997"
12,3,16,791,89,84,173,"6 de julio de 1997"
12,3,16,792,210,167,377,"6 de julio de 1997"
12,3,16,793,171,113,284,"6 de julio de 1997"
12,3,16,794,174,161,335,"6 de julio de 1997"
12,3,16,795,128,121,249,"6 de julio de 1997"
12,3,16,796,116,88,204,"6 de julio de 1997"
12,3,16,797,128,113,241,"6 de julio de 1997"
12,3,16,798,55,66,121,"6 de julio de 1997"
12,3,16,799,84,86,170,"6 de julio de 1997"
12,3,16,800,178,161,339,"6 de julio de 1997"
12,3,16,801,117,99,216,"6 de julio de 1997"
12,3,16,802,74,51,125,"6 de julio de 1997"
12,3,16,803,54,37,91,"6 de julio de 1997"
12,3,16,804,102,88,190,"6 de julio de 1997"
12,3,16,805,117,113,230,"6 de julio de 1997"
12,3,16,806,77,50,127,"6 de julio de 1997"
12,3,16,807,89,88,177,"6 de julio de 1997"
12,3,16,808,140,120,260,"6 de julio de 1997"
12,3,16,809,59,51,110,"6 de julio de 1997"
12,3,16,810,94,75,169,"6 de julio de 1997"
12,3,16,811,79,71,150,"6 de julio de 1997"
12,3,16,812,69,77,146,"6 de julio de 1997"
12,3,16,813,77,50,127,"6 de julio de 1997"
12,3,16,814,119,119,238,"6 de julio de 1997"
12,3,16,815,121,114,235,"6 de julio de 1997"
12,3,16,816,35,20,55,"6 de julio de 1997"
12,3,16,817,101,88,189,"6 de julio de 1997"
12,3,16,818,57,40,97,"6 de julio de 1997"
12,3,16,819,437,349,786,"6 de julio de 1997"
12,3,39,1589,398,403,801,"6 de julio de 1997"
12,3,39,1590,1166,1266,2432,"6 de julio de 1997"
12,3,39,1591,244,281,525,"6 de julio de 1997"
12,3,39,1592,483,477,960,"6 de julio de 1997"
12,3,39,1593,402,396,798,"6 de julio de 1997"
12,3,39,1594,648,620,1268,"6 de julio de 1997"
12,3,39,1595,384,381,765,"6 de julio de 1997"
12,3,39,1596,192,163,355,"6 de julio de 1997"
12,3,39,1597,215,232,447,"6 de julio de 1997"
12,3,39,1598,252,265,517,"6 de julio de 1997"
12,3,39,1599,310,314,624,"6 de julio de 1997"
12,3,39,1600,339,336,675,"6 de julio de 1997"
12,3,39,1601,273,290,563,"6 de julio de 1997"
12,3,39,1602,220,226,446,"6 de julio de 1997"
12,3,39,1603,282,323,605,"6 de julio de 1997"
12,3,39,1604,156,209,365,"6 de julio de 1997"
12,3,39,1605,279,315,594,"6 de julio de 1997"
12,3,39,1606,329,328,657,"6 de julio de 1997"
12,3,39,1607,368,352,720,"6 de julio de 1997"
12,3,39,1608,427,353,780,"6 de julio de 1997"
12,3,39,1609,614,686,1300,"6 de julio de 1997"
12,3,39,1610,403,414,817,"6 de julio de 1997"
12,3,39,1611,522,515,1037,"6 de julio de 1997"
12,3,39,1612,440,449,889,"6 de julio de 1997"
12,3,39,1613,443,485,928,"6 de julio de 1997"
12,3,39,1614,352,376,728,"6 de julio de 1997"
12,3,39,1615,318,337,655,"6 de julio de 1997"
12,3,39,1616,366,420,786,"6 de julio de 1997"
12,3,39,1617,515,542,1057,"6 de julio de 1997"
12,3,39,1618,155,153,308,"6 de julio de 1997"
12,3,39,1619,491,554,1045,"6 de julio de 1997"
12,3,39,1620,349,344,693,"6 de julio de 1997"
12,3,39,1621,188,191,379,"6 de julio de 1997"
12,3,39,1622,126,129,255,"6 de julio de 1997"
12,3,39,1623,165,51,216,"6 de julio de 1997"
12,3,39,1624,209,225,434,"6 de julio de 1997"
12,3,39,1625,282,266,548,"6 de julio de 1997"
12,3,39,1626,114,106,220,"6 de julio de 1997"
12,3,39,1627,156,100,256,"6 de julio de 1997"
12,3,39,1628,639,561,1200,"6 de julio de 1997"
12,3,39,1629,260,235,495,"6 de julio de 1997"
12,3,39,1630,59,43,102,"6 de julio de 1997"
12,3,39,1631,121,98,219,"6 de julio de 1997"
12,3,39,1632,179,155,334,"6 de julio de 1997"
12,3,39,1633,111,110,221,"6 de julio de 1997"
12,3,39,1634,29,27,56,"6 de julio de 1997"
12,3,39,1635,445,481,926,"6 de julio de 1997"
12,3,39,1636,468,493,961,"6 de julio de 1997"
12,3,39,1637,102,91,193,"6 de julio de 1997"
12,3,39,1638,383,390,773,"6 de julio de 1997"
12,3,39,1639,179,174,353,"6 de julio de 1997"
12,3,39,1640,333,356,689,"6 de julio de 1997"
12,3,39,1641,515,564,1079,"6 de julio de 1997"
12,3,39,1642,129,106,235,"6 de julio de 1997"
12,3,39,1643,227,244,471,"6 de julio de 1997"
12,3,39,1644,303,262,565,"6 de julio de 1997"
12,3,39,1645,144,163,307,"6 de julio de 1997"
12,3,39,1646,436,437,873,"6 de julio de 1997"
12,3,39,1647,545,535,1080,"6 de julio de 1997"
12,3,39,1648,475,472,947,"6 de julio de 1997"
12,3,39,1649,266,249,515,"6 de julio de 1997"
12,3,39,1650,180,177,357,"6 de julio de 1997"
12,3,39,1651,192,198,390,"6 de julio de 1997"
12,3,39,1652,237,214,451,"6 de julio de 1997"
12,3,39,1653,249,250,499,"6 de julio de 1997"
12,3,49,1875,416,393,809,"6 de julio de 1997"
12,3,49,1876,873,109,982,"6 de julio de 1997"
12,3,49,1877,350,406,756,"6 de julio de 1997"
12,3,49,1878,260,318,578,"6 de julio de 1997"
12,3,49,1879,332,403,735,"6 de julio de 1997"
12,3,49,1880,224,249,473,"6 de julio de 1997"
12,3,49,1881,258,312,570,"6 de julio de 1997"
12,3,49,1882,256,284,540,"6 de julio de 1997"
12,3,49,1883,330,337,667,"6 de julio de 1997"
12,3,49,1884,272,273,545,"6 de julio de 1997"
12,3,49,1885,246,255,501,"6 de julio de 1997"
12,3,49,1886,329,306,635,"6 de julio de 1997"
12,3,49,1887,624,689,1313,"6 de julio de 1997"
12,3,49,1888,390,417,807,"6 de julio de 1997"
12,3,49,1889,300,336,636,"6 de julio de 1997"
12,3,49,1890,71,41,112,"6 de julio de 1997"
12,3,49,1891,38,24,62,"6 de julio de 1997"
12,3,49,1892,93,53,146,"6 de julio de 1997"
12,3,49,1893,81,57,138,"6 de julio de 1997"
12,3,49,1894,167,129,296,"6 de julio de 1997"
12,3,49,1895,85,59,144,"6 de julio de 1997"
12,3,49,1896,73,54,127,"6 de julio de 1997"
12,3,49,1897,151,129,280,"6 de julio de 1997"
12,3,49,1898,136,100,236,"6 de julio de 1997"
12,3,49,1899,53,41,94,"6 de julio de 1997"
12,3,49,1900,106,86,192,"6 de julio de 1997"
12,3,49,1901,62,57,119,"6 de julio de 1997"
12,3,49,1902,158,101,259,"6 de julio de 1997"
12,3,49,1903,216,152,368,"6 de julio de 1997"
12,3,49,1904,73,53,126,"6 de julio de 1997"
12,3,49,1905,77,45,122,"6 de julio de 1997"
12,3,49,1906,77,79,156,"6 de julio de 1997"
12,3,49,1907,282,224,506,"6 de julio de 1997"
12,3,49,1908,148,110,258,"6 de julio de 1997"
12,3,49,1909,352,390,742,"6 de julio de 1997"
12,3,49,1910,294,300,594,"6 de julio de 1997"
12,3,49,1911,326,356,682,"6 de julio de 1997"
12,3,49,1912,381,409,790,"6 de julio de 1997"
12,3,49,1913,380,350,730,"6 de julio de 1997"
12,3,49,1914,74,55,129,"6 de julio de 1997"
12,3,49,1915,145,111,256,"6 de julio de 1997"
12,3,49,1916,48,37,85,"6 de julio de 1997"
12,3,49,1917,227,174,401,"6 de julio de 1997"
12,3,49,1918,81,61,142,"6 de julio de 1997"
12,3,49,1919,33,28,61,"6 de julio de 1997"
12,3,49,1920,186,166,352,"6 de julio de 1997"
12,3,49,1921,81,58,139,"6 de julio de 1997"
12,3,49,1922,47,27,74,"6 de julio de 1997"
12,3,49,1923,36,29,65,"6 de julio de 1997"
12,3,49,1924,64,63,127,"6 de julio de 1997"
12,3,49,1925,216,197,413,"6 de julio de 1997"
12,3,49,1926,143,146,289,"6 de julio de 1997"
12,3,49,1927,80,81,161,"6 de julio de 1997"
12,3,49,1928,103,73,176,"6 de julio de 1997"
12,3,49,1929,545,533,1078,"6 de julio de 1997"
12,3,49,1930,105,106,211,"6 de julio de 1997"
12,3,49,1931,170,141,311,"6 de julio de 1997"
12,3,49,1932,85,64,149,"6 de julio de 1997"
12,3,58,2262,261,259,520,"6 de julio de 1997"
12,3,58,2263,462,484,946,"6 de julio de 1997"
12,3,58,2264,466,479,945,"6 de julio de 1997"
12,3,58,2265,471,452,923,"6 de julio de 1997"
12,3,58,2266,542,528,1070,"6 de julio de 1997"
12,3,58,2267,386,349,735,"6 de julio de 1997"
12,3,58,2268,541,536,1077,"6 de julio de 1997"
12,3,58,2269,537,551,1088,"6 de julio de 1997"
12,3,58,2270,577,585,1162,"6 de julio de 1997"
12,3,58,2271,442,424,866,"6 de julio de 1997"
12,3,58,2272,229,248,477,"6 de julio de 1997"
12,3,58,2273,244,250,494,"6 de julio de 1997"
12,3,58,2274,284,308,592,"6 de julio de 1997"
12,3,58,2275,76,50,126,"6 de julio de 1997"
12,3,58,2276,217,120,337,"6 de julio de 1997"
12,3,58,2277,319,218,537,"6 de julio de 1997"
12,3,58,2278,94,68,162,"6 de julio de 1997"
12,3,58,2279,168,84,252,"6 de julio de 1997"
12,3,58,2280,126,93,219,"6 de julio de 1997"
12,3,58,2281,75,81,156,"6 de julio de 1997"
12,3,58,2282,28,22,50,"6 de julio de 1997"
12,3,58,2283,103,51,154,"6 de julio de 1997"
12,3,58,2284,44,43,87,"6 de julio de 1997"
12,3,58,2285,211,122,333,"6 de julio de 1997"
12,3,58,2286,189,137,326,"6 de julio de 1997"
12,3,58,2287,57,55,112,"6 de julio de 1997"
12,3,58,2288,39,29,68,"6 de julio de 1997"
12,3,58,2289,185,225,410,"6 de julio de 1997"
12,3,58,2290,211,159,370,"6 de julio de 1997"
12,3,58,2291,95,92,187,"6 de julio de 1997"
12,3,58,2292,413,385,798,"6 de julio de 1997"
12,3,58,2293,239,234,473,"6 de julio de 1997"
12,3,58,2294,269,264,533,"6 de julio de 1997"
12,3,58,2295,79,79,158,"6 de julio de 1997"
12,3,58,2296,82,69,151,"6 de julio de 1997"
12,3,58,2297,53,32,85,"6 de julio de 1997"
12,3,58,2298,97,67,164,"6 de julio de 1997"
12,3,58,2299,67,48,115,"6 de julio de 1997"
12,3,58,2300,219,192,411,"6 de julio de 1997"
12,3,58,2301,70,48,118,"6 de julio de 1997"
12,3,58,2302,143,129,272,"6 de julio de 1997"
12,3,58,2303,126,114,240,"6 de julio de 1997"
12,3,58,2304,269,279,548,"6 de julio de 1997"
12,3,58,2305,324,321,645,"6 de julio de 1997"
12,3,58,2306,394,372,766,"6 de julio de 1997"
12,3,58,2307,212,197,409,"6 de julio de 1997"
12,3,58,2308,437,421,858,"6 de julio de 1997"
12,3,58,2309,308,310,618,"6 de julio de 1997"
12,3,58,2310,474,475,949,"6 de julio de 1997"
12,3,58,2311,70,70,140,"6 de julio de 1997"
12,3,58,2312,99,78,177,"6 de julio de 1997"
12,3,58,2313,237,206,443,"6 de julio de 1997"
12,3,58,2314,81,59,140,"6 de julio de 1997"
12,3,58,2315,47,35,82,"6 de julio de 1997"
12,3,58,2316,63,63,126,"6 de julio de 1997"
12,3,58,2317,159,144,303,"6 de julio de 1997"
12,3,58,2318,59,41,100,"6 de julio de 1997"
12,3,58,2319,252,200,452,"6 de julio de 1997"
12,3,58,2320,232,208,440,"6 de julio de 1997"
12,3,58,2321,176,147,323,"6 de julio de 1997"
12,3,58,2322,71,64,135,"6 de julio de 1997"
12,3,58,2323,359,352,711,"6 de julio de 1997"
12,3,58,2324,339,361,700,"6 de julio de 1997"
12,3,58,2325,67,71,138,"6 de julio de 1997"
12,3,58,2326,321,333,654,"6 de julio de 1997"
12,3,58,2327,285,268,553,"6 de julio de 1997"
12,3,58,2328,391,395,786,"6 de julio de 1997"
12,3,58,2329,107,80,187,"6 de julio de 1997"
12,3,58,2330,639,637,1276,"6 de julio de 1997"
12,3,69,2622,469,450,919,"6 de julio de 1997"
12,3,69,2623,313,297,610,"6 de julio de 1997"
12,3,69,2624,306,283,589,"6 de julio de 1997"
12,3,69,2625,88,71,159,"6 de julio de 1997"
12,3,69,2626,142,129,271,"6 de julio de 1997"
12,3,69,2627,107,83,190,"6 de julio de 1997"
12,3,69,2628,113,76,189,"6 de julio de 1997"
12,3,69,2629,170,145,315,"6 de julio de 1997"
12,3,69,2630,198,175,373,"6 de julio de 1997"
12,3,69,2631,88,74,162,"6 de julio de 1997"
12,3,69,2632,247,226,473,"6 de julio de 1997"
12,3,69,2633,98,72,170,"6 de julio de 1997"
12,3,69,2634,192,197,389,"6 de julio de 1997"
12,3,69,2635,181,162,343,"6 de julio de 1997"
12,3,69,2636,430,424,854,"6 de julio de 1997"
12,3,69,2637,140,122,262,"6 de julio de 1997"
12,3,69,2638,167,151,318,"6 de julio de 1997"
12,3,69,2639,417,344,761,"6 de julio de 1997"
12,3,69,2640,343,290,633,"6 de julio de 1997"
12,3,69,2641,552,511,1063,"6 de julio de 1997"
12,3,69,2642,425,396,821,"6 de julio de 1997"
12,3,69,2643,274,240,514,"6 de julio de 1997"
12,3,69,2644,102,82,184,"6 de julio de 1997"
12,3,69,2645,89,71,160,"6 de julio de 1997"
12,3,69,2646,120,87,207,"6 de julio de 1997"
12,3,69,2647,188,157,345,"6 de julio de 1997"
12,3,69,2648,225,191,416,"6 de julio de 1997"
12,3,69,2649,78,82,160,"6 de julio de 1997"
12,3,69,2650,75,66,141,"6 de julio de 1997"
12,3,69,2651,250,238,488,"6 de julio de 1997"
12,3,69,2652,70,60,130,"6 de julio de 1997"
12,3,69,2653,138,114,252,"6 de julio de 1997"
12,3,69,2654,498,461,959,"6 de julio de 1997"
12,4,8,553,310,331,641,"6 de julio de 1997"
12,4,8,554,345,422,767,"6 de julio de 1997"
12,4,8,555,129,163,292,"6 de julio de 1997"
12,4,8,556,145,166,311,"6 de julio de 1997"
12,4,8,557,162,191,353,"6 de julio de 1997"
12,4,8,558,26,34,60,"6 de julio de 1997"
12,4,8,559,76,86,162,"6 de julio de 1997"
12,4,8,560,233,248,481,"6 de julio de 1997"
12,4,8,561,223,238,461,"6 de julio de 1997"
12,4,8,562,244,265,509,"6 de julio de 1997"
12,4,8,563,219,207,426,"6 de julio de 1997"
12,4,19,858,784,823,1607,"6 de julio de 1997"
12,4,19,859,615,705,1320,"6 de julio de 1997"
12,4,19,860,82,80,162,"6 de julio de 1997"
12,4,19,861,100,80,180,"6 de julio de 1997"
12,4,19,862,436,459,895,"6 de julio de 1997"
12,4,19,863,169,170,339,"6 de julio de 1997"
12,4,19,864,116,135,251,"6 de julio de 1997"
12,4,19,865,214,246,460,"6 de julio de 1997"
12,4,19,866,118,105,223,"6 de julio de 1997"
12,4,19,867,298,299,597,"6 de julio de 1997"
12,4,30,1309,195,202,397,"6 de julio de 1997"
12,4,30,1310,295,284,579,"6 de julio de 1997"
12,4,30,1311,383,401,784,"6 de julio de 1997"
12,4,30,1312,410,452,862,"6 de julio de 1997"
12,4,30,1313,392,378,770,"6 de julio de 1997"
12,4,30,1314,412,517,929,"6 de julio de 1997"
12,4,30,1315,639,638,1277,"6 de julio de 1997"
12,4,30,1316,509,532,1041,"6 de julio de 1997"
12,4,30,1317,349,400,749,"6 de julio de 1997"
12,4,30,1318,473,480,953,"6 de julio de 1997"
12,4,30,1319,259,286,545,"6 de julio de 1997"
12,4,30,1320,187,306,493,"6 de julio de 1997"
12,4,30,1321,22,27,49,"6 de julio de 1997"
12,4,30,1322,177,87,264,"6 de julio de 1997"
12,4,30,1323,306,306,612,"6 de julio de 1997"
12,4,30,1324,245,249,494,"6 de julio de 1997"
12,4,30,1325,52,27,79,"6 de julio de 1997"
12,4,30,1326,258,235,493,"6 de julio de 1997"
12,4,30,1327,35,34,69,"6 de julio de 1997"
12,4,30,1328,154,158,312,"6 de julio de 1997"
12,4,30,1329,464,588,1052,"6 de julio de 1997"
12,4,30,1330,326,395,721,"6 de julio de 1997"
12,4,30,1331,250,266,516,"6 de julio de 1997"
12,4,30,1332,220,233,453,"6 de julio de 1997"
12,4,30,1333,76,57,133,"6 de julio de 1997"
12,4,30,1334,460,512,972,"6 de julio de 1997"
12,4,30,1335,410,453,863,"6 de julio de 1997"
12,4,30,1336,167,166,333,"6 de julio de 1997"
12,4,30,1337,121,133,254,"6 de julio de 1997"
12,4,30,1338,48,38,86,"6 de julio de 1997"
12,4,33,1382,355,408,763,"6 de julio de 1997"
12,4,33,1383,432,442,874,"6 de julio de 1997"
12,4,33,1384,527,542,1069,"6 de julio de 1997"
12,4,33,1385,50,43,93,"6 de julio de 1997"
12,4,33,1386,168,204,372,"6 de julio de 1997"
12,4,33,1387,46,43,89,"6 de julio de 1997"
12,4,33,1388,167,187,354,"6 de julio de 1997"
12,4,33,1389,57,52,109,"6 de julio de 1997"
12,4,33,1390,48,30,78,"6 de julio de 1997"
12,4,33,1391,47,42,89,"6 de julio de 1997"
12,4,33,1392,23,30,53,"6 de julio de 1997"
12,4,33,1393,127,119,246,"6 de julio de 1997"
12,4,33,1394,79,59,138,"6 de julio de 1997"
12,4,33,1395,47,33,80,"6 de julio de 1997"
12,4,33,1396,44,31,75,"6 de julio de 1997"
12,4,33,1397,80,52,132,"6 de julio de 1997"
12,4,33,1398,166,133,299,"6 de julio de 1997"
12,4,33,1399,60,40,100,"6 de julio de 1997"
12,4,33,1400,23,16,39,"6 de julio de 1997"
12,4,33,1401,48,40,88,"6 de julio de 1997"
12,4,33,1402,233,201,434,"6 de julio de 1997"
12,4,33,1403,68,48,116,"6 de julio de 1997"
12,4,33,1404,143,117,260,"6 de julio de 1997"
12,4,33,1405,137,92,229,"6 de julio de 1997"
12,4,33,1406,128,119,247,"6 de julio de 1997"
12,4,33,1407,64,61,125,"6 de julio de 1997"
12,4,33,1408,95,87,182,"6 de julio de 1997"
12,4,33,1409,72,64,136,"6 de julio de 1997"
12,4,33,1410,147,118,265,"6 de julio de 1997"
12,4,33,1411,134,109,243,"6 de julio de 1997"
12,4,33,1412,42,34,76,"6 de julio de 1997"
12,4,33,1413,83,85,168,"6 de julio de 1997"
12,4,33,1414,163,118,281,"6 de julio de 1997"
12,4,33,1415,67,47,114,"6 de julio de 1997"
12,4,33,1416,73,49,122,"6 de julio de 1997"
12,4,33,1417,212,171,383,"6 de julio de 1997"
12,4,33,1418,205,153,358,"6 de julio de 1997"
12,4,33,1419,155,118,273,"6 de julio de 1997"
12,4,33,1420,125,88,213,"6 de julio de 1997"
12,4,33,1421,171,109,280,"6 de julio de 1997"
12,4,33,1422,118,90,208,"6 de julio de 1997"
12,4,33,1423,74,49,123,"6 de julio de 1997"
12,4,33,1424,66,47,113,"6 de julio de 1997"
12,4,33,1425,84,86,170,"6 de julio de 1997"
12,4,33,1426,122,92,214,"6 de julio de 1997"
12,4,33,1427,29,31,60,"6 de julio de 1997"
12,4,33,1428,318,243,561,"6 de julio de 1997"
12,4,33,1429,94,63,157,"6 de julio de 1997"
12,4,33,1430,121,111,232,"6 de julio de 1997"
12,4,33,1431,354,252,606,"6 de julio de 1997"
12,4,35,1444,288,344,632,"6 de julio de 1997"
12,4,35,1445,364,395,759,"6 de julio de 1997"
12,4,35,1446,385,418,803,"6 de julio de 1997"
12,4,35,1447,298,355,653,"6 de julio de 1997"
12,4,35,1448,299,376,675,"6 de julio de 1997"
12,4,35,1449,356,432,788,"6 de julio de 1997"
12,4,35,1450,358,424,782,"6 de julio de 1997"
12,4,35,1451,358,408,766,"6 de julio de 1997"
12,4,35,1452,333,392,725,"6 de julio de 1997"
12,4,35,1453,238,281,519,"6 de julio de 1997"
12,4,35,1454,422,501,923,"6 de julio de 1997"
12,4,35,1455,451,545,996,"6 de julio de 1997"
12,4,35,1456,236,279,515,"6 de julio de 1997"
12,4,35,1457,54,53,107,"6 de julio de 1997"
12,4,35,1458,247,340,587,"6 de julio de 1997"
12,4,35,1459,184,226,410,"6 de julio de 1997"
12,4,35,1460,178,217,395,"6 de julio de 1997"
12,4,35,1461,39,30,69,"6 de julio de 1997"
12,4,35,1462,206,287,493,"6 de julio de 1997"
12,4,35,1463,358,482,840,"6 de julio de 1997"
12,4,35,1464,372,437,809,"6 de julio de 1997"
12,4,35,1465,291,342,633,"6 de julio de 1997"
12,4,35,1466,39,53,92,"6 de julio de 1997"
12,4,35,1467,96,104,200,"6 de julio de 1997"
12,4,35,1468,179,204,383,"6 de julio de 1997"
12,4,35,1469,290,270,560,"6 de julio de 1997"
12,4,35,1470,76,89,165,"6 de julio de 1997"
12,4,35,1471,93,100,193,"6 de julio de 1997"
12,4,35,1472,195,212,407,"6 de julio de 1997"
12,4,35,1473,243,294,537,"6 de julio de 1997"
12,4,35,1474,229,256,485,"6 de julio de 1997"
12,4,35,1475,62,54,116,"6 de julio de 1997"
12,4,35,1476,67,64,131,"6 de julio de 1997"
12,4,35,1477,315,366,681,"6 de julio de 1997"
12,4,35,1478,341,385,726,"6 de julio de 1997"
12,4,35,1479,220,235,455,"6 de julio de 1997"
12,4,36,1480,444,509,953,"6 de julio de 1997"
12,4,36,1481,226,225,451,"6 de julio de 1997"
12,4,36,1482,271,375,646,"6 de julio de 1997"
12,4,36,1483,310,342,652,"6 de julio de 1997"
12,4,36,1484,341,399,740,"6 de julio de 1997"
12,4,36,1485,413,526,939,"6 de julio de 1997"
12,4,36,1486,416,498,914,"6 de julio de 1997"
12,4,36,1487,647,820,1467,"6 de julio de 1997"
12,4,36,1488,346,378,724,"6 de julio de 1997"
12,4,36,1489,322,384,706,"6 de julio de 1997"
12,4,36,1490,504,620,1124,"6 de julio de 1997"
12,4,36,1491,357,406,763,"6 de julio de 1997"
12,4,36,1492,632,737,1369,"6 de julio de 1997"
12,4,36,1493,403,498,901,"6 de julio de 1997"
12,4,36,1494,338,403,741,"6 de julio de 1997"
12,4,36,1495,485,532,1017,"6 de julio de 1997"
12,4,36,1496,133,187,320,"6 de julio de 1997"
12,4,36,1497,355,429,784,"6 de julio de 1997"
12,4,36,1498,406,495,901,"6 de julio de 1997"
12,4,36,1499,333,395,728,"6 de julio de 1997"
12,4,36,1500,546,659,1205,"6 de julio de 1997"
12,4,36,1501,675,447,1122,"6 de julio de 1997"
12,4,36,1502,447,494,941,"6 de julio de 1997"
12,4,36,1503,426,465,891,"6 de julio de 1997"
12,4,36,1504,383,449,832,"6 de julio de 1997"
12,4,36,1505,423,453,876,"6 de julio de 1997"
12,4,36,1506,271,354,625,"6 de julio de 1997"
12,4,36,1507,365,444,809,"6 de julio de 1997"
12,4,36,1508,321,412,733,"6 de julio de 1997"
12,4,36,1509,284,332,616,"6 de julio de 1997"
12,4,36,1510,423,565,988,"6 de julio de 1997"
12,4,36,1511,541,631,1172,"6 de julio de 1997"
12,4,36,1512,552,666,1218,"6 de julio de 1997"
12,4,36,1513,566,735,1301,"6 de julio de 1997"
12,4,36,1514,363,397,760,"6 de julio de 1997"
12,4,36,1515,445,492,937,"6 de julio de 1997"
12,4,36,1516,310,352,662,"6 de julio de 1997"
12,4,36,1517,124,133,257,"6 de julio de 1997"
12,4,36,1518,219,261,480,"6 de julio de 1997"
12,4,36,1519,191,195,386,"6 de julio de 1997"
12,4,36,1520,219,251,470,"6 de julio de 1997"
12,4,36,1521,389,464,853,"6 de julio de 1997"
12,4,36,1522,403,502,905,"6 de julio de 1997"
12,4,36,1523,319,394,713,"6 de julio de 1997"
12,4,36,1524,455,497,952,"6 de julio de 1997"
12,4,36,1525,289,375,664,"6 de julio de 1997"
12,4,36,1526,387,471,858,"6 de julio de 1997"
12,4,36,1527,520,670,1190,"6 de julio de 1997"
12,4,36,1528,446,503,949,"6 de julio de 1997"
12,4,36,1529,293,352,645,"6 de julio de 1997"
12,4,36,1530,298,345,643,"6 de julio de 1997"
12,4,36,1531,448,498,946,"6 de julio de 1997"
12,4,36,1532,467,563,1030,"6 de julio de 1997"
12,4,36,1533,461,562,1023,"6 de julio de 1997"
12,4,36,1534,471,532,1003,"6 de julio de 1997"
12,4,36,1535,348,414,762,"6 de julio de 1997"
12,4,36,1536,472,548,1020,"6 de julio de 1997"
12,4,36,1537,418,530,948,"6 de julio de 1997"
12,4,36,1538,376,429,805,"6 de julio de 1997"
12,4,36,1539,459,550,1009,"6 de julio de 1997"
12,4,36,1540,250,309,559,"6 de julio de 1997"
12,4,36,1541,308,372,680,"6 de julio de 1997"
12,4,36,1542,408,463,871,"6 de julio de 1997"
12,4,36,1543,682,828,1510,"6 de julio de 1997"
12,4,36,1544,284,320,604,"6 de julio de 1997"
12,4,36,1545,122,159,281,"6 de julio de 1997"
12,4,36,1546,100,113,213,"6 de julio de 1997"
12,4,36,1547,527,596,1123,"6 de julio de 1997"
12,4,36,1548,67,62,129,"6 de julio de 1997"
12,4,36,1549,136,176,312,"6 de julio de 1997"
12,4,36,1550,362,411,773,"6 de julio de 1997"
12,4,36,1551,128,147,275,"6 de julio de 1997"
12,4,36,1552,157,163,320,"6 de julio de 1997"
12,4,36,1553,114,123,237,"6 de julio de 1997"
12,4,36,1554,103,113,216,"6 de julio de 1997"
12,4,36,1555,108,123,231,"6 de julio de 1997"
12,4,36,1556,96,103,199,"6 de julio de 1997"
12,4,36,1557,382,428,810,"6 de julio de 1997"
12,4,36,1558,268,331,599,"6 de julio de 1997"
12,4,36,1559,277,313,590,"6 de julio de 1997"
12,4,36,1560,255,326,581,"6 de julio de 1997"
12,4,36,1561,53,60,113,"6 de julio de 1997"
12,4,36,1562,384,437,821,"6 de julio de 1997"
12,4,36,1563,273,297,570,"6 de julio de 1997"
12,4,36,1564,219,241,460,"6 de julio de 1997"
12,4,60,2420,276,303,579,"6 de julio de 1997"
12,4,60,2421,447,520,967,"6 de julio de 1997"
12,4,60,2422,136,140,276,"6 de julio de 1997"
12,4,60,2423,462,523,985,"6 de julio de 1997"
12,4,60,2424,275,298,573,"6 de julio de 1997"
12,4,60,2425,330,424,754,"6 de julio de 1997"
12,4,60,2426,136,159,295,"6 de julio de 1997"
12,4,60,2427,323,350,673,"6 de julio de 1997"
12,4,60,2428,120,133,253,"6 de julio de 1997"
12,4,60,2429,194,185,379,"6 de julio de 1997"
12,4,60,2430,226,254,480,"6 de julio de 1997"
12,4,60,2431,192,185,377,"6 de julio de 1997"
12,4,60,2432,76,74,150,"6 de julio de 1997"
12,4,60,2433,365,441,806,"6 de julio de 1997"
12,4,60,2434,365,472,837,"6 de julio de 1997"
12,4,60,2435,44,35,79,"6 de julio de 1997"
12,4,60,2436,90,125,215,"6 de julio de 1997"
12,4,60,2437,206,249,455,"6 de julio de 1997"
12,4,60,2438,272,313,585,"6 de julio de 1997"
12,4,60,2439,310,334,644,"6 de julio de 1997"
12,4,60,2440,120,126,246,"6 de julio de 1997"
12,4,60,2441,87,96,183,"6 de julio de 1997"
12,4,60,2442,294,326,620,"6 de julio de 1997"
12,4,60,2443,152,185,337,"6 de julio de 1997"
12,4,60,2444,407,534,941,"6 de julio de 1997"
12,4,60,2445,363,457,820,"6 de julio de 1997"
12,4,60,2446,385,441,826,"6 de julio de 1997"
12,4,60,2447,538,656,1194,"6 de julio de 1997"
12,4,60,2448,479,585,1064,"6 de julio de 1997"
12,4,60,2449,68,90,158,"6 de julio de 1997"
12,4,60,2450,238,263,501,"6 de julio de 1997"
12,5,4,456,472,487,959,"6 de julio de 1997"
12,5,4,457,204,229,433,"6 de julio de 1997"
12,5,4,458,51,52,103,"6 de julio de 1997"
12,5,4,459,326,358,684,"6 de julio de 1997"
12,5,4,460,58,63,121,"6 de julio de 1997"
12,5,4,461,131,169,300,"6 de julio de 1997"
12,5,4,462,37,45,82,"6 de julio de 1997"
12,5,4,463,148,145,293,"6 de julio de 1997"
12,5,4,464,147,158,305,"6 de julio de 1997"
12,5,4,465,357,408,765,"6 de julio de 1997"
12,5,4,466,71,88,159,"6 de julio de 1997"
12,5,4,467,278,377,655,"6 de julio de 1997"
12,5,4,468,238,278,516,"6 de julio de 1997"
12,5,4,469,224,214,438,"6 de julio de 1997"
12,5,4,470,88,78,166,"6 de julio de 1997"
12,5,4,471,225,203,428,"6 de julio de 1997"
12,5,4,472,402,434,836,"6 de julio de 1997"
12,5,4,473,283,239,522,"6 de julio de 1997"
12,5,5,474,418,493,911,"6 de julio de 1997"
12,5,5,475,252,295,547,"6 de julio de 1997"
12,5,5,476,297,332,629,"6 de julio de 1997"
12,5,5,477,87,104,191,"6 de julio de 1997"
12,5,5,478,206,244,450,"6 de julio de 1997"
12,5,9,564,246,239,485,"6 de julio de 1997"
12,5,9,565,122,142,264,"6 de julio de 1997"
12,5,9,566,81,79,160,"6 de julio de 1997"
12,5,9,567,48,44,92,"6 de julio de 1997"
12,5,9,568,80,76,156,"6 de julio de 1997"
12,5,9,569,115,129,244,"6 de julio de 1997"
12,5,9,570,204,235,439,"6 de julio de 1997"
12,5,9,571,43,52,95,"6 de julio de 1997"
12,5,9,572,118,106,224,"6 de julio de 1997"
12,5,20,868,589,601,1190,"6 de julio de 1997"
12,5,20,869,109,109,218,"6 de julio de 1997"
12,5,20,870,165,174,339,"6 de julio de 1997"
12,5,20,871,126,146,272,"6 de julio de 1997"
12,5,20,872,348,399,747,"6 de julio de 1997"
12,5,20,873,416,434,850,"6 de julio de 1997"
12,5,20,874,261,241,502,"6 de julio de 1997"
12,5,20,875,131,119,250,"6 de julio de 1997"
12,5,20,876,113,88,201,"6 de julio de 1997"
12,5,20,877,508,575,1083,"6 de julio de 1997"
12,5,20,878,236,270,506,"6 de julio de 1997"
12,5,20,879,223,143,366,"6 de julio de 1997"
12,5,20,880,42,48,90,"6 de julio de 1997"
12,5,20,881,206,203,409,"6 de julio de 1997"
12,5,20,882,92,80,172,"6 de julio de 1997"
12,5,24,1030,490,590,1080,"6 de julio de 1997"
12,5,24,1031,184,151,335,"6 de julio de 1997"
12,5,24,1032,47,45,92,"6 de julio de 1997"
12,5,24,1033,270,288,558,"6 de julio de 1997"
12,5,24,1034,191,168,359,"6 de julio de 1997"
12,5,24,1035,119,108,227,"6 de julio de 1997"
12,5,24,1036,197,207,404,"6 de julio de 1997"
12,5,34,1432,274,366,640,"6 de julio de 1997"
12,5,34,1433,355,448,803,"6 de julio de 1997"
12,5,34,1434,528,632,1160,"6 de julio de 1997"
12,5,34,1435,123,179,302,"6 de julio de 1997"
12,5,34,1436,134,153,287,"6 de julio de 1997"
12,5,34,1437,336,412,748,"6 de julio de 1997"
12,5,34,1438,74,98,172,"6 de julio de 1997"
12,5,34,1439,252,283,535,"6 de julio de 1997"
12,5,34,1440,288,290,578,"6 de julio de 1997"
12,5,34,1441,246,333,579,"6 de julio de 1997"
12,5,34,1442,196,243,439,"6 de julio de 1997"
12,5,34,1443,140,151,291,"6 de julio de 1997"
12,5,42,1699,428,472,900,"6 de julio de 1997"
12,5,42,1700,352,375,727,"6 de julio de 1997"
12,5,42,1701,252,232,484,"6 de julio de 1997"
12,5,42,1702,257,256,513,"6 de julio de 1997"
12,5,42,1703,263,335,598,"6 de julio de 1997"
12,5,42,1704,227,202,429,"6 de julio de 1997"
12,5,42,1705,89,103,192,"6 de julio de 1997"
12,5,42,1706,277,309,586,"6 de julio de 1997"
12,5,42,1707,377,427,804,"6 de julio de 1997"
12,5,42,1708,193,237,430,"6 de julio de 1997"
12,5,42,1709,325,334,659,"6 de julio de 1997"
12,5,42,1710,370,353,723,"6 de julio de 1997"
12,5,42,1711,291,286,577,"6 de julio de 1997"
12,5,42,1712,307,216,523,"6 de julio de 1997"
12,5,42,1713,425,355,780,"6 de julio de 1997"
12,5,42,1714,174,130,304,"6 de julio de 1997"
12,5,42,1715,155,133,288,"6 de julio de 1997"
12,5,42,1716,400,406,806,"6 de julio de 1997"
12,5,42,1717,379,369,748,"6 de julio de 1997"
12,5,42,1718,187,182,369,"6 de julio de 1997"
12,5,44,1735,233,261,494,"6 de julio de 1997"
12,5,44,1736,422,450,872,"6 de julio de 1997"
12,5,44,1737,173,170,343,"6 de julio de 1997"
12,5,44,1738,105,116,221,"6 de julio de 1997"
12,5,44,1739,132,132,264,"6 de julio de 1997"
12,5,44,1740,122,114,236,"6 de julio de 1997"
12,5,44,1741,172,189,361,"6 de julio de 1997"
12,5,44,1742,87,88,175,"6 de julio de 1997"
12,5,44,1743,79,90,169,"6 de julio de 1997"
12,5,44,1744,249,236,485,"6 de julio de 1997"
12,5,44,1745,204,182,386,"6 de julio de 1997"
12,5,44,1746,331,257,588,"6 de julio de 1997"
12,5,44,1747,101,129,230,"6 de julio de 1997"
12,5,44,1748,309,361,670,"6 de julio de 1997"
12,5,44,1749,139,148,287,"6 de julio de 1997"
12,5,44,1750,316,276,592,"6 de julio de 1997"
12,5,44,1751,791,680,1471,"6 de julio de 1997"
12,5,44,1752,198,161,359,"6 de julio de 1997"
12,5,44,1753,442,421,863,"6 de julio de 1997"
12,5,44,1754,393,380,773,"6 de julio de 1997"
12,5,44,1755,106,80,186,"6 de julio de 1997"
12,5,44,1756,291,186,477,"6 de julio de 1997"
12,5,44,1757,161,171,332,"6 de julio de 1997"
12,5,44,1758,252,197,449,"6 de julio de 1997"
12,5,44,1759,348,296,644,"6 de julio de 1997"
12,5,44,1760,240,267,507,"6 de julio de 1997"
12,5,44,1761,174,147,321,"6 de julio de 1997"
12,5,44,1762,330,326,656,"6 de julio de 1997"
12,5,44,1763,41,46,87,"6 de julio de 1997"
12,5,46,1784,392,428,820,"6 de julio de 1997"
12,5,46,1785,327,335,662,"6 de julio de 1997"
12,5,46,1786,552,630,1182,"6 de julio de 1997"
12,5,46,1787,171,159,330,"6 de julio de 1997"
12,5,46,1788,84,109,193,"6 de julio de 1997"
12,5,46,1789,225,240,465,"6 de julio de 1997"
12,5,46,1790,115,91,206,"6 de julio de 1997"
12,5,46,1791,140,129,269,"6 de julio de 1997"
12,5,46,1792,218,222,440,"6 de julio de 1997"
12,5,46,1793,136,132,268,"6 de julio de 1997"
12,5,46,1794,76,79,155,"6 de julio de 1997"
12,5,46,1795,68,72,140,"6 de julio de 1997"
12,5,46,1796,64,53,117,"6 de julio de 1997"
12,5,46,1797,125,103,228,"6 de julio de 1997"
12,5,46,1798,721,677,1398,"6 de julio de 1997"
12,5,46,1799,151,108,259,"6 de julio de 1997"
12,5,46,1800,380,313,693,"6 de julio de 1997"
12,5,46,1801,132,134,266,"6 de julio de 1997"
12,5,46,1802,55,58,113,"6 de julio de 1997"
12,5,46,1803,94,110,204,"6 de julio de 1997"
12,5,46,1804,156,130,286,"6 de julio de 1997"
12,5,46,1805,61,61,122,"6 de julio de 1997"
12,5,46,1806,42,41,83,"6 de julio de 1997"
12,5,46,1807,101,107,208,"6 de julio de 1997"
12,5,46,1808,118,119,237,"6 de julio de 1997"
12,5,64,2523,387,435,822,"6 de julio de 1997"
12,5,64,2524,131,134,265,"6 de julio de 1997"
12,5,64,2525,67,77,144,"6 de julio de 1997"
12,5,64,2526,119,153,272,"6 de julio de 1997"
12,5,64,2527,482,538,1020,"6 de julio de 1997"
12,5,64,2528,249,258,507,"6 de julio de 1997"
12,5,64,2529,31,28,59,"6 de julio de 1997"
12,5,64,2530,86,70,156,"6 de julio de 1997"
12,5,64,2531,285,237,522,"6 de julio de 1997"
12,5,64,2532,80,73,153,"6 de julio de 1997"
12,5,66,2554,227,244,471,"6 de julio de 1997"
12,5,66,2555,344,344,688,"6 de julio de 1997"
12,5,66,2556,113,130,243,"6 de julio de 1997"
12,5,66,2557,80,79,159,"6 de julio de 1997"
12,5,66,2558,97,108,205,"6 de julio de 1997"
12,5,66,2559,58,83,141,"6 de julio de 1997"
12,5,66,2560,280,274,554,"6 de julio de 1997"
12,5,66,2561,335,391,726,"6 de julio de 1997"
12,5,67,2562,639,630,1269,"6 de julio de 1997"
12,5,67,2563,471,553,1024,"6 de julio de 1997"
12,5,67,2564,668,751,1419,"6 de julio de 1997"
12,5,67,2565,321,366,687,"6 de julio de 1997"
12,5,67,2566,666,751,1417,"6 de julio de 1997"
12,5,67,2567,632,774,1406,"6 de julio de 1997"
12,5,67,2568,372,445,817,"6 de julio de 1997"
12,5,67,2569,376,433,809,"6 de julio de 1997"
12,5,67,2570,477,566,1043,"6 de julio de 1997"
12,5,67,2571,403,518,921,"6 de julio de 1997"
12,5,67,2572,594,667,1261,"6 de julio de 1997"
12,5,67,2573,217,226,443,"6 de julio de 1997"
12,5,67,2574,198,190,388,"6 de julio de 1997"
12,5,67,2575,248,189,437,"6 de julio de 1997"
12,5,67,2576,76,77,153,"6 de julio de 1997"
12,5,67,2577,211,259,470,"6 de julio de 1997"
12,5,67,2578,304,256,560,"6 de julio de 1997"
12,5,67,2579,286,263,549,"6 de julio de 1997"
12,5,67,2580,175,163,338,"6 de julio de 1997"
12,5,67,2581,15,26,41,"6 de julio de 1997"
12,5,67,2582,234,230,464,"6 de julio de 1997"
12,5,67,2583,154,174,328,"6 de julio de 1997"
12,5,67,2584,127,125,252,"6 de julio de 1997"
12,5,67,2585,232,276,508,"6 de julio de 1997"
12,5,67,2586,590,546,1136,"6 de julio de 1997"
12,5,67,2587,235,272,507,"6 de julio de 1997"
12,5,67,2588,152,188,340,"6 de julio de 1997"
12,5,67,2589,220,232,452,"6 de julio de 1997"
12,5,67,2590,135,163,298,"6 de julio de 1997"
12,5,67,2591,43,32,75,"6 de julio de 1997"
12,5,67,2592,227,244,471,"6 de julio de 1997"
12,5,67,2593,437,457,894,"6 de julio de 1997"
12,5,67,2594,110,108,218,"6 de julio de 1997"
12,5,67,2595,567,563,1130,"6 de julio de 1997"
12,5,67,2596,102,96,198,"6 de julio de 1997"
12,5,67,2597,81,77,158,"6 de julio de 1997"
12,5,67,2598,201,174,375,"6 de julio de 1997"
12,5,67,2599,83,96,179,"6 de julio de 1997"
12,5,70,2655,822,889,1711,"6 de julio de 1997"
12,5,70,2656,44,43,87,"6 de julio de 1997"
12,5,70,2657,107,133,240,"6 de julio de 1997"
12,5,70,2658,67,92,159,"6 de julio de 1997"
12,5,70,2659,117,152,269,"6 de julio de 1997"
12,5,70,2660,197,177,374,"6 de julio de 1997"
12,5,70,2661,138,139,277,"6 de julio de 1997"
12,5,70,2662,162,225,387,"6 de julio de 1997"
12,5,70,2663,315,308,623,"6 de julio de 1997"
12,5,70,2664,251,275,526,"6 de julio de 1997"
12,5,70,2665,36,39,75,"6 de julio de 1997"
12,5,70,2666,33,36,69,"6 de julio de 1997"
12,5,70,2667,85,119,204,"6 de julio de 1997"
12,5,70,2668,133,154,287,"6 de julio de 1997"
12,5,71,2669,238,312,550,"6 de julio de 1997"
12,5,71,2670,446,641,1087,"6 de julio de 1997"
12,5,71,2671,351,479,830,"6 de julio de 1997"
12,5,71,2672,226,285,511,"6 de julio de 1997"
12,5,71,2673,127,148,275,"6 de julio de 1997"
12,5,71,2674,175,210,385,"6 de julio de 1997"
12,5,71,2675,59,73,132,"6 de julio de 1997"
12,5,71,2676,63,84,147,"6 de julio de 1997"
12,5,71,2677,36,36,72,"6 de julio de 1997"
12,6,2,384,751,755,1506,"6 de julio de 1997"
12,6,2,385,204,210,414,"6 de julio de 1997"
12,6,2,386,163,184,347,"6 de julio de 1997"
12,6,2,387,114,115,229,"6 de julio de 1997"
12,6,2,388,100,92,192,"6 de julio de 1997"
12,6,2,389,189,181,370,"6 de julio de 1997"
12,6,2,390,97,88,185,"6 de julio de 1997"
12,6,2,391,322,323,645,"6 de julio de 1997"
12,6,2,392,55,53,108,"6 de julio de 1997"
12,6,2,393,170,150,320,"6 de julio de 1997"
12,6,2,394,73,88,161,"6 de julio de 1997"
12,6,2,395,102,111,213,"6 de julio de 1997"
12,6,2,396,64,58,122,"6 de julio de 1997"
12,6,2,397,100,94,194,"6 de julio de 1997"
12,6,2,398,108,143,251,"6 de julio de 1997"
12,6,2,399,95,106,201,"6 de julio de 1997"
12,6,2,400,166,165,331,"6 de julio de 1997"
12,6,2,401,98,112,210,"6 de julio de 1997"
12,6,2,402,111,133,244,"6 de julio de 1997"
12,6,2,403,294,352,646,"6 de julio de 1997"
12,6,2,404,118,152,270,"6 de julio de 1997"
12,6,2,405,235,262,497,"6 de julio de 1997"
12,6,2,406,152,214,366,"6 de julio de 1997"
12,6,2,407,48,64,112,"6 de julio de 1997"
12,6,2,408,280,348,628,"6 de julio de 1997"
12,6,2,409,382,383,765,"6 de julio de 1997"
12,6,2,410,45,37,82,"6 de julio de 1997"
12,6,10,573,463,502,965,"6 de julio de 1997"
12,6,10,574,34,40,74,"6 de julio de 1997"
12,6,10,575,88,96,184,"6 de julio de 1997"
12,6,10,576,74,69,143,"6 de julio de 1997"
12,6,10,577,261,288,549,"6 de julio de 1997"
12,6,10,578,90,84,174,"6 de julio de 1997"
12,6,10,579,130,157,287,"6 de julio de 1997"
12,6,10,580,172,190,362,"6 de julio de 1997"
12,6,10,581,55,50,105,"6 de julio de 1997"
12,6,10,582,322,343,665,"6 de julio de 1997"
12,6,10,583,119,136,255,"6 de julio de 1997"
12,6,10,584,214,189,403,"6 de julio de 1997"
12,6,10,585,208,169,377,"6 de julio de 1997"
12,6,10,586,477,416,893,"6 de julio de 1997"
12,6,10,587,183,181,364,"6 de julio de 1997"
12,6,10,588,70,60,130,"6 de julio de 1997"
12,6,10,589,129,126,255,"6 de julio de 1997"
12,6,10,590,125,92,217,"6 de julio de 1997"
12,6,10,591,165,170,335,"6 de julio de 1997"
12,6,10,592,232,225,457,"6 de julio de 1997"
12,6,10,593,83,81,164,"6 de julio de 1997"
12,6,10,594,165,169,334,"6 de julio de 1997"
12,6,10,595,183,169,352,"6 de julio de 1997"
12,6,28,1112,424,499,923,"6 de julio de 1997"
12,6,28,1113,401,438,839,"6 de julio de 1997"
12,6,28,1114,487,538,1025,"6 de julio de 1997"
12,6,28,1115,530,641,1171,"6 de julio de 1997"
12,6,28,1116,348,392,740,"6 de julio de 1997"
12,6,28,1117,405,477,882,"6 de julio de 1997"
12,6,28,1118,359,410,769,"6 de julio de 1997"
12,6,28,1119,351,439,790,"6 de julio de 1997"
12,6,28,1120,427,483,910,"6 de julio de 1997"
12,6,28,1121,563,610,1173,"6 de julio de 1997"
12,6,28,1122,411,430,841,"6 de julio de 1997"
12,6,28,1123,319,323,642,"6 de julio de 1997"
12,6,28,1124,279,302,581,"6 de julio de 1997"
12,6,28,1125,151,159,310,"6 de julio de 1997"
12,6,28,1126,405,400,805,"6 de julio de 1997"
12,6,28,1127,228,274,502,"6 de julio de 1997"
12,6,28,1128,304,371,675,"6 de julio de 1997"
12,6,28,1129,331,339,670,"6 de julio de 1997"
12,6,28,1130,132,150,282,"6 de julio de 1997"
12,6,28,1131,219,169,388,"6 de julio de 1997"
12,6,28,1132,313,340,653,"6 de julio de 1997"
12,6,28,1133,185,209,394,"6 de julio de 1997"
12,6,28,1134,121,128,249,"6 de julio de 1997"
12,6,28,1135,293,329,622,"6 de julio de 1997"
12,6,28,1136,228,276,504,"6 de julio de 1997"
12,6,28,1137,82,102,184,"6 de julio de 1997"
12,6,28,1138,112,129,241,"6 de julio de 1997"
12,6,28,1139,197,233,430,"6 de julio de 1997"
12,6,28,1140,129,141,270,"6 de julio de 1997"
12,6,28,1141,76,77,153,"6 de julio de 1997"
12,6,28,1142,127,149,276,"6 de julio de 1997"
12,6,28,1143,151,168,319,"6 de julio de 1997"
12,6,28,1144,103,106,209,"6 de julio de 1997"
12,6,28,1145,138,171,309,"6 de julio de 1997"
12,6,28,1146,71,79,150,"6 de julio de 1997"
12,6,28,1147,94,107,201,"6 de julio de 1997"
12,6,28,1148,130,164,294,"6 de julio de 1997"
12,6,28,1149,181,174,355,"6 de julio de 1997"
12,6,28,1150,201,169,370,"6 de julio de 1997"
12,6,28,1151,206,206,412,"6 de julio de 1997"
12,6,28,1152,168,188,356,"6 de julio de 1997"
12,6,28,1153,57,65,122,"6 de julio de 1997"
12,6,28,1154,305,319,624,"6 de julio de 1997"
12,6,28,1155,237,224,461,"6 de julio de 1997"
12,6,28,1156,127,131,258,"6 de julio de 1997"
12,6,28,1157,637,710,1347,"6 de julio de 1997"
12,6,28,1158,150,129,279,"6 de julio de 1997"
12,6,28,1159,168,168,336,"6 de julio de 1997"
12,6,28,1160,203,188,391,"6 de julio de 1997"
12,6,28,1161,231,279,510,"6 de julio de 1997"
12,6,28,1162,207,260,467,"6 de julio de 1997"
12,6,28,1163,144,163,307,"6 de julio de 1997"
12,6,28,1164,322,336,658,"6 de julio de 1997"
12,6,28,1165,118,125,243,"6 de julio de 1997"
12,6,28,1166,243,238,481,"6 de julio de 1997"
12,6,28,1167,353,441,794,"6 de julio de 1997"
12,6,28,1168,142,142,284,"6 de julio de 1997"
12,6,28,1169,73,80,153,"6 de julio de 1997"
12,6,28,1170,247,276,523,"6 de julio de 1997"
12,6,28,1171,130,153,283,"6 de julio de 1997"
12,6,28,1172,161,173,334,"6 de julio de 1997"
12,6,28,1173,275,349,624,"6 de julio de 1997"
12,6,28,1174,86,82,168,"6 de julio de 1997"
12,6,28,1175,490,574,1064,"6 de julio de 1997"
12,6,28,1176,84,92,176,"6 de julio de 1997"
12,6,28,1177,427,435,862,"6 de julio de 1997"
12,6,28,1178,385,377,762,"6 de julio de 1997"
12,6,28,1179,261,271,532,"6 de julio de 1997"
12,6,28,1180,134,148,282,"6 de julio de 1997"
12,6,28,1181,302,357,659,"6 de julio de 1997"
12,6,28,1182,100,112,212,"6 de julio de 1997"
12,6,28,1183,214,225,439,"6 de julio de 1997"
12,6,28,1184,211,202,413,"6 de julio de 1997"
12,6,28,1185,306,335,641,"6 de julio de 1997"
12,6,28,1186,111,119,230,"6 de julio de 1997"
12,6,28,1187,189,180,369,"6 de julio de 1997"
12,6,28,1188,81,71,152,"6 de julio de 1997"
12,6,28,1189,231,222,453,"6 de julio de 1997"
12,6,28,1190,292,263,555,"6 de julio de 1997"
12,6,28,1191,185,188,373,"6 de julio de 1997"
12,6,28,1192,153,140,293,"6 de julio de 1997"
12,6,28,1193,78,77,155,"6 de julio de 1997"
12,6,28,1194,259,264,523,"6 de julio de 1997"
12,6,28,1195,532,573,1105,"6 de julio de 1997"
12,6,28,1196,245,253,498,"6 de julio de 1997"
12,6,28,1197,75,71,146,"6 de julio de 1997"
12,6,28,1198,310,312,622,"6 de julio de 1997"
12,6,28,1199,183,146,329,"6 de julio de 1997"
12,6,28,1200,487,349,836,"6 de julio de 1997"
12,6,28,1201,444,346,790,"6 de julio de 1997"
12,6,28,1202,156,130,286,"6 de julio de 1997"
12,6,28,1203,344,322,666,"6 de julio de 1997"
12,6,43,1719,398,423,821,"6 de julio de 1997"
12,6,43,1720,298,310,608,"6 de julio de 1997"
12,6,43,1721,321,361,682,"6 de julio de 1997"
12,6,43,1722,153,163,316,"6 de julio de 1997"
12,6,43,1723,137,177,314,"6 de julio de 1997"
12,6,43,1724,115,129,244,"6 de julio de 1997"
12,6,43,1725,188,159,347,"6 de julio de 1997"
12,6,43,1726,127,99,226,"6 de julio de 1997"
12,6,43,1727,304,277,581,"6 de julio de 1997"
12,6,43,1728,33,28,61,"6 de julio de 1997"
12,6,43,1729,103,102,205,"6 de julio de 1997"
12,6,43,1730,72,74,146,"6 de julio de 1997"
12,6,43,1731,95,76,171,"6 de julio de 1997"
12,6,43,1732,315,375,690,"6 de julio de 1997"
12,6,43,1733,405,421,826,"6 de julio de 1997"
12,6,43,1734,260,307,567,"6 de julio de 1997"
12,6,45,1764,277,306,583,"6 de julio de 1997"
12,6,45,1765,239,257,496,"6 de julio de 1997"
12,6,45,1766,256,258,514,"6 de julio de 1997"
12,6,45,1767,474,476,950,"6 de julio de 1997"
12,6,45,1768,185,200,385,"6 de julio de 1997"
12,6,45,1769,170,194,364,"6 de julio de 1997"
12,6,45,1770,222,238,460,"6 de julio de 1997"
12,6,45,1771,95,89,184,"6 de julio de 1997"
12,6,45,1772,66,63,129,"6 de julio de 1997"
12,6,45,1773,101,89,190,"6 de julio de 1997"
12,6,45,1774,85,69,154,"6 de julio de 1997"
12,6,45,1775,253,237,490,"6 de julio de 1997"
12,6,45,1776,174,172,346,"6 de julio de 1997"
12,6,45,1777,67,50,117,"6 de julio de 1997"
12,6,45,1778,23,18,41,"6 de julio de 1997"
12,6,45,1779,16,10,26,"6 de julio de 1997"
12,6,45,1780,61,48,109,"6 de julio de 1997"
12,6,45,1781,34,41,75,"6 de julio de 1997"
12,6,45,1782,15,11,26,"6 de julio de 1997"
12,6,45,1783,20,22,42,"6 de julio de 1997"
12,6,52,1973,310,343,653,"6 de julio de 1997"
12,6,52,1974,245,245,490,"6 de julio de 1997"
12,6,52,1975,346,343,689,"6 de julio de 1997"
12,6,52,1976,484,521,1005,"6 de julio de 1997"
12,6,52,1977,69,80,149,"6 de julio de 1997"
12,6,52,1978,204,206,410,"6 de julio de 1997"
12,6,52,1979,214,250,464,"6 de julio de 1997"
12,6,52,1980,217,228,445,"6 de julio de 1997"
12,6,52,1981,104,115,219,"6 de julio de 1997"
12,6,52,1982,110,96,206,"6 de julio de 1997"
12,6,52,1983,166,147,313,"6 de julio de 1997"
12,6,52,1984,465,470,935,"6 de julio de 1997"
12,6,52,1985,304,302,606,"6 de julio de 1997"
12,6,52,1986,183,172,355,"6 de julio de 1997"
12,6,52,1987,70,60,130,"6 de julio de 1997"
12,6,52,1988,183,179,362,"6 de julio de 1997"
12,6,52,1989,160,166,326,"6 de julio de 1997"
12,6,52,1990,97,99,196,"6 de julio de 1997"
12,6,52,1991,447,403,850,"6 de julio de 1997"
12,6,52,1992,33,36,69,"6 de julio de 1997"
12,6,52,1993,170,169,339,"6 de julio de 1997"
12,6,52,1994,104,91,195,"6 de julio de 1997"
12,6,52,1995,282,323,605,"6 de julio de 1997"
12,6,52,1996,151,153,304,"6 de julio de 1997"
12,6,52,1997,107,80,187,"6 de julio de 1997"
12,6,52,1998,128,129,257,"6 de julio de 1997"
12,6,52,1999,131,132,263,"6 de julio de 1997"
12,6,52,2000,131,127,258,"6 de julio de 1997"
12,6,52,2001,118,104,222,"6 de julio de 1997"
12,6,52,2002,165,168,333,"6 de julio de 1997"
12,6,52,2003,182,185,367,"6 de julio de 1997"
12,6,52,2004,56,59,115,"6 de julio de 1997"
12,6,52,2005,72,87,159,"6 de julio de 1997"
12,6,52,2006,119,107,226,"6 de julio de 1997"
12,6,52,2007,141,128,269,"6 de julio de 1997"
12,6,52,2008,138,131,269,"6 de julio de 1997"
12,6,52,2009,82,59,141,"6 de julio de 1997"
12,6,52,2010,89,78,167,"6 de julio de 1997"
12,6,52,2011,87,67,154,"6 de julio de 1997"
12,6,52,2012,137,130,267,"6 de julio de 1997"
12,6,52,2013,108,94,202,"6 de julio de 1997"
12,6,52,2014,224,191,415,"6 de julio de 1997"
12,6,62,2479,323,323,646,"6 de julio de 1997"
12,6,62,2480,441,524,965,"6 de julio de 1997"
12,6,62,2481,533,604,1137,"6 de julio de 1997"
12,6,62,2482,254,318,572,"6 de julio de 1997"
12,6,62,2483,345,443,788,"6 de julio de 1997"
12,6,62,2484,400,462,862,"6 de julio de 1997"
12,6,62,2485,498,560,1058,"6 de julio de 1997"
12,6,62,2486,387,454,841,"6 de julio de 1997"
12,6,62,2487,269,339,608,"6 de julio de 1997"
12,6,62,2488,293,307,600,"6 de julio de 1997"
12,6,62,2489,368,428,796,"6 de julio de 1997"
12,6,62,2490,427,347,774,"6 de julio de 1997"
12,6,62,2491,286,278,564,"6 de julio de 1997"
12,6,62,2492,401,399,800,"6 de julio de 1997"
12,6,62,2493,335,294,629,"6 de julio de 1997"
12,6,62,2494,353,365,718,"6 de julio de 1997"
12,6,62,2495,181,141,322,"6 de julio de 1997"
12,6,62,2496,162,154,316,"6 de julio de 1997"
12,6,62,2497,381,419,800,"6 de julio de 1997"
12,6,62,2498,18,9,27,"6 de julio de 1997"
12,6,62,2499,138,129,267,"6 de julio de 1997"
12,6,62,2500,49,48,97,"6 de julio de 1997"
12,6,62,2501,63,63,126,"6 de julio de 1997"
12,6,62,2502,90,89,179,"6 de julio de 1997"
12,6,62,2503,69,55,124,"6 de julio de 1997"
12,6,62,2504,288,330,618,"6 de julio de 1997"
12,6,62,2505,221,282,503,"6 de julio de 1997"
12,6,62,2506,103,107,210,"6 de julio de 1997"
12,6,62,2507,112,105,217,"6 de julio de 1997"
12,6,62,2508,144,148,292,"6 de julio de 1997"
12,6,73,2693,157,187,344,"6 de julio de 1997"
12,6,73,2694,391,380,771,"6 de julio de 1997"
12,6,73,2695,110,102,212,"6 de julio de 1997"
12,6,73,2696,275,283,558,"6 de julio de 1997"
12,6,73,2697,112,128,240,"6 de julio de 1997"
12,6,73,2698,233,227,460,"6 de julio de 1997"
12,6,73,2699,156,159,315,"6 de julio de 1997"
12,6,73,2700,273,283,556,"6 de julio de 1997"
12,6,73,2702,64,55,119,"6 de julio de 1997"
12,6,73,2704,47,56,103,"6 de julio de 1997"
12,6,73,2705,109,129,238,"6 de julio de 1997"
12,6,73,2706,151,161,312,"6 de julio de 1997"
12,6,73,2710,95,104,199,"6 de julio de 1997"
12,6,73,2714,285,309,594,"6 de julio de 1997"
12,6,73,2716,5,9,14,"6 de julio de 1997"
12,6,73,2722,15,14,29,"6 de julio de 1997"
12,6,73,2780,0,0,0,"6 de julio de 1997"
12,6,73,2781,0,0,0,"6 de julio de 1997"
12,6,73,2782,0,0,0,"6 de julio de 1997"
12,6,75,2752,426,489,915,"6 de julio de 1997"
12,6,75,2753,423,472,895,"6 de julio de 1997"
12,6,75,2754,423,487,910,"6 de julio de 1997"
12,6,75,2755,59,62,121,"6 de julio de 1997"
12,6,75,2756,42,37,79,"6 de julio de 1997"
12,6,75,2757,69,65,134,"6 de julio de 1997"
12,6,75,2758,108,87,195,"6 de julio de 1997"
12,6,75,2759,273,319,592,"6 de julio de 1997"
12,6,75,2760,53,50,103,"6 de julio de 1997"
12,6,75,2761,248,261,509,"6 de julio de 1997"
12,6,75,2762,59,63,122,"6 de julio de 1997"
12,6,75,2763,159,170,329,"6 de julio de 1997"
12,6,75,2764,134,164,298,"6 de julio de 1997"
12,6,75,2765,54,62,116,"6 de julio de 1997"
12,6,75,2766,158,166,324,"6 de julio de 1997"
12,6,75,2767,74,63,137,"6 de julio de 1997"
12,6,75,2768,135,167,302,"6 de julio de 1997"
12,6,75,2769,659,716,1375,"6 de julio de 1997"
12,6,75,2770,102,96,198,"6 de julio de 1997"
12,6,75,2771,466,524,990,"6 de julio de 1997"
12,6,76,2701,115,145,260,"6 de julio de 1997"
12,6,76,2703,191,234,425,"6 de julio de 1997"
12,6,76,2707,104,103,207,"6 de julio de 1997"
12,6,76,2708,124,149,273,"6 de julio de 1997"
12,6,76,2709,211,81,292,"6 de julio de 1997"
12,6,76,2711,91,95,186,"6 de julio de 1997"
12,6,76,2712,140,185,325,"6 de julio de 1997"
12,6,76,2713,218,187,405,"6 de julio de 1997"
12,6,76,2715,116,104,220,"6 de julio de 1997"
12,6,76,2717,70,61,131,"6 de julio de 1997"
12,6,76,2718,119,97,216,"6 de julio de 1997"
12,6,76,2719,79,77,156,"6 de julio de 1997"
12,6,76,2720,63,58,121,"6 de julio de 1997"
12,6,76,2721,153,171,324,"6 de julio de 1997"
12,6,76,2723,145,121,266,"6 de julio de 1997"
12,6,76,2724,168,161,329,"6 de julio de 1997"
12,6,76,2772,393,445,838,"6 de julio de 1997"
12,6,76,2773,239,213,452,"6 de julio de 1997"
12,6,76,2774,158,162,320,"6 de julio de 1997"
12,6,76,2775,229,237,466,"6 de julio de 1997"
12,6,76,2776,115,112,227,"6 de julio de 1997"
12,6,76,2777,30,21,51,"6 de julio de 1997"
12,6,76,2778,0,0,0,"6 de julio de 1997"
12,6,76,2779,0,2,2,"6 de julio de 1997"
12,7,21,883,335,378,713,"6 de julio de 1997"
12,7,21,884,495,464,959,"6 de julio de 1997"
12,7,21,885,499,517,1016,"6 de julio de 1997"
12,7,21,886,349,407,756,"6 de julio de 1997"
12,7,21,887,440,491,931,"6 de julio de 1997"
12,7,21,888,401,439,840,"6 de julio de 1997"
12,7,21,889,578,658,1236,"6 de julio de 1997"
12,7,21,890,418,412,830,"6 de julio de 1997"
12,7,21,891,89,63,152,"6 de julio de 1997"
12,7,21,892,129,129,258,"6 de julio de 1997"
12,7,21,893,94,96,190,"6 de julio de 1997"
12,7,21,894,249,227,476,"6 de julio de 1997"
12,7,21,895,811,823,1634,"6 de julio de 1997"
12,7,21,896,248,241,489,"6 de julio de 1997"
12,7,21,897,182,163,345,"6 de julio de 1997"
12,7,21,898,226,228,454,"6 de julio de 1997"
12,7,21,899,203,179,382,"6 de julio de 1997"
12,7,21,900,151,132,283,"6 de julio de 1997"
12,7,21,901,74,56,130,"6 de julio de 1997"
12,7,21,902,153,173,326,"6 de julio de 1997"
12,7,21,903,434,410,844,"6 de julio de 1997"
12,7,21,904,76,68,144,"6 de julio de 1997"
12,7,21,905,140,119,259,"6 de julio de 1997"
12,7,21,906,53,52,105,"6 de julio de 1997"
12,7,21,907,446,465,911,"6 de julio de 1997"
12,7,21,908,349,318,667,"6 de julio de 1997"
12,7,21,909,395,380,775,"6 de julio de 1997"
12,7,21,910,253,239,492,"6 de julio de 1997"
12,7,21,911,99,88,187,"6 de julio de 1997"
12,7,21,912,290,302,592,"6 de julio de 1997"
12,7,21,913,364,401,765,"6 de julio de 1997"
12,7,21,914,255,239,494,"6 de julio de 1997"
12,7,21,915,305,348,653,"6 de julio de 1997"
12,7,21,916,158,148,306,"6 de julio de 1997"
12,7,21,917,635,597,1232,"6 de julio de 1997"
12,7,21,918,298,292,590,"6 de julio de 1997"
12,7,21,919,257,233,490,"6 de julio de 1997"
12,7,21,920,86,95,181,"6 de julio de 1997"
12,7,21,921,173,172,345,"6 de julio de 1997"
12,7,21,922,331,343,674,"6 de julio de 1997"
12,7,21,923,279,246,525,"6 de julio de 1997"
12,7,21,924,35,37,72,"6 de julio de 1997"
12,7,21,925,549,564,1113,"6 de julio de 1997"
12,7,21,926,481,529,1010,"6 de julio de 1997"
12,7,21,927,81,88,169,"6 de julio de 1997"
12,7,21,928,322,361,683,"6 de julio de 1997"
12,7,21,929,370,413,783,"6 de julio de 1997"
12,7,21,930,95,119,214,"6 de julio de 1997"
12,7,21,931,661,687,1348,"6 de julio de 1997"
12,7,21,932,466,524,990,"6 de julio de 1997"
12,7,21,933,485,533,1018,"6 de julio de 1997"
12,7,21,934,271,286,557,"6 de julio de 1997"
12,7,21,935,292,317,609,"6 de julio de 1997"
12,7,21,936,517,586,1103,"6 de julio de 1997"
12,7,21,937,299,353,652,"6 de julio de 1997"
12,7,21,938,39,28,67,"6 de julio de 1997"
12,7,21,939,230,264,494,"6 de julio de 1997"
12,7,21,940,212,209,421,"6 de julio de 1997"
12,7,21,941,184,222,406,"6 de julio de 1997"
12,7,21,942,153,138,291,"6 de julio de 1997"
12,7,29,1204,512,567,1079,"6 de julio de 1997"
12,7,29,1205,410,518,928,"6 de julio de 1997"
12,7,29,1206,364,413,777,"6 de julio de 1997"
12,7,29,1207,257,318,575,"6 de julio de 1997"
12,7,29,1208,396,498,894,"6 de julio de 1997"
12,7,29,1209,452,536,988,"6 de julio de 1997"
12,7,29,1210,370,421,791,"6 de julio de 1997"
12,7,29,1211,330,359,689,"6 de julio de 1997"
12,7,29,1212,595,699,1294,"6 de julio de 1997"
12,7,29,1213,626,743,1369,"6 de julio de 1997"
12,7,29,1214,495,585,1080,"6 de julio de 1997"
12,7,29,1215,475,538,1013,"6 de julio de 1997"
12,7,29,1216,613,786,1399,"6 de julio de 1997"
12,7,29,1217,654,744,1398,"6 de julio de 1997"
12,7,29,1218,240,288,528,"6 de julio de 1997"
12,7,29,1219,472,527,999,"6 de julio de 1997"
12,7,29,1220,482,562,1044,"6 de julio de 1997"
12,7,29,1221,435,497,932,"6 de julio de 1997"
12,7,29,1222,350,409,759,"6 de julio de 1997"
12,7,29,1223,553,629,1182,"6 de julio de 1997"
12,7,29,1224,323,375,698,"6 de julio de 1997"
12,7,29,1225,493,542,1035,"6 de julio de 1997"
12,7,29,1226,632,725,1357,"6 de julio de 1997"
12,7,29,1227,699,796,1495,"6 de julio de 1997"
12,7,29,1228,388,437,825,"6 de julio de 1997"
12,7,29,1229,496,546,1042,"6 de julio de 1997"
12,7,29,1230,430,532,962,"6 de julio de 1997"
12,7,29,1231,366,479,845,"6 de julio de 1997"
12,7,29,1232,570,761,1331,"6 de julio de 1997"
12,7,29,1233,215,283,498,"6 de julio de 1997"
12,7,29,1234,465,515,980,"6 de julio de 1997"
12,7,29,1235,359,360,719,"6 de julio de 1997"
12,7,29,1236,428,535,963,"6 de julio de 1997"
12,7,29,1237,730,872,1602,"6 de julio de 1997"
12,7,29,1238,576,634,1210,"6 de julio de 1997"
12,7,29,1239,408,388,796,"6 de julio de 1997"
12,7,29,1240,495,601,1096,"6 de julio de 1997"
12,7,29,1241,552,606,1158,"6 de julio de 1997"
12,7,29,1242,569,584,1153,"6 de julio de 1997"
12,7,29,1243,273,311,584,"6 de julio de 1997"
12,7,29,1244,439,482,921,"6 de julio de 1997"
12,7,29,1245,270,305,575,"6 de julio de 1997"
12,7,29,1246,267,277,544,"6 de julio de 1997"
12,7,29,1247,445,519,964,"6 de julio de 1997"
12,7,29,1248,411,479,890,"6 de julio de 1997"
12,7,29,1249,421,460,881,"6 de julio de 1997"
12,7,29,1250,567,675,1242,"6 de julio de 1997"
12,7,29,1251,605,652,1257,"6 de julio de 1997"
12,7,29,1252,226,262,488,"6 de julio de 1997"
12,7,29,1253,808,98,906,"6 de julio de 1997"
12,7,29,1254,556,677,1233,"6 de julio de 1997"
12,7,29,1255,420,495,915,"6 de julio de 1997"
12,7,29,1256,362,384,746,"6 de julio de 1997"
12,7,29,1257,421,571,992,"6 de julio de 1997"
12,7,29,1258,502,566,1068,"6 de julio de 1997"
12,7,29,1259,406,412,818,"6 de julio de 1997"
12,7,29,1260,678,829,1507,"6 de julio de 1997"
12,7,29,1261,507,618,1125,"6 de julio de 1997"
12,7,29,1262,357,401,758,"6 de julio de 1997"
12,7,29,1263,480,530,1010,"6 de julio de 1997"
12,7,29,1264,487,572,1059,"6 de julio de 1997"
12,7,29,1265,365,373,738,"6 de julio de 1997"
12,7,29,1266,451,541,992,"6 de julio de 1997"
12,7,29,1267,365,414,779,"6 de julio de 1997"
12,7,29,1268,479,600,1079,"6 de julio de 1997"
12,7,29,1269,381,452,833,"6 de julio de 1997"
12,7,29,1270,279,321,600,"6 de julio de 1997"
12,7,29,1271,224,303,527,"6 de julio de 1997"
12,7,29,1272,32,28,60,"6 de julio de 1997"
12,7,29,1273,179,151,330,"6 de julio de 1997"
12,7,29,1274,103,89,192,"6 de julio de 1997"
12,7,29,1275,92,77,169,"6 de julio de 1997"
12,7,29,1276,243,115,358,"6 de julio de 1997"
12,7,29,1277,89,74,163,"6 de julio de 1997"
12,7,29,1278,283,282,565,"6 de julio de 1997"
12,7,29,1279,505,513,1018,"6 de julio de 1997"
12,7,29,1280,364,351,715,"6 de julio de 1997"
12,7,29,1281,259,278,537,"6 de julio de 1997"
12,7,29,1282,373,322,695,"6 de julio de 1997"
12,7,29,1283,271,201,472,"6 de julio de 1997"
12,7,29,1284,105,81,186,"6 de julio de 1997"
12,7,29,1285,196,156,352,"6 de julio de 1997"
12,7,29,1286,366,446,812,"6 de julio de 1997"
12,7,29,1287,349,389,738,"6 de julio de 1997"
12,7,29,1288,492,599,1091,"6 de julio de 1997"
12,7,29,1289,535,511,1046,"6 de julio de 1997"
12,7,29,1290,43,33,76,"6 de julio de 1997"
12,7,29,1291,89,67,156,"6 de julio de 1997"
12,7,29,1292,204,167,371,"6 de julio de 1997"
12,7,29,1293,157,139,296,"6 de julio de 1997"
12,7,29,1294,244,265,509,"6 de julio de 1997"
12,7,29,1295,345,319,664,"6 de julio de 1997"
12,7,29,1296,264,230,494,"6 de julio de 1997"
12,7,29,1297,212,168,380,"6 de julio de 1997"
12,7,29,1298,65,56,121,"6 de julio de 1997"
12,7,29,1299,124,141,265,"6 de julio de 1997"
12,7,29,1300,276,346,622,"6 de julio de 1997"
12,7,29,1301,411,402,813,"6 de julio de 1997"
12,7,29,1302,618,676,1294,"6 de julio de 1997"
12,7,29,1303,473,519,992,"6 de julio de 1997"
12,7,29,1304,554,604,1158,"6 de julio de 1997"
12,7,29,1305,269,309,578,"6 de julio de 1997"
12,7,29,1306,130,144,274,"6 de julio de 1997"
12,7,29,1307,595,634,1229,"6 de julio de 1997"
12,7,29,1308,233,252,485,"6 de julio de 1997"
12,7,40,1654,357,362,719,"6 de julio de 1997"
12,7,40,1655,340,344,684,"6 de julio de 1997"
12,7,40,1656,566,542,1108,"6 de julio de 1997"
12,7,40,1657,421,430,851,"6 de julio de 1997"
12,7,40,1658,244,277,521,"6 de julio de 1997"
12,7,40,1659,377,367,744,"6 de julio de 1997"
12,7,40,1660,312,311,623,"6 de julio de 1997"
12,7,40,1661,311,337,648,"6 de julio de 1997"
12,7,40,1662,203,223,426,"6 de julio de 1997"
12,7,40,1663,188,189,377,"6 de julio de 1997"
12,7,40,1664,150,136,286,"6 de julio de 1997"
12,7,40,1665,282,275,557,"6 de julio de 1997"
12,7,40,1666,221,247,468,"6 de julio de 1997"
12,7,40,1667,293,295,588,"6 de julio de 1997"
12,7,40,1668,134,127,261,"6 de julio de 1997"
12,7,40,1669,87,85,172,"6 de julio de 1997"
12,7,40,1670,122,106,228,"6 de julio de 1997"
12,7,40,1671,46,37,83,"6 de julio de 1997"
12,7,40,1672,77,62,139,"6 de julio de 1997"
12,7,40,1673,57,46,103,"6 de julio de 1997"
12,7,40,1674,508,491,999,"6 de julio de 1997"
12,7,40,1675,76,84,160,"6 de julio de 1997"
12,7,40,1676,530,522,1052,"6 de julio de 1997"
12,7,41,1677,438,481,919,"6 de julio de 1997"
12,7,41,1678,398,493,891,"6 de julio de 1997"
12,7,41,1679,230,219,449,"6 de julio de 1997"
12,7,41,1680,606,613,1219,"6 de julio de 1997"
12,7,41,1681,349,471,820,"6 de julio de 1997"
12,7,41,1682,274,306,580,"6 de julio de 1997"
12,7,41,1683,87,77,164,"6 de julio de 1997"
12,7,41,1684,196,190,386,"6 de julio de 1997"
12,7,41,1685,88,69,157,"6 de julio de 1997"
12,7,41,1686,179,161,340,"6 de julio de 1997"
12,7,41,1687,86,86,172,"6 de julio de 1997"
12,7,41,1688,185,172,357,"6 de julio de 1997"
12,7,41,1689,272,231,503,"6 de julio de 1997"
12,7,41,1690,67,62,129,"6 de julio de 1997"
12,7,41,1691,175,133,308,"6 de julio de 1997"
12,7,41,1692,116,90,206,"6 de julio de 1997"
12,7,41,1693,148,122,270,"6 de julio de 1997"
12,7,41,1694,362,303,665,"6 de julio de 1997"
12,7,41,1695,337,268,605,"6 de julio de 1997"
12,7,41,1696,83,74,157,"6 de julio de 1997"
12,7,41,1697,84,23,107,"6 de julio de 1997"
12,7,41,1698,150,103,253,"6 de julio de 1997"
12,7,57,2223,416,462,878,"6 de julio de 1997"
12,7,57,2224,380,423,803,"6 de julio de 1997"
12,7,57,2225,133,120,253,"6 de julio de 1997"
12,7,57,2226,152,156,308,"6 de julio de 1997"
12,7,57,2227,149,151,300,"6 de julio de 1997"
12,7,57,2228,170,168,338,"6 de julio de 1997"
12,7,57,2229,110,88,198,"6 de julio de 1997"
12,7,57,2230,105,95,200,"6 de julio de 1997"
12,7,57,2231,284,295,579,"6 de julio de 1997"
12,7,57,2232,427,431,858,"6 de julio de 1997"
12,7,57,2233,292,311,603,"6 de julio de 1997"
12,7,57,2234,312,307,619,"6 de julio de 1997"
12,7,57,2235,252,225,477,"6 de julio de 1997"
12,7,57,2236,169,187,356,"6 de julio de 1997"
12,7,57,2237,377,428,805,"6 de julio de 1997"
12,7,57,2238,473,421,894,"6 de julio de 1997"
12,7,57,2239,436,441,877,"6 de julio de 1997"
12,7,57,2240,287,303,590,"6 de julio de 1997"
12,7,57,2241,370,372,742,"6 de julio de 1997"
12,7,57,2242,247,241,488,"6 de julio de 1997"
12,7,57,2243,145,153,298,"6 de julio de 1997"
12,7,57,2244,382,337,719,"6 de julio de 1997"
12,7,57,2245,124,131,255,"6 de julio de 1997"
12,7,57,2246,105,108,213,"6 de julio de 1997"
12,7,57,2247,448,478,926,"6 de julio de 1997"
12,7,57,2248,239,227,466,"6 de julio de 1997"
12,7,57,2249,199,210,409,"6 de julio de 1997"
12,7,57,2250,223,250,473,"6 de julio de 1997"
12,7,57,2251,86,79,165,"6 de julio de 1997"
12,7,57,2252,139,140,279,"6 de julio de 1997"
12,7,57,2253,81,98,179,"6 de julio de 1997"
12,7,57,2254,137,166,303,"6 de julio de 1997"
12,7,57,2255,138,153,291,"6 de julio de 1997"
12,7,57,2256,87,81,168,"6 de julio de 1997"
12,7,57,2257,268,249,517,"6 de julio de 1997"
12,7,57,2258,107,99,206,"6 de julio de 1997"
12,7,57,2259,117,121,238,"6 de julio de 1997"
12,7,57,2260,117,130,247,"6 de julio de 1997"
12,7,57,2261,55,58,113,"6 de julio de 1997"
12,8,12,671,527,529,1056,"6 de julio de 1997"
12,8,12,672,262,263,525,"6 de julio de 1997"
12,8,12,673,228,239,467,"6 de julio de 1997"
12,8,12,674,660,669,1329,"6 de julio de 1997"
12,8,12,675,410,400,810,"6 de julio de 1997"
12,8,12,676,88,65,153,"6 de julio de 1997"
12,8,12,677,272,247,519,"6 de julio de 1997"
12,8,12,678,80,65,145,"6 de julio de 1997"
12,8,12,679,272,258,530,"6 de julio de 1997"
12,8,12,680,142,123,265,"6 de julio de 1997"
12,8,12,681,116,89,205,"6 de julio de 1997"
12,8,12,682,188,180,368,"6 de julio de 1997"
12,8,12,683,238,277,515,"6 de julio de 1997"
12,8,12,684,506,549,1055,"6 de julio de 1997"
12,8,12,685,98,96,194,"6 de julio de 1997"
12,8,12,686,102,83,185,"6 de julio de 1997"
12,8,12,687,55,50,105,"6 de julio de 1997"
12,8,12,688,140,130,270,"6 de julio de 1997"
12,8,12,689,150,130,280,"6 de julio de 1997"
12,8,12,690,48,43,91,"6 de julio de 1997"
12,8,12,691,150,133,283,"6 de julio de 1997"
12,8,12,692,372,373,745,"6 de julio de 1997"
12,8,12,693,60,71,131,"6 de julio de 1997"
12,8,12,694,312,272,584,"6 de julio de 1997"
12,8,12,695,345,267,612,"6 de julio de 1997"
12,8,12,696,109,104,213,"6 de julio de 1997"
12,8,12,697,144,143,287,"6 de julio de 1997"
12,8,12,698,105,117,222,"6 de julio de 1997"
12,8,12,699,181,172,353,"6 de julio de 1997"
12,8,12,700,305,254,559,"6 de julio de 1997"
12,8,12,701,166,146,312,"6 de julio de 1997"
12,8,12,702,165,148,313,"6 de julio de 1997"
12,8,12,703,183,173,356,"6 de julio de 1997"
12,8,12,704,69,62,131,"6 de julio de 1997"
12,8,12,705,283,246,529,"6 de julio de 1997"
12,8,12,706,216,193,409,"6 de julio de 1997"
12,8,12,707,307,251,558,"6 de julio de 1997"
12,8,12,708,96,92,188,"6 de julio de 1997"
12,8,12,709,141,127,268,"6 de julio de 1997"
12,8,12,710,182,164,346,"6 de julio de 1997"
12,8,12,711,385,348,733,"6 de julio de 1997"
12,8,12,712,215,167,382,"6 de julio de 1997"
12,8,12,713,87,72,159,"6 de julio de 1997"
12,8,12,714,220,200,420,"6 de julio de 1997"
12,8,12,715,86,75,161,"6 de julio de 1997"
12,8,12,716,43,29,72,"6 de julio de 1997"
12,8,12,717,193,176,369,"6 de julio de 1997"
12,8,12,718,256,248,504,"6 de julio de 1997"
12,8,12,719,319,326,645,"6 de julio de 1997"
12,8,12,720,237,269,506,"6 de julio de 1997"
12,8,12,721,124,125,249,"6 de julio de 1997"
12,8,12,722,71,85,156,"6 de julio de 1997"
12,8,12,723,67,57,124,"6 de julio de 1997"
12,8,12,724,105,97,202,"6 de julio de 1997"
12,8,13,725,328,333,661,"6 de julio de 1997"
12,8,13,726,414,416,830,"6 de julio de 1997"
12,8,13,727,350,357,707,"6 de julio de 1997"
12,8,13,728,389,406,795,"6 de julio de 1997"
12,8,13,729,196,157,353,"6 de julio de 1997"
12,8,13,730,398,358,756,"6 de julio de 1997"
12,8,13,731,136,126,262,"6 de julio de 1997"
12,8,13,732,379,365,744,"6 de julio de 1997"
12,8,13,733,147,127,274,"6 de julio de 1997"
12,8,13,734,130,125,255,"6 de julio de 1997"
12,8,13,735,127,104,231,"6 de julio de 1997"
12,8,13,736,92,94,186,"6 de julio de 1997"
12,8,13,737,210,202,412,"6 de julio de 1997"
12,8,13,738,100,100,200,"6 de julio de 1997"
12,8,13,739,54,36,90,"6 de julio de 1997"
12,8,13,740,68,56,124,"6 de julio de 1997"
12,8,13,741,361,467,828,"6 de julio de 1997"
12,8,13,742,314,298,612,"6 de julio de 1997"
12,8,13,743,223,228,451,"6 de julio de 1997"
12,8,13,744,253,262,515,"6 de julio de 1997"
12,8,13,745,209,205,414,"6 de julio de 1997"
12,8,13,746,274,271,545,"6 de julio de 1997"
12,8,13,747,113,77,190,"6 de julio de 1997"
12,8,13,748,139,126,265,"6 de julio de 1997"
12,8,13,749,25,19,44,"6 de julio de 1997"
12,8,13,750,32,36,68,"6 de julio de 1997"
12,8,13,751,101,92,193,"6 de julio de 1997"
12,8,13,752,401,409,810,"6 de julio de 1997"
12,8,13,753,337,344,681,"6 de julio de 1997"
12,8,13,754,445,499,944,"6 de julio de 1997"
12,8,13,755,233,223,456,"6 de julio de 1997"
12,8,13,756,277,293,570,"6 de julio de 1997"
12,8,13,757,34,28,62,"6 de julio de 1997"
12,8,13,758,77,58,135,"6 de julio de 1997"
12,8,13,759,101,87,188,"6 de julio de 1997"
12,8,13,760,56,49,105,"6 de julio de 1997"
12,8,13,761,63,46,109,"6 de julio de 1997"
12,8,13,762,203,200,403,"6 de julio de 1997"
12,8,18,844,587,628,1215,"6 de julio de 1997"
12,8,18,845,226,262,488,"6 de julio de 1997"
12,8,18,846,371,429,800,"6 de julio de 1997"
12,8,18,847,378,372,750,"6 de julio de 1997"
12,8,18,848,171,169,340,"6 de julio de 1997"
12,8,18,849,173,172,345,"6 de julio de 1997"
12,8,18,850,216,235,451,"6 de julio de 1997"
12,8,18,851,74,63,137,"6 de julio de 1997"
12,8,18,852,74,53,127,"6 de julio de 1997"
12,8,18,853,151,159,310,"6 de julio de 1997"
12,8,18,854,94,91,185,"6 de julio de 1997"
12,8,18,855,44,31,75,"6 de julio de 1997"
12,8,18,856,395,376,771,"6 de julio de 1997"
12,8,18,857,129,107,236,"6 de julio de 1997"
12,8,23,1001,308,365,673,"6 de julio de 1997"
12,8,23,1002,271,309,580,"6 de julio de 1997"
12,8,23,1003,268,286,554,"6 de julio de 1997"
12,8,23,1004,306,311,617,"6 de julio de 1997"
12,8,23,1005,266,305,571,"6 de julio de 1997"
12,8,23,1006,318,409,727,"6 de julio de 1997"
12,8,23,1007,279,288,567,"6 de julio de 1997"
12,8,23,1008,180,197,377,"6 de julio de 1997"
12,8,23,1009,61,73,134,"6 de julio de 1997"
12,8,23,1010,197,221,418,"6 de julio de 1997"
12,8,23,1011,54,46,100,"6 de julio de 1997"
12,8,23,1012,221,231,452,"6 de julio de 1997"
12,8,23,1013,241,221,462,"6 de julio de 1997"
12,8,23,1014,392,423,815,"6 de julio de 1997"
12,8,23,1015,142,149,291,"6 de julio de 1997"
12,8,23,1016,203,162,365,"6 de julio de 1997"
12,8,23,1017,180,205,385,"6 de julio de 1997"
12,8,23,1018,92,92,184,"6 de julio de 1997"
12,8,23,1019,128,124,252,"6 de julio de 1997"
12,8,23,1020,230,238,468,"6 de julio de 1997"
12,8,23,1021,45,36,81,"6 de julio de 1997"
12,8,23,1022,226,194,420,"6 de julio de 1997"
12,8,23,1023,282,270,552,"6 de julio de 1997"
12,8,23,1024,238,245,483,"6 de julio de 1997"
12,8,23,1025,244,275,519,"6 de julio de 1997"
12,8,23,1026,130,98,228,"6 de julio de 1997"
12,8,23,1027,235,215,450,"6 de julio de 1997"
12,8,23,1028,48,48,96,"6 de julio de 1997"
12,8,23,1029,300,248,548,"6 de julio de 1997"
12,8,25,1037,387,403,790,"6 de julio de 1997"
12,8,25,1038,470,468,938,"6 de julio de 1997"
12,8,25,1039,386,357,743,"6 de julio de 1997"
12,8,25,1040,240,240,480,"6 de julio de 1997"
12,8,25,1041,122,131,253,"6 de julio de 1997"
12,8,25,1042,218,203,421,"6 de julio de 1997"
12,8,25,1043,158,126,284,"6 de julio de 1997"
12,8,25,1044,182,169,351,"6 de julio de 1997"
12,8,25,1045,379,402,781,"6 de julio de 1997"
12,8,25,1046,178,168,346,"6 de julio de 1997"
12,8,25,1047,178,169,347,"6 de julio de 1997"
12,8,25,1048,296,320,616,"6 de julio de 1997"
12,8,25,1049,246,208,454,"6 de julio de 1997"
12,8,31,1339,671,701,1372,"6 de julio de 1997"
12,8,31,1340,202,190,392,"6 de julio de 1997"
12,8,31,1341,360,364,724,"6 de julio de 1997"
12,8,31,1342,747,818,1565,"6 de julio de 1997"
12,8,31,1343,259,43,302,"6 de julio de 1997"
12,8,31,1344,303,280,583,"6 de julio de 1997"
12,8,31,1345,152,158,310,"6 de julio de 1997"
12,8,31,1346,137,154,291,"6 de julio de 1997"
12,8,31,1347,243,221,464,"6 de julio de 1997"
12,8,31,1348,89,70,159,"6 de julio de 1997"
12,8,31,1349,170,145,315,"6 de julio de 1997"
12,8,31,1350,72,68,140,"6 de julio de 1997"
12,8,31,1351,66,48,114,"6 de julio de 1997"
12,8,31,1352,230,193,423,"6 de julio de 1997"
12,8,31,1353,185,167,352,"6 de julio de 1997"
12,8,31,1354,79,56,135,"6 de julio de 1997"
12,8,31,1355,195,201,396,"6 de julio de 1997"
12,8,31,1356,232,210,442,"6 de julio de 1997"
12,8,31,1357,195,170,365,"6 de julio de 1997"
12,8,37,1565,288,252,540,"6 de julio de 1997"
12,8,37,1566,191,172,363,"6 de julio de 1997"
12,8,37,1567,210,190,400,"6 de julio de 1997"
12,8,37,1568,357,340,697,"6 de julio de 1997"
12,8,37,1569,270,294,564,"6 de julio de 1997"
12,8,37,1570,142,142,284,"6 de julio de 1997"
12,8,37,1571,111,106,217,"6 de julio de 1997"
12,8,37,1572,162,146,308,"6 de julio de 1997"
12,8,37,1573,140,118,258,"6 de julio de 1997"
12,8,37,1574,90,73,163,"6 de julio de 1997"
12,8,37,1575,257,266,523,"6 de julio de 1997"
12,8,47,1809,726,800,1526,"6 de julio de 1997"
12,8,47,1810,407,429,836,"6 de julio de 1997"
12,8,47,1811,671,739,1410,"6 de julio de 1997"
12,8,47,1812,276,293,569,"6 de julio de 1997"
12,8,47,1813,585,630,1215,"6 de julio de 1997"
12,8,47,1814,380,435,815,"6 de julio de 1997"
12,8,47,1815,306,346,652,"6 de julio de 1997"
12,8,47,1816,403,438,841,"6 de julio de 1997"
12,8,47,1817,516,581,1097,"6 de julio de 1997"
12,8,47,1818,327,376,703,"6 de julio de 1997"
12,8,47,1819,648,713,1361,"6 de julio de 1997"
12,8,47,1820,328,328,656,"6 de julio de 1997"
12,8,47,1821,602,571,1173,"6 de julio de 1997"
12,8,47,1822,227,225,452,"6 de julio de 1997"
12,8,47,1823,133,136,269,"6 de julio de 1997"
12,8,47,1824,705,773,1478,"6 de julio de 1997"
12,8,47,1825,70,62,132,"6 de julio de 1997"
12,8,47,1826,198,179,377,"6 de julio de 1997"
12,8,47,1827,60,58,118,"6 de julio de 1997"
12,8,47,1828,182,188,370,"6 de julio de 1997"
12,8,47,1829,150,141,291,"6 de julio de 1997"
12,8,47,1830,607,628,1235,"6 de julio de 1997"
12,8,47,1831,51,34,85,"6 de julio de 1997"
12,8,47,1832,113,93,206,"6 de julio de 1997"
12,8,47,1833,217,188,405,"6 de julio de 1997"
12,8,47,1834,69,75,144,"6 de julio de 1997"
12,8,47,1835,44,36,80,"6 de julio de 1997"
12,8,47,1836,83,64,147,"6 de julio de 1997"
12,8,47,1837,124,95,219,"6 de julio de 1997"
12,8,47,1838,195,178,373,"6 de julio de 1997"
12,8,47,1839,219,225,444,"6 de julio de 1997"
12,8,47,1840,613,576,1189,"6 de julio de 1997"
12,8,47,1841,77,72,149,"6 de julio de 1997"
12,8,47,1842,73,65,138,"6 de julio de 1997"
12,8,47,1843,147,133,280,"6 de julio de 1997"
12,8,47,1844,36,29,65,"6 de julio de 1997"
12,8,47,1845,159,133,292,"6 de julio de 1997"
12,8,47,1846,124,127,251,"6 de julio de 1997"
12,8,53,2015,598,553,1151,"6 de julio de 1997"
12,8,53,2016,401,458,859,"6 de julio de 1997"
12,8,53,2017,479,491,970,"6 de julio de 1997"
12,8,53,2018,285,282,567,"6 de julio de 1997"
12,8,53,2019,145,156,301,"6 de julio de 1997"
12,8,53,2020,243,115,358,"6 de julio de 1997"
12,8,53,2021,231,221,452,"6 de julio de 1997"
12,8,53,2022,113,109,222,"6 de julio de 1997"
12,8,53,2023,157,130,287,"6 de julio de 1997"
12,8,53,2024,597,452,1049,"6 de julio de 1997"
12,8,53,2025,188,157,345,"6 de julio de 1997"
12,8,53,2026,630,514,1144,"6 de julio de 1997"
12,8,53,2027,68,55,123,"6 de julio de 1997"
12,8,53,2028,272,242,514,"6 de julio de 1997"
12,8,53,2029,125,102,227,"6 de julio de 1997"
12,8,53,2030,602,595,1197,"6 de julio de 1997"
12,8,53,2031,166,114,280,"6 de julio de 1997"
12,8,53,2032,209,179,388,"6 de julio de 1997"
12,8,53,2033,101,99,200,"6 de julio de 1997"
12,8,53,2034,39,34,73,"6 de julio de 1997"
12,8,53,2035,533,503,1036,"6 de julio de 1997"
12,8,53,2036,80,61,141,"6 de julio de 1997"
12,8,53,2037,67,52,119,"6 de julio de 1997"
12,8,53,2038,62,57,119,"6 de julio de 1997"
12,8,53,2039,364,361,725,"6 de julio de 1997"
12,8,53,2040,134,116,250,"6 de julio de 1997"
12,8,54,2041,274,364,638,"6 de julio de 1997"
12,8,54,2042,183,201,384,"6 de julio de 1997"
12,8,54,2043,241,235,476,"6 de julio de 1997"
12,8,54,2044,355,409,764,"6 de julio de 1997"
12,8,54,2045,304,332,636,"6 de julio de 1997"
12,8,54,2046,417,526,943,"6 de julio de 1997"
12,8,54,2047,294,300,594,"6 de julio de 1997"
12,8,54,2048,394,422,816,"6 de julio de 1997"
12,8,54,2049,327,373,700,"6 de julio de 1997"
12,8,54,2050,379,404,783,"6 de julio de 1997"
12,8,54,2051,197,205,402,"6 de julio de 1997"
12,8,54,2052,594,684,1278,"6 de julio de 1997"
12,8,54,2053,159,137,296,"6 de julio de 1997"
12,8,54,2054,349,373,722,"6 de julio de 1997"
12,8,54,2055,67,75,142,"6 de julio de 1997"
12,8,54,2056,132,147,279,"6 de julio de 1997"
12,8,54,2057,300,303,603,"6 de julio de 1997"
12,8,54,2058,150,128,278,"6 de julio de 1997"
12,8,54,2059,210,204,414,"6 de julio de 1997"
12,8,54,2060,300,282,582,"6 de julio de 1997"
12,8,54,2061,280,235,515,"6 de julio de 1997"
12,8,54,2062,99,100,199,"6 de julio de 1997"
12,8,54,2063,130,155,285,"6 de julio de 1997"
12,8,54,2064,53,44,97,"6 de julio de 1997"
12,8,54,2065,225,196,421,"6 de julio de 1997"
12,8,54,2066,43,51,94,"6 de julio de 1997"
12,8,54,2067,136,157,293,"6 de julio de 1997"
12,8,54,2068,189,173,362,"6 de julio de 1997"
12,8,54,2069,153,134,287,"6 de julio de 1997"
12,8,54,2070,107,151,258,"6 de julio de 1997"
12,8,54,2071,299,319,618,"6 de julio de 1997"
12,8,54,2072,162,149,311,"6 de julio de 1997"
12,8,54,2073,296,278,574,"6 de julio de 1997"
12,8,54,2074,327,421,748,"6 de julio de 1997"
12,8,54,2075,261,291,552,"6 de julio de 1997"
12,8,54,2076,418,484,902,"6 de julio de 1997"
12,8,54,2077,146,142,288,"6 de julio de 1997"
12,8,54,2078,106,112,218,"6 de julio de 1997"
12,8,54,2079,96,94,190,"6 de julio de 1997"
12,8,54,2080,300,266,566,"6 de julio de 1997"
12,8,54,2081,28,30,58,"6 de julio de 1997"
12,8,54,2082,37,41,78,"6 de julio de 1997"
12,8,54,2083,252,230,482,"6 de julio de 1997"
12,8,54,2084,315,310,625,"6 de julio de 1997"
12,8,54,2085,40,31,71,"6 de julio de 1997"
12,8,54,2086,122,110,232,"6 de julio de 1997"
12,8,54,2087,48,44,92,"6 de julio de 1997"
12,8,54,2088,89,57,146,"6 de julio de 1997"
12,8,54,2089,176,170,346,"6 de julio de 1997"
12,8,54,2090,245,257,502,"6 de julio de 1997"
12,8,54,2091,157,127,284,"6 de julio de 1997"
12,8,63,2509,403,391,794,"6 de julio de 1997"
12,8,63,2510,392,437,829,"6 de julio de 1997"
12,8,63,2511,273,210,483,"6 de julio de 1997"
12,8,63,2512,261,164,425,"6 de julio de 1997"
12,8,63,2513,83,77,160,"6 de julio de 1997"
12,8,63,2514,255,258,513,"6 de julio de 1997"
12,8,63,2515,225,212,437,"6 de julio de 1997"
12,8,63,2516,166,179,345,"6 de julio de 1997"
12,8,63,2517,158,158,316,"6 de julio de 1997"
12,8,63,2518,498,557,1055,"6 de julio de 1997"
12,8,63,2519,193,179,372,"6 de julio de 1997"
12,8,63,2520,79,75,154,"6 de julio de 1997"
12,8,63,2521,177,191,368,"6 de julio de 1997"
12,8,63,2522,328,358,686,"6 de julio de 1997"
12,8,72,2678,560,593,1153,"6 de julio de 1997"
12,8,72,2679,445,536,981,"6 de julio de 1997"
12,8,72,2680,63,36,99,"6 de julio de 1997"
12,8,72,2681,201,179,380,"6 de julio de 1997"
12,8,72,2682,196,193,389,"6 de julio de 1997"
12,8,72,2683,127,112,239,"6 de julio de 1997"
12,8,72,2684,197,178,375,"6 de julio de 1997"
12,8,72,2685,327,324,651,"6 de julio de 1997"
12,8,72,2686,279,236,515,"6 de julio de 1997"
12,8,72,2687,259,311,570,"6 de julio de 1997"
12,8,72,2688,304,302,606,"6 de julio de 1997"
12,8,72,2689,219,206,425,"6 de julio de 1997"
12,8,72,2690,319,325,644,"6 de julio de 1997"
12,8,72,2691,920,906,1826,"6 de julio de 1997"
12,8,72,2692,491,466,957,"6 de julio de 1997"
12,9,1,111,643,728,1371,"6 de julio de 1997"
12,9,1,112,549,654,1203,"6 de julio de 1997"
12,9,1,113,95,128,223,"6 de julio de 1997"
12,9,1,114,462,530,992,"6 de julio de 1997"
12,9,1,115,337,330,667,"6 de julio de 1997"
12,9,1,116,607,634,1241,"6 de julio de 1997"
12,9,1,117,464,581,1045,"6 de julio de 1997"
12,9,1,118,506,570,1076,"6 de julio de 1997"
12,9,1,119,520,659,1179,"6 de julio de 1997"
12,9,1,120,381,452,833,"6 de julio de 1997"
12,9,1,121,609,659,1268,"6 de julio de 1997"
12,9,1,122,432,518,950,"6 de julio de 1997"
12,9,1,127,395,474,869,"6 de julio de 1997"
12,9,1,128,326,458,784,"6 de julio de 1997"
12,9,1,129,513,625,1138,"6 de julio de 1997"
12,9,1,130,463,580,1043,"6 de julio de 1997"
12,9,1,131,435,525,960,"6 de julio de 1997"
12,9,1,132,606,727,1333,"6 de julio de 1997"
12,9,1,133,474,583,1057,"6 de julio de 1997"
12,9,1,134,579,740,1319,"6 de julio de 1997"
12,9,1,135,268,309,577,"6 de julio de 1997"
12,9,1,136,409,482,891,"6 de julio de 1997"
12,9,1,137,423,468,891,"6 de julio de 1997"
12,9,1,138,763,934,1697,"6 de julio de 1997"
12,9,1,139,561,697,1258,"6 de julio de 1997"
12,9,1,140,451,557,1008,"6 de julio de 1997"
12,9,1,141,646,823,1469,"6 de julio de 1997"
12,9,1,142,621,719,1340,"6 de julio de 1997"
12,9,1,143,522,651,1173,"6 de julio de 1997"
12,9,1,144,433,530,963,"6 de julio de 1997"
12,9,1,145,382,497,879,"6 de julio de 1997"
12,9,1,146,605,714,1319,"6 de julio de 1997"
12,9,1,147,691,822,1513,"6 de julio de 1997"
12,9,1,148,645,748,1393,"6 de julio de 1997"
12,9,1,149,737,895,1632,"6 de julio de 1997"
12,9,1,150,437,539,976,"6 de julio de 1997"
12,9,1,151,345,423,768,"6 de julio de 1997"
12,9,1,152,367,460,827,"6 de julio de 1997"
12,9,1,153,447,570,1017,"6 de julio de 1997"
12,9,1,154,478,597,1075,"6 de julio de 1997"
12,9,1,155,481,566,1047,"6 de julio de 1997"
12,9,1,156,482,588,1070,"6 de julio de 1997"
12,9,1,157,540,683,1223,"6 de julio de 1997"
12,9,1,158,383,455,838,"6 de julio de 1997"
12,9,1,159,514,643,1157,"6 de julio de 1997"
12,9,1,160,820,961,1781,"6 de julio de 1997"
12,9,1,161,475,559,1034,"6 de julio de 1997"
12,9,1,162,413,508,921,"6 de julio de 1997"
12,9,1,163,244,314,558,"6 de julio de 1997"
12,9,1,164,489,632,1121,"6 de julio de 1997"
12,9,1,165,568,619,1187,"6 de julio de 1997"
12,9,1,170,209,223,432,"6 de julio de 1997"
12,9,1,171,525,585,1110,"6 de julio de 1997"
12,9,1,172,475,571,1046,"6 de julio de 1997"
12,9,1,173,427,530,957,"6 de julio de 1997"
12,9,1,174,462,539,1001,"6 de julio de 1997"
12,9,1,175,513,614,1127,"6 de julio de 1997"
12,9,1,176,647,710,1357,"6 de julio de 1997"
12,9,1,177,505,618,1123,"6 de julio de 1997"
12,9,1,178,561,676,1237,"6 de julio de 1997"
12,9,1,179,624,757,1381,"6 de julio de 1997"
12,9,1,180,657,793,1450,"6 de julio de 1997"
12,9,1,181,394,517,911,"6 de julio de 1997"
12,9,1,182,480,584,1064,"6 de julio de 1997"
12,9,1,183,447,543,990,"6 de julio de 1997"
12,9,1,184,493,592,1085,"6 de julio de 1997"
12,9,1,185,573,692,1265,"6 de julio de 1997"
12,9,1,186,491,526,1017,"6 de julio de 1997"
12,9,1,187,425,446,871,"6 de julio de 1997"
12,9,1,188,410,480,890,"6 de julio de 1997"
12,9,1,189,186,190,376,"6 de julio de 1997"
12,9,1,190,412,484,896,"6 de julio de 1997"
12,9,1,191,310,381,691,"6 de julio de 1997"
12,9,1,197,420,498,918,"6 de julio de 1997"
12,9,1,199,418,506,924,"6 de julio de 1997"
12,9,1,200,690,758,1448,"6 de julio de 1997"
12,9,1,201,403,462,865,"6 de julio de 1997"
12,9,1,202,634,782,1416,"6 de julio de 1997"
12,9,1,203,436,479,915,"6 de julio de 1997"
12,9,1,204,671,834,1505,"6 de julio de 1997"
12,9,1,205,414,471,885,"6 de julio de 1997"
12,9,1,206,432,538,970,"6 de julio de 1997"
12,9,1,207,387,453,840,"6 de julio de 1997"
12,9,1,208,652,768,1420,"6 de julio de 1997"
12,9,1,209,637,765,1402,"6 de julio de 1997"
12,9,1,210,565,656,1221,"6 de julio de 1997"
12,9,1,211,300,384,684,"6 de julio de 1997"
12,9,1,212,585,679,1264,"6 de julio de 1997"
12,9,1,213,350,440,790,"6 de julio de 1997"
12,9,1,214,540,580,1120,"6 de julio de 1997"
12,9,1,245,735,875,1610,"6 de julio de 1997"
12,9,1,246,517,642,1159,"6 de julio de 1997"
12,9,1,247,507,538,1045,"6 de julio de 1997"
12,9,1,264,474,544,1018,"6 de julio de 1997"
12,9,1,265,663,786,1449,"6 de julio de 1997"
12,9,1,266,677,714,1391,"6 de julio de 1997"
12,9,1,267,504,611,1115,"6 de julio de 1997"
12,9,1,279,1056,1188,2244,"6 de julio de 1997"
12,9,1,280,437,510,947,"6 de julio de 1997"
12,9,1,281,276,340,616,"6 de julio de 1997"
12,9,1,282,348,414,762,"6 de julio de 1997"
12,9,1,283,303,411,714,"6 de julio de 1997"
12,9,1,284,662,710,1372,"6 de julio de 1997"
12,9,1,285,506,623,1129,"6 de julio de 1997"
12,9,1,286,621,694,1315,"6 de julio de 1997"
12,9,1,288,287,328,615,"6 de julio de 1997"
12,9,1,289,419,476,895,"6 de julio de 1997"
12,9,1,290,340,419,759,"6 de julio de 1997"
12,9,1,291,458,533,991,"6 de julio de 1997"
12,9,1,292,473,542,1015,"6 de julio de 1997"
12,9,1,293,480,590,1070,"6 de julio de 1997"
12,9,1,294,647,705,1352,"6 de julio de 1997"
12,9,1,295,604,743,1347,"6 de julio de 1997"
12,9,1,296,612,750,1362,"6 de julio de 1997"
12,9,1,297,762,979,1741,"6 de julio de 1997"
12,9,1,298,683,851,1534,"6 de julio de 1997"
12,9,1,299,660,763,1423,"6 de julio de 1997"
12,9,1,300,780,953,1733,"6 de julio de 1997"
12,9,1,301,939,1109,2048,"6 de julio de 1997"
12,9,1,302,457,346,803,"6 de julio de 1997"
12,9,1,303,1419,127,1546,"6 de julio de 1997"
12,9,1,304,588,514,1102,"6 de julio de 1997"
12,9,1,305,330,388,718,"6 de julio de 1997"
12,9,1,306,640,710,1350,"6 de julio de 1997"
12,9,1,307,541,660,1201,"6 de julio de 1997"
12,9,1,308,732,830,1562,"6 de julio de 1997"
12,9,1,309,158,146,304,"6 de julio de 1997"
12,9,1,310,989,1130,2119,"6 de julio de 1997"
12,9,1,311,357,441,798,"6 de julio de 1997"
12,9,1,312,266,284,550,"6 de julio de 1997"
12,9,1,313,211,202,413,"6 de julio de 1997"
12,9,1,314,123,93,216,"6 de julio de 1997"
12,9,1,315,231,250,481,"6 de julio de 1997"
12,9,1,316,225,202,427,"6 de julio de 1997"
12,9,1,317,312,306,618,"6 de julio de 1997"
12,9,1,318,364,399,763,"6 de julio de 1997"
12,9,1,319,428,494,922,"6 de julio de 1997"
12,9,1,320,549,604,1153,"6 de julio de 1997"
12,9,1,321,134,169,303,"6 de julio de 1997"
12,9,1,322,224,236,460,"6 de julio de 1997"
12,9,1,323,380,381,761,"6 de julio de 1997"
12,9,1,324,236,263,499,"6 de julio de 1997"
12,9,1,325,79,84,163,"6 de julio de 1997"
12,9,1,326,167,176,343,"6 de julio de 1997"
12,9,1,327,247,256,503,"6 de julio de 1997"
12,9,1,328,357,336,693,"6 de julio de 1997"
12,9,1,329,275,303,578,"6 de julio de 1997"
12,9,1,330,272,293,565,"6 de julio de 1997"
12,9,1,331,417,416,833,"6 de julio de 1997"
12,9,1,332,91,89,180,"6 de julio de 1997"
12,9,1,333,440,393,833,"6 de julio de 1997"
12,9,1,334,468,493,961,"6 de julio de 1997"
12,9,1,335,331,359,690,"6 de julio de 1997"
12,9,1,336,422,460,882,"6 de julio de 1997"
12,9,1,337,438,482,920,"6 de julio de 1997"
12,9,1,338,364,398,762,"6 de julio de 1997"
12,9,1,339,476,458,934,"6 de julio de 1997"
12,9,1,340,205,225,430,"6 de julio de 1997"
12,9,1,341,132,127,259,"6 de julio de 1997"
12,9,1,342,79,58,137,"6 de julio de 1997"
12,9,1,343,539,615,1154,"6 de julio de 1997"
12,9,1,344,352,435,787,"6 de julio de 1997"
12,9,1,345,198,156,354,"6 de julio de 1997"
12,9,1,346,165,121,286,"6 de julio de 1997"
12,9,1,347,484,546,1030,"6 de julio de 1997"
12,9,1,348,68,55,123,"6 de julio de 1997"
12,9,1,349,128,119,247,"6 de julio de 1997"
12,9,1,350,195,249,444,"6 de julio de 1997"
12,9,1,351,291,292,583,"6 de julio de 1997"
12,9,1,352,136,144,280,"6 de julio de 1997"
12,9,1,354,230,232,462,"6 de julio de 1997"
12,9,1,355,321,333,654,"6 de julio de 1997"
12,9,1,356,536,524,1060,"6 de julio de 1997"
12,9,1,357,265,249,514,"6 de julio de 1997"
12,9,1,358,129,129,258,"6 de julio de 1997"
12,9,1,359,213,161,374,"6 de julio de 1997"
12,9,1,360,117,122,239,"6 de julio de 1997"
12,9,1,361,69,71,140,"6 de julio de 1997"
12,9,1,362,350,360,710,"6 de julio de 1997"
12,9,1,363,232,258,490,"6 de julio de 1997"
12,9,1,364,457,425,882,"6 de julio de 1997"
12,9,1,365,149,140,289,"6 de julio de 1997"
12,9,1,366,229,227,456,"6 de julio de 1997"
12,9,1,367,231,209,440,"6 de julio de 1997"
12,9,1,368,726,690,1416,"6 de julio de 1997"
12,9,1,369,202,231,433,"6 de julio de 1997"
12,9,1,370,307,324,631,"6 de julio de 1997"
12,9,1,371,340,371,711,"6 de julio de 1997"
12,9,1,372,329,351,680,"6 de julio de 1997"
12,9,1,373,612,710,1322,"6 de julio de 1997"
12,9,1,374,643,696,1339,"6 de julio de 1997"
12,9,1,375,170,150,320,"6 de julio de 1997"
12,9,1,376,145,130,275,"6 de julio de 1997"
12,9,1,377,411,380,791,"6 de julio de 1997"
12,9,1,378,385,356,741,"6 de julio de 1997"
12,9,1,379,442,383,825,"6 de julio de 1997"
12,9,1,380,546,559,1105,"6 de julio de 1997"
12,9,1,381,175,146,321,"6 de julio de 1997"
12,9,1,382,175,216,391,"6 de julio de 1997"
12,10,1,1,546,637,1183,"6 de julio de 1997"
12,10,1,2,423,548,971,"6 de julio de 1997"
12,10,1,3,581,742,1323,"6 de julio de 1997"
12,10,1,4,385,432,817,"6 de julio de 1997"
12,10,1,5,339,403,742,"6 de julio de 1997"
12,10,1,6,346,411,757,"6 de julio de 1997"
12,10,1,7,500,588,1088,"6 de julio de 1997"
12,10,1,8,376,459,835,"6 de julio de 1997"
12,10,1,9,384,499,883,"6 de julio de 1997"
12,10,1,10,296,409,705,"6 de julio de 1997"
12,10,1,11,303,407,710,"6 de julio de 1997"
12,10,1,12,406,544,950,"6 de julio de 1997"
12,10,1,13,574,671,1245,"6 de julio de 1997"
12,10,1,14,272,295,567,"6 de julio de 1997"
12,10,1,15,435,521,956,"6 de julio de 1997"
12,10,1,16,350,364,714,"6 de julio de 1997"
12,10,1,17,404,462,866,"6 de julio de 1997"
12,10,1,18,372,432,804,"6 de julio de 1997"
12,10,1,19,383,522,905,"6 de julio de 1997"
12,10,1,20,434,547,981,"6 de julio de 1997"
12,10,1,21,538,594,1132,"6 de julio de 1997"
12,10,1,22,432,507,939,"6 de julio de 1997"
12,10,1,23,690,820,1510,"6 de julio de 1997"
12,10,1,24,544,661,1205,"6 de julio de 1997"
12,10,1,25,627,799,1426,"6 de julio de 1997"
12,10,1,26,514,652,1166,"6 de julio de 1997"
12,10,1,27,702,809,1511,"6 de julio de 1997"
12,10,1,28,393,439,832,"6 de julio de 1997"
12,10,1,29,611,736,1347,"6 de julio de 1997"
12,10,1,30,563,653,1216,"6 de julio de 1997"
12,10,1,31,932,1146,2078,"6 de julio de 1997"
12,10,1,32,523,683,1206,"6 de julio de 1997"
12,10,1,33,703,804,1507,"6 de julio de 1997"
12,10,1,34,415,507,922,"6 de julio de 1997"
12,10,1,35,393,455,848,"6 de julio de 1997"
12,10,1,36,685,721,1406,"6 de julio de 1997"
12,10,1,37,466,576,1042,"6 de julio de 1997"
12,10,1,38,775,858,1633,"6 de julio de 1997"
12,10,1,39,759,907,1666,"6 de julio de 1997"
12,10,1,40,414,512,926,"6 de julio de 1997"
12,10,1,41,687,847,1534,"6 de julio de 1997"
12,10,1,42,770,813,1583,"6 de julio de 1997"
12,10,1,43,558,605,1163,"6 de julio de 1997"
12,10,1,44,472,529,1001,"6 de julio de 1997"
12,10,1,45,443,503,946,"6 de julio de 1997"
12,10,1,46,419,475,894,"6 de julio de 1997"
12,10,1,47,393,453,846,"6 de julio de 1997"
12,10,1,48,642,706,1348,"6 de julio de 1997"
12,10,1,49,305,347,652,"6 de julio de 1997"
12,10,1,50,427,525,952,"6 de julio de 1997"
12,10,1,51,510,593,1103,"6 de julio de 1997"
12,10,1,52,312,327,639,"6 de julio de 1997"
12,10,1,53,563,673,1236,"6 de julio de 1997"
12,10,1,54,568,635,1203,"6 de julio de 1997"
12,10,1,55,356,452,808,"6 de julio de 1997"
12,10,1,56,595,668,1263,"6 de julio de 1997"
12,10,1,57,443,540,983,"6 de julio de 1997"
12,10,1,58,206,239,445,"6 de julio de 1997"
12,10,1,59,276,328,604,"6 de julio de 1997"
12,10,1,60,359,482,841,"6 de julio de 1997"
12,10,1,61,427,537,964,"6 de julio de 1997"
12,10,1,62,221,250,471,"6 de julio de 1997"
12,10,1,63,281,325,606,"6 de julio de 1997"
12,10,1,64,341,387,728,"6 de julio de 1997"
12,10,1,65,271,316,587,"6 de julio de 1997"
12,10,1,66,268,315,583,"6 de julio de 1997"
12,10,1,67,385,442,827,"6 de julio de 1997"
12,10,1,68,450,487,937,"6 de julio de 1997"
12,10,1,69,289,303,592,"6 de julio de 1997"
12,10,1,70,506,559,1065,"6 de julio de 1997"
12,10,1,71,429,540,969,"6 de julio de 1997"
12,10,1,72,427,474,901,"6 de julio de 1997"
12,10,1,73,368,462,830,"6 de julio de 1997"
12,10,1,74,384,452,836,"6 de julio de 1997"
12,10,1,75,298,336,634,"6 de julio de 1997"
12,10,1,76,272,302,574,"6 de julio de 1997"
12,10,1,77,422,512,934,"6 de julio de 1997"
12,10,1,78,96,100,196,"6 de julio de 1997"
12,10,1,79,269,321,590,"6 de julio de 1997"
12,10,1,80,524,601,1125,"6 de julio de 1997"
12,10,1,81,415,437,852,"6 de julio de 1997"
12,10,1,82,242,282,524,"6 de julio de 1997"
12,10,1,83,303,316,619,"6 de julio de 1997"
12,10,1,84,251,267,518,"6 de julio de 1997"
12,10,1,85,300,402,702,"6 de julio de 1997"
12,10,1,86,418,467,885,"6 de julio de 1997"
12,10,1,87,298,366,664,"6 de julio de 1997"
12,10,1,88,255,286,541,"6 de julio de 1997"
12,10,1,89,452,468,920,"6 de julio de 1997"
12,10,1,90,382,472,854,"6 de julio de 1997"
12,10,1,91,333,429,762,"6 de julio de 1997"
12,10,1,92,195,253,448,"6 de julio de 1997"
12,10,1,93,390,423,813,"6 de julio de 1997"
12,10,1,94,335,385,720,"6 de julio de 1997"
12,10,1,95,274,258,532,"6 de julio de 1997"
12,10,1,96,141,45,186,"6 de julio de 1997"
12,10,1,97,531,575,1106,"6 de julio de 1997"
12,10,1,98,244,258,502,"6 de julio de 1997"
12,10,1,99,404,476,880,"6 de julio de 1997"
12,10,1,100,565,646,1211,"6 de julio de 1997"
12,10,1,101,315,374,689,"6 de julio de 1997"
12,10,1,102,439,513,952,"6 de julio de 1997"
12,10,1,103,353,402,755,"6 de julio de 1997"
12,10,1,104,524,579,1103,"6 de julio de 1997"
12,10,1,105,559,638,1197,"6 de julio de 1997"
12,10,1,106,497,565,1062,"6 de julio de 1997"
12,10,1,107,490,575,1065,"6 de julio de 1997"
12,10,1,108,452,625,1077,"6 de julio de 1997"
12,10,1,109,335,345,680,"6 de julio de 1997"
12,10,1,110,553,664,1217,"6 de julio de 1997"
12,10,1,123,531,566,1097,"6 de julio de 1997"
12,10,1,124,521,540,1061,"6 de julio de 1997"
12,10,1,125,402,482,884,"6 de julio de 1997"
12,10,1,126,450,207,657,"6 de julio de 1997"
12,10,1,166,492,588,1080,"6 de julio de 1997"
12,10,1,167,546,571,1117,"6 de julio de 1997"
12,10,1,168,364,473,837,"6 de julio de 1997"
12,10,1,169,387,487,874,"6 de julio de 1997"
12,10,1,192,637,779,1416,"6 de julio de 1997"
12,10,1,193,472,582,1054,"6 de julio de 1997"
12,10,1,194,459,522,981,"6 de julio de 1997"
12,10,1,195,367,394,761,"6 de julio de 1997"
12,10,1,196,357,421,778,"6 de julio de 1997"
12,10,1,198,950,1036,1986,"6 de julio de 1997"
12,10,1,215,651,762,1413,"6 de julio de 1997"
12,10,1,216,627,783,1410,"6 de julio de 1997"
12,10,1,217,800,1027,1827,"6 de julio de 1997"
12,10,1,218,431,523,954,"6 de julio de 1997"
12,10,1,219,651,764,1415,"6 de julio de 1997"
12,10,1,220,508,566,1074,"6 de julio de 1997"
12,10,1,221,470,534,1004,"6 de julio de 1997"
12,10,1,222,296,358,654,"6 de julio de 1997"
12,10,1,223,656,740,1396,"6 de julio de 1997"
12,10,1,224,557,626,1183,"6 de julio de 1997"
12,10,1,225,308,387,695,"6 de julio de 1997"
12,10,1,226,420,481,901,"6 de julio de 1997"
12,10,1,227,326,410,736,"6 de julio de 1997"
12,10,1,228,360,478,838,"6 de julio de 1997"
12,10,1,229,248,358,606,"6 de julio de 1997"
12,10,1,230,511,583,1094,"6 de julio de 1997"
12,10,1,231,613,654,1267,"6 de julio de 1997"
12,10,1,232,764,863,1627,"6 de julio de 1997"
12,10,1,233,329,391,720,"6 de julio de 1997"
12,10,1,234,304,335,639,"6 de julio de 1997"
12,10,1,235,414,523,937,"6 de julio de 1997"
12,10,1,236,330,445,775,"6 de julio de 1997"
12,10,1,237,418,517,935,"6 de julio de 1997"
12,10,1,238,371,456,827,"6 de julio de 1997"
12,10,1,239,452,558,1010,"6 de julio de 1997"
12,10,1,240,557,642,1199,"6 de julio de 1997"
12,10,1,241,357,444,801,"6 de julio de 1997"
12,10,1,242,421,444,865,"6 de julio de 1997"
12,10,1,243,766,916,1682,"6 de julio de 1997"
12,10,1,244,771,895,1666,"6 de julio de 1997"
12,10,1,248,436,524,960,"6 de julio de 1997"
12,10,1,249,380,423,803,"6 de julio de 1997"
12,10,1,250,311,386,697,"6 de julio de 1997"
12,10,1,251,421,530,951,"6 de julio de 1997"
12,10,1,252,362,453,815,"6 de julio de 1997"
12,10,1,253,374,457,831,"6 de julio de 1997"
12,10,1,254,522,597,1119,"6 de julio de 1997"
12,10,1,255,400,455,855,"6 de julio de 1997"
12,10,1,256,1230,1409,2639,"6 de julio de 1997"
12,10,1,257,541,697,1238,"6 de julio de 1997"
12,10,1,258,370,430,800,"6 de julio de 1997"
12,10,1,259,442,529,971,"6 de julio de 1997"
12,10,1,260,451,457,908,"6 de julio de 1997"
12,10,1,261,717,826,1543,"6 de julio de 1997"
12,10,1,262,768,860,1628,"6 de julio de 1997"
12,10,1,263,503,560,1063,"6 de julio de 1997"
12,10,1,268,402,493,895,"6 de julio de 1997"
12,10,1,269,394,445,839,"6 de julio de 1997"
12,10,1,270,418,543,961,"6 de julio de 1997"
12,10,1,271,331,424,755,"6 de julio de 1997"
12,10,1,272,403,503,906,"6 de julio de 1997"
12,10,1,273,358,436,794,"6 de julio de 1997"
12,10,1,274,487,611,1098,"6 de julio de 1997"
12,10,1,275,261,284,545,"6 de julio de 1997"
12,10,1,276,315,362,677,"6 de julio de 1997"
12,10,1,277,583,668,1251,"6 de julio de 1997"
12,10,1,278,588,601,1189,"6 de julio de 1997"
12,10,1,287,298,298,596,"6 de julio de 1997"
12,10,1,353,86,82,168,"6 de julio de 1997"
12,10,1,383,359,480,839,"6 de julio de 1997"
13,1,10,162,466,540,1006,"6 de julio de 1997"
13,1,10,163,340,306,646,"6 de julio de 1997"
13,1,10,164,133,125,258,"6 de julio de 1997"
13,1,10,165,384,381,765,"6 de julio de 1997"
13,1,10,166,288,263,551,"6 de julio de 1997"
13,1,10,167,132,140,272,"6 de julio de 1997"
13,1,10,168,156,167,323,"6 de julio de 1997"
13,1,10,169,347,414,761,"6 de julio de 1997"
13,1,10,170,278,266,544,"6 de julio de 1997"
13,1,10,171,472,472,944,"6 de julio de 1997"
13,1,10,172,157,171,328,"6 de julio de 1997"
13,1,10,173,143,166,309,"6 de julio de 1997"
13,1,10,174,148,150,298,"6 de julio de 1997"
13,1,10,175,186,220,406,"6 de julio de 1997"
13,1,10,176,292,299,591,"6 de julio de 1997"
13,1,10,177,329,329,658,"6 de julio de 1997"
13,1,13,224,650,732,1382,"6 de julio de 1997"
13,1,13,225,363,421,784,"6 de julio de 1997"
13,1,13,226,145,155,300,"6 de julio de 1997"
13,1,13,227,161,148,309,"6 de julio de 1997"
13,1,13,228,353,373,726,"6 de julio de 1997"
13,1,13,229,181,144,325,"6 de julio de 1997"
13,1,13,230,234,262,496,"6 de julio de 1997"
13,1,13,231,198,182,380,"6 de julio de 1997"
13,1,13,232,679,631,1310,"6 de julio de 1997"
13,1,13,233,149,142,291,"6 de julio de 1997"
13,1,13,234,157,172,329,"6 de julio de 1997"
13,1,13,235,211,222,433,"6 de julio de 1997"
13,1,13,236,302,369,671,"6 de julio de 1997"
13,1,13,237,106,85,191,"6 de julio de 1997"
13,1,13,238,244,277,521,"6 de julio de 1997"
13,1,13,239,43,34,77,"6 de julio de 1997"
13,1,25,405,512,534,1046,"6 de julio de 1997"
13,1,25,406,414,434,848,"6 de julio de 1997"
13,1,25,407,135,141,276,"6 de julio de 1997"
13,1,25,408,147,132,279,"6 de julio de 1997"
13,1,25,409,230,226,456,"6 de julio de 1997"
13,1,25,410,139,137,276,"6 de julio de 1997"
13,1,25,411,218,231,449,"6 de julio de 1997"
13,1,25,412,154,145,299,"6 de julio de 1997"
13,1,25,413,229,210,439,"6 de julio de 1997"
13,1,25,414,173,167,340,"6 de julio de 1997"
13,1,25,415,221,218,439,"6 de julio de 1997"
13,1,25,416,128,135,263,"6 de julio de 1997"
13,1,25,417,469,500,969,"6 de julio de 1997"
13,1,25,418,174,166,340,"6 de julio de 1997"
13,1,25,419,433,466,899,"6 de julio de 1997"
13,1,25,420,135,151,286,"6 de julio de 1997"
13,1,25,421,99,81,180,"6 de julio de 1997"
13,1,25,422,316,301,617,"6 de julio de 1997"
13,1,25,423,65,45,110,"6 de julio de 1997"
13,1,25,424,199,200,399,"6 de julio de 1997"
13,1,25,425,210,201,411,"6 de julio de 1997"
13,1,25,426,159,160,319,"6 de julio de 1997"
13,1,25,427,138,164,302,"6 de julio de 1997"
13,1,25,428,275,297,572,"6 de julio de 1997"
13,1,25,429,366,455,821,"6 de julio de 1997"
13,1,25,430,217,296,513,"6 de julio de 1997"
13,1,26,431,421,444,865,"6 de julio de 1997"
13,1,26,432,176,137,313,"6 de julio de 1997"
13,1,26,433,227,202,429,"6 de julio de 1997"
13,1,26,434,473,473,946,"6 de julio de 1997"
13,1,26,435,343,373,716,"6 de julio de 1997"
13,1,26,436,105,106,211,"6 de julio de 1997"
13,1,26,437,152,158,310,"6 de julio de 1997"
13,1,26,438,294,310,604,"6 de julio de 1997"
13,1,26,439,207,195,402,"6 de julio de 1997"
13,1,26,440,245,258,503,"6 de julio de 1997"
13,1,28,457,1022,1053,2075,"6 de julio de 1997"
13,1,28,458,446,493,939,"6 de julio de 1997"
13,1,28,459,507,567,1074,"6 de julio de 1997"
13,1,28,460,1029,742,1771,"6 de julio de 1997"
13,1,28,461,640,682,1322,"6 de julio de 1997"
13,1,28,462,523,577,1100,"6 de julio de 1997"
13,1,28,463,532,586,1118,"6 de julio de 1997"
13,1,28,464,567,617,1184,"6 de julio de 1997"
13,1,28,465,327,357,684,"6 de julio de 1997"
13,1,28,466,359,392,751,"6 de julio de 1997"
13,1,28,467,581,653,1234,"6 de julio de 1997"
13,1,28,468,562,609,1171,"6 de julio de 1997"
13,1,28,469,584,630,1214,"6 de julio de 1997"
13,1,28,470,662,703,1365,"6 de julio de 1997"
13,1,28,471,598,546,1144,"6 de julio de 1997"
13,1,28,472,251,234,485,"6 de julio de 1997"
13,1,28,473,700,696,1396,"6 de julio de 1997"
13,1,28,474,349,349,698,"6 de julio de 1997"
13,1,28,475,200,167,367,"6 de julio de 1997"
13,1,28,476,459,399,858,"6 de julio de 1997"
13,1,28,477,221,236,457,"6 de julio de 1997"
13,1,28,478,299,298,597,"6 de julio de 1997"
13,1,28,479,335,308,643,"6 de julio de 1997"
13,1,28,480,526,462,988,"6 de julio de 1997"
13,1,28,481,335,303,638,"6 de julio de 1997"
13,1,28,482,576,510,1086,"6 de julio de 1997"
13,1,28,483,466,435,901,"6 de julio de 1997"
13,1,28,484,437,395,832,"6 de julio de 1997"
13,1,28,485,340,324,664,"6 de julio de 1997"
13,1,28,486,590,612,1202,"6 de julio de 1997"
13,1,28,487,510,504,1014,"6 de julio de 1997"
13,1,28,488,363,369,732,"6 de julio de 1997"
13,1,28,489,305,352,657,"6 de julio de 1997"
13,1,28,490,423,480,903,"6 de julio de 1997"
13,1,28,491,474,468,942,"6 de julio de 1997"
13,1,28,492,250,218,468,"6 de julio de 1997"
13,1,28,493,226,242,468,"6 de julio de 1997"
13,1,28,494,321,312,633,"6 de julio de 1997"
13,1,28,495,707,691,1398,"6 de julio de 1997"
13,1,28,496,121,119,240,"6 de julio de 1997"
13,1,28,497,238,242,480,"6 de julio de 1997"
13,1,28,498,28,32,60,"6 de julio de 1997"
13,1,28,499,561,535,1096,"6 de julio de 1997"
13,1,28,500,514,464,978,"6 de julio de 1997"
13,1,28,501,385,306,691,"6 de julio de 1997"
13,1,28,502,681,650,1331,"6 de julio de 1997"
13,1,28,503,263,246,509,"6 de julio de 1997"
13,1,28,504,619,474,1093,"6 de julio de 1997"
13,1,28,505,400,290,690,"6 de julio de 1997"
13,1,28,506,215,217,432,"6 de julio de 1997"
13,1,28,507,338,304,642,"6 de julio de 1997"
13,1,28,508,690,710,1400,"6 de julio de 1997"
13,1,28,509,220,215,435,"6 de julio de 1997"
13,1,32,630,230,208,438,"6 de julio de 1997"
13,1,32,631,604,654,1258,"6 de julio de 1997"
13,1,32,632,579,575,1154,"6 de julio de 1997"
13,1,32,633,158,135,293,"6 de julio de 1997"
13,1,32,634,125,109,234,"6 de julio de 1997"
13,1,32,635,68,61,129,"6 de julio de 1997"
13,1,32,636,96,96,192,"6 de julio de 1997"
13,1,32,637,81,89,170,"6 de julio de 1997"
13,1,32,638,106,102,208,"6 de julio de 1997"
13,1,32,639,119,123,242,"6 de julio de 1997"
13,1,32,640,196,217,413,"6 de julio de 1997"
13,1,32,641,189,180,369,"6 de julio de 1997"
13,1,35,657,265,298,563,"6 de julio de 1997"
13,1,35,658,140,125,265,"6 de julio de 1997"
13,1,35,659,335,289,624,"6 de julio de 1997"
13,1,35,660,404,336,740,"6 de julio de 1997"
13,1,35,661,276,299,575,"6 de julio de 1997"
13,1,35,662,288,311,599,"6 de julio de 1997"
13,1,35,663,347,351,698,"6 de julio de 1997"
13,1,35,664,306,339,645,"6 de julio de 1997"
13,1,42,765,560,603,1163,"6 de julio de 1997"
13,1,42,766,511,563,1074,"6 de julio de 1997"
13,1,42,767,163,116,279,"6 de julio de 1997"
13,1,42,768,172,169,341,"6 de julio de 1997"
13,1,42,769,199,164,363,"6 de julio de 1997"
13,1,42,770,75,60,135,"6 de julio de 1997"
13,1,42,771,137,112,249,"6 de julio de 1997"
13,1,42,772,195,135,330,"6 de julio de 1997"
13,1,42,773,161,156,317,"6 de julio de 1997"
13,1,42,774,81,80,161,"6 de julio de 1997"
13,1,42,775,85,89,174,"6 de julio de 1997"
13,1,42,776,97,68,165,"6 de julio de 1997"
13,1,42,777,88,85,173,"6 de julio de 1997"
13,1,42,778,112,105,217,"6 de julio de 1997"
13,1,42,779,175,184,359,"6 de julio de 1997"
13,1,53,1043,274,257,531,"6 de julio de 1997"
13,1,53,1044,619,603,1222,"6 de julio de 1997"
13,1,53,1045,689,648,1337,"6 de julio de 1997"
13,1,53,1046,260,284,544,"6 de julio de 1997"
13,1,53,1047,268,239,507,"6 de julio de 1997"
13,1,53,1048,492,426,918,"6 de julio de 1997"
13,1,53,1049,337,293,630,"6 de julio de 1997"
13,1,53,1050,453,385,838,"6 de julio de 1997"
13,1,53,1051,320,294,614,"6 de julio de 1997"
13,1,53,1052,184,153,337,"6 de julio de 1997"
13,1,53,1053,304,254,558,"6 de julio de 1997"
13,1,53,1054,132,119,251,"6 de julio de 1997"
13,1,53,1055,389,294,683,"6 de julio de 1997"
13,1,53,1056,357,278,635,"6 de julio de 1997"
13,1,53,1057,306,228,534,"6 de julio de 1997"
13,1,53,1058,196,164,360,"6 de julio de 1997"
13,1,53,1059,381,401,782,"6 de julio de 1997"
13,1,53,1060,558,626,1184,"6 de julio de 1997"
13,1,53,1061,711,826,1537,"6 de julio de 1997"
13,1,53,1062,651,577,1228,"6 de julio de 1997"
13,1,53,1063,335,268,603,"6 de julio de 1997"
13,1,53,1064,115,109,224,"6 de julio de 1997"
13,1,53,1065,187,178,365,"6 de julio de 1997"
13,1,53,1066,255,251,506,"6 de julio de 1997"
13,1,62,1229,226,224,450,"6 de julio de 1997"
13,1,62,1230,154,132,286,"6 de julio de 1997"
13,1,62,1231,60,59,119,"6 de julio de 1997"
13,1,62,1232,283,254,537,"6 de julio de 1997"
13,1,62,1233,148,125,273,"6 de julio de 1997"
13,1,62,1234,116,93,209,"6 de julio de 1997"
13,1,62,1235,123,110,233,"6 de julio de 1997"
13,1,62,1236,344,283,627,"6 de julio de 1997"
13,1,62,1237,397,307,704,"6 de julio de 1997"
13,1,62,1238,46,45,91,"6 de julio de 1997"
13,1,62,1239,38,27,65,"6 de julio de 1997"
13,1,62,1240,386,351,737,"6 de julio de 1997"
13,1,62,1241,117,96,213,"6 de julio de 1997"
13,1,62,1242,240,202,442,"6 de julio de 1997"
13,1,62,1243,229,176,405,"6 de julio de 1997"
13,1,62,1244,156,133,289,"6 de julio de 1997"
13,1,62,1245,182,152,334,"6 de julio de 1997"
13,1,62,1246,257,216,473,"6 de julio de 1997"
13,1,62,1247,95,77,172,"6 de julio de 1997"
13,1,62,1248,133,131,264,"6 de julio de 1997"
13,1,62,1249,350,325,675,"6 de julio de 1997"
13,1,62,1250,174,144,318,"6 de julio de 1997"
13,1,62,1251,141,146,287,"6 de julio de 1997"
13,1,62,1252,94,89,183,"6 de julio de 1997"
13,1,62,1253,212,204,416,"6 de julio de 1997"
13,1,62,1254,239,196,435,"6 de julio de 1997"
13,1,62,1255,68,69,137,"6 de julio de 1997"
13,1,62,1256,57,42,99,"6 de julio de 1997"
13,1,62,1257,85,61,146,"6 de julio de 1997"
13,1,62,1258,151,123,274,"6 de julio de 1997"
13,1,62,1259,129,121,250,"6 de julio de 1997"
13,1,62,1260,264,236,500,"6 de julio de 1997"
13,1,62,1261,204,198,402,"6 de julio de 1997"
13,1,72,1403,473,480,953,"6 de julio de 1997"
13,1,72,1404,129,102,231,"6 de julio de 1997"
13,1,72,1405,184,163,347,"6 de julio de 1997"
13,1,72,1406,341,278,619,"6 de julio de 1997"
13,1,72,1407,237,247,484,"6 de julio de 1997"
13,1,72,1408,225,165,390,"6 de julio de 1997"
13,1,72,1409,299,276,575,"6 de julio de 1997"
13,1,72,1410,592,504,1096,"6 de julio de 1997"
13,1,72,1411,311,271,582,"6 de julio de 1997"
13,1,72,1412,254,249,503,"6 de julio de 1997"
13,1,72,1413,224,208,432,"6 de julio de 1997"
13,1,72,1414,430,380,810,"6 de julio de 1997"
13,1,72,1415,422,387,809,"6 de julio de 1997"
13,1,72,1416,158,131,289,"6 de julio de 1997"
13,1,72,1417,277,263,540,"6 de julio de 1997"
13,1,72,1418,167,139,306,"6 de julio de 1997"
13,1,72,1419,316,309,625,"6 de julio de 1997"
13,1,72,1420,127,102,229,"6 de julio de 1997"
13,1,72,1421,154,131,285,"6 de julio de 1997"
13,1,72,1422,381,353,734,"6 de julio de 1997"
13,1,72,1423,441,421,862,"6 de julio de 1997"
13,1,72,1424,208,215,423,"6 de julio de 1997"
13,1,72,1425,261,220,481,"6 de julio de 1997"
13,1,72,1426,239,195,434,"6 de julio de 1997"
13,1,72,1427,216,198,414,"6 de julio de 1997"
13,1,72,1428,559,556,1115,"6 de julio de 1997"
13,1,78,1563,596,625,1221,"6 de julio de 1997"
13,1,78,1564,214,233,447,"6 de julio de 1997"
13,1,78,1565,206,226,432,"6 de julio de 1997"
13,1,78,1566,146,153,299,"6 de julio de 1997"
13,1,78,1567,403,425,828,"6 de julio de 1997"
13,1,78,1568,404,425,829,"6 de julio de 1997"
13,1,78,1569,223,237,460,"6 de julio de 1997"
13,1,78,1570,355,357,712,"6 de julio de 1997"
13,1,78,1571,290,274,564,"6 de julio de 1997"
13,1,78,1572,356,352,708,"6 de julio de 1997"
13,1,78,1573,113,149,262,"6 de julio de 1997"
13,1,78,1574,145,128,273,"6 de julio de 1997"
13,1,78,1575,235,184,419,"6 de julio de 1997"
13,1,80,1585,713,688,1401,"6 de julio de 1997"
13,1,80,1586,550,503,1053,"6 de julio de 1997"
13,1,80,1587,458,495,953,"6 de julio de 1997"
13,1,80,1588,325,312,637,"6 de julio de 1997"
13,1,80,1589,158,169,327,"6 de julio de 1997"
13,1,80,1590,268,300,568,"6 de julio de 1997"
13,1,80,1591,105,119,224,"6 de julio de 1997"
13,1,80,1592,185,170,355,"6 de julio de 1997"
13,1,80,1593,406,413,819,"6 de julio de 1997"
13,1,80,1594,118,122,240,"6 de julio de 1997"
13,1,80,1595,115,118,233,"6 de julio de 1997"
13,1,80,1596,115,92,207,"6 de julio de 1997"
13,1,80,1597,102,90,192,"6 de julio de 1997"
13,1,80,1598,759,650,1409,"6 de julio de 1997"
13,1,80,1599,357,317,674,"6 de julio de 1997"
13,2,6,92,482,489,971,"6 de julio de 1997"
13,2,6,93,197,198,395,"6 de julio de 1997"
13,2,6,94,114,114,228,"6 de julio de 1997"
13,2,6,95,335,322,657,"6 de julio de 1997"
13,2,6,96,177,156,333,"6 de julio de 1997"
13,2,6,97,229,224,453,"6 de julio de 1997"
13,2,6,98,121,117,238,"6 de julio de 1997"
13,2,6,99,372,384,756,"6 de julio de 1997"
13,2,6,100,243,226,469,"6 de julio de 1997"
13,2,6,101,307,345,652,"6 de julio de 1997"
13,2,6,102,114,88,202,"6 de julio de 1997"
13,2,6,103,401,415,816,"6 de julio de 1997"
13,2,6,104,233,233,466,"6 de julio de 1997"
13,2,6,105,198,175,373,"6 de julio de 1997"
13,2,6,106,242,234,476,"6 de julio de 1997"
13,2,6,107,180,167,347,"6 de julio de 1997"
13,2,6,108,156,146,302,"6 de julio de 1997"
13,2,6,109,175,136,311,"6 de julio de 1997"
13,2,6,110,109,102,211,"6 de julio de 1997"
13,2,6,111,288,253,541,"6 de julio de 1997"
13,2,6,112,78,73,151,"6 de julio de 1997"
13,2,6,113,113,89,202,"6 de julio de 1997"
13,2,14,240,360,365,725,"6 de julio de 1997"
13,2,14,241,354,346,700,"6 de julio de 1997"
13,2,14,242,115,113,228,"6 de julio de 1997"
13,2,14,243,246,215,461,"6 de julio de 1997"
13,2,14,244,100,99,199,"6 de julio de 1997"
13,2,14,245,332,366,698,"6 de julio de 1997"
13,2,14,246,458,431,889,"6 de julio de 1997"
13,2,14,247,209,210,419,"6 de julio de 1997"
13,2,14,248,206,172,378,"6 de julio de 1997"
13,2,14,249,394,385,779,"6 de julio de 1997"
13,2,14,250,520,528,1048,"6 de julio de 1997"
13,2,14,251,179,183,362,"6 de julio de 1997"
13,2,14,252,149,121,270,"6 de julio de 1997"
13,2,14,253,241,175,416,"6 de julio de 1997"
13,2,14,254,133,111,244,"6 de julio de 1997"
13,2,14,255,260,283,543,"6 de julio de 1997"
13,2,14,256,293,274,567,"6 de julio de 1997"
13,2,17,291,508,510,1018,"6 de julio de 1997"
13,2,17,292,427,459,886,"6 de julio de 1997"
13,2,17,293,127,111,238,"6 de julio de 1997"
13,2,17,294,173,169,342,"6 de julio de 1997"
13,2,17,295,69,63,132,"6 de julio de 1997"
13,2,17,296,198,157,355,"6 de julio de 1997"
13,2,17,297,185,167,352,"6 de julio de 1997"
13,2,17,298,251,201,452,"6 de julio de 1997"
13,2,17,299,86,61,147,"6 de julio de 1997"
13,2,17,300,72,57,129,"6 de julio de 1997"
13,2,17,301,119,100,219,"6 de julio de 1997"
13,2,17,302,209,183,392,"6 de julio de 1997"
13,2,17,303,122,108,230,"6 de julio de 1997"
13,2,17,304,134,116,250,"6 de julio de 1997"
13,2,17,305,209,174,383,"6 de julio de 1997"
13,2,17,306,80,59,139,"6 de julio de 1997"
13,2,17,307,262,194,456,"6 de julio de 1997"
13,2,17,308,242,234,476,"6 de julio de 1997"
13,2,17,309,467,454,921,"6 de julio de 1997"
13,2,17,310,276,221,497,"6 de julio de 1997"
13,2,17,311,278,201,479,"6 de julio de 1997"
13,2,17,312,335,280,615,"6 de julio de 1997"
13,2,17,313,127,90,217,"6 de julio de 1997"
13,2,17,314,139,110,249,"6 de julio de 1997"
13,2,17,315,296,279,575,"6 de julio de 1997"
13,2,18,316,614,658,1272,"6 de julio de 1997"
13,2,18,317,183,185,368,"6 de julio de 1997"
13,2,18,318,205,183,388,"6 de julio de 1997"
13,2,18,319,193,172,365,"6 de julio de 1997"
13,2,18,320,290,308,598,"6 de julio de 1997"
13,2,18,321,206,228,434,"6 de julio de 1997"
13,2,18,322,172,189,361,"6 de julio de 1997"
13,2,18,323,401,387,788,"6 de julio de 1997"
13,2,18,324,203,196,399,"6 de julio de 1997"
13,2,18,325,117,118,235,"6 de julio de 1997"
13,2,18,326,45,27,72,"6 de julio de 1997"
13,2,18,327,507,470,977,"6 de julio de 1997"
13,2,18,328,354,291,645,"6 de julio de 1997"
13,2,18,329,544,460,1004,"6 de julio de 1997"
13,2,18,330,40,26,66,"6 de julio de 1997"
13,2,29,510,576,638,1214,"6 de julio de 1997"
13,2,29,511,598,692,1290,"6 de julio de 1997"
13,2,29,512,353,413,766,"6 de julio de 1997"
13,2,29,513,479,576,1055,"6 de julio de 1997"
13,2,29,514,141,125,266,"6 de julio de 1997"
13,2,29,515,96,79,175,"6 de julio de 1997"
13,2,29,516,137,157,294,"6 de julio de 1997"
13,2,29,517,365,348,713,"6 de julio de 1997"
13,2,29,518,402,443,845,"6 de julio de 1997"
13,2,29,519,244,230,474,"6 de julio de 1997"
13,2,29,520,421,415,836,"6 de julio de 1997"
13,2,29,521,190,178,368,"6 de julio de 1997"
13,2,29,522,247,247,494,"6 de julio de 1997"
13,2,29,523,510,477,987,"6 de julio de 1997"
13,2,29,524,136,128,264,"6 de julio de 1997"
13,2,29,525,173,174,347,"6 de julio de 1997"
13,2,29,526,134,127,261,"6 de julio de 1997"
13,2,29,527,138,162,300,"6 de julio de 1997"
13,2,29,528,538,569,1107,"6 de julio de 1997"
13,2,29,529,71,70,141,"6 de julio de 1997"
13,2,29,530,254,248,502,"6 de julio de 1997"
13,2,29,531,221,219,440,"6 de julio de 1997"
13,2,29,532,169,174,343,"6 de julio de 1997"
13,2,29,533,247,239,486,"6 de julio de 1997"
13,2,29,534,458,477,935,"6 de julio de 1997"
13,2,29,535,464,503,967,"6 de julio de 1997"
13,2,29,536,200,187,387,"6 de julio de 1997"
13,2,29,537,341,333,674,"6 de julio de 1997"
13,2,29,538,133,127,260,"6 de julio de 1997"
13,2,29,539,311,339,650,"6 de julio de 1997"
13,2,29,540,500,480,980,"6 de julio de 1997"
13,2,29,541,105,98,203,"6 de julio de 1997"
13,2,29,542,111,104,215,"6 de julio de 1997"
13,2,29,543,305,350,655,"6 de julio de 1997"
13,2,29,544,590,561,1151,"6 de julio de 1997"
13,2,29,545,292,299,591,"6 de julio de 1997"
13,2,29,546,95,91,186,"6 de julio de 1997"
13,2,30,547,503,662,1165,"6 de julio de 1997"
13,2,30,548,341,436,777,"6 de julio de 1997"
13,2,30,549,419,542,961,"6 de julio de 1997"
13,2,30,550,589,730,1319,"6 de julio de 1997"
13,2,30,551,607,745,1352,"6 de julio de 1997"
13,2,30,552,603,773,1376,"6 de julio de 1997"
13,2,30,553,686,901,1587,"6 de julio de 1997"
13,2,30,554,205,270,475,"6 de julio de 1997"
13,2,30,555,528,614,1142,"6 de julio de 1997"
13,2,30,556,386,544,930,"6 de julio de 1997"
13,2,30,557,342,406,748,"6 de julio de 1997"
13,2,30,558,168,211,379,"6 de julio de 1997"
13,2,30,559,423,504,927,"6 de julio de 1997"
13,2,30,560,620,826,1446,"6 de julio de 1997"
13,2,30,561,460,528,988,"6 de julio de 1997"
13,2,30,562,391,467,858,"6 de julio de 1997"
13,2,30,563,417,530,947,"6 de julio de 1997"
13,2,30,564,114,140,254,"6 de julio de 1997"
13,2,30,565,103,106,209,"6 de julio de 1997"
13,2,30,566,100,78,178,"6 de julio de 1997"
13,2,30,567,52,54,106,"6 de julio de 1997"
13,2,30,568,260,254,514,"6 de julio de 1997"
13,2,30,569,205,189,394,"6 de julio de 1997"
13,2,30,570,64,52,116,"6 de julio de 1997"
13,2,30,571,49,51,100,"6 de julio de 1997"
13,2,30,572,106,116,222,"6 de julio de 1997"
13,2,30,573,43,32,75,"6 de julio de 1997"
13,2,30,574,180,216,396,"6 de julio de 1997"
13,2,30,575,484,539,1023,"6 de julio de 1997"
13,2,30,576,138,125,263,"6 de julio de 1997"
13,2,30,577,178,182,360,"6 de julio de 1997"
13,2,30,578,127,128,255,"6 de julio de 1997"
13,2,30,579,235,252,487,"6 de julio de 1997"
13,2,30,580,315,398,713,"6 de julio de 1997"
13,2,30,581,524,633,1157,"6 de julio de 1997"
13,2,30,582,160,196,356,"6 de julio de 1997"
13,2,30,583,197,247,444,"6 de julio de 1997"
13,2,30,584,81,92,173,"6 de julio de 1997"
13,2,30,585,163,191,354,"6 de julio de 1997"
13,2,30,586,243,266,509,"6 de julio de 1997"
13,2,30,587,148,148,296,"6 de julio de 1997"
13,2,30,588,174,185,359,"6 de julio de 1997"
13,2,30,589,143,170,313,"6 de julio de 1997"
13,2,30,590,242,261,503,"6 de julio de 1997"
13,2,30,591,129,179,308,"6 de julio de 1997"
13,2,30,592,139,150,289,"6 de julio de 1997"
13,2,30,593,555,613,1168,"6 de julio de 1997"
13,2,30,594,513,543,1056,"6 de julio de 1997"
13,2,30,595,798,789,1587,"6 de julio de 1997"
13,2,30,596,363,433,796,"6 de julio de 1997"
13,2,30,597,641,622,1263,"6 de julio de 1997"
13,2,30,598,169,194,363,"6 de julio de 1997"
13,2,30,599,67,72,139,"6 de julio de 1997"
13,2,30,600,304,263,567,"6 de julio de 1997"
13,2,30,601,452,504,956,"6 de julio de 1997"
13,2,30,602,137,150,287,"6 de julio de 1997"
13,2,30,603,294,287,581,"6 de julio de 1997"
13,2,30,604,66,58,124,"6 de julio de 1997"
13,2,30,605,324,340,664,"6 de julio de 1997"
13,2,30,606,140,147,287,"6 de julio de 1997"
13,2,30,607,582,648,1230,"6 de julio de 1997"
13,2,31,608,564,648,1212,"6 de julio de 1997"
13,2,31,609,411,483,894,"6 de julio de 1997"
13,2,31,610,202,177,379,"6 de julio de 1997"
13,2,31,611,151,171,322,"6 de julio de 1997"
13,2,31,612,162,191,353,"6 de julio de 1997"
13,2,31,613,196,216,412,"6 de julio de 1997"
13,2,31,614,268,271,539,"6 de julio de 1997"
13,2,31,615,67,55,122,"6 de julio de 1997"
13,2,31,616,75,69,144,"6 de julio de 1997"
13,2,31,617,48,60,108,"6 de julio de 1997"
13,2,31,618,144,125,269,"6 de julio de 1997"
13,2,31,619,39,32,71,"6 de julio de 1997"
13,2,31,620,352,358,710,"6 de julio de 1997"
13,2,31,621,43,45,88,"6 de julio de 1997"
13,2,31,622,126,117,243,"6 de julio de 1997"
13,2,31,623,36,38,74,"6 de julio de 1997"
13,2,31,624,43,36,79,"6 de julio de 1997"
13,2,31,625,53,59,112,"6 de julio de 1997"
13,2,31,626,71,79,150,"6 de julio de 1997"
13,2,31,627,145,167,312,"6 de julio de 1997"
13,2,31,628,120,118,238,"6 de julio de 1997"
13,2,31,629,161,174,335,"6 de julio de 1997"
13,2,34,646,354,332,686,"6 de julio de 1997"
13,2,34,647,359,288,647,"6 de julio de 1997"
13,2,34,648,218,175,393,"6 de julio de 1997"
13,2,34,649,342,301,643,"6 de julio de 1997"
13,2,34,650,469,462,931,"6 de julio de 1997"
13,2,34,651,133,122,255,"6 de julio de 1997"
13,2,34,652,149,138,287,"6 de julio de 1997"
13,2,34,653,205,176,381,"6 de julio de 1997"
13,2,34,654,349,357,706,"6 de julio de 1997"
13,2,34,655,388,379,767,"6 de julio de 1997"
13,2,34,656,174,177,351,"6 de julio de 1997"
13,2,43,780,221,251,472,"6 de julio de 1997"
13,2,43,781,84,69,153,"6 de julio de 1997"
13,2,43,782,97,89,186,"6 de julio de 1997"
13,2,43,783,52,48,100,"6 de julio de 1997"
13,2,43,784,98,100,198,"6 de julio de 1997"
13,2,43,785,67,63,130,"6 de julio de 1997"
13,2,43,786,49,61,110,"6 de julio de 1997"
13,2,43,787,41,33,74,"6 de julio de 1997"
13,2,43,788,102,109,211,"6 de julio de 1997"
13,2,43,789,59,47,106,"6 de julio de 1997"
13,2,43,790,81,92,173,"6 de julio de 1997"
13,2,43,791,59,58,117,"6 de julio de 1997"
13,2,43,792,41,36,77,"6 de julio de 1997"
13,2,43,793,97,92,189,"6 de julio de 1997"
13,2,43,794,27,31,58,"6 de julio de 1997"
13,2,43,795,121,113,234,"6 de julio de 1997"
13,2,43,796,90,99,189,"6 de julio de 1997"
13,2,43,797,65,75,140,"6 de julio de 1997"
13,2,43,798,36,39,75,"6 de julio de 1997"
13,2,43,799,102,110,212,"6 de julio de 1997"
13,2,43,800,89,102,191,"6 de julio de 1997"
13,2,43,801,54,61,115,"6 de julio de 1997"
13,2,46,822,178,215,393,"6 de julio de 1997"
13,2,46,823,181,220,401,"6 de julio de 1997"
13,2,46,824,269,321,590,"6 de julio de 1997"
13,2,46,825,140,163,303,"6 de julio de 1997"
13,2,46,826,100,124,224,"6 de julio de 1997"
13,2,46,827,81,110,191,"6 de julio de 1997"
13,2,46,828,111,131,242,"6 de julio de 1997"
13,2,46,829,161,176,337,"6 de julio de 1997"
13,2,46,830,73,79,152,"6 de julio de 1997"
13,2,46,831,128,149,277,"6 de julio de 1997"
13,2,48,962,726,668,1394,"6 de julio de 1997"
13,2,48,963,211,162,373,"6 de julio de 1997"
13,2,48,964,136,92,228,"6 de julio de 1997"
13,2,48,965,97,105,202,"6 de julio de 1997"
13,2,48,966,130,112,242,"6 de julio de 1997"
13,2,48,967,402,347,749,"6 de julio de 1997"
13,2,48,968,63,58,121,"6 de julio de 1997"
13,2,48,969,118,79,197,"6 de julio de 1997"
13,2,48,970,311,288,599,"6 de julio de 1997"
13,2,48,971,148,120,268,"6 de julio de 1997"
13,2,48,972,526,445,971,"6 de julio de 1997"
13,2,48,973,174,125,299,"6 de julio de 1997"
13,2,48,974,160,139,299,"6 de julio de 1997"
13,2,48,975,133,121,254,"6 de julio de 1997"
13,2,48,976,138,117,255,"6 de julio de 1997"
13,2,48,977,78,78,156,"6 de julio de 1997"
13,2,48,978,188,182,370,"6 de julio de 1997"
13,2,48,979,80,72,152,"6 de julio de 1997"
13,2,48,980,64,54,118,"6 de julio de 1997"
13,2,48,981,146,128,274,"6 de julio de 1997"
13,2,58,1132,243,284,527,"6 de julio de 1997"
13,2,58,1133,364,452,816,"6 de julio de 1997"
13,2,58,1134,508,607,1115,"6 de julio de 1997"
13,2,58,1135,182,196,378,"6 de julio de 1997"
13,2,58,1136,65,69,134,"6 de julio de 1997"
13,2,58,1137,179,212,391,"6 de julio de 1997"
13,2,58,1138,237,284,521,"6 de julio de 1997"
13,2,58,1139,139,202,341,"6 de julio de 1997"
13,2,58,1140,31,39,70,"6 de julio de 1997"
13,2,58,1141,125,139,264,"6 de julio de 1997"
13,2,58,1142,215,247,462,"6 de julio de 1997"
13,2,58,1143,98,100,198,"6 de julio de 1997"
13,2,58,1144,134,157,291,"6 de julio de 1997"
13,2,58,1145,144,163,307,"6 de julio de 1997"
13,2,58,1146,253,246,499,"6 de julio de 1997"
13,2,58,1147,136,130,266,"6 de julio de 1997"
13,2,58,1148,233,206,439,"6 de julio de 1997"
13,2,58,1149,167,157,324,"6 de julio de 1997"
13,2,58,1150,436,403,839,"6 de julio de 1997"
13,2,58,1151,461,663,1124,"6 de julio de 1997"
13,2,59,1152,712,777,1489,"6 de julio de 1997"
13,2,59,1153,753,842,1595,"6 de julio de 1997"
13,2,59,1154,224,241,465,"6 de julio de 1997"
13,2,59,1155,177,193,370,"6 de julio de 1997"
13,2,59,1156,234,226,460,"6 de julio de 1997"
13,2,59,1157,533,513,1046,"6 de julio de 1997"
13,2,59,1158,270,284,554,"6 de julio de 1997"
13,2,59,1159,577,568,1145,"6 de julio de 1997"
13,2,59,1160,272,266,538,"6 de julio de 1997"
13,2,59,1161,426,440,866,"6 de julio de 1997"
13,2,59,1162,483,518,1001,"6 de julio de 1997"
13,2,59,1163,327,307,634,"6 de julio de 1997"
13,2,59,1164,135,137,272,"6 de julio de 1997"
13,2,59,1165,160,149,309,"6 de julio de 1997"
13,2,59,1166,119,120,239,"6 de julio de 1997"
13,2,59,1167,87,99,186,"6 de julio de 1997"
13,2,59,1168,251,213,464,"6 de julio de 1997"
13,2,59,1169,113,86,199,"6 de julio de 1997"
13,2,59,1170,307,308,615,"6 de julio de 1997"
13,2,59,1171,315,330,645,"6 de julio de 1997"
13,2,59,1172,107,71,178,"6 de julio de 1997"
13,2,59,1173,291,279,570,"6 de julio de 1997"
13,2,59,1174,571,512,1083,"6 de julio de 1997"
13,2,59,1175,287,313,600,"6 de julio de 1997"
13,2,59,1176,94,100,194,"6 de julio de 1997"
13,2,84,1644,1021,550,1571,"6 de julio de 1997"
13,2,84,1645,389,456,845,"6 de julio de 1997"
13,2,84,1646,250,344,594,"6 de julio de 1997"
13,2,84,1647,282,317,599,"6 de julio de 1997"
13,2,84,1648,248,332,580,"6 de julio de 1997"
13,2,84,1649,432,496,928,"6 de julio de 1997"
13,2,84,1650,505,575,1080,"6 de julio de 1997"
13,2,84,1651,56,45,101,"6 de julio de 1997"
13,2,84,1652,55,54,109,"6 de julio de 1997"
13,2,84,1653,205,236,441,"6 de julio de 1997"
13,2,84,1654,73,72,145,"6 de julio de 1997"
13,2,84,1655,59,57,116,"6 de julio de 1997"
13,2,84,1656,72,67,139,"6 de julio de 1997"
13,2,84,1657,68,51,119,"6 de julio de 1997"
13,2,84,1658,21,31,52,"6 de julio de 1997"
13,2,84,1659,59,62,121,"6 de julio de 1997"
13,2,84,1660,121,121,242,"6 de julio de 1997"
13,2,84,1661,55,60,115,"6 de julio de 1997"
13,2,84,1662,188,176,364,"6 de julio de 1997"
13,2,84,1663,82,81,163,"6 de julio de 1997"
13,2,84,1664,97,111,208,"6 de julio de 1997"
13,2,84,1665,70,68,138,"6 de julio de 1997"
13,2,84,1666,29,33,62,"6 de julio de 1997"
13,2,84,1667,60,64,124,"6 de julio de 1997"
13,2,84,1668,306,367,673,"6 de julio de 1997"
13,2,84,1669,65,75,140,"6 de julio de 1997"
13,2,84,1670,78,76,154,"6 de julio de 1997"
13,2,84,1671,59,54,113,"6 de julio de 1997"
13,2,84,1672,70,69,139,"6 de julio de 1997"
13,2,84,1673,69,65,134,"6 de julio de 1997"
13,2,84,1674,30,47,77,"6 de julio de 1997"
13,2,84,1675,257,280,537,"6 de julio de 1997"
13,2,84,1676,213,249,462,"6 de julio de 1997"
13,2,84,1677,36,32,68,"6 de julio de 1997"
13,2,84,1678,329,380,709,"6 de julio de 1997"
13,2,84,1679,361,398,759,"6 de julio de 1997"
13,2,84,1680,451,506,957,"6 de julio de 1997"
13,2,84,1681,131,175,306,"6 de julio de 1997"
13,2,84,1682,230,259,489,"6 de julio de 1997"
13,2,84,1683,312,368,680,"6 de julio de 1997"
13,2,84,1684,288,306,594,"6 de julio de 1997"
13,2,84,1685,44,67,111,"6 de julio de 1997"
13,2,84,1686,116,100,216,"6 de julio de 1997"
13,2,84,1687,150,162,312,"6 de julio de 1997"
13,2,84,1688,156,129,285,"6 de julio de 1997"
13,2,84,1689,41,43,84,"6 de julio de 1997"
13,2,84,1690,21,33,54,"6 de julio de 1997"
13,2,84,1691,38,40,78,"6 de julio de 1997"
13,2,84,1692,99,123,222,"6 de julio de 1997"
13,2,84,1693,86,99,185,"6 de julio de 1997"
13,2,84,1694,577,669,1246,"6 de julio de 1997"
13,2,84,1695,39,68,107,"6 de julio de 1997"
13,2,84,1696,93,113,206,"6 de julio de 1997"
13,2,84,1697,50,60,110,"6 de julio de 1997"
13,2,84,1698,81,71,152,"6 de julio de 1997"
13,2,84,1699,141,142,283,"6 de julio de 1997"
13,2,84,1700,133,138,271,"6 de julio de 1997"
13,2,84,1701,61,70,131,"6 de julio de 1997"
13,2,84,1702,170,184,354,"6 de julio de 1997"
13,2,84,1703,181,188,369,"6 de julio de 1997"
13,2,84,1704,92,90,182,"6 de julio de 1997"
13,2,84,1705,40,39,79,"6 de julio de 1997"
13,2,84,1706,128,156,284,"6 de julio de 1997"
13,2,84,1707,48,41,89,"6 de julio de 1997"
13,3,3,34,482,571,1053,"6 de julio de 1997"
13,3,3,35,414,490,904,"6 de julio de 1997"
13,3,3,36,292,325,617,"6 de julio de 1997"
13,3,3,37,520,608,1128,"6 de julio de 1997"
13,3,3,38,469,566,1035,"6 de julio de 1997"
13,3,3,39,581,748,1329,"6 de julio de 1997"
13,3,3,40,712,855,1567,"6 de julio de 1997"
13,3,3,41,322,359,681,"6 de julio de 1997"
13,3,3,42,273,354,627,"6 de julio de 1997"
13,3,3,43,477,560,1037,"6 de julio de 1997"
13,3,3,44,716,859,1575,"6 de julio de 1997"
13,3,3,45,417,500,917,"6 de julio de 1997"
13,3,3,46,395,485,880,"6 de julio de 1997"
13,3,3,47,397,474,871,"6 de julio de 1997"
13,3,3,48,115,92,207,"6 de julio de 1997"
13,3,3,49,101,84,185,"6 de julio de 1997"
13,3,3,50,57,48,105,"6 de julio de 1997"
13,3,3,51,89,93,182,"6 de julio de 1997"
13,3,3,52,288,280,568,"6 de julio de 1997"
13,3,3,53,123,134,257,"6 de julio de 1997"
13,3,3,54,327,371,698,"6 de julio de 1997"
13,3,3,55,317,335,652,"6 de julio de 1997"
13,3,3,56,95,91,186,"6 de julio de 1997"
13,3,3,57,231,221,452,"6 de julio de 1997"
13,3,3,58,148,119,267,"6 de julio de 1997"
13,3,3,59,142,163,305,"6 de julio de 1997"
13,3,3,60,544,590,1134,"6 de julio de 1997"
13,3,3,61,174,188,362,"6 de julio de 1997"
13,3,3,62,603,619,1222,"6 de julio de 1997"
13,3,3,63,108,122,230,"6 de julio de 1997"
13,3,3,64,175,220,395,"6 de julio de 1997"
13,3,3,65,480,499,979,"6 de julio de 1997"
13,3,3,66,382,410,792,"6 de julio de 1997"
13,3,3,67,414,434,848,"6 de julio de 1997"
13,3,3,68,376,414,790,"6 de julio de 1997"
13,3,11,178,453,528,981,"6 de julio de 1997"
13,3,11,179,578,699,1277,"6 de julio de 1997"
13,3,11,180,420,476,896,"6 de julio de 1997"
13,3,11,181,320,362,682,"6 de julio de 1997"
13,3,11,182,86,92,178,"6 de julio de 1997"
13,3,11,183,165,160,325,"6 de julio de 1997"
13,3,11,184,206,191,397,"6 de julio de 1997"
13,3,11,185,70,99,169,"6 de julio de 1997"
13,3,11,186,190,208,398,"6 de julio de 1997"
13,3,11,187,394,407,801,"6 de julio de 1997"
13,3,11,188,222,214,436,"6 de julio de 1997"
13,3,11,189,199,186,385,"6 de julio de 1997"
13,3,11,190,180,198,378,"6 de julio de 1997"
13,3,11,191,250,291,541,"6 de julio de 1997"
13,3,11,192,176,272,448,"6 de julio de 1997"
13,3,11,193,289,302,591,"6 de julio de 1997"
13,3,11,194,333,449,782,"6 de julio de 1997"
13,3,11,195,260,305,565,"6 de julio de 1997"
13,3,11,196,153,180,333,"6 de julio de 1997"
13,3,11,197,398,442,840,"6 de julio de 1997"
13,3,11,198,82,74,156,"6 de julio de 1997"
13,3,11,199,127,127,254,"6 de julio de 1997"
13,3,11,200,225,234,459,"6 de julio de 1997"
13,3,11,201,271,290,561,"6 de julio de 1997"
13,3,11,202,157,130,287,"6 de julio de 1997"
13,3,11,203,311,388,699,"6 de julio de 1997"
13,3,11,204,404,349,753,"6 de julio de 1997"
13,3,11,205,66,61,127,"6 de julio de 1997"
13,3,19,331,552,632,1184,"6 de julio de 1997"
13,3,19,332,292,300,592,"6 de julio de 1997"
13,3,19,333,313,293,606,"6 de julio de 1997"
13,3,19,334,119,117,236,"6 de julio de 1997"
13,3,19,335,229,252,481,"6 de julio de 1997"
13,3,19,336,484,509,993,"6 de julio de 1997"
13,3,19,337,188,191,379,"6 de julio de 1997"
13,3,19,338,149,167,316,"6 de julio de 1997"
13,3,19,339,189,174,363,"6 de julio de 1997"
13,3,19,340,795,761,1556,"6 de julio de 1997"
13,3,19,341,291,318,609,"6 de julio de 1997"
13,3,20,342,274,270,544,"6 de julio de 1997"
13,3,20,343,49,46,95,"6 de julio de 1997"
13,3,20,344,40,39,79,"6 de julio de 1997"
13,3,20,345,283,268,551,"6 de julio de 1997"
13,3,20,346,94,95,189,"6 de julio de 1997"
13,3,20,347,47,44,91,"6 de julio de 1997"
13,3,20,348,93,82,175,"6 de julio de 1997"
13,3,20,349,92,80,172,"6 de julio de 1997"
13,3,23,369,616,661,1277,"6 de julio de 1997"
13,3,23,370,532,620,1152,"6 de julio de 1997"
13,3,23,371,625,682,1307,"6 de julio de 1997"
13,3,23,372,343,371,714,"6 de julio de 1997"
13,3,23,373,571,674,1245,"6 de julio de 1997"
13,3,23,374,441,515,956,"6 de julio de 1997"
13,3,23,375,289,243,532,"6 de julio de 1997"
13,3,23,376,198,237,435,"6 de julio de 1997"
13,3,23,377,156,170,326,"6 de julio de 1997"
13,3,23,378,486,507,993,"6 de julio de 1997"
13,3,23,379,460,504,964,"6 de julio de 1997"
13,3,23,380,332,327,659,"6 de julio de 1997"
13,3,23,381,431,438,869,"6 de julio de 1997"
13,3,23,382,263,260,523,"6 de julio de 1997"
13,3,23,383,657,644,1301,"6 de julio de 1997"
13,3,23,384,677,687,1364,"6 de julio de 1997"
13,3,23,385,728,760,1488,"6 de julio de 1997"
13,3,33,642,252,226,478,"6 de julio de 1997"
13,3,33,643,151,110,261,"6 de julio de 1997"
13,3,33,644,203,192,395,"6 de julio de 1997"
13,3,33,645,329,337,666,"6 de julio de 1997"
13,3,37,674,339,404,743,"6 de julio de 1997"
13,3,37,675,463,523,986,"6 de julio de 1997"
13,3,37,676,208,211,419,"6 de julio de 1997"
13,3,37,677,115,103,218,"6 de julio de 1997"
13,3,37,678,225,234,459,"6 de julio de 1997"
13,3,37,679,247,233,480,"6 de julio de 1997"
13,3,37,680,506,538,1044,"6 de julio de 1997"
13,3,37,681,421,447,868,"6 de julio de 1997"
13,3,37,682,82,79,161,"6 de julio de 1997"
13,3,37,683,121,96,217,"6 de julio de 1997"
13,3,37,684,187,180,367,"6 de julio de 1997"
13,3,37,685,106,126,232,"6 de julio de 1997"
13,3,37,686,228,235,463,"6 de julio de 1997"
13,3,37,687,142,122,264,"6 de julio de 1997"
13,3,37,688,133,129,262,"6 de julio de 1997"
13,3,37,689,264,277,541,"6 de julio de 1997"
13,3,37,690,131,107,238,"6 de julio de 1997"
13,3,37,691,223,177,400,"6 de julio de 1997"
13,3,37,692,122,94,216,"6 de julio de 1997"
13,3,37,693,231,223,454,"6 de julio de 1997"
13,3,37,694,232,278,510,"6 de julio de 1997"
13,3,37,695,281,214,495,"6 de julio de 1997"
13,3,37,696,59,50,109,"6 de julio de 1997"
13,3,37,697,346,340,686,"6 de julio de 1997"
13,3,37,698,181,178,359,"6 de julio de 1997"
13,3,37,699,73,52,125,"6 de julio de 1997"
13,3,41,743,732,809,1541,"6 de julio de 1997"
13,3,41,744,625,696,1321,"6 de julio de 1997"
13,3,41,745,557,575,1132,"6 de julio de 1997"
13,3,41,746,444,536,980,"6 de julio de 1997"
13,3,41,747,379,406,785,"6 de julio de 1997"
13,3,41,748,585,631,1216,"6 de julio de 1997"
13,3,41,749,581,669,1250,"6 de julio de 1997"
13,3,41,750,662,733,1395,"6 de julio de 1997"
13,3,41,751,605,641,1246,"6 de julio de 1997"
13,3,41,752,419,455,874,"6 de julio de 1997"
13,3,41,753,525,598,1123,"6 de julio de 1997"
13,3,41,754,173,163,336,"6 de julio de 1997"
13,3,41,755,217,194,411,"6 de julio de 1997"
13,3,41,756,431,456,887,"6 de julio de 1997"
13,3,41,757,361,304,665,"6 de julio de 1997"
13,3,41,758,360,369,729,"6 de julio de 1997"
13,3,41,759,524,522,1046,"6 de julio de 1997"
13,3,41,760,175,173,348,"6 de julio de 1997"
13,3,41,761,589,596,1185,"6 de julio de 1997"
13,3,41,762,256,267,523,"6 de julio de 1997"
13,3,41,763,275,260,535,"6 de julio de 1997"
13,3,41,764,117,120,237,"6 de julio de 1997"
13,3,49,982,518,567,1085,"6 de julio de 1997"
13,3,49,983,766,872,1638,"6 de julio de 1997"
13,3,49,984,457,508,965,"6 de julio de 1997"
13,3,49,985,464,492,956,"6 de julio de 1997"
13,3,49,986,481,587,1068,"6 de julio de 1997"
13,3,49,987,665,772,1437,"6 de julio de 1997"
13,3,49,988,637,708,1345,"6 de julio de 1997"
13,3,49,989,59,54,113,"6 de julio de 1997"
13,3,49,990,126,121,247,"6 de julio de 1997"
13,3,49,991,505,542,1047,"6 de julio de 1997"
13,3,49,992,461,514,975,"6 de julio de 1997"
13,3,49,993,248,287,535,"6 de julio de 1997"
13,3,50,994,664,719,1383,"6 de julio de 1997"
13,3,50,995,78,104,182,"6 de julio de 1997"
13,3,50,996,271,330,601,"6 de julio de 1997"
13,3,50,997,226,246,472,"6 de julio de 1997"
13,3,50,998,65,56,121,"6 de julio de 1997"
13,3,50,999,122,135,257,"6 de julio de 1997"
13,3,50,1000,194,200,394,"6 de julio de 1997"
13,3,50,1001,198,208,406,"6 de julio de 1997"
13,3,50,1002,199,206,405,"6 de julio de 1997"
13,3,50,1003,62,63,125,"6 de julio de 1997"
13,3,50,1004,58,70,128,"6 de julio de 1997"
13,3,50,1005,191,202,393,"6 de julio de 1997"
13,3,50,1006,96,82,178,"6 de julio de 1997"
13,3,50,1007,57,53,110,"6 de julio de 1997"
13,3,54,1067,462,518,980,"6 de julio de 1997"
13,3,54,1068,478,391,869,"6 de julio de 1997"
13,3,54,1069,188,158,346,"6 de julio de 1997"
13,3,54,1070,429,449,878,"6 de julio de 1997"
13,3,54,1071,143,150,293,"6 de julio de 1997"
13,3,54,1072,362,339,701,"6 de julio de 1997"
13,3,54,1073,360,338,698,"6 de julio de 1997"
13,3,54,1074,293,304,597,"6 de julio de 1997"
13,3,54,1075,170,170,340,"6 de julio de 1997"
13,3,54,1076,240,252,492,"6 de julio de 1997"
13,3,54,1077,158,153,311,"6 de julio de 1997"
13,3,54,1078,400,428,828,"6 de julio de 1997"
13,3,54,1079,655,668,1323,"6 de julio de 1997"
13,3,54,1080,228,264,492,"6 de julio de 1997"
13,3,54,1081,230,229,459,"6 de julio de 1997"
13,3,54,1082,132,149,281,"6 de julio de 1997"
13,3,54,1083,92,83,175,"6 de julio de 1997"
13,3,54,1084,343,332,675,"6 de julio de 1997"
13,3,54,1085,689,750,1439,"6 de julio de 1997"
13,3,54,1086,241,272,513,"6 de julio de 1997"
13,3,54,1087,590,624,1214,"6 de julio de 1997"
13,3,54,1088,389,381,770,"6 de julio de 1997"
13,3,54,1089,200,181,381,"6 de julio de 1997"
13,3,54,1090,273,275,548,"6 de julio de 1997"
13,3,55,1091,521,552,1073,"6 de julio de 1997"
13,3,55,1092,68,58,126,"6 de julio de 1997"
13,3,55,1093,50,39,89,"6 de julio de 1997"
13,3,55,1094,80,73,153,"6 de julio de 1997"
13,3,55,1095,48,34,82,"6 de julio de 1997"
13,3,55,1096,306,278,584,"6 de julio de 1997"
13,3,55,1097,175,145,320,"6 de julio de 1997"
13,3,55,1098,139,136,275,"6 de julio de 1997"
13,3,55,1099,583,614,1197,"6 de julio de 1997"
13,3,55,1100,372,395,767,"6 de julio de 1997"
13,3,55,1101,167,178,345,"6 de julio de 1997"
13,3,55,1102,145,143,288,"6 de julio de 1997"
13,3,55,1103,103,113,216,"6 de julio de 1997"
13,3,55,1104,83,97,180,"6 de julio de 1997"
13,3,55,1105,223,225,448,"6 de julio de 1997"
13,3,55,1106,137,129,266,"6 de julio de 1997"
13,3,55,1107,186,150,336,"6 de julio de 1997"
13,3,55,1108,164,142,306,"6 de julio de 1997"
13,3,55,1109,284,285,569,"6 de julio de 1997"
13,3,67,1333,335,356,691,"6 de julio de 1997"
13,3,67,1334,313,336,649,"6 de julio de 1997"
13,3,67,1335,122,104,226,"6 de julio de 1997"
13,3,67,1336,195,205,400,"6 de julio de 1997"
13,3,67,1337,206,168,374,"6 de julio de 1997"
13,3,67,1338,287,199,486,"6 de julio de 1997"
13,3,67,1339,92,69,161,"6 de julio de 1997"
13,3,67,1340,218,139,357,"6 de julio de 1997"
13,3,67,1341,205,200,405,"6 de julio de 1997"
13,3,67,1342,275,230,505,"6 de julio de 1997"
13,3,67,1343,146,122,268,"6 de julio de 1997"
13,3,67,1344,338,268,606,"6 de julio de 1997"
13,3,67,1345,165,161,326,"6 de julio de 1997"
13,3,67,1346,303,288,591,"6 de julio de 1997"
13,3,67,1347,221,248,469,"6 de julio de 1997"
13,3,67,1348,149,223,372,"6 de julio de 1997"
13,3,70,1378,261,217,478,"6 de julio de 1997"
13,3,70,1379,231,180,411,"6 de julio de 1997"
13,3,70,1380,272,186,458,"6 de julio de 1997"
13,3,70,1381,212,162,374,"6 de julio de 1997"
13,3,70,1382,122,93,215,"6 de julio de 1997"
13,3,70,1383,115,80,195,"6 de julio de 1997"
13,3,70,1384,92,71,163,"6 de julio de 1997"
13,3,70,1385,145,131,276,"6 de julio de 1997"
13,3,70,1386,217,144,361,"6 de julio de 1997"
13,3,70,1387,69,37,106,"6 de julio de 1997"
13,3,70,1388,293,273,566,"6 de julio de 1997"
13,3,70,1389,94,75,169,"6 de julio de 1997"
13,3,70,1390,105,103,208,"6 de julio de 1997"
13,3,70,1391,230,205,435,"6 de julio de 1997"
13,3,70,1392,148,174,322,"6 de julio de 1997"
13,3,70,1393,115,119,234,"6 de julio de 1997"
13,3,70,1394,71,72,143,"6 de julio de 1997"
13,3,79,1576,278,299,577,"6 de julio de 1997"
13,3,79,1577,338,307,645,"6 de julio de 1997"
13,3,79,1578,295,279,574,"6 de julio de 1997"
13,3,79,1579,232,211,443,"6 de julio de 1997"
13,3,79,1580,75,73,148,"6 de julio de 1997"
13,3,79,1581,228,226,454,"6 de julio de 1997"
13,3,79,1582,174,191,365,"6 de julio de 1997"
13,3,79,1583,358,335,693,"6 de julio de 1997"
13,3,79,1584,214,234,448,"6 de julio de 1997"
13,3,81,1600,439,479,918,"6 de julio de 1997"
13,3,81,1601,372,392,764,"6 de julio de 1997"
13,3,81,1602,505,515,1020,"6 de julio de 1997"
13,3,81,1603,412,502,914,"6 de julio de 1997"
13,3,81,1604,359,421,780,"6 de julio de 1997"
13,3,81,1605,393,451,844,"6 de julio de 1997"
13,3,81,1606,450,564,1014,"6 de julio de 1997"
13,3,81,1607,365,415,780,"6 de julio de 1997"
13,3,81,1608,347,402,749,"6 de julio de 1997"
13,3,81,1609,175,125,300,"6 de julio de 1997"
13,3,81,1610,237,170,407,"6 de julio de 1997"
13,3,81,1611,221,267,488,"6 de julio de 1997"
13,3,81,1612,69,66,135,"6 de julio de 1997"
13,3,81,1613,193,150,343,"6 de julio de 1997"
13,3,81,1614,284,274,558,"6 de julio de 1997"
13,3,81,1615,213,214,427,"6 de julio de 1997"
13,3,81,1616,194,187,381,"6 de julio de 1997"
13,3,81,1617,188,176,364,"6 de julio de 1997"
13,3,81,1618,211,207,418,"6 de julio de 1997"
13,4,1,1,439,495,934,"6 de julio de 1997"
13,4,1,2,283,328,611,"6 de julio de 1997"
13,4,1,3,102,92,194,"6 de julio de 1997"
13,4,1,4,71,59,130,"6 de julio de 1997"
13,4,1,5,333,272,605,"6 de julio de 1997"
13,4,1,6,424,391,815,"6 de julio de 1997"
13,4,1,7,412,432,844,"6 de julio de 1997"
13,4,1,8,516,540,1056,"6 de julio de 1997"
13,4,1,9,649,629,1278,"6 de julio de 1997"
13,4,1,10,479,508,987,"6 de julio de 1997"
13,4,1,11,543,640,1183,"6 de julio de 1997"
13,4,1,12,404,435,839,"6 de julio de 1997"
13,4,2,13,608,684,1292,"6 de julio de 1997"
13,4,2,14,531,539,1070,"6 de julio de 1997"
13,4,2,15,158,185,343,"6 de julio de 1997"
13,4,2,16,251,257,508,"6 de julio de 1997"
13,4,2,17,175,223,398,"6 de julio de 1997"
13,4,2,18,140,125,265,"6 de julio de 1997"
13,4,2,19,220,218,438,"6 de julio de 1997"
13,4,2,20,372,488,860,"6 de julio de 1997"
13,4,2,21,286,372,658,"6 de julio de 1997"
13,4,2,22,519,514,1033,"6 de julio de 1997"
13,4,2,23,537,609,1146,"6 de julio de 1997"
13,4,2,24,641,727,1368,"6 de julio de 1997"
13,4,2,25,440,471,911,"6 de julio de 1997"
13,4,2,26,284,310,594,"6 de julio de 1997"
13,4,2,27,705,624,1329,"6 de julio de 1997"
13,4,2,28,265,267,532,"6 de julio de 1997"
13,4,2,29,492,486,978,"6 de julio de 1997"
13,4,2,30,488,522,1010,"6 de julio de 1997"
13,4,2,31,404,411,815,"6 de julio de 1997"
13,4,2,32,441,492,933,"6 de julio de 1997"
13,4,2,33,327,287,614,"6 de julio de 1997"
13,4,4,69,597,666,1263,"6 de julio de 1997"
13,4,4,70,117,110,227,"6 de julio de 1997"
13,4,4,71,67,65,132,"6 de julio de 1997"
13,4,4,72,173,172,345,"6 de julio de 1997"
13,4,4,73,152,121,273,"6 de julio de 1997"
13,4,4,74,131,141,272,"6 de julio de 1997"
13,4,4,75,59,59,118,"6 de julio de 1997"
13,4,4,76,68,78,146,"6 de julio de 1997"
13,4,4,77,308,292,600,"6 de julio de 1997"
13,4,4,78,255,250,505,"6 de julio de 1997"
13,4,4,79,210,217,427,"6 de julio de 1997"
13,4,4,80,175,183,358,"6 de julio de 1997"
13,4,24,386,326,360,686,"6 de julio de 1997"
13,4,24,387,261,285,546,"6 de julio de 1997"
13,4,24,388,105,106,211,"6 de julio de 1997"
13,4,24,389,105,93,198,"6 de julio de 1997"
13,4,24,390,74,81,155,"6 de julio de 1997"
13,4,24,391,202,220,422,"6 de julio de 1997"
13,4,24,392,388,373,761,"6 de julio de 1997"
13,4,24,393,142,138,280,"6 de julio de 1997"
13,4,24,394,108,95,203,"6 de julio de 1997"
13,4,24,395,340,345,685,"6 de julio de 1997"
13,4,24,396,221,195,416,"6 de julio de 1997"
13,4,24,397,270,317,587,"6 de julio de 1997"
13,4,24,398,245,281,526,"6 de julio de 1997"
13,4,24,399,343,395,738,"6 de julio de 1997"
13,4,24,400,402,393,795,"6 de julio de 1997"
13,4,24,401,102,97,199,"6 de julio de 1997"
13,4,24,402,111,149,260,"6 de julio de 1997"
13,4,24,403,179,164,343,"6 de julio de 1997"
13,4,24,404,63,84,147,"6 de julio de 1997"
13,4,27,441,775,763,1538,"6 de julio de 1997"
13,4,27,442,109,87,196,"6 de julio de 1997"
13,4,27,443,280,288,568,"6 de julio de 1997"
13,4,27,444,291,324,615,"6 de julio de 1997"
13,4,27,445,96,85,181,"6 de julio de 1997"
13,4,27,446,246,232,478,"6 de julio de 1997"
13,4,27,447,632,573,1205,"6 de julio de 1997"
13,4,27,448,252,225,477,"6 de julio de 1997"
13,4,27,449,384,382,766,"6 de julio de 1997"
13,4,27,450,280,233,513,"6 de julio de 1997"
13,4,27,451,467,433,900,"6 de julio de 1997"
13,4,27,452,379,346,725,"6 de julio de 1997"
13,4,27,453,432,401,833,"6 de julio de 1997"
13,4,27,454,374,372,746,"6 de julio de 1997"
13,4,27,455,234,192,426,"6 de julio de 1997"
13,4,27,456,180,178,358,"6 de julio de 1997"
13,4,36,665,569,623,1192,"6 de julio de 1997"
13,4,36,666,85,69,154,"6 de julio de 1997"
13,4,36,667,371,405,776,"6 de julio de 1997"
13,4,36,668,677,705,1382,"6 de julio de 1997"
13,4,36,669,112,94,206,"6 de julio de 1997"
13,4,36,670,246,190,436,"6 de julio de 1997"
13,4,36,671,349,331,680,"6 de julio de 1997"
13,4,36,672,100,102,202,"6 de julio de 1997"
13,4,36,673,183,163,346,"6 de julio de 1997"
13,4,45,812,608,651,1259,"6 de julio de 1997"
13,4,45,813,311,323,634,"6 de julio de 1997"
13,4,45,814,117,131,248,"6 de julio de 1997"
13,4,45,815,157,150,307,"6 de julio de 1997"
13,4,45,816,222,241,463,"6 de julio de 1997"
13,4,45,817,228,204,432,"6 de julio de 1997"
13,4,45,818,324,292,616,"6 de julio de 1997"
13,4,45,819,191,202,393,"6 de julio de 1997"
13,4,45,820,115,135,250,"6 de julio de 1997"
13,4,45,821,73,67,140,"6 de julio de 1997"
13,4,52,1026,491,535,1026,"6 de julio de 1997"
13,4,52,1027,715,707,1422,"6 de julio de 1997"
13,4,52,1028,176,145,321,"6 de julio de 1997"
13,4,52,1029,74,72,146,"6 de julio de 1997"
13,4,52,1030,273,247,520,"6 de julio de 1997"
13,4,52,1031,348,276,624,"6 de julio de 1997"
13,4,52,1032,301,255,556,"6 de julio de 1997"
13,4,52,1033,78,75,153,"6 de julio de 1997"
13,4,52,1034,363,320,683,"6 de julio de 1997"
13,4,52,1035,158,137,295,"6 de julio de 1997"
13,4,52,1036,442,438,880,"6 de julio de 1997"
13,4,52,1037,334,255,589,"6 de julio de 1997"
13,4,52,1038,131,110,241,"6 de julio de 1997"
13,4,52,1039,402,372,774,"6 de julio de 1997"
13,4,52,1040,85,92,177,"6 de julio de 1997"
13,4,52,1041,94,93,187,"6 de julio de 1997"
13,4,52,1042,92,83,175,"6 de julio de 1997"
13,4,56,1110,715,780,1495,"6 de julio de 1997"
13,4,56,1111,722,861,1583,"6 de julio de 1997"
13,4,56,1112,640,775,1415,"6 de julio de 1997"
13,4,56,1113,527,641,1168,"6 de julio de 1997"
13,4,56,1114,1023,1097,2120,"6 de julio de 1997"
13,4,56,1115,116,105,221,"6 de julio de 1997"
13,4,56,1116,514,576,1090,"6 de julio de 1997"
13,4,56,1117,283,335,618,"6 de julio de 1997"
13,4,56,1118,732,692,1424,"6 de julio de 1997"
13,4,56,1119,139,113,252,"6 de julio de 1997"
13,4,56,1120,289,313,602,"6 de julio de 1997"
13,4,60,1177,236,277,513,"6 de julio de 1997"
13,4,60,1178,575,599,1174,"6 de julio de 1997"
13,4,60,1179,164,108,272,"6 de julio de 1997"
13,4,60,1180,552,457,1009,"6 de julio de 1997"
13,4,60,1181,283,232,515,"6 de julio de 1997"
13,4,60,1182,161,142,303,"6 de julio de 1997"
13,4,60,1183,274,339,613,"6 de julio de 1997"
13,4,60,1184,156,151,307,"6 de julio de 1997"
13,4,60,1185,200,206,406,"6 de julio de 1997"
13,4,60,1186,168,157,325,"6 de julio de 1997"
13,4,60,1187,161,186,347,"6 de julio de 1997"
13,4,60,1188,318,402,720,"6 de julio de 1997"
13,4,60,1189,217,310,527,"6 de julio de 1997"
13,4,60,1190,288,302,590,"6 de julio de 1997"
13,4,76,1502,870,932,1802,"6 de julio de 1997"
13,4,76,1503,718,830,1548,"6 de julio de 1997"
13,4,76,1504,807,998,1805,"6 de julio de 1997"
13,4,76,1505,698,865,1563,"6 de julio de 1997"
13,4,76,1506,672,795,1467,"6 de julio de 1997"
13,4,76,1507,714,849,1563,"6 de julio de 1997"
13,4,76,1508,538,724,1262,"6 de julio de 1997"
13,4,76,1509,625,730,1355,"6 de julio de 1997"
13,4,76,1510,729,867,1596,"6 de julio de 1997"
13,4,76,1511,701,796,1497,"6 de julio de 1997"
13,4,76,1512,463,552,1015,"6 de julio de 1997"
13,4,76,1513,715,871,1586,"6 de julio de 1997"
13,4,76,1514,739,866,1605,"6 de julio de 1997"
13,4,76,1515,715,845,1560,"6 de julio de 1997"
13,4,76,1516,726,895,1621,"6 de julio de 1997"
13,4,76,1517,668,833,1501,"6 de julio de 1997"
13,4,76,1518,538,667,1205,"6 de julio de 1997"
13,4,76,1519,401,526,927,"6 de julio de 1997"
13,4,76,1520,649,853,1502,"6 de julio de 1997"
13,4,76,1521,372,493,865,"6 de julio de 1997"
13,4,76,1522,470,593,1063,"6 de julio de 1997"
13,4,76,1523,423,577,1000,"6 de julio de 1997"
13,4,76,1524,636,784,1420,"6 de julio de 1997"
13,4,76,1525,741,817,1558,"6 de julio de 1997"
13,4,76,1526,739,871,1610,"6 de julio de 1997"
13,4,76,1527,313,361,674,"6 de julio de 1997"
13,4,76,1528,629,755,1384,"6 de julio de 1997"
13,4,76,1529,835,958,1793,"6 de julio de 1997"
13,4,76,1530,879,1011,1890,"6 de julio de 1997"
13,4,76,1531,476,571,1047,"6 de julio de 1997"
13,4,76,1532,557,636,1193,"6 de julio de 1997"
13,4,76,1533,499,654,1153,"6 de julio de 1997"
13,4,76,1534,629,776,1405,"6 de julio de 1997"
13,4,76,1535,699,793,1492,"6 de julio de 1997"
13,4,76,1536,634,695,1329,"6 de julio de 1997"
13,4,76,1537,629,793,1422,"6 de julio de 1997"
13,4,76,1538,556,677,1233,"6 de julio de 1997"
13,4,76,1539,552,589,1141,"6 de julio de 1997"
13,4,76,1540,198,211,409,"6 de julio de 1997"
13,4,76,1541,142,123,265,"6 de julio de 1997"
13,4,76,1542,236,213,449,"6 de julio de 1997"
13,4,76,1543,414,438,852,"6 de julio de 1997"
13,4,76,1544,803,856,1659,"6 de julio de 1997"
13,4,76,1545,610,661,1271,"6 de julio de 1997"
13,4,76,1546,165,192,357,"6 de julio de 1997"
13,4,76,1547,52,49,101,"6 de julio de 1997"
13,4,76,1548,545,627,1172,"6 de julio de 1997"
13,4,76,1549,380,465,845,"6 de julio de 1997"
13,4,76,1550,197,248,445,"6 de julio de 1997"
13,4,76,1551,415,449,864,"6 de julio de 1997"
13,4,76,1552,88,102,190,"6 de julio de 1997"
13,4,76,1553,295,336,631,"6 de julio de 1997"
13,4,76,1554,754,849,1603,"6 de julio de 1997"
13,4,76,1555,400,440,840,"6 de julio de 1997"
13,5,5,81,433,441,874,"6 de julio de 1997"
13,5,5,82,546,530,1076,"6 de julio de 1997"
13,5,5,83,439,401,840,"6 de julio de 1997"
13,5,5,84,417,444,861,"6 de julio de 1997"
13,5,5,85,435,418,853,"6 de julio de 1997"
13,5,5,86,655,646,1301,"6 de julio de 1997"
13,5,5,87,97,87,184,"6 de julio de 1997"
13,5,5,88,605,620,1225,"6 de julio de 1997"
13,5,5,89,381,373,754,"6 de julio de 1997"
13,5,5,90,120,129,249,"6 de julio de 1997"
13,5,5,91,99,72,171,"6 de julio de 1997"
13,5,9,152,724,770,1494,"6 de julio de 1997"
13,5,9,153,770,740,1510,"6 de julio de 1997"
13,5,9,154,542,504,1046,"6 de julio de 1997"
13,5,9,155,449,400,849,"6 de julio de 1997"
13,5,9,156,608,611,1219,"6 de julio de 1997"
13,5,9,157,604,604,1208,"6 de julio de 1997"
13,5,9,158,639,611,1250,"6 de julio de 1997"
13,5,9,159,409,434,843,"6 de julio de 1997"
13,5,9,160,310,343,653,"6 de julio de 1997"
13,5,9,161,698,674,1372,"6 de julio de 1997"
13,5,12,206,579,563,1142,"6 de julio de 1997"
13,5,12,207,529,492,1021,"6 de julio de 1997"
13,5,12,208,567,564,1131,"6 de julio de 1997"
13,5,12,209,707,708,1415,"6 de julio de 1997"
13,5,12,210,198,193,391,"6 de julio de 1997"
13,5,12,211,407,403,810,"6 de julio de 1997"
13,5,12,212,255,259,514,"6 de julio de 1997"
13,5,12,213,236,237,473,"6 de julio de 1997"
13,5,12,214,386,367,753,"6 de julio de 1997"
13,5,12,215,605,628,1233,"6 de julio de 1997"
13,5,12,216,941,916,1857,"6 de julio de 1997"
13,5,12,217,131,124,255,"6 de julio de 1997"
13,5,12,218,102,100,202,"6 de julio de 1997"
13,5,12,219,78,73,151,"6 de julio de 1997"
13,5,12,220,94,94,188,"6 de julio de 1997"
13,5,12,221,97,99,196,"6 de julio de 1997"
13,5,12,222,441,417,858,"6 de julio de 1997"
13,5,12,223,360,381,741,"6 de julio de 1997"
13,5,16,281,470,442,912,"6 de julio de 1997"
13,5,16,282,399,402,801,"6 de julio de 1997"
13,5,16,283,240,234,474,"6 de julio de 1997"
13,5,16,284,183,169,352,"6 de julio de 1997"
13,5,16,285,193,127,320,"6 de julio de 1997"
13,5,16,286,426,365,791,"6 de julio de 1997"
13,5,16,287,200,168,368,"6 de julio de 1997"
13,5,16,288,427,377,804,"6 de julio de 1997"
13,5,16,289,645,595,1240,"6 de julio de 1997"
13,5,16,290,288,241,529,"6 de julio de 1997"
13,5,44,802,901,846,1747,"6 de julio de 1997"
13,5,44,803,621,670,1291,"6 de julio de 1997"
13,5,44,804,310,263,573,"6 de julio de 1997"
13,5,44,805,347,275,622,"6 de julio de 1997"
13,5,44,806,477,424,901,"6 de julio de 1997"
13,5,44,807,613,596,1209,"6 de julio de 1997"
13,5,44,808,282,230,512,"6 de julio de 1997"
13,5,44,809,247,196,443,"6 de julio de 1997"
13,5,44,810,307,275,582,"6 de julio de 1997"
13,5,44,811,248,205,453,"6 de julio de 1997"
13,5,63,1262,422,441,863,"6 de julio de 1997"
13,5,63,1263,669,776,1445,"6 de julio de 1997"
13,5,63,1264,386,426,812,"6 de julio de 1997"
13,5,63,1265,288,319,607,"6 de julio de 1997"
13,5,63,1266,445,464,909,"6 de julio de 1997"
13,5,63,1267,667,717,1384,"6 de julio de 1997"
13,5,63,1268,432,448,880,"6 de julio de 1997"
13,5,63,1269,644,707,1351,"6 de julio de 1997"
13,5,63,1270,513,550,1063,"6 de julio de 1997"
13,5,63,1271,667,739,1406,"6 de julio de 1997"
13,5,63,1272,886,906,1792,"6 de julio de 1997"
13,5,63,1273,559,637,1196,"6 de julio de 1997"
13,5,63,1274,642,665,1307,"6 de julio de 1997"
13,5,63,1275,521,540,1061,"6 de julio de 1997"
13,5,63,1276,713,810,1523,"6 de julio de 1997"
13,5,63,1277,225,242,467,"6 de julio de 1997"
13,5,63,1278,868,827,1695,"6 de julio de 1997"
13,5,63,1279,476,423,899,"6 de julio de 1997"
13,5,63,1280,479,470,949,"6 de julio de 1997"
13,5,63,1281,462,443,905,"6 de julio de 1997"
13,5,63,1282,477,499,976,"6 de julio de 1997"
13,5,63,1283,316,332,648,"6 de julio de 1997"
13,5,63,1284,673,659,1332,"6 de julio de 1997"
13,5,63,1285,205,225,430,"6 de julio de 1997"
13,5,63,1286,336,339,675,"6 de julio de 1997"
13,5,63,1287,726,760,1486,"6 de julio de 1997"
13,5,63,1288,124,120,244,"6 de julio de 1997"
13,5,63,1289,394,386,780,"6 de julio de 1997"
13,5,63,1290,302,278,580,"6 de julio de 1997"
13,5,63,1291,425,420,845,"6 de julio de 1997"
13,5,63,1292,457,425,882,"6 de julio de 1997"
13,5,63,1293,631,564,1195,"6 de julio de 1997"
13,5,63,1294,380,304,684,"6 de julio de 1997"
13,5,64,1295,526,515,1041,"6 de julio de 1997"
13,5,64,1296,302,277,579,"6 de julio de 1997"
13,5,64,1297,69,55,124,"6 de julio de 1997"
13,5,64,1298,90,83,173,"6 de julio de 1997"
13,5,64,1299,397,411,808,"6 de julio de 1997"
13,5,64,1300,265,253,518,"6 de julio de 1997"
13,5,64,1301,502,583,1085,"6 de julio de 1997"
13,5,64,1302,361,377,738,"6 de julio de 1997"
13,5,65,1303,472,415,887,"6 de julio de 1997"
13,5,65,1304,366,406,772,"6 de julio de 1997"
13,5,65,1305,389,377,766,"6 de julio de 1997"
13,5,65,1306,432,427,859,"6 de julio de 1997"
13,5,65,1307,299,318,617,"6 de julio de 1997"
13,5,65,1308,218,226,444,"6 de julio de 1997"
13,5,65,1309,346,330,676,"6 de julio de 1997"
13,5,66,1310,767,710,1477,"6 de julio de 1997"
13,5,66,1311,586,621,1207,"6 de julio de 1997"
13,5,66,1312,278,266,544,"6 de julio de 1997"
13,5,66,1313,594,640,1234,"6 de julio de 1997"
13,5,66,1314,626,609,1235,"6 de julio de 1997"
13,5,66,1315,152,155,307,"6 de julio de 1997"
13,5,66,1316,705,697,1402,"6 de julio de 1997"
13,5,66,1317,671,644,1315,"6 de julio de 1997"
13,5,66,1318,479,434,913,"6 de julio de 1997"
13,5,66,1319,712,714,1426,"6 de julio de 1997"
13,5,66,1320,356,363,719,"6 de julio de 1997"
13,5,66,1321,276,249,525,"6 de julio de 1997"
13,5,66,1322,429,387,816,"6 de julio de 1997"
13,5,66,1323,198,165,363,"6 de julio de 1997"
13,5,66,1324,332,248,580,"6 de julio de 1997"
13,5,66,1325,404,407,811,"6 de julio de 1997"
13,5,66,1326,355,346,701,"6 de julio de 1997"
13,5,66,1327,425,405,830,"6 de julio de 1997"
13,5,66,1328,604,596,1200,"6 de julio de 1997"
13,5,66,1329,350,350,700,"6 de julio de 1997"
13,5,66,1330,119,105,224,"6 de julio de 1997"
13,5,66,1331,158,168,326,"6 de julio de 1997"
13,5,66,1332,377,366,743,"6 de julio de 1997"
13,5,69,1369,388,395,783,"6 de julio de 1997"
13,5,69,1370,423,498,921,"6 de julio de 1997"
13,5,69,1371,165,172,337,"6 de julio de 1997"
13,5,69,1372,213,216,429,"6 de julio de 1997"
13,5,69,1373,452,503,955,"6 de julio de 1997"
13,5,69,1374,599,667,1266,"6 de julio de 1997"
13,5,69,1375,421,423,844,"6 de julio de 1997"
13,5,69,1376,425,477,902,"6 de julio de 1997"
13,5,69,1377,495,447,942,"6 de julio de 1997"
13,5,73,1429,609,649,1258,"6 de julio de 1997"
13,5,73,1430,726,743,1469,"6 de julio de 1997"
13,5,73,1431,507,472,979,"6 de julio de 1997"
13,5,73,1432,460,509,969,"6 de julio de 1997"
13,5,73,1433,462,477,939,"6 de julio de 1997"
13,5,73,1434,547,514,1061,"6 de julio de 1997"
13,5,73,1435,402,391,793,"6 de julio de 1997"
13,5,73,1436,390,367,757,"6 de julio de 1997"
13,5,73,1437,507,500,1007,"6 de julio de 1997"
13,5,73,1438,632,628,1260,"6 de julio de 1997"
13,5,73,1439,320,307,627,"6 de julio de 1997"
13,5,73,1440,257,251,508,"6 de julio de 1997"
13,5,75,1449,511,532,1043,"6 de julio de 1997"
13,5,75,1450,425,414,839,"6 de julio de 1997"
13,5,75,1451,523,547,1070,"6 de julio de 1997"
13,5,75,1452,714,691,1405,"6 de julio de 1997"
13,5,75,1453,761,852,1613,"6 de julio de 1997"
13,5,75,1454,513,578,1091,"6 de julio de 1997"
13,5,75,1455,389,440,829,"6 de julio de 1997"
13,5,75,1456,688,719,1407,"6 de julio de 1997"
13,5,75,1457,763,828,1591,"6 de julio de 1997"
13,5,75,1458,667,751,1418,"6 de julio de 1997"
13,5,75,1459,697,739,1436,"6 de julio de 1997"
13,5,75,1460,680,681,1361,"6 de julio de 1997"
13,5,75,1461,334,334,668,"6 de julio de 1997"
13,5,75,1462,597,617,1214,"6 de julio de 1997"
13,5,75,1463,132,120,252,"6 de julio de 1997"
13,5,75,1464,580,547,1127,"6 de julio de 1997"
13,5,75,1465,58,63,121,"6 de julio de 1997"
13,5,75,1466,609,713,1322,"6 de julio de 1997"
13,5,75,1467,94,81,175,"6 de julio de 1997"
13,5,75,1468,213,195,408,"6 de julio de 1997"
13,5,75,1469,155,159,314,"6 de julio de 1997"
13,5,75,1470,125,119,244,"6 de julio de 1997"
13,5,75,1471,31,29,60,"6 de julio de 1997"
13,5,75,1472,385,345,730,"6 de julio de 1997"
13,5,75,1473,199,206,405,"6 de julio de 1997"
13,5,75,1474,515,537,1052,"6 de julio de 1997"
13,5,75,1475,141,145,286,"6 de julio de 1997"
13,5,75,1476,595,686,1281,"6 de julio de 1997"
13,5,75,1477,493,521,1014,"6 de julio de 1997"
13,5,75,1478,476,496,972,"6 de julio de 1997"
13,5,75,1479,299,347,646,"6 de julio de 1997"
13,5,75,1480,728,790,1518,"6 de julio de 1997"
13,5,75,1481,428,417,845,"6 de julio de 1997"
13,5,75,1482,350,354,704,"6 de julio de 1997"
13,5,75,1483,317,253,570,"6 de julio de 1997"
13,5,75,1484,483,517,1000,"6 de julio de 1997"
13,5,75,1485,601,648,1249,"6 de julio de 1997"
13,5,75,1486,472,503,975,"6 de julio de 1997"
13,5,75,1487,567,664,1231,"6 de julio de 1997"
13,5,75,1488,671,709,1380,"6 de julio de 1997"
13,5,75,1489,297,293,590,"6 de julio de 1997"
13,5,75,1490,153,106,259,"6 de julio de 1997"
13,5,75,1491,392,404,796,"6 de julio de 1997"
13,5,75,1492,728,724,1452,"6 de julio de 1997"
13,5,75,1493,829,839,1668,"6 de julio de 1997"
13,5,75,1494,712,794,1506,"6 de julio de 1997"
13,5,75,1495,521,499,1020,"6 de julio de 1997"
13,5,75,1496,413,438,851,"6 de julio de 1997"
13,5,75,1497,688,739,1427,"6 de julio de 1997"
13,5,75,1498,808,826,1634,"6 de julio de 1997"
13,5,75,1499,232,241,473,"6 de julio de 1997"
13,5,75,1500,396,425,821,"6 de julio de 1997"
13,5,75,1501,45,44,89,"6 de julio de 1997"
13,6,38,700,221,253,474,"6 de julio de 1997"
13,6,38,701,43,37,80,"6 de julio de 1997"
13,6,38,702,108,103,211,"6 de julio de 1997"
13,6,38,703,40,37,77,"6 de julio de 1997"
13,6,38,704,441,417,858,"6 de julio de 1997"
13,6,38,705,40,40,80,"6 de julio de 1997"
13,6,38,706,36,37,73,"6 de julio de 1997"
13,6,38,707,73,70,143,"6 de julio de 1997"
13,6,38,708,166,138,304,"6 de julio de 1997"
13,6,38,709,36,37,73,"6 de julio de 1997"
13,6,38,710,410,400,810,"6 de julio de 1997"
13,6,38,711,88,64,152,"6 de julio de 1997"
13,6,38,712,214,221,435,"6 de julio de 1997"
13,6,39,713,299,324,623,"6 de julio de 1997"
13,6,39,714,381,432,813,"6 de julio de 1997"
13,6,39,715,465,505,970,"6 de julio de 1997"
13,6,39,716,427,482,909,"6 de julio de 1997"
13,6,39,717,348,404,752,"6 de julio de 1997"
13,6,39,718,406,455,861,"6 de julio de 1997"
13,6,39,719,344,363,707,"6 de julio de 1997"
13,6,39,720,576,683,1259,"6 de julio de 1997"
13,6,39,721,151,145,296,"6 de julio de 1997"
13,6,39,722,71,71,142,"6 de julio de 1997"
13,6,39,723,264,264,528,"6 de julio de 1997"
13,6,39,724,72,65,137,"6 de julio de 1997"
13,6,40,725,372,411,783,"6 de julio de 1997"
13,6,40,726,587,596,1183,"6 de julio de 1997"
13,6,40,727,676,683,1359,"6 de julio de 1997"
13,6,40,728,647,682,1329,"6 de julio de 1997"
13,6,40,729,600,670,1270,"6 de julio de 1997"
13,6,40,730,244,263,507,"6 de julio de 1997"
13,6,40,731,411,459,870,"6 de julio de 1997"
13,6,40,732,517,671,1188,"6 de julio de 1997"
13,6,40,733,243,312,555,"6 de julio de 1997"
13,6,40,734,401,458,859,"6 de julio de 1997"
13,6,40,735,297,360,657,"6 de julio de 1997"
13,6,40,736,424,537,961,"6 de julio de 1997"
13,6,40,737,511,551,1062,"6 de julio de 1997"
13,6,40,738,308,330,638,"6 de julio de 1997"
13,6,40,739,389,449,838,"6 de julio de 1997"
13,6,40,740,340,350,690,"6 de julio de 1997"
13,6,40,741,313,291,604,"6 de julio de 1997"
13,6,40,742,575,607,1182,"6 de julio de 1997"
13,6,47,832,399,421,820,"6 de julio de 1997"
13,6,47,833,479,506,985,"6 de julio de 1997"
13,6,47,834,229,257,486,"6 de julio de 1997"
13,6,47,835,318,365,683,"6 de julio de 1997"
13,6,47,836,302,288,590,"6 de julio de 1997"
13,6,47,837,335,354,689,"6 de julio de 1997"
13,6,47,838,135,166,301,"6 de julio de 1997"
13,6,47,839,284,355,639,"6 de julio de 1997"
13,6,47,840,388,465,853,"6 de julio de 1997"
13,6,47,841,285,350,635,"6 de julio de 1997"
13,6,47,842,335,423,758,"6 de julio de 1997"
13,6,47,843,449,505,954,"6 de julio de 1997"
13,6,47,844,415,471,886,"6 de julio de 1997"
13,6,47,845,252,257,509,"6 de julio de 1997"
13,6,47,846,395,443,838,"6 de julio de 1997"
13,6,47,847,440,457,897,"6 de julio de 1997"
13,6,47,848,648,764,1412,"6 de julio de 1997"
13,6,47,849,269,267,536,"6 de julio de 1997"
13,6,47,850,527,594,1121,"6 de julio de 1997"
13,6,47,851,444,571,1015,"6 de julio de 1997"
13,6,47,852,496,580,1076,"6 de julio de 1997"
13,6,47,853,486,550,1036,"6 de julio de 1997"
13,6,47,854,626,751,1377,"6 de julio de 1997"
13,6,47,855,653,817,1470,"6 de julio de 1997"
13,6,47,856,701,817,1518,"6 de julio de 1997"
13,6,47,857,527,596,1123,"6 de julio de 1997"
13,6,47,858,326,388,714,"6 de julio de 1997"
13,6,47,859,315,399,714,"6 de julio de 1997"
13,6,47,860,446,546,992,"6 de julio de 1997"
13,6,47,861,331,391,722,"6 de julio de 1997"
13,6,47,862,332,371,703,"6 de julio de 1997"
13,6,47,863,767,887,1654,"6 de julio de 1997"
13,6,47,864,241,266,507,"6 de julio de 1997"
13,6,47,865,377,443,820,"6 de julio de 1997"
13,6,47,866,382,434,816,"6 de julio de 1997"
13,6,47,867,626,681,1307,"6 de julio de 1997"
13,6,47,868,543,544,1087,"6 de julio de 1997"
13,6,47,869,298,387,685,"6 de julio de 1997"
13,6,47,870,329,404,733,"6 de julio de 1997"
13,6,47,871,471,580,1051,"6 de julio de 1997"
13,6,47,872,314,416,730,"6 de julio de 1997"
13,6,47,873,536,626,1162,"6 de julio de 1997"
13,6,47,874,417,477,894,"6 de julio de 1997"
13,6,47,875,426,474,900,"6 de julio de 1997"
13,6,47,876,599,674,1273,"6 de julio de 1997"
13,6,47,877,375,467,842,"6 de julio de 1997"
13,6,47,878,619,682,1301,"6 de julio de 1997"
13,6,47,879,453,514,967,"6 de julio de 1997"
13,6,47,880,887,1097,1984,"6 de julio de 1997"
13,6,47,881,319,380,699,"6 de julio de 1997"
13,6,47,882,365,447,812,"6 de julio de 1997"
13,6,47,883,280,404,684,"6 de julio de 1997"
13,6,47,884,300,393,693,"6 de julio de 1997"
13,6,47,885,434,558,992,"6 de julio de 1997"
13,6,47,886,279,332,611,"6 de julio de 1997"
13,6,47,887,542,624,1166,"6 de julio de 1997"
13,6,47,888,475,557,1032,"6 de julio de 1997"
13,6,47,889,367,437,804,"6 de julio de 1997"
13,6,47,890,438,512,950,"6 de julio de 1997"
13,6,47,891,397,518,915,"6 de julio de 1997"
13,6,47,892,283,362,645,"6 de julio de 1997"
13,6,47,893,172,223,395,"6 de julio de 1997"
13,6,47,894,347,452,799,"6 de julio de 1997"
13,6,47,895,424,494,918,"6 de julio de 1997"
13,6,47,896,445,563,1008,"6 de julio de 1997"
13,6,47,897,532,631,1163,"6 de julio de 1997"
13,6,47,898,582,619,1201,"6 de julio de 1997"
13,6,47,899,357,393,750,"6 de julio de 1997"
13,6,47,900,452,507,959,"6 de julio de 1997"
13,6,47,901,464,553,1017,"6 de julio de 1997"
13,6,47,902,665,901,1566,"6 de julio de 1997"
13,6,47,903,456,572,1028,"6 de julio de 1997"
13,6,47,904,517,643,1160,"6 de julio de 1997"
13,6,47,905,302,390,692,"6 de julio de 1997"
13,6,47,906,286,347,633,"6 de julio de 1997"
13,6,47,907,355,454,809,"6 de julio de 1997"
13,6,47,908,361,394,755,"6 de julio de 1997"
13,6,47,909,553,689,1242,"6 de julio de 1997"
13,6,47,910,631,711,1342,"6 de julio de 1997"
13,6,47,911,745,902,1647,"6 de julio de 1997"
13,6,47,912,339,411,750,"6 de julio de 1997"
13,6,47,913,469,488,957,"6 de julio de 1997"
13,6,47,914,511,533,1044,"6 de julio de 1997"
13,6,47,915,587,651,1238,"6 de julio de 1997"
13,6,47,916,545,650,1195,"6 de julio de 1997"
13,6,47,917,932,959,1891,"6 de julio de 1997"
13,6,47,918,642,672,1314,"6 de julio de 1997"
13,6,47,919,425,481,906,"6 de julio de 1997"
13,6,47,920,648,711,1359,"6 de julio de 1997"
13,6,47,921,387,474,861,"6 de julio de 1997"
13,6,47,922,535,652,1187,"6 de julio de 1997"
13,6,47,923,554,673,1227,"6 de julio de 1997"
13,6,47,924,435,509,944,"6 de julio de 1997"
13,6,47,925,451,599,1050,"6 de julio de 1997"
13,6,47,926,343,407,750,"6 de julio de 1997"
13,6,47,927,280,307,587,"6 de julio de 1997"
13,6,47,928,819,956,1775,"6 de julio de 1997"
13,6,47,929,483,523,1006,"6 de julio de 1997"
13,6,47,930,501,523,1024,"6 de julio de 1997"
13,6,47,931,417,446,863,"6 de julio de 1997"
13,6,47,932,713,798,1511,"6 de julio de 1997"
13,6,47,933,593,682,1275,"6 de julio de 1997"
13,6,47,934,792,860,1652,"6 de julio de 1997"
13,6,47,935,904,960,1864,"6 de julio de 1997"
13,6,47,936,464,528,992,"6 de julio de 1997"
13,6,47,937,571,572,1143,"6 de julio de 1997"
13,6,47,938,1031,1125,2156,"6 de julio de 1997"
13,6,47,939,838,883,1721,"6 de julio de 1997"
13,6,47,940,619,722,1341,"6 de julio de 1997"
13,6,47,941,941,533,1474,"6 de julio de 1997"
13,6,47,942,495,560,1055,"6 de julio de 1997"
13,6,47,943,566,661,1227,"6 de julio de 1997"
13,6,47,944,241,274,515,"6 de julio de 1997"
13,6,47,945,267,348,615,"6 de julio de 1997"
13,6,47,946,356,425,781,"6 de julio de 1997"
13,6,47,947,320,385,705,"6 de julio de 1997"
13,6,47,948,498,633,1131,"6 de julio de 1997"
13,6,47,949,463,593,1056,"6 de julio de 1997"
13,6,47,950,362,405,767,"6 de julio de 1997"
13,6,47,951,420,547,967,"6 de julio de 1997"
13,6,47,952,630,795,1425,"6 de julio de 1997"
13,6,47,953,299,412,711,"6 de julio de 1997"
13,6,47,954,337,360,697,"6 de julio de 1997"
13,6,47,955,765,821,1586,"6 de julio de 1997"
13,6,47,956,686,757,1443,"6 de julio de 1997"
13,6,47,957,774,738,1512,"6 de julio de 1997"
13,6,47,958,247,246,493,"6 de julio de 1997"
13,6,47,959,452,508,960,"6 de julio de 1997"
13,6,47,960,347,364,711,"6 de julio de 1997"
13,6,47,961,358,452,810,"6 de julio de 1997"
13,6,51,1008,602,633,1235,"6 de julio de 1997"
13,6,51,1009,474,514,988,"6 de julio de 1997"
13,6,51,1010,674,662,1336,"6 de julio de 1997"
13,6,51,1011,556,565,1121,"6 de julio de 1997"
13,6,51,1012,214,183,397,"6 de julio de 1997"
13,6,51,1013,562,589,1151,"6 de julio de 1997"
13,6,51,1014,442,495,937,"6 de julio de 1997"
13,6,51,1015,374,382,756,"6 de julio de 1997"
13,6,51,1016,517,536,1053,"6 de julio de 1997"
13,6,51,1017,191,211,402,"6 de julio de 1997"
13,6,51,1018,85,70,155,"6 de julio de 1997"
13,6,51,1019,131,128,259,"6 de julio de 1997"
13,6,51,1020,495,483,978,"6 de julio de 1997"
13,6,51,1021,382,380,762,"6 de julio de 1997"
13,6,51,1022,207,192,399,"6 de julio de 1997"
13,6,51,1023,150,161,311,"6 de julio de 1997"
13,6,51,1024,144,106,250,"6 de julio de 1997"
13,6,51,1025,151,168,319,"6 de julio de 1997"
13,7,7,114,722,754,1476,"6 de julio de 1997"
13,7,7,115,418,447,865,"6 de julio de 1997"
13,7,7,116,91,92,183,"6 de julio de 1997"
13,7,7,117,119,126,245,"6 de julio de 1997"
13,7,7,118,122,94,216,"6 de julio de 1997"
13,7,7,119,147,150,297,"6 de julio de 1997"
13,7,7,120,68,64,132,"6 de julio de 1997"
13,7,7,121,257,236,493,"6 de julio de 1997"
13,7,7,122,229,244,473,"6 de julio de 1997"
13,7,7,123,127,114,241,"6 de julio de 1997"
13,7,7,124,100,101,201,"6 de julio de 1997"
13,7,7,125,118,131,249,"6 de julio de 1997"
13,7,7,126,224,233,457,"6 de julio de 1997"
13,7,8,127,724,788,1512,"6 de julio de 1997"
13,7,8,128,818,985,1803,"6 de julio de 1997"
13,7,8,129,692,829,1521,"6 de julio de 1997"
13,7,8,130,756,891,1647,"6 de julio de 1997"
13,7,8,131,559,627,1186,"6 de julio de 1997"
13,7,8,132,428,501,929,"6 de julio de 1997"
13,7,8,133,417,523,940,"6 de julio de 1997"
13,7,8,134,833,940,1773,"6 de julio de 1997"
13,7,8,135,577,595,1172,"6 de julio de 1997"
13,7,8,136,687,822,1509,"6 de julio de 1997"
13,7,8,137,523,567,1090,"6 de julio de 1997"
13,7,8,138,336,407,743,"6 de julio de 1997"
13,7,8,139,212,184,396,"6 de julio de 1997"
13,7,8,140,151,112,263,"6 de julio de 1997"
13,7,8,141,125,99,224,"6 de julio de 1997"
13,7,8,142,200,154,354,"6 de julio de 1997"
13,7,8,143,505,537,1042,"6 de julio de 1997"
13,7,8,144,238,224,462,"6 de julio de 1997"
13,7,8,145,356,392,748,"6 de julio de 1997"
13,7,8,146,397,415,812,"6 de julio de 1997"
13,7,8,147,378,415,793,"6 de julio de 1997"
13,7,8,148,428,398,826,"6 de julio de 1997"
13,7,8,149,82,84,166,"6 de julio de 1997"
13,7,8,150,238,253,491,"6 de julio de 1997"
13,7,8,151,287,285,572,"6 de julio de 1997"
13,7,15,257,636,703,1339,"6 de julio de 1997"
13,7,15,258,830,947,1777,"6 de julio de 1997"
13,7,15,259,545,693,1238,"6 de julio de 1997"
13,7,15,260,262,313,575,"6 de julio de 1997"
13,7,15,261,509,578,1087,"6 de julio de 1997"
13,7,15,262,533,616,1149,"6 de julio de 1997"
13,7,15,263,290,386,676,"6 de julio de 1997"
13,7,15,264,695,759,1454,"6 de julio de 1997"
13,7,15,265,729,851,1580,"6 de julio de 1997"
13,7,15,266,302,338,640,"6 de julio de 1997"
13,7,15,267,304,291,595,"6 de julio de 1997"
13,7,15,268,157,163,320,"6 de julio de 1997"
13,7,15,269,778,787,1565,"6 de julio de 1997"
13,7,15,270,423,423,846,"6 de julio de 1997"
13,7,15,271,561,636,1197,"6 de julio de 1997"
13,7,15,272,296,246,542,"6 de julio de 1997"
13,7,15,273,984,910,1894,"6 de julio de 1997"
13,7,15,274,907,979,1886,"6 de julio de 1997"
13,7,15,275,225,225,450,"6 de julio de 1997"
13,7,15,276,252,223,475,"6 de julio de 1997"
13,7,15,277,269,240,509,"6 de julio de 1997"
13,7,15,278,270,240,510,"6 de julio de 1997"
13,7,15,279,216,210,426,"6 de julio de 1997"
13,7,15,280,420,432,852,"6 de julio de 1997"
13,7,21,350,430,487,917,"6 de julio de 1997"
13,7,21,351,483,543,1026,"6 de julio de 1997"
13,7,21,352,455,550,1005,"6 de julio de 1997"
13,7,21,353,587,649,1236,"6 de julio de 1997"
13,7,21,354,546,587,1133,"6 de julio de 1997"
13,7,21,355,495,524,1019,"6 de julio de 1997"
13,7,21,356,334,329,663,"6 de julio de 1997"
13,7,21,357,386,429,815,"6 de julio de 1997"
13,7,22,358,477,480,957,"6 de julio de 1997"
13,7,22,359,378,382,760,"6 de julio de 1997"
13,7,22,360,391,424,815,"6 de julio de 1997"
13,7,22,361,252,228,480,"6 de julio de 1997"
13,7,22,362,105,101,206,"6 de julio de 1997"
13,7,22,363,531,566,1097,"6 de julio de 1997"
13,7,22,364,102,111,213,"6 de julio de 1997"
13,7,22,365,166,172,338,"6 de julio de 1997"
13,7,22,366,51,53,104,"6 de julio de 1997"
13,7,22,367,195,219,414,"6 de julio de 1997"
13,7,22,368,509,516,1025,"6 de julio de 1997"
13,7,57,1121,782,804,1586,"6 de julio de 1997"
13,7,57,1122,437,509,946,"6 de julio de 1997"
13,7,57,1123,529,525,1054,"6 de julio de 1997"
13,7,57,1124,214,203,417,"6 de julio de 1997"
13,7,57,1125,411,376,787,"6 de julio de 1997"
13,7,57,1126,173,144,317,"6 de julio de 1997"
13,7,57,1127,161,134,295,"6 de julio de 1997"
13,7,57,1128,238,214,452,"6 de julio de 1997"
13,7,57,1129,239,231,470,"6 de julio de 1997"
13,7,57,1130,296,255,551,"6 de julio de 1997"
13,7,57,1131,244,236,480,"6 de julio de 1997"
13,7,61,1191,671,730,1401,"6 de julio de 1997"
13,7,61,1192,537,658,1195,"6 de julio de 1997"
13,7,61,1193,614,680,1294,"6 de julio de 1997"
13,7,61,1194,194,237,431,"6 de julio de 1997"
13,7,61,1195,382,447,829,"6 de julio de 1997"
13,7,61,1196,538,581,1119,"6 de julio de 1997"
13,7,61,1197,710,790,1500,"6 de julio de 1997"
13,7,61,1198,299,302,601,"6 de julio de 1997"
13,7,61,1199,431,487,918,"6 de julio de 1997"
13,7,61,1200,108,105,213,"6 de julio de 1997"
13,7,61,1201,170,146,316,"6 de julio de 1997"
13,7,61,1202,229,204,433,"6 de julio de 1997"
13,7,61,1203,40,43,83,"6 de julio de 1997"
13,7,61,1204,183,172,355,"6 de julio de 1997"
13,7,61,1205,299,260,559,"6 de julio de 1997"
13,7,61,1206,216,274,490,"6 de julio de 1997"
13,7,61,1207,186,217,403,"6 de julio de 1997"
13,7,61,1208,272,335,607,"6 de julio de 1997"
13,7,61,1209,455,577,1032,"6 de julio de 1997"
13,7,61,1210,348,434,782,"6 de julio de 1997"
13,7,61,1211,400,456,856,"6 de julio de 1997"
13,7,61,1212,690,825,1515,"6 de julio de 1997"
13,7,61,1213,389,453,842,"6 de julio de 1997"
13,7,61,1214,327,397,724,"6 de julio de 1997"
13,7,61,1215,682,785,1467,"6 de julio de 1997"
13,7,61,1216,348,372,720,"6 de julio de 1997"
13,7,61,1217,560,621,1181,"6 de julio de 1997"
13,7,61,1218,516,576,1092,"6 de julio de 1997"
13,7,61,1219,282,341,623,"6 de julio de 1997"
13,7,61,1220,724,830,1554,"6 de julio de 1997"
13,7,61,1221,546,581,1127,"6 de julio de 1997"
13,7,61,1222,362,435,797,"6 de julio de 1997"
13,7,61,1223,365,437,802,"6 de julio de 1997"
13,7,61,1224,425,461,886,"6 de julio de 1997"
13,7,61,1225,313,355,668,"6 de julio de 1997"
13,7,61,1226,252,269,521,"6 de julio de 1997"
13,7,61,1227,274,259,533,"6 de julio de 1997"
13,7,61,1228,453,529,982,"6 de julio de 1997"
13,7,68,1349,461,471,932,"6 de julio de 1997"
13,7,68,1350,659,735,1394,"6 de julio de 1997"
13,7,68,1351,727,768,1495,"6 de julio de 1997"
13,7,68,1352,784,834,1618,"6 de julio de 1997"
13,7,68,1353,745,684,1429,"6 de julio de 1997"
13,7,68,1354,473,549,1022,"6 de julio de 1997"
13,7,68,1355,613,672,1285,"6 de julio de 1997"
13,7,68,1356,615,664,1279,"6 de julio de 1997"
13,7,68,1357,791,614,1405,"6 de julio de 1997"
13,7,68,1358,558,626,1184,"6 de julio de 1997"
13,7,68,1359,359,398,757,"6 de julio de 1997"
13,7,68,1360,442,477,919,"6 de julio de 1997"
13,7,68,1361,350,425,775,"6 de julio de 1997"
13,7,68,1362,406,492,898,"6 de julio de 1997"
13,7,68,1363,629,621,1250,"6 de julio de 1997"
13,7,68,1364,136,168,304,"6 de julio de 1997"
13,7,68,1365,427,447,874,"6 de julio de 1997"
13,7,68,1366,524,555,1079,"6 de julio de 1997"
13,7,68,1367,909,894,1803,"6 de julio de 1997"
13,7,68,1368,382,393,775,"6 de julio de 1997"
13,7,71,1395,433,484,917,"6 de julio de 1997"
13,7,71,1396,402,454,856,"6 de julio de 1997"
13,7,71,1397,432,495,927,"6 de julio de 1997"
13,7,71,1398,510,557,1067,"6 de julio de 1997"
13,7,71,1399,480,481,961,"6 de julio de 1997"
13,7,71,1400,118,102,220,"6 de julio de 1997"
13,7,71,1401,216,213,429,"6 de julio de 1997"
13,7,71,1402,324,399,723,"6 de julio de 1997"
13,7,74,1441,305,364,669,"6 de julio de 1997"
13,7,74,1442,579,577,1156,"6 de julio de 1997"
13,7,74,1443,261,268,529,"6 de julio de 1997"
13,7,74,1444,525,572,1097,"6 de julio de 1997"
13,7,74,1445,227,216,443,"6 de julio de 1997"
13,7,74,1446,257,287,544,"6 de julio de 1997"
13,7,74,1447,608,702,1310,"6 de julio de 1997"
13,7,74,1448,58,60,118,"6 de julio de 1997"
13,7,77,1556,518,575,1093,"6 de julio de 1997"
13,7,77,1557,376,408,784,"6 de julio de 1997"
13,7,77,1558,342,391,733,"6 de julio de 1997"
13,7,77,1559,353,388,741,"6 de julio de 1997"
13,7,77,1560,293,295,588,"6 de julio de 1997"
13,7,77,1561,593,618,1211,"6 de julio de 1997"
13,7,77,1562,73,90,163,"6 de julio de 1997"
13,7,82,1619,651,677,1328,"6 de julio de 1997"
13,7,82,1620,694,708,1402,"6 de julio de 1997"
13,7,82,1621,648,685,1333,"6 de julio de 1997"
13,7,82,1622,386,390,776,"6 de julio de 1997"
13,7,82,1623,397,457,854,"6 de julio de 1997"
13,7,82,1624,257,279,536,"6 de julio de 1997"
13,7,82,1625,579,589,1168,"6 de julio de 1997"
13,7,82,1626,428,403,831,"6 de julio de 1997"
13,7,83,1627,425,438,863,"6 de julio de 1997"
13,7,83,1628,542,596,1138,"6 de julio de 1997"
13,7,83,1629,688,675,1363,"6 de julio de 1997"
13,7,83,1630,183,207,390,"6 de julio de 1997"
13,7,83,1631,709,732,1441,"6 de julio de 1997"
13,7,83,1632,453,452,905,"6 de julio de 1997"
13,7,83,1633,535,492,1027,"6 de julio de 1997"
13,7,83,1634,232,213,445,"6 de julio de 1997"
13,7,83,1635,461,418,879,"6 de julio de 1997"
13,7,83,1636,228,207,435,"6 de julio de 1997"
13,7,83,1637,751,727,1478,"6 de julio de 1997"
13,7,83,1638,460,382,842,"6 de julio de 1997"
13,7,83,1639,264,240,504,"6 de julio de 1997"
13,7,83,1640,89,102,191,"6 de julio de 1997"
13,7,83,1641,369,360,729,"6 de julio de 1997"
13,7,83,1642,499,550,1049,"6 de julio de 1997"
13,7,83,1643,163,157,320,"6 de julio de 1997"
14,1,3,24,429,453,882,"6 de julio de 1997"
14,1,3,25,459,508,967,"6 de julio de 1997"
14,1,3,26,405,433,838,"6 de julio de 1997"
14,1,3,27,430,443,873,"6 de julio de 1997"
14,1,3,28,431,457,888,"6 de julio de 1997"
14,1,3,29,646,727,1373,"6 de julio de 1997"
14,1,3,30,343,392,735,"6 de julio de 1997"
14,1,3,31,643,677,1320,"6 de julio de 1997"
14,1,3,32,138,125,263,"6 de julio de 1997"
14,1,3,33,448,476,924,"6 de julio de 1997"
14,1,3,34,570,615,1185,"6 de julio de 1997"
14,1,3,35,505,426,931,"6 de julio de 1997"
14,1,5,40,581,613,1194,"6 de julio de 1997"
14,1,5,41,630,663,1293,"6 de julio de 1997"
14,1,5,42,543,606,1149,"6 de julio de 1997"
14,1,5,43,591,594,1185,"6 de julio de 1997"
14,1,5,44,208,177,385,"6 de julio de 1997"
14,1,5,45,205,175,380,"6 de julio de 1997"
14,1,5,46,185,162,347,"6 de julio de 1997"
14,1,5,47,276,273,549,"6 de julio de 1997"
14,1,7,94,591,647,1238,"6 de julio de 1997"
14,1,7,95,441,466,907,"6 de julio de 1997"
14,1,7,96,382,414,796,"6 de julio de 1997"
14,1,7,97,260,255,515,"6 de julio de 1997"
14,1,7,98,204,200,404,"6 de julio de 1997"
14,1,7,99,68,76,144,"6 de julio de 1997"
14,1,7,100,203,196,399,"6 de julio de 1997"
14,1,7,101,277,305,582,"6 de julio de 1997"
14,1,9,139,826,934,1760,"6 de julio de 1997"
14,1,9,140,792,811,1603,"6 de julio de 1997"
14,1,9,141,853,856,1709,"6 de julio de 1997"
14,1,9,142,621,606,1227,"6 de julio de 1997"
14,1,9,143,619,680,1299,"6 de julio de 1997"
14,1,19,292,391,385,776,"6 de julio de 1997"
14,1,19,293,189,172,361,"6 de julio de 1997"
14,1,19,294,613,499,1112,"6 de julio de 1997"
14,1,19,295,200,186,386,"6 de julio de 1997"
14,1,26,411,333,330,663,"6 de julio de 1997"
14,1,26,412,175,171,346,"6 de julio de 1997"
14,1,26,413,384,409,793,"6 de julio de 1997"
14,1,26,414,340,433,773,"6 de julio de 1997"
14,1,26,415,429,457,886,"6 de julio de 1997"
14,1,26,416,359,428,787,"6 de julio de 1997"
14,1,26,417,340,328,668,"6 de julio de 1997"
14,1,26,418,355,415,770,"6 de julio de 1997"
14,1,26,419,457,495,952,"6 de julio de 1997"
14,1,26,420,422,475,897,"6 de julio de 1997"
14,1,26,421,139,161,300,"6 de julio de 1997"
14,1,26,422,36,39,75,"6 de julio de 1997"
14,1,26,423,81,107,188,"6 de julio de 1997"
14,1,26,424,116,121,237,"6 de julio de 1997"
14,1,26,425,380,454,834,"6 de julio de 1997"
14,1,26,426,163,217,380,"6 de julio de 1997"
14,1,32,476,370,349,719,"6 de julio de 1997"
14,1,32,477,319,323,642,"6 de julio de 1997"
14,1,32,478,127,127,254,"6 de julio de 1997"
14,1,37,530,505,541,1046,"6 de julio de 1997"
14,1,37,531,587,636,1223,"6 de julio de 1997"
14,1,37,532,627,706,1333,"6 de julio de 1997"
14,1,37,533,491,492,983,"6 de julio de 1997"
14,1,37,534,287,328,615,"6 de julio de 1997"
14,1,37,535,405,510,915,"6 de julio de 1997"
14,1,37,536,463,518,981,"6 de julio de 1997"
14,1,37,537,242,253,495,"6 de julio de 1997"
14,1,37,538,342,378,720,"6 de julio de 1997"
14,1,37,539,472,430,902,"6 de julio de 1997"
14,1,37,540,103,90,193,"6 de julio de 1997"
14,1,42,1549,324,306,630,"6 de julio de 1997"
14,1,42,1550,150,137,287,"6 de julio de 1997"
14,1,42,1551,143,156,299,"6 de julio de 1997"
14,1,42,1552,310,300,610,"6 de julio de 1997"
14,1,42,1553,511,465,976,"6 de julio de 1997"
14,1,42,1554,161,193,354,"6 de julio de 1997"
14,1,42,1555,37,36,73,"6 de julio de 1997"
14,1,42,1556,76,54,130,"6 de julio de 1997"
14,1,42,1557,84,78,162,"6 de julio de 1997"
14,1,42,1558,266,202,468,"6 de julio de 1997"
14,1,42,1559,112,83,195,"6 de julio de 1997"
14,1,42,1560,298,253,551,"6 de julio de 1997"
14,1,43,1561,308,368,676,"6 de julio de 1997"
14,1,43,1562,479,570,1049,"6 de julio de 1997"
14,1,43,1563,329,400,729,"6 de julio de 1997"
14,1,43,1564,344,432,776,"6 de julio de 1997"
14,1,43,1565,357,456,813,"6 de julio de 1997"
14,1,44,1566,394,506,900,"6 de julio de 1997"
14,1,44,1567,489,601,1090,"6 de julio de 1997"
14,1,44,1568,421,483,904,"6 de julio de 1997"
14,1,44,1569,283,363,646,"6 de julio de 1997"
14,1,44,1570,107,137,244,"6 de julio de 1997"
14,1,44,1571,86,109,195,"6 de julio de 1997"
14,1,44,1572,324,329,653,"6 de julio de 1997"
14,1,57,1782,534,575,1109,"6 de julio de 1997"
14,1,57,1783,654,689,1343,"6 de julio de 1997"
14,1,57,1784,769,849,1618,"6 de julio de 1997"
14,1,57,1785,446,505,951,"6 de julio de 1997"
14,1,57,1786,433,510,943,"6 de julio de 1997"
14,1,57,1787,481,525,1006,"6 de julio de 1997"
14,1,57,1788,326,347,673,"6 de julio de 1997"
14,1,57,1789,329,339,668,"6 de julio de 1997"
14,1,57,1790,276,271,547,"6 de julio de 1997"
14,1,57,1791,451,458,909,"6 de julio de 1997"
14,1,63,1831,471,512,983,"6 de julio de 1997"
14,1,63,1832,240,297,537,"6 de julio de 1997"
14,1,63,1833,106,122,228,"6 de julio de 1997"
14,1,63,1834,205,188,393,"6 de julio de 1997"
14,1,63,1835,153,175,328,"6 de julio de 1997"
14,1,63,1836,25,21,46,"6 de julio de 1997"
14,1,63,1837,591,330,921,"6 de julio de 1997"
14,1,63,1838,488,270,758,"6 de julio de 1997"
14,1,63,1839,739,489,1228,"6 de julio de 1997"
14,1,77,2107,446,446,892,"6 de julio de 1997"
14,1,77,2108,482,505,987,"6 de julio de 1997"
14,1,77,2109,23,12,35,"6 de julio de 1997"
14,1,78,2110,271,279,550,"6 de julio de 1997"
14,1,78,2111,348,340,688,"6 de julio de 1997"
14,1,78,2112,143,140,283,"6 de julio de 1997"
14,1,78,2113,77,87,164,"6 de julio de 1997"
14,1,78,2114,48,45,93,"6 de julio de 1997"
14,1,82,2157,160,203,363,"6 de julio de 1997"
14,1,82,2158,318,370,688,"6 de julio de 1997"
14,1,82,2159,169,183,352,"6 de julio de 1997"
14,1,82,2160,425,484,909,"6 de julio de 1997"
14,1,82,2161,202,216,418,"6 de julio de 1997"
14,1,84,2181,471,502,973,"6 de julio de 1997"
14,1,84,2182,690,806,1496,"6 de julio de 1997"
14,1,84,2183,308,348,656,"6 de julio de 1997"
14,1,84,2184,465,527,992,"6 de julio de 1997"
14,1,84,2185,410,489,899,"6 de julio de 1997"
14,1,84,2186,493,530,1023,"6 de julio de 1997"
14,1,84,2187,339,413,752,"6 de julio de 1997"
14,1,84,2188,508,518,1026,"6 de julio de 1997"
14,1,84,2189,460,500,960,"6 de julio de 1997"
14,1,84,2190,444,507,951,"6 de julio de 1997"
14,1,84,2191,544,567,1111,"6 de julio de 1997"
14,1,84,2192,322,389,711,"6 de julio de 1997"
14,1,84,2193,554,679,1233,"6 de julio de 1997"
14,1,84,2194,424,421,845,"6 de julio de 1997"
14,1,84,2195,346,444,790,"6 de julio de 1997"
14,1,84,2196,382,416,798,"6 de julio de 1997"
14,1,84,2197,352,393,745,"6 de julio de 1997"
14,1,84,2198,704,743,1447,"6 de julio de 1997"
14,1,84,2199,400,396,796,"6 de julio de 1997"
14,1,84,2200,307,285,592,"6 de julio de 1997"
14,1,84,2201,399,424,823,"6 de julio de 1997"
14,1,84,2202,224,240,464,"6 de julio de 1997"
14,1,84,2203,135,140,275,"6 de julio de 1997"
14,1,84,2204,416,456,872,"6 de julio de 1997"
14,1,84,2205,477,506,983,"6 de julio de 1997"
14,1,84,2206,586,619,1205,"6 de julio de 1997"
14,1,84,2207,470,443,913,"6 de julio de 1997"
14,1,84,2208,467,478,945,"6 de julio de 1997"
14,1,84,2209,293,340,633,"6 de julio de 1997"
14,1,84,2210,953,1068,2021,"6 de julio de 1997"
14,1,84,2211,126,143,269,"6 de julio de 1997"
14,1,95,2396,498,477,975,"6 de julio de 1997"
14,1,95,2397,347,369,716,"6 de julio de 1997"
14,1,95,2398,397,449,846,"6 de julio de 1997"
14,1,95,2399,327,386,713,"6 de julio de 1997"
14,1,95,2400,632,667,1299,"6 de julio de 1997"
14,1,95,2401,474,571,1045,"6 de julio de 1997"
14,1,95,2402,422,477,899,"6 de julio de 1997"
14,1,95,2403,390,448,838,"6 de julio de 1997"
14,1,95,2404,523,613,1136,"6 de julio de 1997"
14,1,95,2405,617,641,1258,"6 de julio de 1997"
14,1,95,2406,527,576,1103,"6 de julio de 1997"
14,1,95,2407,606,643,1249,"6 de julio de 1997"
14,1,95,2408,365,388,753,"6 de julio de 1997"
14,1,95,2409,159,136,295,"6 de julio de 1997"
14,1,95,2410,78,63,141,"6 de julio de 1997"
14,1,95,2411,53,53,106,"6 de julio de 1997"
14,1,95,2412,339,323,662,"6 de julio de 1997"
14,1,95,2413,461,391,852,"6 de julio de 1997"
14,1,95,2414,174,125,299,"6 de julio de 1997"
14,1,95,2415,301,273,574,"6 de julio de 1997"
14,1,95,2416,186,192,378,"6 de julio de 1997"
14,1,95,2417,270,242,512,"6 de julio de 1997"
14,1,96,2418,634,730,1364,"6 de julio de 1997"
14,1,96,2419,458,529,987,"6 de julio de 1997"
14,1,96,2420,220,234,454,"6 de julio de 1997"
14,1,96,2421,174,183,357,"6 de julio de 1997"
14,1,96,2422,478,548,1026,"6 de julio de 1997"
14,1,96,2423,471,510,981,"6 de julio de 1997"
14,1,105,2742,370,503,873,"6 de julio de 1997"
14,1,105,2743,345,419,764,"6 de julio de 1997"
14,1,105,2744,155,195,350,"6 de julio de 1997"
14,1,105,2745,82,119,201,"6 de julio de 1997"
14,1,105,2746,149,176,325,"6 de julio de 1997"
14,1,105,2747,475,529,1004,"6 de julio de 1997"
14,1,115,2839,327,351,678,"6 de julio de 1997"
14,1,115,2840,310,372,682,"6 de julio de 1997"
14,1,115,2841,276,342,618,"6 de julio de 1997"
14,1,115,2842,293,309,602,"6 de julio de 1997"
14,1,115,2843,133,140,273,"6 de julio de 1997"
14,1,115,2844,153,143,296,"6 de julio de 1997"
14,1,115,2845,50,31,81,"6 de julio de 1997"
14,1,115,2846,68,48,116,"6 de julio de 1997"
14,2,36,501,500,635,1135,"6 de julio de 1997"
14,2,36,502,439,576,1015,"6 de julio de 1997"
14,2,36,503,510,655,1165,"6 de julio de 1997"
14,2,36,504,485,568,1053,"6 de julio de 1997"
14,2,36,505,655,827,1482,"6 de julio de 1997"
14,2,36,506,584,812,1396,"6 de julio de 1997"
14,2,36,507,381,494,875,"6 de julio de 1997"
14,2,36,508,236,285,521,"6 de julio de 1997"
14,2,36,509,626,767,1393,"6 de julio de 1997"
14,2,36,510,394,475,869,"6 de julio de 1997"
14,2,36,511,268,267,535,"6 de julio de 1997"
14,2,36,512,545,503,1048,"6 de julio de 1997"
14,2,36,513,120,105,225,"6 de julio de 1997"
14,2,36,514,86,78,164,"6 de julio de 1997"
14,2,36,515,758,844,1602,"6 de julio de 1997"
14,2,36,516,30,24,54,"6 de julio de 1997"
14,2,36,517,41,31,72,"6 de julio de 1997"
14,2,36,518,161,184,345,"6 de julio de 1997"
14,2,36,519,142,143,285,"6 de julio de 1997"
14,2,36,520,633,739,1372,"6 de julio de 1997"
14,2,36,521,495,575,1070,"6 de julio de 1997"
14,2,36,522,107,75,182,"6 de julio de 1997"
14,2,36,523,92,83,175,"6 de julio de 1997"
14,2,36,524,60,63,123,"6 de julio de 1997"
14,2,36,525,593,683,1276,"6 de julio de 1997"
14,2,36,526,408,605,1013,"6 de julio de 1997"
14,2,36,527,464,580,1044,"6 de julio de 1997"
14,2,36,528,97,98,195,"6 de julio de 1997"
14,2,36,529,63,78,141,"6 de julio de 1997"
14,2,55,1702,925,1028,1953,"6 de julio de 1997"
14,2,55,1703,488,546,1034,"6 de julio de 1997"
14,2,55,1704,635,690,1325,"6 de julio de 1997"
14,2,55,1705,376,435,811,"6 de julio de 1997"
14,2,55,1706,790,841,1631,"6 de julio de 1997"
14,2,55,1707,820,971,1791,"6 de julio de 1997"
14,2,55,1708,905,1007,1912,"6 de julio de 1997"
14,2,55,1709,719,773,1492,"6 de julio de 1997"
14,2,55,1710,556,658,1214,"6 de julio de 1997"
14,2,55,1711,1049,1178,2227,"6 de julio de 1997"
14,2,55,1712,416,467,883,"6 de julio de 1997"
14,2,55,1713,662,689,1351,"6 de julio de 1997"
14,2,55,1714,740,825,1565,"6 de julio de 1997"
14,2,55,1715,859,904,1763,"6 de julio de 1997"
14,2,55,1716,198,203,401,"6 de julio de 1997"
14,2,55,1717,328,385,713,"6 de julio de 1997"
14,2,55,1718,180,229,409,"6 de julio de 1997"
14,2,55,1719,594,713,1307,"6 de julio de 1997"
14,2,55,1720,264,313,577,"6 de julio de 1997"
14,2,55,1721,416,455,871,"6 de julio de 1997"
14,2,55,1722,422,517,939,"6 de julio de 1997"
14,2,55,1723,389,486,875,"6 de julio de 1997"
14,2,55,1724,288,414,702,"6 de julio de 1997"
14,2,55,1725,112,125,237,"6 de julio de 1997"
14,2,55,1726,323,379,702,"6 de julio de 1997"
14,2,55,1727,60,56,116,"6 de julio de 1997"
14,2,55,1728,217,270,487,"6 de julio de 1997"
14,2,55,1729,787,948,1735,"6 de julio de 1997"
14,2,55,1730,540,639,1179,"6 de julio de 1997"
14,2,55,1731,705,814,1519,"6 de julio de 1997"
14,2,55,1732,389,448,837,"6 de julio de 1997"
14,2,55,1733,497,663,1160,"6 de julio de 1997"
14,2,55,1734,585,661,1246,"6 de julio de 1997"
14,2,55,1735,771,802,1573,"6 de julio de 1997"
14,2,55,1736,478,535,1013,"6 de julio de 1997"
14,2,55,1737,176,174,350,"6 de julio de 1997"
14,2,55,1738,314,412,726,"6 de julio de 1997"
14,2,55,1739,348,435,783,"6 de julio de 1997"
14,2,55,1740,270,273,543,"6 de julio de 1997"
14,2,55,1741,201,242,443,"6 de julio de 1997"
14,2,55,1742,201,191,392,"6 de julio de 1997"
14,2,55,1743,372,351,723,"6 de julio de 1997"
14,2,55,1744,407,403,810,"6 de julio de 1997"
14,2,55,1745,190,186,376,"6 de julio de 1997"
14,2,55,1746,141,148,289,"6 de julio de 1997"
14,2,55,1747,325,320,645,"6 de julio de 1997"
14,2,55,1748,668,682,1350,"6 de julio de 1997"
14,2,55,1749,817,855,1672,"6 de julio de 1997"
14,2,55,1750,89,97,186,"6 de julio de 1997"
14,2,55,1751,74,91,165,"6 de julio de 1997"
14,2,55,1752,119,109,228,"6 de julio de 1997"
14,2,55,1753,108,114,222,"6 de julio de 1997"
14,2,55,1754,581,635,1216,"6 de julio de 1997"
14,2,55,1755,148,149,297,"6 de julio de 1997"
14,2,55,1756,43,39,82,"6 de julio de 1997"
14,2,55,1757,397,367,764,"6 de julio de 1997"
14,2,55,1758,55,58,113,"6 de julio de 1997"
14,2,55,1759,243,188,431,"6 de julio de 1997"
14,2,55,1760,418,427,845,"6 de julio de 1997"
14,2,55,1761,265,234,499,"6 de julio de 1997"
14,2,55,1762,218,239,457,"6 de julio de 1997"
14,2,55,1763,1026,1083,2109,"6 de julio de 1997"
14,2,55,1764,149,149,298,"6 de julio de 1997"
14,2,55,1765,194,189,383,"6 de julio de 1997"
14,2,55,1766,100,92,192,"6 de julio de 1997"
14,2,55,1767,437,486,923,"6 de julio de 1997"
14,2,55,1768,235,248,483,"6 de julio de 1997"
14,2,55,1769,212,255,467,"6 de julio de 1997"
14,2,55,1770,92,91,183,"6 de julio de 1997"
14,2,55,1771,854,898,1752,"6 de julio de 1997"
14,2,55,1772,475,448,923,"6 de julio de 1997"
14,2,55,1773,227,204,431,"6 de julio de 1997"
14,2,55,1774,153,115,268,"6 de julio de 1997"
14,2,55,1775,48,48,96,"6 de julio de 1997"
14,2,66,1886,564,639,1203,"6 de julio de 1997"
14,2,66,1887,363,399,762,"6 de julio de 1997"
14,2,66,1888,490,549,1039,"6 de julio de 1997"
14,2,66,1889,601,668,1269,"6 de julio de 1997"
14,2,66,1890,341,340,681,"6 de julio de 1997"
14,2,66,1891,206,201,407,"6 de julio de 1997"
14,2,66,1892,594,636,1230,"6 de julio de 1997"
14,2,66,1893,166,173,339,"6 de julio de 1997"
14,2,66,1894,232,239,471,"6 de julio de 1997"
14,2,66,1895,373,396,769,"6 de julio de 1997"
14,2,66,1896,616,578,1194,"6 de julio de 1997"
14,2,66,1897,335,334,669,"6 de julio de 1997"
14,2,66,1898,148,139,287,"6 de julio de 1997"
14,2,66,1899,294,303,597,"6 de julio de 1997"
14,2,66,1900,307,345,652,"6 de julio de 1997"
14,2,74,2055,497,547,1044,"6 de julio de 1997"
14,2,74,2056,491,561,1052,"6 de julio de 1997"
14,2,74,2057,133,165,298,"6 de julio de 1997"
14,2,74,2058,133,109,242,"6 de julio de 1997"
14,2,74,2059,50,46,96,"6 de julio de 1997"
14,2,74,2060,62,62,124,"6 de julio de 1997"
14,2,74,2061,75,94,169,"6 de julio de 1997"
14,2,74,2062,88,85,173,"6 de julio de 1997"
14,2,75,2063,864,967,1831,"6 de julio de 1997"
14,2,75,2064,649,741,1390,"6 de julio de 1997"
14,2,75,2065,574,642,1216,"6 de julio de 1997"
14,2,75,2066,637,775,1412,"6 de julio de 1997"
14,2,75,2067,613,590,1203,"6 de julio de 1997"
14,2,75,2068,669,752,1421,"6 de julio de 1997"
14,2,75,2069,549,644,1193,"6 de julio de 1997"
14,2,75,2070,280,321,601,"6 de julio de 1997"
14,2,75,2071,204,224,428,"6 de julio de 1997"
14,2,75,2072,291,334,625,"6 de julio de 1997"
14,2,75,2073,405,460,865,"6 de julio de 1997"
14,2,75,2074,527,612,1139,"6 de julio de 1997"
14,2,75,2075,335,419,754,"6 de julio de 1997"
14,2,75,2076,532,536,1068,"6 de julio de 1997"
14,2,75,2077,458,607,1065,"6 de julio de 1997"
14,2,75,2078,573,650,1223,"6 de julio de 1997"
14,2,75,2079,547,578,1125,"6 de julio de 1997"
14,2,75,2080,121,180,301,"6 de julio de 1997"
14,2,75,2081,460,552,1012,"6 de julio de 1997"
14,2,75,2082,295,365,660,"6 de julio de 1997"
14,2,75,2083,254,273,527,"6 de julio de 1997"
14,2,75,2084,506,567,1073,"6 de julio de 1997"
14,2,75,2085,161,182,343,"6 de julio de 1997"
14,2,75,2086,203,196,399,"6 de julio de 1997"
14,2,75,2087,151,188,339,"6 de julio de 1997"
14,2,75,2088,141,174,315,"6 de julio de 1997"
14,2,75,2089,136,158,294,"6 de julio de 1997"
14,2,75,2090,115,143,258,"6 de julio de 1997"
14,2,75,2091,120,152,272,"6 de julio de 1997"
14,2,75,2092,190,199,389,"6 de julio de 1997"
14,2,75,2093,474,532,1006,"6 de julio de 1997"
14,2,75,2094,474,526,1000,"6 de julio de 1997"
14,2,75,2095,76,87,163,"6 de julio de 1997"
14,2,75,2096,103,115,218,"6 de julio de 1997"
14,2,76,2097,128,190,318,"6 de julio de 1997"
14,2,76,2098,592,811,1403,"6 de julio de 1997"
14,2,76,2099,524,744,1268,"6 de julio de 1997"
14,2,76,2100,357,491,848,"6 de julio de 1997"
14,2,76,2101,417,595,1012,"6 de julio de 1997"
14,2,76,2102,431,583,1014,"6 de julio de 1997"
14,2,76,2103,310,380,690,"6 de julio de 1997"
14,2,76,2104,111,128,239,"6 de julio de 1997"
14,2,76,2105,133,177,310,"6 de julio de 1997"
14,2,76,2106,54,97,151,"6 de julio de 1997"
14,2,92,2307,595,788,1383,"6 de julio de 1997"
14,2,92,2308,719,873,1592,"6 de julio de 1997"
14,2,92,2309,327,433,760,"6 de julio de 1997"
14,2,92,2310,287,353,640,"6 de julio de 1997"
14,2,92,2311,356,456,812,"6 de julio de 1997"
14,2,92,2312,134,183,317,"6 de julio de 1997"
14,2,92,2313,467,589,1056,"6 de julio de 1997"
14,2,92,2314,137,190,327,"6 de julio de 1997"
14,2,92,2315,367,488,855,"6 de julio de 1997"
14,2,92,2316,372,542,914,"6 de julio de 1997"
14,2,92,2317,290,415,705,"6 de julio de 1997"
14,2,92,2318,783,1029,1812,"6 de julio de 1997"
14,2,92,2319,611,688,1299,"6 de julio de 1997"
14,2,92,2320,493,560,1053,"6 de julio de 1997"
14,2,92,2321,199,295,494,"6 de julio de 1997"
14,2,92,2322,327,437,764,"6 de julio de 1997"
14,2,92,2323,327,438,765,"6 de julio de 1997"
14,2,92,2324,380,439,819,"6 de julio de 1997"
14,2,92,2325,217,213,430,"6 de julio de 1997"
14,2,92,2326,285,382,667,"6 de julio de 1997"
14,2,92,2327,177,221,398,"6 de julio de 1997"
14,2,92,2328,242,246,488,"6 de julio de 1997"
14,2,92,2329,99,122,221,"6 de julio de 1997"
14,2,110,2794,644,759,1403,"6 de julio de 1997"
14,2,110,2795,275,338,613,"6 de julio de 1997"
14,2,110,2796,532,670,1202,"6 de julio de 1997"
14,2,110,2797,382,601,983,"6 de julio de 1997"
14,2,110,2798,258,297,555,"6 de julio de 1997"
14,2,110,2799,151,139,290,"6 de julio de 1997"
14,2,110,2800,513,526,1039,"6 de julio de 1997"
14,2,110,2801,235,267,502,"6 de julio de 1997"
14,2,110,2802,78,94,172,"6 de julio de 1997"
14,2,110,2803,413,482,895,"6 de julio de 1997"
14,2,116,2847,520,675,1195,"6 de julio de 1997"
14,2,116,2848,538,621,1159,"6 de julio de 1997"
14,2,116,2849,442,548,990,"6 de julio de 1997"
14,2,116,2850,321,462,783,"6 de julio de 1997"
14,2,116,2851,347,424,771,"6 de julio de 1997"
14,2,116,2852,154,200,354,"6 de julio de 1997"
14,2,116,2853,180,211,391,"6 de julio de 1997"
14,2,116,2854,572,757,1329,"6 de julio de 1997"
14,3,1,1,284,367,651,"6 de julio de 1997"
14,3,1,2,370,432,802,"6 de julio de 1997"
14,3,1,3,681,854,1535,"6 de julio de 1997"
14,3,1,4,519,597,1116,"6 de julio de 1997"
14,3,1,5,675,726,1401,"6 de julio de 1997"
14,3,1,6,438,486,924,"6 de julio de 1997"
14,3,1,7,190,201,391,"6 de julio de 1997"
14,3,1,8,104,102,206,"6 de julio de 1997"
14,3,1,9,38,38,76,"6 de julio de 1997"
14,3,1,10,668,741,1409,"6 de julio de 1997"
14,3,1,11,325,340,665,"6 de julio de 1997"
14,3,1,12,286,270,556,"6 de julio de 1997"
14,3,8,102,460,502,962,"6 de julio de 1997"
14,3,8,103,718,711,1429,"6 de julio de 1997"
14,3,8,104,356,465,821,"6 de julio de 1997"
14,3,8,105,608,800,1408,"6 de julio de 1997"
14,3,8,106,628,774,1402,"6 de julio de 1997"
14,3,8,107,726,820,1546,"6 de julio de 1997"
14,3,8,108,624,765,1389,"6 de julio de 1997"
14,3,8,109,455,525,980,"6 de julio de 1997"
14,3,8,110,545,609,1154,"6 de julio de 1997"
14,3,8,111,537,643,1180,"6 de julio de 1997"
14,3,8,112,701,815,1516,"6 de julio de 1997"
14,3,8,113,621,791,1412,"6 de julio de 1997"
14,3,8,114,622,696,1318,"6 de julio de 1997"
14,3,8,115,596,731,1327,"6 de julio de 1997"
14,3,8,116,639,741,1380,"6 de julio de 1997"
14,3,8,117,606,678,1284,"6 de julio de 1997"
14,3,8,118,329,424,753,"6 de julio de 1997"
14,3,8,119,387,491,878,"6 de julio de 1997"
14,3,8,120,397,489,886,"6 de julio de 1997"
14,3,8,121,365,436,801,"6 de julio de 1997"
14,3,8,122,745,929,1674,"6 de julio de 1997"
14,3,8,123,681,879,1560,"6 de julio de 1997"
14,3,8,124,284,337,621,"6 de julio de 1997"
14,3,8,125,224,257,481,"6 de julio de 1997"
14,3,8,126,134,141,275,"6 de julio de 1997"
14,3,8,127,475,558,1033,"6 de julio de 1997"
14,3,8,128,132,140,272,"6 de julio de 1997"
14,3,8,129,59,63,122,"6 de julio de 1997"
14,3,8,130,83,69,152,"6 de julio de 1997"
14,3,8,131,144,146,290,"6 de julio de 1997"
14,3,8,132,347,336,683,"6 de julio de 1997"
14,3,8,133,326,262,588,"6 de julio de 1997"
14,3,8,134,338,381,719,"6 de julio de 1997"
14,3,8,135,177,214,391,"6 de julio de 1997"
14,3,8,136,527,561,1088,"6 de julio de 1997"
14,3,8,137,389,441,830,"6 de julio de 1997"
14,3,8,138,314,346,660,"6 de julio de 1997"
14,3,48,1613,369,442,811,"6 de julio de 1997"
14,3,48,1614,528,619,1147,"6 de julio de 1997"
14,3,48,1615,483,582,1065,"6 de julio de 1997"
14,3,48,1616,402,480,882,"6 de julio de 1997"
14,3,48,1617,382,507,889,"6 de julio de 1997"
14,3,48,1618,321,355,676,"6 de julio de 1997"
14,3,48,1619,419,510,929,"6 de julio de 1997"
14,3,48,1620,605,770,1375,"6 de julio de 1997"
14,3,48,1621,366,442,808,"6 de julio de 1997"
14,3,48,1622,448,542,990,"6 de julio de 1997"
14,3,48,1623,285,325,610,"6 de julio de 1997"
14,3,48,1624,483,590,1073,"6 de julio de 1997"
14,3,48,1625,70,101,171,"6 de julio de 1997"
14,3,48,1626,287,378,665,"6 de julio de 1997"
14,3,48,1627,40,26,66,"6 de julio de 1997"
14,3,48,1628,161,154,315,"6 de julio de 1997"
14,3,48,1629,102,122,224,"6 de julio de 1997"
14,3,48,1630,77,95,172,"6 de julio de 1997"
14,3,48,1631,181,166,347,"6 de julio de 1997"
14,3,48,1632,72,74,146,"6 de julio de 1997"
14,3,48,1633,226,283,509,"6 de julio de 1997"
14,3,48,1634,90,68,158,"6 de julio de 1997"
14,3,50,1647,396,475,871,"6 de julio de 1997"
14,3,50,1648,382,431,813,"6 de julio de 1997"
14,3,50,1649,427,528,955,"6 de julio de 1997"
14,3,50,1650,479,622,1101,"6 de julio de 1997"
14,3,50,1651,673,771,1444,"6 de julio de 1997"
14,3,50,1652,128,131,259,"6 de julio de 1997"
14,3,50,1653,294,318,612,"6 de julio de 1997"
14,3,50,1654,323,364,687,"6 de julio de 1997"
14,3,50,1655,549,731,1280,"6 de julio de 1997"
14,3,50,1656,205,205,410,"6 de julio de 1997"
14,3,50,1657,251,310,561,"6 de julio de 1997"
14,3,50,1658,437,516,953,"6 de julio de 1997"
14,3,50,1659,143,233,376,"6 de julio de 1997"
14,3,50,1660,206,300,506,"6 de julio de 1997"
14,3,62,1824,395,569,964,"6 de julio de 1997"
14,3,62,1825,214,294,508,"6 de julio de 1997"
14,3,62,1826,136,173,309,"6 de julio de 1997"
14,3,62,1827,180,256,436,"6 de julio de 1997"
14,3,62,1828,250,328,578,"6 de julio de 1997"
14,3,62,1829,209,304,513,"6 de julio de 1997"
14,3,62,1830,70,80,150,"6 de julio de 1997"
14,3,80,2132,350,415,765,"6 de julio de 1997"
14,3,80,2133,700,880,1580,"6 de julio de 1997"
14,3,80,2134,524,701,1225,"6 de julio de 1997"
14,3,80,2135,472,614,1086,"6 de julio de 1997"
14,3,80,2136,720,944,1664,"6 de julio de 1997"
14,3,80,2137,459,569,1028,"6 de julio de 1997"
14,3,80,2138,548,680,1228,"6 de julio de 1997"
14,3,80,2139,442,641,1083,"6 de julio de 1997"
14,3,80,2140,653,852,1505,"6 de julio de 1997"
14,3,80,2141,68,59,127,"6 de julio de 1997"
14,3,80,2142,294,365,659,"6 de julio de 1997"
14,3,80,2143,32,40,72,"6 de julio de 1997"
14,3,80,2144,170,195,365,"6 de julio de 1997"
14,3,80,2145,96,99,195,"6 de julio de 1997"
14,3,80,2146,91,80,171,"6 de julio de 1997"
14,3,80,2147,200,229,429,"6 de julio de 1997"
14,3,80,2148,56,45,101,"6 de julio de 1997"
14,3,80,2149,269,362,631,"6 de julio de 1997"
14,3,94,2340,702,742,1444,"6 de julio de 1997"
14,3,94,2341,589,680,1269,"6 de julio de 1997"
14,3,94,2342,750,907,1657,"6 de julio de 1997"
14,3,94,2343,662,731,1393,"6 de julio de 1997"
14,3,94,2344,606,727,1333,"6 de julio de 1997"
14,3,94,2345,608,808,1416,"6 de julio de 1997"
14,3,94,2346,840,931,1771,"6 de julio de 1997"
14,3,94,2347,735,805,1540,"6 de julio de 1997"
14,3,94,2348,790,975,1765,"6 de julio de 1997"
14,3,94,2349,463,561,1024,"6 de julio de 1997"
14,3,94,2350,586,708,1294,"6 de julio de 1997"
14,3,94,2351,535,647,1182,"6 de julio de 1997"
14,3,94,2352,762,859,1621,"6 de julio de 1997"
14,3,94,2353,568,613,1181,"6 de julio de 1997"
14,3,94,2354,915,1068,1983,"6 de julio de 1997"
14,3,94,2355,611,735,1346,"6 de julio de 1997"
14,3,94,2356,508,614,1122,"6 de julio de 1997"
14,3,94,2357,810,1016,1826,"6 de julio de 1997"
14,3,94,2358,643,812,1455,"6 de julio de 1997"
14,3,94,2359,714,918,1632,"6 de julio de 1997"
14,3,94,2360,939,1034,1973,"6 de julio de 1997"
14,3,94,2361,1019,1012,2031,"6 de julio de 1997"
14,3,94,2362,711,832,1543,"6 de julio de 1997"
14,3,94,2363,545,690,1235,"6 de julio de 1997"
14,3,94,2364,824,996,1820,"6 de julio de 1997"
14,3,94,2365,459,588,1047,"6 de julio de 1997"
14,3,94,2366,458,599,1057,"6 de julio de 1997"
14,3,94,2367,365,467,832,"6 de julio de 1997"
14,3,94,2368,190,259,449,"6 de julio de 1997"
14,3,94,2369,499,649,1148,"6 de julio de 1997"
14,3,94,2370,516,648,1164,"6 de julio de 1997"
14,3,94,2371,829,1023,1852,"6 de julio de 1997"
14,3,94,2372,643,764,1407,"6 de julio de 1997"
14,3,94,2373,334,533,867,"6 de julio de 1997"
14,3,94,2374,444,569,1013,"6 de julio de 1997"
14,3,94,2375,291,438,729,"6 de julio de 1997"
14,3,94,2376,26,33,59,"6 de julio de 1997"
14,3,94,2377,77,80,157,"6 de julio de 1997"
14,3,94,2378,265,281,546,"6 de julio de 1997"
14,3,94,2379,62,47,109,"6 de julio de 1997"
14,3,94,2380,93,107,200,"6 de julio de 1997"
14,3,94,2381,411,451,862,"6 de julio de 1997"
14,3,94,2382,221,225,446,"6 de julio de 1997"
14,3,94,2383,183,191,374,"6 de julio de 1997"
14,3,94,2384,52,64,116,"6 de julio de 1997"
14,3,94,2385,109,143,252,"6 de julio de 1997"
14,3,94,2386,253,257,510,"6 de julio de 1997"
14,3,94,2387,134,182,316,"6 de julio de 1997"
14,3,94,2388,112,125,237,"6 de julio de 1997"
14,3,94,2389,675,819,1494,"6 de julio de 1997"
14,3,94,2390,137,161,298,"6 de julio de 1997"
14,3,94,2391,47,53,100,"6 de julio de 1997"
14,3,94,2392,424,563,987,"6 de julio de 1997"
14,3,94,2393,169,167,336,"6 de julio de 1997"
14,3,94,2394,281,279,560,"6 de julio de 1997"
14,3,94,2395,264,292,556,"6 de julio de 1997"
14,3,112,2816,580,727,1307,"6 de julio de 1997"
14,3,112,2817,322,384,706,"6 de julio de 1997"
14,3,112,2818,347,441,788,"6 de julio de 1997"
14,3,112,2819,76,80,156,"6 de julio de 1997"
14,3,112,2820,118,115,233,"6 de julio de 1997"
14,3,112,2821,85,79,164,"6 de julio de 1997"
14,3,112,2822,26,31,57,"6 de julio de 1997"
14,3,112,2823,98,100,198,"6 de julio de 1997"
14,3,117,2855,168,228,396,"6 de julio de 1997"
14,3,117,2856,283,379,662,"6 de julio de 1997"
14,3,117,2857,180,249,429,"6 de julio de 1997"
14,3,117,2858,259,332,591,"6 de julio de 1997"
14,3,117,2859,81,91,172,"6 de julio de 1997"
14,3,117,2860,76,92,168,"6 de julio de 1997"
14,3,117,2861,100,175,275,"6 de julio de 1997"
14,3,118,2862,350,410,760,"6 de julio de 1997"
14,3,118,2863,257,320,577,"6 de julio de 1997"
14,3,118,2864,321,352,673,"6 de julio de 1997"
14,3,118,2865,477,563,1040,"6 de julio de 1997"
14,3,118,2866,242,288,530,"6 de julio de 1997"
14,3,118,2867,467,568,1035,"6 de julio de 1997"
14,3,118,2868,512,644,1156,"6 de julio de 1997"
14,3,118,2869,385,475,860,"6 de julio de 1997"
14,3,118,2870,508,629,1137,"6 de julio de 1997"
14,3,118,2871,583,691,1274,"6 de julio de 1997"
14,3,118,2872,41,50,91,"6 de julio de 1997"
14,3,118,2873,133,188,321,"6 de julio de 1997"
14,3,118,2874,101,144,245,"6 de julio de 1997"
14,3,118,2875,276,432,708,"6 de julio de 1997"
14,3,118,2876,94,110,204,"6 de julio de 1997"
14,3,118,2877,112,163,275,"6 de julio de 1997"
14,3,118,2878,520,749,1269,"6 de julio de 1997"
14,3,118,2879,253,299,552,"6 de julio de 1997"
14,3,118,2880,82,88,170,"6 de julio de 1997"
14,3,118,2881,263,347,610,"6 de julio de 1997"
14,3,118,2882,93,139,232,"6 de julio de 1997"
14,3,118,2883,144,168,312,"6 de julio de 1997"
14,4,30,445,540,627,1167,"6 de julio de 1997"
14,4,30,446,489,586,1075,"6 de julio de 1997"
14,4,30,447,335,403,738,"6 de julio de 1997"
14,4,30,448,437,470,907,"6 de julio de 1997"
14,4,30,449,367,349,716,"6 de julio de 1997"
14,4,30,450,437,471,908,"6 de julio de 1997"
14,4,30,451,425,458,883,"6 de julio de 1997"
14,4,30,452,234,212,446,"6 de julio de 1997"
14,4,30,453,425,449,874,"6 de julio de 1997"
14,4,30,454,350,423,773,"6 de julio de 1997"
14,4,30,455,366,391,757,"6 de julio de 1997"
14,4,30,456,294,343,637,"6 de julio de 1997"
14,4,47,1602,563,620,1183,"6 de julio de 1997"
14,4,47,1603,338,420,758,"6 de julio de 1997"
14,4,47,1604,565,604,1169,"6 de julio de 1997"
14,4,47,1605,562,591,1153,"6 de julio de 1997"
14,4,47,1606,399,357,756,"6 de julio de 1997"
14,4,47,1607,441,537,978,"6 de julio de 1997"
14,4,47,1608,350,436,786,"6 de julio de 1997"
14,4,47,1609,674,802,1476,"6 de julio de 1997"
14,4,47,1610,295,279,574,"6 de julio de 1997"
14,4,47,1611,295,361,656,"6 de julio de 1997"
14,4,47,1612,293,363,656,"6 de julio de 1997"
14,4,73,2050,447,442,889,"6 de julio de 1997"
14,4,73,2051,151,171,322,"6 de julio de 1997"
14,4,73,2052,279,248,527,"6 de julio de 1997"
14,4,73,2053,127,127,254,"6 de julio de 1997"
14,4,73,2054,148,135,283,"6 de julio de 1997"
14,4,120,2909,520,567,1087,"6 de julio de 1997"
14,4,120,2910,534,593,1127,"6 de julio de 1997"
14,4,120,2915,678,752,1430,"6 de julio de 1997"
14,4,120,2916,466,546,1012,"6 de julio de 1997"
14,4,120,2917,741,800,1541,"6 de julio de 1997"
14,4,120,2918,647,730,1377,"6 de julio de 1997"
14,4,120,2919,488,573,1061,"6 de julio de 1997"
14,4,120,2920,548,607,1155,"6 de julio de 1997"
14,4,120,2921,678,695,1373,"6 de julio de 1997"
14,4,120,2922,583,686,1269,"6 de julio de 1997"
14,4,120,2923,643,719,1362,"6 de julio de 1997"
14,4,120,2924,576,650,1226,"6 de julio de 1997"
14,4,120,2925,433,546,979,"6 de julio de 1997"
14,4,120,2926,558,661,1219,"6 de julio de 1997"
14,4,120,2927,390,480,870,"6 de julio de 1997"
14,4,120,2928,550,627,1177,"6 de julio de 1997"
14,4,120,2929,428,543,971,"6 de julio de 1997"
14,4,120,2930,787,866,1653,"6 de julio de 1997"
14,4,120,2931,811,957,1768,"6 de julio de 1997"
14,4,120,2932,735,786,1521,"6 de julio de 1997"
14,4,120,2933,800,875,1675,"6 de julio de 1997"
14,4,120,2934,698,774,1472,"6 de julio de 1997"
14,4,120,2935,652,795,1447,"6 de julio de 1997"
14,4,120,2936,405,555,960,"6 de julio de 1997"
14,4,120,2937,438,516,954,"6 de julio de 1997"
14,4,120,2938,739,817,1556,"6 de julio de 1997"
14,4,120,2939,665,724,1389,"6 de julio de 1997"
14,4,120,2940,635,722,1357,"6 de julio de 1997"
14,4,120,2941,607,668,1275,"6 de julio de 1997"
14,4,120,2942,753,810,1563,"6 de julio de 1997"
14,4,120,2943,671,714,1385,"6 de julio de 1997"
14,4,120,2944,287,344,631,"6 de julio de 1997"
14,4,120,2945,622,754,1376,"6 de julio de 1997"
14,4,120,2946,786,833,1619,"6 de julio de 1997"
14,4,120,2947,569,632,1201,"6 de julio de 1997"
14,4,120,2948,834,871,1705,"6 de julio de 1997"
14,4,120,2949,755,798,1553,"6 de julio de 1997"
14,4,120,2950,786,866,1652,"6 de julio de 1997"
14,4,120,2951,650,691,1341,"6 de julio de 1997"
14,4,120,2952,594,656,1250,"6 de julio de 1997"
14,4,120,2953,836,954,1790,"6 de julio de 1997"
14,4,120,2954,871,1013,1884,"6 de julio de 1997"
14,4,120,2955,814,904,1718,"6 de julio de 1997"
14,4,120,2956,753,850,1603,"6 de julio de 1997"
14,4,120,2957,499,559,1058,"6 de julio de 1997"
14,4,120,2958,518,563,1081,"6 de julio de 1997"
14,4,120,2959,500,577,1077,"6 de julio de 1997"
14,4,120,2960,760,839,1599,"6 de julio de 1997"
14,4,120,2961,751,860,1611,"6 de julio de 1997"
14,4,120,2962,604,638,1242,"6 de julio de 1997"
14,4,120,2963,304,342,646,"6 de julio de 1997"
14,4,120,2964,515,560,1075,"6 de julio de 1997"
14,4,120,2965,789,811,1600,"6 de julio de 1997"
14,4,120,2966,1213,1422,2635,"6 de julio de 1997"
14,4,120,2967,611,735,1346,"6 de julio de 1997"
14,4,120,2968,757,817,1574,"6 de julio de 1997"
14,4,120,2969,945,1052,1997,"6 de julio de 1997"
14,4,120,2970,640,757,1397,"6 de julio de 1997"
14,4,120,2971,473,564,1037,"6 de julio de 1997"
14,4,120,2972,722,887,1609,"6 de julio de 1997"
14,4,120,2973,541,622,1163,"6 de julio de 1997"
14,4,120,2974,592,666,1258,"6 de julio de 1997"
14,4,120,2975,497,568,1065,"6 de julio de 1997"
14,4,120,2976,596,658,1254,"6 de julio de 1997"
14,4,120,2977,478,545,1023,"6 de julio de 1997"
14,4,120,2978,440,556,996,"6 de julio de 1997"
14,4,120,2979,770,855,1625,"6 de julio de 1997"
14,4,120,2980,672,777,1449,"6 de julio de 1997"
14,4,120,2981,783,851,1634,"6 de julio de 1997"
14,4,120,2982,586,658,1244,"6 de julio de 1997"
14,4,120,2983,746,798,1544,"6 de julio de 1997"
14,4,120,2984,717,818,1535,"6 de julio de 1997"
14,4,120,2985,1035,1105,2140,"6 de julio de 1997"
14,4,120,2986,917,1045,1962,"6 de julio de 1997"
14,4,120,2987,943,1040,1983,"6 de julio de 1997"
14,4,120,2988,881,981,1862,"6 de julio de 1997"
14,4,120,2989,576,631,1207,"6 de julio de 1997"
14,4,120,2990,682,744,1426,"6 de julio de 1997"
14,4,120,2991,606,658,1264,"6 de julio de 1997"
14,4,120,2992,534,659,1193,"6 de julio de 1997"
14,4,120,2993,1094,1225,2319,"6 de julio de 1997"
14,4,120,2994,883,990,1873,"6 de julio de 1997"
14,4,120,2995,870,944,1814,"6 de julio de 1997"
14,4,120,2996,835,892,1727,"6 de julio de 1997"
14,4,120,2997,588,646,1234,"6 de julio de 1997"
14,4,120,2998,663,729,1392,"6 de julio de 1997"
14,4,120,2999,762,843,1605,"6 de julio de 1997"
14,4,120,3000,947,965,1912,"6 de julio de 1997"
14,4,120,3001,818,930,1748,"6 de julio de 1997"
14,4,120,3002,1097,1170,2267,"6 de julio de 1997"
14,4,120,3003,956,1020,1976,"6 de julio de 1997"
14,4,120,3004,1066,1171,2237,"6 de julio de 1997"
14,4,120,3005,892,949,1841,"6 de julio de 1997"
14,4,120,3006,1231,1321,2552,"6 de julio de 1997"
14,4,120,3007,1013,1116,2129,"6 de julio de 1997"
14,4,120,3008,848,921,1769,"6 de julio de 1997"
14,4,120,3009,495,551,1046,"6 de julio de 1997"
14,4,120,3010,515,561,1076,"6 de julio de 1997"
14,4,120,3011,867,888,1755,"6 de julio de 1997"
14,4,120,3012,570,594,1164,"6 de julio de 1997"
14,4,120,3013,1002,1059,2061,"6 de julio de 1997"
14,4,120,3014,589,652,1241,"6 de julio de 1997"
14,4,120,3015,598,659,1257,"6 de julio de 1997"
14,4,120,3016,667,685,1352,"6 de julio de 1997"
14,4,120,3017,751,754,1505,"6 de julio de 1997"
14,4,120,3024,1443,1529,2972,"6 de julio de 1997"
14,4,120,3026,197,187,384,"6 de julio de 1997"
14,4,120,3027,320,317,637,"6 de julio de 1997"
14,4,120,3028,707,708,1415,"6 de julio de 1997"
14,4,120,3029,277,298,575,"6 de julio de 1997"
14,5,6,48,613,647,1260,"6 de julio de 1997"
14,5,6,49,24,2,26,"6 de julio de 1997"
14,5,6,50,383,480,863,"6 de julio de 1997"
14,5,6,51,428,525,953,"6 de julio de 1997"
14,5,6,52,630,665,1295,"6 de julio de 1997"
14,5,6,53,470,505,975,"6 de julio de 1997"
14,5,6,54,373,422,795,"6 de julio de 1997"
14,5,6,55,465,526,991,"6 de julio de 1997"
14,5,6,56,634,733,1367,"6 de julio de 1997"
14,5,6,57,542,611,1153,"6 de julio de 1997"
14,5,6,58,489,543,1032,"6 de julio de 1997"
14,5,6,59,411,447,858,"6 de julio de 1997"
14,5,6,60,287,339,626,"6 de julio de 1997"
14,5,6,61,467,534,1001,"6 de julio de 1997"
14,5,6,62,433,486,919,"6 de julio de 1997"
14,5,6,63,489,492,981,"6 de julio de 1997"
14,5,6,64,467,519,986,"6 de julio de 1997"
14,5,6,65,535,524,1059,"6 de julio de 1997"
14,5,6,66,531,628,1159,"6 de julio de 1997"
14,5,6,67,711,798,1509,"6 de julio de 1997"
14,5,6,68,426,34,460,"6 de julio de 1997"
14,5,6,69,380,416,796,"6 de julio de 1997"
14,5,6,70,402,479,881,"6 de julio de 1997"
14,5,6,71,296,343,639,"6 de julio de 1997"
14,5,6,72,862,906,1768,"6 de julio de 1997"
14,5,6,73,227,218,445,"6 de julio de 1997"
14,5,6,74,148,130,278,"6 de julio de 1997"
14,5,6,75,292,295,587,"6 de julio de 1997"
14,5,6,76,277,248,525,"6 de julio de 1997"
14,5,6,77,344,348,692,"6 de julio de 1997"
14,5,6,78,248,318,566,"6 de julio de 1997"
14,5,6,79,285,274,559,"6 de julio de 1997"
14,5,6,80,480,528,1008,"6 de julio de 1997"
14,5,6,81,397,404,801,"6 de julio de 1997"
14,5,6,82,89,87,176,"6 de julio de 1997"
14,5,6,83,52,45,97,"6 de julio de 1997"
14,5,6,84,261,260,521,"6 de julio de 1997"
14,5,6,85,167,183,350,"6 de julio de 1997"
14,5,6,86,82,87,169,"6 de julio de 1997"
14,5,6,87,274,327,601,"6 de julio de 1997"
14,5,6,88,289,301,590,"6 de julio de 1997"
14,5,6,89,227,203,430,"6 de julio de 1997"
14,5,6,90,175,186,361,"6 de julio de 1997"
14,5,6,91,474,459,933,"6 de julio de 1997"
14,5,6,92,36,49,85,"6 de julio de 1997"
14,5,6,93,177,190,367,"6 de julio de 1997"
14,5,12,155,273,338,611,"6 de julio de 1997"
14,5,12,156,294,318,612,"6 de julio de 1997"
14,5,12,157,53,57,110,"6 de julio de 1997"
14,5,12,158,74,83,157,"6 de julio de 1997"
14,5,12,159,410,453,863,"6 de julio de 1997"
14,5,12,160,75,97,172,"6 de julio de 1997"
14,5,20,296,542,445,987,"6 de julio de 1997"
14,5,20,297,513,451,964,"6 de julio de 1997"
14,5,20,298,367,238,605,"6 de julio de 1997"
14,5,20,299,246,211,457,"6 de julio de 1997"
14,5,20,300,773,635,1408,"6 de julio de 1997"
14,5,20,301,320,190,510,"6 de julio de 1997"
14,5,40,561,293,305,598,"6 de julio de 1997"
14,5,40,562,243,273,516,"6 de julio de 1997"
14,5,40,563,249,200,449,"6 de julio de 1997"
14,5,40,564,53,40,93,"6 de julio de 1997"
14,5,40,565,145,126,271,"6 de julio de 1997"
14,5,40,566,65,49,114,"6 de julio de 1997"
14,5,40,567,96,93,189,"6 de julio de 1997"
14,5,40,568,50,42,92,"6 de julio de 1997"
14,5,40,569,142,135,277,"6 de julio de 1997"
14,5,60,1802,529,539,1068,"6 de julio de 1997"
14,5,60,1803,455,547,1002,"6 de julio de 1997"
14,5,60,1804,430,431,861,"6 de julio de 1997"
14,5,60,1805,608,674,1282,"6 de julio de 1997"
14,5,60,1806,574,634,1208,"6 de julio de 1997"
14,5,60,1807,133,112,245,"6 de julio de 1997"
14,5,60,1808,277,335,612,"6 de julio de 1997"
14,5,60,1809,347,380,727,"6 de julio de 1997"
14,5,60,1810,168,175,343,"6 de julio de 1997"
14,5,60,1811,65,57,122,"6 de julio de 1997"
14,5,60,1812,73,58,131,"6 de julio de 1997"
14,5,60,1813,108,102,210,"6 de julio de 1997"
14,5,60,1814,246,231,477,"6 de julio de 1997"
14,5,64,1840,249,282,531,"6 de julio de 1997"
14,5,64,1841,267,323,590,"6 de julio de 1997"
14,5,64,1842,372,346,718,"6 de julio de 1997"
14,5,64,1843,127,145,272,"6 de julio de 1997"
14,5,69,1934,126,133,259,"6 de julio de 1997"
14,5,69,1935,962,1002,1964,"6 de julio de 1997"
14,5,69,1936,206,28,234,"6 de julio de 1997"
14,5,69,1937,574,703,1277,"6 de julio de 1997"
14,5,69,1938,823,1026,1849,"6 de julio de 1997"
14,5,69,1939,401,500,901,"6 de julio de 1997"
14,5,69,1940,142,141,283,"6 de julio de 1997"
14,5,69,1941,584,550,1134,"6 de julio de 1997"
14,5,69,1942,599,569,1168,"6 de julio de 1997"
14,5,69,1943,251,309,560,"6 de julio de 1997"
14,5,69,1944,664,694,1358,"6 de julio de 1997"
14,5,69,1945,773,770,1543,"6 de julio de 1997"
14,5,69,1946,627,653,1280,"6 de julio de 1997"
14,5,69,1947,578,606,1184,"6 de julio de 1997"
14,5,69,1948,866,881,1747,"6 de julio de 1997"
14,5,69,1949,465,491,956,"6 de julio de 1997"
14,5,69,1950,732,750,1482,"6 de julio de 1997"
14,5,69,1951,552,561,1113,"6 de julio de 1997"
14,5,69,1952,574,610,1184,"6 de julio de 1997"
14,5,69,1953,542,552,1094,"6 de julio de 1997"
14,5,69,1954,578,569,1147,"6 de julio de 1997"
14,5,69,1955,617,645,1262,"6 de julio de 1997"
14,5,69,1956,496,525,1021,"6 de julio de 1997"
14,5,69,1957,371,411,782,"6 de julio de 1997"
14,5,69,1958,1042,1169,2211,"6 de julio de 1997"
14,5,69,1959,450,496,946,"6 de julio de 1997"
14,5,69,1960,667,717,1384,"6 de julio de 1997"
14,5,69,1961,372,382,754,"6 de julio de 1997"
14,5,69,1962,542,581,1123,"6 de julio de 1997"
14,5,69,1963,377,363,740,"6 de julio de 1997"
14,5,69,1964,582,608,1190,"6 de julio de 1997"
14,5,69,1965,674,700,1374,"6 de julio de 1997"
14,5,69,1966,249,280,529,"6 de julio de 1997"
14,5,69,1967,1000,1050,2050,"6 de julio de 1997"
14,5,69,1968,498,538,1036,"6 de julio de 1997"
14,5,69,1969,737,740,1477,"6 de julio de 1997"
14,5,69,1970,433,444,877,"6 de julio de 1997"
14,5,69,1971,729,717,1446,"6 de julio de 1997"
14,5,69,1972,718,749,1467,"6 de julio de 1997"
14,5,69,1973,890,859,1749,"6 de julio de 1997"
14,5,69,1974,463,436,899,"6 de julio de 1997"
14,5,69,1975,512,502,1014,"6 de julio de 1997"
14,5,69,1976,381,385,766,"6 de julio de 1997"
14,5,69,1977,438,405,843,"6 de julio de 1997"
14,5,69,1978,458,522,980,"6 de julio de 1997"
14,5,69,1979,329,387,716,"6 de julio de 1997"
14,5,69,1980,411,417,828,"6 de julio de 1997"
14,5,69,1981,451,510,961,"6 de julio de 1997"
14,5,69,1982,369,440,809,"6 de julio de 1997"
14,5,69,1983,891,876,1767,"6 de julio de 1997"
14,5,69,1984,452,450,902,"6 de julio de 1997"
14,5,69,1985,689,683,1372,"6 de julio de 1997"
14,5,69,1986,661,670,1331,"6 de julio de 1997"
14,5,69,1987,363,349,712,"6 de julio de 1997"
14,5,69,1988,661,704,1365,"6 de julio de 1997"
14,5,69,1989,661,607,1268,"6 de julio de 1997"
14,5,69,1990,335,284,619,"6 de julio de 1997"
14,5,69,1991,464,440,904,"6 de julio de 1997"
14,5,69,1992,261,263,524,"6 de julio de 1997"
14,5,69,1993,563,521,1084,"6 de julio de 1997"
14,5,69,1994,202,233,435,"6 de julio de 1997"
14,5,69,1995,440,503,943,"6 de julio de 1997"
14,5,69,1996,949,1008,1957,"6 de julio de 1997"
14,5,69,1997,573,570,1143,"6 de julio de 1997"
14,5,69,1998,832,851,1683,"6 de julio de 1997"
14,5,69,1999,642,679,1321,"6 de julio de 1997"
14,5,69,2000,551,539,1090,"6 de julio de 1997"
14,5,69,2001,311,266,577,"6 de julio de 1997"
14,5,69,2002,256,223,479,"6 de julio de 1997"
14,5,81,2150,280,248,528,"6 de julio de 1997"
14,5,81,2151,265,171,436,"6 de julio de 1997"
14,5,81,2152,101,67,168,"6 de julio de 1997"
14,5,81,2153,568,503,1071,"6 de julio de 1997"
14,5,81,2154,240,204,444,"6 de julio de 1997"
14,5,81,2155,171,155,326,"6 de julio de 1997"
14,5,81,2156,197,153,350,"6 de julio de 1997"
14,5,85,2212,531,621,1152,"6 de julio de 1997"
14,5,85,2213,812,827,1639,"6 de julio de 1997"
14,5,85,2214,672,737,1409,"6 de julio de 1997"
14,5,85,2215,278,241,519,"6 de julio de 1997"
14,5,85,2216,205,151,356,"6 de julio de 1997"
14,5,85,2217,166,129,295,"6 de julio de 1997"
14,5,85,2218,55,50,105,"6 de julio de 1997"
14,5,85,2219,99,82,181,"6 de julio de 1997"
14,5,85,2220,367,286,653,"6 de julio de 1997"
14,5,85,2221,137,83,220,"6 de julio de 1997"
14,5,85,2222,246,161,407,"6 de julio de 1997"
14,5,101,2633,518,584,1102,"6 de julio de 1997"
14,5,101,2634,609,603,1212,"6 de julio de 1997"
14,5,101,2635,524,556,1080,"6 de julio de 1997"
14,5,101,2636,318,281,599,"6 de julio de 1997"
14,5,101,2637,441,323,764,"6 de julio de 1997"
14,5,101,2638,406,307,713,"6 de julio de 1997"
14,5,101,2639,629,456,1085,"6 de julio de 1997"
14,5,101,2640,495,398,893,"6 de julio de 1997"
14,5,101,2641,192,133,325,"6 de julio de 1997"
14,5,101,2642,587,456,1043,"6 de julio de 1997"
14,5,101,2643,825,692,1517,"6 de julio de 1997"
14,5,101,2644,218,192,410,"6 de julio de 1997"
14,5,101,2645,211,176,387,"6 de julio de 1997"
14,5,101,2646,387,322,709,"6 de julio de 1997"
14,5,101,2647,288,249,537,"6 de julio de 1997"
14,5,101,2648,552,501,1053,"6 de julio de 1997"
14,5,101,2649,678,646,1324,"6 de julio de 1997"
14,6,120,2900,765,849,1614,"6 de julio de 1997"
14,6,120,2901,462,520,982,"6 de julio de 1997"
14,6,120,2902,968,1062,2030,"6 de julio de 1997"
14,6,120,2903,576,699,1275,"6 de julio de 1997"
14,6,120,2904,571,622,1193,"6 de julio de 1997"
14,6,120,2905,677,737,1414,"6 de julio de 1997"
14,6,120,2906,716,943,1659,"6 de julio de 1997"
14,6,120,2907,621,699,1320,"6 de julio de 1997"
14,6,120,2908,680,748,1428,"6 de julio de 1997"
14,6,120,2911,766,895,1661,"6 de julio de 1997"
14,6,120,2912,586,637,1223,"6 de julio de 1997"
14,6,120,2913,682,815,1497,"6 de julio de 1997"
14,6,120,2914,600,678,1278,"6 de julio de 1997"
14,6,120,3018,1143,1252,2395,"6 de julio de 1997"
14,6,120,3019,826,873,1699,"6 de julio de 1997"
14,6,120,3020,810,867,1677,"6 de julio de 1997"
14,6,120,3021,658,694,1352,"6 de julio de 1997"
14,6,120,3022,604,692,1296,"6 de julio de 1997"
14,6,120,3023,1159,1227,2386,"6 de julio de 1997"
14,6,120,3025,140,104,244,"6 de julio de 1997"
14,6,120,3030,552,547,1099,"6 de julio de 1997"
14,6,120,3031,723,857,1580,"6 de julio de 1997"
14,6,120,3032,768,851,1619,"6 de julio de 1997"
14,6,120,3033,723,827,1550,"6 de julio de 1997"
14,6,120,3034,582,646,1228,"6 de julio de 1997"
14,6,120,3035,493,556,1049,"6 de julio de 1997"
14,6,120,3036,619,748,1367,"6 de julio de 1997"
14,6,120,3037,635,737,1372,"6 de julio de 1997"
14,6,120,3038,686,790,1476,"6 de julio de 1997"
14,6,120,3039,517,617,1134,"6 de julio de 1997"
14,6,120,3040,790,930,1720,"6 de julio de 1997"
14,6,120,3041,513,586,1099,"6 de julio de 1997"
14,6,120,3042,662,760,1422,"6 de julio de 1997"
14,6,120,3043,499,549,1048,"6 de julio de 1997"
14,6,120,3044,343,390,733,"6 de julio de 1997"
14,6,120,3045,614,725,1339,"6 de julio de 1997"
14,6,120,3046,715,803,1518,"6 de julio de 1997"
14,6,120,3047,469,515,984,"6 de julio de 1997"
14,6,120,3048,632,703,1335,"6 de julio de 1997"
14,6,120,3049,661,730,1391,"6 de julio de 1997"
14,6,120,3050,770,896,1666,"6 de julio de 1997"
14,6,120,3051,647,670,1317,"6 de julio de 1997"
14,6,120,3052,728,875,1603,"6 de julio de 1997"
14,6,120,3053,822,969,1791,"6 de julio de 1997"
14,6,120,3054,570,602,1172,"6 de julio de 1997"
14,6,120,3055,535,607,1142,"6 de julio de 1997"
14,6,120,3056,587,621,1208,"6 de julio de 1997"
14,6,120,3057,447,511,958,"6 de julio de 1997"
14,6,120,3058,695,723,1418,"6 de julio de 1997"
14,6,120,3059,574,600,1174,"6 de julio de 1997"
14,6,120,3060,365,383,748,"6 de julio de 1997"
14,6,120,3061,867,981,1848,"6 de julio de 1997"
14,6,120,3062,609,654,1263,"6 de julio de 1997"
14,6,120,3063,500,542,1042,"6 de julio de 1997"
14,6,120,3064,740,831,1571,"6 de julio de 1997"
14,6,120,3065,717,785,1502,"6 de julio de 1997"
14,6,120,3066,616,676,1292,"6 de julio de 1997"
14,6,120,3068,962,1133,2095,"6 de julio de 1997"
14,6,120,3069,619,728,1347,"6 de julio de 1997"
14,6,120,3070,424,410,834,"6 de julio de 1997"
14,6,120,3071,851,1053,1904,"6 de julio de 1997"
14,6,120,3072,666,763,1429,"6 de julio de 1997"
14,6,120,3073,784,795,1579,"6 de julio de 1997"
14,6,120,3074,672,750,1422,"6 de julio de 1997"
14,6,120,3075,598,701,1299,"6 de julio de 1997"
14,6,120,3076,802,964,1766,"6 de julio de 1997"
14,6,120,3085,523,533,1056,"6 de julio de 1997"
14,6,120,3086,1351,1485,2836,"6 de julio de 1997"
14,6,120,3087,894,1078,1972,"6 de julio de 1997"
14,6,120,3116,1062,1123,2185,"6 de julio de 1997"
14,6,120,3117,633,677,1310,"6 de julio de 1997"
14,6,120,3118,840,813,1653,"6 de julio de 1997"
14,6,120,3119,808,840,1648,"6 de julio de 1997"
14,6,120,3120,501,526,1027,"6 de julio de 1997"
14,6,120,3121,884,931,1815,"6 de julio de 1997"
14,6,120,3122,1108,1187,2295,"6 de julio de 1997"
14,6,120,3150,329,359,688,"6 de julio de 1997"
14,6,120,3151,922,1017,1939,"6 de julio de 1997"
14,6,120,3152,924,940,1864,"6 de julio de 1997"
14,6,120,3153,866,929,1795,"6 de julio de 1997"
14,6,120,3154,1249,1345,2594,"6 de julio de 1997"
14,6,120,3155,929,1041,1970,"6 de julio de 1997"
14,6,120,3156,780,942,1722,"6 de julio de 1997"
14,6,120,3157,878,986,1864,"6 de julio de 1997"
14,6,120,3158,1046,1109,2155,"6 de julio de 1997"
14,6,120,3159,725,748,1473,"6 de julio de 1997"
14,6,120,3160,679,741,1420,"6 de julio de 1997"
14,6,120,3206,980,1000,1980,"6 de julio de 1997"
14,6,120,3207,499,531,1030,"6 de julio de 1997"
14,6,120,3208,720,816,1536,"6 de julio de 1997"
14,6,120,3209,377,433,810,"6 de julio de 1997"
14,6,120,3210,910,1040,1950,"6 de julio de 1997"
14,6,120,3211,1180,1220,2400,"6 de julio de 1997"
14,6,120,3212,661,739,1400,"6 de julio de 1997"
14,6,120,3213,623,678,1301,"6 de julio de 1997"
14,6,120,3214,471,489,960,"6 de julio de 1997"
14,6,120,3215,1313,1387,2700,"6 de julio de 1997"
14,6,120,3216,822,864,1686,"6 de julio de 1997"
14,6,120,3217,595,552,1147,"6 de julio de 1997"
14,6,120,3218,217,265,482,"6 de julio de 1997"
14,6,120,3219,738,846,1584,"6 de julio de 1997"
14,6,120,3220,323,402,725,"6 de julio de 1997"
14,6,120,3221,353,407,760,"6 de julio de 1997"
14,6,120,3222,568,599,1167,"6 de julio de 1997"
14,6,120,3223,611,634,1245,"6 de julio de 1997"
14,6,120,3224,393,440,833,"6 de julio de 1997"
14,6,120,3225,756,828,1584,"6 de julio de 1997"
14,6,120,3226,524,620,1144,"6 de julio de 1997"
14,6,120,3227,366,427,793,"6 de julio de 1997"
14,6,120,3228,433,509,942,"6 de julio de 1997"
14,6,120,3229,487,573,1060,"6 de julio de 1997"
14,6,120,3230,590,603,1193,"6 de julio de 1997"
14,6,120,3231,588,572,1160,"6 de julio de 1997"
14,6,120,3232,899,138,1037,"6 de julio de 1997"
14,6,120,3233,1059,85,1144,"6 de julio de 1997"
14,6,120,3234,586,630,1216,"6 de julio de 1997"
14,6,120,3235,1070,1162,2232,"6 de julio de 1997"
14,6,120,3236,404,417,821,"6 de julio de 1997"
14,6,120,3237,380,406,786,"6 de julio de 1997"
14,7,53,1689,407,422,829,"6 de julio de 1997"
14,7,53,1690,460,491,951,"6 de julio de 1997"
14,7,53,1691,493,519,1012,"6 de julio de 1997"
14,7,53,1692,631,680,1311,"6 de julio de 1997"
14,7,53,1693,344,347,691,"6 de julio de 1997"
14,7,53,1694,386,415,801,"6 de julio de 1997"
14,7,53,1695,499,483,982,"6 de julio de 1997"
14,7,72,2024,827,861,1688,"6 de julio de 1997"
14,7,72,2025,1069,1111,2180,"6 de julio de 1997"
14,7,72,2026,436,455,891,"6 de julio de 1997"
14,7,72,2027,646,661,1307,"6 de julio de 1997"
14,7,72,2028,627,640,1267,"6 de julio de 1997"
14,7,72,2029,521,562,1083,"6 de julio de 1997"
14,7,72,2030,803,815,1618,"6 de julio de 1997"
14,7,72,2031,609,647,1256,"6 de julio de 1997"
14,7,72,2032,499,526,1025,"6 de julio de 1997"
14,7,72,2033,775,850,1625,"6 de julio de 1997"
14,7,72,2034,583,620,1203,"6 de julio de 1997"
14,7,72,2035,1072,1141,2213,"6 de julio de 1997"
14,7,72,2036,672,738,1410,"6 de julio de 1997"
14,7,72,2037,506,578,1084,"6 de julio de 1997"
14,7,72,2038,979,1067,2046,"6 de julio de 1997"
14,7,72,2039,706,750,1456,"6 de julio de 1997"
14,7,72,2040,700,740,1440,"6 de julio de 1997"
14,7,72,2041,386,397,783,"6 de julio de 1997"
14,7,72,2042,233,275,508,"6 de julio de 1997"
14,7,72,2043,1101,1185,2286,"6 de julio de 1997"
14,7,72,2044,746,742,1488,"6 de julio de 1997"
14,7,72,2045,722,700,1422,"6 de julio de 1997"
14,7,72,2046,741,733,1474,"6 de julio de 1997"
14,7,72,2047,93,102,195,"6 de julio de 1997"
14,7,72,2048,246,240,486,"6 de julio de 1997"
14,7,72,2049,925,911,1836,"6 de julio de 1997"
14,7,102,2650,1064,1224,2288,"6 de julio de 1997"
14,7,102,2651,1250,1380,2630,"6 de julio de 1997"
14,7,102,2652,844,1001,1845,"6 de julio de 1997"
14,7,102,2653,568,618,1186,"6 de julio de 1997"
14,7,102,2654,519,555,1074,"6 de julio de 1997"
14,7,102,2655,854,942,1796,"6 de julio de 1997"
14,7,102,2656,959,1091,2050,"6 de julio de 1997"
14,7,102,2657,743,759,1502,"6 de julio de 1997"
14,7,102,2658,488,506,994,"6 de julio de 1997"
14,7,102,2659,578,639,1217,"6 de julio de 1997"
14,7,102,2660,710,806,1516,"6 de julio de 1997"
14,7,102,2661,1012,1090,2102,"6 de julio de 1997"
14,7,102,2662,1082,1170,2252,"6 de julio de 1997"
14,7,102,2663,679,726,1405,"6 de julio de 1997"
14,7,102,2664,647,700,1347,"6 de julio de 1997"
14,7,102,2665,768,862,1630,"6 de julio de 1997"
14,7,102,2666,709,749,1458,"6 de julio de 1997"
14,7,102,2667,634,693,1327,"6 de julio de 1997"
14,7,102,2668,618,711,1329,"6 de julio de 1997"
14,7,102,2669,600,634,1234,"6 de julio de 1997"
14,7,102,2670,951,1044,1995,"6 de julio de 1997"
14,7,102,2671,912,978,1890,"6 de julio de 1997"
14,7,102,2672,625,677,1302,"6 de julio de 1997"
14,7,102,2673,576,660,1236,"6 de julio de 1997"
14,7,102,2674,732,836,1568,"6 de julio de 1997"
14,7,102,2675,350,335,685,"6 de julio de 1997"
14,7,102,2676,1042,1108,2150,"6 de julio de 1997"
14,7,102,2677,536,582,1118,"6 de julio de 1997"
14,7,102,2678,726,801,1527,"6 de julio de 1997"
14,7,102,2679,434,467,901,"6 de julio de 1997"
14,7,102,2680,418,455,873,"6 de julio de 1997"
14,7,102,2681,935,1049,1984,"6 de julio de 1997"
14,7,102,2682,728,865,1593,"6 de julio de 1997"
14,7,102,2683,720,709,1429,"6 de julio de 1997"
14,7,102,2684,967,1008,1975,"6 de julio de 1997"
14,7,102,2685,785,818,1603,"6 de julio de 1997"
14,7,102,2686,843,890,1733,"6 de julio de 1997"
14,7,102,2687,865,963,1828,"6 de julio de 1997"
14,7,102,2688,365,398,763,"6 de julio de 1997"
14,7,102,2689,355,402,757,"6 de julio de 1997"
14,7,102,2690,399,371,770,"6 de julio de 1997"
14,7,102,2691,1012,1117,2129,"6 de julio de 1997"
14,7,102,2692,684,731,1415,"6 de julio de 1997"
14,7,102,2693,786,874,1660,"6 de julio de 1997"
14,7,102,2694,633,724,1357,"6 de julio de 1997"
14,7,102,2695,779,781,1560,"6 de julio de 1997"
14,7,102,2696,486,567,1053,"6 de julio de 1997"
14,7,102,2697,1041,1205,2246,"6 de julio de 1997"
14,7,102,2698,552,657,1209,"6 de julio de 1997"
14,7,102,2699,414,489,903,"6 de julio de 1997"
14,7,102,2700,498,670,1168,"6 de julio de 1997"
14,7,102,2701,711,833,1544,"6 de julio de 1997"
14,7,102,2702,1027,1085,2112,"6 de julio de 1997"
14,7,102,2703,868,883,1751,"6 de julio de 1997"
14,7,102,2704,627,724,1351,"6 de julio de 1997"
14,7,102,2705,552,580,1132,"6 de julio de 1997"
14,7,102,2706,432,505,937,"6 de julio de 1997"
14,7,102,2707,1567,1859,3426,"6 de julio de 1997"
14,7,102,2708,727,798,1525,"6 de julio de 1997"
14,7,102,2709,979,1223,2202,"6 de julio de 1997"
14,7,102,2710,1129,1293,2422,"6 de julio de 1997"
14,7,102,2711,867,906,1773,"6 de julio de 1997"
14,7,102,2712,843,906,1749,"6 de julio de 1997"
14,7,102,2713,515,633,1148,"6 de julio de 1997"
14,7,102,2714,655,737,1392,"6 de julio de 1997"
14,7,102,2715,480,599,1079,"6 de julio de 1997"
14,7,102,2716,863,980,1843,"6 de julio de 1997"
14,7,102,2717,888,973,1861,"6 de julio de 1997"
14,7,102,2718,851,920,1771,"6 de julio de 1997"
14,7,102,2719,523,626,1149,"6 de julio de 1997"
14,7,102,2720,481,547,1028,"6 de julio de 1997"
14,7,102,2721,1061,1125,2186,"6 de julio de 1997"
14,7,102,2722,821,870,1691,"6 de julio de 1997"
14,7,102,2723,693,711,1404,"6 de julio de 1997"
14,7,102,2724,371,439,810,"6 de julio de 1997"
14,7,102,2725,640,765,1405,"6 de julio de 1997"
14,7,102,2726,401,442,843,"6 de julio de 1997"
14,7,102,2727,612,633,1245,"6 de julio de 1997"
14,7,102,2728,216,190,406,"6 de julio de 1997"
14,7,102,2729,384,353,737,"6 de julio de 1997"
14,7,124,3278,707,756,1463,"6 de julio de 1997"
14,7,124,3279,471,557,1028,"6 de julio de 1997"
14,7,124,3280,536,680,1216,"6 de julio de 1997"
14,7,124,3281,662,738,1400,"6 de julio de 1997"
14,7,124,3282,608,698,1306,"6 de julio de 1997"
14,7,124,3283,615,698,1313,"6 de julio de 1997"
14,7,124,3284,446,484,930,"6 de julio de 1997"
14,7,124,3285,692,874,1566,"6 de julio de 1997"
14,7,124,3286,586,688,1274,"6 de julio de 1997"
14,7,124,3287,579,612,1191,"6 de julio de 1997"
14,7,124,3288,320,343,663,"6 de julio de 1997"
14,7,124,3289,370,426,796,"6 de julio de 1997"
14,7,124,3290,233,212,445,"6 de julio de 1997"
14,7,124,3291,433,516,949,"6 de julio de 1997"
14,7,124,3292,84,99,183,"6 de julio de 1997"
14,7,124,3293,196,208,404,"6 de julio de 1997"
14,7,124,3294,267,221,488,"6 de julio de 1997"
14,7,124,3295,299,308,607,"6 de julio de 1997"
14,7,124,3296,225,210,435,"6 de julio de 1997"
14,7,124,3297,332,351,683,"6 de julio de 1997"
14,7,124,3298,95,100,195,"6 de julio de 1997"
14,7,124,3299,61,72,133,"6 de julio de 1997"
14,7,124,3300,121,115,236,"6 de julio de 1997"
14,7,124,3301,937,1038,1975,"6 de julio de 1997"
14,7,124,3302,373,425,798,"6 de julio de 1997"
14,7,124,3303,335,353,688,"6 de julio de 1997"
14,7,124,3304,275,268,543,"6 de julio de 1997"
14,7,124,3305,233,236,469,"6 de julio de 1997"
14,7,124,3306,374,398,772,"6 de julio de 1997"
14,7,124,3307,428,454,882,"6 de julio de 1997"
14,7,124,3308,390,428,818,"6 de julio de 1997"
14,7,124,3309,572,638,1210,"6 de julio de 1997"
14,8,41,1087,766,934,1700,"6 de julio de 1997"
14,8,41,1088,630,835,1465,"6 de julio de 1997"
14,8,41,1089,377,479,856,"6 de julio de 1997"
14,8,41,1090,405,490,895,"6 de julio de 1997"
14,8,41,1091,666,818,1484,"6 de julio de 1997"
14,8,41,1092,501,639,1140,"6 de julio de 1997"
14,8,41,1093,459,612,1071,"6 de julio de 1997"
14,8,41,1094,342,450,792,"6 de julio de 1997"
14,8,41,1095,384,482,866,"6 de julio de 1997"
14,8,41,1096,419,475,894,"6 de julio de 1997"
14,8,41,1097,302,416,718,"6 de julio de 1997"
14,8,41,1098,462,557,1019,"6 de julio de 1997"
14,8,41,1099,281,322,603,"6 de julio de 1997"
14,8,41,1100,533,597,1130,"6 de julio de 1997"
14,8,41,1101,631,735,1366,"6 de julio de 1997"
14,8,41,1102,625,674,1299,"6 de julio de 1997"
14,8,41,1103,785,874,1659,"6 de julio de 1997"
14,8,41,1104,573,645,1218,"6 de julio de 1997"
14,8,41,1105,440,511,951,"6 de julio de 1997"
14,8,41,1106,601,792,1393,"6 de julio de 1997"
14,8,41,1107,455,619,1074,"6 de julio de 1997"
14,8,41,1108,670,755,1425,"6 de julio de 1997"
14,8,41,1109,409,507,916,"6 de julio de 1997"
14,8,41,1110,372,436,808,"6 de julio de 1997"
14,8,41,1111,446,551,997,"6 de julio de 1997"
14,8,41,1112,414,488,902,"6 de julio de 1997"
14,8,41,1113,711,876,1587,"6 de julio de 1997"
14,8,41,1114,318,399,717,"6 de julio de 1997"
14,8,41,1115,555,630,1185,"6 de julio de 1997"
14,8,41,1116,613,698,1311,"6 de julio de 1997"
14,8,41,1117,383,407,790,"6 de julio de 1997"
14,8,41,1118,348,448,796,"6 de julio de 1997"
14,8,41,1119,324,391,715,"6 de julio de 1997"
14,8,41,1120,529,644,1173,"6 de julio de 1997"
14,8,41,1121,535,643,1178,"6 de julio de 1997"
14,8,41,1122,498,574,1072,"6 de julio de 1997"
14,8,41,1123,711,784,1495,"6 de julio de 1997"
14,8,41,1124,588,672,1260,"6 de julio de 1997"
14,8,41,1125,596,681,1277,"6 de julio de 1997"
14,8,41,1126,683,788,1471,"6 de julio de 1997"
14,8,41,1127,432,583,1015,"6 de julio de 1997"
14,8,41,1128,703,876,1579,"6 de julio de 1997"
14,8,41,1129,583,802,1385,"6 de julio de 1997"
14,8,41,1130,401,487,888,"6 de julio de 1997"
14,8,41,1131,368,456,824,"6 de julio de 1997"
14,8,41,1132,372,448,820,"6 de julio de 1997"
14,8,41,1133,468,525,993,"6 de julio de 1997"
14,8,41,1134,226,265,491,"6 de julio de 1997"
14,8,41,1135,388,449,837,"6 de julio de 1997"
14,8,41,1136,461,560,1021,"6 de julio de 1997"
14,8,41,1137,565,646,1211,"6 de julio de 1997"
14,8,41,1138,278,301,579,"6 de julio de 1997"
14,8,41,1139,477,589,1066,"6 de julio de 1997"
14,8,41,1140,483,525,1008,"6 de julio de 1997"
14,8,41,1141,424,539,963,"6 de julio de 1997"
14,8,41,1142,522,604,1126,"6 de julio de 1997"
14,8,41,1143,469,587,1056,"6 de julio de 1997"
14,8,41,1144,491,574,1065,"6 de julio de 1997"
14,8,41,1145,513,587,1100,"6 de julio de 1997"
14,8,41,1146,348,429,777,"6 de julio de 1997"
14,8,41,1147,478,513,991,"6 de julio de 1997"
14,8,41,1148,395,405,800,"6 de julio de 1997"
14,8,41,1149,356,394,750,"6 de julio de 1997"
14,8,41,1150,562,645,1207,"6 de julio de 1997"
14,8,41,1151,617,757,1374,"6 de julio de 1997"
14,8,41,1152,518,633,1151,"6 de julio de 1997"
14,8,41,1153,550,614,1164,"6 de julio de 1997"
14,8,41,1154,540,647,1187,"6 de julio de 1997"
14,8,41,1155,313,443,756,"6 de julio de 1997"
14,8,41,1156,489,579,1068,"6 de julio de 1997"
14,8,41,1157,313,393,706,"6 de julio de 1997"
14,8,41,1158,324,400,724,"6 de julio de 1997"
14,8,41,1159,389,448,837,"6 de julio de 1997"
14,8,41,1160,257,363,620,"6 de julio de 1997"
14,8,41,1161,410,569,979,"6 de julio de 1997"
14,8,41,1162,463,555,1018,"6 de julio de 1997"
14,8,41,1163,499,599,1098,"6 de julio de 1997"
14,8,41,1164,578,647,1225,"6 de julio de 1997"
14,8,41,1165,438,538,976,"6 de julio de 1997"
14,8,41,1166,447,500,947,"6 de julio de 1997"
14,8,41,1167,268,338,606,"6 de julio de 1997"
14,8,41,1168,228,299,527,"6 de julio de 1997"
14,8,41,1169,386,463,849,"6 de julio de 1997"
14,8,41,1170,317,338,655,"6 de julio de 1997"
14,8,41,1171,423,509,932,"6 de julio de 1997"
14,8,41,1172,397,454,851,"6 de julio de 1997"
14,8,41,1173,352,422,774,"6 de julio de 1997"
14,8,41,1174,405,527,932,"6 de julio de 1997"
14,8,41,1175,481,606,1087,"6 de julio de 1997"
14,8,41,1176,571,665,1236,"6 de julio de 1997"
14,8,41,1177,486,566,1052,"6 de julio de 1997"
14,8,41,1178,420,439,859,"6 de julio de 1997"
14,8,41,1179,418,506,924,"6 de julio de 1997"
14,8,41,1180,610,692,1302,"6 de julio de 1997"
14,8,41,1181,205,265,470,"6 de julio de 1997"
14,8,41,1182,272,341,613,"6 de julio de 1997"
14,8,41,1183,261,327,588,"6 de julio de 1997"
14,8,41,1184,224,303,527,"6 de julio de 1997"
14,8,41,1185,294,349,643,"6 de julio de 1997"
14,8,41,1186,259,253,512,"6 de julio de 1997"
14,8,41,1187,843,924,1767,"6 de julio de 1997"
14,8,41,1188,696,773,1469,"6 de julio de 1997"
14,8,41,1189,615,681,1296,"6 de julio de 1997"
14,8,41,1192,714,762,1476,"6 de julio de 1997"
14,8,41,1193,884,1035,1919,"6 de julio de 1997"
14,8,41,1201,384,463,847,"6 de julio de 1997"
14,8,41,1202,459,500,959,"6 de julio de 1997"
14,8,41,1203,415,471,886,"6 de julio de 1997"
14,8,41,1204,790,815,1605,"6 de julio de 1997"
14,8,41,1205,658,696,1354,"6 de julio de 1997"
14,8,41,1206,671,774,1445,"6 de julio de 1997"
14,8,41,1207,923,1027,1950,"6 de julio de 1997"
14,8,41,1208,680,724,1404,"6 de julio de 1997"
14,8,41,1209,843,900,1743,"6 de julio de 1997"
14,8,41,1210,345,440,785,"6 de julio de 1997"
14,8,41,1211,521,620,1141,"6 de julio de 1997"
14,8,41,1212,475,510,985,"6 de julio de 1997"
14,8,41,1213,827,900,1727,"6 de julio de 1997"
14,8,41,1214,491,529,1020,"6 de julio de 1997"
14,8,41,1215,391,435,826,"6 de julio de 1997"
14,8,41,1216,929,1003,1932,"6 de julio de 1997"
14,8,41,1217,947,1031,1978,"6 de julio de 1997"
14,8,41,1218,731,818,1549,"6 de julio de 1997"
14,8,41,1219,636,784,1420,"6 de julio de 1997"
14,8,41,1220,627,711,1338,"6 de julio de 1997"
14,8,41,1221,588,609,1197,"6 de julio de 1997"
14,8,41,1247,670,832,1502,"6 de julio de 1997"
14,8,41,1248,494,595,1089,"6 de julio de 1997"
14,8,41,1249,738,802,1540,"6 de julio de 1997"
14,8,41,1250,473,531,1004,"6 de julio de 1997"
14,8,41,1251,427,499,926,"6 de julio de 1997"
14,8,41,1252,687,806,1493,"6 de julio de 1997"
14,8,41,1253,411,493,904,"6 de julio de 1997"
14,8,41,1254,450,512,962,"6 de julio de 1997"
14,8,41,1255,851,909,1760,"6 de julio de 1997"
14,8,41,1256,752,883,1635,"6 de julio de 1997"
14,8,41,1257,631,748,1379,"6 de julio de 1997"
14,8,41,1258,263,320,583,"6 de julio de 1997"
14,8,41,1259,211,258,469,"6 de julio de 1997"
14,8,41,1260,425,452,877,"6 de julio de 1997"
14,8,41,1261,638,785,1423,"6 de julio de 1997"
14,8,41,1294,381,484,865,"6 de julio de 1997"
14,8,41,1295,427,507,934,"6 de julio de 1997"
14,8,41,1296,600,707,1307,"6 de julio de 1997"
14,8,41,1297,609,776,1385,"6 de julio de 1997"
14,8,41,1298,522,620,1142,"6 de julio de 1997"
14,8,41,1299,349,473,822,"6 de julio de 1997"
14,8,41,1300,441,530,971,"6 de julio de 1997"
14,8,41,1301,433,530,963,"6 de julio de 1997"
14,8,41,1302,479,588,1067,"6 de julio de 1997"
14,8,41,1303,661,803,1464,"6 de julio de 1997"
14,8,41,1304,447,576,1023,"6 de julio de 1997"
14,8,41,1305,414,486,900,"6 de julio de 1997"
14,8,41,1306,427,495,922,"6 de julio de 1997"
14,8,41,1307,794,962,1756,"6 de julio de 1997"
14,8,41,1308,458,595,1053,"6 de julio de 1997"
14,8,41,1352,470,587,1057,"6 de julio de 1997"
14,8,41,1353,642,754,1396,"6 de julio de 1997"
14,8,41,1354,340,449,789,"6 de julio de 1997"
14,8,41,1355,565,677,1242,"6 de julio de 1997"
14,8,41,1356,524,644,1168,"6 de julio de 1997"
14,8,41,1357,641,786,1427,"6 de julio de 1997"
14,8,41,1358,683,847,1530,"6 de julio de 1997"
14,8,41,1359,525,649,1174,"6 de julio de 1997"
14,8,41,1360,520,714,1234,"6 de julio de 1997"
14,8,41,1361,615,789,1404,"6 de julio de 1997"
14,9,41,633,494,522,1016,"6 de julio de 1997"
14,9,41,634,415,490,905,"6 de julio de 1997"
14,9,41,635,493,511,1004,"6 de julio de 1997"
14,9,41,636,417,473,890,"6 de julio de 1997"
14,9,41,637,698,816,1514,"6 de julio de 1997"
14,9,41,638,836,952,1788,"6 de julio de 1997"
14,9,41,639,477,514,991,"6 de julio de 1997"
14,9,41,641,546,610,1156,"6 de julio de 1997"
14,9,41,642,506,535,1041,"6 de julio de 1997"
14,9,41,643,430,492,922,"6 de julio de 1997"
14,9,41,644,436,507,943,"6 de julio de 1997"
14,9,41,645,587,658,1245,"6 de julio de 1997"
14,9,41,646,507,535,1042,"6 de julio de 1997"
14,9,41,647,534,629,1163,"6 de julio de 1997"
14,9,41,648,445,493,938,"6 de julio de 1997"
14,9,41,649,419,497,916,"6 de julio de 1997"
14,9,41,650,492,565,1057,"6 de julio de 1997"
14,9,41,651,446,545,991,"6 de julio de 1997"
14,9,41,652,478,500,978,"6 de julio de 1997"
14,9,41,1190,463,483,946,"6 de julio de 1997"
14,9,41,1191,477,490,967,"6 de julio de 1997"
14,9,41,1194,821,954,1775,"6 de julio de 1997"
14,9,41,1195,451,515,966,"6 de julio de 1997"
14,9,41,1196,519,630,1149,"6 de julio de 1997"
14,9,41,1197,553,636,1189,"6 de julio de 1997"
14,9,41,1198,429,480,909,"6 de julio de 1997"
14,9,41,1199,474,506,980,"6 de julio de 1997"
14,9,41,1200,763,848,1611,"6 de julio de 1997"
14,9,41,1222,345,394,739,"6 de julio de 1997"
14,9,41,1223,431,512,943,"6 de julio de 1997"
14,9,41,1224,1111,1227,2338,"6 de julio de 1997"
14,9,41,1225,524,578,1102,"6 de julio de 1997"
14,9,41,1226,408,474,882,"6 de julio de 1997"
14,9,41,1227,515,582,1097,"6 de julio de 1997"
14,9,41,1228,548,596,1144,"6 de julio de 1997"
14,9,41,1229,541,530,1071,"6 de julio de 1997"
14,9,41,1230,501,553,1054,"6 de julio de 1997"
14,9,41,1231,434,502,936,"6 de julio de 1997"
14,9,41,1232,402,427,829,"6 de julio de 1997"
14,9,41,1233,580,625,1205,"6 de julio de 1997"
14,9,41,1234,783,841,1624,"6 de julio de 1997"
14,9,41,1235,734,803,1537,"6 de julio de 1997"
14,9,41,1236,779,835,1614,"6 de julio de 1997"
14,9,41,1237,725,797,1522,"6 de julio de 1997"
14,9,41,1238,754,867,1621,"6 de julio de 1997"
14,9,41,1239,551,599,1150,"6 de julio de 1997"
14,9,41,1240,537,573,1110,"6 de julio de 1997"
14,9,41,1241,453,511,964,"6 de julio de 1997"
14,9,41,1242,992,1069,2061,"6 de julio de 1997"
14,9,41,1243,765,847,1612,"6 de julio de 1997"
14,9,41,1244,635,798,1433,"6 de julio de 1997"
14,9,41,1245,421,510,931,"6 de julio de 1997"
14,9,41,1246,448,508,956,"6 de julio de 1997"
14,9,41,1262,801,900,1701,"6 de julio de 1997"
14,9,41,1263,392,424,816,"6 de julio de 1997"
14,9,41,1264,417,431,848,"6 de julio de 1997"
14,9,41,1265,630,732,1362,"6 de julio de 1997"
14,9,41,1266,548,582,1130,"6 de julio de 1997"
14,9,41,1267,711,774,1485,"6 de julio de 1997"
14,9,41,1268,545,597,1142,"6 de julio de 1997"
14,9,41,1269,634,708,1342,"6 de julio de 1997"
14,9,41,1270,760,845,1605,"6 de julio de 1997"
14,9,41,1271,693,772,1465,"6 de julio de 1997"
14,9,41,1272,782,849,1631,"6 de julio de 1997"
14,9,41,1273,774,890,1664,"6 de julio de 1997"
14,9,41,1274,650,741,1391,"6 de julio de 1997"
14,9,41,1275,503,600,1103,"6 de julio de 1997"
14,9,41,1276,453,521,974,"6 de julio de 1997"
14,9,41,1277,540,662,1202,"6 de julio de 1997"
14,9,41,1278,796,843,1639,"6 de julio de 1997"
14,9,41,1279,605,651,1256,"6 de julio de 1997"
14,9,41,1280,767,807,1574,"6 de julio de 1997"
14,9,41,1281,460,534,994,"6 de julio de 1997"
14,9,41,1282,363,399,762,"6 de julio de 1997"
14,9,41,1283,797,833,1630,"6 de julio de 1997"
14,9,41,1284,449,506,955,"6 de julio de 1997"
14,9,41,1285,377,454,831,"6 de julio de 1997"
14,9,41,1286,492,542,1034,"6 de julio de 1997"
14,9,41,1287,473,481,954,"6 de julio de 1997"
14,9,41,1288,804,880,1684,"6 de julio de 1997"
14,9,41,1289,583,651,1234,"6 de julio de 1997"
14,9,41,1290,529,550,1079,"6 de julio de 1997"
14,9,41,1291,615,660,1275,"6 de julio de 1997"
14,9,41,1292,746,778,1524,"6 de julio de 1997"
14,9,41,1293,671,800,1471,"6 de julio de 1997"
14,9,41,1309,722,919,1641,"6 de julio de 1997"
14,9,41,1310,732,878,1610,"6 de julio de 1997"
14,9,41,1311,461,502,963,"6 de julio de 1997"
14,9,41,1312,396,490,886,"6 de julio de 1997"
14,9,41,1313,471,482,953,"6 de julio de 1997"
14,9,41,1314,356,387,743,"6 de julio de 1997"
14,9,41,1315,607,705,1312,"6 de julio de 1997"
14,9,41,1316,390,492,882,"6 de julio de 1997"
14,9,41,1317,491,582,1073,"6 de julio de 1997"
14,9,41,1318,709,761,1470,"6 de julio de 1997"
14,9,41,1319,713,811,1524,"6 de julio de 1997"
14,9,41,1320,676,758,1434,"6 de julio de 1997"
14,9,41,1321,550,599,1149,"6 de julio de 1997"
14,9,41,1322,428,470,898,"6 de julio de 1997"
14,9,41,1323,545,603,1148,"6 de julio de 1997"
14,9,41,1324,567,584,1151,"6 de julio de 1997"
14,9,41,1325,446,502,948,"6 de julio de 1997"
14,9,41,1326,442,488,930,"6 de julio de 1997"
14,9,41,1327,809,912,1721,"6 de julio de 1997"
14,9,41,1328,732,776,1508,"6 de julio de 1997"
14,9,41,1329,422,473,895,"6 de julio de 1997"
14,9,41,1330,761,861,1622,"6 de julio de 1997"
14,9,41,1331,944,1033,1977,"6 de julio de 1997"
14,9,41,1332,869,907,1776,"6 de julio de 1997"
14,9,41,1333,850,974,1824,"6 de julio de 1997"
14,9,41,1334,509,512,1021,"6 de julio de 1997"
14,9,41,1335,497,538,1035,"6 de julio de 1997"
14,9,41,1336,871,910,1781,"6 de julio de 1997"
14,9,41,1337,571,662,1233,"6 de julio de 1997"
14,9,41,1338,531,589,1120,"6 de julio de 1997"
14,9,41,1339,609,662,1271,"6 de julio de 1997"
14,9,41,1340,802,903,1705,"6 de julio de 1997"
14,9,41,1341,588,742,1330,"6 de julio de 1997"
14,9,41,1342,656,748,1404,"6 de julio de 1997"
14,9,41,1343,715,828,1543,"6 de julio de 1997"
14,9,41,1344,674,690,1364,"6 de julio de 1997"
14,9,41,1345,754,847,1601,"6 de julio de 1997"
14,9,41,1346,700,776,1476,"6 de julio de 1997"
14,9,41,1347,853,900,1753,"6 de julio de 1997"
14,9,41,1348,571,673,1244,"6 de julio de 1997"
14,9,41,1349,597,671,1268,"6 de julio de 1997"
14,9,41,1350,480,547,1027,"6 de julio de 1997"
14,9,41,1351,565,675,1240,"6 de julio de 1997"
14,9,41,1362,415,457,872,"6 de julio de 1997"
14,9,41,1363,401,457,858,"6 de julio de 1997"
14,9,41,1364,607,705,1312,"6 de julio de 1997"
14,9,41,1365,679,745,1424,"6 de julio de 1997"
14,9,41,1366,465,519,984,"6 de julio de 1997"
14,9,41,1367,489,487,976,"6 de julio de 1997"
14,9,41,1368,457,544,1001,"6 de julio de 1997"
14,9,41,1369,374,386,760,"6 de julio de 1997"
14,9,41,1370,428,480,908,"6 de julio de 1997"
14,9,41,1371,795,852,1647,"6 de julio de 1997"
14,9,41,1372,513,575,1088,"6 de julio de 1997"
14,9,41,1373,637,749,1386,"6 de julio de 1997"
14,10,120,3067,983,1089,2072,"6 de julio de 1997"
14,10,120,3077,937,1035,1972,"6 de julio de 1997"
14,10,120,3078,677,840,1517,"6 de julio de 1997"
14,10,120,3079,1028,1195,2223,"6 de julio de 1997"
14,10,120,3080,676,779,1455,"6 de julio de 1997"
14,10,120,3081,383,454,837,"6 de julio de 1997"
14,10,120,3082,845,988,1833,"6 de julio de 1997"
14,10,120,3083,689,827,1516,"6 de julio de 1997"
14,10,120,3084,509,651,1160,"6 de julio de 1997"
14,10,120,3088,526,664,1190,"6 de julio de 1997"
14,10,120,3089,429,533,962,"6 de julio de 1997"
14,10,120,3090,580,774,1354,"6 de julio de 1997"
14,10,120,3091,634,781,1415,"6 de julio de 1997"
14,10,120,3092,779,927,1706,"6 de julio de 1997"
14,10,120,3093,574,697,1271,"6 de julio de 1997"
14,10,120,3094,718,849,1567,"6 de julio de 1997"
14,10,120,3095,670,759,1429,"6 de julio de 1997"
14,10,120,3096,517,548,1065,"6 de julio de 1997"
14,10,120,3097,701,750,1451,"6 de julio de 1997"
14,10,120,3098,625,683,1308,"6 de julio de 1997"
14,10,120,3099,516,533,1049,"6 de julio de 1997"
14,10,120,3100,727,763,1490,"6 de julio de 1997"
14,10,120,3101,587,686,1273,"6 de julio de 1997"
14,10,120,3102,527,676,1203,"6 de julio de 1997"
14,10,120,3103,899,1105,2004,"6 de julio de 1997"
14,10,120,3104,767,945,1712,"6 de julio de 1997"
14,10,120,3105,579,751,1330,"6 de julio de 1997"
14,10,120,3106,876,1011,1887,"6 de julio de 1997"
14,10,120,3107,634,779,1413,"6 de julio de 1997"
14,10,120,3108,676,922,1598,"6 de julio de 1997"
14,10,120,3109,364,382,746,"6 de julio de 1997"
14,10,120,3110,651,786,1437,"6 de julio de 1997"
14,10,120,3111,918,1043,1961,"6 de julio de 1997"
14,10,120,3112,917,1082,1999,"6 de julio de 1997"
14,10,120,3113,810,929,1739,"6 de julio de 1997"
14,10,120,3114,1063,1149,2212,"6 de julio de 1997"
14,10,120,3115,646,776,1422,"6 de julio de 1997"
14,10,120,3123,421,493,914,"6 de julio de 1997"
14,10,120,3124,623,708,1331,"6 de julio de 1997"
14,10,120,3125,558,760,1318,"6 de julio de 1997"
14,10,120,3126,1283,1456,2739,"6 de julio de 1997"
14,10,120,3127,484,593,1077,"6 de julio de 1997"
14,10,120,3128,467,571,1038,"6 de julio de 1997"
14,10,120,3129,1184,1390,2574,"6 de julio de 1997"
14,10,120,3130,871,1019,1890,"6 de julio de 1997"
14,10,120,3131,688,731,1419,"6 de julio de 1997"
14,10,120,3132,1173,1304,2477,"6 de julio de 1997"
14,10,120,3133,697,944,1641,"6 de julio de 1997"
14,10,120,3134,511,573,1084,"6 de julio de 1997"
14,10,120,3135,505,668,1173,"6 de julio de 1997"
14,10,120,3136,464,526,990,"6 de julio de 1997"
14,10,120,3137,451,579,1030,"6 de julio de 1997"
14,10,120,3138,484,600,1084,"6 de julio de 1997"
14,10,120,3139,495,644,1139,"6 de julio de 1997"
14,10,120,3140,549,626,1175,"6 de julio de 1997"
14,10,120,3141,611,750,1361,"6 de julio de 1997"
14,10,120,3142,550,628,1178,"6 de julio de 1997"
14,10,120,3143,712,828,1540,"6 de julio de 1997"
14,10,120,3144,819,1035,1854,"6 de julio de 1997"
14,10,120,3145,682,849,1531,"6 de julio de 1997"
14,10,120,3146,606,812,1418,"6 de julio de 1997"
14,10,120,3147,1098,1258,2356,"6 de julio de 1997"
14,10,120,3148,887,934,1821,"6 de julio de 1997"
14,10,120,3149,667,771,1438,"6 de julio de 1997"
14,10,120,3161,434,517,951,"6 de julio de 1997"
14,10,120,3162,518,623,1141,"6 de julio de 1997"
14,10,120,3163,641,783,1424,"6 de julio de 1997"
14,10,120,3164,377,485,862,"6 de julio de 1997"
14,10,120,3165,397,456,853,"6 de julio de 1997"
14,10,120,3166,626,742,1368,"6 de julio de 1997"
14,10,120,3167,916,1066,1982,"6 de julio de 1997"
14,10,120,3168,912,1067,1979,"6 de julio de 1997"
14,10,120,3169,486,555,1041,"6 de julio de 1997"
14,10,120,3170,875,1004,1879,"6 de julio de 1997"
14,10,120,3171,691,734,1425,"6 de julio de 1997"
14,10,120,3172,914,1030,1944,"6 de julio de 1997"
14,10,120,3173,890,984,1874,"6 de julio de 1997"
14,10,120,3174,694,751,1445,"6 de julio de 1997"
14,10,120,3175,805,882,1687,"6 de julio de 1997"
14,10,120,3176,737,835,1572,"6 de julio de 1997"
14,10,120,3177,644,799,1443,"6 de julio de 1997"
14,10,120,3178,614,704,1318,"6 de julio de 1997"
14,10,120,3179,674,760,1434,"6 de julio de 1997"
14,10,120,3180,613,778,1391,"6 de julio de 1997"
14,10,120,3181,622,733,1355,"6 de julio de 1997"
14,10,120,3182,544,697,1241,"6 de julio de 1997"
14,10,120,3183,502,615,1117,"6 de julio de 1997"
14,10,120,3184,474,581,1055,"6 de julio de 1997"
14,10,120,3185,554,671,1225,"6 de julio de 1997"
14,10,120,3186,595,707,1302,"6 de julio de 1997"
14,10,120,3187,802,930,1732,"6 de julio de 1997"
14,10,120,3188,792,927,1719,"6 de julio de 1997"
14,10,120,3189,688,827,1515,"6 de julio de 1997"
14,10,120,3190,502,568,1070,"6 de julio de 1997"
14,10,120,3191,489,529,1018,"6 de julio de 1997"
14,10,120,3192,557,675,1232,"6 de julio de 1997"
14,10,120,3193,440,533,973,"6 de julio de 1997"
14,10,120,3194,687,777,1464,"6 de julio de 1997"
14,10,120,3195,624,732,1356,"6 de julio de 1997"
14,10,120,3196,611,768,1379,"6 de julio de 1997"
14,10,120,3197,586,687,1273,"6 de julio de 1997"
14,10,120,3198,761,832,1593,"6 de julio de 1997"
14,10,120,3199,890,950,1840,"6 de julio de 1997"
14,10,120,3200,1499,1698,3197,"6 de julio de 1997"
14,10,120,3201,1313,1592,2905,"6 de julio de 1997"
14,10,120,3202,566,699,1265,"6 de julio de 1997"
14,10,120,3203,292,360,652,"6 de julio de 1997"
14,10,120,3204,546,684,1230,"6 de julio de 1997"
14,10,120,3205,514,579,1093,"6 de julio de 1997"
14,11,41,640,442,497,939,"6 de julio de 1997"
14,11,41,653,463,525,988,"6 de julio de 1997"
14,11,41,654,333,409,742,"6 de julio de 1997"
14,11,41,655,243,292,535,"6 de julio de 1997"
14,11,41,656,310,365,675,"6 de julio de 1997"
14,11,41,657,105,129,234,"6 de julio de 1997"
14,11,41,658,117,141,258,"6 de julio de 1997"
14,11,41,659,165,199,364,"6 de julio de 1997"
14,11,41,660,320,341,661,"6 de julio de 1997"
14,11,41,661,545,611,1156,"6 de julio de 1997"
14,11,41,662,497,493,990,"6 de julio de 1997"
14,11,41,663,710,780,1490,"6 de julio de 1997"
14,11,41,664,727,800,1527,"6 de julio de 1997"
14,11,41,665,864,922,1786,"6 de julio de 1997"
14,11,41,666,656,693,1349,"6 de julio de 1997"
14,11,41,667,612,751,1363,"6 de julio de 1997"
14,11,41,668,502,603,1105,"6 de julio de 1997"
14,11,41,669,685,802,1487,"6 de julio de 1997"
14,11,41,670,434,490,924,"6 de julio de 1997"
14,11,41,671,368,420,788,"6 de julio de 1997"
14,11,41,672,563,632,1195,"6 de julio de 1997"
14,11,41,673,630,720,1350,"6 de julio de 1997"
14,11,41,674,691,766,1457,"6 de julio de 1997"
14,11,41,675,476,569,1045,"6 de julio de 1997"
14,11,41,676,476,542,1018,"6 de julio de 1997"
14,11,41,677,520,569,1089,"6 de julio de 1997"
14,11,41,678,426,497,923,"6 de julio de 1997"
14,11,41,679,550,637,1187,"6 de julio de 1997"
14,11,41,680,537,665,1202,"6 de julio de 1997"
14,11,41,681,460,544,1004,"6 de julio de 1997"
14,11,41,682,457,509,966,"6 de julio de 1997"
14,11,41,683,579,689,1268,"6 de julio de 1997"
14,11,41,684,628,765,1393,"6 de julio de 1997"
14,11,41,685,584,689,1273,"6 de julio de 1997"
14,11,41,686,509,574,1083,"6 de julio de 1997"
14,11,41,687,531,610,1141,"6 de julio de 1997"
14,11,41,688,533,622,1155,"6 de julio de 1997"
14,11,41,689,367,416,783,"6 de julio de 1997"
14,11,41,690,540,562,1102,"6 de julio de 1997"
14,11,41,691,580,656,1236,"6 de julio de 1997"
14,11,41,692,590,700,1290,"6 de julio de 1997"
14,11,41,693,534,639,1173,"6 de julio de 1997"
14,11,41,694,531,554,1085,"6 de julio de 1997"
14,11,41,695,649,693,1342,"6 de julio de 1997"
14,11,41,696,702,833,1535,"6 de julio de 1997"
14,11,41,697,553,651,1204,"6 de julio de 1997"
14,11,41,698,505,527,1032,"6 de julio de 1997"
14,11,41,699,654,705,1359,"6 de julio de 1997"
14,11,41,700,635,643,1278,"6 de julio de 1997"
14,11,41,701,664,842,1506,"6 de julio de 1997"
14,11,41,702,482,575,1057,"6 de julio de 1997"
14,11,41,703,504,577,1081,"6 de julio de 1997"
14,11,41,704,496,567,1063,"6 de julio de 1997"
14,11,41,705,562,586,1148,"6 de julio de 1997"
14,11,41,706,445,516,961,"6 de julio de 1997"
14,11,41,707,324,376,700,"6 de julio de 1997"
14,11,41,708,350,427,777,"6 de julio de 1997"
14,11,41,709,329,414,743,"6 de julio de 1997"
14,11,41,710,834,914,1748,"6 de julio de 1997"
14,11,41,711,354,389,743,"6 de julio de 1997"
14,11,41,712,939,995,1934,"6 de julio de 1997"
14,11,41,713,427,531,958,"6 de julio de 1997"
14,11,41,714,408,443,851,"6 de julio de 1997"
14,11,41,715,318,338,656,"6 de julio de 1997"
14,11,41,716,593,644,1237,"6 de julio de 1997"
14,11,41,717,630,667,1297,"6 de julio de 1997"
14,11,41,718,513,576,1089,"6 de julio de 1997"
14,11,41,719,419,443,862,"6 de julio de 1997"
14,11,41,720,599,646,1245,"6 de julio de 1997"
14,11,41,721,464,538,1002,"6 de julio de 1997"
14,11,41,722,510,521,1031,"6 de julio de 1997"
14,11,41,723,554,563,1117,"6 de julio de 1997"
14,11,41,724,962,993,1955,"6 de julio de 1997"
14,11,41,725,679,745,1424,"6 de julio de 1997"
14,11,41,726,710,785,1495,"6 de julio de 1997"
14,11,41,727,728,768,1496,"6 de julio de 1997"
14,11,41,728,600,658,1258,"6 de julio de 1997"
14,11,41,729,632,716,1348,"6 de julio de 1997"
14,11,41,730,854,913,1767,"6 de julio de 1997"
14,11,41,1009,314,430,744,"6 de julio de 1997"
14,11,41,1010,361,443,804,"6 de julio de 1997"
14,11,41,1011,589,747,1336,"6 de julio de 1997"
14,11,41,1012,492,602,1094,"6 de julio de 1997"
14,11,41,1013,449,534,983,"6 de julio de 1997"
14,11,41,1014,530,627,1157,"6 de julio de 1997"
14,11,41,1015,368,432,800,"6 de julio de 1997"
14,11,41,1016,332,377,709,"6 de julio de 1997"
14,11,41,1374,418,455,873,"6 de julio de 1997"
14,11,41,1375,379,454,833,"6 de julio de 1997"
14,11,41,1376,537,641,1178,"6 de julio de 1997"
14,11,41,1377,502,588,1090,"6 de julio de 1997"
14,11,41,1378,807,908,1715,"6 de julio de 1997"
14,11,41,1379,719,809,1528,"6 de julio de 1997"
14,11,41,1380,361,402,763,"6 de julio de 1997"
14,11,41,1381,450,473,923,"6 de julio de 1997"
14,11,41,1382,463,517,980,"6 de julio de 1997"
14,11,41,1383,376,464,840,"6 de julio de 1997"
14,11,41,1384,423,456,879,"6 de julio de 1997"
14,11,41,1385,829,910,1739,"6 de julio de 1997"
14,11,41,1386,472,516,988,"6 de julio de 1997"
14,11,41,1387,769,906,1675,"6 de julio de 1997"
14,11,41,1388,442,508,950,"6 de julio de 1997"
14,11,41,1389,797,860,1657,"6 de julio de 1997"
14,11,41,1390,449,540,989,"6 de julio de 1997"
14,11,41,1391,454,513,967,"6 de julio de 1997"
14,11,41,1392,441,478,919,"6 de julio de 1997"
14,11,41,1393,531,538,1069,"6 de julio de 1997"
14,11,41,1394,489,561,1050,"6 de julio de 1997"
14,11,41,1395,649,688,1337,"6 de julio de 1997"
14,11,41,1396,521,548,1069,"6 de julio de 1997"
14,11,41,1397,883,1005,1888,"6 de julio de 1997"
14,11,41,1398,361,400,761,"6 de julio de 1997"
14,11,41,1399,628,656,1284,"6 de julio de 1997"
14,11,41,1400,634,780,1414,"6 de julio de 1997"
14,11,41,1401,718,781,1499,"6 de julio de 1997"
14,11,41,1402,628,755,1383,"6 de julio de 1997"
14,11,41,1403,816,925,1741,"6 de julio de 1997"
14,11,41,1404,493,549,1042,"6 de julio de 1997"
14,11,41,1405,601,646,1247,"6 de julio de 1997"
14,11,41,1406,464,505,969,"6 de julio de 1997"
14,11,41,1407,554,654,1208,"6 de julio de 1997"
14,11,41,1408,651,723,1374,"6 de julio de 1997"
14,11,41,1409,555,676,1231,"6 de julio de 1997"
14,11,41,1410,477,523,1000,"6 de julio de 1997"
14,11,41,1411,603,646,1249,"6 de julio de 1997"
14,11,41,1412,543,620,1163,"6 de julio de 1997"
14,11,41,1413,770,796,1566,"6 de julio de 1997"
14,11,41,1414,508,565,1073,"6 de julio de 1997"
14,11,41,1415,599,671,1270,"6 de julio de 1997"
14,11,41,1416,747,899,1646,"6 de julio de 1997"
14,11,41,1417,757,829,1586,"6 de julio de 1997"
14,11,41,1418,538,563,1101,"6 de julio de 1997"
14,11,41,1419,472,496,968,"6 de julio de 1997"
14,11,41,1420,510,524,1034,"6 de julio de 1997"
14,11,41,1421,498,530,1028,"6 de julio de 1997"
14,11,41,1422,504,546,1050,"6 de julio de 1997"
14,11,41,1423,466,569,1035,"6 de julio de 1997"
14,11,41,1424,602,615,1217,"6 de julio de 1997"
14,11,41,1425,479,513,992,"6 de julio de 1997"
14,11,41,1426,470,508,978,"6 de julio de 1997"
14,11,41,1427,515,618,1133,"6 de julio de 1997"
14,11,41,1428,569,601,1170,"6 de julio de 1997"
14,11,41,1429,439,527,966,"6 de julio de 1997"
14,11,41,1430,499,530,1029,"6 de julio de 1997"
14,11,41,1431,666,742,1408,"6 de julio de 1997"
14,11,41,1432,359,426,785,"6 de julio de 1997"
14,11,41,1433,455,485,940,"6 de julio de 1997"
14,11,41,1434,520,575,1095,"6 de julio de 1997"
14,11,41,1435,709,788,1497,"6 de julio de 1997"
14,11,41,1436,670,792,1462,"6 de julio de 1997"
14,11,41,1437,408,474,882,"6 de julio de 1997"
14,11,41,1438,359,432,791,"6 de julio de 1997"
14,11,41,1459,788,906,1694,"6 de julio de 1997"
14,11,41,1463,437,468,905,"6 de julio de 1997"
14,11,41,1464,495,545,1040,"6 de julio de 1997"
14,12,41,570,307,418,725,"6 de julio de 1997"
14,12,41,571,270,341,611,"6 de julio de 1997"
14,12,41,572,405,481,886,"6 de julio de 1997"
14,12,41,573,319,408,727,"6 de julio de 1997"
14,12,41,574,310,424,734,"6 de julio de 1997"
14,12,41,575,295,381,676,"6 de julio de 1997"
14,12,41,576,334,412,746,"6 de julio de 1997"
14,12,41,577,316,389,705,"6 de julio de 1997"
14,12,41,578,493,582,1075,"6 de julio de 1997"
14,12,41,579,373,453,826,"6 de julio de 1997"
14,12,41,580,269,349,618,"6 de julio de 1997"
14,12,41,581,376,443,819,"6 de julio de 1997"
14,12,41,582,503,601,1104,"6 de julio de 1997"
14,12,41,583,234,285,519,"6 de julio de 1997"
14,12,41,584,369,450,819,"6 de julio de 1997"
14,12,41,585,328,384,712,"6 de julio de 1997"
14,12,41,586,571,729,1300,"6 de julio de 1997"
14,12,41,587,657,768,1425,"6 de julio de 1997"
14,12,41,588,382,488,870,"6 de julio de 1997"
14,12,41,589,383,457,840,"6 de julio de 1997"
14,12,41,590,400,562,962,"6 de julio de 1997"
14,12,41,591,319,380,699,"6 de julio de 1997"
14,12,41,592,367,444,811,"6 de julio de 1997"
14,12,41,593,505,609,1114,"6 de julio de 1997"
14,12,41,594,356,502,858,"6 de julio de 1997"
14,12,41,595,267,357,624,"6 de julio de 1997"
14,12,41,596,341,456,797,"6 de julio de 1997"
14,12,41,597,278,385,663,"6 de julio de 1997"
14,12,41,598,256,318,574,"6 de julio de 1997"
14,12,41,599,413,536,949,"6 de julio de 1997"
14,12,41,600,555,734,1289,"6 de julio de 1997"
14,12,41,601,500,665,1165,"6 de julio de 1997"
14,12,41,602,523,687,1210,"6 de julio de 1997"
14,12,41,603,358,431,789,"6 de julio de 1997"
14,12,41,604,309,407,716,"6 de julio de 1997"
14,12,41,605,356,466,822,"6 de julio de 1997"
14,12,41,606,266,354,620,"6 de julio de 1997"
14,12,41,607,272,404,676,"6 de julio de 1997"
14,12,41,608,375,501,876,"6 de julio de 1997"
14,12,41,609,535,611,1146,"6 de julio de 1997"
14,12,41,610,274,359,633,"6 de julio de 1997"
14,12,41,611,368,460,828,"6 de julio de 1997"
14,12,41,612,408,471,879,"6 de julio de 1997"
14,12,41,613,423,478,901,"6 de julio de 1997"
14,12,41,614,466,577,1043,"6 de julio de 1997"
14,12,41,615,286,346,632,"6 de julio de 1997"
14,12,41,616,492,566,1058,"6 de julio de 1997"
14,12,41,617,392,469,861,"6 de julio de 1997"
14,12,41,618,357,394,751,"6 de julio de 1997"
14,12,41,619,215,245,460,"6 de julio de 1997"
14,12,41,620,256,309,565,"6 de julio de 1997"
14,12,41,621,594,453,1047,"6 de julio de 1997"
14,12,41,622,514,527,1041,"6 de julio de 1997"
14,12,41,623,293,361,654,"6 de julio de 1997"
14,12,41,624,407,486,893,"6 de julio de 1997"
14,12,41,625,249,307,556,"6 de julio de 1997"
14,12,41,626,330,482,812,"6 de julio de 1997"
14,12,41,627,367,485,852,"6 de julio de 1997"
14,12,41,628,365,442,807,"6 de julio de 1997"
14,12,41,629,250,345,595,"6 de julio de 1997"
14,12,41,630,492,575,1067,"6 de julio de 1997"
14,12,41,631,515,671,1186,"6 de julio de 1997"
14,12,41,632,256,361,617,"6 de julio de 1997"
14,12,41,757,311,403,714,"6 de julio de 1997"
14,12,41,758,392,493,885,"6 de julio de 1997"
14,12,41,759,571,719,1290,"6 de julio de 1997"
14,12,41,760,505,661,1166,"6 de julio de 1997"
14,12,41,761,427,535,962,"6 de julio de 1997"
14,12,41,762,518,638,1156,"6 de julio de 1997"
14,12,41,763,405,582,987,"6 de julio de 1997"
14,12,41,764,341,419,760,"6 de julio de 1997"
14,12,41,765,254,353,607,"6 de julio de 1997"
14,12,41,766,529,722,1251,"6 de julio de 1997"
14,12,41,767,373,501,874,"6 de julio de 1997"
14,12,41,768,341,433,774,"6 de julio de 1997"
14,12,41,769,425,568,993,"6 de julio de 1997"
14,12,41,770,447,476,923,"6 de julio de 1997"
14,12,41,771,657,732,1389,"6 de julio de 1997"
14,12,41,772,374,434,808,"6 de julio de 1997"
14,12,41,773,442,507,949,"6 de julio de 1997"
14,12,41,774,412,502,914,"6 de julio de 1997"
14,12,41,775,351,386,737,"6 de julio de 1997"
14,12,41,776,405,457,862,"6 de julio de 1997"
14,12,41,777,601,740,1341,"6 de julio de 1997"
14,12,41,778,581,637,1218,"6 de julio de 1997"
14,12,41,779,551,658,1209,"6 de julio de 1997"
14,12,41,780,497,569,1066,"6 de julio de 1997"
14,12,41,781,330,440,770,"6 de julio de 1997"
14,12,41,782,420,497,917,"6 de julio de 1997"
14,12,41,783,469,495,964,"6 de julio de 1997"
14,12,41,784,708,850,1558,"6 de julio de 1997"
14,12,41,785,328,429,757,"6 de julio de 1997"
14,12,41,786,325,421,746,"6 de julio de 1997"
14,12,41,787,579,652,1231,"6 de julio de 1997"
14,12,41,788,722,815,1537,"6 de julio de 1997"
14,12,41,789,557,763,1320,"6 de julio de 1997"
14,12,41,790,642,759,1401,"6 de julio de 1997"
14,12,41,795,475,499,974,"6 de julio de 1997"
14,12,41,796,551,581,1132,"6 de julio de 1997"
14,12,41,797,710,740,1450,"6 de julio de 1997"
14,12,41,798,667,737,1404,"6 de julio de 1997"
14,12,41,799,842,963,1805,"6 de julio de 1997"
14,12,41,800,354,382,736,"6 de julio de 1997"
14,12,41,801,363,435,798,"6 de julio de 1997"
14,12,41,802,453,531,984,"6 de julio de 1997"
14,12,41,803,419,506,925,"6 de julio de 1997"
14,12,41,804,445,552,997,"6 de julio de 1997"
14,12,41,805,530,648,1178,"6 de julio de 1997"
14,12,41,806,525,566,1091,"6 de julio de 1997"
14,12,41,807,833,914,1747,"6 de julio de 1997"
14,12,41,808,719,837,1556,"6 de julio de 1997"
14,12,41,809,730,873,1603,"6 de julio de 1997"
14,12,41,810,775,941,1716,"6 de julio de 1997"
14,12,41,811,501,633,1134,"6 de julio de 1997"
14,12,41,812,504,542,1046,"6 de julio de 1997"
14,12,41,813,775,910,1685,"6 de julio de 1997"
14,12,41,814,578,624,1202,"6 de julio de 1997"
14,12,41,815,440,484,924,"6 de julio de 1997"
14,12,41,816,687,782,1469,"6 de julio de 1997"
14,12,41,817,449,498,947,"6 de julio de 1997"
14,12,41,818,391,445,836,"6 de julio de 1997"
14,12,41,819,435,476,911,"6 de julio de 1997"
14,12,41,820,391,465,856,"6 de julio de 1997"
14,12,41,821,762,881,1643,"6 de julio de 1997"
14,12,41,830,718,880,1598,"6 de julio de 1997"
14,12,41,831,699,822,1521,"6 de julio de 1997"
14,12,41,832,787,907,1694,"6 de julio de 1997"
14,12,41,833,693,832,1525,"6 de julio de 1997"
14,12,41,834,640,736,1376,"6 de julio de 1997"
14,12,41,835,699,825,1524,"6 de julio de 1997"
14,12,41,836,524,636,1160,"6 de julio de 1997"
14,12,41,837,577,664,1241,"6 de julio de 1997"
14,12,41,838,611,719,1330,"6 de julio de 1997"
14,12,41,886,797,924,1721,"6 de julio de 1997"
14,12,41,887,839,1026,1865,"6 de julio de 1997"
14,12,41,888,708,849,1557,"6 de julio de 1997"
14,12,41,889,411,495,906,"6 de julio de 1997"
14,12,41,890,472,573,1045,"6 de julio de 1997"
14,12,41,891,751,826,1577,"6 de julio de 1997"
14,12,41,892,448,561,1009,"6 de julio de 1997"
14,12,41,893,881,1017,1898,"6 de julio de 1997"
14,12,41,894,784,895,1679,"6 de julio de 1997"
14,12,41,910,616,687,1303,"6 de julio de 1997"
14,12,41,911,778,907,1685,"6 de julio de 1997"
14,12,41,912,515,575,1090,"6 de julio de 1997"
14,12,41,913,545,633,1178,"6 de julio de 1997"
14,12,41,914,631,743,1374,"6 de julio de 1997"
14,12,41,915,451,503,954,"6 de julio de 1997"
14,12,41,916,488,569,1057,"6 de julio de 1997"
14,12,41,1050,310,348,658,"6 de julio de 1997"
14,12,41,1051,235,254,489,"6 de julio de 1997"
14,12,41,1052,279,364,643,"6 de julio de 1997"
14,12,41,1053,349,367,716,"6 de julio de 1997"
14,12,41,1054,263,319,582,"6 de julio de 1997"
14,12,41,1055,182,199,381,"6 de julio de 1997"
14,12,41,1056,362,439,801,"6 de julio de 1997"
14,12,41,1057,161,228,389,"6 de julio de 1997"
14,12,41,1058,441,550,991,"6 de julio de 1997"
14,12,41,1059,220,295,515,"6 de julio de 1997"
14,12,41,1060,210,267,477,"6 de julio de 1997"
14,12,41,1061,467,556,1023,"6 de julio de 1997"
14,12,41,1062,378,520,898,"6 de julio de 1997"
14,12,41,1063,195,230,425,"6 de julio de 1997"
14,12,41,1064,366,480,846,"6 de julio de 1997"
14,12,41,1065,543,639,1182,"6 de julio de 1997"
14,12,41,1066,407,445,852,"6 de julio de 1997"
14,12,41,1067,322,374,696,"6 de julio de 1997"
14,12,41,1068,412,465,877,"6 de julio de 1997"
14,12,41,1069,309,422,731,"6 de julio de 1997"
14,12,41,1070,519,546,1065,"6 de julio de 1997"
14,12,41,1071,404,513,917,"6 de julio de 1997"
14,12,41,1072,353,475,828,"6 de julio de 1997"
14,12,41,1073,267,305,572,"6 de julio de 1997"
14,12,41,1074,364,402,766,"6 de julio de 1997"
14,12,41,1075,505,671,1176,"6 de julio de 1997"
14,12,41,1076,257,318,575,"6 de julio de 1997"
14,12,41,1077,418,470,888,"6 de julio de 1997"
14,12,41,1078,467,564,1031,"6 de julio de 1997"
14,12,41,1079,337,375,712,"6 de julio de 1997"
14,12,41,1080,316,362,678,"6 de julio de 1997"
14,12,41,1081,331,369,700,"6 de julio de 1997"
14,12,41,1082,457,569,1026,"6 de julio de 1997"
14,12,41,1083,425,423,848,"6 de julio de 1997"
14,12,41,1084,345,388,733,"6 de julio de 1997"
14,12,41,1085,363,389,752,"6 de julio de 1997"
14,12,41,1086,498,616,1114,"6 de julio de 1997"
14,13,41,731,686,762,1448,"6 de julio de 1997"
14,13,41,732,410,454,864,"6 de julio de 1997"
14,13,41,733,325,348,673,"6 de julio de 1997"
14,13,41,734,542,593,1135,"6 de julio de 1997"
14,13,41,735,508,535,1043,"6 de julio de 1997"
14,13,41,736,828,966,1794,"6 de julio de 1997"
14,13,41,737,329,387,716,"6 de julio de 1997"
14,13,41,738,404,459,863,"6 de julio de 1997"
14,13,41,739,590,641,1231,"6 de julio de 1997"
14,13,41,740,449,538,987,"6 de julio de 1997"
14,13,41,741,434,542,976,"6 de julio de 1997"
14,13,41,742,408,458,866,"6 de julio de 1997"
14,13,41,743,567,582,1149,"6 de julio de 1997"
14,13,41,744,463,529,992,"6 de julio de 1997"
14,13,41,745,377,481,858,"6 de julio de 1997"
14,13,41,746,374,437,811,"6 de julio de 1997"
14,13,41,747,358,432,790,"6 de julio de 1997"
14,13,41,748,787,909,1696,"6 de julio de 1997"
14,13,41,749,699,797,1496,"6 de julio de 1997"
14,13,41,750,719,798,1517,"6 de julio de 1997"
14,13,41,751,672,810,1482,"6 de julio de 1997"
14,13,41,752,544,653,1197,"6 de julio de 1997"
14,13,41,753,504,572,1076,"6 de julio de 1997"
14,13,41,754,356,414,770,"6 de julio de 1997"
14,13,41,755,467,585,1052,"6 de julio de 1997"
14,13,41,756,663,750,1413,"6 de julio de 1997"
14,13,41,929,418,396,814,"6 de julio de 1997"
14,13,41,930,204,216,420,"6 de julio de 1997"
14,13,41,931,339,404,743,"6 de julio de 1997"
14,13,41,932,465,540,1005,"6 de julio de 1997"
14,13,41,933,325,374,699,"6 de julio de 1997"
14,13,41,934,608,88,696,"6 de julio de 1997"
14,13,41,935,458,547,1005,"6 de julio de 1997"
14,13,41,936,380,479,859,"6 de julio de 1997"
14,13,41,937,475,611,1086,"6 de julio de 1997"
14,13,41,938,373,420,793,"6 de julio de 1997"
14,13,41,939,431,511,942,"6 de julio de 1997"
14,13,41,940,479,600,1079,"6 de julio de 1997"
14,13,41,941,551,616,1167,"6 de julio de 1997"
14,13,41,942,473,597,1070,"6 de julio de 1997"
14,13,41,943,310,393,703,"6 de julio de 1997"
14,13,41,944,291,336,627,"6 de julio de 1997"
14,13,41,945,441,484,925,"6 de julio de 1997"
14,13,41,946,370,427,797,"6 de julio de 1997"
14,13,41,947,321,391,712,"6 de julio de 1997"
14,13,41,948,245,311,556,"6 de julio de 1997"
14,13,41,949,411,463,874,"6 de julio de 1997"
14,13,41,950,498,539,1037,"6 de julio de 1997"
14,13,41,951,315,367,682,"6 de julio de 1997"
14,13,41,952,314,376,690,"6 de julio de 1997"
14,13,41,953,326,423,749,"6 de julio de 1997"
14,13,41,954,362,443,805,"6 de julio de 1997"
14,13,41,955,358,450,808,"6 de julio de 1997"
14,13,41,956,367,451,818,"6 de julio de 1997"
14,13,41,957,354,399,753,"6 de julio de 1997"
14,13,41,958,592,653,1245,"6 de julio de 1997"
14,13,41,959,402,573,975,"6 de julio de 1997"
14,13,41,960,404,442,846,"6 de julio de 1997"
14,13,41,961,337,369,706,"6 de julio de 1997"
14,13,41,962,349,458,807,"6 de julio de 1997"
14,13,41,963,359,422,781,"6 de julio de 1997"
14,13,41,964,564,656,1220,"6 de julio de 1997"
14,13,41,965,448,508,956,"6 de julio de 1997"
14,13,41,966,364,424,788,"6 de julio de 1997"
14,13,41,975,519,602,1121,"6 de julio de 1997"
14,13,41,976,254,256,510,"6 de julio de 1997"
14,13,41,1017,432,530,962,"6 de julio de 1997"
14,13,41,1018,276,319,595,"6 de julio de 1997"
14,13,41,1019,482,566,1048,"6 de julio de 1997"
14,13,41,1020,283,320,603,"6 de julio de 1997"
14,13,41,1021,378,450,828,"6 de julio de 1997"
14,13,41,1022,297,430,727,"6 de julio de 1997"
14,13,41,1023,290,364,654,"6 de julio de 1997"
14,13,41,1024,285,356,641,"6 de julio de 1997"
14,13,41,1025,325,413,738,"6 de julio de 1997"
14,13,41,1026,200,233,433,"6 de julio de 1997"
14,13,41,1027,362,425,787,"6 de julio de 1997"
14,13,41,1028,212,268,480,"6 de julio de 1997"
14,13,41,1029,241,272,513,"6 de julio de 1997"
14,13,41,1030,337,393,730,"6 de julio de 1997"
14,13,41,1031,389,461,850,"6 de julio de 1997"
14,13,41,1032,340,388,728,"6 de julio de 1997"
14,13,41,1033,523,647,1170,"6 de julio de 1997"
14,13,41,1034,234,261,495,"6 de julio de 1997"
14,13,41,1035,398,460,858,"6 de julio de 1997"
14,13,41,1036,289,359,648,"6 de julio de 1997"
14,13,41,1037,327,375,702,"6 de julio de 1997"
14,13,41,1038,351,454,805,"6 de julio de 1997"
14,13,41,1039,244,378,622,"6 de julio de 1997"
14,13,41,1040,379,491,870,"6 de julio de 1997"
14,13,41,1041,347,390,737,"6 de julio de 1997"
14,13,41,1042,363,489,852,"6 de julio de 1997"
14,13,41,1043,342,428,770,"6 de julio de 1997"
14,13,41,1044,287,372,659,"6 de julio de 1997"
14,13,41,1045,219,226,445,"6 de julio de 1997"
14,13,41,1046,303,371,674,"6 de julio de 1997"
14,13,41,1047,329,414,743,"6 de julio de 1997"
14,13,41,1048,239,232,471,"6 de julio de 1997"
14,13,41,1049,211,169,380,"6 de julio de 1997"
14,13,41,1439,411,461,872,"6 de julio de 1997"
14,13,41,1440,460,562,1022,"6 de julio de 1997"
14,13,41,1441,468,558,1026,"6 de julio de 1997"
14,13,41,1442,430,475,905,"6 de julio de 1997"
14,13,41,1443,298,355,653,"6 de julio de 1997"
14,13,41,1444,364,419,783,"6 de julio de 1997"
14,13,41,1445,374,387,761,"6 de julio de 1997"
14,13,41,1446,449,522,971,"6 de julio de 1997"
14,13,41,1447,580,627,1207,"6 de julio de 1997"
14,13,41,1448,867,976,1843,"6 de julio de 1997"
14,13,41,1449,594,735,1329,"6 de julio de 1997"
14,13,41,1450,802,906,1708,"6 de julio de 1997"
14,13,41,1451,650,736,1386,"6 de julio de 1997"
14,13,41,1452,703,841,1544,"6 de julio de 1997"
14,13,41,1453,764,886,1650,"6 de julio de 1997"
14,13,41,1454,742,890,1632,"6 de julio de 1997"
14,13,41,1455,766,876,1642,"6 de julio de 1997"
14,13,41,1456,616,750,1366,"6 de julio de 1997"
14,13,41,1457,512,633,1145,"6 de julio de 1997"
14,13,41,1458,609,639,1248,"6 de julio de 1997"
14,13,41,1460,428,453,881,"6 de julio de 1997"
14,13,41,1461,531,539,1070,"6 de julio de 1997"
14,13,41,1462,441,444,885,"6 de julio de 1997"
14,13,41,1465,626,687,1313,"6 de julio de 1997"
14,13,41,1466,588,661,1249,"6 de julio de 1997"
14,13,41,1467,550,606,1156,"6 de julio de 1997"
14,13,41,1468,511,539,1050,"6 de julio de 1997"
14,13,41,1469,501,549,1050,"6 de julio de 1997"
14,13,41,1470,521,568,1089,"6 de julio de 1997"
14,13,41,1471,553,608,1161,"6 de julio de 1997"
14,13,41,1472,510,570,1080,"6 de julio de 1997"
14,13,41,1473,422,488,910,"6 de julio de 1997"
14,13,41,1474,412,433,845,"6 de julio de 1997"
14,13,41,1475,597,654,1251,"6 de julio de 1997"
14,13,41,1476,626,663,1289,"6 de julio de 1997"
14,13,41,1477,494,541,1035,"6 de julio de 1997"
14,13,41,1478,428,487,915,"6 de julio de 1997"
14,13,41,1479,470,470,940,"6 de julio de 1997"
14,13,41,1480,419,468,887,"6 de julio de 1997"
14,13,41,1481,561,562,1123,"6 de julio de 1997"
14,13,41,1482,570,644,1214,"6 de julio de 1997"
14,13,41,1483,643,665,1308,"6 de julio de 1997"
14,13,41,1484,446,541,987,"6 de julio de 1997"
14,13,41,1485,293,361,654,"6 de julio de 1997"
14,13,41,1486,321,384,705,"6 de julio de 1997"
14,13,41,1487,396,466,862,"6 de julio de 1997"
14,13,41,1488,375,416,791,"6 de julio de 1997"
14,13,41,1489,348,415,763,"6 de julio de 1997"
14,13,41,1490,412,478,890,"6 de julio de 1997"
14,13,41,1491,389,494,883,"6 de julio de 1997"
14,13,41,1492,542,612,1154,"6 de julio de 1997"
14,13,41,1493,510,562,1072,"6 de julio de 1997"
14,13,41,1494,461,568,1029,"6 de julio de 1997"
14,13,41,1495,578,667,1245,"6 de julio de 1997"
14,13,41,1496,405,409,814,"6 de julio de 1997"
14,13,41,1497,555,670,1225,"6 de julio de 1997"
14,13,41,1498,745,831,1576,"6 de julio de 1997"
14,13,41,1499,648,810,1458,"6 de julio de 1997"
14,13,41,1500,467,545,1012,"6 de julio de 1997"
14,13,41,1501,552,683,1235,"6 de julio de 1997"
14,13,41,1502,496,646,1142,"6 de julio de 1997"
14,13,41,1503,383,474,857,"6 de julio de 1997"
14,13,41,1504,314,380,694,"6 de julio de 1997"
14,13,41,1505,523,605,1128,"6 de julio de 1997"
14,13,41,1506,523,602,1125,"6 de julio de 1997"
14,13,41,1507,586,743,1329,"6 de julio de 1997"
14,13,41,1508,414,498,912,"6 de julio de 1997"
14,13,41,1509,554,597,1151,"6 de julio de 1997"
14,13,41,1510,412,469,881,"6 de julio de 1997"
14,13,41,1511,511,679,1190,"6 de julio de 1997"
14,13,41,1512,413,509,922,"6 de julio de 1997"
14,13,41,1513,482,536,1018,"6 de julio de 1997"
14,13,41,1514,744,833,1577,"6 de julio de 1997"
14,13,41,1515,630,697,1327,"6 de julio de 1997"
14,13,41,1516,502,589,1091,"6 de julio de 1997"
14,13,41,1517,818,988,1806,"6 de julio de 1997"
14,13,41,1518,600,689,1289,"6 de julio de 1997"
14,13,41,1519,552,634,1186,"6 de julio de 1997"
14,13,41,1520,522,640,1162,"6 de julio de 1997"
14,13,41,1521,554,621,1175,"6 de julio de 1997"
14,13,41,1522,427,509,936,"6 de julio de 1997"
14,13,41,1523,529,706,1235,"6 de julio de 1997"
14,13,41,1524,418,496,914,"6 de julio de 1997"
14,13,41,1525,496,596,1092,"6 de julio de 1997"
14,14,41,791,947,1005,1952,"6 de julio de 1997"
14,14,41,792,521,565,1086,"6 de julio de 1997"
14,14,41,793,597,637,1234,"6 de julio de 1997"
14,14,41,794,623,781,1404,"6 de julio de 1997"
14,14,41,822,474,598,1072,"6 de julio de 1997"
14,14,41,823,357,410,767,"6 de julio de 1997"
14,14,41,824,577,648,1225,"6 de julio de 1997"
14,14,41,825,657,724,1381,"6 de julio de 1997"
14,14,41,826,696,767,1463,"6 de julio de 1997"
14,14,41,827,816,887,1703,"6 de julio de 1997"
14,14,41,828,850,987,1837,"6 de julio de 1997"
14,14,41,829,806,873,1679,"6 de julio de 1997"
14,14,41,839,713,781,1494,"6 de julio de 1997"
14,14,41,840,638,695,1333,"6 de julio de 1997"
14,14,41,841,597,674,1271,"6 de julio de 1997"
14,14,41,842,788,827,1615,"6 de julio de 1997"
14,14,41,843,568,608,1176,"6 de julio de 1997"
14,14,41,844,814,847,1661,"6 de julio de 1997"
14,14,41,845,538,619,1157,"6 de julio de 1997"
14,14,41,846,430,492,922,"6 de julio de 1997"
14,14,41,847,544,597,1141,"6 de julio de 1997"
14,14,41,848,455,504,959,"6 de julio de 1997"
14,14,41,849,654,711,1365,"6 de julio de 1997"
14,14,41,850,424,455,879,"6 de julio de 1997"
14,14,41,851,762,763,1525,"6 de julio de 1997"
14,14,41,852,674,739,1413,"6 de julio de 1997"
14,14,41,853,861,1016,1877,"6 de julio de 1997"
14,14,41,854,775,862,1637,"6 de julio de 1997"
14,14,41,855,724,875,1599,"6 de julio de 1997"
14,14,41,856,771,828,1599,"6 de julio de 1997"
14,14,41,857,749,783,1532,"6 de julio de 1997"
14,14,41,858,346,390,736,"6 de julio de 1997"
14,14,41,859,573,733,1306,"6 de julio de 1997"
14,14,41,860,475,471,946,"6 de julio de 1997"
14,14,41,861,452,478,930,"6 de julio de 1997"
14,14,41,862,779,851,1630,"6 de julio de 1997"
14,14,41,863,843,894,1737,"6 de julio de 1997"
14,14,41,864,519,571,1090,"6 de julio de 1997"
14,14,41,865,526,516,1042,"6 de julio de 1997"
14,14,41,866,570,597,1167,"6 de julio de 1997"
14,14,41,867,355,367,722,"6 de julio de 1997"
14,14,41,868,968,1025,1993,"6 de julio de 1997"
14,14,41,869,839,910,1749,"6 de julio de 1997"
14,14,41,870,504,601,1105,"6 de julio de 1997"
14,14,41,871,512,547,1059,"6 de julio de 1997"
14,14,41,872,391,421,812,"6 de julio de 1997"
14,14,41,873,712,746,1458,"6 de julio de 1997"
14,14,41,874,720,780,1500,"6 de julio de 1997"
14,14,41,875,798,873,1671,"6 de julio de 1997"
14,14,41,876,869,947,1816,"6 de julio de 1997"
14,14,41,877,836,912,1748,"6 de julio de 1997"
14,14,41,878,609,647,1256,"6 de julio de 1997"
14,14,41,879,549,580,1129,"6 de julio de 1997"
14,14,41,880,892,949,1841,"6 de julio de 1997"
14,14,41,881,870,906,1776,"6 de julio de 1997"
14,14,41,882,807,875,1682,"6 de julio de 1997"
14,14,41,883,809,872,1681,"6 de julio de 1997"
14,14,41,884,690,706,1396,"6 de julio de 1997"
14,14,41,885,826,967,1793,"6 de julio de 1997"
14,14,41,895,1001,1050,2051,"6 de julio de 1997"
14,14,41,896,551,581,1132,"6 de julio de 1997"
14,14,41,897,455,449,904,"6 de julio de 1997"
14,14,41,898,650,687,1337,"6 de julio de 1997"
14,14,41,899,702,843,1545,"6 de julio de 1997"
14,14,41,900,736,788,1524,"6 de julio de 1997"
14,14,41,901,721,776,1497,"6 de julio de 1997"
14,14,41,902,825,971,1796,"6 de julio de 1997"
14,14,41,903,596,661,1257,"6 de julio de 1997"
14,14,41,904,863,985,1848,"6 de julio de 1997"
14,14,41,905,525,596,1121,"6 de julio de 1997"
14,14,41,906,434,495,929,"6 de julio de 1997"
14,14,41,907,894,991,1885,"6 de julio de 1997"
14,14,41,908,496,526,1022,"6 de julio de 1997"
14,14,41,909,399,406,805,"6 de julio de 1997"
14,14,41,917,654,658,1312,"6 de julio de 1997"
14,14,41,918,930,1000,1930,"6 de julio de 1997"
14,14,41,919,778,853,1631,"6 de julio de 1997"
14,14,41,920,870,958,1828,"6 de julio de 1997"
14,14,41,921,589,607,1196,"6 de julio de 1997"
14,14,41,922,893,969,1862,"6 de julio de 1997"
14,14,41,923,689,761,1450,"6 de julio de 1997"
14,14,41,924,835,917,1752,"6 de julio de 1997"
14,14,41,925,1332,1422,2754,"6 de julio de 1997"
14,14,41,926,845,946,1791,"6 de julio de 1997"
14,14,41,927,596,670,1266,"6 de julio de 1997"
14,14,41,928,655,703,1358,"6 de julio de 1997"
14,14,41,967,479,567,1046,"6 de julio de 1997"
14,14,41,968,441,542,983,"6 de julio de 1997"
14,14,41,969,297,370,667,"6 de julio de 1997"
14,14,41,970,206,239,445,"6 de julio de 1997"
14,14,41,971,251,334,585,"6 de julio de 1997"
14,14,41,972,284,326,610,"6 de julio de 1997"
14,14,41,973,368,409,777,"6 de julio de 1997"
14,14,41,974,292,368,660,"6 de julio de 1997"
14,14,41,977,257,255,512,"6 de julio de 1997"
14,14,41,978,365,379,744,"6 de julio de 1997"
14,14,41,979,252,230,482,"6 de julio de 1997"
14,14,41,980,300,344,644,"6 de julio de 1997"
14,14,41,981,378,404,782,"6 de julio de 1997"
14,14,41,982,470,578,1048,"6 de julio de 1997"
14,14,41,983,199,209,408,"6 de julio de 1997"
14,14,41,984,452,510,962,"6 de julio de 1997"
14,14,41,985,161,196,357,"6 de julio de 1997"
14,14,41,986,255,278,533,"6 de julio de 1997"
14,14,41,987,281,368,649,"6 de julio de 1997"
14,14,41,988,593,583,1176,"6 de julio de 1997"
14,14,41,989,231,212,443,"6 de julio de 1997"
14,14,41,990,623,704,1327,"6 de julio de 1997"
14,14,41,991,327,375,702,"6 de julio de 1997"
14,14,41,992,337,387,724,"6 de julio de 1997"
14,14,41,993,432,463,895,"6 de julio de 1997"
14,14,41,994,649,688,1337,"6 de julio de 1997"
14,14,41,995,411,414,825,"6 de julio de 1997"
14,14,41,996,749,819,1568,"6 de julio de 1997"
14,14,41,997,327,329,656,"6 de julio de 1997"
14,14,41,998,344,388,732,"6 de julio de 1997"
14,14,41,999,780,886,1666,"6 de julio de 1997"
14,14,41,1000,350,368,718,"6 de julio de 1997"
14,14,41,1001,530,568,1098,"6 de julio de 1997"
14,14,41,1002,480,537,1017,"6 de julio de 1997"
14,14,41,1003,576,655,1231,"6 de julio de 1997"
14,14,41,1004,681,726,1407,"6 de julio de 1997"
14,14,41,1005,490,547,1037,"6 de julio de 1997"
14,14,41,1006,363,421,784,"6 de julio de 1997"
14,14,41,1007,509,545,1054,"6 de julio de 1997"
14,14,41,1008,707,747,1454,"6 de julio de 1997"
14,14,41,1526,634,791,1425,"6 de julio de 1997"
14,14,41,1527,309,358,667,"6 de julio de 1997"
14,14,41,1528,373,401,774,"6 de julio de 1997"
14,14,41,1529,349,408,757,"6 de julio de 1997"
14,14,41,1530,364,390,754,"6 de julio de 1997"
14,14,41,1531,426,526,952,"6 de julio de 1997"
14,14,41,1532,305,378,683,"6 de julio de 1997"
14,14,41,1533,290,351,641,"6 de julio de 1997"
14,14,41,1534,755,938,1693,"6 de julio de 1997"
14,14,41,1535,526,647,1173,"6 de julio de 1997"
14,14,41,1536,462,505,967,"6 de julio de 1997"
14,14,41,1537,468,520,988,"6 de julio de 1997"
14,14,41,1538,544,652,1196,"6 de julio de 1997"
14,14,41,1539,767,873,1640,"6 de julio de 1997"
14,14,41,1540,388,432,820,"6 de julio de 1997"
14,14,41,1541,428,522,950,"6 de julio de 1997"
14,14,41,1542,544,614,1158,"6 de julio de 1997"
14,14,41,1543,415,521,936,"6 de julio de 1997"
14,14,41,1544,406,446,852,"6 de julio de 1997"
14,14,41,1545,581,649,1230,"6 de julio de 1997"
14,14,41,1546,400,460,860,"6 de julio de 1997"
14,14,41,1547,420,510,930,"6 de julio de 1997"
14,14,41,1548,363,450,813,"6 de julio de 1997"
14,15,13,161,693,811,1504,"6 de julio de 1997"
14,15,13,162,284,365,649,"6 de julio de 1997"
14,15,13,163,611,738,1349,"6 de julio de 1997"
14,15,13,164,290,378,668,"6 de julio de 1997"
14,15,13,165,361,458,819,"6 de julio de 1997"
14,15,13,166,573,655,1228,"6 de julio de 1997"
14,15,13,167,606,627,1233,"6 de julio de 1997"
14,15,13,168,572,644,1216,"6 de julio de 1997"
14,15,13,169,480,598,1078,"6 de julio de 1997"
14,15,13,170,429,478,907,"6 de julio de 1997"
14,15,13,171,691,771,1462,"6 de julio de 1997"
14,15,13,172,727,855,1582,"6 de julio de 1997"
14,15,13,173,629,751,1380,"6 de julio de 1997"
14,15,13,174,277,344,621,"6 de julio de 1997"
14,15,13,175,310,378,688,"6 de julio de 1997"
14,15,13,176,481,652,1133,"6 de julio de 1997"
14,15,13,177,587,741,1328,"6 de julio de 1997"
14,15,13,178,82,84,166,"6 de julio de 1997"
14,15,13,179,195,216,411,"6 de julio de 1997"
14,15,13,180,322,353,675,"6 de julio de 1997"
14,15,13,181,392,449,841,"6 de julio de 1997"
14,15,13,182,529,612,1141,"6 de julio de 1997"
14,15,13,183,265,347,612,"6 de julio de 1997"
14,15,13,184,626,695,1321,"6 de julio de 1997"
14,15,13,185,451,552,1003,"6 de julio de 1997"
14,15,13,186,372,335,707,"6 de julio de 1997"
14,15,13,187,404,452,856,"6 de julio de 1997"
14,15,16,224,618,724,1342,"6 de julio de 1997"
14,15,16,225,774,908,1682,"6 de julio de 1997"
14,15,16,226,595,688,1283,"6 de julio de 1997"
14,15,16,227,716,787,1503,"6 de julio de 1997"
14,15,16,228,502,625,1127,"6 de julio de 1997"
14,15,16,229,391,469,860,"6 de julio de 1997"
14,15,16,230,394,433,827,"6 de julio de 1997"
14,15,16,231,409,494,903,"6 de julio de 1997"
14,15,16,232,623,726,1349,"6 de julio de 1997"
14,15,16,233,844,780,1624,"6 de julio de 1997"
14,15,16,234,25,27,52,"6 de julio de 1997"
14,15,16,235,62,78,140,"6 de julio de 1997"
14,15,16,236,284,298,582,"6 de julio de 1997"
14,15,16,237,77,97,174,"6 de julio de 1997"
14,15,16,238,288,335,623,"6 de julio de 1997"
14,15,16,239,145,178,323,"6 de julio de 1997"
14,15,16,240,168,173,341,"6 de julio de 1997"
14,15,16,241,192,207,399,"6 de julio de 1997"
14,15,16,242,330,363,693,"6 de julio de 1997"
14,15,16,243,625,666,1291,"6 de julio de 1997"
14,15,18,256,664,773,1437,"6 de julio de 1997"
14,15,18,257,628,696,1324,"6 de julio de 1997"
14,15,18,258,647,755,1402,"6 de julio de 1997"
14,15,18,259,690,763,1453,"6 de julio de 1997"
14,15,18,260,339,399,738,"6 de julio de 1997"
14,15,18,261,765,915,1680,"6 de julio de 1997"
14,15,18,262,714,749,1463,"6 de julio de 1997"
14,15,18,263,519,635,1154,"6 de julio de 1997"
14,15,18,264,375,465,840,"6 de julio de 1997"
14,15,18,265,688,851,1539,"6 de julio de 1997"
14,15,18,266,381,472,853,"6 de julio de 1997"
14,15,18,267,625,788,1413,"6 de julio de 1997"
14,15,18,268,371,496,867,"6 de julio de 1997"
14,15,18,269,599,716,1315,"6 de julio de 1997"
14,15,18,270,353,427,780,"6 de julio de 1997"
14,15,18,271,353,447,800,"6 de julio de 1997"
14,15,18,272,173,170,343,"6 de julio de 1997"
14,15,18,273,409,461,870,"6 de julio de 1997"
14,15,18,274,369,440,809,"6 de julio de 1997"
14,15,18,275,349,426,775,"6 de julio de 1997"
14,15,18,276,202,221,423,"6 de julio de 1997"
14,15,18,277,237,236,473,"6 de julio de 1997"
14,15,18,278,322,434,756,"6 de julio de 1997"
14,15,18,279,269,323,592,"6 de julio de 1997"
14,15,18,280,406,458,864,"6 de julio de 1997"
14,15,18,281,374,411,785,"6 de julio de 1997"
14,15,18,282,240,269,509,"6 de julio de 1997"
14,15,18,283,462,602,1064,"6 de julio de 1997"
14,15,18,284,124,176,300,"6 de julio de 1997"
14,15,18,285,388,525,913,"6 de julio de 1997"
14,15,18,286,128,124,252,"6 de julio de 1997"
14,15,18,287,566,645,1211,"6 de julio de 1997"
14,15,18,288,390,455,845,"6 de julio de 1997"
14,15,18,289,277,330,607,"6 de julio de 1997"
14,15,18,290,588,682,1270,"6 de julio de 1997"
14,15,18,291,310,341,651,"6 de julio de 1997"
14,15,34,483,767,880,1647,"6 de julio de 1997"
14,15,34,484,469,524,993,"6 de julio de 1997"
14,15,34,485,499,605,1104,"6 de julio de 1997"
14,15,34,486,312,387,699,"6 de julio de 1997"
14,15,34,487,502,574,1076,"6 de julio de 1997"
14,15,34,488,543,639,1182,"6 de julio de 1997"
14,15,34,489,494,552,1046,"6 de julio de 1997"
14,15,34,490,259,271,530,"6 de julio de 1997"
14,15,34,491,282,295,577,"6 de julio de 1997"
14,15,34,492,91,95,186,"6 de julio de 1997"
14,15,34,493,254,328,582,"6 de julio de 1997"
14,15,34,494,89,95,184,"6 de julio de 1997"
14,15,34,495,264,264,528,"6 de julio de 1997"
14,15,34,496,361,412,773,"6 de julio de 1997"
14,15,34,497,228,251,479,"6 de julio de 1997"
14,15,34,498,234,246,480,"6 de julio de 1997"
14,15,49,1635,560,567,1127,"6 de julio de 1997"
14,15,49,1636,827,931,1758,"6 de julio de 1997"
14,15,49,1637,667,786,1453,"6 de julio de 1997"
14,15,49,1638,252,262,514,"6 de julio de 1997"
14,15,49,1639,370,464,834,"6 de julio de 1997"
14,15,49,1640,279,279,558,"6 de julio de 1997"
14,15,49,1641,660,641,1301,"6 de julio de 1997"
14,15,49,1642,516,564,1080,"6 de julio de 1997"
14,15,49,1643,631,668,1299,"6 de julio de 1997"
14,15,49,1644,527,659,1186,"6 de julio de 1997"
14,15,49,1645,669,48,717,"6 de julio de 1997"
14,15,49,1646,138,135,273,"6 de julio de 1997"
14,15,65,1844,593,616,1209,"6 de julio de 1997"
14,15,65,1845,525,546,1071,"6 de julio de 1997"
14,15,65,1846,615,669,1284,"6 de julio de 1997"
14,15,65,1847,714,778,1492,"6 de julio de 1997"
14,15,65,1848,554,585,1139,"6 de julio de 1997"
14,15,65,1849,476,565,1041,"6 de julio de 1997"
14,15,65,1850,617,675,1292,"6 de julio de 1997"
14,15,65,1851,650,709,1359,"6 de julio de 1997"
14,15,65,1852,884,926,1810,"6 de julio de 1997"
14,15,65,1853,670,712,1382,"6 de julio de 1997"
14,15,65,1854,627,664,1291,"6 de julio de 1997"
14,15,65,1855,582,665,1247,"6 de julio de 1997"
14,15,65,1856,541,600,1141,"6 de julio de 1997"
14,15,65,1857,597,675,1272,"6 de julio de 1997"
14,15,65,1858,337,351,688,"6 de julio de 1997"
14,15,65,1859,510,580,1090,"6 de julio de 1997"
14,15,65,1860,329,391,720,"6 de julio de 1997"
14,15,65,1861,472,539,1011,"6 de julio de 1997"
14,15,65,1862,442,474,916,"6 de julio de 1997"
14,15,65,1863,319,364,683,"6 de julio de 1997"
14,15,65,1864,560,661,1221,"6 de julio de 1997"
14,15,65,1865,255,286,541,"6 de julio de 1997"
14,15,65,1866,451,497,948,"6 de julio de 1997"
14,15,65,1867,428,503,931,"6 de julio de 1997"
14,15,65,1868,372,356,728,"6 de julio de 1997"
14,15,65,1869,345,382,727,"6 de julio de 1997"
14,15,65,1870,416,530,946,"6 de julio de 1997"
14,15,65,1871,396,486,882,"6 de julio de 1997"
14,15,65,1872,644,739,1383,"6 de julio de 1997"
14,15,65,1873,448,497,945,"6 de julio de 1997"
14,15,65,1874,752,781,1533,"6 de julio de 1997"
14,15,65,1875,694,700,1394,"6 de julio de 1997"
14,15,65,1876,658,687,1345,"6 de julio de 1997"
14,15,65,1877,990,1051,2041,"6 de julio de 1997"
14,15,65,1878,609,649,1258,"6 de julio de 1997"
14,15,65,1879,379,414,793,"6 de julio de 1997"
14,15,65,1880,214,261,475,"6 de julio de 1997"
14,15,65,1881,311,303,614,"6 de julio de 1997"
14,15,65,1882,215,237,452,"6 de julio de 1997"
14,15,65,1883,303,373,676,"6 de julio de 1997"
14,15,65,1884,210,252,462,"6 de julio de 1997"
14,15,65,1885,560,610,1170,"6 de julio de 1997"
14,15,68,1914,336,396,732,"6 de julio de 1997"
14,15,68,1915,689,811,1500,"6 de julio de 1997"
14,15,68,1916,558,633,1191,"6 de julio de 1997"
14,15,68,1917,323,369,692,"6 de julio de 1997"
14,15,68,1918,487,575,1062,"6 de julio de 1997"
14,15,68,1919,627,732,1359,"6 de julio de 1997"
14,15,68,1920,308,342,650,"6 de julio de 1997"
14,15,68,1921,528,564,1092,"6 de julio de 1997"
14,15,68,1922,490,522,1012,"6 de julio de 1997"
14,15,68,1923,385,392,777,"6 de julio de 1997"
14,15,68,1924,437,409,846,"6 de julio de 1997"
14,15,68,1925,626,657,1283,"6 de julio de 1997"
14,15,68,1926,515,575,1090,"6 de julio de 1997"
14,15,68,1927,523,576,1099,"6 de julio de 1997"
14,15,68,1928,421,426,847,"6 de julio de 1997"
14,15,68,1929,565,637,1202,"6 de julio de 1997"
14,15,68,1930,296,262,558,"6 de julio de 1997"
14,15,68,1931,916,965,1881,"6 de julio de 1997"
14,15,68,1932,142,141,283,"6 de julio de 1997"
14,15,68,1933,508,551,1059,"6 de julio de 1997"
14,15,106,2748,669,726,1395,"6 de julio de 1997"
14,15,106,2749,815,902,1717,"6 de julio de 1997"
14,15,106,2750,610,738,1348,"6 de julio de 1997"
14,15,106,2751,585,680,1265,"6 de julio de 1997"
14,15,106,2752,378,478,856,"6 de julio de 1997"
14,15,106,2753,216,219,435,"6 de julio de 1997"
14,15,106,2754,187,206,393,"6 de julio de 1997"
14,15,106,2755,172,204,376,"6 de julio de 1997"
14,15,106,2756,383,377,760,"6 de julio de 1997"
14,15,106,2757,276,283,559,"6 de julio de 1997"
14,15,106,2758,147,172,319,"6 de julio de 1997"
14,15,106,2759,291,351,642,"6 de julio de 1997"
14,15,106,2760,180,210,390,"6 de julio de 1997"
14,15,106,2761,491,589,1080,"6 de julio de 1997"
14,15,123,3265,414,461,875,"6 de julio de 1997"
14,15,123,3266,420,452,872,"6 de julio de 1997"
14,15,123,3267,242,233,475,"6 de julio de 1997"
14,15,123,3268,85,85,170,"6 de julio de 1997"
14,15,123,3269,272,270,542,"6 de julio de 1997"
14,15,123,3270,159,154,313,"6 de julio de 1997"
14,15,123,3271,338,353,691,"6 de julio de 1997"
14,15,123,3272,319,348,667,"6 de julio de 1997"
14,15,123,3273,463,506,969,"6 de julio de 1997"
14,15,123,3274,144,178,322,"6 de julio de 1997"
14,15,123,3275,405,410,815,"6 de julio de 1997"
14,15,123,3276,453,454,907,"6 de julio de 1997"
14,15,123,3277,237,241,478,"6 de julio de 1997"
14,16,99,2473,637,806,1443,"6 de julio de 1997"
14,16,99,2474,484,590,1074,"6 de julio de 1997"
14,16,99,2475,452,517,969,"6 de julio de 1997"
14,16,99,2476,439,506,945,"6 de julio de 1997"
14,16,99,2477,616,726,1342,"6 de julio de 1997"
14,16,99,2478,489,558,1047,"6 de julio de 1997"
14,16,99,2479,422,482,904,"6 de julio de 1997"
14,16,99,2480,417,493,910,"6 de julio de 1997"
14,16,99,2481,412,447,859,"6 de julio de 1997"
14,16,99,2482,842,905,1747,"6 de julio de 1997"
14,16,99,2483,657,723,1380,"6 de julio de 1997"
14,16,99,2484,526,600,1126,"6 de julio de 1997"
14,16,99,2485,414,484,898,"6 de julio de 1997"
14,16,99,2486,709,751,1460,"6 de julio de 1997"
14,16,99,2487,874,955,1829,"6 de julio de 1997"
14,16,99,2488,711,816,1527,"6 de julio de 1997"
14,16,99,2489,448,509,957,"6 de julio de 1997"
14,16,99,2490,593,679,1272,"6 de julio de 1997"
14,16,99,2491,911,961,1872,"6 de julio de 1997"
14,16,99,2492,408,435,843,"6 de julio de 1997"
14,16,99,2493,205,232,437,"6 de julio de 1997"
14,16,99,2494,267,332,599,"6 de julio de 1997"
14,16,99,2495,403,450,853,"6 de julio de 1997"
14,16,99,2496,404,476,880,"6 de julio de 1997"
14,16,99,2497,662,714,1376,"6 de julio de 1997"
14,16,99,2498,433,498,931,"6 de julio de 1997"
14,16,99,2499,369,422,791,"6 de julio de 1997"
14,16,99,2500,568,668,1236,"6 de julio de 1997"
14,16,99,2501,556,608,1164,"6 de julio de 1997"
14,16,99,2502,469,513,982,"6 de julio de 1997"
14,16,99,2503,558,628,1186,"6 de julio de 1997"
14,16,99,2504,560,653,1213,"6 de julio de 1997"
14,16,99,2505,498,559,1057,"6 de julio de 1997"
14,16,99,2506,572,608,1180,"6 de julio de 1997"
14,16,99,2507,563,624,1187,"6 de julio de 1997"
14,16,99,2508,467,514,981,"6 de julio de 1997"
14,16,99,2509,507,534,1041,"6 de julio de 1997"
14,16,99,2510,673,767,1440,"6 de julio de 1997"
14,16,99,2511,493,537,1030,"6 de julio de 1997"
14,16,99,2512,727,859,1586,"6 de julio de 1997"
14,16,99,2513,710,718,1428,"6 de julio de 1997"
14,16,99,2514,310,374,684,"6 de julio de 1997"
14,16,99,2515,463,441,904,"6 de julio de 1997"
14,16,99,2516,457,525,982,"6 de julio de 1997"
14,16,99,2517,474,512,986,"6 de julio de 1997"
14,16,99,2518,585,653,1238,"6 de julio de 1997"
14,16,99,2519,595,646,1241,"6 de julio de 1997"
14,16,99,2520,616,649,1265,"6 de julio de 1997"
14,16,99,2521,402,487,889,"6 de julio de 1997"
14,16,99,2522,436,524,960,"6 de julio de 1997"
14,16,99,2523,723,772,1495,"6 de julio de 1997"
14,16,99,2524,623,742,1365,"6 de julio de 1997"
14,16,99,2525,213,239,452,"6 de julio de 1997"
14,16,99,2526,864,969,1833,"6 de julio de 1997"
14,16,99,2527,467,517,984,"6 de julio de 1997"
14,16,99,2528,556,573,1129,"6 de julio de 1997"
14,16,99,2529,533,610,1143,"6 de julio de 1997"
14,16,99,2530,1276,1399,2675,"6 de julio de 1997"
14,16,99,2531,700,785,1485,"6 de julio de 1997"
14,16,99,2532,516,615,1131,"6 de julio de 1997"
14,16,99,2533,463,523,986,"6 de julio de 1997"
14,16,99,2534,685,795,1480,"6 de julio de 1997"
14,16,99,2535,399,408,807,"6 de julio de 1997"
14,16,99,2536,461,474,935,"6 de julio de 1997"
14,16,99,2537,290,344,634,"6 de julio de 1997"
14,16,99,2538,586,646,1232,"6 de julio de 1997"
14,16,99,2539,556,601,1157,"6 de julio de 1997"
14,16,99,2540,932,1016,1948,"6 de julio de 1997"
14,16,99,2541,856,929,1785,"6 de julio de 1997"
14,16,99,2542,691,760,1451,"6 de julio de 1997"
14,16,99,2543,565,586,1151,"6 de julio de 1997"
14,16,99,2544,412,444,856,"6 de julio de 1997"
14,16,99,2545,891,939,1830,"6 de julio de 1997"
14,16,99,2546,693,732,1425,"6 de julio de 1997"
14,16,99,2547,604,653,1257,"6 de julio de 1997"
14,16,99,2548,861,912,1773,"6 de julio de 1997"
14,16,99,2549,597,623,1220,"6 de julio de 1997"
14,16,99,2550,764,804,1568,"6 de julio de 1997"
14,16,99,2551,806,826,1632,"6 de julio de 1997"
14,16,99,2552,935,1000,1935,"6 de julio de 1997"
14,16,99,2553,974,992,1966,"6 de julio de 1997"
14,16,99,2554,827,901,1728,"6 de julio de 1997"
14,16,99,2555,485,526,1011,"6 de julio de 1997"
14,16,99,2556,963,1024,1987,"6 de julio de 1997"
14,16,99,2557,652,681,1333,"6 de julio de 1997"
14,16,99,2558,699,725,1424,"6 de julio de 1997"
14,16,99,2559,716,773,1489,"6 de julio de 1997"
14,16,99,2560,510,522,1032,"6 de julio de 1997"
14,16,99,2561,582,589,1171,"6 de julio de 1997"
14,16,99,2562,1050,1159,2209,"6 de julio de 1997"
14,16,99,2563,820,892,1712,"6 de julio de 1997"
14,16,99,2564,874,918,1792,"6 de julio de 1997"
14,16,99,2565,771,794,1565,"6 de julio de 1997"
14,16,99,2566,862,864,1726,"6 de julio de 1997"
14,16,99,2567,809,888,1697,"6 de julio de 1997"
14,16,99,2568,849,963,1812,"6 de julio de 1997"
14,16,99,2569,808,816,1624,"6 de julio de 1997"
14,16,99,2570,690,727,1417,"6 de julio de 1997"
14,16,99,2571,460,463,923,"6 de julio de 1997"
14,16,99,2572,383,460,843,"6 de julio de 1997"
14,16,99,2573,429,485,914,"6 de julio de 1997"
14,16,99,2574,594,624,1218,"6 de julio de 1997"
14,16,99,2575,485,541,1026,"6 de julio de 1997"
14,16,99,2576,1049,1131,2180,"6 de julio de 1997"
14,16,99,2577,959,1036,1995,"6 de julio de 1997"
14,16,99,2578,995,1155,2150,"6 de julio de 1997"
14,16,99,2579,530,617,1147,"6 de julio de 1997"
14,16,99,2580,390,476,866,"6 de julio de 1997"
14,16,99,2581,408,473,881,"6 de julio de 1997"
14,16,99,2582,772,820,1592,"6 de julio de 1997"
14,16,99,2583,886,957,1843,"6 de julio de 1997"
14,16,99,2584,838,869,1707,"6 de julio de 1997"
14,16,99,2585,866,967,1833,"6 de julio de 1997"
14,16,99,2586,779,819,1598,"6 de julio de 1997"
14,16,99,2587,932,987,1919,"6 de julio de 1997"
14,16,99,2588,939,1048,1987,"6 de julio de 1997"
14,16,99,2589,634,683,1317,"6 de julio de 1997"
14,16,99,2590,794,798,1592,"6 de julio de 1997"
14,16,99,2591,703,768,1471,"6 de julio de 1997"
14,16,99,2592,858,932,1790,"6 de julio de 1997"
14,16,99,2593,841,900,1741,"6 de julio de 1997"
14,16,99,2594,713,795,1508,"6 de julio de 1997"
14,16,99,2595,728,839,1567,"6 de julio de 1997"
14,16,99,2596,910,978,1888,"6 de julio de 1997"
14,16,99,2597,589,620,1209,"6 de julio de 1997"
14,16,99,2598,552,599,1151,"6 de julio de 1997"
14,16,99,2599,463,489,952,"6 de julio de 1997"
14,16,99,2600,457,487,944,"6 de julio de 1997"
14,16,99,2601,928,1071,1999,"6 de julio de 1997"
14,16,99,2602,896,1020,1916,"6 de julio de 1997"
14,16,99,2603,785,847,1632,"6 de julio de 1997"
14,16,99,2604,1372,1572,2944,"6 de julio de 1997"
14,16,99,2605,775,886,1661,"6 de julio de 1997"
14,16,99,2606,774,858,1632,"6 de julio de 1997"
14,16,99,2607,832,936,1768,"6 de julio de 1997"
14,16,99,2608,331,361,692,"6 de julio de 1997"
14,16,99,2609,596,638,1234,"6 de julio de 1997"
14,16,99,2610,432,473,905,"6 de julio de 1997"
14,16,99,2611,614,697,1311,"6 de julio de 1997"
14,16,99,2612,489,547,1036,"6 de julio de 1997"
14,16,99,2613,409,433,842,"6 de julio de 1997"
14,16,99,2614,529,560,1089,"6 de julio de 1997"
14,16,99,2615,577,583,1160,"6 de julio de 1997"
14,16,99,2616,712,803,1515,"6 de julio de 1997"
14,16,99,2617,223,235,458,"6 de julio de 1997"
14,16,99,2618,412,468,880,"6 de julio de 1997"
14,16,99,2619,619,678,1297,"6 de julio de 1997"
14,16,99,2620,414,503,917,"6 de julio de 1997"
14,16,99,2621,523,640,1163,"6 de julio de 1997"
14,16,99,2622,530,626,1156,"6 de julio de 1997"
14,16,99,2623,547,615,1162,"6 de julio de 1997"
14,16,99,2624,994,1024,2018,"6 de julio de 1997"
14,17,2,13,521,531,1052,"6 de julio de 1997"
14,17,2,14,457,511,968,"6 de julio de 1997"
14,17,2,15,449,506,955,"6 de julio de 1997"
14,17,2,16,485,558,1043,"6 de julio de 1997"
14,17,2,17,337,358,695,"6 de julio de 1997"
14,17,2,18,439,491,930,"6 de julio de 1997"
14,17,2,19,523,514,1037,"6 de julio de 1997"
14,17,2,20,454,468,922,"6 de julio de 1997"
14,17,2,21,350,334,684,"6 de julio de 1997"
14,17,2,22,692,713,1405,"6 de julio de 1997"
14,17,2,23,235,220,455,"6 de julio de 1997"
14,17,4,36,247,288,535,"6 de julio de 1997"
14,17,4,37,541,664,1205,"6 de julio de 1997"
14,17,4,38,100,110,210,"6 de julio de 1997"
14,17,4,39,489,564,1053,"6 de julio de 1997"
14,17,10,144,383,416,799,"6 de julio de 1997"
14,17,10,145,394,438,832,"6 de julio de 1997"
14,17,10,146,282,296,578,"6 de julio de 1997"
14,17,10,147,70,57,127,"6 de julio de 1997"
14,17,10,148,197,204,401,"6 de julio de 1997"
14,17,14,188,738,793,1531,"6 de julio de 1997"
14,17,14,189,545,617,1162,"6 de julio de 1997"
14,17,14,190,337,383,720,"6 de julio de 1997"
14,17,14,191,219,225,444,"6 de julio de 1997"
14,17,14,192,239,285,524,"6 de julio de 1997"
14,17,14,193,359,407,766,"6 de julio de 1997"
14,17,31,457,499,526,1025,"6 de julio de 1997"
14,17,31,458,849,935,1784,"6 de julio de 1997"
14,17,31,459,746,835,1581,"6 de julio de 1997"
14,17,31,460,431,554,985,"6 de julio de 1997"
14,17,31,461,501,570,1071,"6 de julio de 1997"
14,17,31,462,448,449,897,"6 de julio de 1997"
14,17,31,463,634,682,1316,"6 de julio de 1997"
14,17,31,464,466,504,970,"6 de julio de 1997"
14,17,31,465,215,234,449,"6 de julio de 1997"
14,17,31,466,569,638,1207,"6 de julio de 1997"
14,17,31,467,623,770,1393,"6 de julio de 1997"
14,17,31,468,586,692,1278,"6 de julio de 1997"
14,17,31,469,322,363,685,"6 de julio de 1997"
14,17,31,470,816,884,1700,"6 de julio de 1997"
14,17,31,471,431,452,883,"6 de julio de 1997"
14,17,31,472,577,615,1192,"6 de julio de 1997"
14,17,31,473,393,421,814,"6 de julio de 1997"
14,17,31,474,468,530,998,"6 de julio de 1997"
14,17,31,475,718,803,1521,"6 de julio de 1997"
14,17,46,1591,642,646,1288,"6 de julio de 1997"
14,17,46,1592,747,798,1545,"6 de julio de 1997"
14,17,46,1593,412,459,871,"6 de julio de 1997"
14,17,46,1594,709,771,1480,"6 de julio de 1997"
14,17,46,1595,512,461,973,"6 de julio de 1997"
14,17,46,1596,745,775,1520,"6 de julio de 1997"
14,17,46,1597,559,579,1138,"6 de julio de 1997"
14,17,46,1598,288,267,555,"6 de julio de 1997"
14,17,46,1599,413,406,819,"6 de julio de 1997"
14,17,46,1600,50,41,91,"6 de julio de 1997"
14,17,46,1601,547,545,1092,"6 de julio de 1997"
14,17,52,1671,412,441,853,"6 de julio de 1997"
14,17,52,1672,582,638,1220,"6 de julio de 1997"
14,17,52,1673,337,361,698,"6 de julio de 1997"
14,17,52,1674,706,771,1477,"6 de julio de 1997"
14,17,52,1675,757,764,1521,"6 de julio de 1997"
14,17,52,1676,716,796,1512,"6 de julio de 1997"
14,17,52,1677,532,608,1140,"6 de julio de 1997"
14,17,52,1678,679,736,1415,"6 de julio de 1997"
14,17,52,1679,161,166,327,"6 de julio de 1997"
14,17,52,1680,262,249,511,"6 de julio de 1997"
14,17,52,1681,675,756,1431,"6 de julio de 1997"
14,17,52,1682,562,614,1176,"6 de julio de 1997"
14,17,52,1683,363,366,729,"6 de julio de 1997"
14,17,52,1684,508,542,1050,"6 de julio de 1997"
14,17,52,1685,324,351,675,"6 de julio de 1997"
14,17,52,1686,576,640,1216,"6 de julio de 1997"
14,17,52,1687,324,365,689,"6 de julio de 1997"
14,17,52,1688,522,579,1101,"6 de julio de 1997"
14,17,83,2162,624,663,1287,"6 de julio de 1997"
14,17,83,2163,452,513,965,"6 de julio de 1997"
14,17,83,2164,528,641,1169,"6 de julio de 1997"
14,17,83,2165,500,574,1074,"6 de julio de 1997"
14,17,83,2166,393,444,837,"6 de julio de 1997"
14,17,83,2167,313,32,345,"6 de julio de 1997"
14,17,83,2168,393,464,857,"6 de julio de 1997"
14,17,83,2169,296,366,662,"6 de julio de 1997"
14,17,83,2170,373,429,802,"6 de julio de 1997"
14,17,83,2171,569,679,1248,"6 de julio de 1997"
14,17,83,2172,332,373,705,"6 de julio de 1997"
14,17,83,2173,539,592,1131,"6 de julio de 1997"
14,17,83,2174,421,511,932,"6 de julio de 1997"
14,17,83,2175,594,671,1265,"6 de julio de 1997"
14,17,83,2176,455,553,1008,"6 de julio de 1997"
14,17,83,2177,431,504,935,"6 de julio de 1997"
14,17,83,2178,256,279,535,"6 de julio de 1997"
14,17,83,2179,437,500,937,"6 de julio de 1997"
14,17,83,2180,108,144,252,"6 de julio de 1997"
14,17,87,2260,376,395,771,"6 de julio de 1997"
14,17,87,2261,338,335,673,"6 de julio de 1997"
14,17,87,2262,458,578,1036,"6 de julio de 1997"
14,17,87,2263,444,529,973,"6 de julio de 1997"
14,17,87,2264,577,549,1126,"6 de julio de 1997"
14,17,87,2265,394,389,783,"6 de julio de 1997"
14,17,87,2266,72,73,145,"6 de julio de 1997"
14,17,87,2267,470,461,931,"6 de julio de 1997"
14,17,87,2268,195,160,355,"6 de julio de 1997"
14,17,90,2298,267,327,594,"6 de julio de 1997"
14,17,90,2299,325,401,726,"6 de julio de 1997"
14,17,90,2300,316,320,636,"6 de julio de 1997"
14,17,93,2330,394,437,831,"6 de julio de 1997"
14,17,93,2331,409,500,909,"6 de julio de 1997"
14,17,93,2332,332,358,690,"6 de julio de 1997"
14,17,93,2333,248,279,527,"6 de julio de 1997"
14,17,93,2334,436,534,970,"6 de julio de 1997"
14,17,93,2335,326,345,671,"6 de julio de 1997"
14,17,93,2336,161,135,296,"6 de julio de 1997"
14,17,93,2337,331,313,644,"6 de julio de 1997"
14,17,93,2338,397,445,842,"6 de julio de 1997"
14,17,93,2339,515,532,1047,"6 de julio de 1997"
14,17,97,2424,540,577,1117,"6 de julio de 1997"
14,17,97,2425,335,434,769,"6 de julio de 1997"
14,17,97,2426,418,531,949,"6 de julio de 1997"
14,17,97,2427,308,380,688,"6 de julio de 1997"
14,17,97,2428,209,241,450,"6 de julio de 1997"
14,17,97,2429,308,357,665,"6 de julio de 1997"
14,17,97,2430,432,504,936,"6 de julio de 1997"
14,17,97,2431,474,536,1010,"6 de julio de 1997"
14,17,97,2432,285,297,582,"6 de julio de 1997"
14,17,97,2433,211,220,431,"6 de julio de 1997"
14,17,97,2434,360,392,752,"6 de julio de 1997"
14,17,97,2435,694,802,1496,"6 de julio de 1997"
14,17,97,2436,190,222,412,"6 de julio de 1997"
14,17,97,2437,155,151,306,"6 de julio de 1997"
14,17,98,2438,499,518,1017,"6 de julio de 1997"
14,17,98,2439,455,468,923,"6 de julio de 1997"
14,17,98,2440,510,531,1041,"6 de julio de 1997"
14,17,98,2441,433,446,879,"6 de julio de 1997"
14,17,98,2442,553,572,1125,"6 de julio de 1997"
14,17,98,2443,581,633,1214,"6 de julio de 1997"
14,17,98,2444,724,717,1441,"6 de julio de 1997"
14,17,98,2445,442,453,895,"6 de julio de 1997"
14,17,98,2446,818,933,1751,"6 de julio de 1997"
14,17,98,2447,527,473,1000,"6 de julio de 1997"
14,17,98,2448,865,889,1754,"6 de julio de 1997"
14,17,98,2449,870,930,1800,"6 de julio de 1997"
14,17,98,2450,900,993,1893,"6 de julio de 1997"
14,17,98,2451,646,771,1417,"6 de julio de 1997"
14,17,98,2452,562,623,1185,"6 de julio de 1997"
14,17,98,2453,903,1046,1949,"6 de julio de 1997"
14,17,98,2454,893,971,1864,"6 de julio de 1997"
14,17,98,2455,1148,1251,2399,"6 de julio de 1997"
14,17,98,2456,757,835,1592,"6 de julio de 1997"
14,17,98,2457,573,630,1203,"6 de julio de 1997"
14,17,98,2458,494,520,1014,"6 de julio de 1997"
14,17,98,2459,669,718,1387,"6 de julio de 1997"
14,17,98,2460,826,888,1714,"6 de julio de 1997"
14,17,98,2461,465,519,984,"6 de julio de 1997"
14,17,98,2462,294,289,583,"6 de julio de 1997"
14,17,98,2463,575,543,1118,"6 de julio de 1997"
14,17,98,2464,597,605,1202,"6 de julio de 1997"
14,17,98,2465,1713,1788,3501,"6 de julio de 1997"
14,17,98,2466,602,690,1292,"6 de julio de 1997"
14,17,98,2467,673,687,1360,"6 de julio de 1997"
14,17,98,2468,883,890,1773,"6 de julio de 1997"
14,17,98,2469,708,743,1451,"6 de julio de 1997"
14,17,98,2470,457,460,917,"6 de julio de 1997"
14,17,98,2471,409,392,801,"6 de julio de 1997"
14,17,98,2472,719,702,1421,"6 de julio de 1997"
14,17,108,2767,521,558,1079,"6 de julio de 1997"
14,17,108,2768,479,490,969,"6 de julio de 1997"
14,17,108,2769,370,450,820,"6 de julio de 1997"
14,17,108,2770,303,296,599,"6 de julio de 1997"
14,17,114,2829,730,814,1544,"6 de julio de 1997"
14,17,114,2830,674,706,1380,"6 de julio de 1997"
14,17,114,2831,592,618,1210,"6 de julio de 1997"
14,17,114,2832,454,502,956,"6 de julio de 1997"
14,17,114,2833,430,566,996,"6 de julio de 1997"
14,17,114,2834,354,458,812,"6 de julio de 1997"
14,17,114,2835,307,385,692,"6 de julio de 1997"
14,17,114,2836,120,118,238,"6 de julio de 1997"
14,17,114,2837,275,341,616,"6 de julio de 1997"
14,17,114,2838,429,480,909,"6 de julio de 1997"
14,17,119,2884,478,515,993,"6 de julio de 1997"
14,17,119,2885,473,515,988,"6 de julio de 1997"
14,17,119,2886,541,590,1131,"6 de julio de 1997"
14,17,119,2887,654,720,1374,"6 de julio de 1997"
14,17,119,2888,484,534,1018,"6 de julio de 1997"
14,17,119,2889,686,763,1449,"6 de julio de 1997"
14,17,119,2890,487,561,1048,"6 de julio de 1997"
14,17,119,2891,365,418,783,"6 de julio de 1997"
14,17,119,2892,299,333,632,"6 de julio de 1997"
14,17,119,2893,485,464,949,"6 de julio de 1997"
14,17,119,2894,351,345,696,"6 de julio de 1997"
14,17,119,2895,328,333,661,"6 de julio de 1997"
14,17,119,2896,188,221,409,"6 de julio de 1997"
14,17,119,2897,375,406,781,"6 de julio de 1997"
14,17,119,2898,592,585,1177,"6 de julio de 1997"
14,17,119,2899,411,416,827,"6 de julio de 1997"
14,18,11,149,298,317,615,"6 de julio de 1997"
14,18,11,150,232,252,484,"6 de julio de 1997"
14,18,11,151,119,113,232,"6 de julio de 1997"
14,18,11,152,167,138,305,"6 de julio de 1997"
14,18,11,153,463,449,912,"6 de julio de 1997"
14,18,11,154,131,124,255,"6 de julio de 1997"
14,18,15,194,812,892,1704,"6 de julio de 1997"
14,18,15,195,547,641,1188,"6 de julio de 1997"
14,18,15,196,377,466,843,"6 de julio de 1997"
14,18,15,197,911,934,1845,"6 de julio de 1997"
14,18,15,198,490,607,1097,"6 de julio de 1997"
14,18,15,199,624,701,1325,"6 de julio de 1997"
14,18,15,200,553,657,1210,"6 de julio de 1997"
14,18,15,201,482,568,1050,"6 de julio de 1997"
14,18,15,202,600,690,1290,"6 de julio de 1997"
14,18,15,203,578,663,1241,"6 de julio de 1997"
14,18,15,204,544,608,1152,"6 de julio de 1997"
14,18,15,205,525,639,1164,"6 de julio de 1997"
14,18,15,206,450,519,969,"6 de julio de 1997"
14,18,15,207,749,835,1584,"6 de julio de 1997"
14,18,15,208,284,310,594,"6 de julio de 1997"
14,18,15,209,639,690,1329,"6 de julio de 1997"
14,18,15,210,408,426,834,"6 de julio de 1997"
14,18,15,211,241,278,519,"6 de julio de 1997"
14,18,15,212,726,758,1484,"6 de julio de 1997"
14,18,15,213,320,296,616,"6 de julio de 1997"
14,18,15,214,454,416,870,"6 de julio de 1997"
14,18,15,215,189,181,370,"6 de julio de 1997"
14,18,15,216,347,331,678,"6 de julio de 1997"
14,18,15,217,381,388,769,"6 de julio de 1997"
14,18,15,218,223,229,452,"6 de julio de 1997"
14,18,15,219,307,313,620,"6 de julio de 1997"
14,18,15,220,62,53,115,"6 de julio de 1997"
14,18,15,221,140,129,269,"6 de julio de 1997"
14,18,15,222,298,308,606,"6 de julio de 1997"
14,18,15,223,391,412,803,"6 de julio de 1997"
14,18,17,244,606,661,1267,"6 de julio de 1997"
14,18,17,245,397,417,814,"6 de julio de 1997"
14,18,17,246,233,263,496,"6 de julio de 1997"
14,18,17,247,340,368,708,"6 de julio de 1997"
14,18,17,248,370,424,794,"6 de julio de 1997"
14,18,17,249,160,168,328,"6 de julio de 1997"
14,18,17,250,258,247,505,"6 de julio de 1997"
14,18,17,251,232,241,473,"6 de julio de 1997"
14,18,17,252,190,169,359,"6 de julio de 1997"
14,18,17,253,247,203,450,"6 de julio de 1997"
14,18,17,254,226,141,367,"6 de julio de 1997"
14,18,17,255,259,184,443,"6 de julio de 1997"
14,18,21,302,365,375,740,"6 de julio de 1997"
14,18,21,303,466,481,947,"6 de julio de 1997"
14,18,21,304,476,541,1017,"6 de julio de 1997"
14,18,21,305,392,366,758,"6 de julio de 1997"
14,18,21,306,307,332,639,"6 de julio de 1997"
14,18,21,307,328,348,676,"6 de julio de 1997"
14,18,21,308,547,574,1121,"6 de julio de 1997"
14,18,21,309,250,256,506,"6 de julio de 1997"
14,18,21,310,471,491,962,"6 de julio de 1997"
14,18,21,311,571,566,1137,"6 de julio de 1997"
14,18,21,312,354,369,723,"6 de julio de 1997"
14,18,21,313,350,364,714,"6 de julio de 1997"
14,18,21,314,412,427,839,"6 de julio de 1997"
14,18,21,315,267,226,493,"6 de julio de 1997"
14,18,22,316,408,417,825,"6 de julio de 1997"
14,18,22,317,440,411,851,"6 de julio de 1997"
14,18,22,318,332,299,631,"6 de julio de 1997"
14,18,22,319,671,715,1386,"6 de julio de 1997"
14,18,22,320,566,580,1146,"6 de julio de 1997"
14,18,22,321,646,692,1338,"6 de julio de 1997"
14,18,22,322,400,372,772,"6 de julio de 1997"
14,18,22,323,416,451,867,"6 de julio de 1997"
14,18,22,324,273,278,551,"6 de julio de 1997"
14,18,22,325,345,351,696,"6 de julio de 1997"
14,18,22,326,432,440,872,"6 de julio de 1997"
14,18,22,327,640,651,1291,"6 de julio de 1997"
14,18,22,328,728,777,1505,"6 de julio de 1997"
14,18,22,329,141,89,230,"6 de julio de 1997"
14,18,22,330,453,424,877,"6 de julio de 1997"
14,18,22,331,724,667,1391,"6 de julio de 1997"
14,18,22,332,105,79,184,"6 de julio de 1997"
14,18,25,394,622,667,1289,"6 de julio de 1997"
14,18,25,395,277,320,597,"6 de julio de 1997"
14,18,25,396,396,434,830,"6 de julio de 1997"
14,18,25,397,539,620,1159,"6 de julio de 1997"
14,18,25,398,512,597,1109,"6 de julio de 1997"
14,18,25,399,468,558,1026,"6 de julio de 1997"
14,18,25,400,190,202,392,"6 de julio de 1997"
14,18,25,401,733,833,1566,"6 de julio de 1997"
14,18,25,402,375,440,815,"6 de julio de 1997"
14,18,25,403,403,499,902,"6 de julio de 1997"
14,18,25,404,442,594,1036,"6 de julio de 1997"
14,18,25,405,322,398,720,"6 de julio de 1997"
14,18,25,406,375,493,868,"6 de julio de 1997"
14,18,25,407,190,190,380,"6 de julio de 1997"
14,18,25,408,566,609,1175,"6 de julio de 1997"
14,18,25,409,296,302,598,"6 de julio de 1997"
14,18,25,410,303,297,600,"6 de julio de 1997"
14,18,28,432,421,411,832,"6 de julio de 1997"
14,18,28,433,416,349,765,"6 de julio de 1997"
14,18,28,434,467,390,857,"6 de julio de 1997"
14,18,28,435,586,512,1098,"6 de julio de 1997"
14,18,28,436,609,454,1063,"6 de julio de 1997"
14,18,28,437,571,461,1032,"6 de julio de 1997"
14,18,28,438,119,112,231,"6 de julio de 1997"
14,18,28,439,635,601,1236,"6 de julio de 1997"
14,18,28,440,132,119,251,"6 de julio de 1997"
14,18,29,441,314,411,725,"6 de julio de 1997"
14,18,29,442,178,206,384,"6 de julio de 1997"
14,18,29,443,57,63,120,"6 de julio de 1997"
14,18,29,444,107,118,225,"6 de julio de 1997"
14,18,33,479,446,473,919,"6 de julio de 1997"
14,18,33,480,516,556,1072,"6 de julio de 1997"
14,18,33,481,124,127,251,"6 de julio de 1997"
14,18,33,482,205,219,424,"6 de julio de 1997"
14,18,35,499,426,491,917,"6 de julio de 1997"
14,18,35,500,159,169,328,"6 de julio de 1997"
14,18,39,549,526,640,1166,"6 de julio de 1997"
14,18,39,550,773,855,1628,"6 de julio de 1997"
14,18,39,551,425,497,922,"6 de julio de 1997"
14,18,39,552,446,458,904,"6 de julio de 1997"
14,18,39,553,656,748,1404,"6 de julio de 1997"
14,18,39,554,496,525,1021,"6 de julio de 1997"
14,18,39,555,563,659,1222,"6 de julio de 1997"
14,18,39,556,403,458,861,"6 de julio de 1997"
14,18,39,557,356,384,740,"6 de julio de 1997"
14,18,39,558,594,686,1280,"6 de julio de 1997"
14,18,39,559,358,346,704,"6 de julio de 1997"
14,18,39,560,140,145,285,"6 de julio de 1997"
14,18,45,1573,344,355,699,"6 de julio de 1997"
14,18,45,1574,415,447,862,"6 de julio de 1997"
14,18,45,1575,355,386,741,"6 de julio de 1997"
14,18,45,1576,188,197,385,"6 de julio de 1997"
14,18,45,1577,198,208,406,"6 de julio de 1997"
14,18,45,1578,421,459,880,"6 de julio de 1997"
14,18,45,1579,198,151,349,"6 de julio de 1997"
14,18,45,1580,206,164,370,"6 de julio de 1997"
14,18,45,1581,200,160,360,"6 de julio de 1997"
14,18,45,1582,524,525,1049,"6 de julio de 1997"
14,18,45,1583,99,105,204,"6 de julio de 1997"
14,18,45,1584,266,234,500,"6 de julio de 1997"
14,18,45,1585,460,361,821,"6 de julio de 1997"
14,18,45,1586,214,188,402,"6 de julio de 1997"
14,18,45,1587,570,460,1030,"6 de julio de 1997"
14,18,45,1588,371,354,725,"6 de julio de 1997"
14,18,45,1589,358,350,708,"6 de julio de 1997"
14,18,45,1590,263,245,508,"6 de julio de 1997"
14,18,54,1696,398,465,863,"6 de julio de 1997"
14,18,54,1697,322,386,708,"6 de julio de 1997"
14,18,54,1698,341,429,770,"6 de julio de 1997"
14,18,54,1699,199,202,401,"6 de julio de 1997"
14,18,54,1700,284,358,642,"6 de julio de 1997"
14,18,54,1701,138,136,274,"6 de julio de 1997"
14,18,56,1776,203,236,439,"6 de julio de 1997"
14,18,56,1777,363,379,742,"6 de julio de 1997"
14,18,56,1778,448,475,923,"6 de julio de 1997"
14,18,56,1779,387,379,766,"6 de julio de 1997"
14,18,56,1780,337,335,672,"6 de julio de 1997"
14,18,56,1781,317,318,635,"6 de julio de 1997"
14,18,70,2003,475,446,921,"6 de julio de 1997"
14,18,70,2004,335,320,655,"6 de julio de 1997"
14,18,70,2005,359,370,729,"6 de julio de 1997"
14,18,70,2006,329,320,649,"6 de julio de 1997"
14,18,70,2007,450,405,855,"6 de julio de 1997"
14,18,70,2008,98,80,178,"6 de julio de 1997"
14,18,70,2009,421,353,774,"6 de julio de 1997"
14,18,70,2010,383,299,682,"6 de julio de 1997"
14,18,70,2011,233,206,439,"6 de julio de 1997"
14,18,79,2115,648,707,1355,"6 de julio de 1997"
14,18,79,2116,450,487,937,"6 de julio de 1997"
14,18,79,2117,577,661,1238,"6 de julio de 1997"
14,18,79,2118,527,613,1140,"6 de julio de 1997"
14,18,79,2119,425,545,970,"6 de julio de 1997"
14,18,79,2120,299,365,664,"6 de julio de 1997"
14,18,79,2121,430,416,846,"6 de julio de 1997"
14,18,79,2122,374,395,769,"6 de julio de 1997"
14,18,79,2123,563,664,1227,"6 de julio de 1997"
14,18,79,2124,975,1064,2039,"6 de julio de 1997"
14,18,79,2125,720,801,1521,"6 de julio de 1997"
14,18,79,2126,364,418,782,"6 de julio de 1997"
14,18,79,2127,275,314,589,"6 de julio de 1997"
14,18,79,2128,228,271,499,"6 de julio de 1997"
14,18,79,2129,266,253,519,"6 de julio de 1997"
14,18,79,2130,482,476,958,"6 de julio de 1997"
14,18,79,2131,226,225,451,"6 de julio de 1997"
14,18,89,2285,644,648,1292,"6 de julio de 1997"
14,18,89,2286,366,390,756,"6 de julio de 1997"
14,18,89,2287,395,380,775,"6 de julio de 1997"
14,18,89,2288,693,738,1431,"6 de julio de 1997"
14,18,89,2289,276,279,555,"6 de julio de 1997"
14,18,89,2290,264,270,534,"6 de julio de 1997"
14,18,89,2291,110,124,234,"6 de julio de 1997"
14,18,89,2292,293,280,573,"6 de julio de 1997"
14,18,89,2293,344,349,693,"6 de julio de 1997"
14,18,89,2294,367,363,730,"6 de julio de 1997"
14,18,89,2295,98,114,212,"6 de julio de 1997"
14,18,89,2296,465,508,973,"6 de julio de 1997"
14,18,89,2297,135,129,264,"6 de julio de 1997"
14,18,91,2301,568,612,1180,"6 de julio de 1997"
14,18,91,2302,496,517,1013,"6 de julio de 1997"
14,18,91,2303,325,365,690,"6 de julio de 1997"
14,18,91,2304,290,288,578,"6 de julio de 1997"
14,18,91,2305,78,84,162,"6 de julio de 1997"
14,18,91,2306,329,322,651,"6 de julio de 1997"
14,18,103,2730,529,650,1179,"6 de julio de 1997"
14,18,103,2731,296,368,664,"6 de julio de 1997"
14,18,103,2732,315,386,701,"6 de julio de 1997"
14,18,103,2733,273,334,607,"6 de julio de 1997"
14,18,103,2734,314,373,687,"6 de julio de 1997"
14,18,107,2762,396,424,820,"6 de julio de 1997"
14,18,107,2763,127,113,240,"6 de julio de 1997"
14,18,107,2764,212,224,436,"6 de julio de 1997"
14,18,107,2765,147,142,289,"6 de julio de 1997"
14,18,107,2766,340,270,610,"6 de julio de 1997"
14,18,111,2804,641,695,1336,"6 de julio de 1997"
14,18,111,2805,411,469,880,"6 de julio de 1997"
14,18,111,2806,236,290,526,"6 de julio de 1997"
14,18,111,2807,320,403,723,"6 de julio de 1997"
14,18,111,2808,391,512,903,"6 de julio de 1997"
14,18,111,2809,351,396,747,"6 de julio de 1997"
14,18,111,2810,253,267,520,"6 de julio de 1997"
14,18,111,2811,322,366,688,"6 de julio de 1997"
14,18,111,2812,328,317,645,"6 de julio de 1997"
14,18,111,2813,319,327,646,"6 de julio de 1997"
14,18,111,2814,234,235,469,"6 de julio de 1997"
14,18,111,2815,171,164,335,"6 de julio de 1997"
14,19,23,333,525,569,1094,"6 de julio de 1997"
14,19,23,334,652,756,1408,"6 de julio de 1997"
14,19,23,335,483,495,978,"6 de julio de 1997"
14,19,23,336,634,709,1343,"6 de julio de 1997"
14,19,23,337,480,585,1065,"6 de julio de 1997"
14,19,23,338,615,684,1299,"6 de julio de 1997"
14,19,23,339,325,355,680,"6 de julio de 1997"
14,19,23,340,465,567,1032,"6 de julio de 1997"
14,19,23,341,431,512,943,"6 de julio de 1997"
14,19,23,342,472,523,995,"6 de julio de 1997"
14,19,23,343,278,326,604,"6 de julio de 1997"
14,19,23,344,322,338,660,"6 de julio de 1997"
14,19,23,345,400,491,891,"6 de julio de 1997"
14,19,23,346,300,387,687,"6 de julio de 1997"
14,19,23,347,454,535,989,"6 de julio de 1997"
14,19,23,348,526,582,1108,"6 de julio de 1997"
14,19,23,349,575,673,1248,"6 de julio de 1997"
14,19,23,350,129,176,305,"6 de julio de 1997"
14,19,23,351,483,600,1083,"6 de julio de 1997"
14,19,23,352,442,526,968,"6 de julio de 1997"
14,19,23,353,341,411,752,"6 de julio de 1997"
14,19,23,354,518,583,1101,"6 de julio de 1997"
14,19,23,355,445,499,944,"6 de julio de 1997"
14,19,23,356,368,358,726,"6 de julio de 1997"
14,19,23,357,599,684,1283,"6 de julio de 1997"
14,19,23,358,528,664,1192,"6 de julio de 1997"
14,19,23,359,412,545,957,"6 de julio de 1997"
14,19,23,360,612,761,1373,"6 de julio de 1997"
14,19,23,361,642,713,1355,"6 de julio de 1997"
14,19,23,362,348,376,724,"6 de julio de 1997"
14,19,23,363,428,485,913,"6 de julio de 1997"
14,19,23,364,443,505,948,"6 de julio de 1997"
14,19,23,365,536,607,1143,"6 de julio de 1997"
14,19,23,366,189,216,405,"6 de julio de 1997"
14,19,23,367,485,562,1047,"6 de julio de 1997"
14,19,23,368,415,452,867,"6 de julio de 1997"
14,19,23,369,620,648,1268,"6 de julio de 1997"
14,19,23,370,728,791,1519,"6 de julio de 1997"
14,19,23,371,504,514,1018,"6 de julio de 1997"
14,19,23,372,562,636,1198,"6 de julio de 1997"
14,19,23,373,495,559,1054,"6 de julio de 1997"
14,19,23,374,617,695,1312,"6 de julio de 1997"
14,19,23,375,657,714,1371,"6 de julio de 1997"
14,19,23,376,566,668,1234,"6 de julio de 1997"
14,19,23,377,571,650,1221,"6 de julio de 1997"
14,19,23,378,576,661,1237,"6 de julio de 1997"
14,19,23,379,371,424,795,"6 de julio de 1997"
14,19,23,380,432,518,950,"6 de julio de 1997"
14,19,23,381,532,565,1097,"6 de julio de 1997"
14,19,23,382,100,103,203,"6 de julio de 1997"
14,19,23,383,272,296,568,"6 de julio de 1997"
14,19,24,384,449,512,961,"6 de julio de 1997"
14,19,24,385,547,654,1201,"6 de julio de 1997"
14,19,24,386,321,344,665,"6 de julio de 1997"
14,19,24,387,510,578,1088,"6 de julio de 1997"
14,19,24,388,470,508,978,"6 de julio de 1997"
14,19,24,389,285,328,613,"6 de julio de 1997"
14,19,24,390,138,109,247,"6 de julio de 1997"
14,19,24,391,484,472,956,"6 de julio de 1997"
14,19,24,392,327,345,672,"6 de julio de 1997"
14,19,24,393,467,452,919,"6 de julio de 1997"
14,19,27,427,376,421,797,"6 de julio de 1997"
14,19,27,428,450,515,965,"6 de julio de 1997"
14,19,27,429,426,468,894,"6 de julio de 1997"
14,19,27,430,48,47,95,"6 de julio de 1997"
14,19,27,431,210,201,411,"6 de julio de 1997"
14,19,38,541,512,594,1106,"6 de julio de 1997"
14,19,38,542,500,519,1019,"6 de julio de 1997"
14,19,38,543,523,624,1147,"6 de julio de 1997"
14,19,38,544,397,476,873,"6 de julio de 1997"
14,19,38,545,718,803,1521,"6 de julio de 1997"
14,19,38,546,180,186,366,"6 de julio de 1997"
14,19,38,547,85,84,169,"6 de julio de 1997"
14,19,38,548,61,74,135,"6 de julio de 1997"
14,19,51,1661,517,487,1004,"6 de julio de 1997"
14,19,51,1662,119,95,214,"6 de julio de 1997"
14,19,51,1663,29,20,49,"6 de julio de 1997"
14,19,51,1664,105,76,181,"6 de julio de 1997"
14,19,51,1665,310,316,626,"6 de julio de 1997"
14,19,51,1666,615,511,1126,"6 de julio de 1997"
14,19,51,1667,131,92,223,"6 de julio de 1997"
14,19,51,1668,263,167,430,"6 de julio de 1997"
14,19,51,1669,209,172,381,"6 de julio de 1997"
14,19,51,1670,98,73,171,"6 de julio de 1997"
14,19,58,1792,302,335,637,"6 de julio de 1997"
14,19,58,1793,111,95,206,"6 de julio de 1997"
14,19,58,1794,75,52,127,"6 de julio de 1997"
14,19,58,1795,132,133,265,"6 de julio de 1997"
14,19,58,1796,117,106,223,"6 de julio de 1997"
14,19,59,1797,287,337,624,"6 de julio de 1997"
14,19,59,1798,210,221,431,"6 de julio de 1997"
14,19,59,1799,194,250,444,"6 de julio de 1997"
14,19,59,1800,156,183,339,"6 de julio de 1997"
14,19,59,1801,128,165,293,"6 de julio de 1997"
14,19,61,1815,557,638,1195,"6 de julio de 1997"
14,19,61,1816,547,661,1208,"6 de julio de 1997"
14,19,61,1817,405,486,891,"6 de julio de 1997"
14,19,61,1818,255,309,564,"6 de julio de 1997"
14,19,61,1819,228,264,492,"6 de julio de 1997"
14,19,61,1820,174,205,379,"6 de julio de 1997"
14,19,61,1821,256,307,563,"6 de julio de 1997"
14,19,61,1822,93,81,174,"6 de julio de 1997"
14,19,61,1823,309,305,614,"6 de julio de 1997"
14,19,67,1901,470,465,935,"6 de julio de 1997"
14,19,67,1902,446,458,904,"6 de julio de 1997"
14,19,67,1903,453,500,953,"6 de julio de 1997"
14,19,67,1904,407,450,857,"6 de julio de 1997"
14,19,67,1905,517,589,1106,"6 de julio de 1997"
14,19,67,1906,318,345,663,"6 de julio de 1997"
14,19,67,1907,291,295,586,"6 de julio de 1997"
14,19,67,1908,445,455,900,"6 de julio de 1997"
14,19,67,1909,352,283,635,"6 de julio de 1997"
14,19,67,1910,116,95,211,"6 de julio de 1997"
14,19,67,1911,86,72,158,"6 de julio de 1997"
14,19,67,1912,248,210,458,"6 de julio de 1997"
14,19,67,1913,186,169,355,"6 de julio de 1997"
14,19,71,2012,293,381,674,"6 de julio de 1997"
14,19,71,2013,481,587,1068,"6 de julio de 1997"
14,19,71,2014,166,231,397,"6 de julio de 1997"
14,19,71,2015,332,452,784,"6 de julio de 1997"
14,19,71,2016,236,319,555,"6 de julio de 1997"
14,19,71,2017,221,292,513,"6 de julio de 1997"
14,19,71,2018,596,748,1344,"6 de julio de 1997"
14,19,71,2019,178,230,408,"6 de julio de 1997"
14,19,71,2020,81,85,166,"6 de julio de 1997"
14,19,71,2021,161,214,375,"6 de julio de 1997"
14,19,71,2022,155,144,299,"6 de julio de 1997"
14,19,71,2023,244,239,483,"6 de julio de 1997"
14,19,86,2223,518,535,1053,"6 de julio de 1997"
14,19,86,2224,347,393,740,"6 de julio de 1997"
14,19,86,2225,301,356,657,"6 de julio de 1997"
14,19,86,2226,499,529,1028,"6 de julio de 1997"
14,19,86,2227,444,533,977,"6 de julio de 1997"
14,19,86,2228,460,550,1010,"6 de julio de 1997"
14,19,86,2229,312,329,641,"6 de julio de 1997"
14,19,86,2230,243,276,519,"6 de julio de 1997"
14,19,86,2231,307,393,700,"6 de julio de 1997"
14,19,86,2232,418,478,896,"6 de julio de 1997"
14,19,86,2233,278,336,614,"6 de julio de 1997"
14,19,86,2234,606,729,1335,"6 de julio de 1997"
14,19,86,2235,323,426,749,"6 de julio de 1997"
14,19,86,2236,362,463,825,"6 de julio de 1997"
14,19,86,2237,526,563,1089,"6 de julio de 1997"
14,19,86,2238,741,818,1559,"6 de julio de 1997"
14,19,86,2239,418,448,866,"6 de julio de 1997"
14,19,86,2240,80,75,155,"6 de julio de 1997"
14,19,86,2241,122,127,249,"6 de julio de 1997"
14,19,86,2242,52,45,97,"6 de julio de 1997"
14,19,86,2243,239,255,494,"6 de julio de 1997"
14,19,86,2244,691,865,1556,"6 de julio de 1997"
14,19,86,2245,32,54,86,"6 de julio de 1997"
14,19,86,2246,258,275,533,"6 de julio de 1997"
14,19,86,2247,545,645,1190,"6 de julio de 1997"
14,19,86,2248,311,291,602,"6 de julio de 1997"
14,19,86,2249,119,127,246,"6 de julio de 1997"
14,19,86,2250,43,30,73,"6 de julio de 1997"
14,19,86,2251,170,177,347,"6 de julio de 1997"
14,19,86,2252,300,292,592,"6 de julio de 1997"
14,19,86,2253,215,277,492,"6 de julio de 1997"
14,19,86,2254,322,313,635,"6 de julio de 1997"
14,19,86,2255,416,443,859,"6 de julio de 1997"
14,19,86,2256,393,381,774,"6 de julio de 1997"
14,19,86,2257,380,434,814,"6 de julio de 1997"
14,19,86,2258,74,62,136,"6 de julio de 1997"
14,19,86,2259,167,177,344,"6 de julio de 1997"
14,19,88,2269,328,422,750,"6 de julio de 1997"
14,19,88,2270,411,448,859,"6 de julio de 1997"
14,19,88,2271,368,463,831,"6 de julio de 1997"
14,19,88,2272,330,344,674,"6 de julio de 1997"
14,19,88,2273,396,491,887,"6 de julio de 1997"
14,19,88,2274,610,692,1302,"6 de julio de 1997"
14,19,88,2275,695,725,1420,"6 de julio de 1997"
14,19,88,2276,530,629,1159,"6 de julio de 1997"
14,19,88,2277,346,373,719,"6 de julio de 1997"
14,19,88,2278,56,44,100,"6 de julio de 1997"
14,19,88,2279,237,247,484,"6 de julio de 1997"
14,19,88,2280,126,129,255,"6 de julio de 1997"
14,19,88,2281,130,97,227,"6 de julio de 1997"
14,19,88,2282,60,41,101,"6 de julio de 1997"
14,19,88,2283,142,101,243,"6 de julio de 1997"
14,19,88,2284,219,160,379,"6 de julio de 1997"
14,19,100,2625,345,392,737,"6 de julio de 1997"
14,19,100,2626,303,332,635,"6 de julio de 1997"
14,19,100,2627,227,175,402,"6 de julio de 1997"
14,19,100,2628,257,261,518,"6 de julio de 1997"
14,19,100,2629,484,495,979,"6 de julio de 1997"
14,19,100,2630,361,388,749,"6 de julio de 1997"
14,19,100,2631,304,345,649,"6 de julio de 1997"
14,19,100,2632,45,29,74,"6 de julio de 1997"
14,19,104,2735,207,209,416,"6 de julio de 1997"
14,19,104,2736,237,258,495,"6 de julio de 1997"
14,19,104,2737,288,263,551,"6 de julio de 1997"
14,19,104,2738,331,347,678,"6 de julio de 1997"
14,19,104,2739,433,483,916,"6 de julio de 1997"
14,19,104,2740,585,615,1200,"6 de julio de 1997"
14,19,104,2741,107,124,231,"6 de julio de 1997"
14,19,109,2771,640,733,1373,"6 de julio de 1997"
14,19,109,2772,286,297,583,"6 de julio de 1997"
14,19,109,2773,616,645,1261,"6 de julio de 1997"
14,19,109,2774,428,467,895,"6 de julio de 1997"
14,19,109,2775,556,623,1179,"6 de julio de 1997"
14,19,109,2776,200,247,447,"6 de julio de 1997"
14,19,109,2777,462,553,1015,"6 de julio de 1997"
14,19,109,2778,471,509,980,"6 de julio de 1997"
14,19,109,2779,497,558,1055,"6 de julio de 1997"
14,19,109,2780,518,566,1084,"6 de julio de 1997"
14,19,109,2781,460,530,990,"6 de julio de 1997"
14,19,109,2782,880,886,1766,"6 de julio de 1997"
14,19,109,2783,368,442,810,"6 de julio de 1997"
14,19,109,2784,471,541,1012,"6 de julio de 1997"
14,19,109,2785,280,304,584,"6 de julio de 1997"
14,19,109,2786,446,511,957,"6 de julio de 1997"
14,19,109,2787,350,362,712,"6 de julio de 1997"
14,19,109,2788,137,137,274,"6 de julio de 1997"
14,19,109,2789,290,267,557,"6 de julio de 1997"
14,19,109,2790,332,378,710,"6 de julio de 1997"
14,19,109,2791,469,479,948,"6 de julio de 1997"
14,19,109,2792,375,405,780,"6 de julio de 1997"
14,19,109,2793,219,187,406,"6 de julio de 1997"
14,19,113,2824,210,307,517,"6 de julio de 1997"
14,19,113,2825,320,402,722,"6 de julio de 1997"
14,19,113,2826,581,758,1339,"6 de julio de 1997"
14,19,113,2827,19,15,34,"6 de julio de 1997"
14,19,113,2828,233,319,552,"6 de julio de 1997"
14,19,121,3238,571,644,1215,"6 de julio de 1997"
14,19,121,3239,773,973,1746,"6 de julio de 1997"
14,19,121,3240,427,492,919,"6 de julio de 1997"
14,19,121,3241,442,442,884,"6 de julio de 1997"
14,19,121,3242,387,460,847,"6 de julio de 1997"
14,19,121,3243,315,370,685,"6 de julio de 1997"
14,19,121,3244,632,675,1307,"6 de julio de 1997"
14,19,121,3245,552,598,1150,"6 de julio de 1997"
14,19,121,3246,289,337,626,"6 de julio de 1997"
14,19,121,3247,379,410,789,"6 de julio de 1997"
14,19,121,3248,441,503,944,"6 de julio de 1997"
14,19,121,3249,239,290,529,"6 de julio de 1997"
14,19,121,3250,244,295,539,"6 de julio de 1997"
14,19,121,3251,287,322,609,"6 de julio de 1997"
14,19,121,3252,581,678,1259,"6 de julio de 1997"
14,19,121,3253,76,84,160,"6 de julio de 1997"
14,19,121,3254,136,145,281,"6 de julio de 1997"
14,19,121,3255,138,156,294,"6 de julio de 1997"
14,19,121,3256,640,725,1365,"6 de julio de 1997"
14,19,121,3257,158,178,336,"6 de julio de 1997"
14,19,121,3258,221,240,461,"6 de julio de 1997"
14,19,122,3259,429,488,917,"6 de julio de 1997"
14,19,122,3260,337,352,689,"6 de julio de 1997"
14,19,122,3261,178,192,370,"6 de julio de 1997"
14,19,122,3262,281,288,569,"6 de julio de 1997"
14,19,122,3263,261,265,526,"6 de julio de 1997"
14,19,122,3264,67,73,140,"6 de julio de 1997"
15,1,1,1,467,537,1004,"6 de julio de 1997"
15,1,1,2,455,541,996,"6 de julio de 1997"
15,1,1,3,568,617,1185,"6 de julio de 1997"
15,1,1,4,509,500,1009,"6 de julio de 1997"
15,1,1,5,388,392,780,"6 de julio de 1997"
15,1,1,6,319,367,686,"6 de julio de 1997"
15,1,1,7,224,248,472,"6 de julio de 1997"
15,1,1,8,258,310,568,"6 de julio de 1997"
15,1,1,9,257,309,566,"6 de julio de 1997"
15,1,1,10,358,334,692,"6 de julio de 1997"
15,1,1,11,287,273,560,"6 de julio de 1997"
15,1,1,12,313,295,608,"6 de julio de 1997"
15,1,1,13,474,448,922,"6 de julio de 1997"
15,1,1,14,587,470,1057,"6 de julio de 1997"
15,1,1,15,452,359,811,"6 de julio de 1997"
15,1,1,16,335,358,693,"6 de julio de 1997"
15,1,1,17,395,422,817,"6 de julio de 1997"
15,1,1,18,200,227,427,"6 de julio de 1997"
15,1,1,19,547,571,1118,"6 de julio de 1997"
15,1,1,20,590,588,1178,"6 de julio de 1997"
15,1,1,21,390,403,793,"6 de julio de 1997"
15,1,1,22,417,442,859,"6 de julio de 1997"
15,1,1,23,231,226,457,"6 de julio de 1997"
15,1,1,24,488,421,909,"6 de julio de 1997"
15,1,1,25,226,259,485,"6 de julio de 1997"
15,1,1,26,453,445,898,"6 de julio de 1997"
15,1,1,27,450,401,851,"6 de julio de 1997"
15,1,1,28,424,350,774,"6 de julio de 1997"
15,1,1,29,304,327,631,"6 de julio de 1997"
15,1,1,30,351,366,717,"6 de julio de 1997"
15,1,1,31,481,485,966,"6 de julio de 1997"
15,1,1,32,352,349,701,"6 de julio de 1997"
15,1,3,59,493,604,1097,"6 de julio de 1997"
15,1,3,60,398,348,746,"6 de julio de 1997"
15,1,3,61,309,302,611,"6 de julio de 1997"
15,1,3,62,371,294,665,"6 de julio de 1997"
15,1,3,63,397,375,772,"6 de julio de 1997"
15,1,3,64,219,229,448,"6 de julio de 1997"
15,1,3,65,300,285,585,"6 de julio de 1997"
15,1,3,66,410,428,838,"6 de julio de 1997"
15,1,3,67,532,531,1063,"6 de julio de 1997"
15,1,3,68,358,332,690,"6 de julio de 1997"
15,1,3,69,640,635,1275,"6 de julio de 1997"
15,1,3,70,710,729,1439,"6 de julio de 1997"
15,1,3,71,199,170,369,"6 de julio de 1997"
15,1,3,72,717,782,1499,"6 de julio de 1997"
15,1,3,73,351,342,693,"6 de julio de 1997"
15,1,3,74,356,320,676,"6 de julio de 1997"
15,1,3,75,613,498,1111,"6 de julio de 1997"
15,1,3,76,396,310,706,"6 de julio de 1997"
15,1,3,77,467,377,844,"6 de julio de 1997"
15,1,3,78,156,149,305,"6 de julio de 1997"
15,1,3,79,55,46,101,"6 de julio de 1997"
15,1,3,80,263,212,475,"6 de julio de 1997"
15,1,3,81,265,291,556,"6 de julio de 1997"
15,1,14,417,1012,1219,2231,"6 de julio de 1997"
15,1,14,418,583,644,1227,"6 de julio de 1997"
15,1,14,419,413,528,941,"6 de julio de 1997"
15,1,14,420,529,609,1138,"6 de julio de 1997"
15,1,14,421,373,402,775,"6 de julio de 1997"
15,1,14,422,872,997,1869,"6 de julio de 1997"
15,1,14,423,655,802,1457,"6 de julio de 1997"
15,1,14,424,434,472,906,"6 de julio de 1997"
15,1,14,425,304,311,615,"6 de julio de 1997"
15,1,14,426,368,398,766,"6 de julio de 1997"
15,1,14,427,233,267,500,"6 de julio de 1997"
15,1,14,428,273,267,540,"6 de julio de 1997"
15,1,14,429,247,285,532,"6 de julio de 1997"
15,1,14,430,468,482,950,"6 de julio de 1997"
15,1,14,431,837,813,1650,"6 de julio de 1997"
15,1,14,432,183,188,371,"6 de julio de 1997"
15,1,14,433,399,377,776,"6 de julio de 1997"
15,1,14,434,343,375,718,"6 de julio de 1997"
15,1,14,435,467,441,908,"6 de julio de 1997"
15,1,14,436,442,461,903,"6 de julio de 1997"
15,1,14,437,448,486,934,"6 de julio de 1997"
15,1,14,438,213,264,477,"6 de julio de 1997"
15,1,14,439,123,130,253,"6 de julio de 1997"
15,1,14,440,530,617,1147,"6 de julio de 1997"
15,1,14,441,255,261,516,"6 de julio de 1997"
15,1,14,442,517,602,1119,"6 de julio de 1997"
15,1,14,443,554,648,1202,"6 de julio de 1997"
15,1,14,444,336,358,694,"6 de julio de 1997"
15,1,14,445,625,685,1310,"6 de julio de 1997"
15,1,14,446,365,468,833,"6 de julio de 1997"
15,1,14,447,262,263,525,"6 de julio de 1997"
15,1,14,448,296,253,549,"6 de julio de 1997"
15,1,14,449,81,88,169,"6 de julio de 1997"
15,1,14,450,339,321,660,"6 de julio de 1997"
15,1,14,451,107,100,207,"6 de julio de 1997"
15,1,14,452,105,116,221,"6 de julio de 1997"
15,1,14,453,211,195,406,"6 de julio de 1997"
15,1,14,454,125,123,248,"6 de julio de 1997"
15,1,14,455,89,111,200,"6 de julio de 1997"
15,1,46,2260,623,725,1348,"6 de julio de 1997"
15,1,46,2261,404,507,911,"6 de julio de 1997"
15,1,46,2262,325,352,677,"6 de julio de 1997"
15,1,46,2263,504,533,1037,"6 de julio de 1997"
15,1,46,2264,459,504,963,"6 de julio de 1997"
15,1,46,2265,404,459,863,"6 de julio de 1997"
15,1,46,2266,81,65,146,"6 de julio de 1997"
15,1,46,2267,557,468,1025,"6 de julio de 1997"
15,1,46,2268,168,224,392,"6 de julio de 1997"
15,1,46,2269,541,495,1036,"6 de julio de 1997"
15,1,46,2270,48,41,89,"6 de julio de 1997"
15,1,46,2271,329,320,649,"6 de julio de 1997"
15,1,46,2272,279,242,521,"6 de julio de 1997"
15,1,46,2273,368,376,744,"6 de julio de 1997"
15,1,46,2274,316,267,583,"6 de julio de 1997"
15,1,46,2275,491,487,978,"6 de julio de 1997"
15,1,46,2276,214,185,399,"6 de julio de 1997"
15,1,46,2277,636,586,1222,"6 de julio de 1997"
15,1,46,2278,105,92,197,"6 de julio de 1997"
15,1,46,2279,124,121,245,"6 de julio de 1997"
15,1,46,2280,418,366,784,"6 de julio de 1997"
15,1,46,2281,451,379,830,"6 de julio de 1997"
15,1,46,2282,425,458,883,"6 de julio de 1997"
15,1,46,2283,441,444,885,"6 de julio de 1997"
15,1,46,2284,205,229,434,"6 de julio de 1997"
15,1,46,2285,314,263,577,"6 de julio de 1997"
15,1,46,2286,354,333,687,"6 de julio de 1997"
15,1,46,2287,1108,1077,2185,"6 de julio de 1997"
15,1,46,2288,434,434,868,"6 de julio de 1997"
15,1,46,2289,574,531,1105,"6 de julio de 1997"
15,1,46,2290,274,251,525,"6 de julio de 1997"
15,1,46,2291,683,672,1355,"6 de julio de 1997"
15,1,46,2292,393,399,792,"6 de julio de 1997"
15,1,46,2293,356,320,676,"6 de julio de 1997"
15,1,46,2294,226,162,388,"6 de julio de 1997"
15,1,46,2295,437,473,910,"6 de julio de 1997"
15,1,46,2296,582,560,1142,"6 de julio de 1997"
15,1,46,2297,337,308,645,"6 de julio de 1997"
15,1,46,2298,474,461,935,"6 de julio de 1997"
15,1,46,2299,200,192,392,"6 de julio de 1997"
15,1,46,2300,143,126,269,"6 de julio de 1997"
15,1,46,2301,274,304,578,"6 de julio de 1997"
15,1,46,2302,111,108,219,"6 de julio de 1997"
15,1,46,2303,131,126,257,"6 de julio de 1997"
15,1,49,2344,468,516,984,"6 de julio de 1997"
15,1,49,2345,230,240,470,"6 de julio de 1997"
15,1,49,2346,370,414,784,"6 de julio de 1997"
15,1,49,2347,369,410,779,"6 de julio de 1997"
15,1,49,2348,566,619,1185,"6 de julio de 1997"
15,1,49,2349,336,369,705,"6 de julio de 1997"
15,1,49,2350,593,647,1240,"6 de julio de 1997"
15,1,49,2351,282,301,583,"6 de julio de 1997"
15,1,49,2352,522,590,1112,"6 de julio de 1997"
15,1,49,2353,469,517,986,"6 de julio de 1997"
15,1,49,2354,358,374,732,"6 de julio de 1997"
15,1,49,2355,410,420,830,"6 de julio de 1997"
15,1,49,2356,484,528,1012,"6 de julio de 1997"
15,1,49,2357,399,445,844,"6 de julio de 1997"
15,1,49,2358,384,359,743,"6 de julio de 1997"
15,1,49,2359,483,485,968,"6 de julio de 1997"
15,1,49,2360,305,296,601,"6 de julio de 1997"
15,1,49,2361,422,411,833,"6 de julio de 1997"
15,1,49,2362,389,402,791,"6 de julio de 1997"
15,1,49,2363,139,121,260,"6 de julio de 1997"
15,1,49,2364,423,416,839,"6 de julio de 1997"
15,1,49,2365,248,231,479,"6 de julio de 1997"
15,1,49,2366,494,517,1011,"6 de julio de 1997"
15,1,49,2367,583,548,1131,"6 de julio de 1997"
15,1,49,2368,408,405,813,"6 de julio de 1997"
15,1,49,2369,510,540,1050,"6 de julio de 1997"
15,1,49,2370,384,414,798,"6 de julio de 1997"
15,1,49,2371,482,499,981,"6 de julio de 1997"
15,1,49,2372,313,322,635,"6 de julio de 1997"
15,1,57,2554,320,373,693,"6 de julio de 1997"
15,1,57,2555,322,376,698,"6 de julio de 1997"
15,1,57,2556,213,288,501,"6 de julio de 1997"
15,1,57,2557,332,353,685,"6 de julio de 1997"
15,1,57,2558,329,359,688,"6 de julio de 1997"
15,1,57,2559,163,195,358,"6 de julio de 1997"
15,1,57,2560,441,466,907,"6 de julio de 1997"
15,1,57,2561,444,510,954,"6 de julio de 1997"
15,1,57,2562,163,210,373,"6 de julio de 1997"
15,1,57,2563,164,215,379,"6 de julio de 1997"
15,1,57,2564,565,510,1075,"6 de julio de 1997"
15,1,57,2565,358,363,721,"6 de julio de 1997"
15,1,57,2566,226,241,467,"6 de julio de 1997"
15,1,57,2567,197,175,372,"6 de julio de 1997"
15,1,57,2568,513,434,947,"6 de julio de 1997"
15,1,57,2569,145,153,298,"6 de julio de 1997"
15,1,57,2570,326,320,646,"6 de julio de 1997"
15,1,57,2571,518,525,1043,"6 de julio de 1997"
15,1,72,4008,667,657,1324,"6 de julio de 1997"
15,1,72,4009,718,740,1458,"6 de julio de 1997"
15,1,72,4010,298,293,591,"6 de julio de 1997"
15,1,72,4011,457,436,893,"6 de julio de 1997"
15,1,72,4012,214,226,440,"6 de julio de 1997"
15,1,72,4013,306,294,600,"6 de julio de 1997"
15,1,72,4014,266,282,548,"6 de julio de 1997"
15,1,72,4015,274,266,540,"6 de julio de 1997"
15,1,72,4016,234,230,464,"6 de julio de 1997"
15,1,72,4017,133,111,244,"6 de julio de 1997"
15,1,80,4158,896,900,1796,"6 de julio de 1997"
15,1,80,4159,289,294,583,"6 de julio de 1997"
15,1,80,4160,265,226,491,"6 de julio de 1997"
15,1,80,4161,433,399,832,"6 de julio de 1997"
15,1,80,4162,429,377,806,"6 de julio de 1997"
15,1,80,4163,152,146,298,"6 de julio de 1997"
15,1,80,4164,98,89,187,"6 de julio de 1997"
15,1,103,4725,375,402,777,"6 de julio de 1997"
15,1,103,4726,377,336,713,"6 de julio de 1997"
15,1,103,4727,431,411,842,"6 de julio de 1997"
15,1,103,4728,351,324,675,"6 de julio de 1997"
15,1,103,4729,433,407,840,"6 de julio de 1997"
15,1,103,4730,350,337,687,"6 de julio de 1997"
15,1,103,4731,627,627,1254,"6 de julio de 1997"
15,1,103,4732,229,233,462,"6 de julio de 1997"
15,1,103,4733,477,449,926,"6 de julio de 1997"
15,1,103,4734,106,80,186,"6 de julio de 1997"
15,1,103,4735,61,66,127,"6 de julio de 1997"
15,2,10,219,662,694,1356,"6 de julio de 1997"
15,2,10,220,836,851,1687,"6 de julio de 1997"
15,2,10,221,748,764,1512,"6 de julio de 1997"
15,2,10,222,891,896,1787,"6 de julio de 1997"
15,2,10,223,433,468,901,"6 de julio de 1997"
15,2,10,224,672,684,1356,"6 de julio de 1997"
15,2,10,225,216,219,435,"6 de julio de 1997"
15,2,10,226,270,246,516,"6 de julio de 1997"
15,2,10,227,141,152,293,"6 de julio de 1997"
15,2,10,228,62,70,132,"6 de julio de 1997"
15,2,10,229,45,41,86,"6 de julio de 1997"
15,2,10,230,210,221,431,"6 de julio de 1997"
15,2,10,231,436,421,857,"6 de julio de 1997"
15,2,10,232,407,431,838,"6 de julio de 1997"
15,2,23,654,992,1036,2028,"6 de julio de 1997"
15,2,23,655,869,886,1755,"6 de julio de 1997"
15,2,23,656,900,916,1816,"6 de julio de 1997"
15,2,23,657,684,662,1346,"6 de julio de 1997"
15,2,23,658,1004,1059,2063,"6 de julio de 1997"
15,2,23,659,460,516,976,"6 de julio de 1997"
15,2,23,660,711,724,1435,"6 de julio de 1997"
15,2,23,661,686,715,1401,"6 de julio de 1997"
15,2,23,662,645,597,1242,"6 de julio de 1997"
15,2,23,663,668,705,1373,"6 de julio de 1997"
15,2,23,664,1020,1019,2039,"6 de julio de 1997"
15,2,36,1956,556,568,1124,"6 de julio de 1997"
15,2,36,1957,473,509,982,"6 de julio de 1997"
15,2,36,1958,383,382,765,"6 de julio de 1997"
15,2,36,1959,928,891,1819,"6 de julio de 1997"
15,2,36,1960,651,620,1271,"6 de julio de 1997"
15,2,36,1961,376,420,796,"6 de julio de 1997"
15,2,36,1962,681,718,1399,"6 de julio de 1997"
15,2,36,1963,338,369,707,"6 de julio de 1997"
15,2,36,1964,259,262,521,"6 de julio de 1997"
15,2,36,1965,136,122,258,"6 de julio de 1997"
15,2,36,1966,178,165,343,"6 de julio de 1997"
15,2,36,1967,681,705,1386,"6 de julio de 1997"
15,2,36,1968,683,682,1365,"6 de julio de 1997"
15,2,36,1969,520,601,1121,"6 de julio de 1997"
15,2,36,1970,564,599,1163,"6 de julio de 1997"
15,2,36,1971,522,565,1087,"6 de julio de 1997"
15,2,36,1972,358,430,788,"6 de julio de 1997"
15,2,36,1973,484,513,997,"6 de julio de 1997"
15,2,36,1974,369,411,780,"6 de julio de 1997"
15,2,36,1975,433,477,910,"6 de julio de 1997"
15,2,37,1976,863,904,1767,"6 de julio de 1997"
15,2,37,1977,372,310,682,"6 de julio de 1997"
15,2,37,1978,661,560,1221,"6 de julio de 1997"
15,2,37,1979,543,567,1110,"6 de julio de 1997"
15,2,37,1980,666,633,1299,"6 de julio de 1997"
15,2,37,1981,748,704,1452,"6 de julio de 1997"
15,2,37,1982,196,158,354,"6 de julio de 1997"
15,2,37,1983,863,846,1709,"6 de julio de 1997"
15,2,37,1984,759,766,1525,"6 de julio de 1997"
15,2,37,1985,587,546,1133,"6 de julio de 1997"
15,2,37,1986,81,71,152,"6 de julio de 1997"
15,2,37,1987,467,424,891,"6 de julio de 1997"
15,2,37,1988,216,227,443,"6 de julio de 1997"
15,2,37,1989,494,519,1013,"6 de julio de 1997"
15,2,37,1990,638,621,1259,"6 de julio de 1997"
15,2,37,1991,541,516,1057,"6 de julio de 1997"
15,2,45,2243,592,687,1279,"6 de julio de 1997"
15,2,45,2244,747,719,1466,"6 de julio de 1997"
15,2,45,2245,688,760,1448,"6 de julio de 1997"
15,2,45,2246,26,30,56,"6 de julio de 1997"
15,2,45,2247,87,107,194,"6 de julio de 1997"
15,2,45,2248,597,604,1201,"6 de julio de 1997"
15,2,45,2249,656,692,1348,"6 de julio de 1997"
15,2,45,2250,440,484,924,"6 de julio de 1997"
15,2,45,2251,441,544,985,"6 de julio de 1997"
15,2,45,2252,359,432,791,"6 de julio de 1997"
15,2,45,2253,320,353,673,"6 de julio de 1997"
15,2,45,2254,442,468,910,"6 de julio de 1997"
15,2,45,2255,464,502,966,"6 de julio de 1997"
15,2,45,2256,426,512,938,"6 de julio de 1997"
15,2,45,2257,320,372,692,"6 de julio de 1997"
15,2,45,2258,255,286,541,"6 de julio de 1997"
15,2,45,2259,291,335,626,"6 de julio de 1997"
15,2,59,3036,783,865,1648,"6 de julio de 1997"
15,2,59,3037,594,647,1241,"6 de julio de 1997"
15,2,59,3038,427,473,900,"6 de julio de 1997"
15,2,59,3039,240,304,544,"6 de julio de 1997"
15,2,59,3040,656,720,1376,"6 de julio de 1997"
15,2,59,3041,189,205,394,"6 de julio de 1997"
15,2,59,3042,360,371,731,"6 de julio de 1997"
15,2,59,3043,281,279,560,"6 de julio de 1997"
15,2,59,3044,65,65,130,"6 de julio de 1997"
15,2,59,3045,342,369,711,"6 de julio de 1997"
15,2,92,4498,829,872,1701,"6 de julio de 1997"
15,2,92,4499,994,979,1973,"6 de julio de 1997"
15,2,92,4500,491,520,1011,"6 de julio de 1997"
15,2,92,4501,772,882,1654,"6 de julio de 1997"
15,2,92,4502,433,455,888,"6 de julio de 1997"
15,2,92,4503,378,399,777,"6 de julio de 1997"
15,2,92,4504,525,575,1100,"6 de julio de 1997"
15,2,92,4505,697,735,1432,"6 de julio de 1997"
15,2,92,4506,849,911,1760,"6 de julio de 1997"
15,2,92,4507,510,536,1046,"6 de julio de 1997"
15,2,92,4508,591,693,1284,"6 de julio de 1997"
15,2,92,4509,770,837,1607,"6 de julio de 1997"
15,2,92,4510,1031,1112,2143,"6 de julio de 1997"
15,2,92,4511,729,716,1445,"6 de julio de 1997"
15,2,92,4512,846,847,1693,"6 de julio de 1997"
15,2,92,4513,592,652,1244,"6 de julio de 1997"
15,2,92,4514,273,294,567,"6 de julio de 1997"
15,2,92,4515,433,462,895,"6 de julio de 1997"
15,2,92,4516,424,457,881,"6 de julio de 1997"
15,2,92,4517,306,312,618,"6 de julio de 1997"
15,2,92,4518,116,136,252,"6 de julio de 1997"
15,2,92,4519,470,497,967,"6 de julio de 1997"
15,2,92,4520,27,37,64,"6 de julio de 1997"
15,2,92,4521,440,464,904,"6 de julio de 1997"
15,2,92,4522,682,639,1321,"6 de julio de 1997"
15,2,97,4588,771,838,1609,"6 de julio de 1997"
15,2,97,4589,933,957,1890,"6 de julio de 1997"
15,2,97,4590,621,643,1264,"6 de julio de 1997"
15,2,97,4591,573,609,1182,"6 de julio de 1997"
15,2,97,4592,814,833,1647,"6 de julio de 1997"
15,2,97,4593,885,851,1736,"6 de julio de 1997"
15,2,97,4594,481,448,929,"6 de julio de 1997"
15,2,97,4595,508,472,980,"6 de julio de 1997"
15,2,97,4596,447,458,905,"6 de julio de 1997"
15,2,97,4597,86,60,146,"6 de julio de 1997"
15,2,97,4598,34,30,64,"6 de julio de 1997"
15,2,97,4599,454,448,902,"6 de julio de 1997"
15,2,97,4600,119,124,243,"6 de julio de 1997"
15,2,121,5880,883,987,1870,"6 de julio de 1997"
15,2,121,5881,712,784,1496,"6 de julio de 1997"
15,2,121,5882,821,900,1721,"6 de julio de 1997"
15,2,121,5883,739,762,1501,"6 de julio de 1997"
15,2,121,5884,933,1103,2036,"6 de julio de 1997"
15,2,121,5885,805,833,1638,"6 de julio de 1997"
15,2,121,5886,666,752,1418,"6 de julio de 1997"
15,2,121,5887,868,909,1777,"6 de julio de 1997"
15,2,121,5888,874,931,1805,"6 de julio de 1997"
15,2,121,5889,676,701,1377,"6 de julio de 1997"
15,2,121,5890,636,655,1291,"6 de julio de 1997"
15,2,121,5891,773,804,1577,"6 de julio de 1997"
15,2,121,5892,646,721,1367,"6 de julio de 1997"
15,2,121,5893,70,90,160,"6 de julio de 1997"
15,2,121,5894,254,261,515,"6 de julio de 1997"
15,2,121,5895,333,351,684,"6 de julio de 1997"
15,2,121,5896,447,495,942,"6 de julio de 1997"
15,2,121,5897,279,279,558,"6 de julio de 1997"
15,2,121,5898,348,364,712,"6 de julio de 1997"
15,2,121,5899,350,334,684,"6 de julio de 1997"
15,2,121,5900,648,702,1350,"6 de julio de 1997"
15,2,121,5901,713,735,1448,"6 de julio de 1997"
15,2,121,5902,835,856,1691,"6 de julio de 1997"
15,2,121,5903,87,78,165,"6 de julio de 1997"
15,2,121,5904,166,158,324,"6 de julio de 1997"
15,2,121,5905,239,266,505,"6 de julio de 1997"
15,2,121,5906,1026,1054,2080,"6 de julio de 1997"
15,2,121,5907,732,795,1527,"6 de julio de 1997"
15,2,121,5908,813,869,1682,"6 de julio de 1997"
15,2,121,5909,866,847,1713,"6 de julio de 1997"
15,2,121,5910,850,872,1722,"6 de julio de 1997"
15,2,121,5911,579,585,1164,"6 de julio de 1997"
15,2,121,5912,181,179,360,"6 de julio de 1997"
15,2,121,5913,38,51,89,"6 de julio de 1997"
15,2,121,5914,152,169,321,"6 de julio de 1997"
15,2,121,5915,616,678,1294,"6 de julio de 1997"
15,2,121,5916,568,610,1178,"6 de julio de 1997"
15,2,121,5917,355,357,712,"6 de julio de 1997"
15,2,121,5918,64,67,131,"6 de julio de 1997"
15,2,121,5919,182,214,396,"6 de julio de 1997"
15,2,121,5920,79,88,167,"6 de julio de 1997"
15,2,121,5921,1664,828,2492,"6 de julio de 1997"
15,2,121,5922,371,250,621,"6 de julio de 1997"
15,2,121,5923,1414,449,1863,"6 de julio de 1997"
15,3,65,3863,225,247,472,"6 de julio de 1997"
15,3,65,3864,567,626,1193,"6 de julio de 1997"
15,3,65,3865,385,457,842,"6 de julio de 1997"
15,3,65,3866,511,488,999,"6 de julio de 1997"
15,3,65,3867,604,677,1281,"6 de julio de 1997"
15,3,65,3868,467,432,899,"6 de julio de 1997"
15,3,65,3869,649,644,1293,"6 de julio de 1997"
15,3,65,3870,535,562,1097,"6 de julio de 1997"
15,3,65,3871,245,295,540,"6 de julio de 1997"
15,3,65,3872,178,203,381,"6 de julio de 1997"
15,3,65,3873,443,479,922,"6 de julio de 1997"
15,3,65,3874,578,655,1233,"6 de julio de 1997"
15,3,65,3875,430,406,836,"6 de julio de 1997"
15,3,65,3876,263,277,540,"6 de julio de 1997"
15,3,65,3877,389,417,806,"6 de julio de 1997"
15,3,65,3878,82,91,173,"6 de julio de 1997"
15,3,65,3879,75,75,150,"6 de julio de 1997"
15,3,75,4026,747,855,1602,"6 de julio de 1997"
15,3,75,4027,247,216,463,"6 de julio de 1997"
15,3,75,4028,369,384,753,"6 de julio de 1997"
15,3,75,4029,476,495,971,"6 de julio de 1997"
15,3,75,4030,212,201,413,"6 de julio de 1997"
15,3,75,4031,508,524,1032,"6 de julio de 1997"
15,3,75,4032,337,373,710,"6 de julio de 1997"
15,3,75,4033,249,248,497,"6 de julio de 1997"
15,3,75,4034,380,431,811,"6 de julio de 1997"
15,3,75,4035,453,516,969,"6 de julio de 1997"
15,3,75,4036,558,687,1245,"6 de julio de 1997"
15,3,75,4037,999,1048,2047,"6 de julio de 1997"
15,3,75,4038,427,415,842,"6 de julio de 1997"
15,3,75,4039,433,441,874,"6 de julio de 1997"
15,3,75,4040,325,373,698,"6 de julio de 1997"
15,3,75,4041,418,462,880,"6 de julio de 1997"
15,3,75,4042,497,591,1088,"6 de julio de 1997"
15,3,75,4043,438,512,950,"6 de julio de 1997"
15,3,75,4044,390,443,833,"6 de julio de 1997"
15,3,75,4045,493,459,952,"6 de julio de 1997"
15,3,75,4046,567,572,1139,"6 de julio de 1997"
15,3,75,4047,358,342,700,"6 de julio de 1997"
15,3,75,4048,512,529,1041,"6 de julio de 1997"
15,3,75,4049,498,510,1008,"6 de julio de 1997"
15,3,75,4050,292,299,591,"6 de julio de 1997"
15,3,75,4051,400,423,823,"6 de julio de 1997"
15,3,75,4052,263,326,589,"6 de julio de 1997"
15,3,75,4053,476,531,1007,"6 de julio de 1997"
15,3,75,4054,284,370,654,"6 de julio de 1997"
15,3,75,4055,337,400,737,"6 de julio de 1997"
15,3,75,4056,222,247,469,"6 de julio de 1997"
15,3,75,4057,525,649,1174,"6 de julio de 1997"
15,3,75,4058,119,139,258,"6 de julio de 1997"
15,3,75,4059,803,855,1658,"6 de julio de 1997"
15,3,75,4060,441,491,932,"6 de julio de 1997"
15,3,75,4061,618,691,1309,"6 de julio de 1997"
15,3,75,4062,351,382,733,"6 de julio de 1997"
15,3,75,4063,351,385,736,"6 de julio de 1997"
15,3,75,4064,338,357,695,"6 de julio de 1997"
15,3,75,4065,477,511,988,"6 de julio de 1997"
15,3,75,4066,417,447,864,"6 de julio de 1997"
15,3,75,4067,426,426,852,"6 de julio de 1997"
15,3,75,4068,255,264,519,"6 de julio de 1997"
15,3,75,4069,771,884,1655,"6 de julio de 1997"
15,3,75,4070,440,525,965,"6 de julio de 1997"
15,3,75,4071,290,347,637,"6 de julio de 1997"
15,3,75,4072,737,937,1674,"6 de julio de 1997"
15,3,75,4073,113,124,237,"6 de julio de 1997"
15,3,75,4074,458,517,975,"6 de julio de 1997"
15,3,75,4075,748,815,1563,"6 de julio de 1997"
15,3,75,4076,485,485,970,"6 de julio de 1997"
15,3,75,4077,473,522,995,"6 de julio de 1997"
15,3,75,4078,599,711,1310,"6 de julio de 1997"
15,3,75,4079,475,529,1004,"6 de julio de 1997"
15,3,75,4080,727,752,1479,"6 de julio de 1997"
15,3,75,4081,301,292,593,"6 de julio de 1997"
15,3,75,4082,440,427,867,"6 de julio de 1997"
15,3,75,4083,224,222,446,"6 de julio de 1997"
15,3,75,4084,379,425,804,"6 de julio de 1997"
15,3,75,4085,454,482,936,"6 de julio de 1997"
15,3,75,4086,118,126,244,"6 de julio de 1997"
15,3,75,4087,452,486,938,"6 de julio de 1997"
15,3,75,4088,282,320,602,"6 de julio de 1997"
15,3,75,4089,607,623,1230,"6 de julio de 1997"
15,3,75,4090,548,617,1165,"6 de julio de 1997"
15,3,75,4091,652,643,1295,"6 de julio de 1997"
15,3,75,4092,327,300,627,"6 de julio de 1997"
15,3,75,4093,255,247,502,"6 de julio de 1997"
15,3,75,4094,354,339,693,"6 de julio de 1997"
15,3,75,4095,348,360,708,"6 de julio de 1997"
15,3,75,4096,463,426,889,"6 de julio de 1997"
15,3,75,4097,171,207,378,"6 de julio de 1997"
15,3,75,4098,217,234,451,"6 de julio de 1997"
15,3,75,4099,89,87,176,"6 de julio de 1997"
15,3,75,4100,181,229,410,"6 de julio de 1997"
15,3,75,4101,116,139,255,"6 de julio de 1997"
15,3,75,4102,333,335,668,"6 de julio de 1997"
15,3,75,4103,264,298,562,"6 de julio de 1997"
15,3,75,4104,277,273,550,"6 de julio de 1997"
15,3,75,4105,111,103,214,"6 de julio de 1997"
15,3,86,4346,452,524,976,"6 de julio de 1997"
15,3,86,4347,372,422,794,"6 de julio de 1997"
15,3,86,4348,398,449,847,"6 de julio de 1997"
15,3,86,4349,478,531,1009,"6 de julio de 1997"
15,3,86,4350,373,377,750,"6 de julio de 1997"
15,3,86,4351,574,608,1182,"6 de julio de 1997"
15,3,86,4352,356,329,685,"6 de julio de 1997"
15,3,86,4353,397,377,774,"6 de julio de 1997"
15,3,86,4354,505,552,1057,"6 de julio de 1997"
15,3,86,4355,275,281,556,"6 de julio de 1997"
15,3,86,4356,667,711,1378,"6 de julio de 1997"
15,3,86,4357,358,348,706,"6 de julio de 1997"
15,3,86,4358,542,550,1092,"6 de julio de 1997"
15,3,86,4359,578,563,1141,"6 de julio de 1997"
15,3,86,4360,458,486,944,"6 de julio de 1997"
15,3,86,4361,369,344,713,"6 de julio de 1997"
15,3,86,4362,398,368,766,"6 de julio de 1997"
15,3,86,4363,469,448,917,"6 de julio de 1997"
15,3,86,4364,450,410,860,"6 de julio de 1997"
15,3,86,4365,371,357,728,"6 de julio de 1997"
15,3,86,4366,228,214,442,"6 de julio de 1997"
15,3,86,4367,463,481,944,"6 de julio de 1997"
15,3,86,4368,132,140,272,"6 de julio de 1997"
15,3,86,4369,676,618,1294,"6 de julio de 1997"
15,3,86,4370,222,213,435,"6 de julio de 1997"
15,3,86,4371,320,324,644,"6 de julio de 1997"
15,3,86,4372,425,439,864,"6 de julio de 1997"
15,3,86,4373,503,490,993,"6 de julio de 1997"
15,3,86,4374,321,389,710,"6 de julio de 1997"
15,3,86,4375,412,460,872,"6 de julio de 1997"
15,3,86,4376,797,833,1630,"6 de julio de 1997"
15,3,86,4377,229,258,487,"6 de julio de 1997"
15,3,86,4378,462,525,987,"6 de julio de 1997"
15,3,86,4379,159,155,314,"6 de julio de 1997"
15,3,115,5748,393,425,818,"6 de julio de 1997"
15,3,115,5749,335,352,687,"6 de julio de 1997"
15,3,115,5750,370,405,775,"6 de julio de 1997"
15,3,115,5751,511,495,1006,"6 de julio de 1997"
15,3,115,5752,259,252,511,"6 de julio de 1997"
15,3,115,5753,275,278,553,"6 de julio de 1997"
15,3,115,5754,621,653,1274,"6 de julio de 1997"
15,3,115,5755,362,402,764,"6 de julio de 1997"
15,3,115,5756,496,479,975,"6 de julio de 1997"
15,3,115,5757,134,158,292,"6 de julio de 1997"
15,3,115,5758,170,162,332,"6 de julio de 1997"
15,3,115,5759,347,364,711,"6 de julio de 1997"
15,3,115,5760,159,144,303,"6 de julio de 1997"
15,3,115,5761,698,756,1454,"6 de julio de 1997"
15,3,115,5762,246,264,510,"6 de julio de 1997"
15,3,115,5763,554,521,1075,"6 de julio de 1997"
15,3,115,5764,233,243,476,"6 de julio de 1997"
15,3,115,5765,168,155,323,"6 de julio de 1997"
15,3,115,5766,639,605,1244,"6 de julio de 1997"
15,3,115,5767,377,365,742,"6 de julio de 1997"
15,3,115,5768,314,333,647,"6 de julio de 1997"
15,3,115,5769,224,203,427,"6 de julio de 1997"
15,3,115,5770,360,334,694,"6 de julio de 1997"
15,3,115,5771,381,368,749,"6 de julio de 1997"
15,3,115,5772,571,571,1142,"6 de julio de 1997"
15,3,115,5773,398,401,799,"6 de julio de 1997"
15,3,115,5774,366,319,685,"6 de julio de 1997"
15,3,115,5775,408,357,765,"6 de julio de 1997"
15,3,115,5776,219,220,439,"6 de julio de 1997"
15,3,115,5777,149,123,272,"6 de julio de 1997"
15,3,115,5778,200,190,390,"6 de julio de 1997"
15,3,115,5779,332,330,662,"6 de julio de 1997"
15,3,115,5780,479,424,903,"6 de julio de 1997"
15,3,115,5781,574,505,1079,"6 de julio de 1997"
15,3,115,5782,217,210,427,"6 de julio de 1997"
15,3,115,5783,370,371,741,"6 de julio de 1997"
15,3,115,5784,328,344,672,"6 de julio de 1997"
15,3,115,5785,172,151,323,"6 de julio de 1997"
15,3,115,5786,184,164,348,"6 de julio de 1997"
15,3,115,5787,342,288,630,"6 de julio de 1997"
15,3,115,5788,190,178,368,"6 de julio de 1997"
15,3,115,5789,250,251,501,"6 de julio de 1997"
15,3,115,5790,265,216,481,"6 de julio de 1997"
15,4,27,1081,588,583,1171,"6 de julio de 1997"
15,4,27,1082,316,343,659,"6 de julio de 1997"
15,4,27,1083,494,495,989,"6 de julio de 1997"
15,4,27,1084,310,293,603,"6 de julio de 1997"
15,4,27,1085,842,820,1662,"6 de julio de 1997"
15,4,27,1086,531,459,990,"6 de julio de 1997"
15,4,27,1087,328,373,701,"6 de julio de 1997"
15,4,27,1088,245,250,495,"6 de julio de 1997"
15,4,27,1089,292,253,545,"6 de julio de 1997"
15,4,27,1090,388,383,771,"6 de julio de 1997"
15,4,27,1091,305,253,558,"6 de julio de 1997"
15,4,27,1092,242,215,457,"6 de julio de 1997"
15,4,27,1093,190,184,374,"6 de julio de 1997"
15,4,27,1094,99,77,176,"6 de julio de 1997"
15,4,61,3723,608,615,1223,"6 de julio de 1997"
15,4,61,3724,514,540,1054,"6 de julio de 1997"
15,4,61,3725,580,677,1257,"6 de julio de 1997"
15,4,61,3726,1090,1155,2245,"6 de julio de 1997"
15,4,61,3727,926,1017,1943,"6 de julio de 1997"
15,4,61,3728,1033,1139,2172,"6 de julio de 1997"
15,4,61,3729,215,224,439,"6 de julio de 1997"
15,4,61,3730,849,926,1775,"6 de julio de 1997"
15,4,61,3731,1102,1123,2225,"6 de julio de 1997"
15,4,61,3732,473,503,976,"6 de julio de 1997"
15,4,61,3733,615,624,1239,"6 de julio de 1997"
15,4,61,3734,936,1025,1961,"6 de julio de 1997"
15,4,61,3735,734,763,1497,"6 de julio de 1997"
15,4,61,3736,719,741,1460,"6 de julio de 1997"
15,4,61,3737,436,495,931,"6 de julio de 1997"
15,4,61,3738,842,930,1772,"6 de julio de 1997"
15,4,61,3739,902,980,1882,"6 de julio de 1997"
15,4,61,3740,921,934,1855,"6 de julio de 1997"
15,4,61,3741,355,387,742,"6 de julio de 1997"
15,4,61,3742,561,621,1182,"6 de julio de 1997"
15,4,61,3743,671,748,1419,"6 de julio de 1997"
15,4,61,3744,895,958,1853,"6 de julio de 1997"
15,4,61,3745,859,968,1827,"6 de julio de 1997"
15,4,61,3746,525,600,1125,"6 de julio de 1997"
15,4,61,3747,539,619,1158,"6 de julio de 1997"
15,4,61,3748,1009,1101,2110,"6 de julio de 1997"
15,4,61,3749,747,795,1542,"6 de julio de 1997"
15,4,61,3750,751,779,1530,"6 de julio de 1997"
15,4,61,3751,740,714,1454,"6 de julio de 1997"
15,4,61,3752,728,773,1501,"6 de julio de 1997"
15,4,61,3753,792,899,1691,"6 de julio de 1997"
15,4,61,3754,720,794,1514,"6 de julio de 1997"
15,4,61,3755,667,717,1384,"6 de julio de 1997"
15,4,61,3756,688,719,1407,"6 de julio de 1997"
15,4,61,3757,778,891,1669,"6 de julio de 1997"
15,4,61,3758,755,796,1551,"6 de julio de 1997"
15,4,61,3759,880,896,1776,"6 de julio de 1997"
15,4,61,3760,932,973,1905,"6 de julio de 1997"
15,4,61,3761,700,749,1449,"6 de julio de 1997"
15,4,61,3762,525,573,1098,"6 de julio de 1997"
15,4,61,3763,554,547,1101,"6 de julio de 1997"
15,4,61,3764,753,797,1550,"6 de julio de 1997"
15,4,61,3765,515,580,1095,"6 de julio de 1997"
15,4,61,3766,639,674,1313,"6 de julio de 1997"
15,4,61,3767,582,609,1191,"6 de julio de 1997"
15,4,61,3768,565,615,1180,"6 de julio de 1997"
15,4,61,3769,488,542,1030,"6 de julio de 1997"
15,4,61,3770,848,928,1776,"6 de julio de 1997"
15,4,61,3771,697,679,1376,"6 de julio de 1997"
15,4,61,3772,644,691,1335,"6 de julio de 1997"
15,4,61,3773,560,578,1138,"6 de julio de 1997"
15,4,61,3774,963,1011,1974,"6 de julio de 1997"
15,4,61,3775,920,948,1868,"6 de julio de 1997"
15,4,61,3776,1479,1576,3055,"6 de julio de 1997"
15,4,61,3777,515,551,1066,"6 de julio de 1997"
15,4,61,3778,483,506,989,"6 de julio de 1997"
15,4,61,3779,591,689,1280,"6 de julio de 1997"
15,4,61,3780,550,567,1117,"6 de julio de 1997"
15,4,61,3781,725,766,1491,"6 de julio de 1997"
15,4,61,3782,647,712,1359,"6 de julio de 1997"
15,4,61,3783,628,657,1285,"6 de julio de 1997"
15,4,61,3784,610,700,1310,"6 de julio de 1997"
15,4,61,3785,863,892,1755,"6 de julio de 1997"
15,4,61,3786,562,633,1195,"6 de julio de 1997"
15,4,61,3787,836,901,1737,"6 de julio de 1997"
15,4,61,3788,893,1029,1922,"6 de julio de 1997"
15,4,61,3789,467,493,960,"6 de julio de 1997"
15,4,61,3790,822,894,1716,"6 de julio de 1997"
15,4,61,3791,1037,1152,2189,"6 de julio de 1997"
15,4,61,3792,1114,1187,2301,"6 de julio de 1997"
15,4,61,3793,716,738,1454,"6 de julio de 1997"
15,4,61,3794,812,860,1672,"6 de julio de 1997"
15,4,61,3795,412,464,876,"6 de julio de 1997"
15,4,61,3796,187,163,350,"6 de julio de 1997"
15,4,61,3797,321,329,650,"6 de julio de 1997"
15,4,61,3798,504,524,1028,"6 de julio de 1997"
15,4,61,3799,556,566,1122,"6 de julio de 1997"
15,4,61,3800,499,473,972,"6 de julio de 1997"
15,4,61,3801,770,842,1612,"6 de julio de 1997"
15,4,61,3802,412,433,845,"6 de julio de 1997"
15,4,61,3803,351,365,716,"6 de julio de 1997"
15,4,61,3804,851,885,1736,"6 de julio de 1997"
15,4,61,3805,231,261,492,"6 de julio de 1997"
15,4,61,3806,351,390,741,"6 de julio de 1997"
15,4,61,3807,660,709,1369,"6 de julio de 1997"
15,4,61,3808,924,1030,1954,"6 de julio de 1997"
15,4,61,3809,583,601,1184,"6 de julio de 1997"
15,4,61,3810,438,421,859,"6 de julio de 1997"
15,4,61,3811,369,358,727,"6 de julio de 1997"
15,4,61,3812,159,165,324,"6 de julio de 1997"
15,4,61,3813,505,528,1033,"6 de julio de 1997"
15,4,61,3814,422,500,922,"6 de julio de 1997"
15,4,61,3815,446,481,927,"6 de julio de 1997"
15,4,61,3816,346,404,750,"6 de julio de 1997"
15,4,61,3817,438,445,883,"6 de julio de 1997"
15,4,61,3818,386,379,765,"6 de julio de 1997"
15,4,61,3819,527,547,1074,"6 de julio de 1997"
15,4,61,3820,415,457,872,"6 de julio de 1997"
15,4,61,3821,811,898,1709,"6 de julio de 1997"
15,4,61,3822,486,524,1010,"6 de julio de 1997"
15,4,96,4564,676,691,1367,"6 de julio de 1997"
15,4,96,4565,605,671,1276,"6 de julio de 1997"
15,4,96,4566,801,838,1639,"6 de julio de 1997"
15,4,96,4567,736,797,1533,"6 de julio de 1997"
15,4,96,4568,990,1190,2180,"6 de julio de 1997"
15,4,96,4569,365,411,776,"6 de julio de 1997"
15,4,96,4570,755,770,1525,"6 de julio de 1997"
15,4,96,4571,953,1017,1970,"6 de julio de 1997"
15,4,96,4572,905,1006,1911,"6 de julio de 1997"
15,4,96,4573,658,636,1294,"6 de julio de 1997"
15,4,96,4574,456,501,957,"6 de julio de 1997"
15,4,96,4575,788,823,1611,"6 de julio de 1997"
15,4,96,4576,581,657,1238,"6 de julio de 1997"
15,4,96,4577,550,593,1143,"6 de julio de 1997"
15,4,96,4578,148,117,265,"6 de julio de 1997"
15,4,96,4579,291,254,545,"6 de julio de 1997"
15,4,96,4580,758,776,1534,"6 de julio de 1997"
15,4,96,4581,297,309,606,"6 de julio de 1997"
15,4,96,4582,1076,1101,2177,"6 de julio de 1997"
15,4,96,4583,446,471,917,"6 de julio de 1997"
15,4,96,4584,620,620,1240,"6 de julio de 1997"
15,4,96,4585,485,525,1010,"6 de julio de 1997"
15,4,96,4586,790,804,1594,"6 de julio de 1997"
15,4,96,4587,601,594,1195,"6 de julio de 1997"
15,4,113,5704,656,695,1351,"6 de julio de 1997"
15,4,113,5705,601,676,1277,"6 de julio de 1997"
15,4,113,5706,588,597,1185,"6 de julio de 1997"
15,4,113,5707,787,724,1511,"6 de julio de 1997"
15,4,113,5708,299,264,563,"6 de julio de 1997"
15,4,113,5709,203,192,395,"6 de julio de 1997"
15,4,113,5710,356,301,657,"6 de julio de 1997"
15,4,113,5711,193,179,372,"6 de julio de 1997"
15,4,113,5712,447,387,834,"6 de julio de 1997"
15,4,113,5713,548,487,1035,"6 de julio de 1997"
15,4,113,5714,345,311,656,"6 de julio de 1997"
15,4,113,5715,120,115,235,"6 de julio de 1997"
15,4,113,5716,561,531,1092,"6 de julio de 1997"
15,4,113,5717,356,286,642,"6 de julio de 1997"
15,4,113,5718,484,483,967,"6 de julio de 1997"
15,4,113,5719,467,401,868,"6 de julio de 1997"
15,4,113,5720,497,425,922,"6 de julio de 1997"
15,4,113,5721,637,621,1258,"6 de julio de 1997"
15,4,113,5722,145,112,257,"6 de julio de 1997"
15,5,2,33,569,581,1150,"6 de julio de 1997"
15,5,2,34,617,672,1289,"6 de julio de 1997"
15,5,2,35,659,675,1334,"6 de julio de 1997"
15,5,2,36,50,53,103,"6 de julio de 1997"
15,5,2,37,563,595,1158,"6 de julio de 1997"
15,5,2,38,588,613,1201,"6 de julio de 1997"
15,5,2,39,37,45,82,"6 de julio de 1997"
15,5,2,40,220,241,461,"6 de julio de 1997"
15,5,2,41,526,555,1081,"6 de julio de 1997"
15,5,2,42,519,565,1084,"6 de julio de 1997"
15,5,2,43,529,569,1098,"6 de julio de 1997"
15,5,2,44,477,518,995,"6 de julio de 1997"
15,5,2,45,495,533,1028,"6 de julio de 1997"
15,5,2,46,616,685,1301,"6 de julio de 1997"
15,5,2,47,618,667,1285,"6 de julio de 1997"
15,5,2,48,695,672,1367,"6 de julio de 1997"
15,5,2,49,861,894,1755,"6 de julio de 1997"
15,5,2,50,818,876,1694,"6 de julio de 1997"
15,5,2,51,845,899,1744,"6 de julio de 1997"
15,5,2,52,469,481,950,"6 de julio de 1997"
15,5,2,53,706,860,1566,"6 de julio de 1997"
15,5,2,54,708,823,1531,"6 de julio de 1997"
15,5,2,55,754,840,1594,"6 de julio de 1997"
15,5,2,56,590,627,1217,"6 de julio de 1997"
15,5,2,57,611,634,1245,"6 de julio de 1997"
15,5,2,58,554,599,1153,"6 de julio de 1997"
15,5,16,469,469,459,928,"6 de julio de 1997"
15,5,16,470,438,449,887,"6 de julio de 1997"
15,5,16,471,198,232,430,"6 de julio de 1997"
15,5,16,472,406,391,797,"6 de julio de 1997"
15,5,16,473,368,360,728,"6 de julio de 1997"
15,5,16,474,148,149,297,"6 de julio de 1997"
15,5,16,475,202,174,376,"6 de julio de 1997"
15,5,16,476,79,76,155,"6 de julio de 1997"
15,5,16,477,115,98,213,"6 de julio de 1997"
15,5,16,478,603,589,1192,"6 de julio de 1997"
15,5,16,479,49,50,99,"6 de julio de 1997"
15,5,16,480,78,63,141,"6 de julio de 1997"
15,5,16,481,124,116,240,"6 de julio de 1997"
15,5,16,482,255,250,505,"6 de julio de 1997"
15,5,16,483,150,130,280,"6 de julio de 1997"
15,5,16,484,133,122,255,"6 de julio de 1997"
15,5,16,485,390,402,792,"6 de julio de 1997"
15,5,16,486,358,357,715,"6 de julio de 1997"
15,5,16,487,542,572,1114,"6 de julio de 1997"
15,5,16,488,23,25,48,"6 de julio de 1997"
15,5,16,489,38,46,84,"6 de julio de 1997"
15,5,62,3823,387,399,786,"6 de julio de 1997"
15,5,62,3824,350,356,706,"6 de julio de 1997"
15,5,62,3825,41,36,77,"6 de julio de 1997"
15,5,62,3826,791,774,1565,"6 de julio de 1997"
15,5,62,3827,372,379,751,"6 de julio de 1997"
15,5,66,3880,499,593,1092,"6 de julio de 1997"
15,5,66,3881,483,562,1045,"6 de julio de 1997"
15,5,66,3882,290,339,629,"6 de julio de 1997"
15,5,66,3883,722,770,1492,"6 de julio de 1997"
15,5,66,3884,471,474,945,"6 de julio de 1997"
15,5,66,3885,564,613,1177,"6 de julio de 1997"
15,5,66,3886,27,21,48,"6 de julio de 1997"
15,5,66,3887,385,355,740,"6 de julio de 1997"
15,5,66,3888,170,161,331,"6 de julio de 1997"
15,5,66,3889,230,270,500,"6 de julio de 1997"
15,5,66,3890,399,389,788,"6 de julio de 1997"
15,5,66,3891,275,229,504,"6 de julio de 1997"
15,5,66,3892,338,337,675,"6 de julio de 1997"
15,5,66,3893,67,42,109,"6 de julio de 1997"
15,5,66,3894,198,145,343,"6 de julio de 1997"
15,5,66,3895,457,432,889,"6 de julio de 1997"
15,5,66,3896,587,540,1127,"6 de julio de 1997"
15,5,66,3897,415,397,812,"6 de julio de 1997"
15,5,66,3898,338,367,705,"6 de julio de 1997"
15,5,76,4106,518,541,1059,"6 de julio de 1997"
15,5,76,4107,573,618,1191,"6 de julio de 1997"
15,5,76,4108,566,571,1137,"6 de julio de 1997"
15,5,76,4109,685,734,1419,"6 de julio de 1997"
15,5,76,4110,763,775,1538,"6 de julio de 1997"
15,5,76,4111,51,50,101,"6 de julio de 1997"
15,5,76,4112,114,93,207,"6 de julio de 1997"
15,5,76,4113,281,276,557,"6 de julio de 1997"
15,5,76,4114,223,209,432,"6 de julio de 1997"
15,5,76,4115,154,153,307,"6 de julio de 1997"
15,5,76,4116,179,192,371,"6 de julio de 1997"
15,5,76,4117,45,47,92,"6 de julio de 1997"
15,5,76,4118,381,421,802,"6 de julio de 1997"
15,5,76,4119,399,341,740,"6 de julio de 1997"
15,5,76,4120,6,2,8,"6 de julio de 1997"
15,5,82,4188,522,548,1070,"6 de julio de 1997"
15,5,82,4189,607,654,1261,"6 de julio de 1997"
15,5,82,4190,749,811,1560,"6 de julio de 1997"
15,5,82,4191,700,728,1428,"6 de julio de 1997"
15,5,82,4192,473,530,1003,"6 de julio de 1997"
15,5,82,4193,531,556,1087,"6 de julio de 1997"
15,5,82,4194,397,403,800,"6 de julio de 1997"
15,5,82,4195,542,582,1124,"6 de julio de 1997"
15,5,82,4196,305,329,634,"6 de julio de 1997"
15,5,82,4197,810,884,1694,"6 de julio de 1997"
15,5,82,4198,533,610,1143,"6 de julio de 1997"
15,5,82,4199,677,723,1400,"6 de julio de 1997"
15,5,82,4200,295,324,619,"6 de julio de 1997"
15,5,82,4201,737,699,1436,"6 de julio de 1997"
15,5,82,4202,460,489,949,"6 de julio de 1997"
15,5,82,4203,650,711,1361,"6 de julio de 1997"
15,5,82,4204,746,842,1588,"6 de julio de 1997"
15,5,82,4205,602,593,1195,"6 de julio de 1997"
15,5,82,4206,576,616,1192,"6 de julio de 1997"
15,5,82,4207,738,752,1490,"6 de julio de 1997"
15,5,82,4208,429,467,896,"6 de julio de 1997"
15,5,82,4209,693,739,1432,"6 de julio de 1997"
15,5,82,4210,50,56,106,"6 de julio de 1997"
15,5,82,4211,471,523,994,"6 de julio de 1997"
15,5,82,4212,895,981,1876,"6 de julio de 1997"
15,5,82,4213,672,727,1399,"6 de julio de 1997"
15,5,82,4214,560,589,1149,"6 de julio de 1997"
15,5,82,4215,612,684,1296,"6 de julio de 1997"
15,5,82,4216,738,806,1544,"6 de julio de 1997"
15,5,82,4217,535,575,1110,"6 de julio de 1997"
15,5,82,4218,841,883,1724,"6 de julio de 1997"
15,5,82,4219,561,604,1165,"6 de julio de 1997"
15,5,82,4220,722,798,1520,"6 de julio de 1997"
15,5,82,4221,483,490,973,"6 de julio de 1997"
15,5,82,4222,409,475,884,"6 de julio de 1997"
15,5,82,4223,606,676,1282,"6 de julio de 1997"
15,5,82,4224,656,729,1385,"6 de julio de 1997"
15,5,82,4225,420,439,859,"6 de julio de 1997"
15,5,82,4226,901,953,1854,"6 de julio de 1997"
15,5,82,4227,615,646,1261,"6 de julio de 1997"
15,5,82,4228,720,753,1473,"6 de julio de 1997"
15,5,82,4229,680,779,1459,"6 de julio de 1997"
15,5,82,4230,516,571,1087,"6 de julio de 1997"
15,5,82,4231,691,753,1444,"6 de julio de 1997"
15,5,82,4232,578,626,1204,"6 de julio de 1997"
15,5,82,4233,686,778,1464,"6 de julio de 1997"
15,5,82,4234,643,726,1369,"6 de julio de 1997"
15,5,82,4235,472,516,988,"6 de julio de 1997"
15,5,82,4236,559,612,1171,"6 de julio de 1997"
15,5,82,4237,716,846,1562,"6 de julio de 1997"
15,5,82,4238,649,722,1371,"6 de julio de 1997"
15,5,82,4239,508,576,1084,"6 de julio de 1997"
15,5,82,4240,447,528,975,"6 de julio de 1997"
15,5,82,4241,544,586,1130,"6 de julio de 1997"
15,5,82,4242,621,642,1263,"6 de julio de 1997"
15,5,82,4243,626,705,1331,"6 de julio de 1997"
15,5,82,4244,609,655,1264,"6 de julio de 1997"
15,5,82,4245,601,669,1270,"6 de julio de 1997"
15,5,82,4246,557,601,1158,"6 de julio de 1997"
15,5,82,4247,764,910,1674,"6 de julio de 1997"
15,5,82,4248,708,770,1478,"6 de julio de 1997"
15,5,82,4249,551,647,1198,"6 de julio de 1997"
15,5,82,4250,677,777,1454,"6 de julio de 1997"
15,5,82,4251,691,767,1458,"6 de julio de 1997"
15,5,82,4252,211,226,437,"6 de julio de 1997"
15,5,82,4253,525,591,1116,"6 de julio de 1997"
15,5,82,4254,176,194,370,"6 de julio de 1997"
15,5,82,4255,461,536,997,"6 de julio de 1997"
15,5,85,4331,707,761,1468,"6 de julio de 1997"
15,5,85,4332,655,700,1355,"6 de julio de 1997"
15,5,85,4333,69,72,141,"6 de julio de 1997"
15,5,85,4334,457,495,952,"6 de julio de 1997"
15,5,85,4335,391,392,783,"6 de julio de 1997"
15,5,85,4336,166,165,331,"6 de julio de 1997"
15,5,85,4337,892,912,1804,"6 de julio de 1997"
15,5,85,4338,278,305,583,"6 de julio de 1997"
15,5,85,4339,224,257,481,"6 de julio de 1997"
15,5,85,4340,517,549,1066,"6 de julio de 1997"
15,5,85,4341,215,193,408,"6 de julio de 1997"
15,5,85,4342,778,766,1544,"6 de julio de 1997"
15,5,85,4343,501,526,1027,"6 de julio de 1997"
15,5,85,4344,441,442,883,"6 de julio de 1997"
15,5,85,4345,146,126,272,"6 de julio de 1997"
15,5,93,4523,765,847,1612,"6 de julio de 1997"
15,5,93,4524,775,892,1667,"6 de julio de 1997"
15,5,93,4525,1836,971,2807,"6 de julio de 1997"
15,5,93,4526,802,877,1679,"6 de julio de 1997"
15,5,93,4527,866,995,1861,"6 de julio de 1997"
15,5,93,4528,968,1026,1994,"6 de julio de 1997"
15,5,93,4529,169,180,349,"6 de julio de 1997"
15,5,93,4530,211,234,445,"6 de julio de 1997"
15,5,93,4531,104,100,204,"6 de julio de 1997"
15,5,93,4532,251,222,473,"6 de julio de 1997"
15,5,93,4533,67,67,134,"6 de julio de 1997"
15,5,93,4534,468,480,948,"6 de julio de 1997"
15,5,93,4535,457,502,959,"6 de julio de 1997"
15,5,93,4536,68,73,141,"6 de julio de 1997"
15,5,93,4537,514,535,1049,"6 de julio de 1997"
15,5,93,4538,798,808,1606,"6 de julio de 1997"
15,5,93,4539,632,612,1244,"6 de julio de 1997"
15,5,93,4540,83,91,174,"6 de julio de 1997"
15,5,93,4541,100,86,186,"6 de julio de 1997"
15,5,93,4542,642,661,1303,"6 de julio de 1997"
15,5,93,4543,487,515,1002,"6 de julio de 1997"
15,5,93,4544,41,37,78,"6 de julio de 1997"
15,5,93,4545,548,583,1131,"6 de julio de 1997"
15,5,94,4546,528,583,1111,"6 de julio de 1997"
15,5,94,4547,589,611,1200,"6 de julio de 1997"
15,5,94,4548,517,537,1054,"6 de julio de 1997"
15,5,94,4549,537,552,1089,"6 de julio de 1997"
15,5,94,4550,498,495,993,"6 de julio de 1997"
15,5,94,4551,611,629,1240,"6 de julio de 1997"
15,5,94,4552,296,316,612,"6 de julio de 1997"
15,5,94,4553,710,714,1424,"6 de julio de 1997"
15,5,94,4554,773,767,1540,"6 de julio de 1997"
15,5,94,4555,294,275,569,"6 de julio de 1997"
15,5,101,4691,766,778,1544,"6 de julio de 1997"
15,5,101,4692,705,764,1469,"6 de julio de 1997"
15,5,101,4693,402,462,864,"6 de julio de 1997"
15,5,101,4694,433,470,903,"6 de julio de 1997"
15,5,101,4695,705,761,1466,"6 de julio de 1997"
15,5,101,4696,463,495,958,"6 de julio de 1997"
15,5,101,4697,875,922,1797,"6 de julio de 1997"
15,5,101,4698,105,106,211,"6 de julio de 1997"
15,5,101,4699,28,38,66,"6 de julio de 1997"
15,5,101,4700,233,240,473,"6 de julio de 1997"
15,6,20,523,831,893,1724,"6 de julio de 1997"
15,6,20,524,736,827,1563,"6 de julio de 1997"
15,6,20,525,717,804,1521,"6 de julio de 1997"
15,6,20,526,700,796,1496,"6 de julio de 1997"
15,6,20,527,773,909,1682,"6 de julio de 1997"
15,6,20,528,831,924,1755,"6 de julio de 1997"
15,6,20,529,486,533,1019,"6 de julio de 1997"
15,6,20,530,514,542,1056,"6 de julio de 1997"
15,6,20,531,691,792,1483,"6 de julio de 1997"
15,6,20,532,536,573,1109,"6 de julio de 1997"
15,6,20,533,535,572,1107,"6 de julio de 1997"
15,6,20,534,865,1003,1868,"6 de julio de 1997"
15,6,20,535,880,1003,1883,"6 de julio de 1997"
15,6,20,536,530,632,1162,"6 de julio de 1997"
15,6,20,537,748,857,1605,"6 de julio de 1997"
15,6,20,538,695,805,1500,"6 de julio de 1997"
15,6,20,539,749,844,1593,"6 de julio de 1997"
15,6,20,540,894,970,1864,"6 de julio de 1997"
15,6,20,541,461,534,995,"6 de julio de 1997"
15,6,20,542,333,400,733,"6 de julio de 1997"
15,6,20,543,490,570,1060,"6 de julio de 1997"
15,6,20,544,317,394,711,"6 de julio de 1997"
15,6,20,545,308,351,659,"6 de julio de 1997"
15,6,20,546,518,586,1104,"6 de julio de 1997"
15,6,20,547,326,358,684,"6 de julio de 1997"
15,6,20,548,515,582,1097,"6 de julio de 1997"
15,6,20,549,1063,1224,2287,"6 de julio de 1997"
15,6,20,550,726,803,1529,"6 de julio de 1997"
15,6,20,551,826,945,1771,"6 de julio de 1997"
15,6,20,552,811,934,1745,"6 de julio de 1997"
15,6,20,553,310,360,670,"6 de julio de 1997"
15,6,20,554,673,799,1472,"6 de julio de 1997"
15,6,20,555,322,403,725,"6 de julio de 1997"
15,6,20,556,670,763,1433,"6 de julio de 1997"
15,6,20,557,344,438,782,"6 de julio de 1997"
15,6,20,558,691,842,1533,"6 de julio de 1997"
15,6,20,559,790,866,1656,"6 de julio de 1997"
15,6,20,560,607,643,1250,"6 de julio de 1997"
15,6,20,561,617,621,1238,"6 de julio de 1997"
15,6,20,562,814,1028,1842,"6 de julio de 1997"
15,6,20,563,551,610,1161,"6 de julio de 1997"
15,6,20,564,333,403,736,"6 de julio de 1997"
15,6,20,565,464,518,982,"6 de julio de 1997"
15,6,20,566,397,471,868,"6 de julio de 1997"
15,6,20,567,328,335,663,"6 de julio de 1997"
15,6,20,568,231,264,495,"6 de julio de 1997"
15,6,20,569,922,1053,1975,"6 de julio de 1997"
15,6,20,570,517,539,1056,"6 de julio de 1997"
15,6,20,571,363,433,796,"6 de julio de 1997"
15,6,20,572,547,682,1229,"6 de julio de 1997"
15,6,20,573,779,967,1746,"6 de julio de 1997"
15,6,20,574,65,83,148,"6 de julio de 1997"
15,6,20,575,669,687,1356,"6 de julio de 1997"
15,6,20,576,712,817,1529,"6 de julio de 1997"
15,6,20,577,591,653,1244,"6 de julio de 1997"
15,6,20,578,941,1096,2037,"6 de julio de 1997"
15,6,20,579,227,236,463,"6 de julio de 1997"
15,6,20,580,160,197,357,"6 de julio de 1997"
15,6,20,581,252,280,532,"6 de julio de 1997"
15,6,20,582,240,267,507,"6 de julio de 1997"
15,6,20,583,289,337,626,"6 de julio de 1997"
15,6,20,584,286,326,612,"6 de julio de 1997"
15,6,20,585,350,404,754,"6 de julio de 1997"
15,6,20,586,291,338,629,"6 de julio de 1997"
15,6,20,587,118,119,237,"6 de julio de 1997"
15,6,20,588,388,448,836,"6 de julio de 1997"
15,6,20,589,532,589,1121,"6 de julio de 1997"
15,6,20,590,601,667,1268,"6 de julio de 1997"
15,6,20,591,622,693,1315,"6 de julio de 1997"
15,6,20,592,765,789,1554,"6 de julio de 1997"
15,6,20,593,478,532,1010,"6 de julio de 1997"
15,6,20,594,625,726,1351,"6 de julio de 1997"
15,6,20,595,536,601,1137,"6 de julio de 1997"
15,6,20,596,315,404,719,"6 de julio de 1997"
15,6,20,597,436,515,951,"6 de julio de 1997"
15,6,20,598,318,376,694,"6 de julio de 1997"
15,6,20,599,337,384,721,"6 de julio de 1997"
15,6,20,600,394,439,833,"6 de julio de 1997"
15,6,20,601,790,833,1623,"6 de julio de 1997"
15,6,20,602,752,839,1591,"6 de julio de 1997"
15,6,20,603,457,450,907,"6 de julio de 1997"
15,6,20,604,489,570,1059,"6 de julio de 1997"
15,6,20,605,612,647,1259,"6 de julio de 1997"
15,6,20,606,693,743,1436,"6 de julio de 1997"
15,6,20,607,567,617,1184,"6 de julio de 1997"
15,6,20,608,472,529,1001,"6 de julio de 1997"
15,6,20,609,727,851,1578,"6 de julio de 1997"
15,6,20,610,1301,1353,2654,"6 de julio de 1997"
15,6,20,611,713,799,1512,"6 de julio de 1997"
15,6,20,612,495,532,1027,"6 de julio de 1997"
15,6,20,613,734,728,1462,"6 de julio de 1997"
15,6,20,614,1083,1177,2260,"6 de julio de 1997"
15,6,20,615,764,771,1535,"6 de julio de 1997"
15,6,20,616,716,773,1489,"6 de julio de 1997"
15,6,20,617,554,652,1206,"6 de julio de 1997"
15,6,20,618,892,1061,1953,"6 de julio de 1997"
15,6,20,619,652,711,1363,"6 de julio de 1997"
15,6,20,620,655,733,1388,"6 de julio de 1997"
15,6,20,621,663,673,1336,"6 de julio de 1997"
15,6,20,622,344,402,746,"6 de julio de 1997"
15,6,20,623,266,308,574,"6 de julio de 1997"
15,6,20,624,468,520,988,"6 de julio de 1997"
15,6,20,625,232,308,540,"6 de julio de 1997"
15,6,20,626,429,534,963,"6 de julio de 1997"
15,6,20,627,346,447,793,"6 de julio de 1997"
15,6,20,628,360,398,758,"6 de julio de 1997"
15,6,54,2448,485,490,975,"6 de julio de 1997"
15,6,54,2449,447,466,913,"6 de julio de 1997"
15,6,54,2450,973,1036,2009,"6 de julio de 1997"
15,6,54,2451,718,806,1524,"6 de julio de 1997"
15,6,54,2452,610,601,1211,"6 de julio de 1997"
15,6,54,2453,766,859,1625,"6 de julio de 1997"
15,6,54,2454,824,866,1690,"6 de julio de 1997"
15,6,54,2455,634,715,1349,"6 de julio de 1997"
15,6,54,2456,667,714,1381,"6 de julio de 1997"
15,6,54,2457,487,502,989,"6 de julio de 1997"
15,6,54,2458,580,626,1206,"6 de julio de 1997"
15,6,54,2459,661,740,1401,"6 de julio de 1997"
15,6,54,2460,88,83,171,"6 de julio de 1997"
15,6,54,2461,80,93,173,"6 de julio de 1997"
15,6,54,2462,774,782,1556,"6 de julio de 1997"
15,6,54,2463,275,310,585,"6 de julio de 1997"
15,6,109,5452,787,853,1640,"6 de julio de 1997"
15,6,109,5453,651,699,1350,"6 de julio de 1997"
15,6,109,5454,696,828,1524,"6 de julio de 1997"
15,6,109,5455,764,829,1593,"6 de julio de 1997"
15,6,109,5456,932,1036,1968,"6 de julio de 1997"
15,6,109,5457,571,637,1208,"6 de julio de 1997"
15,6,109,5458,407,452,859,"6 de julio de 1997"
15,6,109,5459,773,857,1630,"6 de julio de 1997"
15,6,109,5460,469,538,1007,"6 de julio de 1997"
15,6,109,5461,742,823,1565,"6 de julio de 1997"
15,6,109,5462,740,725,1465,"6 de julio de 1997"
15,6,109,5463,630,690,1320,"6 de julio de 1997"
15,6,109,5464,521,598,1119,"6 de julio de 1997"
15,6,109,5465,618,700,1318,"6 de julio de 1997"
15,6,109,5466,684,752,1436,"6 de julio de 1997"
15,6,109,5467,640,732,1372,"6 de julio de 1997"
15,6,109,5468,452,497,949,"6 de julio de 1997"
15,6,109,5469,148,161,309,"6 de julio de 1997"
15,6,109,5470,73,85,158,"6 de julio de 1997"
15,6,109,5471,242,275,517,"6 de julio de 1997"
15,6,109,5472,143,178,321,"6 de julio de 1997"
15,6,109,5473,775,789,1564,"6 de julio de 1997"
15,6,109,5474,459,541,1000,"6 de julio de 1997"
15,6,109,5475,721,864,1585,"6 de julio de 1997"
15,6,109,5476,539,602,1141,"6 de julio de 1997"
15,6,109,5477,909,887,1796,"6 de julio de 1997"
15,6,109,5478,705,875,1580,"6 de julio de 1997"
15,6,109,5479,600,688,1288,"6 de julio de 1997"
15,6,109,5480,712,774,1486,"6 de julio de 1997"
15,6,109,5481,544,598,1142,"6 de julio de 1997"
15,7,25,692,467,542,1009,"6 de julio de 1997"
15,7,25,693,1138,1138,2276,"6 de julio de 1997"
15,7,25,694,679,765,1444,"6 de julio de 1997"
15,7,25,695,572,604,1176,"6 de julio de 1997"
15,7,25,696,522,594,1116,"6 de julio de 1997"
15,7,25,697,598,628,1226,"6 de julio de 1997"
15,7,25,698,664,686,1350,"6 de julio de 1997"
15,7,25,699,504,565,1069,"6 de julio de 1997"
15,7,25,700,613,623,1236,"6 de julio de 1997"
15,7,25,701,476,533,1009,"6 de julio de 1997"
15,7,25,702,440,539,979,"6 de julio de 1997"
15,7,25,703,367,378,745,"6 de julio de 1997"
15,7,25,704,722,770,1492,"6 de julio de 1997"
15,7,25,705,572,572,1144,"6 de julio de 1997"
15,7,25,706,605,616,1221,"6 de julio de 1997"
15,7,25,707,291,310,601,"6 de julio de 1997"
15,7,25,708,356,386,742,"6 de julio de 1997"
15,7,25,709,449,509,958,"6 de julio de 1997"
15,7,25,710,432,482,914,"6 de julio de 1997"
15,7,25,711,561,618,1179,"6 de julio de 1997"
15,7,25,712,168,209,377,"6 de julio de 1997"
15,7,25,713,404,478,882,"6 de julio de 1997"
15,7,25,714,636,731,1367,"6 de julio de 1997"
15,7,25,715,393,457,850,"6 de julio de 1997"
15,7,25,716,437,489,926,"6 de julio de 1997"
15,7,25,717,286,316,602,"6 de julio de 1997"
15,7,25,718,701,764,1465,"6 de julio de 1997"
15,7,25,719,604,647,1251,"6 de julio de 1997"
15,7,25,720,496,573,1069,"6 de julio de 1997"
15,7,25,721,176,211,387,"6 de julio de 1997"
15,7,25,722,550,601,1151,"6 de julio de 1997"
15,7,25,723,468,573,1041,"6 de julio de 1997"
15,7,25,724,553,555,1108,"6 de julio de 1997"
15,7,25,725,718,755,1473,"6 de julio de 1997"
15,7,25,726,417,405,822,"6 de julio de 1997"
15,7,25,727,605,627,1232,"6 de julio de 1997"
15,7,25,728,386,450,836,"6 de julio de 1997"
15,7,25,729,418,492,910,"6 de julio de 1997"
15,7,25,730,940,993,1933,"6 de julio de 1997"
15,7,25,731,835,907,1742,"6 de julio de 1997"
15,7,25,732,459,500,959,"6 de julio de 1997"
15,7,25,733,338,368,706,"6 de julio de 1997"
15,7,25,734,696,758,1454,"6 de julio de 1997"
15,7,25,735,554,637,1191,"6 de julio de 1997"
15,7,25,736,485,538,1023,"6 de julio de 1997"
15,7,25,737,549,599,1148,"6 de julio de 1997"
15,7,25,738,583,629,1212,"6 de julio de 1997"
15,7,25,739,472,527,999,"6 de julio de 1997"
15,7,25,740,320,363,683,"6 de julio de 1997"
15,7,25,741,540,620,1160,"6 de julio de 1997"
15,7,25,742,332,368,700,"6 de julio de 1997"
15,7,25,743,365,390,755,"6 de julio de 1997"
15,7,25,744,452,524,976,"6 de julio de 1997"
15,7,25,745,451,480,931,"6 de julio de 1997"
15,7,25,746,779,846,1625,"6 de julio de 1997"
15,7,25,747,652,767,1419,"6 de julio de 1997"
15,7,25,748,327,332,659,"6 de julio de 1997"
15,7,25,749,323,364,687,"6 de julio de 1997"
15,7,25,750,351,429,780,"6 de julio de 1997"
15,7,25,751,394,423,817,"6 de julio de 1997"
15,7,25,752,392,455,847,"6 de julio de 1997"
15,7,25,753,380,431,811,"6 de julio de 1997"
15,7,25,754,591,626,1217,"6 de julio de 1997"
15,7,25,755,641,720,1361,"6 de julio de 1997"
15,7,25,756,579,631,1210,"6 de julio de 1997"
15,7,25,757,266,315,581,"6 de julio de 1997"
15,7,25,758,682,737,1419,"6 de julio de 1997"
15,7,25,759,457,522,979,"6 de julio de 1997"
15,7,25,760,681,722,1403,"6 de julio de 1997"
15,7,25,761,527,568,1095,"6 de julio de 1997"
15,7,25,762,503,618,1121,"6 de julio de 1997"
15,7,25,763,275,317,592,"6 de julio de 1997"
15,7,25,764,357,398,755,"6 de julio de 1997"
15,7,25,765,634,686,1320,"6 de julio de 1997"
15,7,25,766,499,546,1045,"6 de julio de 1997"
15,7,25,767,568,609,1177,"6 de julio de 1997"
15,7,25,768,538,628,1166,"6 de julio de 1997"
15,7,25,769,534,588,1122,"6 de julio de 1997"
15,7,25,770,589,651,1240,"6 de julio de 1997"
15,7,25,771,345,369,714,"6 de julio de 1997"
15,7,25,772,206,243,449,"6 de julio de 1997"
15,7,25,773,271,317,588,"6 de julio de 1997"
15,7,25,774,299,319,618,"6 de julio de 1997"
15,7,25,775,237,279,516,"6 de julio de 1997"
15,7,25,776,228,278,506,"6 de julio de 1997"
15,7,25,777,229,259,488,"6 de julio de 1997"
15,7,25,778,229,246,475,"6 de julio de 1997"
15,7,25,779,793,861,1654,"6 de julio de 1997"
15,7,25,780,478,551,1029,"6 de julio de 1997"
15,7,25,781,475,529,1004,"6 de julio de 1997"
15,7,25,782,493,558,1051,"6 de julio de 1997"
15,7,25,783,696,803,1499,"6 de julio de 1997"
15,7,25,784,623,712,1335,"6 de julio de 1997"
15,7,25,785,551,652,1203,"6 de julio de 1997"
15,7,25,786,316,379,695,"6 de julio de 1997"
15,7,25,787,579,660,1239,"6 de julio de 1997"
15,7,25,788,391,474,865,"6 de julio de 1997"
15,7,25,789,550,639,1189,"6 de julio de 1997"
15,7,25,790,515,538,1053,"6 de julio de 1997"
15,7,25,791,691,764,1455,"6 de julio de 1997"
15,7,25,792,841,959,1800,"6 de julio de 1997"
15,7,25,793,565,591,1156,"6 de julio de 1997"
15,7,25,794,648,699,1347,"6 de julio de 1997"
15,7,25,795,484,613,1097,"6 de julio de 1997"
15,7,25,796,415,559,974,"6 de julio de 1997"
15,7,25,797,496,613,1109,"6 de julio de 1997"
15,7,25,798,952,1057,2009,"6 de julio de 1997"
15,7,25,799,549,633,1182,"6 de julio de 1997"
15,7,25,800,626,710,1336,"6 de julio de 1997"
15,7,25,801,522,587,1109,"6 de julio de 1997"
15,7,25,802,1036,1107,2143,"6 de julio de 1997"
15,7,25,803,264,331,595,"6 de julio de 1997"
15,7,25,804,595,647,1242,"6 de julio de 1997"
15,7,25,805,386,443,829,"6 de julio de 1997"
15,7,25,806,438,486,924,"6 de julio de 1997"
15,7,25,807,381,468,849,"6 de julio de 1997"
15,7,25,808,617,736,1353,"6 de julio de 1997"
15,7,25,809,730,838,1568,"6 de julio de 1997"
15,7,25,810,210,259,469,"6 de julio de 1997"
15,7,25,811,332,392,724,"6 de julio de 1997"
15,7,25,812,381,469,850,"6 de julio de 1997"
15,7,25,813,570,676,1246,"6 de julio de 1997"
15,7,25,814,198,218,416,"6 de julio de 1997"
15,7,25,815,764,808,1572,"6 de julio de 1997"
15,7,25,816,602,724,1326,"6 de julio de 1997"
15,7,25,817,504,584,1088,"6 de julio de 1997"
15,7,25,818,616,683,1299,"6 de julio de 1997"
15,7,25,819,630,674,1304,"6 de julio de 1997"
15,7,25,820,338,378,716,"6 de julio de 1997"
15,7,25,821,407,462,869,"6 de julio de 1997"
15,7,25,822,360,394,754,"6 de julio de 1997"
15,7,25,823,352,422,774,"6 de julio de 1997"
15,7,25,824,355,431,786,"6 de julio de 1997"
15,7,25,825,608,715,1323,"6 de julio de 1997"
15,7,25,826,291,311,602,"6 de julio de 1997"
15,7,25,827,441,515,956,"6 de julio de 1997"
15,7,25,828,572,659,1231,"6 de julio de 1997"
15,7,25,829,450,469,919,"6 de julio de 1997"
15,7,25,830,362,401,763,"6 de julio de 1997"
15,7,25,831,387,398,785,"6 de julio de 1997"
15,7,25,832,321,388,709,"6 de julio de 1997"
15,7,25,833,326,376,702,"6 de julio de 1997"
15,7,25,834,431,485,916,"6 de julio de 1997"
15,7,25,835,367,401,768,"6 de julio de 1997"
15,7,25,836,314,367,681,"6 de julio de 1997"
15,7,25,837,922,1032,1954,"6 de julio de 1997"
15,7,25,838,260,353,613,"6 de julio de 1997"
15,7,25,839,270,323,593,"6 de julio de 1997"
15,7,25,840,661,808,1469,"6 de julio de 1997"
15,7,25,841,577,667,1244,"6 de julio de 1997"
15,7,25,842,318,379,697,"6 de julio de 1997"
15,7,25,843,371,427,798,"6 de julio de 1997"
15,7,25,844,283,309,592,"6 de julio de 1997"
15,7,25,845,398,413,811,"6 de julio de 1997"
15,7,25,846,336,359,695,"6 de julio de 1997"
15,7,25,847,385,456,841,"6 de julio de 1997"
15,7,25,848,634,677,1311,"6 de julio de 1997"
15,7,25,849,561,700,1261,"6 de julio de 1997"
15,7,25,850,1776,2169,3945,"6 de julio de 1997"
15,7,25,851,810,985,1795,"6 de julio de 1997"
15,7,25,852,340,390,730,"6 de julio de 1997"
15,7,25,853,781,861,1642,"6 de julio de 1997"
15,7,25,854,568,621,1189,"6 de julio de 1997"
15,7,25,855,417,434,851,"6 de julio de 1997"
15,7,25,856,497,501,998,"6 de julio de 1997"
15,7,25,857,826,838,1664,"6 de julio de 1997"
15,7,25,858,260,307,567,"6 de julio de 1997"
15,7,25,859,490,508,998,"6 de julio de 1997"
15,7,25,860,419,441,860,"6 de julio de 1997"
15,7,25,861,413,428,841,"6 de julio de 1997"
15,7,25,862,487,570,1057,"6 de julio de 1997"
15,7,25,863,461,543,1004,"6 de julio de 1997"
15,7,25,864,555,567,1122,"6 de julio de 1997"
15,7,25,865,483,490,973,"6 de julio de 1997"
15,7,25,866,539,541,1080,"6 de julio de 1997"
15,7,25,867,951,980,1931,"6 de julio de 1997"
15,7,25,868,629,731,1360,"6 de julio de 1997"
15,7,25,869,705,738,1443,"6 de julio de 1997"
15,7,25,870,687,721,1408,"6 de julio de 1997"
15,7,25,871,533,536,1069,"6 de julio de 1997"
15,7,25,872,394,428,822,"6 de julio de 1997"
15,7,25,873,578,621,1199,"6 de julio de 1997"
15,7,25,874,538,567,1105,"6 de julio de 1997"
15,7,25,875,642,698,1340,"6 de julio de 1997"
15,7,25,876,356,408,764,"6 de julio de 1997"
15,7,25,877,252,294,546,"6 de julio de 1997"
15,7,25,878,409,433,842,"6 de julio de 1997"
15,7,25,879,508,552,1060,"6 de julio de 1997"
15,7,25,880,386,408,794,"6 de julio de 1997"
15,7,25,881,721,849,1570,"6 de julio de 1997"
15,7,25,882,903,1058,1961,"6 de julio de 1997"
15,7,25,883,422,486,908,"6 de julio de 1997"
15,7,25,884,743,821,1564,"6 de julio de 1997"
15,7,25,885,947,972,1919,"6 de julio de 1997"
15,7,25,886,580,601,1181,"6 de julio de 1997"
15,7,25,887,938,945,1883,"6 de julio de 1997"
15,7,25,888,488,535,1023,"6 de julio de 1997"
15,7,25,889,643,781,1424,"6 de julio de 1997"
15,7,25,890,334,404,738,"6 de julio de 1997"
15,7,25,891,150,165,315,"6 de julio de 1997"
15,7,25,892,168,178,346,"6 de julio de 1997"
15,7,25,893,496,570,1066,"6 de julio de 1997"
15,7,25,894,621,742,1363,"6 de julio de 1997"
15,7,25,895,504,554,1058,"6 de julio de 1997"
15,7,25,896,461,523,984,"6 de julio de 1997"
15,7,25,897,538,606,1144,"6 de julio de 1997"
15,7,25,898,371,478,849,"6 de julio de 1997"
15,7,25,899,459,565,1024,"6 de julio de 1997"
15,7,25,900,638,707,1345,"6 de julio de 1997"
15,7,25,901,267,336,603,"6 de julio de 1997"
15,7,25,902,892,967,1859,"6 de julio de 1997"
15,7,25,903,705,725,1430,"6 de julio de 1997"
15,7,25,904,573,633,1206,"6 de julio de 1997"
15,7,25,905,715,769,1484,"6 de julio de 1997"
15,7,25,906,664,682,1346,"6 de julio de 1997"
15,7,25,907,801,833,1634,"6 de julio de 1997"
15,7,25,908,531,523,1054,"6 de julio de 1997"
15,7,25,909,795,848,1643,"6 de julio de 1997"
15,7,25,910,956,1059,2015,"6 de julio de 1997"
15,7,25,911,635,652,1287,"6 de julio de 1997"
15,8,24,665,478,523,1001,"6 de julio de 1997"
15,8,24,666,663,790,1453,"6 de julio de 1997"
15,8,24,667,781,857,1638,"6 de julio de 1997"
15,8,24,668,694,835,1529,"6 de julio de 1997"
15,8,24,669,806,923,1729,"6 de julio de 1997"
15,8,24,670,872,904,1776,"6 de julio de 1997"
15,8,24,671,688,768,1456,"6 de julio de 1997"
15,8,24,672,697,764,1461,"6 de julio de 1997"
15,8,24,673,491,523,1014,"6 de julio de 1997"
15,8,24,674,479,623,1102,"6 de julio de 1997"
15,8,24,675,788,887,1675,"6 de julio de 1997"
15,8,24,676,472,495,967,"6 de julio de 1997"
15,8,24,677,500,539,1039,"6 de julio de 1997"
15,8,24,678,549,614,1163,"6 de julio de 1997"
15,8,24,679,489,538,1027,"6 de julio de 1997"
15,8,24,680,713,757,1470,"6 de julio de 1997"
15,8,24,681,384,443,827,"6 de julio de 1997"
15,8,24,682,342,366,708,"6 de julio de 1997"
15,8,24,683,297,334,631,"6 de julio de 1997"
15,8,24,684,407,482,889,"6 de julio de 1997"
15,8,24,685,577,577,1154,"6 de julio de 1997"
15,8,24,686,233,227,460,"6 de julio de 1997"
15,8,24,687,519,549,1068,"6 de julio de 1997"
15,8,24,688,523,560,1083,"6 de julio de 1997"
15,8,24,689,769,789,1558,"6 de julio de 1997"
15,8,24,690,715,739,1454,"6 de julio de 1997"
15,8,24,691,573,567,1140,"6 de julio de 1997"
15,8,110,5482,548,583,1131,"6 de julio de 1997"
15,8,110,5483,714,755,1469,"6 de julio de 1997"
15,8,110,5484,665,764,1429,"6 de julio de 1997"
15,8,110,5485,695,714,1409,"6 de julio de 1997"
15,8,110,5486,474,475,949,"6 de julio de 1997"
15,8,110,5487,424,417,841,"6 de julio de 1997"
15,8,110,5488,822,845,1667,"6 de julio de 1997"
15,8,110,5489,317,308,625,"6 de julio de 1997"
15,8,110,5490,879,858,1737,"6 de julio de 1997"
15,8,110,5491,388,410,798,"6 de julio de 1997"
15,8,110,5492,617,612,1229,"6 de julio de 1997"
15,8,110,5493,684,794,1478,"6 de julio de 1997"
15,8,110,5494,481,517,998,"6 de julio de 1997"
15,8,110,5495,566,620,1186,"6 de julio de 1997"
15,8,110,5496,312,298,610,"6 de julio de 1997"
15,8,110,5497,136,141,277,"6 de julio de 1997"
15,8,110,5498,251,273,524,"6 de julio de 1997"
15,8,110,5499,980,1081,2061,"6 de julio de 1997"
15,8,110,5500,741,774,1515,"6 de julio de 1997"
15,8,110,5501,464,494,958,"6 de julio de 1997"
15,8,110,5502,587,617,1204,"6 de julio de 1997"
15,8,110,5503,254,276,530,"6 de julio de 1997"
15,8,110,5504,305,336,641,"6 de julio de 1997"
15,8,110,5505,506,539,1045,"6 de julio de 1997"
15,8,110,5506,502,543,1045,"6 de julio de 1997"
15,8,110,5507,674,724,1398,"6 de julio de 1997"
15,8,110,5508,741,725,1466,"6 de julio de 1997"
15,8,110,5509,325,325,650,"6 de julio de 1997"
15,8,110,5510,619,628,1247,"6 de julio de 1997"
15,8,110,5511,529,552,1081,"6 de julio de 1997"
15,8,110,5512,700,757,1457,"6 de julio de 1997"
15,8,110,5513,592,574,1166,"6 de julio de 1997"
15,8,110,5514,590,555,1145,"6 de julio de 1997"
15,8,110,5515,839,916,1755,"6 de julio de 1997"
15,8,110,5516,730,773,1503,"6 de julio de 1997"
15,8,110,5517,780,833,1613,"6 de julio de 1997"
15,8,110,5518,755,807,1562,"6 de julio de 1997"
15,8,110,5519,658,671,1329,"6 de julio de 1997"
15,8,110,5520,165,201,366,"6 de julio de 1997"
15,8,110,5521,52,58,110,"6 de julio de 1997"
15,8,110,5522,585,660,1245,"6 de julio de 1997"
15,8,110,5523,1092,1237,2329,"6 de julio de 1997"
15,8,110,5524,424,454,878,"6 de julio de 1997"
15,8,110,5525,610,648,1258,"6 de julio de 1997"
15,8,110,5526,834,876,1710,"6 de julio de 1997"
15,8,110,5527,791,823,1614,"6 de julio de 1997"
15,8,110,5528,719,705,1424,"6 de julio de 1997"
15,8,110,5529,507,529,1036,"6 de julio de 1997"
15,8,110,5530,650,681,1331,"6 de julio de 1997"
15,8,110,5531,590,673,1263,"6 de julio de 1997"
15,8,110,5532,569,641,1210,"6 de julio de 1997"
15,8,110,5533,839,965,1804,"6 de julio de 1997"
15,8,110,5534,389,435,824,"6 de julio de 1997"
15,8,110,5535,379,438,817,"6 de julio de 1997"
15,8,110,5536,508,572,1080,"6 de julio de 1997"
15,8,110,5537,310,427,737,"6 de julio de 1997"
15,8,110,5538,547,592,1139,"6 de julio de 1997"
15,8,110,5539,999,1036,2035,"6 de julio de 1997"
15,8,110,5540,792,823,1615,"6 de julio de 1997"
15,8,110,5541,886,907,1793,"6 de julio de 1997"
15,8,110,5542,351,425,776,"6 de julio de 1997"
15,8,110,5543,288,305,593,"6 de julio de 1997"
15,8,110,5544,693,719,1412,"6 de julio de 1997"
15,8,110,5545,814,843,1657,"6 de julio de 1997"
15,8,110,5546,790,771,1561,"6 de julio de 1997"
15,8,110,5547,641,649,1290,"6 de julio de 1997"
15,8,110,5548,1132,1147,2279,"6 de julio de 1997"
15,8,110,5549,251,288,539,"6 de julio de 1997"
15,8,110,5550,678,711,1389,"6 de julio de 1997"
15,8,110,5551,343,395,738,"6 de julio de 1997"
15,8,110,5552,687,783,1470,"6 de julio de 1997"
15,8,110,5553,694,798,1492,"6 de julio de 1997"
15,8,110,5554,690,807,1497,"6 de julio de 1997"
15,8,110,5555,141,166,307,"6 de julio de 1997"
15,8,110,5556,503,548,1051,"6 de julio de 1997"
15,8,110,5557,1341,1397,2738,"6 de julio de 1997"
15,8,110,5558,726,750,1476,"6 de julio de 1997"
15,8,110,5559,630,641,1271,"6 de julio de 1997"
15,8,110,5560,590,637,1227,"6 de julio de 1997"
15,8,110,5561,718,740,1458,"6 de julio de 1997"
15,8,110,5562,660,735,1395,"6 de julio de 1997"
15,8,110,5563,559,537,1096,"6 de julio de 1997"
15,8,110,5564,628,647,1275,"6 de julio de 1997"
15,8,110,5565,223,229,452,"6 de julio de 1997"
15,8,110,5566,895,932,1827,"6 de julio de 1997"
15,8,110,5567,401,427,828,"6 de julio de 1997"
15,8,110,5568,256,291,547,"6 de julio de 1997"
15,8,110,5569,828,873,1701,"6 de julio de 1997"
15,8,110,5570,542,583,1125,"6 de julio de 1997"
15,8,110,5571,391,445,836,"6 de julio de 1997"
15,8,110,5572,640,739,1379,"6 de julio de 1997"
15,8,110,5573,668,748,1416,"6 de julio de 1997"
15,8,110,5574,446,500,946,"6 de julio de 1997"
15,8,110,5575,771,843,1614,"6 de julio de 1997"
15,8,110,5576,1601,1924,3525,"6 de julio de 1997"
15,8,110,5577,793,911,1704,"6 de julio de 1997"
15,8,110,5578,778,874,1652,"6 de julio de 1997"
15,8,110,5579,697,744,1441,"6 de julio de 1997"
15,8,110,5580,212,249,461,"6 de julio de 1997"
15,8,110,5581,451,514,965,"6 de julio de 1997"
15,8,110,5582,697,714,1411,"6 de julio de 1997"
15,8,110,5583,980,997,1977,"6 de julio de 1997"
15,8,110,5584,515,549,1064,"6 de julio de 1997"
15,8,110,5585,232,290,522,"6 de julio de 1997"
15,8,110,5586,334,379,713,"6 de julio de 1997"
15,8,110,5587,603,647,1250,"6 de julio de 1997"
15,8,110,5588,867,1092,1959,"6 de julio de 1997"
15,8,110,5589,577,625,1202,"6 de julio de 1997"
15,8,110,5590,1024,1238,2262,"6 de julio de 1997"
15,8,110,5591,241,269,510,"6 de julio de 1997"
15,8,110,5592,389,422,811,"6 de julio de 1997"
15,8,110,5593,379,437,816,"6 de julio de 1997"
15,8,110,5594,420,497,917,"6 de julio de 1997"
15,8,110,5595,708,875,1583,"6 de julio de 1997"
15,8,110,5596,275,338,613,"6 de julio de 1997"
15,8,110,5597,740,746,1486,"6 de julio de 1997"
15,8,110,5598,825,900,1725,"6 de julio de 1997"
15,8,110,5599,125,129,254,"6 de julio de 1997"
15,8,110,5600,546,584,1130,"6 de julio de 1997"
15,8,110,5601,523,593,1116,"6 de julio de 1997"
15,8,110,5602,382,445,827,"6 de julio de 1997"
15,8,110,5603,397,470,867,"6 de julio de 1997"
15,8,110,5604,507,551,1058,"6 de julio de 1997"
15,8,110,5605,578,692,1270,"6 de julio de 1997"
15,8,110,5606,374,470,844,"6 de julio de 1997"
15,8,110,5607,573,682,1255,"6 de julio de 1997"
15,8,110,5608,355,400,755,"6 de julio de 1997"
15,8,110,5609,591,591,1182,"6 de julio de 1997"
15,8,110,5610,790,774,1564,"6 de julio de 1997"
15,8,110,5611,373,344,717,"6 de julio de 1997"
15,8,110,5612,719,831,1550,"6 de julio de 1997"
15,8,110,5613,908,1022,1930,"6 de julio de 1997"
15,8,110,5614,206,237,443,"6 de julio de 1997"
15,8,110,5615,289,384,673,"6 de julio de 1997"
15,8,110,5616,512,556,1068,"6 de julio de 1997"
15,8,110,5617,595,659,1254,"6 de julio de 1997"
15,8,110,5618,532,544,1076,"6 de julio de 1997"
15,8,110,5619,568,655,1223,"6 de julio de 1997"
15,8,110,5620,285,346,631,"6 de julio de 1997"
15,8,110,5621,325,403,728,"6 de julio de 1997"
15,8,110,5622,316,447,763,"6 de julio de 1997"
15,8,110,5623,532,597,1129,"6 de julio de 1997"
15,8,110,5624,458,480,938,"6 de julio de 1997"
15,8,110,5625,442,464,906,"6 de julio de 1997"
15,8,110,5626,319,387,706,"6 de julio de 1997"
15,8,110,5627,347,412,759,"6 de julio de 1997"
15,8,110,5628,437,528,965,"6 de julio de 1997"
15,8,110,5629,306,337,643,"6 de julio de 1997"
15,8,110,5630,294,325,619,"6 de julio de 1997"
15,8,110,5631,490,546,1036,"6 de julio de 1997"
15,8,110,5632,302,393,695,"6 de julio de 1997"
15,8,110,5633,335,364,699,"6 de julio de 1997"
15,8,110,5634,165,224,389,"6 de julio de 1997"
15,8,110,5635,171,213,384,"6 de julio de 1997"
15,8,110,5636,476,551,1027,"6 de julio de 1997"
15,8,110,5637,224,283,507,"6 de julio de 1997"
15,8,110,5638,420,525,945,"6 de julio de 1997"
15,8,110,5639,377,446,823,"6 de julio de 1997"
15,8,110,5640,266,302,568,"6 de julio de 1997"
15,8,110,5641,269,318,587,"6 de julio de 1997"
15,8,110,5642,376,432,808,"6 de julio de 1997"
15,8,110,5643,335,419,754,"6 de julio de 1997"
15,8,110,5644,258,302,560,"6 de julio de 1997"
15,8,110,5645,222,249,471,"6 de julio de 1997"
15,8,110,5646,120,153,273,"6 de julio de 1997"
15,8,110,5647,151,206,357,"6 de julio de 1997"
15,8,110,5648,1798,2185,3983,"6 de julio de 1997"
15,8,110,5649,558,624,1182,"6 de julio de 1997"
15,8,110,5650,497,532,1029,"6 de julio de 1997"
15,8,110,5651,621,666,1287,"6 de julio de 1997"
15,8,110,5652,831,885,1716,"6 de julio de 1997"
15,8,110,5653,272,319,591,"6 de julio de 1997"
15,9,5,94,832,889,1721,"6 de julio de 1997"
15,9,5,95,267,254,521,"6 de julio de 1997"
15,9,5,96,320,316,636,"6 de julio de 1997"
15,9,5,97,705,610,1315,"6 de julio de 1997"
15,9,5,98,133,117,250,"6 de julio de 1997"
15,9,5,99,226,228,454,"6 de julio de 1997"
15,9,5,100,634,610,1244,"6 de julio de 1997"
15,9,5,101,548,555,1103,"6 de julio de 1997"
15,9,5,102,683,685,1368,"6 de julio de 1997"
15,9,5,103,184,177,361,"6 de julio de 1997"
15,9,5,104,104,93,197,"6 de julio de 1997"
15,9,5,105,260,253,513,"6 de julio de 1997"
15,9,5,106,428,404,832,"6 de julio de 1997"
15,9,5,107,539,575,1114,"6 de julio de 1997"
15,9,5,108,132,130,262,"6 de julio de 1997"
15,9,5,109,271,266,537,"6 de julio de 1997"
15,9,5,110,484,446,930,"6 de julio de 1997"
15,9,5,111,291,278,569,"6 de julio de 1997"
15,9,5,112,628,625,1253,"6 de julio de 1997"
15,9,5,113,590,561,1151,"6 de julio de 1997"
15,9,5,114,404,379,783,"6 de julio de 1997"
15,9,5,115,440,416,856,"6 de julio de 1997"
15,9,5,116,246,258,504,"6 de julio de 1997"
15,9,5,117,439,426,865,"6 de julio de 1997"
15,9,5,118,424,423,847,"6 de julio de 1997"
15,9,5,119,359,339,698,"6 de julio de 1997"
15,9,5,120,374,392,766,"6 de julio de 1997"
15,9,5,121,535,592,1127,"6 de julio de 1997"
15,9,5,122,416,442,858,"6 de julio de 1997"
15,9,5,123,724,714,1438,"6 de julio de 1997"
15,9,5,124,461,475,936,"6 de julio de 1997"
15,9,5,125,614,634,1248,"6 de julio de 1997"
15,9,5,126,502,477,979,"6 de julio de 1997"
15,9,5,127,284,302,586,"6 de julio de 1997"
15,9,5,128,668,645,1313,"6 de julio de 1997"
15,9,5,129,354,337,691,"6 de julio de 1997"
15,9,5,130,392,387,779,"6 de julio de 1997"
15,9,5,131,378,375,753,"6 de julio de 1997"
15,9,5,132,510,515,1025,"6 de julio de 1997"
15,9,5,133,544,569,1113,"6 de julio de 1997"
15,9,5,134,464,421,885,"6 de julio de 1997"
15,9,5,135,431,355,786,"6 de julio de 1997"
15,9,5,136,402,351,753,"6 de julio de 1997"
15,9,5,137,417,339,756,"6 de julio de 1997"
15,9,5,138,528,458,986,"6 de julio de 1997"
15,9,5,139,356,364,720,"6 de julio de 1997"
15,9,5,140,766,770,1536,"6 de julio de 1997"
15,9,5,141,616,683,1299,"6 de julio de 1997"
15,9,5,142,619,623,1242,"6 de julio de 1997"
15,9,5,143,495,511,1006,"6 de julio de 1997"
15,9,5,144,553,576,1129,"6 de julio de 1997"
15,9,5,145,455,391,846,"6 de julio de 1997"
15,9,5,146,312,256,568,"6 de julio de 1997"
15,9,5,147,316,273,589,"6 de julio de 1997"
15,9,5,148,201,176,377,"6 de julio de 1997"
15,9,5,149,231,223,454,"6 de julio de 1997"
15,9,5,150,173,164,337,"6 de julio de 1997"
15,9,39,2068,730,740,1470,"6 de julio de 1997"
15,9,39,2069,680,686,1366,"6 de julio de 1997"
15,9,39,2070,456,457,913,"6 de julio de 1997"
15,9,39,2071,103,95,198,"6 de julio de 1997"
15,9,39,2072,32,33,65,"6 de julio de 1997"
15,9,43,2188,463,522,985,"6 de julio de 1997"
15,9,43,2189,474,600,1074,"6 de julio de 1997"
15,9,43,2190,680,688,1368,"6 de julio de 1997"
15,9,43,2191,616,712,1328,"6 de julio de 1997"
15,9,43,2192,102,95,197,"6 de julio de 1997"
15,9,43,2193,162,169,331,"6 de julio de 1997"
15,9,43,2194,511,491,1002,"6 de julio de 1997"
15,9,43,2195,759,854,1613,"6 de julio de 1997"
15,9,43,2196,1200,1334,2534,"6 de julio de 1997"
15,9,43,2197,389,420,809,"6 de julio de 1997"
15,9,43,2198,549,615,1164,"6 de julio de 1997"
15,9,43,2199,731,742,1473,"6 de julio de 1997"
15,9,43,2200,628,685,1313,"6 de julio de 1997"
15,9,43,2201,511,500,1011,"6 de julio de 1997"
15,9,43,2202,212,223,435,"6 de julio de 1997"
15,9,43,2203,586,596,1182,"6 de julio de 1997"
15,9,43,2204,408,401,809,"6 de julio de 1997"
15,9,43,2205,375,406,781,"6 de julio de 1997"
15,9,43,2206,479,583,1062,"6 de julio de 1997"
15,9,43,2207,544,706,1250,"6 de julio de 1997"
15,9,43,2208,550,643,1193,"6 de julio de 1997"
15,9,43,2209,728,853,1581,"6 de julio de 1997"
15,9,43,2210,640,809,1449,"6 de julio de 1997"
15,9,43,2211,688,770,1458,"6 de julio de 1997"
15,9,43,2212,462,528,990,"6 de julio de 1997"
15,9,43,2213,523,586,1109,"6 de julio de 1997"
15,9,43,2214,589,666,1255,"6 de julio de 1997"
15,9,43,2215,949,1122,2071,"6 de julio de 1997"
15,9,43,2216,342,356,698,"6 de julio de 1997"
15,9,43,2217,352,375,727,"6 de julio de 1997"
15,9,43,2218,751,931,1682,"6 de julio de 1997"
15,9,43,2219,496,573,1069,"6 de julio de 1997"
15,9,43,2220,397,509,906,"6 de julio de 1997"
15,9,43,2221,680,797,1477,"6 de julio de 1997"
15,9,43,2222,184,214,398,"6 de julio de 1997"
15,9,43,2223,299,296,595,"6 de julio de 1997"
15,9,43,2224,379,450,829,"6 de julio de 1997"
15,9,43,2225,203,222,425,"6 de julio de 1997"
15,9,43,2226,170,150,320,"6 de julio de 1997"
15,9,43,2227,710,724,1434,"6 de julio de 1997"
15,9,43,2228,601,570,1171,"6 de julio de 1997"
15,9,43,2229,793,825,1618,"6 de julio de 1997"
15,9,43,2230,447,475,922,"6 de julio de 1997"
15,9,43,2231,88,79,167,"6 de julio de 1997"
15,9,43,2232,747,790,1537,"6 de julio de 1997"
15,9,43,2233,611,691,1302,"6 de julio de 1997"
15,9,43,2234,653,704,1357,"6 de julio de 1997"
15,9,43,2235,134,150,284,"6 de julio de 1997"
15,9,48,2314,657,713,1370,"6 de julio de 1997"
15,9,48,2315,313,343,656,"6 de julio de 1997"
15,9,48,2316,406,431,837,"6 de julio de 1997"
15,9,48,2317,223,273,496,"6 de julio de 1997"
15,9,48,2318,684,748,1432,"6 de julio de 1997"
15,9,48,2319,744,1004,1748,"6 de julio de 1997"
15,9,48,2320,300,325,625,"6 de julio de 1997"
15,9,48,2321,376,409,785,"6 de julio de 1997"
15,9,48,2322,393,390,783,"6 de julio de 1997"
15,9,48,2323,435,440,875,"6 de julio de 1997"
15,9,48,2324,196,175,371,"6 de julio de 1997"
15,9,48,2325,405,495,900,"6 de julio de 1997"
15,9,48,2326,289,319,608,"6 de julio de 1997"
15,9,48,2327,403,423,826,"6 de julio de 1997"
15,9,48,2328,569,725,1294,"6 de julio de 1997"
15,9,48,2329,706,749,1455,"6 de julio de 1997"
15,9,48,2330,551,621,1172,"6 de julio de 1997"
15,9,48,2331,404,476,880,"6 de julio de 1997"
15,9,48,2332,660,609,1269,"6 de julio de 1997"
15,9,48,2333,467,524,991,"6 de julio de 1997"
15,9,48,2334,449,445,894,"6 de julio de 1997"
15,9,48,2335,170,159,329,"6 de julio de 1997"
15,9,48,2336,301,298,599,"6 de julio de 1997"
15,9,48,2337,606,550,1156,"6 de julio de 1997"
15,9,48,2338,492,502,994,"6 de julio de 1997"
15,9,48,2339,408,413,821,"6 de julio de 1997"
15,9,48,2340,232,242,474,"6 de julio de 1997"
15,9,48,2341,396,400,796,"6 de julio de 1997"
15,9,48,2342,92,88,180,"6 de julio de 1997"
15,9,48,2343,317,374,691,"6 de julio de 1997"
15,9,88,4403,695,813,1508,"6 de julio de 1997"
15,9,88,4404,225,231,456,"6 de julio de 1997"
15,9,88,4405,411,429,840,"6 de julio de 1997"
15,9,88,4406,762,709,1471,"6 de julio de 1997"
15,9,88,4407,324,336,660,"6 de julio de 1997"
15,9,88,4408,810,859,1669,"6 de julio de 1997"
15,9,88,4409,416,418,834,"6 de julio de 1997"
15,9,88,4410,297,223,520,"6 de julio de 1997"
15,9,88,4411,331,356,687,"6 de julio de 1997"
15,9,88,4412,326,340,666,"6 de julio de 1997"
15,9,88,4413,536,634,1170,"6 de julio de 1997"
15,9,88,4414,443,476,919,"6 de julio de 1997"
15,9,88,4415,591,656,1247,"6 de julio de 1997"
15,9,88,4416,641,742,1383,"6 de julio de 1997"
15,9,88,4417,664,732,1396,"6 de julio de 1997"
15,9,88,4418,553,667,1220,"6 de julio de 1997"
15,9,88,4419,897,982,1879,"6 de julio de 1997"
15,9,88,4420,385,390,775,"6 de julio de 1997"
15,9,88,4421,544,502,1046,"6 de julio de 1997"
15,9,88,4422,684,732,1416,"6 de julio de 1997"
15,9,88,4423,1009,1057,2066,"6 de julio de 1997"
15,9,88,4424,575,587,1162,"6 de julio de 1997"
15,9,88,4425,349,359,708,"6 de julio de 1997"
15,9,88,4426,573,617,1190,"6 de julio de 1997"
15,9,88,4427,318,321,639,"6 de julio de 1997"
15,9,88,4428,306,291,597,"6 de julio de 1997"
15,10,34,1302,1049,1095,2144,"6 de julio de 1997"
15,10,34,1303,1416,1698,3114,"6 de julio de 1997"
15,10,34,1304,1004,1098,2102,"6 de julio de 1997"
15,10,34,1305,817,909,1726,"6 de julio de 1997"
15,10,34,1306,766,860,1626,"6 de julio de 1997"
15,10,34,1307,405,419,824,"6 de julio de 1997"
15,10,34,1308,728,792,1520,"6 de julio de 1997"
15,10,34,1309,523,577,1100,"6 de julio de 1997"
15,10,34,1310,518,614,1132,"6 de julio de 1997"
15,10,34,1311,561,601,1162,"6 de julio de 1997"
15,10,34,1312,377,431,808,"6 de julio de 1997"
15,10,34,1313,352,439,791,"6 de julio de 1997"
15,10,34,1314,412,501,913,"6 de julio de 1997"
15,10,34,1315,392,440,832,"6 de julio de 1997"
15,10,34,1316,624,643,1267,"6 de julio de 1997"
15,10,34,1317,773,876,1649,"6 de julio de 1997"
15,10,34,1318,771,806,1577,"6 de julio de 1997"
15,10,34,1319,619,676,1295,"6 de julio de 1997"
15,10,34,1320,673,622,1295,"6 de julio de 1997"
15,10,34,1321,1349,1492,2841,"6 de julio de 1997"
15,10,34,1322,917,999,1916,"6 de julio de 1997"
15,10,34,1323,806,878,1684,"6 de julio de 1997"
15,10,34,1324,884,980,1864,"6 de julio de 1997"
15,10,34,1325,565,571,1136,"6 de julio de 1997"
15,10,34,1326,540,527,1067,"6 de julio de 1997"
15,10,34,1327,625,670,1295,"6 de julio de 1997"
15,10,34,1328,767,772,1539,"6 de julio de 1997"
15,10,34,1329,779,851,1630,"6 de julio de 1997"
15,10,34,1330,768,839,1607,"6 de julio de 1997"
15,10,34,1331,875,981,1856,"6 de julio de 1997"
15,10,34,1332,523,573,1096,"6 de julio de 1997"
15,10,34,1333,461,522,983,"6 de julio de 1997"
15,10,34,1334,753,845,1598,"6 de julio de 1997"
15,10,34,1335,1018,1173,2191,"6 de julio de 1997"
15,10,34,1336,725,781,1506,"6 de julio de 1997"
15,10,34,1337,593,636,1229,"6 de julio de 1997"
15,10,34,1338,562,599,1161,"6 de julio de 1997"
15,10,34,1339,729,724,1453,"6 de julio de 1997"
15,10,34,1340,745,764,1509,"6 de julio de 1997"
15,10,34,1341,682,760,1442,"6 de julio de 1997"
15,10,34,1342,535,623,1158,"6 de julio de 1997"
15,10,34,1343,457,525,982,"6 de julio de 1997"
15,10,34,1344,543,614,1157,"6 de julio de 1997"
15,10,34,1345,759,833,1592,"6 de julio de 1997"
15,10,34,1346,588,665,1253,"6 de julio de 1997"
15,10,34,1347,646,779,1425,"6 de julio de 1997"
15,10,34,1348,763,871,1634,"6 de julio de 1997"
15,10,34,1349,487,531,1018,"6 de julio de 1997"
15,10,34,1350,678,794,1472,"6 de julio de 1997"
15,10,34,1351,807,878,1685,"6 de julio de 1997"
15,10,34,1352,543,568,1111,"6 de julio de 1997"
15,10,34,1735,530,568,1098,"6 de julio de 1997"
15,10,34,1736,473,530,1003,"6 de julio de 1997"
15,10,34,1737,473,588,1061,"6 de julio de 1997"
15,10,34,1738,538,579,1117,"6 de julio de 1997"
15,10,34,1739,516,589,1105,"6 de julio de 1997"
15,10,34,1740,455,480,935,"6 de julio de 1997"
15,10,34,1741,479,520,999,"6 de julio de 1997"
15,10,34,1742,429,455,884,"6 de julio de 1997"
15,10,34,1743,354,393,747,"6 de julio de 1997"
15,10,34,1744,402,423,825,"6 de julio de 1997"
15,10,34,1745,285,337,622,"6 de julio de 1997"
15,10,34,1746,570,642,1212,"6 de julio de 1997"
15,10,34,1747,520,591,1111,"6 de julio de 1997"
15,10,34,1748,591,651,1242,"6 de julio de 1997"
15,10,34,1749,554,580,1134,"6 de julio de 1997"
15,10,34,1750,588,640,1228,"6 de julio de 1997"
15,10,34,1751,515,528,1043,"6 de julio de 1997"
15,10,34,1752,525,545,1070,"6 de julio de 1997"
15,10,34,1753,504,520,1024,"6 de julio de 1997"
15,10,34,1754,584,641,1225,"6 de julio de 1997"
15,10,34,1755,388,433,821,"6 de julio de 1997"
15,10,34,1756,538,613,1151,"6 de julio de 1997"
15,10,34,1757,734,877,1611,"6 de julio de 1997"
15,10,34,1758,326,374,700,"6 de julio de 1997"
15,10,34,1759,844,965,1809,"6 de julio de 1997"
15,10,34,1760,718,780,1498,"6 de julio de 1997"
15,10,34,1761,748,841,1589,"6 de julio de 1997"
15,10,34,1762,801,861,1662,"6 de julio de 1997"
15,10,34,1763,759,792,1551,"6 de julio de 1997"
15,10,34,1764,728,784,1512,"6 de julio de 1997"
15,10,34,1765,326,330,656,"6 de julio de 1997"
15,10,34,1766,761,778,1539,"6 de julio de 1997"
15,10,34,1767,822,966,1788,"6 de julio de 1997"
15,10,34,1768,426,474,900,"6 de julio de 1997"
15,10,34,1769,567,621,1188,"6 de julio de 1997"
15,10,34,1770,816,953,1769,"6 de julio de 1997"
15,10,34,1771,403,477,880,"6 de julio de 1997"
15,10,34,1772,312,341,653,"6 de julio de 1997"
15,10,34,1773,754,801,1555,"6 de julio de 1997"
15,10,34,1774,516,575,1091,"6 de julio de 1997"
15,10,34,1775,486,528,1014,"6 de julio de 1997"
15,10,34,1776,654,703,1357,"6 de julio de 1997"
15,10,34,1777,429,538,967,"6 de julio de 1997"
15,10,34,1778,320,396,716,"6 de julio de 1997"
15,10,34,1779,583,617,1200,"6 de julio de 1997"
15,10,34,1780,500,576,1076,"6 de julio de 1997"
15,10,34,1781,2818,3404,6222,"6 de julio de 1997"
15,10,34,1782,70,86,156,"6 de julio de 1997"
15,10,34,1783,834,979,1813,"6 de julio de 1997"
15,10,34,1784,538,632,1170,"6 de julio de 1997"
15,10,34,1785,858,968,1826,"6 de julio de 1997"
15,10,34,1786,931,1081,2012,"6 de julio de 1997"
15,10,34,1787,739,847,1586,"6 de julio de 1997"
15,10,34,1788,895,1028,1923,"6 de julio de 1997"
15,10,34,1789,816,905,1721,"6 de julio de 1997"
15,10,34,1790,835,939,1774,"6 de julio de 1997"
15,10,34,1791,984,1094,2078,"6 de julio de 1997"
15,10,34,1792,858,972,1830,"6 de julio de 1997"
15,10,34,1793,339,399,738,"6 de julio de 1997"
15,10,34,1794,904,1010,1914,"6 de julio de 1997"
15,10,34,1795,492,585,1077,"6 de julio de 1997"
15,10,34,1796,745,850,1595,"6 de julio de 1997"
15,10,34,1797,564,649,1213,"6 de julio de 1997"
15,10,34,1798,595,670,1265,"6 de julio de 1997"
15,10,34,1799,388,472,860,"6 de julio de 1997"
15,10,34,1800,936,1106,2042,"6 de julio de 1997"
15,10,34,1801,366,480,846,"6 de julio de 1997"
15,10,34,1802,734,831,1565,"6 de julio de 1997"
15,10,34,1803,882,1044,1926,"6 de julio de 1997"
15,10,34,1804,916,1004,1920,"6 de julio de 1997"
15,10,34,1805,972,1106,2078,"6 de julio de 1997"
15,10,34,1806,667,747,1414,"6 de julio de 1997"
15,10,34,1807,133,177,310,"6 de julio de 1997"
15,10,34,1808,287,299,586,"6 de julio de 1997"
15,10,34,1809,169,214,383,"6 de julio de 1997"
15,10,34,1810,791,927,1718,"6 de julio de 1997"
15,10,34,1811,719,794,1513,"6 de julio de 1997"
15,10,34,1812,779,903,1682,"6 de julio de 1997"
15,10,34,1813,396,470,866,"6 de julio de 1997"
15,10,34,1814,443,537,980,"6 de julio de 1997"
15,10,34,1815,505,524,1029,"6 de julio de 1997"
15,10,34,1816,546,577,1123,"6 de julio de 1997"
15,10,34,1817,470,498,968,"6 de julio de 1997"
15,10,34,1818,609,654,1263,"6 de julio de 1997"
15,10,34,1819,545,597,1142,"6 de julio de 1997"
15,10,34,1820,532,528,1060,"6 de julio de 1997"
15,10,34,1821,641,679,1320,"6 de julio de 1997"
15,10,34,1822,474,478,952,"6 de julio de 1997"
15,10,34,1823,690,829,1519,"6 de julio de 1997"
15,10,34,1824,685,760,1445,"6 de julio de 1997"
15,10,34,1825,870,978,1848,"6 de julio de 1997"
15,10,34,1826,887,978,1865,"6 de julio de 1997"
15,10,34,1827,664,694,1358,"6 de julio de 1997"
15,10,34,1828,816,995,1811,"6 de julio de 1997"
15,10,34,1829,854,946,1800,"6 de julio de 1997"
15,10,34,1830,963,1031,1994,"6 de julio de 1997"
15,10,34,1831,638,697,1335,"6 de julio de 1997"
15,10,34,1832,902,1035,1937,"6 de julio de 1997"
15,10,34,1833,821,902,1723,"6 de julio de 1997"
15,10,34,1834,847,979,1826,"6 de julio de 1997"
15,10,34,1835,554,571,1125,"6 de julio de 1997"
15,10,34,1836,524,566,1090,"6 de julio de 1997"
15,10,34,1837,541,620,1161,"6 de julio de 1997"
15,10,34,1838,633,761,1394,"6 de julio de 1997"
15,10,34,1839,318,381,699,"6 de julio de 1997"
15,10,34,1840,570,687,1257,"6 de julio de 1997"
15,10,34,1841,461,563,1024,"6 de julio de 1997"
15,10,34,1842,799,903,1702,"6 de julio de 1997"
15,10,34,1843,531,615,1146,"6 de julio de 1997"
15,10,34,1844,597,686,1283,"6 de julio de 1997"
15,10,34,1855,608,648,1256,"6 de julio de 1997"
15,10,34,1857,347,403,750,"6 de julio de 1997"
15,11,34,1353,440,438,878,"6 de julio de 1997"
15,11,34,1354,801,888,1689,"6 de julio de 1997"
15,11,34,1355,782,851,1633,"6 de julio de 1997"
15,11,34,1356,811,842,1653,"6 de julio de 1997"
15,11,34,1357,1021,1058,2079,"6 de julio de 1997"
15,11,34,1358,614,646,1260,"6 de julio de 1997"
15,11,34,1359,347,330,677,"6 de julio de 1997"
15,11,34,1360,605,579,1184,"6 de julio de 1997"
15,11,34,1361,881,867,1748,"6 de julio de 1997"
15,11,34,1501,727,703,1430,"6 de julio de 1997"
15,11,34,1502,748,775,1523,"6 de julio de 1997"
15,11,34,1503,815,865,1680,"6 de julio de 1997"
15,11,34,1504,528,570,1098,"6 de julio de 1997"
15,11,34,1505,484,547,1031,"6 de julio de 1997"
15,11,34,1506,581,617,1198,"6 de julio de 1997"
15,11,34,1507,837,873,1710,"6 de julio de 1997"
15,11,34,1508,631,668,1299,"6 de julio de 1997"
15,11,34,1509,490,502,992,"6 de julio de 1997"
15,11,34,1510,557,697,1254,"6 de julio de 1997"
15,11,34,1511,541,575,1116,"6 de julio de 1997"
15,11,34,1512,691,755,1446,"6 de julio de 1997"
15,11,34,1513,708,743,1451,"6 de julio de 1997"
15,11,34,1514,500,526,1026,"6 de julio de 1997"
15,11,34,1515,1134,1157,2291,"6 de julio de 1997"
15,11,34,1516,486,531,1017,"6 de julio de 1997"
15,11,34,1517,939,1022,1961,"6 de julio de 1997"
15,11,34,1518,779,914,1693,"6 de julio de 1997"
15,11,34,1519,493,511,1004,"6 de julio de 1997"
15,11,34,1520,591,637,1228,"6 de julio de 1997"
15,11,34,1521,381,427,808,"6 de julio de 1997"
15,11,34,1522,1051,1138,2189,"6 de julio de 1997"
15,11,34,1523,825,905,1730,"6 de julio de 1997"
15,11,34,1524,318,292,610,"6 de julio de 1997"
15,11,34,1526,838,887,1725,"6 de julio de 1997"
15,11,34,1528,882,940,1822,"6 de julio de 1997"
15,11,34,1529,465,522,987,"6 de julio de 1997"
15,11,34,1530,428,490,918,"6 de julio de 1997"
15,11,34,1531,622,709,1331,"6 de julio de 1997"
15,11,34,1532,610,723,1333,"6 de julio de 1997"
15,11,34,1533,541,647,1188,"6 de julio de 1997"
15,11,34,1535,493,512,1005,"6 de julio de 1997"
15,11,34,1536,715,740,1455,"6 de julio de 1997"
15,11,34,1538,590,644,1234,"6 de julio de 1997"
15,11,34,1539,447,515,962,"6 de julio de 1997"
15,11,34,1540,528,542,1070,"6 de julio de 1997"
15,11,34,1845,438,497,935,"6 de julio de 1997"
15,11,34,1846,491,593,1084,"6 de julio de 1997"
15,11,34,1847,684,798,1482,"6 de julio de 1997"
15,11,34,1848,865,918,1783,"6 de julio de 1997"
15,11,34,1849,846,947,1793,"6 de julio de 1997"
15,11,34,1850,870,1002,1872,"6 de julio de 1997"
15,11,34,1851,608,698,1306,"6 de julio de 1997"
15,11,34,1852,551,670,1221,"6 de julio de 1997"
15,11,34,1853,468,559,1027,"6 de julio de 1997"
15,11,34,1854,613,709,1322,"6 de julio de 1997"
15,11,34,1856,499,585,1084,"6 de julio de 1997"
15,11,34,1858,681,790,1471,"6 de julio de 1997"
15,11,34,1859,683,840,1523,"6 de julio de 1997"
15,11,34,1860,554,637,1191,"6 de julio de 1997"
15,11,34,1861,809,860,1669,"6 de julio de 1997"
15,11,34,1862,815,841,1656,"6 de julio de 1997"
15,11,34,1863,293,358,651,"6 de julio de 1997"
15,11,34,1864,1046,1166,2212,"6 de julio de 1997"
15,11,34,1865,749,833,1582,"6 de julio de 1997"
15,11,34,1866,647,731,1378,"6 de julio de 1997"
15,11,34,1867,573,639,1212,"6 de julio de 1997"
15,11,34,1868,362,418,780,"6 de julio de 1997"
15,11,34,1869,662,764,1426,"6 de julio de 1997"
15,11,34,1870,882,1050,1932,"6 de julio de 1997"
15,11,34,1871,851,1013,1864,"6 de julio de 1997"
15,11,34,1872,713,798,1511,"6 de julio de 1997"
15,11,34,1873,732,789,1521,"6 de julio de 1997"
15,11,34,1874,607,718,1325,"6 de julio de 1997"
15,11,34,1875,626,684,1310,"6 de julio de 1997"
15,11,34,1876,812,941,1753,"6 de julio de 1997"
15,11,34,1877,794,886,1680,"6 de julio de 1997"
15,11,34,1878,643,745,1388,"6 de julio de 1997"
15,11,34,1879,657,713,1370,"6 de julio de 1997"
15,11,34,1880,897,963,1860,"6 de julio de 1997"
15,11,34,1881,658,669,1327,"6 de julio de 1997"
15,11,34,1882,678,833,1511,"6 de julio de 1997"
15,11,34,1883,753,830,1583,"6 de julio de 1997"
15,11,34,1884,523,553,1076,"6 de julio de 1997"
15,11,34,1885,485,550,1035,"6 de julio de 1997"
15,11,34,1886,557,661,1218,"6 de julio de 1997"
15,11,34,1887,615,726,1341,"6 de julio de 1997"
15,11,34,1888,458,569,1027,"6 de julio de 1997"
15,11,34,1889,614,691,1305,"6 de julio de 1997"
15,11,34,1890,487,557,1044,"6 de julio de 1997"
15,11,34,1891,423,473,896,"6 de julio de 1997"
15,11,34,1892,577,603,1180,"6 de julio de 1997"
15,11,34,1893,765,843,1608,"6 de julio de 1997"
15,11,34,1894,957,1047,2004,"6 de julio de 1997"
15,11,34,1895,870,959,1829,"6 de julio de 1997"
15,11,34,1896,506,543,1049,"6 de julio de 1997"
15,11,34,1897,560,591,1151,"6 de julio de 1997"
15,11,34,1898,512,634,1146,"6 de julio de 1997"
15,11,34,1899,518,547,1065,"6 de julio de 1997"
15,11,34,1900,591,666,1257,"6 de julio de 1997"
15,11,34,1901,496,519,1015,"6 de julio de 1997"
15,11,34,1902,490,574,1064,"6 de julio de 1997"
15,11,34,1903,591,660,1251,"6 de julio de 1997"
15,11,34,1904,874,1016,1890,"6 de julio de 1997"
15,11,34,1905,848,955,1803,"6 de julio de 1997"
15,11,34,1906,552,612,1164,"6 de julio de 1997"
15,11,34,1907,510,568,1078,"6 de julio de 1997"
15,11,34,1908,695,773,1468,"6 de julio de 1997"
15,11,34,1909,585,636,1221,"6 de julio de 1997"
15,11,34,1910,568,615,1183,"6 de julio de 1997"
15,11,34,1911,591,640,1231,"6 de julio de 1997"
15,11,34,1912,599,643,1242,"6 de julio de 1997"
15,11,34,1913,617,671,1288,"6 de julio de 1997"
15,11,34,1914,407,482,889,"6 de julio de 1997"
15,11,34,1915,379,423,802,"6 de julio de 1997"
15,11,34,1916,517,574,1091,"6 de julio de 1997"
15,11,34,1917,821,990,1811,"6 de julio de 1997"
15,11,34,1918,542,650,1192,"6 de julio de 1997"
15,11,34,1919,438,510,948,"6 de julio de 1997"
15,11,34,1920,756,891,1647,"6 de julio de 1997"
15,11,34,1921,584,655,1239,"6 de julio de 1997"
15,11,34,1922,832,981,1813,"6 de julio de 1997"
15,11,34,1923,523,572,1095,"6 de julio de 1997"
15,11,34,1924,814,903,1717,"6 de julio de 1997"
15,11,34,1925,669,795,1464,"6 de julio de 1997"
15,11,34,1926,520,597,1117,"6 de julio de 1997"
15,11,34,1927,578,638,1216,"6 de julio de 1997"
15,11,34,1928,719,823,1542,"6 de julio de 1997"
15,11,34,1929,608,662,1270,"6 de julio de 1997"
15,11,34,1930,685,765,1450,"6 de julio de 1997"
15,11,34,1931,784,887,1671,"6 de julio de 1997"
15,11,34,1932,663,678,1341,"6 de julio de 1997"
15,11,34,1933,458,527,985,"6 de julio de 1997"
15,11,34,1934,743,827,1570,"6 de julio de 1997"
15,11,34,1935,771,901,1672,"6 de julio de 1997"
15,11,34,1936,490,584,1074,"6 de julio de 1997"
15,11,34,1937,352,394,746,"6 de julio de 1997"
15,11,34,1938,692,742,1434,"6 de julio de 1997"
15,11,34,1939,669,769,1438,"6 de julio de 1997"
15,11,34,1940,885,963,1848,"6 de julio de 1997"
15,11,34,1941,761,821,1582,"6 de julio de 1997"
15,11,34,1942,741,871,1612,"6 de julio de 1997"
15,11,34,1943,482,558,1040,"6 de julio de 1997"
15,11,34,1944,613,733,1346,"6 de julio de 1997"
15,11,34,1945,679,748,1427,"6 de julio de 1997"
15,11,34,1946,731,817,1548,"6 de julio de 1997"
15,11,34,1947,668,776,1444,"6 de julio de 1997"
15,11,34,1948,759,851,1610,"6 de julio de 1997"
15,11,34,1949,624,760,1384,"6 de julio de 1997"
15,11,34,1950,335,393,728,"6 de julio de 1997"
15,11,34,1951,536,599,1135,"6 de julio de 1997"
15,12,11,233,918,1015,1933,"6 de julio de 1997"
15,12,11,234,778,823,1601,"6 de julio de 1997"
15,12,11,235,635,668,1303,"6 de julio de 1997"
15,12,11,236,685,712,1397,"6 de julio de 1997"
15,12,11,237,899,927,1826,"6 de julio de 1997"
15,12,11,238,197,203,400,"6 de julio de 1997"
15,12,11,239,158,153,311,"6 de julio de 1997"
15,12,11,240,741,780,1521,"6 de julio de 1997"
15,12,11,241,435,434,869,"6 de julio de 1997"
15,12,11,242,727,828,1555,"6 de julio de 1997"
15,12,11,243,728,739,1467,"6 de julio de 1997"
15,12,11,244,314,303,617,"6 de julio de 1997"
15,12,11,245,427,440,867,"6 de julio de 1997"
15,12,11,246,121,113,234,"6 de julio de 1997"
15,12,29,1097,791,835,1626,"6 de julio de 1997"
15,12,29,1098,716,850,1566,"6 de julio de 1997"
15,12,29,1099,401,472,873,"6 de julio de 1997"
15,12,29,1100,193,179,372,"6 de julio de 1997"
15,12,29,1101,356,379,735,"6 de julio de 1997"
15,12,29,1102,228,249,477,"6 de julio de 1997"
15,12,29,1103,246,249,495,"6 de julio de 1997"
15,12,29,1104,117,123,240,"6 de julio de 1997"
15,12,29,1105,178,212,390,"6 de julio de 1997"
15,12,29,1106,237,254,491,"6 de julio de 1997"
15,12,29,1107,732,764,1496,"6 de julio de 1997"
15,12,29,1108,679,711,1390,"6 de julio de 1997"
15,12,31,1142,645,701,1346,"6 de julio de 1997"
15,12,31,1143,768,829,1597,"6 de julio de 1997"
15,12,31,1144,659,683,1342,"6 de julio de 1997"
15,12,31,1145,781,828,1609,"6 de julio de 1997"
15,12,31,1146,547,573,1120,"6 de julio de 1997"
15,12,31,1147,843,936,1779,"6 de julio de 1997"
15,12,31,1148,667,716,1383,"6 de julio de 1997"
15,12,40,2073,1225,1448,2673,"6 de julio de 1997"
15,12,40,2074,466,537,1003,"6 de julio de 1997"
15,12,40,2075,444,535,979,"6 de julio de 1997"
15,12,40,2076,189,230,419,"6 de julio de 1997"
15,12,40,2077,670,814,1484,"6 de julio de 1997"
15,12,40,2078,629,696,1325,"6 de julio de 1997"
15,12,40,2079,341,385,726,"6 de julio de 1997"
15,12,40,2080,412,455,867,"6 de julio de 1997"
15,12,40,2081,1652,2212,3864,"6 de julio de 1997"
15,12,40,2082,870,946,1816,"6 de julio de 1997"
15,12,40,2087,288,360,648,"6 de julio de 1997"
15,12,40,2088,277,344,621,"6 de julio de 1997"
15,12,40,2089,695,779,1474,"6 de julio de 1997"
15,12,40,2090,364,396,760,"6 de julio de 1997"
15,12,40,2091,378,442,820,"6 de julio de 1997"
15,12,40,2092,344,363,707,"6 de julio de 1997"
15,12,40,2093,475,512,987,"6 de julio de 1997"
15,12,40,2094,871,857,1728,"6 de julio de 1997"
15,12,40,2095,840,940,1780,"6 de julio de 1997"
15,12,40,2096,541,618,1159,"6 de julio de 1997"
15,12,40,2097,1187,1395,2582,"6 de julio de 1997"
15,12,40,2098,452,486,938,"6 de julio de 1997"
15,12,40,2099,392,463,855,"6 de julio de 1997"
15,12,40,2100,706,762,1468,"6 de julio de 1997"
15,12,40,2101,494,530,1024,"6 de julio de 1997"
15,12,40,2102,358,359,717,"6 de julio de 1997"
15,12,40,2103,641,704,1345,"6 de julio de 1997"
15,12,40,2104,393,453,846,"6 de julio de 1997"
15,12,40,2105,285,311,596,"6 de julio de 1997"
15,12,40,2106,616,731,1347,"6 de julio de 1997"
15,12,40,2107,753,812,1565,"6 de julio de 1997"
15,12,40,2108,624,691,1315,"6 de julio de 1997"
15,12,40,2109,490,544,1034,"6 de julio de 1997"
15,12,40,2110,602,661,1263,"6 de julio de 1997"
15,12,40,2111,617,613,1230,"6 de julio de 1997"
15,12,40,2112,318,391,709,"6 de julio de 1997"
15,12,40,2113,230,282,512,"6 de julio de 1997"
15,12,40,2122,403,460,863,"6 de julio de 1997"
15,12,40,2123,813,885,1698,"6 de julio de 1997"
15,12,40,2124,485,560,1045,"6 de julio de 1997"
15,12,40,2125,659,703,1362,"6 de julio de 1997"
15,12,40,2126,380,444,824,"6 de julio de 1997"
15,12,40,2127,542,625,1167,"6 de julio de 1997"
15,12,40,2128,736,833,1569,"6 de julio de 1997"
15,12,40,2129,843,882,1725,"6 de julio de 1997"
15,12,40,2130,461,526,987,"6 de julio de 1997"
15,12,40,2131,527,591,1118,"6 de julio de 1997"
15,12,40,2132,595,630,1225,"6 de julio de 1997"
15,12,40,2133,748,823,1571,"6 de julio de 1997"
15,12,40,2134,523,617,1140,"6 de julio de 1997"
15,12,40,2135,577,673,1250,"6 de julio de 1997"
15,12,40,2136,617,639,1256,"6 de julio de 1997"
15,12,40,2137,487,533,1020,"6 de julio de 1997"
15,12,40,2138,370,384,754,"6 de julio de 1997"
15,12,40,2139,568,616,1184,"6 de julio de 1997"
15,12,40,2140,509,523,1032,"6 de julio de 1997"
15,12,40,2141,415,457,872,"6 de julio de 1997"
15,12,40,2142,296,324,620,"6 de julio de 1997"
15,12,40,2143,676,717,1393,"6 de julio de 1997"
15,12,40,2144,526,564,1090,"6 de julio de 1997"
15,12,40,2145,345,351,696,"6 de julio de 1997"
15,12,40,2146,329,370,699,"6 de julio de 1997"
15,12,40,2147,409,411,820,"6 de julio de 1997"
15,12,40,2148,326,379,705,"6 de julio de 1997"
15,12,40,2149,617,662,1279,"6 de julio de 1997"
15,12,40,2150,648,803,1451,"6 de julio de 1997"
15,12,40,2151,668,703,1371,"6 de julio de 1997"
15,12,40,2152,520,553,1073,"6 de julio de 1997"
15,12,40,2153,502,512,1014,"6 de julio de 1997"
15,12,40,2154,484,543,1027,"6 de julio de 1997"
15,12,40,2155,604,694,1298,"6 de julio de 1997"
15,12,40,2156,461,519,980,"6 de julio de 1997"
15,12,40,2157,461,469,930,"6 de julio de 1997"
15,12,40,2158,551,555,1106,"6 de julio de 1997"
15,12,40,2159,388,480,868,"6 de julio de 1997"
15,12,40,2160,206,205,411,"6 de julio de 1997"
15,12,40,2161,352,401,753,"6 de julio de 1997"
15,12,40,2162,652,665,1317,"6 de julio de 1997"
15,12,40,2163,1717,2139,3856,"6 de julio de 1997"
15,12,70,3940,527,593,1120,"6 de julio de 1997"
15,12,70,3941,500,571,1071,"6 de julio de 1997"
15,12,100,4611,705,760,1465,"6 de julio de 1997"
15,12,100,4612,544,585,1129,"6 de julio de 1997"
15,12,100,4613,382,457,839,"6 de julio de 1997"
15,12,100,4614,468,532,1000,"6 de julio de 1997"
15,12,100,4615,564,635,1199,"6 de julio de 1997"
15,12,100,4616,468,503,971,"6 de julio de 1997"
15,12,100,4617,879,995,1874,"6 de julio de 1997"
15,12,100,4618,748,799,1547,"6 de julio de 1997"
15,12,100,4619,492,557,1049,"6 de julio de 1997"
15,12,100,4620,600,769,1369,"6 de julio de 1997"
15,12,100,4621,539,547,1086,"6 de julio de 1997"
15,12,100,4622,386,403,789,"6 de julio de 1997"
15,12,100,4623,585,678,1263,"6 de julio de 1997"
15,12,100,4624,434,491,925,"6 de julio de 1997"
15,12,100,4625,716,915,1631,"6 de julio de 1997"
15,12,100,4626,570,658,1228,"6 de julio de 1997"
15,12,100,4627,640,705,1345,"6 de julio de 1997"
15,12,100,4628,757,810,1567,"6 de julio de 1997"
15,12,100,4629,605,669,1274,"6 de julio de 1997"
15,12,100,4630,640,741,1381,"6 de julio de 1997"
15,12,100,4631,695,857,1552,"6 de julio de 1997"
15,12,100,4632,594,752,1346,"6 de julio de 1997"
15,12,100,4633,494,593,1087,"6 de julio de 1997"
15,12,100,4634,424,513,937,"6 de julio de 1997"
15,12,100,4635,691,767,1458,"6 de julio de 1997"
15,12,100,4636,785,771,1556,"6 de julio de 1997"
15,12,100,4637,555,624,1179,"6 de julio de 1997"
15,12,100,4638,350,427,777,"6 de julio de 1997"
15,12,100,4639,315,347,662,"6 de julio de 1997"
15,12,100,4640,787,843,1630,"6 de julio de 1997"
15,12,100,4641,325,336,661,"6 de julio de 1997"
15,12,100,4642,973,169,1142,"6 de julio de 1997"
15,12,100,4643,458,454,912,"6 de julio de 1997"
15,12,100,4644,491,563,1054,"6 de julio de 1997"
15,12,100,4645,411,430,841,"6 de julio de 1997"
15,12,100,4646,712,732,1444,"6 de julio de 1997"
15,12,100,4647,789,485,1274,"6 de julio de 1997"
15,12,100,4648,500,481,981,"6 de julio de 1997"
15,12,100,4649,1038,1162,2200,"6 de julio de 1997"
15,12,100,4650,799,819,1618,"6 de julio de 1997"
15,12,100,4651,721,752,1473,"6 de julio de 1997"
15,12,100,4652,775,820,1595,"6 de julio de 1997"
15,12,100,4653,822,890,1712,"6 de julio de 1997"
15,12,100,4654,804,905,1709,"6 de julio de 1997"
15,12,100,4655,858,875,1733,"6 de julio de 1997"
15,12,100,4656,382,395,777,"6 de julio de 1997"
15,12,100,4657,361,377,738,"6 de julio de 1997"
15,12,100,4658,676,716,1392,"6 de julio de 1997"
15,12,100,4659,708,636,1344,"6 de julio de 1997"
15,12,100,4660,426,470,896,"6 de julio de 1997"
15,12,100,4661,421,488,909,"6 de julio de 1997"
15,12,100,4662,772,829,1601,"6 de julio de 1997"
15,12,100,4663,655,674,1329,"6 de julio de 1997"
15,12,100,4664,497,492,989,"6 de julio de 1997"
15,12,100,4665,461,450,911,"6 de julio de 1997"
15,12,100,4666,468,478,946,"6 de julio de 1997"
15,12,100,4667,478,505,983,"6 de julio de 1997"
15,12,100,4668,503,559,1062,"6 de julio de 1997"
15,12,100,4669,486,494,980,"6 de julio de 1997"
15,12,100,4670,524,527,1051,"6 de julio de 1997"
15,12,100,4671,628,686,1314,"6 de julio de 1997"
15,12,100,4672,407,429,836,"6 de julio de 1997"
15,12,100,4673,631,588,1219,"6 de julio de 1997"
15,12,100,4674,725,795,1520,"6 de julio de 1997"
15,12,100,4675,912,961,1873,"6 de julio de 1997"
15,12,100,4676,560,580,1140,"6 de julio de 1997"
15,12,100,4677,706,768,1474,"6 de julio de 1997"
15,12,100,4678,243,284,527,"6 de julio de 1997"
15,12,100,4679,938,1011,1949,"6 de julio de 1997"
15,12,100,4680,643,662,1305,"6 de julio de 1997"
15,12,100,4681,546,537,1083,"6 de julio de 1997"
15,12,100,4682,479,405,884,"6 de julio de 1997"
15,12,100,4683,270,331,601,"6 de julio de 1997"
15,12,100,4684,1626,2004,3630,"6 de julio de 1997"
15,12,100,4685,397,437,834,"6 de julio de 1997"
15,12,100,4686,438,468,906,"6 de julio de 1997"
15,12,100,4687,495,541,1036,"6 de julio de 1997"
15,12,100,4688,509,494,1003,"6 de julio de 1997"
15,12,100,4689,441,463,904,"6 de julio de 1997"
15,12,100,4690,385,398,783,"6 de julio de 1997"
15,13,34,1362,1067,1095,2162,"6 de julio de 1997"
15,13,34,1363,1158,1236,2394,"6 de julio de 1997"
15,13,34,1364,640,715,1355,"6 de julio de 1997"
15,13,34,1365,854,1003,1857,"6 de julio de 1997"
15,13,34,1366,804,876,1680,"6 de julio de 1997"
15,13,34,1367,704,791,1495,"6 de julio de 1997"
15,13,34,1368,682,735,1417,"6 de julio de 1997"
15,13,34,1369,520,551,1071,"6 de julio de 1997"
15,13,34,1370,1024,1100,2124,"6 de julio de 1997"
15,13,34,1371,709,786,1495,"6 de julio de 1997"
15,13,34,1372,648,682,1330,"6 de julio de 1997"
15,13,34,1373,654,736,1390,"6 de julio de 1997"
15,13,34,1374,924,956,1880,"6 de julio de 1997"
15,13,34,1375,894,980,1874,"6 de julio de 1997"
15,13,34,1376,682,700,1382,"6 de julio de 1997"
15,13,34,1377,558,615,1173,"6 de julio de 1997"
15,13,34,1378,964,1070,2034,"6 de julio de 1997"
15,13,34,1379,832,886,1718,"6 de julio de 1997"
15,13,34,1380,762,801,1563,"6 de julio de 1997"
15,13,34,1381,732,826,1558,"6 de julio de 1997"
15,13,34,1382,837,933,1770,"6 de julio de 1997"
15,13,34,1383,979,983,1962,"6 de julio de 1997"
15,13,34,1384,712,743,1455,"6 de julio de 1997"
15,13,34,1385,709,753,1462,"6 de julio de 1997"
15,13,34,1386,872,874,1746,"6 de julio de 1997"
15,13,34,1387,764,740,1504,"6 de julio de 1997"
15,13,34,1388,727,742,1469,"6 de julio de 1997"
15,13,34,1389,878,971,1849,"6 de julio de 1997"
15,13,34,1390,910,1016,1926,"6 de julio de 1997"
15,13,34,1391,760,802,1562,"6 de julio de 1997"
15,13,34,1392,714,810,1524,"6 de julio de 1997"
15,13,34,1393,696,828,1524,"6 de julio de 1997"
15,13,34,1394,612,705,1317,"6 de julio de 1997"
15,13,34,1395,518,539,1057,"6 de julio de 1997"
15,13,34,1396,894,965,1859,"6 de julio de 1997"
15,13,34,1397,751,900,1651,"6 de julio de 1997"
15,13,34,1398,949,1006,1955,"6 de julio de 1997"
15,13,34,1399,653,643,1296,"6 de julio de 1997"
15,13,34,1400,520,599,1119,"6 de julio de 1997"
15,13,34,1401,809,880,1689,"6 de julio de 1997"
15,13,34,1402,798,868,1666,"6 de julio de 1997"
15,13,34,1403,432,495,927,"6 de julio de 1997"
15,13,34,1404,389,460,849,"6 de julio de 1997"
15,13,34,1405,737,844,1581,"6 de julio de 1997"
15,13,34,1406,572,603,1175,"6 de julio de 1997"
15,13,34,1407,917,940,1857,"6 de julio de 1997"
15,13,34,1408,885,969,1854,"6 de julio de 1997"
15,13,34,1409,568,641,1209,"6 de julio de 1997"
15,13,34,1410,700,765,1465,"6 de julio de 1997"
15,13,34,1411,983,984,1967,"6 de julio de 1997"
15,13,34,1412,853,877,1730,"6 de julio de 1997"
15,13,34,1413,837,886,1723,"6 de julio de 1997"
15,13,34,1414,420,474,894,"6 de julio de 1997"
15,13,34,1415,391,396,787,"6 de julio de 1997"
15,13,34,1416,764,786,1550,"6 de julio de 1997"
15,13,34,1417,733,763,1496,"6 de julio de 1997"
15,13,34,1418,661,763,1424,"6 de julio de 1997"
15,13,34,1419,714,763,1477,"6 de julio de 1997"
15,13,34,1420,451,482,933,"6 de julio de 1997"
15,13,34,1421,679,800,1479,"6 de julio de 1997"
15,13,34,1422,894,868,1762,"6 de julio de 1997"
15,13,34,1423,658,717,1375,"6 de julio de 1997"
15,13,34,1424,664,687,1351,"6 de julio de 1997"
15,13,34,1425,596,586,1182,"6 de julio de 1997"
15,13,34,1426,604,710,1314,"6 de julio de 1997"
15,13,34,1430,350,405,755,"6 de julio de 1997"
15,13,34,1431,679,768,1447,"6 de julio de 1997"
15,13,34,1432,740,795,1535,"6 de julio de 1997"
15,13,34,1433,765,831,1596,"6 de julio de 1997"
15,13,34,1434,619,642,1261,"6 de julio de 1997"
15,13,34,1435,627,600,1227,"6 de julio de 1997"
15,13,34,1436,503,553,1056,"6 de julio de 1997"
15,13,34,1437,522,559,1081,"6 de julio de 1997"
15,13,34,1438,555,530,1085,"6 de julio de 1997"
15,13,34,1439,751,853,1604,"6 de julio de 1997"
15,13,34,1440,711,753,1464,"6 de julio de 1997"
15,13,34,1441,710,750,1460,"6 de julio de 1997"
15,13,34,1442,575,567,1142,"6 de julio de 1997"
15,13,34,1443,685,779,1464,"6 de julio de 1997"
15,13,34,1444,670,759,1429,"6 de julio de 1997"
15,13,34,1445,859,885,1744,"6 de julio de 1997"
15,13,34,1446,615,632,1247,"6 de julio de 1997"
15,13,34,1447,821,905,1726,"6 de julio de 1997"
15,13,34,1448,816,973,1789,"6 de julio de 1997"
15,13,34,1449,726,755,1481,"6 de julio de 1997"
15,13,34,1450,885,937,1822,"6 de julio de 1997"
15,13,34,1451,467,471,938,"6 de julio de 1997"
15,13,34,1452,516,550,1066,"6 de julio de 1997"
15,13,34,1453,548,534,1082,"6 de julio de 1997"
15,13,34,1454,812,902,1714,"6 de julio de 1997"
15,13,34,1455,722,791,1513,"6 de julio de 1997"
15,13,34,1456,704,717,1421,"6 de julio de 1997"
15,13,34,1457,464,463,927,"6 de julio de 1997"
15,13,34,1458,517,622,1139,"6 de julio de 1997"
15,13,34,1459,292,369,661,"6 de julio de 1997"
15,13,34,1460,297,327,624,"6 de julio de 1997"
15,13,34,1463,584,636,1220,"6 de julio de 1997"
15,13,34,1464,466,505,971,"6 de julio de 1997"
15,13,34,1465,720,758,1478,"6 de julio de 1997"
15,13,34,1466,717,797,1514,"6 de julio de 1997"
15,13,34,1467,641,655,1296,"6 de julio de 1997"
15,13,34,1468,828,930,1758,"6 de julio de 1997"
15,13,34,1469,595,604,1199,"6 de julio de 1997"
15,13,34,1470,858,967,1825,"6 de julio de 1997"
15,13,34,1471,648,660,1308,"6 de julio de 1997"
15,13,34,1472,706,740,1446,"6 de julio de 1997"
15,13,34,1473,718,785,1503,"6 de julio de 1997"
15,13,34,1474,781,848,1629,"6 de julio de 1997"
15,13,34,1475,844,942,1786,"6 de julio de 1997"
15,13,34,1476,650,712,1362,"6 de julio de 1997"
15,13,34,1477,750,739,1489,"6 de julio de 1997"
15,13,34,1478,758,820,1578,"6 de julio de 1997"
15,13,34,1479,678,769,1447,"6 de julio de 1997"
15,13,34,1486,622,702,1324,"6 de julio de 1997"
15,13,34,1487,581,639,1220,"6 de julio de 1997"
15,13,34,1488,591,651,1242,"6 de julio de 1997"
15,13,34,1489,447,497,944,"6 de julio de 1997"
15,13,34,1490,524,571,1095,"6 de julio de 1997"
15,13,34,1491,650,712,1362,"6 de julio de 1997"
15,13,34,1492,797,829,1626,"6 de julio de 1997"
15,13,34,1493,408,463,871,"6 de julio de 1997"
15,13,34,1494,511,645,1156,"6 de julio de 1997"
15,13,34,1495,544,621,1165,"6 de julio de 1997"
15,13,34,1496,682,765,1447,"6 de julio de 1997"
15,13,34,1497,500,597,1097,"6 de julio de 1997"
15,13,34,1498,783,817,1600,"6 de julio de 1997"
15,13,34,1525,499,565,1064,"6 de julio de 1997"
15,13,34,1527,623,663,1286,"6 de julio de 1997"
15,13,34,1534,629,691,1320,"6 de julio de 1997"
15,13,34,1610,438,485,923,"6 de julio de 1997"
15,13,34,1611,355,408,763,"6 de julio de 1997"
15,13,34,1612,689,702,1391,"6 de julio de 1997"
15,13,34,1647,832,893,1725,"6 de julio de 1997"
15,13,34,1648,662,734,1396,"6 de julio de 1997"
15,13,34,1649,844,924,1768,"6 de julio de 1997"
15,13,34,1650,833,911,1744,"6 de julio de 1997"
15,13,34,1652,481,471,952,"6 de julio de 1997"
15,13,34,1653,443,478,921,"6 de julio de 1997"
15,13,34,1654,493,526,1019,"6 de julio de 1997"
15,13,34,1688,639,673,1312,"6 de julio de 1997"
15,13,34,1689,509,561,1070,"6 de julio de 1997"
15,13,34,1690,508,501,1009,"6 de julio de 1997"
15,13,34,1691,897,983,1880,"6 de julio de 1997"
15,13,34,1692,767,779,1546,"6 de julio de 1997"
15,13,34,1693,628,672,1300,"6 de julio de 1997"
15,13,34,1694,815,871,1686,"6 de julio de 1997"
15,13,34,1695,587,636,1223,"6 de julio de 1997"
15,13,34,1696,607,705,1312,"6 de julio de 1997"
15,13,34,1697,666,688,1354,"6 de julio de 1997"
15,13,34,1698,625,692,1317,"6 de julio de 1997"
15,13,34,1710,613,651,1264,"6 de julio de 1997"
15,13,34,1711,676,733,1409,"6 de julio de 1997"
15,14,13,250,639,678,1317,"6 de julio de 1997"
15,14,13,251,480,550,1030,"6 de julio de 1997"
15,14,13,252,774,827,1601,"6 de julio de 1997"
15,14,13,253,601,645,1246,"6 de julio de 1997"
15,14,13,254,758,824,1582,"6 de julio de 1997"
15,14,13,255,717,790,1507,"6 de julio de 1997"
15,14,13,256,913,1041,1954,"6 de julio de 1997"
15,14,13,257,708,806,1514,"6 de julio de 1997"
15,14,13,258,983,1112,2095,"6 de julio de 1997"
15,14,13,259,494,550,1044,"6 de julio de 1997"
15,14,13,260,370,418,788,"6 de julio de 1997"
15,14,13,261,922,1007,1929,"6 de julio de 1997"
15,14,13,262,1261,1347,2608,"6 de julio de 1997"
15,14,13,263,803,915,1718,"6 de julio de 1997"
15,14,13,264,486,563,1049,"6 de julio de 1997"
15,14,13,265,495,556,1051,"6 de julio de 1997"
15,14,13,266,229,297,526,"6 de julio de 1997"
15,14,13,267,422,533,955,"6 de julio de 1997"
15,14,13,268,404,526,930,"6 de julio de 1997"
15,14,13,269,193,247,440,"6 de julio de 1997"
15,14,13,270,694,771,1465,"6 de julio de 1997"
15,14,13,271,666,774,1440,"6 de julio de 1997"
15,14,13,272,1539,1684,3223,"6 de julio de 1997"
15,14,13,273,558,575,1133,"6 de julio de 1997"
15,14,13,274,699,774,1473,"6 de julio de 1997"
15,14,13,275,655,668,1323,"6 de julio de 1997"
15,14,13,276,871,942,1813,"6 de julio de 1997"
15,14,13,277,521,591,1112,"6 de julio de 1997"
15,14,13,278,687,751,1438,"6 de julio de 1997"
15,14,13,279,519,567,1086,"6 de julio de 1997"
15,14,13,280,473,518,991,"6 de julio de 1997"
15,14,13,281,675,833,1508,"6 de julio de 1997"
15,14,13,282,901,1025,1926,"6 de julio de 1997"
15,14,13,283,920,1016,1936,"6 de julio de 1997"
15,14,13,284,332,426,758,"6 de julio de 1997"
15,14,13,285,431,505,936,"6 de julio de 1997"
15,14,13,286,240,295,535,"6 de julio de 1997"
15,14,13,287,826,848,1674,"6 de julio de 1997"
15,14,13,288,689,720,1409,"6 de julio de 1997"
15,14,13,289,793,885,1678,"6 de julio de 1997"
15,14,13,290,845,869,1714,"6 de julio de 1997"
15,14,13,291,391,463,854,"6 de julio de 1997"
15,14,13,292,466,532,998,"6 de julio de 1997"
15,14,13,293,249,258,507,"6 de julio de 1997"
15,14,13,294,734,813,1547,"6 de julio de 1997"
15,14,13,295,1082,1115,2197,"6 de julio de 1997"
15,14,13,296,663,756,1419,"6 de julio de 1997"
15,14,13,297,1037,1074,2111,"6 de julio de 1997"
15,14,13,298,666,770,1436,"6 de julio de 1997"
15,14,13,299,719,806,1525,"6 de julio de 1997"
15,14,13,300,697,759,1456,"6 de julio de 1997"
15,14,13,301,760,814,1574,"6 de julio de 1997"
15,14,13,302,821,920,1741,"6 de julio de 1997"
15,14,13,303,337,388,725,"6 de julio de 1997"
15,14,13,304,370,404,774,"6 de julio de 1997"
15,14,13,305,392,438,830,"6 de julio de 1997"
15,14,13,306,689,724,1413,"6 de julio de 1997"
15,14,13,307,951,1043,1994,"6 de julio de 1997"
15,14,13,308,494,600,1094,"6 de julio de 1997"
15,14,13,309,465,539,1004,"6 de julio de 1997"
15,14,13,310,861,967,1828,"6 de julio de 1997"
15,14,13,311,427,508,935,"6 de julio de 1997"
15,14,13,312,1253,1336,2589,"6 de julio de 1997"
15,14,13,313,779,900,1679,"6 de julio de 1997"
15,14,13,314,923,998,1921,"6 de julio de 1997"
15,14,13,315,473,503,976,"6 de julio de 1997"
15,14,13,316,761,795,1556,"6 de julio de 1997"
15,14,13,317,745,740,1485,"6 de julio de 1997"
15,14,13,318,862,957,1819,"6 de julio de 1997"
15,14,13,319,742,793,1535,"6 de julio de 1997"
15,14,13,320,960,1023,1983,"6 de julio de 1997"
15,14,13,321,746,968,1714,"6 de julio de 1997"
15,14,13,322,811,908,1719,"6 de julio de 1997"
15,14,13,323,648,694,1342,"6 de julio de 1997"
15,14,13,324,1074,1149,2223,"6 de julio de 1997"
15,14,13,325,529,592,1121,"6 de julio de 1997"
15,14,13,326,759,856,1615,"6 de julio de 1997"
15,14,13,327,425,520,945,"6 de julio de 1997"
15,14,13,328,306,369,675,"6 de julio de 1997"
15,14,13,329,736,808,1544,"6 de julio de 1997"
15,14,13,330,1069,1117,2186,"6 de julio de 1997"
15,14,13,331,734,791,1525,"6 de julio de 1997"
15,14,13,332,916,921,1837,"6 de julio de 1997"
15,14,13,333,932,1022,1954,"6 de julio de 1997"
15,14,13,334,373,366,739,"6 de julio de 1997"
15,14,13,335,665,684,1349,"6 de julio de 1997"
15,14,13,336,823,892,1715,"6 de julio de 1997"
15,14,13,337,677,789,1466,"6 de julio de 1997"
15,14,13,338,651,653,1304,"6 de julio de 1997"
15,14,13,339,532,599,1131,"6 de julio de 1997"
15,14,13,340,882,927,1809,"6 de julio de 1997"
15,14,13,341,716,777,1493,"6 de julio de 1997"
15,14,13,342,712,840,1552,"6 de julio de 1997"
15,14,13,343,809,845,1654,"6 de julio de 1997"
15,14,13,344,275,301,576,"6 de julio de 1997"
15,14,13,345,898,1051,1949,"6 de julio de 1997"
15,14,13,346,693,738,1431,"6 de julio de 1997"
15,14,13,347,596,653,1249,"6 de julio de 1997"
15,14,13,348,662,710,1372,"6 de julio de 1997"
15,14,13,349,760,843,1603,"6 de julio de 1997"
15,14,13,350,609,591,1200,"6 de julio de 1997"
15,14,13,351,869,952,1821,"6 de julio de 1997"
15,14,13,352,1020,1084,2104,"6 de julio de 1997"
15,14,13,353,913,957,1870,"6 de julio de 1997"
15,14,13,354,891,967,1858,"6 de julio de 1997"
15,14,13,355,605,620,1225,"6 de julio de 1997"
15,14,13,356,837,901,1738,"6 de julio de 1997"
15,14,13,357,882,913,1795,"6 de julio de 1997"
15,14,13,358,463,595,1058,"6 de julio de 1997"
15,14,13,359,843,934,1777,"6 de julio de 1997"
15,14,13,360,935,1005,1940,"6 de julio de 1997"
15,14,13,361,865,980,1845,"6 de julio de 1997"
15,14,13,362,560,675,1235,"6 de julio de 1997"
15,14,13,363,671,784,1455,"6 de julio de 1997"
15,14,13,364,700,805,1505,"6 de julio de 1997"
15,14,13,365,662,704,1366,"6 de julio de 1997"
15,14,13,366,588,610,1198,"6 de julio de 1997"
15,14,13,367,412,490,902,"6 de julio de 1997"
15,14,13,368,612,775,1387,"6 de julio de 1997"
15,14,13,369,789,896,1685,"6 de julio de 1997"
15,14,13,370,536,629,1165,"6 de julio de 1997"
15,14,13,371,402,434,836,"6 de julio de 1997"
15,14,13,372,686,798,1484,"6 de julio de 1997"
15,14,13,373,432,463,895,"6 de julio de 1997"
15,14,13,374,748,812,1560,"6 de julio de 1997"
15,14,13,375,734,844,1578,"6 de julio de 1997"
15,14,13,376,306,347,653,"6 de julio de 1997"
15,14,13,377,859,917,1776,"6 de julio de 1997"
15,14,13,378,422,458,880,"6 de julio de 1997"
15,14,13,379,712,814,1526,"6 de julio de 1997"
15,14,13,380,409,508,917,"6 de julio de 1997"
15,14,13,381,1143,1372,2515,"6 de julio de 1997"
15,14,13,382,719,880,1599,"6 de julio de 1997"
15,14,13,383,878,981,1859,"6 de julio de 1997"
15,14,13,384,204,234,438,"6 de julio de 1997"
15,14,13,385,458,529,987,"6 de julio de 1997"
15,14,13,386,639,672,1311,"6 de julio de 1997"
15,14,13,387,477,612,1089,"6 de julio de 1997"
15,14,13,388,523,589,1112,"6 de julio de 1997"
15,14,13,389,460,533,993,"6 de julio de 1997"
15,14,13,390,626,678,1304,"6 de julio de 1997"
15,14,13,391,269,325,594,"6 de julio de 1997"
15,14,13,392,743,893,1636,"6 de julio de 1997"
15,14,13,393,1107,1158,2265,"6 de julio de 1997"
15,14,13,394,774,808,1582,"6 de julio de 1997"
15,14,13,395,928,987,1915,"6 de julio de 1997"
15,14,13,396,946,1036,1982,"6 de julio de 1997"
15,14,13,397,672,745,1417,"6 de julio de 1997"
15,14,13,398,855,941,1796,"6 de julio de 1997"
15,14,13,399,896,942,1838,"6 de julio de 1997"
15,14,13,400,734,839,1573,"6 de julio de 1997"
15,14,13,401,670,710,1380,"6 de julio de 1997"
15,14,13,402,931,988,1919,"6 de julio de 1997"
15,14,13,403,643,773,1416,"6 de julio de 1997"
15,14,13,404,762,905,1667,"6 de julio de 1997"
15,14,13,405,718,778,1496,"6 de julio de 1997"
15,14,13,406,591,702,1293,"6 de julio de 1997"
15,14,13,407,424,452,876,"6 de julio de 1997"
15,14,13,408,908,1008,1916,"6 de julio de 1997"
15,14,13,409,743,864,1607,"6 de julio de 1997"
15,14,13,410,1063,1122,2185,"6 de julio de 1997"
15,14,13,411,918,987,1905,"6 de julio de 1997"
15,14,13,412,568,725,1293,"6 de julio de 1997"
15,14,13,413,667,750,1417,"6 de julio de 1997"
15,14,13,414,467,568,1035,"6 de julio de 1997"
15,14,13,415,329,367,696,"6 de julio de 1997"
15,14,13,416,604,715,1319,"6 de julio de 1997"
15,15,105,4840,440,588,1028,"6 de julio de 1997"
15,15,105,4869,536,523,1059,"6 de julio de 1997"
15,15,105,4870,830,768,1598,"6 de julio de 1997"
15,15,105,4871,452,462,914,"6 de julio de 1997"
15,15,105,4872,839,938,1777,"6 de julio de 1997"
15,15,105,4873,623,682,1305,"6 de julio de 1997"
15,15,105,4874,529,593,1122,"6 de julio de 1997"
15,15,105,4875,641,716,1357,"6 de julio de 1997"
15,15,105,4876,807,857,1664,"6 de julio de 1997"
15,15,105,4877,675,727,1402,"6 de julio de 1997"
15,15,105,4906,467,550,1017,"6 de julio de 1997"
15,15,105,4907,503,537,1040,"6 de julio de 1997"
15,15,105,4908,445,472,917,"6 de julio de 1997"
15,15,105,4909,663,759,1422,"6 de julio de 1997"
15,15,105,4910,628,722,1350,"6 de julio de 1997"
15,15,105,4911,501,572,1073,"6 de julio de 1997"
15,15,105,4912,686,779,1465,"6 de julio de 1997"
15,15,105,4913,328,356,684,"6 de julio de 1997"
15,15,105,4914,688,764,1452,"6 de julio de 1997"
15,15,105,4915,741,831,1572,"6 de julio de 1997"
15,15,105,4916,422,499,921,"6 de julio de 1997"
15,15,105,4917,791,894,1685,"6 de julio de 1997"
15,15,105,4918,670,675,1345,"6 de julio de 1997"
15,15,105,4919,535,597,1132,"6 de julio de 1997"
15,15,105,4920,695,747,1442,"6 de julio de 1997"
15,15,105,4921,562,679,1241,"6 de julio de 1997"
15,15,105,4922,440,469,909,"6 de julio de 1997"
15,15,105,4923,582,629,1211,"6 de julio de 1997"
15,15,105,4924,312,333,645,"6 de julio de 1997"
15,15,105,4925,695,789,1484,"6 de julio de 1997"
15,15,105,4926,825,908,1733,"6 de julio de 1997"
15,15,105,4927,515,611,1126,"6 de julio de 1997"
15,15,105,4928,513,632,1145,"6 de julio de 1997"
15,15,105,4929,636,766,1402,"6 de julio de 1997"
15,15,105,4930,583,574,1157,"6 de julio de 1997"
15,15,105,4945,585,625,1210,"6 de julio de 1997"
15,15,105,4946,872,905,1777,"6 de julio de 1997"
15,15,105,4947,462,539,1001,"6 de julio de 1997"
15,15,105,4948,678,795,1473,"6 de julio de 1997"
15,15,105,4949,726,813,1539,"6 de julio de 1997"
15,15,105,4950,460,503,963,"6 de julio de 1997"
15,15,105,4951,480,491,971,"6 de julio de 1997"
15,15,105,4952,455,479,934,"6 de julio de 1997"
15,15,105,4953,598,659,1257,"6 de julio de 1997"
15,15,105,4954,654,647,1301,"6 de julio de 1997"
15,15,105,4955,538,597,1135,"6 de julio de 1997"
15,15,105,4962,598,638,1236,"6 de julio de 1997"
15,15,105,4963,545,601,1146,"6 de julio de 1997"
15,15,105,4964,759,875,1634,"6 de julio de 1997"
15,15,105,4965,605,725,1330,"6 de julio de 1997"
15,15,105,4966,507,654,1161,"6 de julio de 1997"
15,15,105,4967,371,420,791,"6 de julio de 1997"
15,15,105,4968,386,436,822,"6 de julio de 1997"
15,15,105,4969,397,436,833,"6 de julio de 1997"
15,15,105,4970,457,553,1010,"6 de julio de 1997"
15,15,105,4971,468,509,977,"6 de julio de 1997"
15,15,105,4972,451,529,980,"6 de julio de 1997"
15,15,105,4973,625,738,1363,"6 de julio de 1997"
15,15,105,4974,654,759,1413,"6 de julio de 1997"
15,15,105,4975,747,904,1651,"6 de julio de 1997"
15,15,105,4976,547,634,1181,"6 de julio de 1997"
15,15,105,4977,609,719,1328,"6 de julio de 1997"
15,15,105,4978,901,1021,1922,"6 de julio de 1997"
15,15,105,4979,635,776,1411,"6 de julio de 1997"
15,15,105,4980,681,798,1479,"6 de julio de 1997"
15,15,105,4981,417,489,906,"6 de julio de 1997"
15,15,105,4982,663,754,1417,"6 de julio de 1997"
15,15,105,4983,658,699,1357,"6 de julio de 1997"
15,15,105,4984,381,407,788,"6 de julio de 1997"
15,15,105,4985,958,1008,1966,"6 de julio de 1997"
15,15,105,4986,801,921,1722,"6 de julio de 1997"
15,15,105,4987,806,875,1681,"6 de julio de 1997"
15,15,105,4988,835,902,1737,"6 de julio de 1997"
15,15,105,4989,898,893,1791,"6 de julio de 1997"
15,15,105,4990,813,920,1733,"6 de julio de 1997"
15,15,105,4991,646,683,1329,"6 de julio de 1997"
15,15,105,4992,480,496,976,"6 de julio de 1997"
15,15,105,4993,470,496,966,"6 de julio de 1997"
15,15,105,4994,280,358,638,"6 de julio de 1997"
15,15,105,4995,417,391,808,"6 de julio de 1997"
15,15,105,4996,569,706,1275,"6 de julio de 1997"
15,15,105,5002,597,632,1229,"6 de julio de 1997"
15,15,105,5004,572,604,1176,"6 de julio de 1997"
15,15,105,5005,647,714,1361,"6 de julio de 1997"
15,15,105,5024,424,487,911,"6 de julio de 1997"
15,15,105,5025,691,784,1475,"6 de julio de 1997"
15,15,105,5037,462,508,970,"6 de julio de 1997"
15,15,105,5048,628,632,1260,"6 de julio de 1997"
15,15,105,5092,558,559,1117,"6 de julio de 1997"
15,15,105,5093,423,462,885,"6 de julio de 1997"
15,15,105,5094,518,587,1105,"6 de julio de 1997"
15,15,105,5095,510,546,1056,"6 de julio de 1997"
15,15,105,5096,601,655,1256,"6 de julio de 1997"
15,15,105,5097,471,489,960,"6 de julio de 1997"
15,15,105,5098,367,421,788,"6 de julio de 1997"
15,15,105,5099,477,525,1002,"6 de julio de 1997"
15,15,105,5100,394,479,873,"6 de julio de 1997"
15,15,105,5101,352,410,762,"6 de julio de 1997"
15,15,105,5102,304,352,656,"6 de julio de 1997"
15,15,105,5103,361,432,793,"6 de julio de 1997"
15,15,105,5104,654,686,1340,"6 de julio de 1997"
15,15,105,5105,126,151,277,"6 de julio de 1997"
15,15,105,5106,801,898,1699,"6 de julio de 1997"
15,15,105,5107,823,863,1686,"6 de julio de 1997"
15,15,105,5108,449,504,953,"6 de julio de 1997"
15,15,105,5109,430,487,917,"6 de julio de 1997"
15,15,105,5110,541,583,1124,"6 de julio de 1997"
15,15,105,5111,530,566,1096,"6 de julio de 1997"
15,15,105,5112,651,667,1318,"6 de julio de 1997"
15,15,105,5113,802,871,1673,"6 de julio de 1997"
15,15,105,5114,702,729,1431,"6 de julio de 1997"
15,15,105,5115,410,495,905,"6 de julio de 1997"
15,15,105,5116,377,430,807,"6 de julio de 1997"
15,15,105,5117,705,790,1495,"6 de julio de 1997"
15,15,105,5118,627,683,1310,"6 de julio de 1997"
15,15,105,5119,569,605,1174,"6 de julio de 1997"
15,15,105,5120,594,670,1264,"6 de julio de 1997"
15,15,105,5121,313,334,647,"6 de julio de 1997"
15,15,105,5122,800,759,1559,"6 de julio de 1997"
15,15,105,5123,560,528,1088,"6 de julio de 1997"
15,15,105,5124,855,893,1748,"6 de julio de 1997"
15,15,105,5125,648,667,1315,"6 de julio de 1997"
15,15,105,5126,465,509,974,"6 de julio de 1997"
15,15,105,5127,434,468,902,"6 de julio de 1997"
15,15,105,5128,460,485,945,"6 de julio de 1997"
15,15,105,5129,860,897,1757,"6 de julio de 1997"
15,15,105,5133,780,836,1616,"6 de julio de 1997"
15,15,105,5134,815,877,1692,"6 de julio de 1997"
15,15,105,5135,568,608,1176,"6 de julio de 1997"
15,15,105,5136,430,481,911,"6 de julio de 1997"
15,16,105,4757,862,909,1771,"6 de julio de 1997"
15,16,105,4758,568,645,1213,"6 de julio de 1997"
15,16,105,4759,462,489,951,"6 de julio de 1997"
15,16,105,4760,429,469,898,"6 de julio de 1997"
15,16,105,4761,455,464,919,"6 de julio de 1997"
15,16,105,4762,589,616,1205,"6 de julio de 1997"
15,16,105,4763,432,471,903,"6 de julio de 1997"
15,16,105,4764,915,982,1897,"6 de julio de 1997"
15,16,105,4765,1148,1266,2414,"6 de julio de 1997"
15,16,105,4766,875,939,1814,"6 de julio de 1997"
15,16,105,4767,704,731,1435,"6 de julio de 1997"
15,16,105,4768,919,962,1881,"6 de julio de 1997"
15,16,105,4769,669,681,1350,"6 de julio de 1997"
15,16,105,4770,603,643,1246,"6 de julio de 1997"
15,16,105,4771,505,553,1058,"6 de julio de 1997"
15,16,105,4772,507,525,1032,"6 de julio de 1997"
15,16,105,4773,473,501,974,"6 de julio de 1997"
15,16,105,4774,460,516,976,"6 de julio de 1997"
15,16,105,4775,673,705,1378,"6 de julio de 1997"
15,16,105,4776,591,623,1214,"6 de julio de 1997"
15,16,105,4777,568,591,1159,"6 de julio de 1997"
15,16,105,4778,540,554,1094,"6 de julio de 1997"
15,16,105,4779,923,967,1890,"6 de julio de 1997"
15,16,105,4780,749,791,1540,"6 de julio de 1997"
15,16,105,4781,594,673,1267,"6 de julio de 1997"
15,16,105,4782,547,621,1168,"6 de julio de 1997"
15,16,105,4783,611,654,1265,"6 de julio de 1997"
15,16,105,4784,588,632,1220,"6 de julio de 1997"
15,16,105,4785,412,414,826,"6 de julio de 1997"
15,16,105,4786,758,809,1567,"6 de julio de 1997"
15,16,105,4787,931,993,1924,"6 de julio de 1997"
15,16,105,4788,966,1000,1966,"6 de julio de 1997"
15,16,105,4789,481,558,1039,"6 de julio de 1997"
15,16,105,4790,499,575,1074,"6 de julio de 1997"
15,16,105,4791,874,916,1790,"6 de julio de 1997"
15,16,105,4792,536,571,1107,"6 de julio de 1997"
15,16,105,4793,575,606,1181,"6 de julio de 1997"
15,16,105,4794,540,565,1105,"6 de julio de 1997"
15,16,105,4795,583,604,1187,"6 de julio de 1997"
15,16,105,4796,444,495,939,"6 de julio de 1997"
15,16,105,4797,607,623,1230,"6 de julio de 1997"
15,16,105,4798,828,866,1694,"6 de julio de 1997"
15,16,105,4799,885,1044,1929,"6 de julio de 1997"
15,16,105,4800,601,675,1276,"6 de julio de 1997"
15,16,105,4801,452,459,911,"6 de julio de 1997"
15,16,105,4802,668,759,1427,"6 de julio de 1997"
15,16,105,4803,747,762,1509,"6 de julio de 1997"
15,16,105,4804,1035,1075,2110,"6 de julio de 1997"
15,16,105,4805,976,1001,1977,"6 de julio de 1997"
15,16,105,4806,554,613,1167,"6 de julio de 1997"
15,16,105,4807,512,545,1057,"6 de julio de 1997"
15,16,105,4808,949,969,1918,"6 de julio de 1997"
15,16,105,4809,540,571,1111,"6 de julio de 1997"
15,16,105,4810,496,551,1047,"6 de julio de 1997"
15,16,105,4811,306,364,670,"6 de julio de 1997"
15,16,105,4812,687,736,1423,"6 de julio de 1997"
15,16,105,4813,488,550,1038,"6 de julio de 1997"
15,16,105,4814,618,695,1313,"6 de julio de 1997"
15,16,105,4815,725,750,1475,"6 de julio de 1997"
15,16,105,4816,837,843,1680,"6 de julio de 1997"
15,16,105,4817,611,601,1212,"6 de julio de 1997"
15,16,105,4818,506,548,1054,"6 de julio de 1997"
15,16,105,4819,458,504,962,"6 de julio de 1997"
15,16,105,4820,446,480,926,"6 de julio de 1997"
15,16,105,4821,532,556,1088,"6 de julio de 1997"
15,16,105,4822,585,598,1183,"6 de julio de 1997"
15,16,105,4823,780,838,1618,"6 de julio de 1997"
15,16,105,4824,728,806,1534,"6 de julio de 1997"
15,16,105,4825,609,637,1246,"6 de julio de 1997"
15,16,105,4826,727,736,1463,"6 de julio de 1997"
15,16,105,4827,782,842,1624,"6 de julio de 1997"
15,16,105,4828,562,579,1141,"6 de julio de 1997"
15,16,105,4829,396,402,798,"6 de julio de 1997"
15,16,105,4830,934,988,1922,"6 de julio de 1997"
15,16,105,4831,883,863,1746,"6 de julio de 1997"
15,16,105,4832,888,912,1800,"6 de julio de 1997"
15,16,105,4833,573,592,1165,"6 de julio de 1997"
15,16,105,4834,670,694,1364,"6 de julio de 1997"
15,16,105,4835,560,559,1119,"6 de julio de 1997"
15,16,105,4878,761,770,1531,"6 de julio de 1997"
15,16,105,4879,120,163,283,"6 de julio de 1997"
15,16,105,4880,130,157,287,"6 de julio de 1997"
15,16,105,4881,306,346,652,"6 de julio de 1997"
15,16,105,4882,533,528,1061,"6 de julio de 1997"
15,16,105,4883,485,553,1038,"6 de julio de 1997"
15,16,105,4884,489,517,1006,"6 de julio de 1997"
15,16,105,4885,595,649,1244,"6 de julio de 1997"
15,16,105,4886,703,765,1468,"6 de julio de 1997"
15,16,105,4887,536,573,1109,"6 de julio de 1997"
15,16,105,4888,601,651,1252,"6 de julio de 1997"
15,16,105,4889,406,457,863,"6 de julio de 1997"
15,16,105,4890,785,872,1657,"6 de julio de 1997"
15,16,105,4891,415,491,906,"6 de julio de 1997"
15,16,105,4892,389,430,819,"6 de julio de 1997"
15,16,105,4893,497,543,1040,"6 de julio de 1997"
15,16,105,4894,786,852,1638,"6 de julio de 1997"
15,16,105,4895,614,648,1262,"6 de julio de 1997"
15,16,105,4896,399,441,840,"6 de julio de 1997"
15,16,105,4897,430,447,877,"6 de julio de 1997"
15,16,105,4898,649,681,1330,"6 de julio de 1997"
15,16,105,4899,502,512,1014,"6 de julio de 1997"
15,16,105,4900,367,411,778,"6 de julio de 1997"
15,16,105,4901,443,483,926,"6 de julio de 1997"
15,16,105,4902,230,271,501,"6 de julio de 1997"
15,16,105,4903,294,354,648,"6 de julio de 1997"
15,16,105,4904,371,452,823,"6 de julio de 1997"
15,16,105,4905,566,663,1229,"6 de julio de 1997"
15,16,105,4931,394,440,834,"6 de julio de 1997"
15,16,105,4932,226,260,486,"6 de julio de 1997"
15,16,105,4933,324,354,678,"6 de julio de 1997"
15,16,105,4934,325,368,693,"6 de julio de 1997"
15,16,105,4935,710,792,1502,"6 de julio de 1997"
15,16,105,4936,385,412,797,"6 de julio de 1997"
15,16,105,4937,701,744,1445,"6 de julio de 1997"
15,16,105,4938,771,810,1581,"6 de julio de 1997"
15,16,105,4939,425,498,923,"6 de julio de 1997"
15,16,105,4940,457,472,929,"6 de julio de 1997"
15,16,105,4941,586,673,1259,"6 de julio de 1997"
15,16,105,4942,724,742,1466,"6 de julio de 1997"
15,16,105,4943,720,753,1473,"6 de julio de 1997"
15,16,105,4944,672,724,1396,"6 de julio de 1997"
15,16,105,4956,567,659,1226,"6 de julio de 1997"
15,16,105,4957,524,606,1130,"6 de julio de 1997"
15,16,105,4958,690,734,1424,"6 de julio de 1997"
15,16,105,4959,595,665,1260,"6 de julio de 1997"
15,16,105,4960,551,583,1134,"6 de julio de 1997"
15,16,105,4961,660,719,1379,"6 de julio de 1997"
15,16,105,5130,672,736,1408,"6 de julio de 1997"
15,16,105,5131,721,747,1468,"6 de julio de 1997"
15,16,105,5132,743,741,1484,"6 de julio de 1997"
15,17,34,1427,542,590,1132,"6 de julio de 1997"
15,17,34,1428,303,350,653,"6 de julio de 1997"
15,17,34,1429,683,764,1447,"6 de julio de 1997"
15,17,34,1461,606,708,1314,"6 de julio de 1997"
15,17,34,1462,700,778,1478,"6 de julio de 1997"
15,17,34,1480,565,670,1235,"6 de julio de 1997"
15,17,34,1481,640,750,1390,"6 de julio de 1997"
15,17,34,1482,479,553,1032,"6 de julio de 1997"
15,17,34,1483,291,382,673,"6 de julio de 1997"
15,17,34,1484,470,518,988,"6 de julio de 1997"
15,17,34,1485,367,419,786,"6 de julio de 1997"
15,17,34,1499,354,394,748,"6 de julio de 1997"
15,17,34,1500,580,679,1259,"6 de julio de 1997"
15,17,34,1537,752,758,1510,"6 de julio de 1997"
15,17,34,1541,624,702,1326,"6 de julio de 1997"
15,17,34,1542,311,374,685,"6 de julio de 1997"
15,17,34,1543,533,622,1155,"6 de julio de 1997"
15,17,34,1544,125,132,257,"6 de julio de 1997"
15,17,34,1545,526,600,1126,"6 de julio de 1997"
15,17,34,1546,416,490,906,"6 de julio de 1997"
15,17,34,1547,591,695,1286,"6 de julio de 1997"
15,17,34,1548,497,535,1032,"6 de julio de 1997"
15,17,34,1549,317,385,702,"6 de julio de 1997"
15,17,34,1550,225,307,532,"6 de julio de 1997"
15,17,34,1551,576,611,1187,"6 de julio de 1997"
15,17,34,1552,431,478,909,"6 de julio de 1997"
15,17,34,1553,329,407,736,"6 de julio de 1997"
15,17,34,1554,560,633,1193,"6 de julio de 1997"
15,17,34,1555,645,702,1347,"6 de julio de 1997"
15,17,34,1556,770,836,1606,"6 de julio de 1997"
15,17,34,1557,824,856,1680,"6 de julio de 1997"
15,17,34,1558,966,1039,2005,"6 de julio de 1997"
15,17,34,1559,736,755,1491,"6 de julio de 1997"
15,17,34,1560,558,583,1141,"6 de julio de 1997"
15,17,34,1561,896,995,1891,"6 de julio de 1997"
15,17,34,1562,256,276,532,"6 de julio de 1997"
15,17,34,1563,531,576,1107,"6 de julio de 1997"
15,17,34,1564,518,607,1125,"6 de julio de 1997"
15,17,34,1565,762,804,1566,"6 de julio de 1997"
15,17,34,1566,671,770,1441,"6 de julio de 1997"
15,17,34,1567,831,948,1779,"6 de julio de 1997"
15,17,34,1568,524,659,1183,"6 de julio de 1997"
15,17,34,1569,481,581,1062,"6 de julio de 1997"
15,17,34,1570,855,935,1790,"6 de julio de 1997"
15,17,34,1571,772,813,1585,"6 de julio de 1997"
15,17,34,1572,611,700,1311,"6 de julio de 1997"
15,17,34,1573,665,772,1437,"6 de julio de 1997"
15,17,34,1574,741,854,1595,"6 de julio de 1997"
15,17,34,1575,716,800,1516,"6 de julio de 1997"
15,17,34,1576,551,632,1183,"6 de julio de 1997"
15,17,34,1577,411,431,842,"6 de julio de 1997"
15,17,34,1578,682,805,1487,"6 de julio de 1997"
15,17,34,1579,688,796,1484,"6 de julio de 1997"
15,17,34,1580,662,739,1401,"6 de julio de 1997"
15,17,34,1581,433,535,968,"6 de julio de 1997"
15,17,34,1582,537,600,1137,"6 de julio de 1997"
15,17,34,1583,526,589,1115,"6 de julio de 1997"
15,17,34,1584,724,773,1497,"6 de julio de 1997"
15,17,34,1585,739,786,1525,"6 de julio de 1997"
15,17,34,1586,264,276,540,"6 de julio de 1997"
15,17,34,1587,396,483,879,"6 de julio de 1997"
15,17,34,1588,840,910,1750,"6 de julio de 1997"
15,17,34,1589,282,315,597,"6 de julio de 1997"
15,17,34,1590,213,248,461,"6 de julio de 1997"
15,17,34,1591,755,781,1536,"6 de julio de 1997"
15,17,34,1592,707,788,1495,"6 de julio de 1997"
15,17,34,1593,378,393,771,"6 de julio de 1997"
15,17,34,1594,444,524,968,"6 de julio de 1997"
15,17,34,1595,574,605,1179,"6 de julio de 1997"
15,17,34,1596,601,587,1188,"6 de julio de 1997"
15,17,34,1597,739,756,1495,"6 de julio de 1997"
15,17,34,1598,648,654,1302,"6 de julio de 1997"
15,17,34,1599,409,475,884,"6 de julio de 1997"
15,17,34,1600,319,345,664,"6 de julio de 1997"
15,17,34,1601,260,270,530,"6 de julio de 1997"
15,17,34,1602,539,572,1111,"6 de julio de 1997"
15,17,34,1603,503,550,1053,"6 de julio de 1997"
15,17,34,1604,674,691,1365,"6 de julio de 1997"
15,17,34,1605,752,813,1565,"6 de julio de 1997"
15,17,34,1606,803,796,1599,"6 de julio de 1997"
15,17,34,1607,809,875,1684,"6 de julio de 1997"
15,17,34,1608,285,340,625,"6 de julio de 1997"
15,17,34,1609,609,664,1273,"6 de julio de 1997"
15,17,34,1613,805,835,1640,"6 de julio de 1997"
15,17,34,1614,502,548,1050,"6 de julio de 1997"
15,17,34,1615,492,493,985,"6 de julio de 1997"
15,17,34,1616,471,521,992,"6 de julio de 1997"
15,17,34,1617,404,486,890,"6 de julio de 1997"
15,17,34,1618,633,677,1310,"6 de julio de 1997"
15,17,34,1619,204,270,474,"6 de julio de 1997"
15,17,34,1620,296,356,652,"6 de julio de 1997"
15,17,34,1621,361,428,789,"6 de julio de 1997"
15,17,34,1622,306,359,665,"6 de julio de 1997"
15,17,34,1623,251,287,538,"6 de julio de 1997"
15,17,34,1624,381,474,855,"6 de julio de 1997"
15,17,34,1625,546,621,1167,"6 de julio de 1997"
15,17,34,1626,548,649,1197,"6 de julio de 1997"
15,17,34,1627,659,728,1387,"6 de julio de 1997"
15,17,34,1628,331,357,688,"6 de julio de 1997"
15,17,34,1629,692,747,1439,"6 de julio de 1997"
15,17,34,1630,304,358,662,"6 de julio de 1997"
15,17,34,1631,525,583,1108,"6 de julio de 1997"
15,17,34,1632,466,530,996,"6 de julio de 1997"
15,17,34,1633,564,630,1194,"6 de julio de 1997"
15,17,34,1634,374,434,808,"6 de julio de 1997"
15,17,34,1635,287,357,644,"6 de julio de 1997"
15,17,34,1636,240,335,575,"6 de julio de 1997"
15,17,34,1637,339,442,781,"6 de julio de 1997"
15,17,34,1638,347,407,754,"6 de julio de 1997"
15,17,34,1639,305,359,664,"6 de julio de 1997"
15,17,34,1640,306,383,689,"6 de julio de 1997"
15,17,34,1641,177,232,409,"6 de julio de 1997"
15,17,34,1642,385,386,771,"6 de julio de 1997"
15,17,34,1643,520,536,1056,"6 de julio de 1997"
15,17,34,1644,690,780,1470,"6 de julio de 1997"
15,17,34,1645,664,724,1388,"6 de julio de 1997"
15,17,34,1646,624,624,1248,"6 de julio de 1997"
15,17,34,1651,511,558,1069,"6 de julio de 1997"
15,17,34,1655,779,888,1667,"6 de julio de 1997"
15,17,34,1656,495,536,1031,"6 de julio de 1997"
15,17,34,1657,461,489,950,"6 de julio de 1997"
15,17,34,1658,903,992,1895,"6 de julio de 1997"
15,17,34,1659,880,926,1806,"6 de julio de 1997"
15,17,34,1660,443,547,990,"6 de julio de 1997"
15,17,34,1661,492,593,1085,"6 de julio de 1997"
15,17,34,1662,494,582,1076,"6 de julio de 1997"
15,17,34,1663,461,532,993,"6 de julio de 1997"
15,17,34,1664,277,325,602,"6 de julio de 1997"
15,17,34,1665,341,365,706,"6 de julio de 1997"
15,17,34,1666,546,573,1119,"6 de julio de 1997"
15,17,34,1667,410,446,856,"6 de julio de 1997"
15,17,34,1668,402,430,832,"6 de julio de 1997"
15,17,34,1669,390,450,840,"6 de julio de 1997"
15,17,34,1670,441,490,931,"6 de julio de 1997"
15,17,34,1671,730,768,1498,"6 de julio de 1997"
15,17,34,1672,459,501,960,"6 de julio de 1997"
15,17,34,1673,567,635,1202,"6 de julio de 1997"
15,17,34,1674,446,508,954,"6 de julio de 1997"
15,17,34,1675,496,506,1002,"6 de julio de 1997"
15,17,34,1676,541,518,1059,"6 de julio de 1997"
15,17,34,1677,497,574,1071,"6 de julio de 1997"
15,17,34,1678,528,579,1107,"6 de julio de 1997"
15,17,34,1679,588,604,1192,"6 de julio de 1997"
15,17,34,1680,768,845,1613,"6 de julio de 1997"
15,17,34,1681,600,666,1266,"6 de julio de 1997"
15,17,34,1682,672,738,1410,"6 de julio de 1997"
15,17,34,1683,818,894,1712,"6 de julio de 1997"
15,17,34,1684,373,365,738,"6 de julio de 1997"
15,17,34,1685,392,458,850,"6 de julio de 1997"
15,17,34,1686,431,485,916,"6 de julio de 1997"
15,17,34,1687,590,603,1193,"6 de julio de 1997"
15,17,34,1699,703,719,1422,"6 de julio de 1997"
15,17,34,1700,951,1107,2058,"6 de julio de 1997"
15,17,34,1701,584,644,1228,"6 de julio de 1997"
15,17,34,1702,646,695,1341,"6 de julio de 1997"
15,17,34,1703,872,1035,1907,"6 de julio de 1997"
15,17,34,1704,635,698,1333,"6 de julio de 1997"
15,17,34,1705,579,644,1223,"6 de julio de 1997"
15,17,34,1706,775,795,1570,"6 de julio de 1997"
15,17,34,1707,524,563,1087,"6 de julio de 1997"
15,17,34,1708,792,873,1665,"6 de julio de 1997"
15,17,34,1709,624,673,1297,"6 de julio de 1997"
15,17,34,1712,619,689,1308,"6 de julio de 1997"
15,17,34,1713,253,284,537,"6 de julio de 1997"
15,17,34,1714,591,623,1214,"6 de julio de 1997"
15,17,34,1715,530,596,1126,"6 de julio de 1997"
15,17,34,1716,572,615,1187,"6 de julio de 1997"
15,17,34,1717,678,790,1468,"6 de julio de 1997"
15,17,34,1718,739,812,1551,"6 de julio de 1997"
15,17,34,1719,432,476,908,"6 de julio de 1997"
15,17,34,1720,901,942,1843,"6 de julio de 1997"
15,17,34,1721,652,744,1396,"6 de julio de 1997"
15,17,34,1722,725,763,1488,"6 de julio de 1997"
15,17,34,1723,521,600,1121,"6 de julio de 1997"
15,17,34,1724,652,687,1339,"6 de julio de 1997"
15,17,34,1725,238,296,534,"6 de julio de 1997"
15,17,34,1726,186,212,398,"6 de julio de 1997"
15,17,34,1727,242,275,517,"6 de julio de 1997"
15,17,34,1728,308,321,629,"6 de julio de 1997"
15,17,34,1729,454,437,891,"6 de julio de 1997"
15,17,34,1730,270,296,566,"6 de julio de 1997"
15,17,34,1731,138,147,285,"6 de julio de 1997"
15,17,34,1732,758,894,1652,"6 de julio de 1997"
15,17,34,1733,755,841,1596,"6 de julio de 1997"
15,17,34,1734,689,736,1425,"6 de julio de 1997"
15,18,38,1992,540,555,1095,"6 de julio de 1997"
15,18,38,1993,377,422,799,"6 de julio de 1997"
15,18,38,1994,464,476,940,"6 de julio de 1997"
15,18,38,1995,745,770,1515,"6 de julio de 1997"
15,18,38,1996,830,939,1769,"6 de julio de 1997"
15,18,38,1997,752,823,1575,"6 de julio de 1997"
15,18,38,1998,497,495,992,"6 de julio de 1997"
15,18,38,1999,408,503,911,"6 de julio de 1997"
15,18,38,2000,881,924,1805,"6 de julio de 1997"
15,18,38,2001,435,474,909,"6 de julio de 1997"
15,18,38,2002,483,618,1101,"6 de julio de 1997"
15,18,38,2003,556,782,1338,"6 de julio de 1997"
15,18,38,2004,487,639,1126,"6 de julio de 1997"
15,18,38,2005,543,731,1274,"6 de julio de 1997"
15,18,38,2006,881,1037,1918,"6 de julio de 1997"
15,18,38,2007,1174,1301,2475,"6 de julio de 1997"
15,18,38,2008,987,1117,2104,"6 de julio de 1997"
15,18,38,2009,471,608,1079,"6 de julio de 1997"
15,18,38,2010,716,918,1634,"6 de julio de 1997"
15,18,38,2011,566,830,1396,"6 de julio de 1997"
15,18,38,2012,501,658,1159,"6 de julio de 1997"
15,18,38,2013,476,622,1098,"6 de julio de 1997"
15,18,38,2014,547,728,1275,"6 de julio de 1997"
15,18,38,2015,547,779,1326,"6 de julio de 1997"
15,18,38,2016,677,810,1487,"6 de julio de 1997"
15,18,38,2017,482,652,1134,"6 de julio de 1997"
15,18,38,2018,695,734,1429,"6 de julio de 1997"
15,18,38,2019,849,885,1734,"6 de julio de 1997"
15,18,38,2020,745,770,1515,"6 de julio de 1997"
15,18,38,2021,501,527,1028,"6 de julio de 1997"
15,18,38,2022,503,563,1066,"6 de julio de 1997"
15,18,38,2023,505,541,1046,"6 de julio de 1997"
15,18,38,2024,713,773,1486,"6 de julio de 1997"
15,18,38,2025,869,931,1800,"6 de julio de 1997"
15,18,38,2026,587,637,1224,"6 de julio de 1997"
15,18,38,2027,1038,1072,2110,"6 de julio de 1997"
15,18,38,2028,755,830,1585,"6 de julio de 1997"
15,18,38,2029,439,439,878,"6 de julio de 1997"
15,18,38,2030,567,572,1139,"6 de julio de 1997"
15,18,38,2031,495,520,1015,"6 de julio de 1997"
15,18,38,2032,142,146,288,"6 de julio de 1997"
15,18,38,2033,449,474,923,"6 de julio de 1997"
15,18,38,2034,952,1013,1965,"6 de julio de 1997"
15,18,38,2035,125,163,288,"6 de julio de 1997"
15,18,38,2036,463,636,1099,"6 de julio de 1997"
15,18,38,2037,518,647,1165,"6 de julio de 1997"
15,18,38,2038,364,520,884,"6 de julio de 1997"
15,18,38,2039,854,939,1793,"6 de julio de 1997"
15,18,38,2040,564,589,1153,"6 de julio de 1997"
15,18,38,2041,510,523,1033,"6 de julio de 1997"
15,18,38,2042,704,749,1453,"6 de julio de 1997"
15,18,38,2043,545,561,1106,"6 de julio de 1997"
15,18,38,2044,533,547,1080,"6 de julio de 1997"
15,18,38,2045,376,407,783,"6 de julio de 1997"
15,18,38,2046,876,968,1844,"6 de julio de 1997"
15,18,38,2047,949,1030,1979,"6 de julio de 1997"
15,18,38,2048,452,483,935,"6 de julio de 1997"
15,18,38,2049,515,621,1136,"6 de julio de 1997"
15,18,38,2050,696,811,1507,"6 de julio de 1997"
15,18,38,2051,480,550,1030,"6 de julio de 1997"
15,18,38,2052,454,536,990,"6 de julio de 1997"
15,18,38,2053,592,630,1222,"6 de julio de 1997"
15,18,38,2054,530,574,1104,"6 de julio de 1997"
15,18,38,2055,473,498,971,"6 de julio de 1997"
15,18,38,2056,162,183,345,"6 de julio de 1997"
15,18,38,2057,632,649,1281,"6 de julio de 1997"
15,18,38,2058,447,457,904,"6 de julio de 1997"
15,18,38,2059,288,316,604,"6 de julio de 1997"
15,18,38,2060,905,975,1880,"6 de julio de 1997"
15,18,38,2061,606,588,1194,"6 de julio de 1997"
15,18,38,2062,293,310,603,"6 de julio de 1997"
15,18,38,2063,548,609,1157,"6 de julio de 1997"
15,18,38,2064,475,471,946,"6 de julio de 1997"
15,18,38,2065,718,730,1448,"6 de julio de 1997"
15,18,38,2066,628,689,1317,"6 de julio de 1997"
15,18,38,2067,787,814,1601,"6 de julio de 1997"
15,18,47,2304,343,357,700,"6 de julio de 1997"
15,18,47,2305,127,104,231,"6 de julio de 1997"
15,18,47,2306,335,300,635,"6 de julio de 1997"
15,18,47,2307,240,220,460,"6 de julio de 1997"
15,18,47,2308,776,811,1587,"6 de julio de 1997"
15,18,47,2309,170,167,337,"6 de julio de 1997"
15,18,47,2310,496,532,1028,"6 de julio de 1997"
15,18,47,2311,491,464,955,"6 de julio de 1997"
15,18,47,2312,236,238,474,"6 de julio de 1997"
15,18,47,2313,351,381,732,"6 de julio de 1997"
15,18,68,3903,903,924,1827,"6 de julio de 1997"
15,18,68,3904,898,981,1879,"6 de julio de 1997"
15,18,68,3905,930,993,1923,"6 de julio de 1997"
15,18,68,3906,554,590,1144,"6 de julio de 1997"
15,18,68,3907,543,574,1117,"6 de julio de 1997"
15,18,68,3908,409,395,804,"6 de julio de 1997"
15,18,68,3909,674,689,1363,"6 de julio de 1997"
15,18,68,3910,666,581,1247,"6 de julio de 1997"
15,18,68,3911,243,248,491,"6 de julio de 1997"
15,18,68,3912,805,865,1670,"6 de julio de 1997"
15,18,68,3913,550,542,1092,"6 de julio de 1997"
15,18,68,3914,342,324,666,"6 de julio de 1997"
15,18,68,3915,484,511,995,"6 de julio de 1997"
15,18,68,3916,211,203,414,"6 de julio de 1997"
15,18,68,3917,298,311,609,"6 de julio de 1997"
15,18,68,3918,490,488,978,"6 de julio de 1997"
15,18,68,3919,729,752,1481,"6 de julio de 1997"
15,18,68,3920,204,196,400,"6 de julio de 1997"
15,18,68,3921,609,625,1234,"6 de julio de 1997"
15,18,68,3922,243,257,500,"6 de julio de 1997"
15,18,68,3923,208,200,408,"6 de julio de 1997"
15,18,68,3924,549,573,1122,"6 de julio de 1997"
15,18,68,3925,295,292,587,"6 de julio de 1997"
15,18,68,3926,292,282,574,"6 de julio de 1997"
15,18,116,5791,592,623,1215,"6 de julio de 1997"
15,18,116,5792,655,674,1329,"6 de julio de 1997"
15,18,116,5793,908,958,1866,"6 de julio de 1997"
15,18,116,5794,708,756,1464,"6 de julio de 1997"
15,18,116,5795,541,597,1138,"6 de julio de 1997"
15,18,116,5796,702,790,1492,"6 de julio de 1997"
15,18,116,5797,792,838,1630,"6 de julio de 1997"
15,18,116,5798,466,437,903,"6 de julio de 1997"
15,18,116,5799,731,664,1395,"6 de julio de 1997"
15,18,116,5800,557,511,1068,"6 de julio de 1997"
15,18,116,5801,493,489,982,"6 de julio de 1997"
15,18,116,5802,951,1005,1956,"6 de julio de 1997"
15,18,116,5803,874,921,1795,"6 de julio de 1997"
15,18,116,5804,661,643,1304,"6 de julio de 1997"
15,19,105,4836,727,871,1598,"6 de julio de 1997"
15,19,105,4837,691,861,1552,"6 de julio de 1997"
15,19,105,4838,849,954,1803,"6 de julio de 1997"
15,19,105,4839,661,848,1509,"6 de julio de 1997"
15,19,105,4841,728,840,1568,"6 de julio de 1997"
15,19,105,4842,686,777,1463,"6 de julio de 1997"
15,19,105,4843,721,848,1569,"6 de julio de 1997"
15,19,105,4844,180,188,368,"6 de julio de 1997"
15,19,105,4845,674,783,1457,"6 de julio de 1997"
15,19,105,4846,805,944,1749,"6 de julio de 1997"
15,19,105,4847,610,727,1337,"6 de julio de 1997"
15,19,105,4848,545,667,1212,"6 de julio de 1997"
15,19,105,4849,738,892,1630,"6 de julio de 1997"
15,19,105,4850,555,616,1171,"6 de julio de 1997"
15,19,105,4851,711,846,1557,"6 de julio de 1997"
15,19,105,4852,685,796,1481,"6 de julio de 1997"
15,19,105,4853,623,752,1375,"6 de julio de 1997"
15,19,105,4854,627,857,1484,"6 de julio de 1997"
15,19,105,4855,652,662,1314,"6 de julio de 1997"
15,19,105,4856,669,738,1407,"6 de julio de 1997"
15,19,105,4857,582,681,1263,"6 de julio de 1997"
15,19,105,4858,858,964,1822,"6 de julio de 1997"
15,19,105,4859,446,485,931,"6 de julio de 1997"
15,19,105,4860,457,503,960,"6 de julio de 1997"
15,19,105,4861,783,759,1542,"6 de julio de 1997"
15,19,105,4862,692,741,1433,"6 de julio de 1997"
15,19,105,4863,450,491,941,"6 de julio de 1997"
15,19,105,4864,332,377,709,"6 de julio de 1997"
15,19,105,4865,661,845,1506,"6 de julio de 1997"
15,19,105,4866,807,917,1724,"6 de julio de 1997"
15,19,105,4867,411,433,844,"6 de julio de 1997"
15,19,105,4868,860,851,1711,"6 de julio de 1997"
15,19,105,4997,772,927,1699,"6 de julio de 1997"
15,19,105,4998,721,840,1561,"6 de julio de 1997"
15,19,105,4999,635,770,1405,"6 de julio de 1997"
15,19,105,5000,667,863,1530,"6 de julio de 1997"
15,19,105,5001,653,762,1415,"6 de julio de 1997"
15,19,105,5003,593,682,1275,"6 de julio de 1997"
15,19,105,5006,537,596,1133,"6 de julio de 1997"
15,19,105,5007,282,304,586,"6 de julio de 1997"
15,19,105,5008,556,619,1175,"6 de julio de 1997"
15,19,105,5009,591,675,1266,"6 de julio de 1997"
15,19,105,5010,395,405,800,"6 de julio de 1997"
15,19,105,5011,787,884,1671,"6 de julio de 1997"
15,19,105,5012,740,889,1629,"6 de julio de 1997"
15,19,105,5013,582,681,1263,"6 de julio de 1997"
15,19,105,5014,595,713,1308,"6 de julio de 1997"
15,19,105,5015,670,777,1447,"6 de julio de 1997"
15,19,105,5016,482,528,1010,"6 de julio de 1997"
15,19,105,5017,405,428,833,"6 de julio de 1997"
15,19,105,5018,387,424,811,"6 de julio de 1997"
15,19,105,5019,499,483,982,"6 de julio de 1997"
15,19,105,5020,431,480,911,"6 de julio de 1997"
15,19,105,5021,410,456,866,"6 de julio de 1997"
15,19,105,5022,780,832,1612,"6 de julio de 1997"
15,19,105,5023,465,496,961,"6 de julio de 1997"
15,19,105,5026,410,477,887,"6 de julio de 1997"
15,19,105,5027,406,436,842,"6 de julio de 1997"
15,19,105,5028,754,817,1571,"6 de julio de 1997"
15,19,105,5029,263,300,563,"6 de julio de 1997"
15,19,105,5030,381,438,819,"6 de julio de 1997"
15,19,105,5031,345,464,809,"6 de julio de 1997"
15,19,105,5032,398,486,884,"6 de julio de 1997"
15,19,105,5033,339,315,654,"6 de julio de 1997"
15,19,105,5034,625,725,1350,"6 de julio de 1997"
15,19,105,5035,700,805,1505,"6 de julio de 1997"
15,19,105,5036,718,848,1566,"6 de julio de 1997"
15,19,105,5038,726,776,1502,"6 de julio de 1997"
15,19,105,5039,667,743,1410,"6 de julio de 1997"
15,19,105,5040,583,538,1121,"6 de julio de 1997"
15,19,105,5041,389,368,757,"6 de julio de 1997"
15,19,105,5042,743,843,1586,"6 de julio de 1997"
15,19,105,5043,512,612,1124,"6 de julio de 1997"
15,19,105,5044,718,801,1519,"6 de julio de 1997"
15,19,105,5045,600,651,1251,"6 de julio de 1997"
15,19,105,5046,542,617,1159,"6 de julio de 1997"
15,19,105,5047,456,506,962,"6 de julio de 1997"
15,19,105,5049,497,508,1005,"6 de julio de 1997"
15,19,105,5050,428,465,893,"6 de julio de 1997"
15,19,105,5051,504,565,1069,"6 de julio de 1997"
15,19,105,5052,738,771,1509,"6 de julio de 1997"
15,19,105,5053,700,788,1488,"6 de julio de 1997"
15,19,105,5054,698,721,1419,"6 de julio de 1997"
15,19,105,5055,803,874,1677,"6 de julio de 1997"
15,19,105,5056,824,898,1722,"6 de julio de 1997"
15,19,105,5057,688,739,1427,"6 de julio de 1997"
15,19,105,5058,357,384,741,"6 de julio de 1997"
15,19,105,5059,796,917,1713,"6 de julio de 1997"
15,19,105,5060,575,669,1244,"6 de julio de 1997"
15,19,105,5061,764,829,1593,"6 de julio de 1997"
15,19,105,5062,544,557,1101,"6 de julio de 1997"
15,19,105,5063,639,660,1299,"6 de julio de 1997"
15,19,105,5064,731,805,1536,"6 de julio de 1997"
15,19,105,5065,692,762,1454,"6 de julio de 1997"
15,19,105,5066,837,894,1731,"6 de julio de 1997"
15,19,105,5067,721,805,1526,"6 de julio de 1997"
15,19,105,5068,803,875,1678,"6 de julio de 1997"
15,19,105,5069,641,757,1398,"6 de julio de 1997"
15,19,105,5070,699,743,1442,"6 de julio de 1997"
15,19,105,5071,467,540,1007,"6 de julio de 1997"
15,19,105,5072,674,808,1482,"6 de julio de 1997"
15,19,105,5073,619,804,1423,"6 de julio de 1997"
15,19,105,5074,484,537,1021,"6 de julio de 1997"
15,19,105,5075,444,525,969,"6 de julio de 1997"
15,19,105,5076,857,876,1733,"6 de julio de 1997"
15,19,105,5077,703,799,1502,"6 de julio de 1997"
15,19,105,5078,727,761,1488,"6 de julio de 1997"
15,19,105,5079,878,917,1795,"6 de julio de 1997"
15,19,105,5080,439,539,978,"6 de julio de 1997"
15,19,105,5081,477,475,952,"6 de julio de 1997"
15,19,105,5082,435,437,872,"6 de julio de 1997"
15,19,105,5083,498,536,1034,"6 de julio de 1997"
15,19,105,5084,484,488,972,"6 de julio de 1997"
15,19,105,5085,502,520,1022,"6 de julio de 1997"
15,19,105,5086,394,432,826,"6 de julio de 1997"
15,19,105,5087,461,584,1045,"6 de julio de 1997"
15,19,105,5088,594,681,1275,"6 de julio de 1997"
15,19,105,5089,572,571,1143,"6 de julio de 1997"
15,19,105,5090,726,773,1499,"6 de julio de 1997"
15,19,105,5091,584,629,1213,"6 de julio de 1997"
15,20,60,3107,550,645,1195,"6 de julio de 1997"
15,20,60,3108,667,815,1482,"6 de julio de 1997"
15,20,60,3109,598,723,1321,"6 de julio de 1997"
15,20,60,3110,615,716,1331,"6 de julio de 1997"
15,20,60,3111,591,744,1335,"6 de julio de 1997"
15,20,60,3112,552,619,1171,"6 de julio de 1997"
15,20,60,3113,472,584,1056,"6 de julio de 1997"
15,20,60,3114,621,758,1379,"6 de julio de 1997"
15,20,60,3115,628,705,1333,"6 de julio de 1997"
15,20,60,3116,706,830,1536,"6 de julio de 1997"
15,20,60,3117,645,729,1374,"6 de julio de 1997"
15,20,60,3118,443,538,981,"6 de julio de 1997"
15,20,60,3119,403,447,850,"6 de julio de 1997"
15,20,60,3120,506,551,1057,"6 de julio de 1997"
15,20,60,3121,706,789,1495,"6 de julio de 1997"
15,20,60,3122,680,755,1435,"6 de julio de 1997"
15,20,60,3123,615,772,1387,"6 de julio de 1997"
15,20,60,3124,595,693,1288,"6 de julio de 1997"
15,20,60,3125,531,592,1123,"6 de julio de 1997"
15,20,60,3126,400,461,861,"6 de julio de 1997"
15,20,60,3127,493,529,1022,"6 de julio de 1997"
15,20,60,3128,454,558,1012,"6 de julio de 1997"
15,20,60,3129,698,796,1494,"6 de julio de 1997"
15,20,60,3130,584,649,1233,"6 de julio de 1997"
15,20,60,3131,437,497,934,"6 de julio de 1997"
15,20,60,3132,402,447,849,"6 de julio de 1997"
15,20,60,3133,290,352,642,"6 de julio de 1997"
15,20,60,3134,493,523,1016,"6 de julio de 1997"
15,20,60,3135,389,480,869,"6 de julio de 1997"
15,20,60,3136,479,528,1007,"6 de julio de 1997"
15,20,60,3137,392,480,872,"6 de julio de 1997"
15,20,60,3138,399,468,867,"6 de julio de 1997"
15,20,60,3139,870,947,1817,"6 de julio de 1997"
15,20,60,3140,579,627,1206,"6 de julio de 1997"
15,20,60,3141,610,641,1251,"6 de julio de 1997"
15,20,60,3142,403,460,863,"6 de julio de 1997"
15,20,60,3143,486,528,1014,"6 de julio de 1997"
15,20,60,3144,609,660,1269,"6 de julio de 1997"
15,20,60,3145,353,443,796,"6 de julio de 1997"
15,20,60,3146,339,375,714,"6 de julio de 1997"
15,20,60,3147,285,326,611,"6 de julio de 1997"
15,20,60,3148,263,321,584,"6 de julio de 1997"
15,20,60,3149,437,514,951,"6 de julio de 1997"
15,20,60,3150,221,268,489,"6 de julio de 1997"
15,20,60,3151,628,749,1377,"6 de julio de 1997"
15,20,60,3152,436,517,953,"6 de julio de 1997"
15,20,60,3153,526,577,1103,"6 de julio de 1997"
15,20,60,3154,556,603,1159,"6 de julio de 1997"
15,20,60,3155,521,535,1056,"6 de julio de 1997"
15,20,60,3156,458,498,956,"6 de julio de 1997"
15,20,60,3157,737,804,1541,"6 de julio de 1997"
15,20,60,3158,488,553,1041,"6 de julio de 1997"
15,20,60,3159,827,829,1656,"6 de julio de 1997"
15,20,60,3160,603,611,1214,"6 de julio de 1997"
15,20,60,3161,454,493,947,"6 de julio de 1997"
15,20,60,3162,935,964,1899,"6 de julio de 1997"
15,20,60,3163,716,758,1474,"6 de julio de 1997"
15,20,60,3164,592,633,1225,"6 de julio de 1997"
15,20,60,3165,483,489,972,"6 de julio de 1997"
15,20,60,3166,669,704,1373,"6 de julio de 1997"
15,20,60,3167,938,1017,1955,"6 de julio de 1997"
15,20,60,3168,499,520,1019,"6 de julio de 1997"
15,20,60,3169,844,869,1713,"6 de julio de 1997"
15,20,60,3170,485,496,981,"6 de julio de 1997"
15,20,60,3171,644,718,1362,"6 de julio de 1997"
15,20,60,3172,570,651,1221,"6 de julio de 1997"
15,20,60,3173,455,515,970,"6 de julio de 1997"
15,20,60,3174,645,655,1300,"6 de julio de 1997"
15,20,60,3175,706,768,1474,"6 de julio de 1997"
15,20,60,3176,466,523,989,"6 de julio de 1997"
15,20,60,3177,795,825,1620,"6 de julio de 1997"
15,20,60,3178,659,664,1323,"6 de julio de 1997"
15,20,60,3179,437,478,915,"6 de julio de 1997"
15,20,60,3180,631,694,1325,"6 de julio de 1997"
15,20,60,3181,454,519,973,"6 de julio de 1997"
15,20,60,3182,675,741,1416,"6 de julio de 1997"
15,20,60,3183,571,638,1209,"6 de julio de 1997"
15,20,60,3184,576,606,1182,"6 de julio de 1997"
15,20,60,3185,573,594,1167,"6 de julio de 1997"
15,20,60,3186,558,600,1158,"6 de julio de 1997"
15,20,60,3194,520,579,1099,"6 de julio de 1997"
15,20,60,3195,460,546,1006,"6 de julio de 1997"
15,20,60,3196,1133,1350,2483,"6 de julio de 1997"
15,20,60,3197,338,391,729,"6 de julio de 1997"
15,20,60,3198,485,653,1138,"6 de julio de 1997"
15,20,60,3199,536,665,1201,"6 de julio de 1997"
15,20,60,3200,278,317,595,"6 de julio de 1997"
15,20,60,3201,320,384,704,"6 de julio de 1997"
15,20,60,3202,499,641,1140,"6 de julio de 1997"
15,20,60,3203,555,678,1233,"6 de julio de 1997"
15,20,60,3204,545,690,1235,"6 de julio de 1997"
15,20,60,3205,515,641,1156,"6 de julio de 1997"
15,20,60,3206,576,678,1254,"6 de julio de 1997"
15,20,60,3207,431,544,975,"6 de julio de 1997"
15,20,60,3208,326,364,690,"6 de julio de 1997"
15,20,60,3209,440,445,885,"6 de julio de 1997"
15,20,60,3210,637,738,1375,"6 de julio de 1997"
15,20,60,3211,251,280,531,"6 de julio de 1997"
15,20,60,3212,592,695,1287,"6 de julio de 1997"
15,20,60,3213,681,849,1530,"6 de julio de 1997"
15,20,60,3214,578,682,1260,"6 de julio de 1997"
15,20,60,3215,415,505,920,"6 de julio de 1997"
15,20,60,3216,376,491,867,"6 de julio de 1997"
15,20,60,3217,686,880,1566,"6 de julio de 1997"
15,20,60,3218,671,754,1425,"6 de julio de 1997"
15,20,60,3219,451,528,979,"6 de julio de 1997"
15,20,60,3220,773,909,1682,"6 de julio de 1997"
15,20,60,3221,775,816,1591,"6 de julio de 1997"
15,20,60,3222,805,901,1706,"6 de julio de 1997"
15,20,60,3223,726,773,1499,"6 de julio de 1997"
15,20,60,3224,636,740,1376,"6 de julio de 1997"
15,20,60,3225,583,637,1220,"6 de julio de 1997"
15,20,60,3226,849,921,1770,"6 de julio de 1997"
15,20,60,3227,749,782,1531,"6 de julio de 1997"
15,20,60,3228,574,605,1179,"6 de julio de 1997"
15,20,60,3229,758,857,1615,"6 de julio de 1997"
15,20,60,3230,267,345,612,"6 de julio de 1997"
15,20,60,3231,643,692,1335,"6 de julio de 1997"
15,20,60,3232,985,1074,2059,"6 de julio de 1997"
15,20,60,3233,944,966,1910,"6 de julio de 1997"
15,20,60,3234,934,962,1896,"6 de julio de 1997"
15,20,60,3235,710,757,1467,"6 de julio de 1997"
15,20,60,3236,669,710,1379,"6 de julio de 1997"
15,20,60,3237,685,657,1342,"6 de julio de 1997"
15,20,60,3238,540,622,1162,"6 de julio de 1997"
15,20,60,3239,744,785,1529,"6 de julio de 1997"
15,20,60,3240,810,916,1726,"6 de julio de 1997"
15,20,60,3241,789,834,1623,"6 de julio de 1997"
15,20,60,3242,716,761,1477,"6 de julio de 1997"
15,20,60,3243,656,688,1344,"6 de julio de 1997"
15,20,60,3244,794,902,1696,"6 de julio de 1997"
15,20,60,3245,734,823,1557,"6 de julio de 1997"
15,20,60,3246,802,838,1640,"6 de julio de 1997"
15,20,60,3247,701,750,1451,"6 de julio de 1997"
15,20,60,3248,586,601,1187,"6 de julio de 1997"
15,20,60,3282,482,496,978,"6 de julio de 1997"
15,20,60,3283,385,408,793,"6 de julio de 1997"
15,20,60,3287,767,785,1552,"6 de julio de 1997"
15,20,60,3288,723,746,1469,"6 de julio de 1997"
15,21,58,2572,477,511,988,"6 de julio de 1997"
15,21,58,2574,487,600,1087,"6 de julio de 1997"
15,21,58,2575,491,635,1126,"6 de julio de 1997"
15,21,58,2576,626,734,1360,"6 de julio de 1997"
15,21,58,2723,451,555,1006,"6 de julio de 1997"
15,21,58,2724,508,605,1113,"6 de julio de 1997"
15,21,58,2725,366,442,808,"6 de julio de 1997"
15,21,58,2726,260,310,570,"6 de julio de 1997"
15,21,58,2727,362,426,788,"6 de julio de 1997"
15,21,58,2728,422,463,885,"6 de julio de 1997"
15,21,58,2729,490,574,1064,"6 de julio de 1997"
15,21,58,2730,532,654,1186,"6 de julio de 1997"
15,21,58,2731,403,520,923,"6 de julio de 1997"
15,21,58,2732,364,472,836,"6 de julio de 1997"
15,21,58,2733,366,459,825,"6 de julio de 1997"
15,21,58,2734,633,807,1440,"6 de julio de 1997"
15,21,58,2735,383,468,851,"6 de julio de 1997"
15,21,58,2736,629,813,1442,"6 de julio de 1997"
15,21,58,2737,816,1075,1891,"6 de julio de 1997"
15,21,58,2738,498,625,1123,"6 de julio de 1997"
15,21,58,2739,564,622,1186,"6 de julio de 1997"
15,21,58,2740,560,691,1251,"6 de julio de 1997"
15,21,58,2741,644,774,1418,"6 de julio de 1997"
15,21,58,2742,775,947,1722,"6 de julio de 1997"
15,21,58,2743,466,582,1048,"6 de julio de 1997"
15,21,58,2744,501,629,1130,"6 de julio de 1997"
15,21,58,2745,350,452,802,"6 de julio de 1997"
15,21,58,2746,419,523,942,"6 de julio de 1997"
15,21,58,2747,519,598,1117,"6 de julio de 1997"
15,21,58,2748,307,374,681,"6 de julio de 1997"
15,21,58,2749,500,567,1067,"6 de julio de 1997"
15,21,58,2750,131,155,286,"6 de julio de 1997"
15,21,58,2751,347,385,732,"6 de julio de 1997"
15,21,58,2752,189,208,397,"6 de julio de 1997"
15,21,58,2753,605,693,1298,"6 de julio de 1997"
15,21,58,2754,367,456,823,"6 de julio de 1997"
15,21,58,2755,459,515,974,"6 de julio de 1997"
15,21,58,2756,413,484,897,"6 de julio de 1997"
15,21,58,2757,297,339,636,"6 de julio de 1997"
15,21,58,2758,624,752,1376,"6 de julio de 1997"
15,21,58,2759,621,787,1408,"6 de julio de 1997"
15,21,58,2760,678,785,1463,"6 de julio de 1997"
15,21,58,2761,1033,1107,2140,"6 de julio de 1997"
15,21,58,2762,769,847,1616,"6 de julio de 1997"
15,21,58,2763,676,732,1408,"6 de julio de 1997"
15,21,58,2764,577,650,1227,"6 de julio de 1997"
15,21,58,2765,501,522,1023,"6 de julio de 1997"
15,21,58,2766,418,445,863,"6 de julio de 1997"
15,21,58,2767,465,496,961,"6 de julio de 1997"
15,21,58,2768,857,994,1851,"6 de julio de 1997"
15,21,58,2769,848,1001,1849,"6 de julio de 1997"
15,21,58,2770,702,718,1420,"6 de julio de 1997"
15,21,58,2771,431,486,917,"6 de julio de 1997"
15,21,58,2772,599,636,1235,"6 de julio de 1997"
15,21,58,2773,845,851,1696,"6 de julio de 1997"
15,21,58,2774,657,723,1380,"6 de julio de 1997"
15,21,58,2775,677,759,1436,"6 de julio de 1997"
15,21,58,2776,615,694,1309,"6 de julio de 1997"
15,21,58,2777,603,661,1264,"6 de julio de 1997"
15,21,58,2778,606,681,1287,"6 de julio de 1997"
15,21,58,2779,438,522,960,"6 de julio de 1997"
15,21,58,2780,557,628,1185,"6 de julio de 1997"
15,21,58,2781,500,572,1072,"6 de julio de 1997"
15,21,58,2782,654,833,1487,"6 de julio de 1997"
15,21,58,2783,617,787,1404,"6 de julio de 1997"
15,21,58,2784,457,566,1023,"6 de julio de 1997"
15,21,58,2785,466,573,1039,"6 de julio de 1997"
15,21,58,2786,401,493,894,"6 de julio de 1997"
15,21,58,2787,374,449,823,"6 de julio de 1997"
15,21,58,2788,447,559,1006,"6 de julio de 1997"
15,21,58,2789,327,350,677,"6 de julio de 1997"
15,21,58,2790,488,653,1141,"6 de julio de 1997"
15,21,58,2791,295,398,693,"6 de julio de 1997"
15,21,58,2792,388,510,898,"6 de julio de 1997"
15,21,58,2793,676,791,1467,"6 de julio de 1997"
15,21,58,2794,149,171,320,"6 de julio de 1997"
15,21,58,2795,437,475,912,"6 de julio de 1997"
15,21,58,2796,625,756,1381,"6 de julio de 1997"
15,21,58,2797,613,769,1382,"6 de julio de 1997"
15,21,58,2798,286,344,630,"6 de julio de 1997"
15,21,58,2799,388,480,868,"6 de julio de 1997"
15,21,58,2800,294,350,644,"6 de julio de 1997"
15,21,58,2801,580,655,1235,"6 de julio de 1997"
15,21,58,2802,498,528,1026,"6 de julio de 1997"
15,21,58,2803,604,657,1261,"6 de julio de 1997"
15,21,58,2804,568,621,1189,"6 de julio de 1997"
15,21,58,2805,1183,1352,2535,"6 de julio de 1997"
15,21,58,2806,399,465,864,"6 de julio de 1997"
15,21,58,2807,499,629,1128,"6 de julio de 1997"
15,21,58,2808,476,581,1057,"6 de julio de 1997"
15,21,58,2809,601,712,1313,"6 de julio de 1997"
15,21,58,2810,673,828,1501,"6 de julio de 1997"
15,21,58,2811,751,841,1592,"6 de julio de 1997"
15,21,58,2812,405,537,942,"6 de julio de 1997"
15,21,58,2813,613,720,1333,"6 de julio de 1997"
15,21,58,2814,587,798,1385,"6 de julio de 1997"
15,21,58,2815,699,858,1557,"6 de julio de 1997"
15,21,58,2816,684,827,1511,"6 de julio de 1997"
15,21,58,2817,545,710,1255,"6 de julio de 1997"
15,21,58,2818,278,351,629,"6 de julio de 1997"
15,21,58,2819,447,534,981,"6 de julio de 1997"
15,21,58,2820,591,612,1203,"6 de julio de 1997"
15,21,58,2821,454,466,920,"6 de julio de 1997"
15,21,58,2822,390,412,802,"6 de julio de 1997"
15,21,58,2823,492,521,1013,"6 de julio de 1997"
15,21,58,2824,430,487,917,"6 de julio de 1997"
15,21,58,2825,478,569,1047,"6 de julio de 1997"
15,21,58,2826,585,753,1338,"6 de julio de 1997"
15,21,58,2827,564,734,1298,"6 de julio de 1997"
15,21,58,2828,380,480,860,"6 de julio de 1997"
15,21,58,2829,372,508,880,"6 de julio de 1997"
15,21,58,2830,582,675,1257,"6 de julio de 1997"
15,21,58,2831,768,948,1716,"6 de julio de 1997"
15,21,58,2832,131,194,325,"6 de julio de 1997"
15,21,58,2833,94,106,200,"6 de julio de 1997"
15,21,58,2834,616,669,1285,"6 de julio de 1997"
15,21,58,2835,589,685,1274,"6 de julio de 1997"
15,21,58,2836,239,313,552,"6 de julio de 1997"
15,21,58,2837,887,940,1827,"6 de julio de 1997"
15,21,58,2838,522,641,1163,"6 de julio de 1997"
15,21,58,2839,777,778,1555,"6 de julio de 1997"
15,21,58,2840,552,661,1213,"6 de julio de 1997"
15,21,58,2841,360,456,816,"6 de julio de 1997"
15,21,58,2842,261,345,606,"6 de julio de 1997"
15,21,58,2843,158,220,378,"6 de julio de 1997"
15,21,58,2844,320,364,684,"6 de julio de 1997"
15,21,58,2845,359,365,724,"6 de julio de 1997"
15,21,58,2846,616,663,1279,"6 de julio de 1997"
15,21,58,2847,342,395,737,"6 de julio de 1997"
15,21,58,2848,249,290,539,"6 de julio de 1997"
15,21,58,2849,274,324,598,"6 de julio de 1997"
15,21,58,2850,317,354,671,"6 de julio de 1997"
15,21,58,2851,417,511,928,"6 de julio de 1997"
15,21,58,2852,311,412,723,"6 de julio de 1997"
15,21,58,2853,355,367,722,"6 de julio de 1997"
15,21,58,2854,868,71,939,"6 de julio de 1997"
15,21,58,2855,296,309,605,"6 de julio de 1997"
15,21,58,2856,659,697,1356,"6 de julio de 1997"
15,21,58,2857,242,282,524,"6 de julio de 1997"
15,21,58,2858,244,253,497,"6 de julio de 1997"
15,21,58,2859,372,400,772,"6 de julio de 1997"
15,21,58,2860,324,323,647,"6 de julio de 1997"
15,21,58,2861,260,267,527,"6 de julio de 1997"
15,21,58,2862,244,257,501,"6 de julio de 1997"
15,21,58,2863,611,644,1255,"6 de julio de 1997"
15,21,58,2864,405,440,845,"6 de julio de 1997"
15,21,58,2865,436,424,860,"6 de julio de 1997"
15,21,58,2866,691,689,1380,"6 de julio de 1997"
15,21,58,2867,600,653,1253,"6 de julio de 1997"
15,21,58,2868,254,268,522,"6 de julio de 1997"
15,21,58,2887,183,231,414,"6 de julio de 1997"
15,21,58,2888,721,753,1474,"6 de julio de 1997"
15,21,58,2889,879,1019,1898,"6 de julio de 1997"
15,21,58,2890,643,678,1321,"6 de julio de 1997"
15,21,58,2891,421,484,905,"6 de julio de 1997"
15,21,58,2892,455,456,911,"6 de julio de 1997"
15,21,58,2893,490,538,1028,"6 de julio de 1997"
15,21,58,2894,494,590,1084,"6 de julio de 1997"
15,21,58,2895,654,812,1466,"6 de julio de 1997"
15,21,58,2896,675,784,1459,"6 de julio de 1997"
15,21,58,3000,739,824,1563,"6 de julio de 1997"
15,21,58,3001,462,496,958,"6 de julio de 1997"
15,21,58,3002,465,453,918,"6 de julio de 1997"
15,21,58,3003,591,618,1209,"6 de julio de 1997"
15,21,58,3033,315,338,653,"6 de julio de 1997"
15,21,58,3034,296,287,583,"6 de julio de 1997"
15,21,58,3035,1116,1204,2320,"6 de julio de 1997"
15,22,58,2573,429,522,951,"6 de julio de 1997"
15,22,58,2577,474,555,1029,"6 de julio de 1997"
15,22,58,2578,438,504,942,"6 de julio de 1997"
15,22,58,2579,473,560,1033,"6 de julio de 1997"
15,22,58,2580,420,543,963,"6 de julio de 1997"
15,22,58,2581,407,510,917,"6 de julio de 1997"
15,22,58,2582,575,678,1253,"6 de julio de 1997"
15,22,58,2583,587,649,1236,"6 de julio de 1997"
15,22,58,2584,503,556,1059,"6 de julio de 1997"
15,22,58,2585,343,376,719,"6 de julio de 1997"
15,22,58,2586,263,313,576,"6 de julio de 1997"
15,22,58,2587,587,586,1173,"6 de julio de 1997"
15,22,58,2588,622,649,1271,"6 de julio de 1997"
15,22,58,2589,513,593,1106,"6 de julio de 1997"
15,22,58,2590,481,578,1059,"6 de julio de 1997"
15,22,58,2591,420,510,930,"6 de julio de 1997"
15,22,58,2592,466,522,988,"6 de julio de 1997"
15,22,58,2593,528,550,1078,"6 de julio de 1997"
15,22,58,2594,461,487,948,"6 de julio de 1997"
15,22,58,2595,772,839,1611,"6 de julio de 1997"
15,22,58,2596,528,624,1152,"6 de julio de 1997"
15,22,58,2597,315,309,624,"6 de julio de 1997"
15,22,58,2598,222,256,478,"6 de julio de 1997"
15,22,58,2599,404,451,855,"6 de julio de 1997"
15,22,58,2600,342,419,761,"6 de julio de 1997"
15,22,58,2601,541,572,1113,"6 de julio de 1997"
15,22,58,2602,500,532,1032,"6 de julio de 1997"
15,22,58,2603,697,774,1471,"6 de julio de 1997"
15,22,58,2604,524,546,1070,"6 de julio de 1997"
15,22,58,2605,484,483,967,"6 de julio de 1997"
15,22,58,2606,767,773,1540,"6 de julio de 1997"
15,22,58,2607,536,616,1152,"6 de julio de 1997"
15,22,58,2608,673,736,1409,"6 de julio de 1997"
15,22,58,2609,592,602,1194,"6 de julio de 1997"
15,22,58,2616,457,506,963,"6 de julio de 1997"
15,22,58,2617,436,454,890,"6 de julio de 1997"
15,22,58,2618,547,657,1204,"6 de julio de 1997"
15,22,58,2628,441,464,905,"6 de julio de 1997"
15,22,58,2629,755,796,1551,"6 de julio de 1997"
15,22,58,2630,455,473,928,"6 de julio de 1997"
15,22,58,2631,506,522,1028,"6 de julio de 1997"
15,22,58,2632,509,544,1053,"6 de julio de 1997"
15,22,58,2667,730,778,1508,"6 de julio de 1997"
15,22,58,2668,656,702,1358,"6 de julio de 1997"
15,22,58,2669,816,840,1656,"6 de julio de 1997"
15,22,58,2678,1106,1206,2312,"6 de julio de 1997"
15,22,58,2679,881,904,1785,"6 de julio de 1997"
15,22,58,2680,887,948,1835,"6 de julio de 1997"
15,22,58,2681,830,868,1698,"6 de julio de 1997"
15,22,58,2682,844,852,1696,"6 de julio de 1997"
15,22,58,2683,783,851,1634,"6 de julio de 1997"
15,22,58,2684,258,255,513,"6 de julio de 1997"
15,22,58,2685,358,372,730,"6 de julio de 1997"
15,22,58,2686,751,874,1625,"6 de julio de 1997"
15,22,58,2687,740,875,1615,"6 de julio de 1997"
15,22,58,2688,481,562,1043,"6 de julio de 1997"
15,22,58,2689,486,485,971,"6 de julio de 1997"
15,22,58,2690,756,993,1749,"6 de julio de 1997"
15,22,58,2691,529,703,1232,"6 de julio de 1997"
15,22,58,2692,444,501,945,"6 de julio de 1997"
15,22,58,2693,231,276,507,"6 de julio de 1997"
15,22,58,2694,416,526,942,"6 de julio de 1997"
15,22,58,2695,443,585,1028,"6 de julio de 1997"
15,22,58,2696,496,657,1153,"6 de julio de 1997"
15,22,58,2697,408,503,911,"6 de julio de 1997"
15,22,58,2698,479,654,1133,"6 de julio de 1997"
15,22,58,2699,309,426,735,"6 de julio de 1997"
15,22,58,2700,546,731,1277,"6 de julio de 1997"
15,22,58,2701,778,802,1580,"6 de julio de 1997"
15,22,58,2702,490,670,1160,"6 de julio de 1997"
15,22,58,2703,383,527,910,"6 de julio de 1997"
15,22,58,2704,319,423,742,"6 de julio de 1997"
15,22,58,2705,651,644,1295,"6 de julio de 1997"
15,22,58,2706,430,541,971,"6 de julio de 1997"
15,22,58,2707,85,214,299,"6 de julio de 1997"
15,22,58,2708,450,707,1157,"6 de julio de 1997"
15,22,58,2709,1343,4,1347,"6 de julio de 1997"
15,22,58,2710,597,5,602,"6 de julio de 1997"
15,22,58,2711,116,206,322,"6 de julio de 1997"
15,22,58,2712,625,1,626,"6 de julio de 1997"
15,22,58,2713,413,0,413,"6 de julio de 1997"
15,22,58,2714,311,0,311,"6 de julio de 1997"
15,22,58,2715,1204,4,1208,"6 de julio de 1997"
15,22,58,2716,113,7,120,"6 de julio de 1997"
15,22,58,2717,443,1,444,"6 de julio de 1997"
15,22,58,2718,170,1,171,"6 de julio de 1997"
15,22,58,2719,1017,43,1060,"6 de julio de 1997"
15,22,58,2720,1314,1,1315,"6 de julio de 1997"
15,22,58,2721,520,1,521,"6 de julio de 1997"
15,22,58,2722,779,4,783,"6 de julio de 1997"
15,22,58,2869,427,454,881,"6 de julio de 1997"
15,22,58,2870,284,323,607,"6 de julio de 1997"
15,22,58,2871,192,274,466,"6 de julio de 1997"
15,22,58,2872,529,542,1071,"6 de julio de 1997"
15,22,58,2873,385,448,833,"6 de julio de 1997"
15,22,58,2874,607,620,1227,"6 de julio de 1997"
15,22,58,2875,465,469,934,"6 de julio de 1997"
15,22,58,2876,216,227,443,"6 de julio de 1997"
15,22,58,2877,414,420,834,"6 de julio de 1997"
15,22,58,2878,468,537,1005,"6 de julio de 1997"
15,22,58,2879,332,377,709,"6 de julio de 1997"
15,22,58,2880,799,880,1679,"6 de julio de 1997"
15,22,58,2881,303,340,643,"6 de julio de 1997"
15,22,58,2882,335,412,747,"6 de julio de 1997"
15,22,58,2883,257,249,506,"6 de julio de 1997"
15,22,58,2884,226,250,476,"6 de julio de 1997"
15,22,58,2886,180,226,406,"6 de julio de 1997"
15,22,58,2897,424,458,882,"6 de julio de 1997"
15,22,58,2898,760,787,1547,"6 de julio de 1997"
15,22,58,2899,694,741,1435,"6 de julio de 1997"
15,22,58,2900,586,631,1217,"6 de julio de 1997"
15,22,58,2901,520,574,1094,"6 de julio de 1997"
15,22,58,2902,830,892,1722,"6 de julio de 1997"
15,22,58,2903,228,275,503,"6 de julio de 1997"
15,22,58,2904,381,414,795,"6 de julio de 1997"
15,22,58,2905,484,487,971,"6 de julio de 1997"
15,22,58,2906,572,632,1204,"6 de julio de 1997"
15,22,58,2907,758,820,1578,"6 de julio de 1997"
15,22,58,2908,1014,1119,2133,"6 de julio de 1997"
15,22,58,2909,835,883,1718,"6 de julio de 1997"
15,22,58,2910,845,902,1747,"6 de julio de 1997"
15,22,58,2911,974,1049,2023,"6 de julio de 1997"
15,22,58,2912,932,1001,1933,"6 de julio de 1997"
15,22,58,2913,907,969,1876,"6 de julio de 1997"
15,22,58,2914,570,611,1181,"6 de julio de 1997"
15,22,58,2915,768,902,1670,"6 de julio de 1997"
15,22,58,2916,687,777,1464,"6 de julio de 1997"
15,22,58,2917,542,575,1117,"6 de julio de 1997"
15,22,58,2918,449,479,928,"6 de julio de 1997"
15,22,58,2919,655,748,1403,"6 de julio de 1997"
15,22,58,2920,202,221,423,"6 de julio de 1997"
15,22,58,2921,844,912,1756,"6 de julio de 1997"
15,22,58,2922,824,915,1739,"6 de julio de 1997"
15,22,58,2923,852,873,1725,"6 de julio de 1997"
15,22,58,2924,828,894,1722,"6 de julio de 1997"
15,22,58,2925,824,892,1716,"6 de julio de 1997"
15,22,58,2926,869,947,1816,"6 de julio de 1997"
15,22,58,2927,882,863,1745,"6 de julio de 1997"
15,22,58,2928,615,624,1239,"6 de julio de 1997"
15,22,58,2929,684,741,1425,"6 de julio de 1997"
15,22,58,2930,426,427,853,"6 de julio de 1997"
15,22,58,2931,365,402,767,"6 de julio de 1997"
15,22,58,2932,721,770,1491,"6 de julio de 1997"
15,22,58,2933,291,330,621,"6 de julio de 1997"
15,22,58,2934,889,906,1795,"6 de julio de 1997"
15,22,58,2935,510,538,1048,"6 de julio de 1997"
15,22,58,2936,684,737,1421,"6 de julio de 1997"
15,22,58,2937,647,659,1306,"6 de julio de 1997"
15,22,58,2938,496,477,973,"6 de julio de 1997"
15,22,58,2939,532,640,1172,"6 de julio de 1997"
15,22,58,2940,792,857,1649,"6 de julio de 1997"
15,22,58,2941,840,863,1703,"6 de julio de 1997"
15,22,58,2942,713,784,1497,"6 de julio de 1997"
15,22,58,2961,788,909,1697,"6 de julio de 1997"
15,22,58,2962,745,827,1572,"6 de julio de 1997"
15,22,58,2963,667,716,1383,"6 de julio de 1997"
15,22,58,3030,527,550,1077,"6 de julio de 1997"
15,22,58,3031,565,615,1180,"6 de julio de 1997"
15,23,7,156,300,337,637,"6 de julio de 1997"
15,23,7,157,304,261,565,"6 de julio de 1997"
15,23,7,158,367,315,682,"6 de julio de 1997"
15,23,7,159,233,205,438,"6 de julio de 1997"
15,23,7,160,664,678,1342,"6 de julio de 1997"
15,23,7,161,561,529,1090,"6 de julio de 1997"
15,23,7,162,512,470,982,"6 de julio de 1997"
15,23,7,163,587,587,1174,"6 de julio de 1997"
15,23,7,164,477,457,934,"6 de julio de 1997"
15,23,7,165,578,518,1096,"6 de julio de 1997"
15,23,33,1286,294,280,574,"6 de julio de 1997"
15,23,33,1287,283,265,548,"6 de julio de 1997"
15,23,33,1288,307,328,635,"6 de julio de 1997"
15,23,33,1289,262,229,491,"6 de julio de 1997"
15,23,33,1290,646,623,1269,"6 de julio de 1997"
15,23,33,1291,147,130,277,"6 de julio de 1997"
15,23,33,1292,416,417,833,"6 de julio de 1997"
15,23,33,1293,403,430,833,"6 de julio de 1997"
15,23,33,1294,399,372,771,"6 de julio de 1997"
15,23,33,1295,336,305,641,"6 de julio de 1997"
15,23,33,1296,376,355,731,"6 de julio de 1997"
15,23,33,1297,326,319,645,"6 de julio de 1997"
15,23,33,1298,383,469,852,"6 de julio de 1997"
15,23,33,1299,301,384,685,"6 de julio de 1997"
15,23,33,1300,681,656,1337,"6 de julio de 1997"
15,23,33,1301,185,178,363,"6 de julio de 1997"
15,23,42,2183,406,400,806,"6 de julio de 1997"
15,23,42,2184,401,338,739,"6 de julio de 1997"
15,23,42,2185,216,218,434,"6 de julio de 1997"
15,23,42,2186,209,174,383,"6 de julio de 1997"
15,23,42,2187,315,282,597,"6 de julio de 1997"
15,23,67,3899,477,458,935,"6 de julio de 1997"
15,23,67,3900,173,166,339,"6 de julio de 1997"
15,23,67,3901,240,218,458,"6 de julio de 1997"
15,23,67,3902,313,302,615,"6 de julio de 1997"
15,23,79,4148,354,406,760,"6 de julio de 1997"
15,23,79,4149,273,297,570,"6 de julio de 1997"
15,23,79,4150,53,59,112,"6 de julio de 1997"
15,23,79,4151,426,406,832,"6 de julio de 1997"
15,23,79,4152,106,90,196,"6 de julio de 1997"
15,23,79,4153,95,85,180,"6 de julio de 1997"
15,23,79,4154,109,79,188,"6 de julio de 1997"
15,23,79,4155,224,205,429,"6 de julio de 1997"
15,23,79,4156,63,61,124,"6 de julio de 1997"
15,23,79,4157,408,451,859,"6 de julio de 1997"
15,23,87,4380,499,565,1064,"6 de julio de 1997"
15,23,87,4381,271,321,592,"6 de julio de 1997"
15,23,87,4382,320,335,655,"6 de julio de 1997"
15,23,87,4383,358,313,671,"6 de julio de 1997"
15,23,87,4384,428,392,820,"6 de julio de 1997"
15,23,87,4385,375,378,753,"6 de julio de 1997"
15,23,87,4386,286,279,565,"6 de julio de 1997"
15,23,87,4387,341,327,668,"6 de julio de 1997"
15,23,87,4388,264,261,525,"6 de julio de 1997"
15,23,87,4389,341,328,669,"6 de julio de 1997"
15,23,87,4390,513,538,1051,"6 de julio de 1997"
15,23,87,4391,221,217,438,"6 de julio de 1997"
15,23,87,4392,185,169,354,"6 de julio de 1997"
15,23,87,4393,333,333,666,"6 de julio de 1997"
15,23,87,4394,490,474,964,"6 de julio de 1997"
15,23,87,4395,423,397,820,"6 de julio de 1997"
15,23,87,4396,131,136,267,"6 de julio de 1997"
15,23,87,4397,184,203,387,"6 de julio de 1997"
15,23,87,4398,82,72,154,"6 de julio de 1997"
15,23,87,4399,121,109,230,"6 de julio de 1997"
15,23,87,4400,110,99,209,"6 de julio de 1997"
15,23,87,4401,189,161,350,"6 de julio de 1997"
15,23,87,4402,151,128,279,"6 de julio de 1997"
15,23,111,5654,353,382,735,"6 de julio de 1997"
15,23,111,5655,945,1024,1969,"6 de julio de 1997"
15,23,111,5656,446,486,932,"6 de julio de 1997"
15,23,111,5657,825,874,1699,"6 de julio de 1997"
15,23,111,5658,788,867,1655,"6 de julio de 1997"
15,23,111,5659,454,532,986,"6 de julio de 1997"
15,23,111,5660,380,407,787,"6 de julio de 1997"
15,23,111,5661,601,673,1274,"6 de julio de 1997"
15,23,111,5662,470,479,949,"6 de julio de 1997"
15,23,111,5663,215,183,398,"6 de julio de 1997"
15,23,111,5664,281,293,574,"6 de julio de 1997"
15,23,111,5665,233,235,468,"6 de julio de 1997"
15,23,111,5666,339,307,646,"6 de julio de 1997"
15,23,111,5667,556,555,1111,"6 de julio de 1997"
15,23,111,5668,201,180,381,"6 de julio de 1997"
15,23,111,5669,584,583,1167,"6 de julio de 1997"
15,23,111,5670,124,117,241,"6 de julio de 1997"
15,23,111,5671,184,185,369,"6 de julio de 1997"
15,23,111,5672,422,415,837,"6 de julio de 1997"
15,23,111,5673,543,511,1054,"6 de julio de 1997"
15,23,111,5674,286,258,544,"6 de julio de 1997"
15,23,111,5675,344,327,671,"6 de julio de 1997"
15,23,111,5676,265,279,544,"6 de julio de 1997"
15,23,111,5677,436,535,971,"6 de julio de 1997"
15,23,111,5678,328,324,652,"6 de julio de 1997"
15,23,111,5679,568,663,1231,"6 de julio de 1997"
15,23,111,5680,670,768,1438,"6 de julio de 1997"
15,23,111,5681,659,705,1364,"6 de julio de 1997"
15,23,112,5682,517,556,1073,"6 de julio de 1997"
15,23,112,5683,393,381,774,"6 de julio de 1997"
15,23,112,5684,454,442,896,"6 de julio de 1997"
15,23,112,5685,391,403,794,"6 de julio de 1997"
15,23,112,5686,125,125,250,"6 de julio de 1997"
15,23,112,5687,354,343,697,"6 de julio de 1997"
15,23,112,5688,727,743,1470,"6 de julio de 1997"
15,23,112,5689,316,353,669,"6 de julio de 1997"
15,23,112,5690,197,218,415,"6 de julio de 1997"
15,23,112,5691,501,517,1018,"6 de julio de 1997"
15,23,112,5692,570,539,1109,"6 de julio de 1997"
15,23,112,5693,231,220,451,"6 de julio de 1997"
15,23,112,5694,278,250,528,"6 de julio de 1997"
15,23,112,5695,407,388,795,"6 de julio de 1997"
15,23,112,5696,451,372,823,"6 de julio de 1997"
15,23,112,5697,584,596,1180,"6 de julio de 1997"
15,23,112,5698,162,146,308,"6 de julio de 1997"
15,23,112,5699,251,249,500,"6 de julio de 1997"
15,23,112,5700,279,263,542,"6 de julio de 1997"
15,23,112,5701,356,345,701,"6 de julio de 1997"
15,23,112,5702,137,133,270,"6 de julio de 1997"
15,23,112,5703,469,430,899,"6 de julio de 1997"
15,23,117,5805,628,566,1194,"6 de julio de 1997"
15,23,117,5806,194,214,408,"6 de julio de 1997"
15,23,119,5822,529,586,1115,"6 de julio de 1997"
15,23,119,5823,419,494,913,"6 de julio de 1997"
15,23,119,5824,466,509,975,"6 de julio de 1997"
15,23,119,5825,494,559,1053,"6 de julio de 1997"
15,23,119,5826,704,728,1432,"6 de julio de 1997"
15,23,119,5827,574,610,1184,"6 de julio de 1997"
15,23,119,5828,778,827,1605,"6 de julio de 1997"
15,23,119,5829,655,721,1376,"6 de julio de 1997"
15,23,119,5830,414,426,840,"6 de julio de 1997"
15,23,119,5831,513,618,1131,"6 de julio de 1997"
15,23,119,5832,377,393,770,"6 de julio de 1997"
15,23,119,5833,373,374,747,"6 de julio de 1997"
15,23,119,5834,984,1051,2035,"6 de julio de 1997"
15,23,119,5835,843,882,1725,"6 de julio de 1997"
15,23,119,5836,1009,971,1980,"6 de julio de 1997"
15,23,119,5837,811,882,1693,"6 de julio de 1997"
15,23,119,5838,710,640,1350,"6 de julio de 1997"
15,23,119,5839,787,790,1577,"6 de julio de 1997"
15,23,119,5840,54,58,112,"6 de julio de 1997"
15,23,119,5841,679,715,1394,"6 de julio de 1997"
15,23,119,5842,474,508,982,"6 de julio de 1997"
15,23,119,5843,193,194,387,"6 de julio de 1997"
15,23,119,5844,262,279,541,"6 de julio de 1997"
15,23,119,5845,325,341,666,"6 de julio de 1997"
15,23,119,5846,245,266,511,"6 de julio de 1997"
15,23,119,5847,977,999,1976,"6 de julio de 1997"
15,23,119,5848,679,701,1380,"6 de julio de 1997"
15,23,119,5849,1058,1117,2175,"6 de julio de 1997"
15,23,119,5850,184,204,388,"6 de julio de 1997"
15,23,119,5851,743,783,1526,"6 de julio de 1997"
15,23,119,5852,475,484,959,"6 de julio de 1997"
15,23,119,5853,798,858,1656,"6 de julio de 1997"
15,23,119,5854,443,494,937,"6 de julio de 1997"
15,23,119,5855,688,785,1473,"6 de julio de 1997"
15,23,119,5856,632,675,1307,"6 de julio de 1997"
15,23,119,5857,779,822,1601,"6 de julio de 1997"
15,23,119,5858,601,616,1217,"6 de julio de 1997"
15,23,119,5859,781,802,1583,"6 de julio de 1997"
15,23,119,5860,921,968,1889,"6 de julio de 1997"
15,23,119,5861,685,715,1400,"6 de julio de 1997"
15,23,119,5862,593,619,1212,"6 de julio de 1997"
15,23,119,5863,333,327,660,"6 de julio de 1997"
15,23,119,5864,377,401,778,"6 de julio de 1997"
15,23,119,5865,131,98,229,"6 de julio de 1997"
15,23,119,5866,132,104,236,"6 de julio de 1997"
15,23,119,5867,109,102,211,"6 de julio de 1997"
15,23,119,5868,123,105,228,"6 de julio de 1997"
15,24,58,2610,655,657,1312,"6 de julio de 1997"
15,24,58,2611,529,573,1102,"6 de julio de 1997"
15,24,58,2612,334,369,703,"6 de julio de 1997"
15,24,58,2613,530,616,1146,"6 de julio de 1997"
15,24,58,2614,319,420,739,"6 de julio de 1997"
15,24,58,2615,663,711,1374,"6 de julio de 1997"
15,24,58,2619,602,638,1240,"6 de julio de 1997"
15,24,58,2620,581,614,1195,"6 de julio de 1997"
15,24,58,2621,699,739,1438,"6 de julio de 1997"
15,24,58,2622,510,527,1037,"6 de julio de 1997"
15,24,58,2623,466,521,987,"6 de julio de 1997"
15,24,58,2624,399,384,783,"6 de julio de 1997"
15,24,58,2625,610,707,1317,"6 de julio de 1997"
15,24,58,2626,532,552,1084,"6 de julio de 1997"
15,24,58,2627,545,607,1152,"6 de julio de 1997"
15,24,58,2633,349,395,744,"6 de julio de 1997"
15,24,58,2634,688,778,1466,"6 de julio de 1997"
15,24,58,2635,667,716,1383,"6 de julio de 1997"
15,24,58,2636,833,861,1694,"6 de julio de 1997"
15,24,58,2637,720,770,1490,"6 de julio de 1997"
15,24,58,2638,823,872,1695,"6 de julio de 1997"
15,24,58,2639,729,777,1506,"6 de julio de 1997"
15,24,58,2640,848,966,1814,"6 de julio de 1997"
15,24,58,2641,743,817,1560,"6 de julio de 1997"
15,24,58,2642,735,782,1517,"6 de julio de 1997"
15,24,58,2643,717,728,1445,"6 de julio de 1997"
15,24,58,2644,668,723,1391,"6 de julio de 1997"
15,24,58,2645,859,900,1759,"6 de julio de 1997"
15,24,58,2646,581,586,1167,"6 de julio de 1997"
15,24,58,2647,859,877,1736,"6 de julio de 1997"
15,24,58,2648,697,725,1422,"6 de julio de 1997"
15,24,58,2649,986,1029,2015,"6 de julio de 1997"
15,24,58,2650,1028,1127,2155,"6 de julio de 1997"
15,24,58,2651,541,573,1114,"6 de julio de 1997"
15,24,58,2652,552,609,1161,"6 de julio de 1997"
15,24,58,2653,668,738,1406,"6 de julio de 1997"
15,24,58,2654,722,715,1437,"6 de julio de 1997"
15,24,58,2655,608,685,1293,"6 de julio de 1997"
15,24,58,2656,915,992,1907,"6 de julio de 1997"
15,24,58,2657,743,755,1498,"6 de julio de 1997"
15,24,58,2658,845,895,1740,"6 de julio de 1997"
15,24,58,2659,525,540,1065,"6 de julio de 1997"
15,24,58,2660,426,456,882,"6 de julio de 1997"
15,24,58,2661,829,864,1693,"6 de julio de 1997"
15,24,58,2662,902,953,1855,"6 de julio de 1997"
15,24,58,2663,527,634,1161,"6 de julio de 1997"
15,24,58,2664,774,859,1633,"6 de julio de 1997"
15,24,58,2665,653,669,1322,"6 de julio de 1997"
15,24,58,2666,650,777,1427,"6 de julio de 1997"
15,24,58,2670,599,673,1272,"6 de julio de 1997"
15,24,58,2671,444,454,898,"6 de julio de 1997"
15,24,58,2672,624,695,1319,"6 de julio de 1997"
15,24,58,2673,541,609,1150,"6 de julio de 1997"
15,24,58,2674,560,613,1173,"6 de julio de 1997"
15,24,58,2675,803,864,1667,"6 de julio de 1997"
15,24,58,2676,881,909,1790,"6 de julio de 1997"
15,24,58,2677,735,758,1493,"6 de julio de 1997"
15,24,58,2885,300,288,588,"6 de julio de 1997"
15,24,58,2943,388,397,785,"6 de julio de 1997"
15,24,58,2944,604,627,1231,"6 de julio de 1997"
15,24,58,2945,519,540,1059,"6 de julio de 1997"
15,24,58,2946,336,405,741,"6 de julio de 1997"
15,24,58,2947,446,446,892,"6 de julio de 1997"
15,24,58,2948,458,498,956,"6 de julio de 1997"
15,24,58,2949,687,750,1437,"6 de julio de 1997"
15,24,58,2950,517,526,1043,"6 de julio de 1997"
15,24,58,2951,650,643,1293,"6 de julio de 1997"
15,24,58,2952,417,451,868,"6 de julio de 1997"
15,24,58,2953,712,716,1428,"6 de julio de 1997"
15,24,58,2954,511,569,1080,"6 de julio de 1997"
15,24,58,2955,521,555,1076,"6 de julio de 1997"
15,24,58,2956,617,676,1293,"6 de julio de 1997"
15,24,58,2957,543,588,1131,"6 de julio de 1997"
15,24,58,2958,903,1036,1939,"6 de julio de 1997"
15,24,58,2959,824,875,1699,"6 de julio de 1997"
15,24,58,2960,759,834,1593,"6 de julio de 1997"
15,24,58,2964,574,598,1172,"6 de julio de 1997"
15,24,58,2965,505,532,1037,"6 de julio de 1997"
15,24,58,2966,730,819,1549,"6 de julio de 1997"
15,24,58,2967,758,825,1583,"6 de julio de 1997"
15,24,58,2968,791,887,1678,"6 de julio de 1997"
15,24,58,2969,865,1004,1869,"6 de julio de 1997"
15,24,58,2970,541,616,1157,"6 de julio de 1997"
15,24,58,2971,738,791,1529,"6 de julio de 1997"
15,24,58,2972,596,619,1215,"6 de julio de 1997"
15,24,58,2973,514,576,1090,"6 de julio de 1997"
15,24,58,2974,495,512,1007,"6 de julio de 1997"
15,24,58,2975,639,714,1353,"6 de julio de 1997"
15,24,58,2976,637,673,1310,"6 de julio de 1997"
15,24,58,2977,600,594,1194,"6 de julio de 1997"
15,24,58,2978,788,890,1678,"6 de julio de 1997"
15,24,58,2979,757,780,1537,"6 de julio de 1997"
15,24,58,2980,752,738,1490,"6 de julio de 1997"
15,24,58,2981,564,593,1157,"6 de julio de 1997"
15,24,58,2982,425,438,863,"6 de julio de 1997"
15,24,58,2983,478,561,1039,"6 de julio de 1997"
15,24,58,2984,466,485,951,"6 de julio de 1997"
15,24,58,2985,413,458,871,"6 de julio de 1997"
15,24,58,2986,494,507,1001,"6 de julio de 1997"
15,24,58,2987,561,585,1146,"6 de julio de 1997"
15,24,58,2988,493,539,1032,"6 de julio de 1997"
15,24,58,2989,702,729,1431,"6 de julio de 1997"
15,24,58,2990,555,634,1189,"6 de julio de 1997"
15,24,58,2991,458,514,972,"6 de julio de 1997"
15,24,58,2992,778,783,1561,"6 de julio de 1997"
15,24,58,2993,487,528,1015,"6 de julio de 1997"
15,24,58,2994,840,931,1771,"6 de julio de 1997"
15,24,58,2995,724,818,1542,"6 de julio de 1997"
15,24,58,2996,576,592,1168,"6 de julio de 1997"
15,24,58,2997,580,617,1197,"6 de julio de 1997"
15,24,58,2998,556,592,1148,"6 de julio de 1997"
15,24,58,2999,1029,1050,2079,"6 de julio de 1997"
15,24,58,3004,684,750,1434,"6 de julio de 1997"
15,24,58,3005,683,744,1427,"6 de julio de 1997"
15,24,58,3006,719,805,1524,"6 de julio de 1997"
15,24,58,3007,684,774,1458,"6 de julio de 1997"
15,24,58,3008,321,378,699,"6 de julio de 1997"
15,24,58,3009,689,812,1501,"6 de julio de 1997"
15,24,58,3010,462,526,988,"6 de julio de 1997"
15,24,58,3011,588,629,1217,"6 de julio de 1997"
15,24,58,3012,380,396,776,"6 de julio de 1997"
15,24,58,3013,276,262,538,"6 de julio de 1997"
15,24,58,3014,743,799,1542,"6 de julio de 1997"
15,24,58,3015,529,511,1040,"6 de julio de 1997"
15,24,58,3016,689,732,1421,"6 de julio de 1997"
15,24,58,3017,650,695,1345,"6 de julio de 1997"
15,24,58,3018,642,717,1359,"6 de julio de 1997"
15,24,58,3019,498,557,1055,"6 de julio de 1997"
15,24,58,3020,545,554,1099,"6 de julio de 1997"
15,24,58,3021,333,404,737,"6 de julio de 1997"
15,24,58,3022,583,677,1260,"6 de julio de 1997"
15,24,58,3023,417,485,902,"6 de julio de 1997"
15,24,58,3024,298,344,642,"6 de julio de 1997"
15,24,58,3025,528,528,1056,"6 de julio de 1997"
15,24,58,3026,513,554,1067,"6 de julio de 1997"
15,24,58,3027,458,473,931,"6 de julio de 1997"
15,24,58,3028,457,534,991,"6 de julio de 1997"
15,24,58,3029,723,771,1494,"6 de julio de 1997"
15,24,58,3032,563,562,1125,"6 de julio de 1997"
15,25,30,1109,994,1022,2016,"6 de julio de 1997"
15,25,30,1110,680,713,1393,"6 de julio de 1997"
15,25,30,1111,624,702,1326,"6 de julio de 1997"
15,25,30,1112,1183,1219,2402,"6 de julio de 1997"
15,25,30,1113,732,798,1530,"6 de julio de 1997"
15,25,30,1114,661,738,1399,"6 de julio de 1997"
15,25,30,1115,473,527,1000,"6 de julio de 1997"
15,25,30,1116,751,787,1538,"6 de julio de 1997"
15,25,30,1117,502,598,1100,"6 de julio de 1997"
15,25,30,1118,622,694,1316,"6 de julio de 1997"
15,25,30,1119,429,515,944,"6 de julio de 1997"
15,25,30,1120,454,475,929,"6 de julio de 1997"
15,25,30,1121,1147,1292,2439,"6 de julio de 1997"
15,25,30,1122,668,750,1418,"6 de julio de 1997"
15,25,30,1123,589,654,1243,"6 de julio de 1997"
15,25,30,1124,705,772,1477,"6 de julio de 1997"
15,25,30,1125,541,559,1100,"6 de julio de 1997"
15,25,30,1126,590,643,1233,"6 de julio de 1997"
15,25,30,1127,538,604,1142,"6 de julio de 1997"
15,25,30,1128,502,554,1056,"6 de julio de 1997"
15,25,30,1129,469,506,975,"6 de julio de 1997"
15,25,30,1130,636,716,1352,"6 de julio de 1997"
15,25,30,1131,437,506,943,"6 de julio de 1997"
15,25,30,1132,417,476,893,"6 de julio de 1997"
15,25,30,1133,544,623,1167,"6 de julio de 1997"
15,25,30,1134,555,584,1139,"6 de julio de 1997"
15,25,30,1135,446,503,949,"6 de julio de 1997"
15,25,30,1136,617,696,1313,"6 de julio de 1997"
15,25,30,1137,545,599,1144,"6 de julio de 1997"
15,25,30,1138,414,434,848,"6 de julio de 1997"
15,25,30,1139,335,355,690,"6 de julio de 1997"
15,25,30,1140,491,522,1013,"6 de julio de 1997"
15,25,30,1141,784,912,1696,"6 de julio de 1997"
15,25,32,1149,708,819,1527,"6 de julio de 1997"
15,25,32,1150,736,915,1651,"6 de julio de 1997"
15,25,32,1151,655,725,1380,"6 de julio de 1997"
15,25,32,1152,605,676,1281,"6 de julio de 1997"
15,25,32,1153,349,421,770,"6 de julio de 1997"
15,25,32,1154,455,500,955,"6 de julio de 1997"
15,25,32,1155,753,888,1641,"6 de julio de 1997"
15,25,32,1156,374,426,800,"6 de julio de 1997"
15,25,32,1157,383,431,814,"6 de julio de 1997"
15,25,32,1158,427,485,912,"6 de julio de 1997"
15,25,32,1159,464,508,972,"6 de julio de 1997"
15,25,32,1160,730,815,1545,"6 de julio de 1997"
15,25,32,1161,720,864,1584,"6 de julio de 1997"
15,25,32,1162,639,734,1373,"6 de julio de 1997"
15,25,32,1163,656,829,1485,"6 de julio de 1997"
15,25,32,1164,785,979,1764,"6 de julio de 1997"
15,25,32,1165,598,676,1274,"6 de julio de 1997"
15,25,32,1166,634,744,1378,"6 de julio de 1997"
15,25,32,1167,615,703,1318,"6 de julio de 1997"
15,25,32,1168,605,682,1287,"6 de julio de 1997"
15,25,32,1169,639,712,1351,"6 de julio de 1997"
15,25,32,1170,864,978,1842,"6 de julio de 1997"
15,25,32,1171,580,674,1254,"6 de julio de 1997"
15,25,32,1172,575,641,1216,"6 de julio de 1997"
15,25,32,1173,1045,1170,2215,"6 de julio de 1997"
15,25,32,1174,633,708,1341,"6 de julio de 1997"
15,25,32,1175,631,714,1345,"6 de julio de 1997"
15,25,32,1176,637,718,1355,"6 de julio de 1997"
15,25,32,1177,715,791,1506,"6 de julio de 1997"
15,25,32,1178,691,767,1458,"6 de julio de 1997"
15,25,32,1179,626,680,1306,"6 de julio de 1997"
15,25,32,1180,679,819,1498,"6 de julio de 1997"
15,25,32,1181,533,603,1136,"6 de julio de 1997"
15,25,32,1182,551,606,1157,"6 de julio de 1997"
15,25,32,1183,532,634,1166,"6 de julio de 1997"
15,25,32,1184,532,614,1146,"6 de julio de 1997"
15,25,32,1185,580,662,1242,"6 de julio de 1997"
15,25,32,1186,602,662,1264,"6 de julio de 1997"
15,25,32,1187,575,612,1187,"6 de julio de 1997"
15,25,32,1188,477,576,1053,"6 de julio de 1997"
15,25,32,1189,634,685,1319,"6 de julio de 1997"
15,25,32,1190,557,621,1178,"6 de julio de 1997"
15,25,32,1191,652,732,1384,"6 de julio de 1997"
15,25,32,1192,1150,1306,2456,"6 de julio de 1997"
15,25,32,1193,930,1073,2003,"6 de julio de 1997"
15,25,32,1194,937,1106,2043,"6 de julio de 1997"
15,25,32,1195,695,785,1480,"6 de julio de 1997"
15,25,32,1196,566,639,1205,"6 de julio de 1997"
15,25,32,1197,530,632,1162,"6 de julio de 1997"
15,25,32,1198,594,647,1241,"6 de julio de 1997"
15,25,32,1199,590,659,1249,"6 de julio de 1997"
15,25,32,1200,623,718,1341,"6 de julio de 1997"
15,25,32,1201,529,594,1123,"6 de julio de 1997"
15,25,32,1202,478,541,1019,"6 de julio de 1997"
15,25,32,1203,417,486,903,"6 de julio de 1997"
15,25,32,1204,736,825,1561,"6 de julio de 1997"
15,25,32,1205,549,692,1241,"6 de julio de 1997"
15,25,32,1206,494,580,1074,"6 de julio de 1997"
15,25,32,1207,540,617,1157,"6 de julio de 1997"
15,25,32,1208,487,531,1018,"6 de julio de 1997"
15,25,32,1209,951,1017,1968,"6 de julio de 1997"
15,25,32,1210,970,1075,2045,"6 de julio de 1997"
15,25,32,1211,623,711,1334,"6 de julio de 1997"
15,25,32,1212,812,919,1731,"6 de julio de 1997"
15,25,32,1213,753,891,1644,"6 de julio de 1997"
15,25,32,1214,393,404,797,"6 de julio de 1997"
15,25,32,1215,672,688,1360,"6 de julio de 1997"
15,25,32,1216,375,443,818,"6 de julio de 1997"
15,25,32,1217,604,711,1315,"6 de julio de 1997"
15,25,32,1218,1001,1145,2146,"6 de julio de 1997"
15,25,32,1219,850,922,1772,"6 de julio de 1997"
15,25,32,1220,350,425,775,"6 de julio de 1997"
15,25,32,1221,453,568,1021,"6 de julio de 1997"
15,25,32,1222,583,677,1260,"6 de julio de 1997"
15,25,32,1223,632,723,1355,"6 de julio de 1997"
15,25,32,1224,652,714,1366,"6 de julio de 1997"
15,25,32,1225,529,613,1142,"6 de julio de 1997"
15,25,32,1226,357,369,726,"6 de julio de 1997"
15,25,32,1227,659,737,1396,"6 de julio de 1997"
15,25,32,1228,613,669,1282,"6 de julio de 1997"
15,25,32,1229,555,626,1181,"6 de julio de 1997"
15,25,32,1230,676,769,1445,"6 de julio de 1997"
15,25,32,1231,664,703,1367,"6 de julio de 1997"
15,25,32,1232,720,751,1471,"6 de julio de 1997"
15,25,32,1233,670,744,1414,"6 de julio de 1997"
15,25,32,1234,742,771,1513,"6 de julio de 1997"
15,25,32,1235,760,819,1579,"6 de julio de 1997"
15,25,32,1236,929,1038,1967,"6 de julio de 1997"
15,25,32,1237,820,962,1782,"6 de julio de 1997"
15,25,32,1238,490,603,1093,"6 de julio de 1997"
15,25,32,1239,410,458,868,"6 de julio de 1997"
15,25,32,1240,667,756,1423,"6 de julio de 1997"
15,25,32,1241,791,898,1689,"6 de julio de 1997"
15,25,32,1242,518,603,1121,"6 de julio de 1997"
15,25,32,1243,710,768,1478,"6 de julio de 1997"
15,25,32,1244,648,675,1323,"6 de julio de 1997"
15,25,32,1245,661,706,1367,"6 de julio de 1997"
15,25,32,1246,767,862,1629,"6 de julio de 1997"
15,25,32,1247,287,335,622,"6 de julio de 1997"
15,25,32,1248,785,842,1627,"6 de julio de 1997"
15,25,32,1249,712,830,1542,"6 de julio de 1997"
15,25,32,1250,588,734,1322,"6 de julio de 1997"
15,25,32,1251,878,1014,1892,"6 de julio de 1997"
15,25,32,1252,502,554,1056,"6 de julio de 1997"
15,25,32,1253,463,489,952,"6 de julio de 1997"
15,25,32,1254,579,624,1203,"6 de julio de 1997"
15,25,32,1255,845,968,1813,"6 de julio de 1997"
15,25,32,1256,978,1070,2048,"6 de julio de 1997"
15,25,32,1257,692,830,1522,"6 de julio de 1997"
15,25,32,1258,560,623,1183,"6 de julio de 1997"
15,25,32,1259,615,683,1298,"6 de julio de 1997"
15,25,32,1260,522,559,1081,"6 de julio de 1997"
15,25,32,1261,451,489,940,"6 de julio de 1997"
15,25,32,1262,534,591,1125,"6 de julio de 1997"
15,25,32,1263,572,606,1178,"6 de julio de 1997"
15,25,32,1264,561,650,1211,"6 de julio de 1997"
15,25,32,1265,1020,1166,2186,"6 de julio de 1997"
15,25,32,1266,683,770,1453,"6 de julio de 1997"
15,25,32,1267,866,982,1848,"6 de julio de 1997"
15,25,32,1268,1197,1339,2536,"6 de julio de 1997"
15,25,32,1269,1436,1648,3084,"6 de julio de 1997"
15,25,32,1270,426,533,959,"6 de julio de 1997"
15,25,32,1271,328,398,726,"6 de julio de 1997"
15,25,32,1272,402,529,931,"6 de julio de 1997"
15,25,32,1273,426,448,874,"6 de julio de 1997"
15,25,32,1274,478,535,1013,"6 de julio de 1997"
15,25,32,1275,536,720,1256,"6 de julio de 1997"
15,25,32,1276,482,557,1039,"6 de julio de 1997"
15,25,32,1277,2498,3300,5798,"6 de julio de 1997"
15,25,32,1278,372,436,808,"6 de julio de 1997"
15,25,32,1279,357,358,715,"6 de julio de 1997"
15,25,32,1280,538,569,1107,"6 de julio de 1997"
15,25,32,1281,400,451,851,"6 de julio de 1997"
15,25,32,1282,407,406,813,"6 de julio de 1997"
15,25,32,1283,190,218,408,"6 de julio de 1997"
15,25,32,1284,343,393,736,"6 de julio de 1997"
15,25,32,1285,326,350,676,"6 de julio de 1997"
15,26,107,5169,673,807,1480,"6 de julio de 1997"
15,26,107,5170,882,1028,1910,"6 de julio de 1997"
15,26,107,5171,654,798,1452,"6 de julio de 1997"
15,26,107,5172,409,457,866,"6 de julio de 1997"
15,26,107,5173,661,788,1449,"6 de julio de 1997"
15,26,107,5174,753,933,1686,"6 de julio de 1997"
15,26,107,5175,566,751,1317,"6 de julio de 1997"
15,26,107,5176,799,906,1705,"6 de julio de 1997"
15,26,107,5177,620,789,1409,"6 de julio de 1997"
15,26,107,5178,637,748,1385,"6 de julio de 1997"
15,26,107,5179,600,740,1340,"6 de julio de 1997"
15,26,107,5180,697,819,1516,"6 de julio de 1997"
15,26,107,5181,522,637,1159,"6 de julio de 1997"
15,26,107,5182,259,329,588,"6 de julio de 1997"
15,26,107,5183,489,538,1027,"6 de julio de 1997"
15,26,107,5184,663,710,1373,"6 de julio de 1997"
15,26,107,5185,874,1071,1945,"6 de julio de 1997"
15,26,107,5186,777,937,1714,"6 de julio de 1997"
15,26,107,5187,528,584,1112,"6 de julio de 1997"
15,26,107,5188,990,1066,2056,"6 de julio de 1997"
15,26,107,5189,517,638,1155,"6 de julio de 1997"
15,26,107,5190,653,713,1366,"6 de julio de 1997"
15,26,107,5191,678,878,1556,"6 de julio de 1997"
15,26,107,5192,604,729,1333,"6 de julio de 1997"
15,26,107,5193,625,719,1344,"6 de julio de 1997"
15,26,107,5194,255,316,571,"6 de julio de 1997"
15,26,107,5195,100,118,218,"6 de julio de 1997"
15,26,107,5196,170,246,416,"6 de julio de 1997"
15,26,107,5197,206,272,478,"6 de julio de 1997"
15,26,107,5198,668,886,1554,"6 de julio de 1997"
15,26,107,5199,394,505,899,"6 de julio de 1997"
15,26,107,5200,461,582,1043,"6 de julio de 1997"
15,26,107,5201,532,669,1201,"6 de julio de 1997"
15,26,107,5202,503,595,1098,"6 de julio de 1997"
15,26,107,5203,868,1023,1891,"6 de julio de 1997"
15,26,107,5204,71,107,178,"6 de julio de 1997"
15,26,107,5205,382,516,898,"6 de julio de 1997"
15,26,107,5206,447,594,1041,"6 de julio de 1997"
15,26,107,5266,646,738,1384,"6 de julio de 1997"
15,26,107,5267,642,701,1343,"6 de julio de 1997"
15,26,107,5268,515,576,1091,"6 de julio de 1997"
15,26,107,5269,917,1055,1972,"6 de julio de 1997"
15,26,107,5270,556,618,1174,"6 de julio de 1997"
15,26,107,5271,728,840,1568,"6 de julio de 1997"
15,26,107,5272,606,711,1317,"6 de julio de 1997"
15,26,107,5273,240,270,510,"6 de julio de 1997"
15,26,107,5274,832,913,1745,"6 de julio de 1997"
15,26,107,5275,501,568,1069,"6 de julio de 1997"
15,26,107,5276,511,590,1101,"6 de julio de 1997"
15,26,107,5277,635,679,1314,"6 de julio de 1997"
15,26,107,5278,963,1111,2074,"6 de julio de 1997"
15,26,107,5279,399,446,845,"6 de julio de 1997"
15,26,107,5280,225,254,479,"6 de julio de 1997"
15,26,107,5281,196,210,406,"6 de julio de 1997"
15,26,107,5282,306,360,666,"6 de julio de 1997"
15,26,107,5283,636,673,1309,"6 de julio de 1997"
15,26,107,5284,468,568,1036,"6 de julio de 1997"
15,26,107,5285,1080,1243,2323,"6 de julio de 1997"
15,26,107,5286,674,705,1379,"6 de julio de 1997"
15,26,107,5287,863,997,1860,"6 de julio de 1997"
15,26,107,5288,480,575,1055,"6 de julio de 1997"
15,26,107,5289,468,537,1005,"6 de julio de 1997"
15,26,107,5290,478,527,1005,"6 de julio de 1997"
15,26,107,5291,888,978,1866,"6 de julio de 1997"
15,26,107,5292,588,740,1328,"6 de julio de 1997"
15,26,107,5293,700,795,1495,"6 de julio de 1997"
15,26,107,5294,634,686,1320,"6 de julio de 1997"
15,26,107,5295,581,629,1210,"6 de julio de 1997"
15,26,107,5296,765,831,1596,"6 de julio de 1997"
15,26,107,5297,531,605,1136,"6 de julio de 1997"
15,26,107,5299,303,329,632,"6 de julio de 1997"
15,26,107,5300,459,518,977,"6 de julio de 1997"
15,26,107,5301,402,488,890,"6 de julio de 1997"
15,26,107,5302,593,730,1323,"6 de julio de 1997"
15,26,107,5303,1016,1132,2148,"6 de julio de 1997"
15,26,107,5304,751,847,1598,"6 de julio de 1997"
15,26,107,5305,787,921,1708,"6 de julio de 1997"
15,26,107,5306,725,872,1597,"6 de julio de 1997"
15,26,107,5354,772,962,1734,"6 de julio de 1997"
15,26,107,5355,803,863,1666,"6 de julio de 1997"
15,26,107,5356,672,670,1342,"6 de julio de 1997"
15,26,107,5357,233,231,464,"6 de julio de 1997"
15,26,107,5358,379,435,814,"6 de julio de 1997"
15,26,107,5359,583,621,1204,"6 de julio de 1997"
15,26,107,5360,420,437,857,"6 de julio de 1997"
15,26,107,5361,360,378,738,"6 de julio de 1997"
15,26,107,5362,516,532,1048,"6 de julio de 1997"
15,26,107,5363,433,512,945,"6 de julio de 1997"
15,26,107,5364,639,671,1310,"6 de julio de 1997"
15,26,107,5365,292,301,593,"6 de julio de 1997"
15,26,107,5366,649,664,1313,"6 de julio de 1997"
15,26,107,5367,433,483,916,"6 de julio de 1997"
15,26,107,5368,571,554,1125,"6 de julio de 1997"
15,26,107,5369,423,446,869,"6 de julio de 1997"
15,26,107,5370,422,429,851,"6 de julio de 1997"
15,26,107,5371,212,222,434,"6 de julio de 1997"
15,26,107,5372,621,665,1286,"6 de julio de 1997"
15,26,107,5373,483,499,982,"6 de julio de 1997"
15,26,107,5374,449,496,945,"6 de julio de 1997"
15,26,107,5375,641,718,1359,"6 de julio de 1997"
15,26,107,5376,740,783,1523,"6 de julio de 1997"
15,26,107,5377,354,380,734,"6 de julio de 1997"
15,26,107,5378,710,753,1463,"6 de julio de 1997"
15,26,107,5379,614,635,1249,"6 de julio de 1997"
15,26,107,5380,489,515,1004,"6 de julio de 1997"
15,26,107,5381,765,825,1590,"6 de julio de 1997"
15,26,107,5382,611,660,1271,"6 de julio de 1997"
15,26,107,5383,491,574,1065,"6 de julio de 1997"
15,26,107,5384,633,645,1278,"6 de julio de 1997"
15,26,107,5385,313,343,656,"6 de julio de 1997"
15,26,107,5386,527,574,1101,"6 de julio de 1997"
15,26,107,5387,392,420,812,"6 de julio de 1997"
15,26,107,5388,587,618,1205,"6 de julio de 1997"
15,26,107,5389,886,957,1843,"6 de julio de 1997"
15,26,107,5390,702,776,1478,"6 de julio de 1997"
15,26,107,5391,452,490,942,"6 de julio de 1997"
15,26,107,5392,386,426,812,"6 de julio de 1997"
15,26,107,5393,396,409,805,"6 de julio de 1997"
15,26,107,5394,573,586,1159,"6 de julio de 1997"
15,26,107,5395,242,304,546,"6 de julio de 1997"
15,26,107,5396,397,414,811,"6 de julio de 1997"
15,26,107,5397,678,733,1411,"6 de julio de 1997"
15,26,107,5398,752,802,1554,"6 de julio de 1997"
15,26,107,5399,934,1001,1935,"6 de julio de 1997"
15,26,107,5400,688,743,1431,"6 de julio de 1997"
15,26,107,5401,844,893,1737,"6 de julio de 1997"
15,26,107,5402,573,612,1185,"6 de julio de 1997"
15,26,107,5403,538,585,1123,"6 de julio de 1997"
15,26,107,5404,580,667,1247,"6 de julio de 1997"
15,26,107,5405,659,763,1422,"6 de julio de 1997"
15,26,107,5406,648,687,1335,"6 de julio de 1997"
15,26,107,5407,602,656,1258,"6 de julio de 1997"
15,26,107,5408,507,560,1067,"6 de julio de 1997"
15,26,107,5409,374,372,746,"6 de julio de 1997"
15,26,107,5410,486,524,1010,"6 de julio de 1997"
15,26,107,5411,692,730,1422,"6 de julio de 1997"
15,26,107,5412,660,679,1339,"6 de julio de 1997"
15,26,107,5413,339,334,673,"6 de julio de 1997"
15,26,107,5414,931,995,1926,"6 de julio de 1997"
15,26,107,5415,816,924,1740,"6 de julio de 1997"
15,26,107,5416,681,753,1434,"6 de julio de 1997"
15,26,107,5417,549,617,1166,"6 de julio de 1997"
15,26,107,5418,491,531,1022,"6 de julio de 1997"
15,26,107,5439,367,356,723,"6 de julio de 1997"
15,26,107,5441,398,403,801,"6 de julio de 1997"
15,26,107,5442,433,454,887,"6 de julio de 1997"
15,27,52,2386,421,427,848,"6 de julio de 1997"
15,27,52,2387,1014,1148,2162,"6 de julio de 1997"
15,27,52,2388,1101,1229,2330,"6 de julio de 1997"
15,27,52,2389,648,697,1345,"6 de julio de 1997"
15,27,52,2390,650,668,1318,"6 de julio de 1997"
15,27,52,2391,332,378,710,"6 de julio de 1997"
15,27,52,2392,120,117,237,"6 de julio de 1997"
15,27,52,2393,200,220,420,"6 de julio de 1997"
15,27,52,2394,262,261,523,"6 de julio de 1997"
15,27,52,2395,488,464,952,"6 de julio de 1997"
15,27,52,2396,223,234,457,"6 de julio de 1997"
15,27,52,2397,404,394,798,"6 de julio de 1997"
15,27,52,2398,409,414,823,"6 de julio de 1997"
15,27,52,2399,384,403,787,"6 de julio de 1997"
15,27,52,2400,320,313,633,"6 de julio de 1997"
15,27,52,2401,251,241,492,"6 de julio de 1997"
15,27,52,2402,369,371,740,"6 de julio de 1997"
15,27,52,2403,158,169,327,"6 de julio de 1997"
15,27,52,2404,626,683,1309,"6 de julio de 1997"
15,27,52,2405,568,533,1101,"6 de julio de 1997"
15,27,52,2406,290,291,581,"6 de julio de 1997"
15,27,52,2407,334,322,656,"6 de julio de 1997"
15,27,52,2408,446,458,904,"6 de julio de 1997"
15,27,52,2409,480,443,923,"6 de julio de 1997"
15,27,52,2410,80,81,161,"6 de julio de 1997"
15,27,52,2411,458,428,886,"6 de julio de 1997"
15,27,52,2412,475,411,886,"6 de julio de 1997"
15,27,52,2413,768,756,1524,"6 de julio de 1997"
15,27,52,2414,307,300,607,"6 de julio de 1997"
15,27,52,2415,606,585,1191,"6 de julio de 1997"
15,27,52,2416,725,728,1453,"6 de julio de 1997"
15,27,52,2417,807,843,1650,"6 de julio de 1997"
15,27,52,2418,835,815,1650,"6 de julio de 1997"
15,27,52,2419,1063,1064,2127,"6 de julio de 1997"
15,27,52,2420,682,687,1369,"6 de julio de 1997"
15,27,52,2421,629,592,1221,"6 de julio de 1997"
15,27,52,2422,289,313,602,"6 de julio de 1997"
15,27,52,2423,82,75,157,"6 de julio de 1997"
15,27,52,2424,760,809,1569,"6 de julio de 1997"
15,27,52,2425,660,674,1334,"6 de julio de 1997"
15,27,52,2426,427,353,780,"6 de julio de 1997"
15,27,52,2427,667,678,1345,"6 de julio de 1997"
15,27,52,2428,637,615,1252,"6 de julio de 1997"
15,27,52,2429,627,634,1261,"6 de julio de 1997"
15,27,52,2430,229,224,453,"6 de julio de 1997"
15,27,52,2431,224,248,472,"6 de julio de 1997"
15,27,55,2464,665,807,1472,"6 de julio de 1997"
15,27,55,2465,553,567,1120,"6 de julio de 1997"
15,27,55,2466,572,647,1219,"6 de julio de 1997"
15,27,55,2467,420,467,887,"6 de julio de 1997"
15,27,55,2468,291,324,615,"6 de julio de 1997"
15,27,55,2469,289,303,592,"6 de julio de 1997"
15,27,55,2470,587,696,1283,"6 de julio de 1997"
15,27,55,2471,554,592,1146,"6 de julio de 1997"
15,27,55,2472,469,523,992,"6 de julio de 1997"
15,27,55,2473,467,549,1016,"6 de julio de 1997"
15,27,55,2474,410,447,857,"6 de julio de 1997"
15,27,55,2475,534,621,1155,"6 de julio de 1997"
15,27,55,2476,582,697,1279,"6 de julio de 1997"
15,27,55,2477,584,619,1203,"6 de julio de 1997"
15,27,55,2478,612,655,1267,"6 de julio de 1997"
15,27,55,2479,791,886,1677,"6 de julio de 1997"
15,27,55,2480,1000,1130,2130,"6 de julio de 1997"
15,27,55,2481,718,819,1537,"6 de julio de 1997"
15,27,55,2482,408,463,871,"6 de julio de 1997"
15,27,55,2483,324,356,680,"6 de julio de 1997"
15,27,55,2484,498,608,1106,"6 de julio de 1997"
15,27,55,2485,497,587,1084,"6 de julio de 1997"
15,27,55,2486,461,536,997,"6 de julio de 1997"
15,27,55,2487,508,616,1124,"6 de julio de 1997"
15,27,55,2488,849,931,1780,"6 de julio de 1997"
15,27,55,2489,880,978,1858,"6 de julio de 1997"
15,27,55,2490,1086,1180,2266,"6 de julio de 1997"
15,27,55,2491,356,420,776,"6 de julio de 1997"
15,27,55,2492,971,1038,2009,"6 de julio de 1997"
15,27,55,2493,535,540,1075,"6 de julio de 1997"
15,27,55,2494,380,417,797,"6 de julio de 1997"
15,27,55,2495,502,566,1068,"6 de julio de 1997"
15,27,55,2496,449,484,933,"6 de julio de 1997"
15,27,55,2497,687,778,1465,"6 de julio de 1997"
15,27,55,2498,770,862,1632,"6 de julio de 1997"
15,27,55,2499,765,904,1669,"6 de julio de 1997"
15,27,55,2500,142,187,329,"6 de julio de 1997"
15,27,55,2501,458,520,978,"6 de julio de 1997"
15,27,55,2502,661,719,1380,"6 de julio de 1997"
15,27,55,2503,368,409,777,"6 de julio de 1997"
15,27,55,2504,391,474,865,"6 de julio de 1997"
15,27,55,2505,228,260,488,"6 de julio de 1997"
15,27,55,2506,718,791,1509,"6 de julio de 1997"
15,27,55,2507,896,970,1866,"6 de julio de 1997"
15,27,55,2508,749,788,1537,"6 de julio de 1997"
15,27,55,2509,460,476,936,"6 de julio de 1997"
15,27,55,2510,353,421,774,"6 de julio de 1997"
15,27,55,2511,465,601,1066,"6 de julio de 1997"
15,27,55,2512,233,236,469,"6 de julio de 1997"
15,27,55,2513,353,358,711,"6 de julio de 1997"
15,27,55,2514,488,558,1046,"6 de julio de 1997"
15,27,55,2515,530,596,1126,"6 de julio de 1997"
15,27,55,2516,411,452,863,"6 de julio de 1997"
15,27,55,2517,358,468,826,"6 de julio de 1997"
15,27,55,2518,550,616,1166,"6 de julio de 1997"
15,27,55,2519,238,269,507,"6 de julio de 1997"
15,27,55,2520,716,744,1460,"6 de julio de 1997"
15,27,55,2521,725,786,1511,"6 de julio de 1997"
15,27,55,2522,211,252,463,"6 de julio de 1997"
15,27,55,2523,183,208,391,"6 de julio de 1997"
15,27,55,2524,694,792,1486,"6 de julio de 1997"
15,27,55,2525,704,753,1457,"6 de julio de 1997"
15,27,55,2526,289,361,650,"6 de julio de 1997"
15,27,55,2527,601,736,1337,"6 de julio de 1997"
15,27,55,2528,631,732,1363,"6 de julio de 1997"
15,27,55,2529,651,724,1375,"6 de julio de 1997"
15,27,55,2530,516,584,1100,"6 de julio de 1997"
15,27,55,2531,720,757,1477,"6 de julio de 1997"
15,27,55,2532,655,713,1368,"6 de julio de 1997"
15,27,55,2533,666,801,1467,"6 de julio de 1997"
15,27,55,2534,926,1032,1958,"6 de julio de 1997"
15,27,55,2535,300,328,628,"6 de julio de 1997"
15,27,55,2536,417,511,928,"6 de julio de 1997"
15,27,55,2537,410,533,943,"6 de julio de 1997"
15,27,55,2538,854,932,1786,"6 de julio de 1997"
15,27,55,2539,983,1046,2029,"6 de julio de 1997"
15,27,55,2540,40,41,81,"6 de julio de 1997"
15,27,55,2541,681,690,1371,"6 de julio de 1997"
15,27,55,2542,575,612,1187,"6 de julio de 1997"
15,27,55,2543,197,205,402,"6 de julio de 1997"
15,27,55,2544,795,883,1678,"6 de julio de 1997"
15,27,55,2545,495,522,1017,"6 de julio de 1997"
15,27,55,2546,401,434,835,"6 de julio de 1997"
15,27,55,2547,725,754,1479,"6 de julio de 1997"
15,27,55,2548,759,794,1553,"6 de julio de 1997"
15,27,55,2549,519,553,1072,"6 de julio de 1997"
15,27,56,2550,434,494,928,"6 de julio de 1997"
15,27,56,2551,760,823,1583,"6 de julio de 1997"
15,27,56,2552,463,496,959,"6 de julio de 1997"
15,27,56,2553,558,597,1155,"6 de julio de 1997"
15,27,63,3828,604,612,1216,"6 de julio de 1997"
15,27,63,3829,440,463,903,"6 de julio de 1997"
15,27,63,3830,649,715,1364,"6 de julio de 1997"
15,27,63,3831,664,648,1312,"6 de julio de 1997"
15,27,63,3832,576,581,1157,"6 de julio de 1997"
15,27,63,3833,722,701,1423,"6 de julio de 1997"
15,27,63,3834,545,582,1127,"6 de julio de 1997"
15,27,63,3835,635,652,1287,"6 de julio de 1997"
15,27,63,3836,208,239,447,"6 de julio de 1997"
15,27,63,3837,590,614,1204,"6 de julio de 1997"
15,27,63,3838,607,700,1307,"6 de julio de 1997"
15,27,63,3839,422,408,830,"6 de julio de 1997"
15,27,63,3840,360,359,719,"6 de julio de 1997"
15,27,63,3841,245,250,495,"6 de julio de 1997"
15,27,63,3842,929,919,1848,"6 de julio de 1997"
15,27,63,3843,526,544,1070,"6 de julio de 1997"
15,27,63,3844,567,549,1116,"6 de julio de 1997"
15,27,63,3845,925,997,1922,"6 de julio de 1997"
15,27,63,3846,524,572,1096,"6 de julio de 1997"
15,27,63,3847,496,477,973,"6 de julio de 1997"
15,27,63,3848,404,416,820,"6 de julio de 1997"
15,27,63,3849,463,476,939,"6 de julio de 1997"
15,27,77,4121,436,448,884,"6 de julio de 1997"
15,27,77,4122,619,664,1283,"6 de julio de 1997"
15,27,77,4123,551,567,1118,"6 de julio de 1997"
15,27,77,4124,620,658,1278,"6 de julio de 1997"
15,27,77,4125,597,669,1266,"6 de julio de 1997"
15,27,77,4126,876,941,1817,"6 de julio de 1997"
15,27,77,4127,708,737,1445,"6 de julio de 1997"
15,27,77,4128,558,545,1103,"6 de julio de 1997"
15,27,77,4129,900,911,1811,"6 de julio de 1997"
15,27,77,4130,816,949,1765,"6 de julio de 1997"
15,27,77,4131,577,634,1211,"6 de julio de 1997"
15,27,77,4132,554,581,1135,"6 de julio de 1997"
15,27,77,4133,455,506,961,"6 de julio de 1997"
15,27,77,4134,798,840,1638,"6 de julio de 1997"
15,27,77,4135,1107,1191,2298,"6 de julio de 1997"
15,27,77,4136,496,502,998,"6 de julio de 1997"
15,27,77,4137,604,571,1175,"6 de julio de 1997"
15,27,77,4138,664,661,1325,"6 de julio de 1997"
15,27,77,4139,490,461,951,"6 de julio de 1997"
15,27,77,4140,533,523,1056,"6 de julio de 1997"
15,27,77,4141,553,529,1082,"6 de julio de 1997"
15,27,77,4142,563,555,1118,"6 de julio de 1997"
15,27,77,4143,122,116,238,"6 de julio de 1997"
15,28,60,3046,662,709,1371,"6 de julio de 1997"
15,28,60,3047,567,660,1227,"6 de julio de 1997"
15,28,60,3048,691,775,1466,"6 de julio de 1997"
15,28,60,3049,536,580,1116,"6 de julio de 1997"
15,28,60,3050,772,868,1640,"6 de julio de 1997"
15,28,60,3051,501,519,1020,"6 de julio de 1997"
15,28,60,3061,844,934,1778,"6 de julio de 1997"
15,28,60,3062,831,906,1737,"6 de julio de 1997"
15,28,60,3075,599,668,1267,"6 de julio de 1997"
15,28,60,3076,615,654,1269,"6 de julio de 1997"
15,28,60,3077,594,654,1248,"6 de julio de 1997"
15,28,60,3078,499,539,1038,"6 de julio de 1997"
15,28,60,3079,505,559,1064,"6 de julio de 1997"
15,28,60,3080,527,541,1068,"6 de julio de 1997"
15,28,60,3081,423,441,864,"6 de julio de 1997"
15,28,60,3082,790,837,1627,"6 de julio de 1997"
15,28,60,3083,527,547,1074,"6 de julio de 1997"
15,28,60,3084,394,419,813,"6 de julio de 1997"
15,28,60,3085,763,834,1597,"6 de julio de 1997"
15,28,60,3086,543,641,1184,"6 de julio de 1997"
15,28,60,3087,695,754,1449,"6 de julio de 1997"
15,28,60,3098,927,973,1900,"6 de julio de 1997"
15,28,60,3099,458,485,943,"6 de julio de 1997"
15,28,60,3100,500,516,1016,"6 de julio de 1997"
15,28,60,3101,473,531,1004,"6 de julio de 1997"
15,28,60,3102,500,555,1055,"6 de julio de 1997"
15,28,60,3103,470,500,970,"6 de julio de 1997"
15,28,60,3104,492,516,1008,"6 de julio de 1997"
15,28,60,3105,485,541,1026,"6 de julio de 1997"
15,28,60,3106,499,540,1039,"6 de julio de 1997"
15,28,60,3249,733,747,1480,"6 de julio de 1997"
15,28,60,3250,661,726,1387,"6 de julio de 1997"
15,28,60,3251,739,824,1563,"6 de julio de 1997"
15,28,60,3252,615,688,1303,"6 de julio de 1997"
15,28,60,3253,712,708,1420,"6 de julio de 1997"
15,28,60,3254,432,507,939,"6 de julio de 1997"
15,28,60,3255,706,702,1408,"6 de julio de 1997"
15,28,60,3256,644,658,1302,"6 de julio de 1997"
15,28,60,3257,479,478,957,"6 de julio de 1997"
15,28,60,3258,542,572,1114,"6 de julio de 1997"
15,28,60,3259,815,873,1688,"6 de julio de 1997"
15,28,60,3260,767,836,1603,"6 de julio de 1997"
15,28,60,3261,675,686,1361,"6 de julio de 1997"
15,28,60,3262,453,502,955,"6 de julio de 1997"
15,28,60,3263,651,714,1365,"6 de julio de 1997"
15,28,60,3264,598,630,1228,"6 de julio de 1997"
15,28,60,3265,657,702,1359,"6 de julio de 1997"
15,28,60,3266,527,536,1063,"6 de julio de 1997"
15,28,60,3267,756,822,1578,"6 de julio de 1997"
15,28,60,3268,828,882,1710,"6 de julio de 1997"
15,28,60,3269,734,845,1579,"6 de julio de 1997"
15,28,60,3270,604,684,1288,"6 de julio de 1997"
15,28,60,3271,759,747,1506,"6 de julio de 1997"
15,28,60,3272,660,672,1332,"6 de julio de 1997"
15,28,60,3273,399,515,914,"6 de julio de 1997"
15,28,60,3274,461,450,911,"6 de julio de 1997"
15,28,60,3275,391,469,860,"6 de julio de 1997"
15,28,60,3284,750,785,1535,"6 de julio de 1997"
15,28,60,3285,814,856,1670,"6 de julio de 1997"
15,28,60,3286,763,767,1530,"6 de julio de 1997"
15,28,60,3289,559,579,1138,"6 de julio de 1997"
15,28,60,3290,473,501,974,"6 de julio de 1997"
15,28,60,3291,635,672,1307,"6 de julio de 1997"
15,28,60,3292,708,740,1448,"6 de julio de 1997"
15,28,60,3293,442,449,891,"6 de julio de 1997"
15,28,60,3294,607,638,1245,"6 de julio de 1997"
15,28,60,3295,604,631,1235,"6 de julio de 1997"
15,28,60,3296,426,439,865,"6 de julio de 1997"
15,28,60,3297,503,524,1027,"6 de julio de 1997"
15,28,60,3298,650,660,1310,"6 de julio de 1997"
15,28,60,3299,492,524,1016,"6 de julio de 1997"
15,28,60,3300,377,377,754,"6 de julio de 1997"
15,28,60,3301,529,538,1067,"6 de julio de 1997"
15,28,60,3302,558,617,1175,"6 de julio de 1997"
15,28,60,3303,597,690,1287,"6 de julio de 1997"
15,28,60,3304,677,731,1408,"6 de julio de 1997"
15,28,60,3305,572,583,1155,"6 de julio de 1997"
15,28,60,3306,600,603,1203,"6 de julio de 1997"
15,28,60,3307,552,519,1071,"6 de julio de 1997"
15,28,60,3308,411,437,848,"6 de julio de 1997"
15,28,60,3309,769,858,1627,"6 de julio de 1997"
15,28,60,3310,482,510,992,"6 de julio de 1997"
15,28,60,3311,405,440,845,"6 de julio de 1997"
15,28,60,3312,798,851,1649,"6 de julio de 1997"
15,28,60,3313,806,872,1678,"6 de julio de 1997"
15,28,60,3314,711,738,1449,"6 de julio de 1997"
15,28,60,3315,738,753,1491,"6 de julio de 1997"
15,28,60,3316,653,705,1358,"6 de julio de 1997"
15,28,60,3317,626,657,1283,"6 de julio de 1997"
15,28,60,3318,771,801,1572,"6 de julio de 1997"
15,28,60,3319,543,577,1120,"6 de julio de 1997"
15,28,60,3320,504,540,1044,"6 de julio de 1997"
15,28,60,3321,438,486,924,"6 de julio de 1997"
15,28,60,3322,476,492,968,"6 de julio de 1997"
15,28,60,3323,693,732,1425,"6 de julio de 1997"
15,28,60,3324,559,646,1205,"6 de julio de 1997"
15,28,60,3325,610,667,1277,"6 de julio de 1997"
15,28,60,3326,514,530,1044,"6 de julio de 1997"
15,28,60,3327,478,503,981,"6 de julio de 1997"
15,28,60,3328,423,440,863,"6 de julio de 1997"
15,28,60,3329,558,611,1169,"6 de julio de 1997"
15,28,60,3330,560,625,1185,"6 de julio de 1997"
15,28,60,3331,477,497,974,"6 de julio de 1997"
15,28,60,3332,890,923,1813,"6 de julio de 1997"
15,28,60,3333,798,790,1588,"6 de julio de 1997"
15,28,60,3334,404,420,824,"6 de julio de 1997"
15,28,60,3335,747,783,1530,"6 de julio de 1997"
15,28,60,3336,623,674,1297,"6 de julio de 1997"
15,28,60,3337,655,724,1379,"6 de julio de 1997"
15,28,60,3338,737,791,1528,"6 de julio de 1997"
15,28,60,3339,699,755,1454,"6 de julio de 1997"
15,28,60,3340,544,604,1148,"6 de julio de 1997"
15,28,60,3341,511,545,1056,"6 de julio de 1997"
15,28,60,3342,523,575,1098,"6 de julio de 1997"
15,28,60,3343,540,570,1110,"6 de julio de 1997"
15,28,60,3344,364,424,788,"6 de julio de 1997"
15,28,60,3345,426,426,852,"6 de julio de 1997"
15,28,60,3346,440,473,913,"6 de julio de 1997"
15,28,60,3347,417,477,894,"6 de julio de 1997"
15,28,60,3348,393,468,861,"6 de julio de 1997"
15,28,60,3349,547,596,1143,"6 de julio de 1997"
15,28,60,3350,466,521,987,"6 de julio de 1997"
15,28,60,3351,605,669,1274,"6 de julio de 1997"
15,28,60,3352,639,741,1380,"6 de julio de 1997"
15,28,60,3353,551,569,1120,"6 de julio de 1997"
15,28,60,3458,549,591,1140,"6 de julio de 1997"
15,28,60,3459,478,488,966,"6 de julio de 1997"
15,28,60,3460,452,474,926,"6 de julio de 1997"
15,28,60,3461,550,583,1133,"6 de julio de 1997"
15,28,60,3469,492,544,1036,"6 de julio de 1997"
15,28,60,3470,477,507,984,"6 de julio de 1997"
15,28,60,3471,491,546,1037,"6 de julio de 1997"
15,28,60,3472,519,612,1131,"6 de julio de 1997"
15,28,60,3473,561,589,1150,"6 de julio de 1997"
15,28,60,3474,638,672,1310,"6 de julio de 1997"
15,28,60,3475,524,535,1059,"6 de julio de 1997"
15,28,60,3476,548,548,1096,"6 de julio de 1997"
15,28,60,3477,511,522,1033,"6 de julio de 1997"
15,29,60,3276,760,818,1578,"6 de julio de 1997"
15,29,60,3277,613,625,1238,"6 de julio de 1997"
15,29,60,3278,483,519,1002,"6 de julio de 1997"
15,29,60,3279,497,514,1011,"6 de julio de 1997"
15,29,60,3280,332,354,686,"6 de julio de 1997"
15,29,60,3281,508,594,1102,"6 de julio de 1997"
15,29,60,3354,546,607,1153,"6 de julio de 1997"
15,29,60,3355,624,677,1301,"6 de julio de 1997"
15,29,60,3356,673,766,1439,"6 de julio de 1997"
15,29,60,3357,783,866,1649,"6 de julio de 1997"
15,29,60,3358,350,386,736,"6 de julio de 1997"
15,29,60,3359,578,621,1199,"6 de julio de 1997"
15,29,60,3360,467,561,1028,"6 de julio de 1997"
15,29,60,3361,453,514,967,"6 de julio de 1997"
15,29,60,3362,408,437,845,"6 de julio de 1997"
15,29,60,3363,368,409,777,"6 de julio de 1997"
15,29,60,3364,380,416,796,"6 de julio de 1997"
15,29,60,3365,824,911,1735,"6 de julio de 1997"
15,29,60,3366,608,669,1277,"6 de julio de 1997"
15,29,60,3367,401,446,847,"6 de julio de 1997"
15,29,60,3368,863,891,1754,"6 de julio de 1997"
15,29,60,3369,551,582,1133,"6 de julio de 1997"
15,29,60,3370,353,395,748,"6 de julio de 1997"
15,29,60,3371,568,648,1216,"6 de julio de 1997"
15,29,60,3372,508,613,1121,"6 de julio de 1997"
15,29,60,3373,431,480,911,"6 de julio de 1997"
15,29,60,3374,543,595,1138,"6 de julio de 1997"
15,29,60,3375,547,618,1165,"6 de julio de 1997"
15,29,60,3376,697,789,1486,"6 de julio de 1997"
15,29,60,3377,504,533,1037,"6 de julio de 1997"
15,29,60,3378,464,468,932,"6 de julio de 1997"
15,29,60,3379,408,443,851,"6 de julio de 1997"
15,29,60,3380,528,582,1110,"6 de julio de 1997"
15,29,60,3381,489,596,1085,"6 de julio de 1997"
15,29,60,3382,491,545,1036,"6 de julio de 1997"
15,29,60,3383,635,685,1320,"6 de julio de 1997"
15,29,60,3384,635,662,1297,"6 de julio de 1997"
15,29,60,3385,687,740,1427,"6 de julio de 1997"
15,29,60,3386,344,404,748,"6 de julio de 1997"
15,29,60,3387,755,838,1593,"6 de julio de 1997"
15,29,60,3388,466,503,969,"6 de julio de 1997"
15,29,60,3389,621,694,1315,"6 de julio de 1997"
15,29,60,3390,632,717,1349,"6 de julio de 1997"
15,29,60,3391,334,373,707,"6 de julio de 1997"
15,29,60,3392,585,660,1245,"6 de julio de 1997"
15,29,60,3393,341,386,727,"6 de julio de 1997"
15,29,60,3394,620,690,1310,"6 de julio de 1997"
15,29,60,3395,608,650,1258,"6 de julio de 1997"
15,29,60,3396,372,404,776,"6 de julio de 1997"
15,29,60,3397,513,592,1105,"6 de julio de 1997"
15,29,60,3398,707,798,1505,"6 de julio de 1997"
15,29,60,3399,546,530,1076,"6 de julio de 1997"
15,29,60,3400,626,676,1302,"6 de julio de 1997"
15,29,60,3401,621,674,1295,"6 de julio de 1997"
15,29,60,3402,708,751,1459,"6 de julio de 1997"
15,29,60,3403,764,870,1634,"6 de julio de 1997"
15,29,60,3404,445,548,993,"6 de julio de 1997"
15,29,60,3405,632,695,1327,"6 de julio de 1997"
15,29,60,3406,462,519,981,"6 de julio de 1997"
15,29,60,3407,437,466,903,"6 de julio de 1997"
15,29,60,3408,699,753,1452,"6 de julio de 1997"
15,29,60,3409,508,603,1111,"6 de julio de 1997"
15,29,60,3410,763,780,1543,"6 de julio de 1997"
15,29,60,3411,506,563,1069,"6 de julio de 1997"
15,29,60,3412,616,685,1301,"6 de julio de 1997"
15,29,60,3413,882,963,1845,"6 de julio de 1997"
15,29,60,3414,512,563,1075,"6 de julio de 1997"
15,29,60,3415,709,768,1477,"6 de julio de 1997"
15,29,60,3416,601,630,1231,"6 de julio de 1997"
15,29,60,3417,527,560,1087,"6 de julio de 1997"
15,29,60,3418,754,885,1639,"6 de julio de 1997"
15,29,60,3419,816,884,1700,"6 de julio de 1997"
15,29,60,3420,726,779,1505,"6 de julio de 1997"
15,29,60,3421,492,565,1057,"6 de julio de 1997"
15,29,60,3422,654,698,1352,"6 de julio de 1997"
15,29,60,3423,598,642,1240,"6 de julio de 1997"
15,29,60,3424,489,552,1041,"6 de julio de 1997"
15,29,60,3425,737,836,1573,"6 de julio de 1997"
15,29,60,3426,507,543,1050,"6 de julio de 1997"
15,29,60,3427,673,759,1432,"6 de julio de 1997"
15,29,60,3428,350,388,738,"6 de julio de 1997"
15,29,60,3429,627,680,1307,"6 de julio de 1997"
15,29,60,3430,561,636,1197,"6 de julio de 1997"
15,29,60,3431,378,396,774,"6 de julio de 1997"
15,29,60,3432,709,740,1449,"6 de julio de 1997"
15,29,60,3433,732,777,1509,"6 de julio de 1997"
15,29,60,3434,570,605,1175,"6 de julio de 1997"
15,29,60,3435,753,828,1581,"6 de julio de 1997"
15,29,60,3436,379,410,789,"6 de julio de 1997"
15,29,60,3437,430,508,938,"6 de julio de 1997"
15,29,60,3438,449,531,980,"6 de julio de 1997"
15,29,60,3439,784,837,1621,"6 de julio de 1997"
15,29,60,3440,575,687,1262,"6 de julio de 1997"
15,29,60,3441,389,429,818,"6 de julio de 1997"
15,29,60,3442,452,468,920,"6 de julio de 1997"
15,29,60,3443,710,757,1467,"6 de julio de 1997"
15,29,60,3444,456,521,977,"6 de julio de 1997"
15,29,60,3445,406,430,836,"6 de julio de 1997"
15,29,60,3446,611,660,1271,"6 de julio de 1997"
15,29,60,3447,864,980,1844,"6 de julio de 1997"
15,29,60,3448,427,474,901,"6 de julio de 1997"
15,29,60,3449,816,831,1647,"6 de julio de 1997"
15,29,60,3450,633,720,1353,"6 de julio de 1997"
15,29,60,3451,717,799,1516,"6 de julio de 1997"
15,29,60,3487,438,500,938,"6 de julio de 1997"
15,29,60,3488,760,851,1611,"6 de julio de 1997"
15,29,60,3489,728,795,1523,"6 de julio de 1997"
15,29,60,3490,605,647,1252,"6 de julio de 1997"
15,29,60,3491,654,719,1373,"6 de julio de 1997"
15,29,60,3501,562,664,1226,"6 de julio de 1997"
15,29,60,3502,594,669,1263,"6 de julio de 1997"
15,29,60,3503,782,805,1587,"6 de julio de 1997"
15,29,60,3504,619,689,1308,"6 de julio de 1997"
15,29,60,3505,630,702,1332,"6 de julio de 1997"
15,29,60,3506,566,664,1230,"6 de julio de 1997"
15,29,60,3579,828,914,1742,"6 de julio de 1997"
15,29,60,3580,417,462,879,"6 de julio de 1997"
15,29,60,3581,504,530,1034,"6 de julio de 1997"
15,29,60,3582,365,393,758,"6 de julio de 1997"
15,29,60,3583,502,564,1066,"6 de julio de 1997"
15,29,60,3584,809,966,1775,"6 de julio de 1997"
15,29,60,3614,807,957,1764,"6 de julio de 1997"
15,29,60,3615,567,617,1184,"6 de julio de 1997"
15,29,60,3616,486,564,1050,"6 de julio de 1997"
15,29,60,3617,512,572,1084,"6 de julio de 1997"
15,29,60,3618,604,657,1261,"6 de julio de 1997"
15,29,60,3644,758,872,1630,"6 de julio de 1997"
15,29,60,3645,581,620,1201,"6 de julio de 1997"
15,29,60,3646,658,714,1372,"6 de julio de 1997"
15,29,60,3647,574,695,1269,"6 de julio de 1997"
15,29,60,3648,492,584,1076,"6 de julio de 1997"
15,29,60,3649,296,322,618,"6 de julio de 1997"
15,30,60,3052,456,512,968,"6 de julio de 1997"
15,30,60,3053,875,893,1768,"6 de julio de 1997"
15,30,60,3054,741,769,1510,"6 de julio de 1997"
15,30,60,3055,516,507,1023,"6 de julio de 1997"
15,30,60,3056,827,907,1734,"6 de julio de 1997"
15,30,60,3057,515,554,1069,"6 de julio de 1997"
15,30,60,3058,389,405,794,"6 de julio de 1997"
15,30,60,3059,774,826,1600,"6 de julio de 1997"
15,30,60,3060,634,703,1337,"6 de julio de 1997"
15,30,60,3063,718,796,1514,"6 de julio de 1997"
15,30,60,3064,789,868,1657,"6 de julio de 1997"
15,30,60,3065,727,788,1515,"6 de julio de 1997"
15,30,60,3066,694,737,1431,"6 de julio de 1997"
15,30,60,3067,566,608,1174,"6 de julio de 1997"
15,30,60,3071,641,707,1348,"6 de julio de 1997"
15,30,60,3072,754,786,1540,"6 de julio de 1997"
15,30,60,3073,767,845,1612,"6 de julio de 1997"
15,30,60,3074,642,701,1343,"6 de julio de 1997"
15,30,60,3088,609,699,1308,"6 de julio de 1997"
15,30,60,3089,552,679,1231,"6 de julio de 1997"
15,30,60,3090,614,668,1282,"6 de julio de 1997"
15,30,60,3091,421,452,873,"6 de julio de 1997"
15,30,60,3092,740,815,1555,"6 de julio de 1997"
15,30,60,3094,427,491,918,"6 de julio de 1997"
15,30,60,3452,723,768,1491,"6 de julio de 1997"
15,30,60,3453,666,713,1379,"6 de julio de 1997"
15,30,60,3454,799,858,1657,"6 de julio de 1997"
15,30,60,3455,835,869,1704,"6 de julio de 1997"
15,30,60,3456,852,896,1748,"6 de julio de 1997"
15,30,60,3457,716,746,1462,"6 de julio de 1997"
15,30,60,3462,540,564,1104,"6 de julio de 1997"
15,30,60,3463,681,690,1371,"6 de julio de 1997"
15,30,60,3464,904,879,1783,"6 de julio de 1997"
15,30,60,3465,600,678,1278,"6 de julio de 1997"
15,30,60,3466,666,694,1360,"6 de julio de 1997"
15,30,60,3467,637,677,1314,"6 de julio de 1997"
15,30,60,3468,524,531,1055,"6 de julio de 1997"
15,30,60,3478,568,602,1170,"6 de julio de 1997"
15,30,60,3479,674,712,1386,"6 de julio de 1997"
15,30,60,3480,741,770,1511,"6 de julio de 1997"
15,30,60,3481,630,709,1339,"6 de julio de 1997"
15,30,60,3482,660,656,1316,"6 de julio de 1997"
15,30,60,3483,610,697,1307,"6 de julio de 1997"
15,30,60,3484,629,689,1318,"6 de julio de 1997"
15,30,60,3485,646,711,1357,"6 de julio de 1997"
15,30,60,3486,585,630,1215,"6 de julio de 1997"
15,30,60,3492,620,688,1308,"6 de julio de 1997"
15,30,60,3493,686,750,1436,"6 de julio de 1997"
15,30,60,3494,672,699,1371,"6 de julio de 1997"
15,30,60,3495,613,656,1269,"6 de julio de 1997"
15,30,60,3496,565,602,1167,"6 de julio de 1997"
15,30,60,3497,770,849,1619,"6 de julio de 1997"
15,30,60,3498,697,764,1461,"6 de julio de 1997"
15,30,60,3499,876,903,1779,"6 de julio de 1997"
15,30,60,3500,556,639,1195,"6 de julio de 1997"
15,30,60,3507,527,581,1108,"6 de julio de 1997"
15,30,60,3508,392,447,839,"6 de julio de 1997"
15,30,60,3509,401,386,787,"6 de julio de 1997"
15,30,60,3510,685,736,1421,"6 de julio de 1997"
15,30,60,3511,777,848,1625,"6 de julio de 1997"
15,30,60,3512,533,568,1101,"6 de julio de 1997"
15,30,60,3513,532,591,1123,"6 de julio de 1997"
15,30,60,3514,708,729,1437,"6 de julio de 1997"
15,30,60,3515,544,612,1156,"6 de julio de 1997"
15,30,60,3516,640,722,1362,"6 de julio de 1997"
15,30,60,3527,632,676,1308,"6 de julio de 1997"
15,30,60,3528,489,544,1033,"6 de julio de 1997"
15,30,60,3529,541,612,1153,"6 de julio de 1997"
15,30,60,3530,489,479,968,"6 de julio de 1997"
15,30,60,3531,390,463,853,"6 de julio de 1997"
15,30,60,3532,611,667,1278,"6 de julio de 1997"
15,30,60,3533,607,683,1290,"6 de julio de 1997"
15,30,60,3534,622,650,1272,"6 de julio de 1997"
15,30,60,3535,789,892,1681,"6 de julio de 1997"
15,30,60,3536,694,744,1438,"6 de julio de 1997"
15,30,60,3547,515,538,1053,"6 de julio de 1997"
15,30,60,3548,895,951,1846,"6 de julio de 1997"
15,30,60,3549,670,711,1381,"6 de julio de 1997"
15,30,60,3550,674,718,1392,"6 de julio de 1997"
15,30,60,3551,509,530,1039,"6 de julio de 1997"
15,30,60,3552,637,633,1270,"6 de julio de 1997"
15,30,60,3553,479,536,1015,"6 de julio de 1997"
15,30,60,3554,452,504,956,"6 de julio de 1997"
15,30,60,3555,449,461,910,"6 de julio de 1997"
15,30,60,3556,569,624,1193,"6 de julio de 1997"
15,30,60,3557,687,737,1424,"6 de julio de 1997"
15,30,60,3565,696,725,1421,"6 de julio de 1997"
15,30,60,3566,624,636,1260,"6 de julio de 1997"
15,30,60,3567,510,516,1026,"6 de julio de 1997"
15,30,60,3568,902,981,1883,"6 de julio de 1997"
15,30,60,3569,396,418,814,"6 de julio de 1997"
15,30,60,3570,593,606,1199,"6 de julio de 1997"
15,30,60,3571,622,658,1280,"6 de julio de 1997"
15,30,60,3572,502,545,1047,"6 de julio de 1997"
15,30,60,3573,548,603,1151,"6 de julio de 1997"
15,30,60,3574,725,775,1500,"6 de julio de 1997"
15,30,60,3577,665,675,1340,"6 de julio de 1997"
15,30,60,3578,435,465,900,"6 de julio de 1997"
15,30,60,3585,470,521,991,"6 de julio de 1997"
15,30,60,3586,523,592,1115,"6 de julio de 1997"
15,30,60,3587,807,915,1722,"6 de julio de 1997"
15,30,60,3588,852,932,1784,"6 de julio de 1997"
15,30,60,3589,654,667,1321,"6 de julio de 1997"
15,30,60,3590,765,852,1617,"6 de julio de 1997"
15,30,60,3591,795,854,1649,"6 de julio de 1997"
15,30,60,3592,800,900,1700,"6 de julio de 1997"
15,30,60,3593,498,531,1029,"6 de julio de 1997"
15,30,60,3594,556,600,1156,"6 de julio de 1997"
15,30,60,3595,592,607,1199,"6 de julio de 1997"
15,30,60,3596,536,601,1137,"6 de julio de 1997"
15,30,60,3597,861,908,1769,"6 de julio de 1997"
15,30,60,3599,601,618,1219,"6 de julio de 1997"
15,30,60,3610,775,832,1607,"6 de julio de 1997"
15,30,60,3611,786,785,1571,"6 de julio de 1997"
15,30,60,3612,688,716,1404,"6 de julio de 1997"
15,30,60,3613,802,916,1718,"6 de julio de 1997"
15,30,60,3619,742,728,1470,"6 de julio de 1997"
15,30,60,3620,666,708,1374,"6 de julio de 1997"
15,30,60,3621,688,737,1425,"6 de julio de 1997"
15,30,60,3622,692,764,1456,"6 de julio de 1997"
15,30,60,3637,446,477,923,"6 de julio de 1997"
15,30,60,3638,469,516,985,"6 de julio de 1997"
15,30,60,3639,475,463,938,"6 de julio de 1997"
15,30,60,3640,699,730,1429,"6 de julio de 1997"
15,30,60,3641,729,798,1527,"6 de julio de 1997"
15,30,60,3642,759,809,1568,"6 de julio de 1997"
15,30,60,3643,793,847,1640,"6 de julio de 1997"
15,31,60,3068,760,790,1550,"6 de julio de 1997"
15,31,60,3069,614,673,1287,"6 de julio de 1997"
15,31,60,3070,493,577,1070,"6 de julio de 1997"
15,31,60,3093,505,545,1050,"6 de julio de 1997"
15,31,60,3095,782,882,1664,"6 de julio de 1997"
15,31,60,3096,362,428,790,"6 de julio de 1997"
15,31,60,3097,482,587,1069,"6 de julio de 1997"
15,31,60,3517,725,799,1524,"6 de julio de 1997"
15,31,60,3518,684,758,1442,"6 de julio de 1997"
15,31,60,3519,570,593,1163,"6 de julio de 1997"
15,31,60,3520,512,551,1063,"6 de julio de 1997"
15,31,60,3521,497,521,1018,"6 de julio de 1997"
15,31,60,3522,849,869,1718,"6 de julio de 1997"
15,31,60,3523,652,669,1321,"6 de julio de 1997"
15,31,60,3524,324,378,702,"6 de julio de 1997"
15,31,60,3525,662,672,1334,"6 de julio de 1997"
15,31,60,3526,610,682,1292,"6 de julio de 1997"
15,31,60,3537,515,564,1079,"6 de julio de 1997"
15,31,60,3538,443,502,945,"6 de julio de 1997"
15,31,60,3539,497,581,1078,"6 de julio de 1997"
15,31,60,3540,344,415,759,"6 de julio de 1997"
15,31,60,3541,515,558,1073,"6 de julio de 1997"
15,31,60,3542,678,722,1400,"6 de julio de 1997"
15,31,60,3543,591,600,1191,"6 de julio de 1997"
15,31,60,3544,400,434,834,"6 de julio de 1997"
15,31,60,3545,540,602,1142,"6 de julio de 1997"
15,31,60,3546,571,642,1213,"6 de julio de 1997"
15,31,60,3558,656,670,1326,"6 de julio de 1997"
15,31,60,3559,778,854,1632,"6 de julio de 1997"
15,31,60,3560,571,582,1153,"6 de julio de 1997"
15,31,60,3561,582,663,1245,"6 de julio de 1997"
15,31,60,3562,497,560,1057,"6 de julio de 1997"
15,31,60,3563,653,681,1334,"6 de julio de 1997"
15,31,60,3564,458,515,973,"6 de julio de 1997"
15,31,60,3575,706,788,1494,"6 de julio de 1997"
15,31,60,3576,648,698,1346,"6 de julio de 1997"
15,31,60,3598,357,387,744,"6 de julio de 1997"
15,31,60,3600,483,515,998,"6 de julio de 1997"
15,31,60,3601,428,459,887,"6 de julio de 1997"
15,31,60,3602,843,843,1686,"6 de julio de 1997"
15,31,60,3603,642,689,1331,"6 de julio de 1997"
15,31,60,3604,448,469,917,"6 de julio de 1997"
15,31,60,3605,461,509,970,"6 de julio de 1997"
15,31,60,3606,836,984,1820,"6 de julio de 1997"
15,31,60,3607,619,630,1249,"6 de julio de 1997"
15,31,60,3608,405,430,835,"6 de julio de 1997"
15,31,60,3609,391,439,830,"6 de julio de 1997"
15,31,60,3623,720,817,1537,"6 de julio de 1997"
15,31,60,3624,511,509,1020,"6 de julio de 1997"
15,31,60,3625,808,847,1655,"6 de julio de 1997"
15,31,60,3626,501,530,1031,"6 de julio de 1997"
15,31,60,3627,567,663,1230,"6 de julio de 1997"
15,31,60,3628,554,597,1151,"6 de julio de 1997"
15,31,60,3629,415,499,914,"6 de julio de 1997"
15,31,60,3630,526,496,1022,"6 de julio de 1997"
15,31,60,3631,435,445,880,"6 de julio de 1997"
15,31,60,3632,849,882,1731,"6 de julio de 1997"
15,31,60,3633,603,671,1274,"6 de julio de 1997"
15,31,60,3634,601,687,1288,"6 de julio de 1997"
15,31,60,3635,785,862,1647,"6 de julio de 1997"
15,31,60,3636,436,472,908,"6 de julio de 1997"
15,31,60,3650,581,629,1210,"6 de julio de 1997"
15,31,60,3651,796,930,1726,"6 de julio de 1997"
15,31,60,3652,696,736,1432,"6 de julio de 1997"
15,31,60,3653,614,671,1285,"6 de julio de 1997"
15,31,60,3654,405,417,822,"6 de julio de 1997"
15,31,60,3655,508,548,1056,"6 de julio de 1997"
15,31,60,3656,469,510,979,"6 de julio de 1997"
15,31,60,3657,434,498,932,"6 de julio de 1997"
15,31,60,3658,511,582,1093,"6 de julio de 1997"
15,31,60,3659,523,596,1119,"6 de julio de 1997"
15,31,60,3660,533,574,1107,"6 de julio de 1997"
15,31,60,3661,538,618,1156,"6 de julio de 1997"
15,31,60,3662,497,552,1049,"6 de julio de 1997"
15,31,60,3663,496,508,1004,"6 de julio de 1997"
15,31,60,3664,516,557,1073,"6 de julio de 1997"
15,31,60,3665,509,564,1073,"6 de julio de 1997"
15,31,60,3666,678,744,1422,"6 de julio de 1997"
15,31,60,3667,519,594,1113,"6 de julio de 1997"
15,31,60,3668,884,958,1842,"6 de julio de 1997"
15,31,60,3669,870,947,1817,"6 de julio de 1997"
15,31,60,3670,924,968,1892,"6 de julio de 1997"
15,31,60,3671,762,746,1508,"6 de julio de 1997"
15,31,60,3672,691,732,1423,"6 de julio de 1997"
15,31,60,3673,638,703,1341,"6 de julio de 1997"
15,31,60,3674,640,706,1346,"6 de julio de 1997"
15,31,60,3675,466,493,959,"6 de julio de 1997"
15,31,60,3676,384,451,835,"6 de julio de 1997"
15,31,60,3677,774,874,1648,"6 de julio de 1997"
15,31,60,3678,494,543,1037,"6 de julio de 1997"
15,31,60,3679,868,898,1766,"6 de julio de 1997"
15,31,60,3680,821,854,1675,"6 de julio de 1997"
15,31,60,3681,662,670,1332,"6 de julio de 1997"
15,31,60,3682,769,800,1569,"6 de julio de 1997"
15,31,60,3683,590,634,1224,"6 de julio de 1997"
15,31,60,3684,716,779,1495,"6 de julio de 1997"
15,31,60,3685,480,542,1022,"6 de julio de 1997"
15,31,60,3686,519,577,1096,"6 de julio de 1997"
15,31,60,3687,656,723,1379,"6 de julio de 1997"
15,31,60,3688,822,851,1673,"6 de julio de 1997"
15,31,60,3689,617,685,1302,"6 de julio de 1997"
15,31,60,3690,431,462,893,"6 de julio de 1997"
15,31,60,3691,426,498,924,"6 de julio de 1997"
15,31,60,3692,508,592,1100,"6 de julio de 1997"
15,31,60,3693,550,641,1191,"6 de julio de 1997"
15,31,60,3694,531,609,1140,"6 de julio de 1997"
15,31,60,3695,490,519,1009,"6 de julio de 1997"
15,31,60,3696,565,616,1181,"6 de julio de 1997"
15,31,60,3697,565,621,1186,"6 de julio de 1997"
15,31,60,3698,846,954,1800,"6 de julio de 1997"
15,31,60,3699,897,918,1815,"6 de julio de 1997"
15,31,60,3700,489,546,1035,"6 de julio de 1997"
15,31,60,3701,421,459,880,"6 de julio de 1997"
15,31,60,3702,522,559,1081,"6 de julio de 1997"
15,31,60,3703,654,719,1373,"6 de julio de 1997"
15,31,60,3704,600,705,1305,"6 de julio de 1997"
15,31,60,3705,776,774,1550,"6 de julio de 1997"
15,31,60,3706,535,522,1057,"6 de julio de 1997"
15,31,60,3707,505,503,1008,"6 de julio de 1997"
15,31,60,3708,755,825,1580,"6 de julio de 1997"
15,31,60,3709,536,619,1155,"6 de julio de 1997"
15,31,60,3710,904,930,1834,"6 de julio de 1997"
15,31,60,3711,667,702,1369,"6 de julio de 1997"
15,31,60,3712,700,748,1448,"6 de julio de 1997"
15,31,60,3713,728,809,1537,"6 de julio de 1997"
15,31,60,3714,764,823,1587,"6 de julio de 1997"
15,31,60,3715,733,820,1553,"6 de julio de 1997"
15,31,60,3716,577,600,1177,"6 de julio de 1997"
15,31,60,3717,760,811,1571,"6 de julio de 1997"
15,31,60,3718,468,499,967,"6 de julio de 1997"
15,31,60,3719,514,584,1098,"6 de julio de 1997"
15,31,60,3720,696,806,1502,"6 de julio de 1997"
15,31,60,3721,460,505,965,"6 de julio de 1997"
15,31,60,3722,448,528,976,"6 de julio de 1997"
15,32,71,3942,359,394,753,"6 de julio de 1997"
15,32,71,3943,877,1000,1877,"6 de julio de 1997"
15,32,71,3944,461,509,970,"6 de julio de 1997"
15,32,71,3945,797,826,1623,"6 de julio de 1997"
15,32,71,3946,969,1033,2002,"6 de julio de 1997"
15,32,71,3947,237,254,491,"6 de julio de 1997"
15,32,71,3948,451,513,964,"6 de julio de 1997"
15,32,71,3949,666,775,1441,"6 de julio de 1997"
15,32,71,3950,1036,1124,2160,"6 de julio de 1997"
15,32,71,3951,841,945,1786,"6 de julio de 1997"
15,32,71,3952,785,802,1587,"6 de julio de 1997"
15,32,71,3953,786,893,1679,"6 de julio de 1997"
15,32,71,3954,705,704,1409,"6 de julio de 1997"
15,32,71,3955,886,937,1823,"6 de julio de 1997"
15,32,71,3956,694,694,1388,"6 de julio de 1997"
15,32,71,3957,805,851,1656,"6 de julio de 1997"
15,32,71,3958,811,884,1695,"6 de julio de 1997"
15,32,71,3959,818,892,1710,"6 de julio de 1997"
15,32,71,3960,685,680,1365,"6 de julio de 1997"
15,32,71,3961,653,683,1336,"6 de julio de 1997"
15,32,71,3962,669,742,1411,"6 de julio de 1997"
15,32,71,3963,775,834,1609,"6 de julio de 1997"
15,32,71,3964,664,720,1384,"6 de julio de 1997"
15,32,71,3965,808,848,1656,"6 de julio de 1997"
15,32,71,3966,655,686,1341,"6 de julio de 1997"
15,32,71,3967,1342,1556,2898,"6 de julio de 1997"
15,32,71,3968,820,914,1734,"6 de julio de 1997"
15,32,71,3969,628,718,1346,"6 de julio de 1997"
15,32,71,3970,679,746,1425,"6 de julio de 1997"
15,32,71,3971,646,681,1327,"6 de julio de 1997"
15,32,71,3972,751,775,1526,"6 de julio de 1997"
15,32,71,3973,844,874,1718,"6 de julio de 1997"
15,32,71,3974,758,815,1573,"6 de julio de 1997"
15,32,71,3975,596,632,1228,"6 de julio de 1997"
15,32,71,3976,542,616,1158,"6 de julio de 1997"
15,32,71,3977,863,882,1745,"6 de julio de 1997"
15,32,71,3978,594,654,1248,"6 de julio de 1997"
15,32,71,3979,588,638,1226,"6 de julio de 1997"
15,32,71,3980,865,962,1827,"6 de julio de 1997"
15,32,71,3981,453,538,991,"6 de julio de 1997"
15,32,71,3982,559,598,1157,"6 de julio de 1997"
15,32,71,3983,656,741,1397,"6 de julio de 1997"
15,32,71,3984,695,747,1442,"6 de julio de 1997"
15,32,71,3985,395,442,837,"6 de julio de 1997"
15,32,71,3986,700,748,1448,"6 de julio de 1997"
15,32,71,3987,775,839,1614,"6 de julio de 1997"
15,32,71,3988,812,890,1702,"6 de julio de 1997"
15,32,71,3989,459,501,960,"6 de julio de 1997"
15,32,71,3990,613,663,1276,"6 de julio de 1997"
15,32,71,3991,457,480,937,"6 de julio de 1997"
15,32,71,3992,492,547,1039,"6 de julio de 1997"
15,32,71,3993,482,524,1006,"6 de julio de 1997"
15,32,71,3994,656,708,1364,"6 de julio de 1997"
15,32,71,3995,546,556,1102,"6 de julio de 1997"
15,32,71,3996,327,388,715,"6 de julio de 1997"
15,32,71,3997,570,599,1169,"6 de julio de 1997"
15,32,71,3998,635,701,1336,"6 de julio de 1997"
15,32,71,3999,308,361,669,"6 de julio de 1997"
15,32,71,4000,617,662,1279,"6 de julio de 1997"
15,32,71,4001,653,797,1450,"6 de julio de 1997"
15,32,71,4002,544,550,1094,"6 de julio de 1997"
15,32,71,4003,640,721,1361,"6 de julio de 1997"
15,32,71,4004,1109,1206,2315,"6 de julio de 1997"
15,32,71,4005,582,659,1241,"6 de julio de 1997"
15,32,71,4006,243,285,528,"6 de julio de 1997"
15,32,71,4007,323,395,718,"6 de julio de 1997"
15,32,122,912,568,658,1226,"6 de julio de 1997"
15,32,122,913,670,678,1348,"6 de julio de 1997"
15,32,122,914,509,529,1038,"6 de julio de 1997"
15,32,122,915,567,662,1229,"6 de julio de 1997"
15,32,122,916,529,637,1166,"6 de julio de 1997"
15,32,122,917,424,473,897,"6 de julio de 1997"
15,32,122,918,309,324,633,"6 de julio de 1997"
15,32,122,919,634,693,1327,"6 de julio de 1997"
15,32,122,920,474,491,965,"6 de julio de 1997"
15,32,122,921,358,407,765,"6 de julio de 1997"
15,32,122,922,370,373,743,"6 de julio de 1997"
15,32,122,923,500,573,1073,"6 de julio de 1997"
15,32,122,924,707,735,1442,"6 de julio de 1997"
15,32,122,925,615,713,1328,"6 de julio de 1997"
15,32,122,926,669,710,1379,"6 de julio de 1997"
15,32,122,927,380,408,788,"6 de julio de 1997"
15,32,122,928,337,364,701,"6 de julio de 1997"
15,32,122,929,484,520,1004,"6 de julio de 1997"
15,32,122,930,428,454,882,"6 de julio de 1997"
15,32,122,931,625,657,1282,"6 de julio de 1997"
15,32,122,932,541,582,1123,"6 de julio de 1997"
15,32,122,933,545,586,1131,"6 de julio de 1997"
15,32,122,934,642,694,1336,"6 de julio de 1997"
15,32,122,935,414,450,864,"6 de julio de 1997"
15,32,122,936,482,545,1027,"6 de julio de 1997"
15,32,122,939,587,659,1246,"6 de julio de 1997"
15,32,122,940,603,635,1238,"6 de julio de 1997"
15,32,122,941,594,670,1264,"6 de julio de 1997"
15,32,122,942,667,673,1340,"6 de julio de 1997"
15,32,122,943,570,579,1149,"6 de julio de 1997"
15,32,122,944,427,497,924,"6 de julio de 1997"
15,32,122,945,379,391,770,"6 de julio de 1997"
15,32,122,946,522,568,1090,"6 de julio de 1997"
15,32,122,947,859,915,1774,"6 de julio de 1997"
15,32,122,948,690,739,1429,"6 de julio de 1997"
15,32,122,949,545,622,1167,"6 de julio de 1997"
15,32,122,950,447,498,945,"6 de julio de 1997"
15,32,122,951,691,787,1478,"6 de julio de 1997"
15,32,122,952,515,605,1120,"6 de julio de 1997"
15,32,122,953,417,435,852,"6 de julio de 1997"
15,32,122,954,377,415,792,"6 de julio de 1997"
15,32,122,955,508,541,1049,"6 de julio de 1997"
15,32,122,956,404,449,853,"6 de julio de 1997"
15,32,122,957,485,521,1006,"6 de julio de 1997"
15,32,122,958,570,624,1194,"6 de julio de 1997"
15,32,122,959,505,562,1067,"6 de julio de 1997"
15,32,122,960,658,725,1383,"6 de julio de 1997"
15,32,122,961,719,798,1517,"6 de julio de 1997"
15,32,122,962,690,756,1446,"6 de julio de 1997"
15,32,122,963,668,725,1393,"6 de julio de 1997"
15,32,122,964,649,693,1342,"6 de julio de 1997"
15,32,122,965,446,493,939,"6 de julio de 1997"
15,32,122,968,559,604,1163,"6 de julio de 1997"
15,32,122,969,616,633,1249,"6 de julio de 1997"
15,32,122,970,525,581,1106,"6 de julio de 1997"
15,32,122,971,848,942,1790,"6 de julio de 1997"
15,32,122,972,819,928,1747,"6 de julio de 1997"
15,32,122,973,515,571,1086,"6 de julio de 1997"
15,32,122,974,913,920,1833,"6 de julio de 1997"
15,32,122,975,538,532,1070,"6 de julio de 1997"
15,32,122,976,575,637,1212,"6 de julio de 1997"
15,32,122,977,702,817,1519,"6 de julio de 1997"
15,32,122,978,533,536,1069,"6 de julio de 1997"
15,32,122,979,463,560,1023,"6 de julio de 1997"
15,32,122,980,551,594,1145,"6 de julio de 1997"
15,32,122,981,644,691,1335,"6 de julio de 1997"
15,32,122,982,633,681,1314,"6 de julio de 1997"
15,32,122,983,667,749,1416,"6 de julio de 1997"
15,32,122,984,847,894,1741,"6 de julio de 1997"
15,32,122,985,507,524,1031,"6 de julio de 1997"
15,32,122,997,411,466,877,"6 de julio de 1997"
15,32,122,998,375,384,759,"6 de julio de 1997"
15,32,122,999,666,709,1375,"6 de julio de 1997"
15,32,122,1000,661,677,1338,"6 de julio de 1997"
15,32,122,1001,588,667,1255,"6 de julio de 1997"
15,32,122,1002,647,678,1325,"6 de julio de 1997"
15,32,122,1003,783,819,1602,"6 de julio de 1997"
15,32,122,1004,512,544,1056,"6 de julio de 1997"
15,32,122,1005,510,530,1040,"6 de julio de 1997"
15,32,122,1006,505,579,1084,"6 de julio de 1997"
15,32,122,1007,837,866,1703,"6 de julio de 1997"
15,32,122,1008,538,579,1117,"6 de julio de 1997"
15,32,122,1009,771,841,1612,"6 de julio de 1997"
15,32,122,1010,669,758,1427,"6 de julio de 1997"
15,32,122,1011,785,834,1619,"6 de julio de 1997"
15,32,122,1012,662,714,1376,"6 de julio de 1997"
15,32,122,1013,574,617,1191,"6 de julio de 1997"
15,32,122,1014,538,611,1149,"6 de julio de 1997"
15,32,122,1015,546,610,1156,"6 de julio de 1997"
15,32,122,1016,490,558,1048,"6 de julio de 1997"
15,32,122,1028,556,610,1166,"6 de julio de 1997"
15,32,122,1029,779,817,1596,"6 de julio de 1997"
15,32,122,1030,729,799,1528,"6 de julio de 1997"
15,32,122,1031,618,716,1334,"6 de julio de 1997"
15,32,122,1032,669,731,1400,"6 de julio de 1997"
15,32,122,1033,568,607,1175,"6 de julio de 1997"
15,32,122,1034,818,821,1639,"6 de julio de 1997"
15,32,122,1061,424,484,908,"6 de julio de 1997"
15,32,122,2083,916,1038,1954,"6 de julio de 1997"
15,32,122,2084,385,357,742,"6 de julio de 1997"
15,32,122,2085,296,321,617,"6 de julio de 1997"
15,32,122,2086,658,718,1376,"6 de julio de 1997"
15,32,122,2114,595,644,1239,"6 de julio de 1997"
15,32,122,2115,373,422,795,"6 de julio de 1997"
15,32,122,2116,465,472,937,"6 de julio de 1997"
15,32,122,2117,659,708,1367,"6 de julio de 1997"
15,32,122,2118,637,722,1359,"6 de julio de 1997"
15,32,122,2119,451,529,980,"6 de julio de 1997"
15,32,122,2120,568,601,1169,"6 de julio de 1997"
15,32,122,2121,504,570,1074,"6 de julio de 1997"
15,32,122,5924,94,103,197,"6 de julio de 1997"
15,32,122,5925,32,43,75,"6 de julio de 1997"
15,32,122,5926,72,87,159,"6 de julio de 1997"
15,32,122,5927,358,389,747,"6 de julio de 1997"
15,32,122,5928,0,0,0,"6 de julio de 1997"
15,33,9,193,394,460,854,"6 de julio de 1997"
15,33,9,194,406,443,849,"6 de julio de 1997"
15,33,9,195,499,554,1053,"6 de julio de 1997"
15,33,9,196,494,535,1029,"6 de julio de 1997"
15,33,9,197,395,489,884,"6 de julio de 1997"
15,33,9,198,328,385,713,"6 de julio de 1997"
15,33,9,199,290,321,611,"6 de julio de 1997"
15,33,9,200,338,415,753,"6 de julio de 1997"
15,33,9,201,529,590,1119,"6 de julio de 1997"
15,33,9,202,530,505,1035,"6 de julio de 1997"
15,33,9,203,299,333,632,"6 de julio de 1997"
15,33,9,204,398,436,834,"6 de julio de 1997"
15,33,9,205,380,463,843,"6 de julio de 1997"
15,33,9,206,436,466,902,"6 de julio de 1997"
15,33,9,207,572,616,1188,"6 de julio de 1997"
15,33,9,208,578,667,1245,"6 de julio de 1997"
15,33,9,209,486,524,1010,"6 de julio de 1997"
15,33,9,210,528,521,1049,"6 de julio de 1997"
15,33,9,211,519,523,1042,"6 de julio de 1997"
15,33,9,212,729,735,1464,"6 de julio de 1997"
15,33,9,213,484,464,948,"6 de julio de 1997"
15,33,9,214,366,405,771,"6 de julio de 1997"
15,33,9,215,648,689,1337,"6 de julio de 1997"
15,33,9,216,388,452,840,"6 de julio de 1997"
15,33,9,217,467,478,945,"6 de julio de 1997"
15,33,9,218,379,382,761,"6 de julio de 1997"
15,33,15,456,617,632,1249,"6 de julio de 1997"
15,33,15,457,401,435,836,"6 de julio de 1997"
15,33,15,458,394,411,805,"6 de julio de 1997"
15,33,15,459,427,440,867,"6 de julio de 1997"
15,33,15,460,520,559,1079,"6 de julio de 1997"
15,33,15,461,129,121,250,"6 de julio de 1997"
15,33,15,462,220,259,479,"6 de julio de 1997"
15,33,15,463,684,707,1391,"6 de julio de 1997"
15,33,15,464,835,837,1672,"6 de julio de 1997"
15,33,15,465,359,353,712,"6 de julio de 1997"
15,33,15,466,387,414,801,"6 de julio de 1997"
15,33,15,467,636,609,1245,"6 de julio de 1997"
15,33,15,468,391,371,762,"6 de julio de 1997"
15,33,17,490,512,555,1067,"6 de julio de 1997"
15,33,17,491,396,411,807,"6 de julio de 1997"
15,33,17,492,114,120,234,"6 de julio de 1997"
15,33,17,493,197,197,394,"6 de julio de 1997"
15,33,17,494,320,326,646,"6 de julio de 1997"
15,33,22,648,504,536,1040,"6 de julio de 1997"
15,33,22,649,558,591,1149,"6 de julio de 1997"
15,33,22,650,510,561,1071,"6 de julio de 1997"
15,33,22,651,459,464,923,"6 de julio de 1997"
15,33,22,652,568,604,1172,"6 de julio de 1997"
15,33,22,653,380,403,783,"6 de julio de 1997"
15,33,26,937,824,903,1727,"6 de julio de 1997"
15,33,26,938,160,188,348,"6 de julio de 1997"
15,33,26,966,572,605,1177,"6 de julio de 1997"
15,33,26,967,580,648,1228,"6 de julio de 1997"
15,33,26,986,450,510,960,"6 de julio de 1997"
15,33,26,987,600,626,1226,"6 de julio de 1997"
15,33,26,988,933,1032,1965,"6 de julio de 1997"
15,33,26,989,306,305,611,"6 de julio de 1997"
15,33,26,990,366,396,762,"6 de julio de 1997"
15,33,26,991,619,725,1344,"6 de julio de 1997"
15,33,26,992,650,787,1437,"6 de julio de 1997"
15,33,26,993,655,713,1368,"6 de julio de 1997"
15,33,26,994,726,847,1573,"6 de julio de 1997"
15,33,26,995,1418,1606,3024,"6 de julio de 1997"
15,33,26,996,1113,1149,2262,"6 de julio de 1997"
15,33,26,1017,465,525,990,"6 de julio de 1997"
15,33,26,1018,571,620,1191,"6 de julio de 1997"
15,33,26,1019,788,852,1640,"6 de julio de 1997"
15,33,26,1020,479,512,991,"6 de julio de 1997"
15,33,26,1021,436,529,965,"6 de julio de 1997"
15,33,26,1022,667,717,1384,"6 de julio de 1997"
15,33,26,1023,627,692,1319,"6 de julio de 1997"
15,33,26,1024,356,378,734,"6 de julio de 1997"
15,33,26,1025,696,799,1495,"6 de julio de 1997"
15,33,26,1026,553,627,1180,"6 de julio de 1997"
15,33,26,1027,603,674,1277,"6 de julio de 1997"
15,33,26,1035,582,623,1205,"6 de julio de 1997"
15,33,26,1036,935,1030,1965,"6 de julio de 1997"
15,33,26,1037,986,1127,2113,"6 de julio de 1997"
15,33,26,1038,548,588,1136,"6 de julio de 1997"
15,33,26,1039,713,845,1558,"6 de julio de 1997"
15,33,26,1040,716,812,1528,"6 de julio de 1997"
15,33,26,1041,548,633,1181,"6 de julio de 1997"
15,33,26,1042,762,901,1663,"6 de julio de 1997"
15,33,26,1043,435,496,931,"6 de julio de 1997"
15,33,26,1044,507,495,1002,"6 de julio de 1997"
15,33,26,1045,385,436,821,"6 de julio de 1997"
15,33,26,1046,379,396,775,"6 de julio de 1997"
15,33,26,1047,667,686,1353,"6 de julio de 1997"
15,33,26,1048,254,292,546,"6 de julio de 1997"
15,33,26,1049,754,812,1566,"6 de julio de 1997"
15,33,26,1050,515,572,1087,"6 de julio de 1997"
15,33,26,1051,497,531,1028,"6 de julio de 1997"
15,33,26,1052,447,504,951,"6 de julio de 1997"
15,33,26,1053,771,774,1545,"6 de julio de 1997"
15,33,26,1054,507,605,1112,"6 de julio de 1997"
15,33,26,1055,622,634,1256,"6 de julio de 1997"
15,33,26,1056,331,337,668,"6 de julio de 1997"
15,33,26,1057,378,405,783,"6 de julio de 1997"
15,33,26,1058,432,438,870,"6 de julio de 1997"
15,33,26,1059,529,538,1067,"6 de julio de 1997"
15,33,26,1060,573,612,1185,"6 de julio de 1997"
15,33,26,1062,522,541,1063,"6 de julio de 1997"
15,33,26,1063,711,752,1463,"6 de julio de 1997"
15,33,26,1064,539,606,1145,"6 de julio de 1997"
15,33,26,1065,800,821,1621,"6 de julio de 1997"
15,33,26,1066,372,410,782,"6 de julio de 1997"
15,33,26,1067,645,717,1362,"6 de julio de 1997"
15,33,26,1068,745,766,1511,"6 de julio de 1997"
15,33,26,1069,462,503,965,"6 de julio de 1997"
15,33,26,1070,570,628,1198,"6 de julio de 1997"
15,33,26,1071,513,560,1073,"6 de julio de 1997"
15,33,26,1072,531,579,1110,"6 de julio de 1997"
15,33,26,1073,714,745,1459,"6 de julio de 1997"
15,33,26,1074,470,520,990,"6 de julio de 1997"
15,33,26,1075,700,774,1474,"6 de julio de 1997"
15,33,26,1076,965,1025,1990,"6 de julio de 1997"
15,33,26,1077,558,591,1149,"6 de julio de 1997"
15,33,26,1078,522,531,1053,"6 de julio de 1997"
15,33,26,1079,825,889,1714,"6 de julio de 1997"
15,33,26,1080,622,628,1250,"6 de julio de 1997"
15,33,35,1952,744,810,1554,"6 de julio de 1997"
15,33,35,1953,629,636,1265,"6 de julio de 1997"
15,33,35,1954,237,255,492,"6 de julio de 1997"
15,33,35,1955,219,193,412,"6 de julio de 1997"
15,33,51,2378,468,501,969,"6 de julio de 1997"
15,33,51,2379,463,552,1015,"6 de julio de 1997"
15,33,51,2380,814,906,1720,"6 de julio de 1997"
15,33,51,2381,701,736,1437,"6 de julio de 1997"
15,33,51,2382,492,541,1033,"6 de julio de 1997"
15,33,51,2383,559,597,1156,"6 de julio de 1997"
15,33,51,2384,658,655,1313,"6 de julio de 1997"
15,33,51,2385,574,521,1095,"6 de julio de 1997"
15,33,69,3927,443,469,912,"6 de julio de 1997"
15,33,69,3928,186,192,378,"6 de julio de 1997"
15,33,69,3929,604,678,1282,"6 de julio de 1997"
15,33,69,3930,724,846,1570,"6 de julio de 1997"
15,33,69,3931,558,611,1169,"6 de julio de 1997"
15,33,69,3932,587,698,1285,"6 de julio de 1997"
15,33,69,3933,624,704,1328,"6 de julio de 1997"
15,33,69,3934,383,430,813,"6 de julio de 1997"
15,33,69,3935,369,370,739,"6 de julio de 1997"
15,33,69,3936,487,538,1025,"6 de julio de 1997"
15,33,69,3937,349,329,678,"6 de julio de 1997"
15,33,69,3938,399,407,806,"6 de julio de 1997"
15,33,69,3939,122,128,250,"6 de julio de 1997"
15,33,84,4326,528,591,1119,"6 de julio de 1997"
15,33,84,4327,610,755,1365,"6 de julio de 1997"
15,33,84,4328,393,440,833,"6 de julio de 1997"
15,33,84,4329,216,243,459,"6 de julio de 1997"
15,33,84,4330,995,145,1140,"6 de julio de 1997"
15,33,90,4466,435,461,896,"6 de julio de 1997"
15,33,90,4467,416,441,857,"6 de julio de 1997"
15,33,90,4468,510,548,1058,"6 de julio de 1997"
15,33,90,4469,536,530,1066,"6 de julio de 1997"
15,33,90,4470,408,450,858,"6 de julio de 1997"
15,33,95,4556,610,611,1221,"6 de julio de 1997"
15,33,95,4557,391,457,848,"6 de julio de 1997"
15,33,95,4558,610,641,1251,"6 de julio de 1997"
15,33,95,4559,745,764,1509,"6 de julio de 1997"
15,33,95,4560,412,394,806,"6 de julio de 1997"
15,33,95,4561,460,465,925,"6 de julio de 1997"
15,33,95,4562,338,315,653,"6 de julio de 1997"
15,33,95,4563,606,644,1250,"6 de julio de 1997"
15,33,104,4736,555,598,1153,"6 de julio de 1997"
15,33,104,4737,831,945,1776,"6 de julio de 1997"
15,33,104,4738,565,637,1202,"6 de julio de 1997"
15,33,104,4739,551,612,1163,"6 de julio de 1997"
15,33,104,4740,569,621,1190,"6 de julio de 1997"
15,33,104,4741,781,819,1600,"6 de julio de 1997"
15,33,104,4742,509,518,1027,"6 de julio de 1997"
15,33,104,4743,617,680,1297,"6 de julio de 1997"
15,33,104,4744,599,606,1205,"6 de julio de 1997"
15,33,104,4745,759,823,1582,"6 de julio de 1997"
15,33,104,4746,334,355,689,"6 de julio de 1997"
15,33,104,4747,402,436,838,"6 de julio de 1997"
15,33,104,4748,362,419,781,"6 de julio de 1997"
15,33,104,4749,532,575,1107,"6 de julio de 1997"
15,33,104,4750,795,827,1622,"6 de julio de 1997"
15,33,104,4751,537,579,1116,"6 de julio de 1997"
15,33,104,4752,450,456,906,"6 de julio de 1997"
15,33,104,4753,570,599,1169,"6 de julio de 1997"
15,33,104,4754,459,456,915,"6 de julio de 1997"
15,33,104,4755,444,484,928,"6 de julio de 1997"
15,33,104,4756,379,419,798,"6 de julio de 1997"
15,34,107,5207,353,417,770,"6 de julio de 1997"
15,34,107,5208,143,189,332,"6 de julio de 1997"
15,34,107,5209,151,208,359,"6 de julio de 1997"
15,34,107,5210,250,343,593,"6 de julio de 1997"
15,34,107,5211,244,336,580,"6 de julio de 1997"
15,34,107,5212,225,272,497,"6 de julio de 1997"
15,34,107,5213,401,525,926,"6 de julio de 1997"
15,34,107,5214,564,747,1311,"6 de julio de 1997"
15,34,107,5215,344,439,783,"6 de julio de 1997"
15,34,107,5216,418,540,958,"6 de julio de 1997"
15,34,107,5217,451,502,953,"6 de julio de 1997"
15,34,107,5218,602,776,1378,"6 de julio de 1997"
15,34,107,5219,659,839,1498,"6 de julio de 1997"
15,34,107,5220,499,673,1172,"6 de julio de 1997"
15,34,107,5221,372,429,801,"6 de julio de 1997"
15,34,107,5222,499,666,1165,"6 de julio de 1997"
15,34,107,5223,531,658,1189,"6 de julio de 1997"
15,34,107,5224,449,598,1047,"6 de julio de 1997"
15,34,107,5225,401,580,981,"6 de julio de 1997"
15,34,107,5226,532,733,1265,"6 de julio de 1997"
15,34,107,5227,573,726,1299,"6 de julio de 1997"
15,34,107,5228,503,623,1126,"6 de julio de 1997"
15,34,107,5229,431,574,1005,"6 de julio de 1997"
15,34,107,5230,362,461,823,"6 de julio de 1997"
15,34,107,5231,711,904,1615,"6 de julio de 1997"
15,34,107,5232,761,949,1710,"6 de julio de 1997"
15,34,107,5233,477,544,1021,"6 de julio de 1997"
15,34,107,5234,444,570,1014,"6 de julio de 1997"
15,34,107,5235,480,592,1072,"6 de julio de 1997"
15,34,107,5236,694,992,1686,"6 de julio de 1997"
15,34,107,5237,590,705,1295,"6 de julio de 1997"
15,34,107,5238,413,574,987,"6 de julio de 1997"
15,34,107,5239,432,512,944,"6 de julio de 1997"
15,34,107,5240,662,884,1546,"6 de julio de 1997"
15,34,107,5241,591,761,1352,"6 de julio de 1997"
15,34,107,5242,615,753,1368,"6 de julio de 1997"
15,34,107,5243,560,681,1241,"6 de julio de 1997"
15,34,107,5244,597,736,1333,"6 de julio de 1997"
15,34,107,5245,692,918,1610,"6 de julio de 1997"
15,34,107,5246,410,513,923,"6 de julio de 1997"
15,34,107,5247,411,495,906,"6 de julio de 1997"
15,34,107,5248,740,886,1626,"6 de julio de 1997"
15,34,107,5249,434,550,984,"6 de julio de 1997"
15,34,107,5250,495,603,1098,"6 de julio de 1997"
15,34,107,5251,647,774,1421,"6 de julio de 1997"
15,34,107,5252,614,738,1352,"6 de julio de 1997"
15,34,107,5253,1139,594,1733,"6 de julio de 1997"
15,34,107,5254,575,666,1241,"6 de julio de 1997"
15,34,107,5255,795,855,1650,"6 de julio de 1997"
15,34,107,5256,775,795,1570,"6 de julio de 1997"
15,34,107,5257,556,662,1218,"6 de julio de 1997"
15,34,107,5258,517,641,1158,"6 de julio de 1997"
15,34,107,5259,541,644,1185,"6 de julio de 1997"
15,34,107,5260,535,603,1138,"6 de julio de 1997"
15,34,107,5261,812,909,1721,"6 de julio de 1997"
15,34,107,5262,625,758,1383,"6 de julio de 1997"
15,34,107,5263,638,827,1465,"6 de julio de 1997"
15,34,107,5264,703,805,1508,"6 de julio de 1997"
15,34,107,5265,644,720,1364,"6 de julio de 1997"
15,34,107,5298,844,934,1778,"6 de julio de 1997"
15,34,107,5307,514,653,1167,"6 de julio de 1997"
15,34,107,5308,530,740,1270,"6 de julio de 1997"
15,34,107,5309,900,1002,1902,"6 de julio de 1997"
15,34,107,5310,703,757,1460,"6 de julio de 1997"
15,34,107,5311,748,800,1548,"6 de julio de 1997"
15,34,107,5312,499,611,1110,"6 de julio de 1997"
15,34,107,5313,627,815,1442,"6 de julio de 1997"
15,34,107,5314,758,974,1732,"6 de julio de 1997"
15,34,107,5315,291,436,727,"6 de julio de 1997"
15,34,107,5316,658,804,1462,"6 de julio de 1997"
15,34,107,5317,776,865,1641,"6 de julio de 1997"
15,34,107,5318,715,835,1550,"6 de julio de 1997"
15,34,107,5319,693,824,1517,"6 de julio de 1997"
15,34,107,5320,764,916,1680,"6 de julio de 1997"
15,34,107,5321,639,766,1405,"6 de julio de 1997"
15,34,107,5322,581,696,1277,"6 de julio de 1997"
15,34,107,5323,1015,1005,2020,"6 de julio de 1997"
15,34,107,5324,641,739,1380,"6 de julio de 1997"
15,34,107,5325,489,498,987,"6 de julio de 1997"
15,34,107,5326,614,631,1245,"6 de julio de 1997"
15,34,107,5327,481,550,1031,"6 de julio de 1997"
15,34,107,5328,357,411,768,"6 de julio de 1997"
15,34,107,5329,605,749,1354,"6 de julio de 1997"
15,34,107,5330,940,1045,1985,"6 de julio de 1997"
15,34,107,5331,489,531,1020,"6 de julio de 1997"
15,34,107,5332,439,470,909,"6 de julio de 1997"
15,34,107,5333,506,549,1055,"6 de julio de 1997"
15,34,107,5334,481,536,1017,"6 de julio de 1997"
15,34,107,5335,772,868,1640,"6 de julio de 1997"
15,34,107,5336,780,891,1671,"6 de julio de 1997"
15,34,107,5337,655,732,1387,"6 de julio de 1997"
15,34,107,5338,461,540,1001,"6 de julio de 1997"
15,34,107,5339,737,884,1621,"6 de julio de 1997"
15,34,107,5340,289,359,648,"6 de julio de 1997"
15,34,107,5341,616,778,1394,"6 de julio de 1997"
15,34,107,5342,646,780,1426,"6 de julio de 1997"
15,34,107,5343,611,689,1300,"6 de julio de 1997"
15,34,107,5344,498,566,1064,"6 de julio de 1997"
15,34,107,5345,594,717,1311,"6 de julio de 1997"
15,34,107,5346,336,390,726,"6 de julio de 1997"
15,34,107,5347,776,838,1614,"6 de julio de 1997"
15,34,107,5348,844,949,1793,"6 de julio de 1997"
15,34,107,5349,914,1072,1986,"6 de julio de 1997"
15,34,107,5350,969,1113,2082,"6 de julio de 1997"
15,34,107,5351,891,987,1878,"6 de julio de 1997"
15,34,107,5352,218,282,500,"6 de julio de 1997"
15,34,107,5353,281,344,625,"6 de julio de 1997"
15,34,107,5419,443,468,911,"6 de julio de 1997"
15,34,107,5420,386,414,800,"6 de julio de 1997"
15,34,107,5421,483,518,1001,"6 de julio de 1997"
15,34,107,5422,784,743,1527,"6 de julio de 1997"
15,34,107,5423,504,501,1005,"6 de julio de 1997"
15,34,107,5424,450,455,905,"6 de julio de 1997"
15,34,107,5425,788,813,1601,"6 de julio de 1997"
15,34,107,5426,147,149,296,"6 de julio de 1997"
15,34,107,5427,46,53,99,"6 de julio de 1997"
15,34,107,5428,549,531,1080,"6 de julio de 1997"
15,34,107,5429,400,430,830,"6 de julio de 1997"
15,34,107,5430,550,591,1141,"6 de julio de 1997"
15,34,107,5431,482,470,952,"6 de julio de 1997"
15,34,107,5432,432,455,887,"6 de julio de 1997"
15,34,107,5433,816,773,1589,"6 de julio de 1997"
15,34,107,5434,723,730,1453,"6 de julio de 1997"
15,34,107,5435,641,676,1317,"6 de julio de 1997"
15,34,107,5436,594,621,1215,"6 de julio de 1997"
15,34,107,5437,780,777,1557,"6 de julio de 1997"
15,34,107,5438,726,719,1445,"6 de julio de 1997"
15,34,107,5440,793,923,1716,"6 de julio de 1997"
15,35,6,151,507,593,1100,"6 de julio de 1997"
15,35,6,152,435,525,960,"6 de julio de 1997"
15,35,6,153,383,428,811,"6 de julio de 1997"
15,35,6,154,426,447,873,"6 de julio de 1997"
15,35,6,155,380,477,857,"6 de julio de 1997"
15,35,12,247,488,511,999,"6 de julio de 1997"
15,35,12,248,706,770,1476,"6 de julio de 1997"
15,35,12,249,612,662,1274,"6 de julio de 1997"
15,35,18,495,421,435,856,"6 de julio de 1997"
15,35,18,496,393,424,817,"6 de julio de 1997"
15,35,18,497,441,512,953,"6 de julio de 1997"
15,35,18,498,391,409,800,"6 de julio de 1997"
15,35,18,499,506,531,1037,"6 de julio de 1997"
15,35,18,500,814,852,1666,"6 de julio de 1997"
15,35,18,501,575,616,1191,"6 de julio de 1997"
15,35,18,502,706,701,1407,"6 de julio de 1997"
15,35,18,503,322,306,628,"6 de julio de 1997"
15,35,18,504,407,443,850,"6 de julio de 1997"
15,35,18,505,702,747,1449,"6 de julio de 1997"
15,35,18,506,624,610,1234,"6 de julio de 1997"
15,35,18,507,399,381,780,"6 de julio de 1997"
15,35,18,508,670,700,1370,"6 de julio de 1997"
15,35,18,509,556,582,1138,"6 de julio de 1997"
15,35,18,510,212,224,436,"6 de julio de 1997"
15,35,19,511,753,798,1551,"6 de julio de 1997"
15,35,19,512,811,872,1683,"6 de julio de 1997"
15,35,19,513,778,903,1681,"6 de julio de 1997"
15,35,19,514,613,693,1306,"6 de julio de 1997"
15,35,19,515,681,732,1413,"6 de julio de 1997"
15,35,19,516,489,560,1049,"6 de julio de 1997"
15,35,19,517,409,489,898,"6 de julio de 1997"
15,35,19,518,761,758,1519,"6 de julio de 1997"
15,35,19,519,174,199,373,"6 de julio de 1997"
15,35,19,520,421,463,884,"6 de julio de 1997"
15,35,19,521,296,273,569,"6 de julio de 1997"
15,35,19,522,491,508,999,"6 de julio de 1997"
15,35,28,1095,860,905,1765,"6 de julio de 1997"
15,35,28,1096,482,545,1027,"6 de julio de 1997"
15,35,44,2236,805,858,1663,"6 de julio de 1997"
15,35,44,2237,845,919,1764,"6 de julio de 1997"
15,35,44,2238,625,684,1309,"6 de julio de 1997"
15,35,44,2239,815,868,1683,"6 de julio de 1997"
15,35,44,2240,501,500,1001,"6 de julio de 1997"
15,35,44,2241,285,291,576,"6 de julio de 1997"
15,35,44,2242,73,62,135,"6 de julio de 1997"
15,35,50,2373,467,591,1058,"6 de julio de 1997"
15,35,50,2374,631,696,1327,"6 de julio de 1997"
15,35,50,2375,530,584,1114,"6 de julio de 1997"
15,35,50,2376,517,517,1034,"6 de julio de 1997"
15,35,50,2377,248,244,492,"6 de julio de 1997"
15,35,53,2432,358,393,751,"6 de julio de 1997"
15,35,53,2433,488,477,965,"6 de julio de 1997"
15,35,53,2434,471,514,985,"6 de julio de 1997"
15,35,53,2435,349,411,760,"6 de julio de 1997"
15,35,53,2436,441,453,894,"6 de julio de 1997"
15,35,53,2437,435,419,854,"6 de julio de 1997"
15,35,53,2438,484,491,975,"6 de julio de 1997"
15,35,53,2439,531,517,1048,"6 de julio de 1997"
15,35,53,2440,151,129,280,"6 de julio de 1997"
15,35,53,2441,97,71,168,"6 de julio de 1997"
15,35,53,2442,142,165,307,"6 de julio de 1997"
15,35,53,2443,328,316,644,"6 de julio de 1997"
15,35,53,2444,208,197,405,"6 de julio de 1997"
15,35,53,2445,126,112,238,"6 de julio de 1997"
15,35,53,2446,331,366,697,"6 de julio de 1997"
15,35,53,2447,97,92,189,"6 de julio de 1997"
15,35,64,3850,666,684,1350,"6 de julio de 1997"
15,35,64,3851,66,61,127,"6 de julio de 1997"
15,35,64,3852,617,614,1231,"6 de julio de 1997"
15,35,64,3853,554,497,1051,"6 de julio de 1997"
15,35,64,3854,879,920,1799,"6 de julio de 1997"
15,35,64,3855,374,370,744,"6 de julio de 1997"
15,35,64,3856,574,575,1149,"6 de julio de 1997"
15,35,64,3857,219,181,400,"6 de julio de 1997"
15,35,64,3858,257,191,448,"6 de julio de 1997"
15,35,64,3859,398,424,822,"6 de julio de 1997"
15,35,64,3860,195,198,393,"6 de julio de 1997"
15,35,64,3861,253,289,542,"6 de julio de 1997"
15,35,64,3862,356,380,736,"6 de julio de 1997"
15,35,73,4018,754,779,1533,"6 de julio de 1997"
15,35,73,4019,535,543,1078,"6 de julio de 1997"
15,35,73,4020,577,548,1125,"6 de julio de 1997"
15,35,73,4021,495,488,983,"6 de julio de 1997"
15,35,74,4022,622,663,1285,"6 de julio de 1997"
15,35,74,4023,814,778,1592,"6 de julio de 1997"
15,35,74,4024,702,705,1407,"6 de julio de 1997"
15,35,74,4025,489,451,940,"6 de julio de 1997"
15,35,89,4429,547,700,1247,"6 de julio de 1997"
15,35,89,4430,765,874,1639,"6 de julio de 1997"
15,35,89,4431,530,616,1146,"6 de julio de 1997"
15,35,89,4432,762,899,1661,"6 de julio de 1997"
15,35,89,4433,347,10,357,"6 de julio de 1997"
15,35,89,4434,450,559,1009,"6 de julio de 1997"
15,35,89,4435,493,585,1078,"6 de julio de 1997"
15,35,89,4436,575,654,1229,"6 de julio de 1997"
15,35,89,4437,831,1013,1844,"6 de julio de 1997"
15,35,89,4438,636,751,1387,"6 de julio de 1997"
15,35,89,4439,696,782,1478,"6 de julio de 1997"
15,35,89,4440,618,720,1338,"6 de julio de 1997"
15,35,89,4441,602,706,1308,"6 de julio de 1997"
15,35,89,4442,553,591,1144,"6 de julio de 1997"
15,35,89,4443,685,728,1413,"6 de julio de 1997"
15,35,89,4444,126,125,251,"6 de julio de 1997"
15,35,89,4445,426,463,889,"6 de julio de 1997"
15,35,89,4446,502,501,1003,"6 de julio de 1997"
15,35,89,4447,380,376,756,"6 de julio de 1997"
15,35,89,4448,716,729,1445,"6 de julio de 1997"
15,35,89,4449,214,182,396,"6 de julio de 1997"
15,35,89,4450,433,457,890,"6 de julio de 1997"
15,35,89,4451,706,804,1510,"6 de julio de 1997"
15,35,89,4452,329,386,715,"6 de julio de 1997"
15,35,89,4453,154,166,320,"6 de julio de 1997"
15,35,89,4454,427,483,910,"6 de julio de 1997"
15,35,89,4455,411,432,843,"6 de julio de 1997"
15,35,89,4456,662,575,1237,"6 de julio de 1997"
15,35,89,4457,100,96,196,"6 de julio de 1997"
15,35,89,4458,585,638,1223,"6 de julio de 1997"
15,35,89,4459,432,513,945,"6 de julio de 1997"
15,35,89,4460,505,596,1101,"6 de julio de 1997"
15,35,89,4461,471,546,1017,"6 de julio de 1997"
15,35,89,4462,197,206,403,"6 de julio de 1997"
15,35,89,4463,242,219,461,"6 de julio de 1997"
15,35,89,4464,108,86,194,"6 de julio de 1997"
15,35,89,4465,187,162,349,"6 de julio de 1997"
15,35,91,4471,614,678,1292,"6 de julio de 1997"
15,35,91,4472,734,805,1539,"6 de julio de 1997"
15,35,91,4473,681,836,1517,"6 de julio de 1997"
15,35,91,4474,708,785,1493,"6 de julio de 1997"
15,35,91,4475,582,680,1262,"6 de julio de 1997"
15,35,91,4476,362,437,799,"6 de julio de 1997"
15,35,91,4477,492,593,1085,"6 de julio de 1997"
15,35,91,4478,468,565,1033,"6 de julio de 1997"
15,35,91,4479,380,438,818,"6 de julio de 1997"
15,35,91,4480,71,91,162,"6 de julio de 1997"
15,35,91,4481,504,501,1005,"6 de julio de 1997"
15,35,91,4482,612,644,1256,"6 de julio de 1997"
15,35,91,4483,574,572,1146,"6 de julio de 1997"
15,35,91,4484,509,540,1049,"6 de julio de 1997"
15,35,91,4485,426,438,864,"6 de julio de 1997"
15,35,91,4486,361,369,730,"6 de julio de 1997"
15,35,91,4487,297,305,602,"6 de julio de 1997"
15,35,91,4488,830,958,1788,"6 de julio de 1997"
15,35,91,4489,220,236,456,"6 de julio de 1997"
15,35,91,4490,387,360,747,"6 de julio de 1997"
15,35,91,4491,535,543,1078,"6 de julio de 1997"
15,35,91,4492,319,306,625,"6 de julio de 1997"
15,35,91,4493,417,421,838,"6 de julio de 1997"
15,35,91,4494,608,668,1276,"6 de julio de 1997"
15,35,91,4495,713,791,1504,"6 de julio de 1997"
15,35,91,4496,391,449,840,"6 de julio de 1997"
15,35,91,4497,521,576,1097,"6 de julio de 1997"
15,35,99,4609,478,527,1005,"6 de julio de 1997"
15,35,99,4610,536,590,1126,"6 de julio de 1997"
15,35,102,4701,854,988,1842,"6 de julio de 1997"
15,35,102,4702,633,741,1374,"6 de julio de 1997"
15,35,102,4703,901,1074,1975,"6 de julio de 1997"
15,35,102,4704,897,895,1792,"6 de julio de 1997"
15,35,102,4705,773,791,1564,"6 de julio de 1997"
15,35,102,4706,539,647,1186,"6 de julio de 1997"
15,35,102,4707,374,381,755,"6 de julio de 1997"
15,35,102,4708,359,420,779,"6 de julio de 1997"
15,35,102,4709,813,849,1662,"6 de julio de 1997"
15,35,102,4710,568,604,1172,"6 de julio de 1997"
15,35,102,4711,484,522,1006,"6 de julio de 1997"
15,35,102,4712,49,58,107,"6 de julio de 1997"
15,35,102,4713,258,240,498,"6 de julio de 1997"
15,35,102,4714,287,260,547,"6 de julio de 1997"
15,35,102,4715,522,562,1084,"6 de julio de 1997"
15,35,102,4716,411,415,826,"6 de julio de 1997"
15,35,102,4717,346,417,763,"6 de julio de 1997"
15,35,102,4718,499,579,1078,"6 de julio de 1997"
15,35,102,4719,411,469,880,"6 de julio de 1997"
15,35,102,4720,711,750,1461,"6 de julio de 1997"
15,35,102,4721,315,322,637,"6 de julio de 1997"
15,35,102,4722,464,448,912,"6 de julio de 1997"
15,35,102,4723,314,311,625,"6 de julio de 1997"
15,35,102,4724,327,314,641,"6 de julio de 1997"
15,35,120,5869,541,620,1161,"6 de julio de 1997"
15,35,120,5870,373,497,870,"6 de julio de 1997"
15,35,120,5871,261,254,515,"6 de julio de 1997"
15,35,120,5872,529,529,1058,"6 de julio de 1997"
15,35,120,5873,309,336,645,"6 de julio de 1997"
15,35,120,5874,164,183,347,"6 de julio de 1997"
15,35,120,5875,147,148,295,"6 de julio de 1997"
15,35,120,5876,92,87,179,"6 de julio de 1997"
15,35,120,5877,277,321,598,"6 de julio de 1997"
15,35,120,5878,210,216,426,"6 de julio de 1997"
15,35,120,5879,189,220,409,"6 de julio de 1997"
15,36,4,82,335,395,730,"6 de julio de 1997"
15,36,4,83,339,396,735,"6 de julio de 1997"
15,36,4,84,358,382,740,"6 de julio de 1997"
15,36,4,85,248,268,516,"6 de julio de 1997"
15,36,4,86,560,686,1246,"6 de julio de 1997"
15,36,4,87,287,397,684,"6 de julio de 1997"
15,36,4,88,251,269,520,"6 de julio de 1997"
15,36,4,89,250,266,516,"6 de julio de 1997"
15,36,4,90,94,89,183,"6 de julio de 1997"
15,36,4,91,60,66,126,"6 de julio de 1997"
15,36,4,92,361,358,719,"6 de julio de 1997"
15,36,4,93,212,216,428,"6 de julio de 1997"
15,36,8,166,582,608,1190,"6 de julio de 1997"
15,36,8,167,535,610,1145,"6 de julio de 1997"
15,36,8,168,121,141,262,"6 de julio de 1997"
15,36,8,169,166,178,344,"6 de julio de 1997"
15,36,8,170,318,339,657,"6 de julio de 1997"
15,36,8,171,687,717,1404,"6 de julio de 1997"
15,36,8,172,174,172,346,"6 de julio de 1997"
15,36,8,173,258,286,544,"6 de julio de 1997"
15,36,8,174,167,148,315,"6 de julio de 1997"
15,36,8,175,454,529,983,"6 de julio de 1997"
15,36,8,176,390,495,885,"6 de julio de 1997"
15,36,8,177,53,44,97,"6 de julio de 1997"
15,36,8,178,144,160,304,"6 de julio de 1997"
15,36,8,179,143,163,306,"6 de julio de 1997"
15,36,8,180,360,389,749,"6 de julio de 1997"
15,36,8,181,213,253,466,"6 de julio de 1997"
15,36,8,182,107,117,224,"6 de julio de 1997"
15,36,8,183,227,196,423,"6 de julio de 1997"
15,36,8,184,430,490,920,"6 de julio de 1997"
15,36,8,185,72,117,189,"6 de julio de 1997"
15,36,8,186,238,259,497,"6 de julio de 1997"
15,36,8,187,222,214,436,"6 de julio de 1997"
15,36,8,188,80,85,165,"6 de julio de 1997"
15,36,8,189,130,153,283,"6 de julio de 1997"
15,36,8,190,220,289,509,"6 de julio de 1997"
15,36,8,191,186,225,411,"6 de julio de 1997"
15,36,8,192,143,169,312,"6 de julio de 1997"
15,36,21,629,549,636,1185,"6 de julio de 1997"
15,36,21,630,587,729,1316,"6 de julio de 1997"
15,36,21,631,423,551,974,"6 de julio de 1997"
15,36,21,632,555,728,1283,"6 de julio de 1997"
15,36,21,633,249,213,462,"6 de julio de 1997"
15,36,21,634,251,238,489,"6 de julio de 1997"
15,36,21,635,233,233,466,"6 de julio de 1997"
15,36,21,636,564,571,1135,"6 de julio de 1997"
15,36,21,637,391,373,764,"6 de julio de 1997"
15,36,21,638,181,206,387,"6 de julio de 1997"
15,36,21,639,391,455,846,"6 de julio de 1997"
15,36,21,640,258,301,559,"6 de julio de 1997"
15,36,21,641,380,392,772,"6 de julio de 1997"
15,36,21,642,335,381,716,"6 de julio de 1997"
15,36,21,643,282,337,619,"6 de julio de 1997"
15,36,21,644,415,450,865,"6 de julio de 1997"
15,36,21,645,283,307,590,"6 de julio de 1997"
15,36,21,646,358,418,776,"6 de julio de 1997"
15,36,21,647,192,144,336,"6 de julio de 1997"
15,36,41,2164,646,729,1375,"6 de julio de 1997"
15,36,41,2165,203,282,485,"6 de julio de 1997"
15,36,41,2166,488,572,1060,"6 de julio de 1997"
15,36,41,2167,404,449,853,"6 de julio de 1997"
15,36,41,2168,366,459,825,"6 de julio de 1997"
15,36,41,2169,345,483,828,"6 de julio de 1997"
15,36,41,2170,531,702,1233,"6 de julio de 1997"
15,36,41,2171,84,72,156,"6 de julio de 1997"
15,36,41,2172,524,582,1106,"6 de julio de 1997"
15,36,41,2173,293,336,629,"6 de julio de 1997"
15,36,41,2174,517,545,1062,"6 de julio de 1997"
15,36,41,2175,218,218,436,"6 de julio de 1997"
15,36,41,2176,290,314,604,"6 de julio de 1997"
15,36,41,2177,78,76,154,"6 de julio de 1997"
15,36,41,2178,283,379,662,"6 de julio de 1997"
15,36,41,2179,310,337,647,"6 de julio de 1997"
15,36,41,2180,185,218,403,"6 de julio de 1997"
15,36,41,2181,159,172,331,"6 de julio de 1997"
15,36,41,2182,170,180,350,"6 de julio de 1997"
15,36,78,4144,519,553,1072,"6 de julio de 1997"
15,36,78,4145,173,192,365,"6 de julio de 1997"
15,36,78,4146,205,196,401,"6 de julio de 1997"
15,36,78,4147,286,273,559,"6 de julio de 1997"
15,36,81,4165,263,311,574,"6 de julio de 1997"
15,36,81,4166,449,502,951,"6 de julio de 1997"
15,36,81,4167,477,537,1014,"6 de julio de 1997"
15,36,81,4168,175,189,364,"6 de julio de 1997"
15,36,81,4169,358,410,768,"6 de julio de 1997"
15,36,81,4170,496,512,1008,"6 de julio de 1997"
15,36,81,4171,94,105,199,"6 de julio de 1997"
15,36,81,4172,103,105,208,"6 de julio de 1997"
15,36,81,4173,120,150,270,"6 de julio de 1997"
15,36,81,4174,340,418,758,"6 de julio de 1997"
15,36,81,4175,190,185,375,"6 de julio de 1997"
15,36,81,4176,274,328,602,"6 de julio de 1997"
15,36,81,4177,172,211,383,"6 de julio de 1997"
15,36,81,4178,362,412,774,"6 de julio de 1997"
15,36,81,4179,206,200,406,"6 de julio de 1997"
15,36,81,4180,199,217,416,"6 de julio de 1997"
15,36,81,4181,244,276,520,"6 de julio de 1997"
15,36,81,4182,135,161,296,"6 de julio de 1997"
15,36,81,4183,239,230,469,"6 de julio de 1997"
15,36,81,4184,154,144,298,"6 de julio de 1997"
15,36,81,4185,161,156,317,"6 de julio de 1997"
15,36,81,4186,139,123,262,"6 de julio de 1997"
15,36,81,4187,124,122,246,"6 de julio de 1997"
15,36,83,4256,384,463,847,"6 de julio de 1997"
15,36,83,4257,454,546,1000,"6 de julio de 1997"
15,36,83,4258,512,651,1163,"6 de julio de 1997"
15,36,83,4259,666,808,1474,"6 de julio de 1997"
15,36,83,4260,565,629,1194,"6 de julio de 1997"
15,36,83,4261,385,483,868,"6 de julio de 1997"
15,36,83,4262,583,683,1266,"6 de julio de 1997"
15,36,83,4263,524,673,1197,"6 de julio de 1997"
15,36,83,4264,348,434,782,"6 de julio de 1997"
15,36,83,4265,468,569,1037,"6 de julio de 1997"
15,36,83,4266,123,97,220,"6 de julio de 1997"
15,36,83,4267,181,162,343,"6 de julio de 1997"
15,36,83,4268,222,171,393,"6 de julio de 1997"
15,36,83,4269,113,101,214,"6 de julio de 1997"
15,36,83,4270,379,384,763,"6 de julio de 1997"
15,36,83,4271,405,436,841,"6 de julio de 1997"
15,36,83,4272,288,290,578,"6 de julio de 1997"
15,36,83,4273,130,134,264,"6 de julio de 1997"
15,36,83,4274,238,228,466,"6 de julio de 1997"
15,36,83,4275,277,305,582,"6 de julio de 1997"
15,36,83,4276,193,184,377,"6 de julio de 1997"
15,36,83,4277,304,311,615,"6 de julio de 1997"
15,36,83,4278,387,392,779,"6 de julio de 1997"
15,36,83,4279,153,182,335,"6 de julio de 1997"
15,36,83,4280,221,225,446,"6 de julio de 1997"
15,36,83,4281,341,375,716,"6 de julio de 1997"
15,36,83,4282,152,148,300,"6 de julio de 1997"
15,36,83,4283,287,329,616,"6 de julio de 1997"
15,36,83,4284,416,483,899,"6 de julio de 1997"
15,36,83,4285,504,580,1084,"6 de julio de 1997"
15,36,83,4286,508,629,1137,"6 de julio de 1997"
15,36,83,4287,555,614,1169,"6 de julio de 1997"
15,36,83,4288,104,97,201,"6 de julio de 1997"
15,36,83,4289,242,282,524,"6 de julio de 1997"
15,36,83,4290,335,378,713,"6 de julio de 1997"
15,36,83,4291,303,341,644,"6 de julio de 1997"
15,36,83,4292,269,265,534,"6 de julio de 1997"
15,36,83,4293,271,262,533,"6 de julio de 1997"
15,36,83,4294,577,720,1297,"6 de julio de 1997"
15,36,83,4295,266,346,612,"6 de julio de 1997"
15,36,83,4296,72,82,154,"6 de julio de 1997"
15,36,83,4297,160,178,338,"6 de julio de 1997"
15,36,83,4298,436,467,903,"6 de julio de 1997"
15,36,83,4299,123,174,297,"6 de julio de 1997"
15,36,83,4300,361,404,765,"6 de julio de 1997"
15,36,83,4301,243,264,507,"6 de julio de 1997"
15,36,83,4302,143,154,297,"6 de julio de 1997"
15,36,83,4303,118,116,234,"6 de julio de 1997"
15,36,83,4304,172,185,357,"6 de julio de 1997"
15,36,83,4305,145,148,293,"6 de julio de 1997"
15,36,83,4306,100,106,206,"6 de julio de 1997"
15,36,83,4307,106,133,239,"6 de julio de 1997"
15,36,83,4308,186,261,447,"6 de julio de 1997"
15,36,83,4309,450,543,993,"6 de julio de 1997"
15,36,83,4310,78,89,167,"6 de julio de 1997"
15,36,83,4311,31,29,60,"6 de julio de 1997"
15,36,83,4312,145,178,323,"6 de julio de 1997"
15,36,83,4313,119,109,228,"6 de julio de 1997"
15,36,83,4314,485,555,1040,"6 de julio de 1997"
15,36,83,4315,458,510,968,"6 de julio de 1997"
15,36,83,4316,336,280,616,"6 de julio de 1997"
15,36,83,4317,119,108,227,"6 de julio de 1997"
15,36,83,4318,265,222,487,"6 de julio de 1997"
15,36,83,4319,185,213,398,"6 de julio de 1997"
15,36,83,4320,43,55,98,"6 de julio de 1997"
15,36,83,4321,126,142,268,"6 de julio de 1997"
15,36,83,4322,89,78,167,"6 de julio de 1997"
15,36,83,4323,257,314,571,"6 de julio de 1997"
15,36,83,4324,188,210,398,"6 de julio de 1997"
15,36,83,4325,233,279,512,"6 de julio de 1997"
15,36,98,4601,754,762,1516,"6 de julio de 1997"
15,36,98,4602,354,344,698,"6 de julio de 1997"
15,36,98,4603,486,487,973,"6 de julio de 1997"
15,36,98,4604,581,568,1149,"6 de julio de 1997"
15,36,98,4605,317,340,657,"6 de julio de 1997"
15,36,98,4606,264,272,536,"6 de julio de 1997"
15,36,98,4607,309,307,616,"6 de julio de 1997"
15,36,98,4608,358,333,691,"6 de julio de 1997"
15,36,106,5137,468,448,916,"6 de julio de 1997"
15,36,106,5138,434,465,899,"6 de julio de 1997"
15,36,106,5139,291,312,603,"6 de julio de 1997"
15,36,106,5140,189,181,370,"6 de julio de 1997"
15,36,106,5141,237,262,499,"6 de julio de 1997"
15,36,106,5142,191,236,427,"6 de julio de 1997"
15,36,106,5143,420,508,928,"6 de julio de 1997"
15,36,106,5144,121,143,264,"6 de julio de 1997"
15,36,106,5145,288,292,580,"6 de julio de 1997"
15,36,106,5146,186,199,385,"6 de julio de 1997"
15,36,106,5147,330,346,676,"6 de julio de 1997"
15,36,106,5148,612,692,1304,"6 de julio de 1997"
15,36,106,5149,49,46,95,"6 de julio de 1997"
15,36,106,5150,142,154,296,"6 de julio de 1997"
15,36,106,5151,263,289,552,"6 de julio de 1997"
15,36,106,5152,230,252,482,"6 de julio de 1997"
15,36,106,5153,361,423,784,"6 de julio de 1997"
15,36,106,5154,168,184,352,"6 de julio de 1997"
15,36,106,5155,204,212,416,"6 de julio de 1997"
15,36,106,5156,191,206,397,"6 de julio de 1997"
15,36,106,5157,325,382,707,"6 de julio de 1997"
15,36,106,5158,260,290,550,"6 de julio de 1997"
15,36,106,5159,219,257,476,"6 de julio de 1997"
15,36,106,5160,152,173,325,"6 de julio de 1997"
15,36,106,5161,364,382,746,"6 de julio de 1997"
15,36,106,5162,108,128,236,"6 de julio de 1997"
15,36,106,5163,320,406,726,"6 de julio de 1997"
15,36,106,5164,188,186,374,"6 de julio de 1997"
15,36,106,5165,200,219,419,"6 de julio de 1997"
15,36,106,5166,140,151,291,"6 de julio de 1997"
15,36,106,5167,157,189,346,"6 de julio de 1997"
15,36,106,5168,188,200,388,"6 de julio de 1997"
15,36,108,5443,431,542,973,"6 de julio de 1997"
15,36,108,5444,428,499,927,"6 de julio de 1997"
15,36,108,5445,442,538,980,"6 de julio de 1997"
15,36,108,5446,361,429,790,"6 de julio de 1997"
15,36,108,5447,321,409,730,"6 de julio de 1997"
15,36,108,5448,187,173,360,"6 de julio de 1997"
15,36,108,5449,277,294,571,"6 de julio de 1997"
15,36,108,5450,328,370,698,"6 de julio de 1997"
15,36,108,5451,133,147,280,"6 de julio de 1997"
15,36,114,5723,807,972,1779,"6 de julio de 1997"
15,36,114,5724,533,646,1179,"6 de julio de 1997"
15,36,114,5725,325,358,683,"6 de julio de 1997"
15,36,114,5726,639,728,1367,"6 de julio de 1997"
15,36,114,5727,593,537,1130,"6 de julio de 1997"
15,36,114,5728,399,408,807,"6 de julio de 1997"
15,36,114,5729,207,189,396,"6 de julio de 1997"
15,36,114,5730,511,520,1031,"6 de julio de 1997"
15,36,114,5731,271,298,569,"6 de julio de 1997"
15,36,114,5732,509,551,1060,"6 de julio de 1997"
15,36,114,5733,464,480,944,"6 de julio de 1997"
15,36,114,5734,302,326,628,"6 de julio de 1997"
15,36,114,5735,652,753,1405,"6 de julio de 1997"
15,36,114,5736,423,435,858,"6 de julio de 1997"
15,36,114,5737,289,299,588,"6 de julio de 1997"
15,36,114,5738,523,613,1136,"6 de julio de 1997"
15,36,114,5739,310,334,644,"6 de julio de 1997"
15,36,114,5740,554,598,1152,"6 de julio de 1997"
15,36,114,5741,349,375,724,"6 de julio de 1997"
15,36,114,5742,431,501,932,"6 de julio de 1997"
15,36,114,5743,235,257,492,"6 de julio de 1997"
15,36,114,5744,326,333,659,"6 de julio de 1997"
15,36,114,5745,223,226,449,"6 de julio de 1997"
15,36,114,5746,178,171,349,"6 de julio de 1997"
15,36,114,5747,120,103,223,"6 de julio de 1997"
15,36,118,5807,340,402,742,"6 de julio de 1997"
15,36,118,5808,573,684,1257,"6 de julio de 1997"
15,36,118,5809,353,330,683,"6 de julio de 1997"
15,36,118,5810,321,337,658,"6 de julio de 1997"
15,36,118,5811,191,191,382,"6 de julio de 1997"
15,36,118,5812,211,244,455,"6 de julio de 1997"
15,36,118,5813,90,104,194,"6 de julio de 1997"
15,36,118,5814,77,73,150,"6 de julio de 1997"
15,36,118,5815,75,83,158,"6 de julio de 1997"
15,36,118,5816,308,341,649,"6 de julio de 1997"
15,36,118,5817,213,217,430,"6 de julio de 1997"
15,36,118,5818,298,321,619,"6 de julio de 1997"
15,36,118,5819,164,214,378,"6 de julio de 1997"
15,36,118,5820,177,200,377,"6 de julio de 1997"
15,36,118,5821,91,87,178,"6 de julio de 1997"
16,1,11,184,484,580,1064,"6 de julio de 1997"
16,1,11,185,625,678,1303,"6 de julio de 1997"
16,1,11,186,262,322,584,"6 de julio de 1997"
16,1,11,187,254,312,566,"6 de julio de 1997"
16,1,11,188,504,622,1126,"6 de julio de 1997"
16,1,11,189,446,535,981,"6 de julio de 1997"
16,1,28,411,390,502,892,"6 de julio de 1997"
16,1,28,412,378,448,826,"6 de julio de 1997"
16,1,28,413,318,379,697,"6 de julio de 1997"
16,1,28,414,355,510,865,"6 de julio de 1997"
16,1,28,415,49,59,108,"6 de julio de 1997"
16,1,28,416,246,420,666,"6 de julio de 1997"
16,1,28,417,279,367,646,"6 de julio de 1997"
16,1,28,418,236,306,542,"6 de julio de 1997"
16,1,28,419,126,137,263,"6 de julio de 1997"
16,1,30,433,363,499,862,"6 de julio de 1997"
16,1,30,434,260,383,643,"6 de julio de 1997"
16,1,30,435,206,286,492,"6 de julio de 1997"
16,1,30,436,475,651,1126,"6 de julio de 1997"
16,1,30,437,274,435,709,"6 de julio de 1997"
16,1,30,438,263,391,654,"6 de julio de 1997"
16,1,30,439,661,1006,1667,"6 de julio de 1997"
16,1,30,440,399,568,967,"6 de julio de 1997"
16,1,30,441,260,349,609,"6 de julio de 1997"
16,1,30,442,240,328,568,"6 de julio de 1997"
16,1,30,443,196,261,457,"6 de julio de 1997"
16,1,30,444,229,336,565,"6 de julio de 1997"
16,1,30,445,212,321,533,"6 de julio de 1997"
16,1,61,1369,563,709,1272,"6 de julio de 1997"
16,1,61,1370,737,849,1586,"6 de julio de 1997"
16,1,61,1371,76,90,166,"6 de julio de 1997"
16,1,61,1372,98,122,220,"6 de julio de 1997"
16,1,61,1373,605,749,1354,"6 de julio de 1997"
16,1,61,1374,188,207,395,"6 de julio de 1997"
16,1,61,1375,231,248,479,"6 de julio de 1997"
16,1,61,1376,204,221,425,"6 de julio de 1997"
16,1,61,1377,233,266,499,"6 de julio de 1997"
16,1,68,1498,330,433,763,"6 de julio de 1997"
16,1,68,1499,213,288,501,"6 de julio de 1997"
16,1,68,1500,354,481,835,"6 de julio de 1997"
16,1,68,1501,323,475,798,"6 de julio de 1997"
16,1,68,1502,194,248,442,"6 de julio de 1997"
16,1,68,1503,344,445,789,"6 de julio de 1997"
16,1,68,1504,387,499,886,"6 de julio de 1997"
16,1,68,1505,229,291,520,"6 de julio de 1997"
16,1,68,1506,347,417,764,"6 de julio de 1997"
16,1,68,1507,484,644,1128,"6 de julio de 1997"
16,1,68,1508,518,561,1079,"6 de julio de 1997"
16,1,68,1509,244,300,544,"6 de julio de 1997"
16,1,68,1510,144,184,328,"6 de julio de 1997"
16,1,68,1511,216,293,509,"6 de julio de 1997"
16,1,68,1512,326,490,816,"6 de julio de 1997"
16,1,68,1513,238,360,598,"6 de julio de 1997"
16,1,68,1514,232,297,529,"6 de julio de 1997"
16,1,68,1515,239,283,522,"6 de julio de 1997"
16,1,68,1516,218,301,519,"6 de julio de 1997"
16,1,70,1529,527,581,1108,"6 de julio de 1997"
16,1,70,1530,775,916,1691,"6 de julio de 1997"
16,1,70,1531,581,680,1261,"6 de julio de 1997"
16,1,70,1532,542,603,1145,"6 de julio de 1997"
16,1,70,1533,436,460,896,"6 de julio de 1997"
16,1,70,1534,513,564,1077,"6 de julio de 1997"
16,1,70,1535,605,724,1329,"6 de julio de 1997"
16,1,70,1536,377,469,846,"6 de julio de 1997"
16,1,70,1537,611,785,1396,"6 de julio de 1997"
16,1,70,1538,427,487,914,"6 de julio de 1997"
16,1,70,1539,404,514,918,"6 de julio de 1997"
16,1,70,1540,358,429,787,"6 de julio de 1997"
16,1,70,1541,572,660,1232,"6 de julio de 1997"
16,1,70,1542,197,211,408,"6 de julio de 1997"
16,1,70,1543,821,944,1765,"6 de julio de 1997"
16,1,70,1544,491,575,1066,"6 de julio de 1997"
16,1,70,1545,554,592,1146,"6 de julio de 1997"
16,1,70,1546,429,551,980,"6 de julio de 1997"
16,1,70,1547,380,522,902,"6 de julio de 1997"
16,1,70,1548,343,412,755,"6 de julio de 1997"
16,1,70,1549,233,249,482,"6 de julio de 1997"
16,1,70,1550,269,349,618,"6 de julio de 1997"
16,1,70,1551,257,311,568,"6 de julio de 1997"
16,1,70,1552,472,574,1046,"6 de julio de 1997"
16,1,70,1553,401,491,892,"6 de julio de 1997"
16,1,70,1554,298,374,672,"6 de julio de 1997"
16,1,70,1555,384,455,839,"6 de julio de 1997"
16,1,70,1556,299,384,683,"6 de julio de 1997"
16,1,70,1557,301,370,671,"6 de julio de 1997"
16,1,70,1558,286,323,609,"6 de julio de 1997"
16,1,70,1559,337,431,768,"6 de julio de 1997"
16,1,70,1560,382,413,795,"6 de julio de 1997"
16,1,70,1561,371,443,814,"6 de julio de 1997"
16,1,70,1562,361,450,811,"6 de julio de 1997"
16,1,70,1563,448,593,1041,"6 de julio de 1997"
16,1,70,1564,310,362,672,"6 de julio de 1997"
16,1,70,1565,338,465,803,"6 de julio de 1997"
16,1,70,1566,561,735,1296,"6 de julio de 1997"
16,1,70,1567,614,780,1394,"6 de julio de 1997"
16,1,70,1568,565,701,1266,"6 de julio de 1997"
16,1,70,1569,323,407,730,"6 de julio de 1997"
16,1,70,1570,427,485,912,"6 de julio de 1997"
16,1,70,1571,577,696,1273,"6 de julio de 1997"
16,1,70,1572,672,799,1471,"6 de julio de 1997"
16,1,70,1573,552,783,1335,"6 de julio de 1997"
16,1,70,1574,129,151,280,"6 de julio de 1997"
16,1,70,1575,148,189,337,"6 de julio de 1997"
16,1,70,1576,264,349,613,"6 de julio de 1997"
16,1,70,1577,354,461,815,"6 de julio de 1997"
16,1,70,1578,186,241,427,"6 de julio de 1997"
16,1,70,1579,184,232,416,"6 de julio de 1997"
16,1,70,1580,253,344,597,"6 de julio de 1997"
16,1,70,1581,116,141,257,"6 de julio de 1997"
16,1,70,1582,83,103,186,"6 de julio de 1997"
16,1,70,1583,315,399,714,"6 de julio de 1997"
16,1,70,1584,473,649,1122,"6 de julio de 1997"
16,1,70,1585,148,212,360,"6 de julio de 1997"
16,1,70,1586,252,430,682,"6 de julio de 1997"
16,1,70,1587,481,827,1308,"6 de julio de 1997"
16,1,70,1588,122,157,279,"6 de julio de 1997"
16,1,70,1589,458,540,998,"6 de julio de 1997"
16,1,71,1590,329,382,711,"6 de julio de 1997"
16,1,71,1591,246,314,560,"6 de julio de 1997"
16,1,71,1592,522,611,1133,"6 de julio de 1997"
16,1,71,1593,566,661,1227,"6 de julio de 1997"
16,1,71,1594,430,493,923,"6 de julio de 1997"
16,1,71,1595,406,500,906,"6 de julio de 1997"
16,1,71,1596,412,521,933,"6 de julio de 1997"
16,1,71,1597,576,630,1206,"6 de julio de 1997"
16,1,71,1598,511,571,1082,"6 de julio de 1997"
16,1,71,1599,169,224,393,"6 de julio de 1997"
16,1,71,1600,237,315,552,"6 de julio de 1997"
16,1,87,1939,630,692,1322,"6 de julio de 1997"
16,1,87,1940,212,250,462,"6 de julio de 1997"
16,1,87,1941,432,460,892,"6 de julio de 1997"
16,1,87,1942,482,516,998,"6 de julio de 1997"
16,1,87,1943,391,467,858,"6 de julio de 1997"
16,1,87,1944,408,403,811,"6 de julio de 1997"
16,1,87,1945,495,517,1012,"6 de julio de 1997"
16,1,87,1946,287,362,649,"6 de julio de 1997"
16,1,87,1947,320,393,713,"6 de julio de 1997"
16,1,87,1948,261,344,605,"6 de julio de 1997"
16,1,87,1949,236,250,486,"6 de julio de 1997"
16,1,95,2040,262,321,583,"6 de julio de 1997"
16,1,95,2041,203,265,468,"6 de julio de 1997"
16,1,95,2042,221,284,505,"6 de julio de 1997"
16,1,95,2043,279,341,620,"6 de julio de 1997"
16,1,95,2044,377,482,859,"6 de julio de 1997"
16,1,95,2045,154,175,329,"6 de julio de 1997"
16,1,95,2046,168,214,382,"6 de julio de 1997"
16,1,95,2047,139,142,281,"6 de julio de 1997"
16,1,95,2048,280,331,611,"6 de julio de 1997"
16,1,95,2049,221,341,562,"6 de julio de 1997"
16,1,95,2050,254,266,520,"6 de julio de 1997"
16,1,95,2051,284,342,626,"6 de julio de 1997"
16,1,106,2357,519,547,1066,"6 de julio de 1997"
16,1,106,2358,335,386,721,"6 de julio de 1997"
16,1,106,2359,273,287,560,"6 de julio de 1997"
16,1,106,2360,524,548,1072,"6 de julio de 1997"
16,1,106,2361,689,778,1467,"6 de julio de 1997"
16,1,106,2362,507,593,1100,"6 de julio de 1997"
16,1,106,2363,323,343,666,"6 de julio de 1997"
16,1,106,2364,198,186,384,"6 de julio de 1997"
16,1,106,2365,444,563,1007,"6 de julio de 1997"
16,1,106,2366,310,382,692,"6 de julio de 1997"
16,1,106,2367,300,335,635,"6 de julio de 1997"
16,1,106,2368,287,301,588,"6 de julio de 1997"
16,1,106,2369,495,512,1007,"6 de julio de 1997"
16,1,107,2370,356,393,749,"6 de julio de 1997"
16,1,107,2371,338,389,727,"6 de julio de 1997"
16,1,107,2372,291,334,625,"6 de julio de 1997"
16,1,107,2373,540,637,1177,"6 de julio de 1997"
16,1,107,2374,308,329,637,"6 de julio de 1997"
16,1,107,2375,506,554,1060,"6 de julio de 1997"
16,1,107,2376,312,395,707,"6 de julio de 1997"
16,1,107,2377,387,463,850,"6 de julio de 1997"
16,1,107,2378,469,514,983,"6 de julio de 1997"
16,1,107,2379,652,682,1334,"6 de julio de 1997"
16,1,107,2380,779,839,1618,"6 de julio de 1997"
16,1,107,2381,323,329,652,"6 de julio de 1997"
16,1,107,2382,99,113,212,"6 de julio de 1997"
16,1,107,2383,449,466,915,"6 de julio de 1997"
16,1,107,2384,361,367,728,"6 de julio de 1997"
16,1,107,2385,277,269,546,"6 de julio de 1997"
16,1,107,2386,318,302,620,"6 de julio de 1997"
16,1,107,2387,150,194,344,"6 de julio de 1997"
16,1,107,2388,191,228,419,"6 de julio de 1997"
16,1,110,2531,244,312,556,"6 de julio de 1997"
16,1,110,2532,235,330,565,"6 de julio de 1997"
16,1,110,2533,199,274,473,"6 de julio de 1997"
16,1,110,2534,81,117,198,"6 de julio de 1997"
16,1,110,2535,128,178,306,"6 de julio de 1997"
16,1,110,2536,194,248,442,"6 de julio de 1997"
16,1,110,2537,269,352,621,"6 de julio de 1997"
16,2,3,26,531,656,1187,"6 de julio de 1997"
16,2,3,27,647,778,1425,"6 de julio de 1997"
16,2,3,28,606,715,1321,"6 de julio de 1997"
16,2,3,29,307,334,641,"6 de julio de 1997"
16,2,3,30,342,437,779,"6 de julio de 1997"
16,2,3,31,444,523,967,"6 de julio de 1997"
16,2,3,32,457,520,977,"6 de julio de 1997"
16,2,3,33,326,376,702,"6 de julio de 1997"
16,2,3,34,399,503,902,"6 de julio de 1997"
16,2,3,35,402,540,942,"6 de julio de 1997"
16,2,3,36,366,453,819,"6 de julio de 1997"
16,2,3,37,269,316,585,"6 de julio de 1997"
16,2,4,38,327,368,695,"6 de julio de 1997"
16,2,4,39,411,468,879,"6 de julio de 1997"
16,2,4,40,297,368,665,"6 de julio de 1997"
16,2,4,41,473,580,1053,"6 de julio de 1997"
16,2,4,42,312,348,660,"6 de julio de 1997"
16,2,4,43,409,481,890,"6 de julio de 1997"
16,2,4,44,203,237,440,"6 de julio de 1997"
16,2,4,45,668,744,1412,"6 de julio de 1997"
16,2,4,46,234,236,470,"6 de julio de 1997"
16,2,4,47,47,56,103,"6 de julio de 1997"
16,2,4,48,120,165,285,"6 de julio de 1997"
16,2,4,49,178,192,370,"6 de julio de 1997"
16,2,4,50,253,348,601,"6 de julio de 1997"
16,2,4,51,355,401,756,"6 de julio de 1997"
16,2,18,299,333,427,760,"6 de julio de 1997"
16,2,18,300,343,412,755,"6 de julio de 1997"
16,2,18,301,468,628,1096,"6 de julio de 1997"
16,2,18,302,368,479,847,"6 de julio de 1997"
16,2,18,303,378,405,783,"6 de julio de 1997"
16,2,18,304,446,497,943,"6 de julio de 1997"
16,2,20,324,620,694,1314,"6 de julio de 1997"
16,2,20,325,303,366,669,"6 de julio de 1997"
16,2,20,326,416,491,907,"6 de julio de 1997"
16,2,20,327,317,416,733,"6 de julio de 1997"
16,2,20,328,350,427,777,"6 de julio de 1997"
16,2,20,329,328,398,726,"6 de julio de 1997"
16,2,20,330,281,418,699,"6 de julio de 1997"
16,2,20,331,447,607,1054,"6 de julio de 1997"
16,2,20,332,314,461,775,"6 de julio de 1997"
16,2,20,333,475,757,1232,"6 de julio de 1997"
16,2,20,334,38,85,123,"6 de julio de 1997"
16,2,20,335,275,365,640,"6 de julio de 1997"
16,2,20,336,259,358,617,"6 de julio de 1997"
16,2,20,337,608,669,1277,"6 de julio de 1997"
16,2,20,338,538,710,1248,"6 de julio de 1997"
16,2,20,339,516,590,1106,"6 de julio de 1997"
16,2,27,405,309,387,696,"6 de julio de 1997"
16,2,27,406,306,363,669,"6 de julio de 1997"
16,2,27,407,439,597,1036,"6 de julio de 1997"
16,2,27,408,277,340,617,"6 de julio de 1997"
16,2,27,409,566,656,1222,"6 de julio de 1997"
16,2,27,410,246,301,547,"6 de julio de 1997"
16,2,36,580,208,300,508,"6 de julio de 1997"
16,2,36,581,347,481,828,"6 de julio de 1997"
16,2,36,582,245,324,569,"6 de julio de 1997"
16,2,36,583,288,374,662,"6 de julio de 1997"
16,2,36,584,320,416,736,"6 de julio de 1997"
16,2,36,585,245,305,550,"6 de julio de 1997"
16,2,36,586,371,519,890,"6 de julio de 1997"
16,2,36,587,225,349,574,"6 de julio de 1997"
16,2,36,588,337,441,778,"6 de julio de 1997"
16,2,36,589,406,639,1045,"6 de julio de 1997"
16,2,46,756,422,454,876,"6 de julio de 1997"
16,2,46,757,274,277,551,"6 de julio de 1997"
16,2,46,758,662,853,1515,"6 de julio de 1997"
16,2,46,759,466,572,1038,"6 de julio de 1997"
16,2,46,760,739,870,1609,"6 de julio de 1997"
16,2,46,761,392,468,860,"6 de julio de 1997"
16,2,46,762,448,568,1016,"6 de julio de 1997"
16,2,46,763,282,365,647,"6 de julio de 1997"
16,2,46,764,559,711,1270,"6 de julio de 1997"
16,2,46,765,420,472,892,"6 de julio de 1997"
16,2,46,766,579,701,1280,"6 de julio de 1997"
16,2,46,767,79,101,180,"6 de julio de 1997"
16,2,46,768,190,231,421,"6 de julio de 1997"
16,2,46,769,400,498,898,"6 de julio de 1997"
16,2,46,770,572,696,1268,"6 de julio de 1997"
16,2,46,771,392,497,889,"6 de julio de 1997"
16,2,46,772,411,448,859,"6 de julio de 1997"
16,2,46,773,384,393,777,"6 de julio de 1997"
16,2,55,1288,313,411,724,"6 de julio de 1997"
16,2,55,1289,392,555,947,"6 de julio de 1997"
16,2,55,1290,245,333,578,"6 de julio de 1997"
16,2,55,1291,183,276,459,"6 de julio de 1997"
16,2,55,1292,467,706,1173,"6 de julio de 1997"
16,2,55,1293,343,467,810,"6 de julio de 1997"
16,2,55,1294,240,362,602,"6 de julio de 1997"
16,2,55,1295,306,427,733,"6 de julio de 1997"
16,2,55,1296,267,340,607,"6 de julio de 1997"
16,2,64,1407,64,50,114,"6 de julio de 1997"
16,2,64,1408,62,70,132,"6 de julio de 1997"
16,2,64,1409,307,371,678,"6 de julio de 1997"
16,2,64,1410,204,259,463,"6 de julio de 1997"
16,2,64,1411,302,401,703,"6 de julio de 1997"
16,2,64,1412,360,446,806,"6 de julio de 1997"
16,2,64,1413,416,489,905,"6 de julio de 1997"
16,2,64,1414,294,436,730,"6 de julio de 1997"
16,2,64,1415,191,253,444,"6 de julio de 1997"
16,2,64,1416,62,93,155,"6 de julio de 1997"
16,2,64,1417,359,480,839,"6 de julio de 1997"
16,2,64,1418,190,235,425,"6 de julio de 1997"
16,2,64,1419,277,311,588,"6 de julio de 1997"
16,2,64,1420,134,179,313,"6 de julio de 1997"
16,2,64,1421,447,639,1086,"6 de julio de 1997"
16,2,64,1422,152,210,362,"6 de julio de 1997"
16,2,64,1423,185,227,412,"6 de julio de 1997"
16,2,64,1424,338,450,788,"6 de julio de 1997"
16,2,64,1425,339,429,768,"6 de julio de 1997"
16,2,72,1601,321,380,701,"6 de julio de 1997"
16,2,72,1602,630,797,1427,"6 de julio de 1997"
16,2,72,1603,482,534,1016,"6 de julio de 1997"
16,2,72,1604,433,558,991,"6 de julio de 1997"
16,2,72,1605,328,428,756,"6 de julio de 1997"
16,2,72,1606,391,495,886,"6 de julio de 1997"
16,2,72,1607,653,833,1486,"6 de julio de 1997"
16,2,72,1608,538,606,1144,"6 de julio de 1997"
16,2,72,1609,759,833,1592,"6 de julio de 1997"
16,2,72,1610,342,432,774,"6 de julio de 1997"
16,2,72,1611,602,764,1366,"6 de julio de 1997"
16,2,72,1612,360,444,804,"6 de julio de 1997"
16,2,72,1613,661,794,1455,"6 de julio de 1997"
16,2,72,1614,313,344,657,"6 de julio de 1997"
16,2,72,1615,596,679,1275,"6 de julio de 1997"
16,2,72,1616,361,434,795,"6 de julio de 1997"
16,2,72,1617,281,354,635,"6 de julio de 1997"
16,2,72,1618,396,483,879,"6 de julio de 1997"
16,2,72,1619,313,393,706,"6 de julio de 1997"
16,2,72,1620,304,348,652,"6 de julio de 1997"
16,2,72,1621,272,388,660,"6 de julio de 1997"
16,2,72,1622,131,261,392,"6 de julio de 1997"
16,2,72,1623,462,607,1069,"6 de julio de 1997"
16,2,72,1624,655,797,1452,"6 de julio de 1997"
16,2,72,1625,698,789,1487,"6 de julio de 1997"
16,2,72,1626,301,386,687,"6 de julio de 1997"
16,2,72,1627,137,150,287,"6 de julio de 1997"
16,2,72,1628,285,366,651,"6 de julio de 1997"
16,2,72,1629,415,524,939,"6 de julio de 1997"
16,2,72,1630,175,226,401,"6 de julio de 1997"
16,2,72,1631,277,326,603,"6 de julio de 1997"
16,2,72,1632,386,456,842,"6 de julio de 1997"
16,2,72,1633,461,560,1021,"6 de julio de 1997"
16,2,72,1634,255,409,664,"6 de julio de 1997"
16,2,72,1635,391,587,978,"6 de julio de 1997"
16,2,72,1636,439,556,995,"6 de julio de 1997"
16,2,72,1637,622,816,1438,"6 de julio de 1997"
16,2,72,1638,617,648,1265,"6 de julio de 1997"
16,2,72,1639,217,254,471,"6 de julio de 1997"
16,2,72,1640,331,422,753,"6 de julio de 1997"
16,2,72,1641,324,406,730,"6 de julio de 1997"
16,2,72,1642,240,322,562,"6 de julio de 1997"
16,2,72,1643,330,422,752,"6 de julio de 1997"
16,2,72,1644,272,422,694,"6 de julio de 1997"
16,2,72,1645,281,406,687,"6 de julio de 1997"
16,2,72,1646,387,562,949,"6 de julio de 1997"
16,2,79,1788,207,274,481,"6 de julio de 1997"
16,2,79,1789,460,578,1038,"6 de julio de 1997"
16,2,79,1790,570,700,1270,"6 de julio de 1997"
16,2,79,1791,553,660,1213,"6 de julio de 1997"
16,2,79,1792,378,601,979,"6 de julio de 1997"
16,2,79,1793,265,439,704,"6 de julio de 1997"
16,2,79,1794,78,72,150,"6 de julio de 1997"
16,2,79,1795,414,576,990,"6 de julio de 1997"
16,2,79,1796,292,372,664,"6 de julio de 1997"
16,2,79,1797,205,267,472,"6 de julio de 1997"
16,2,79,1798,210,288,498,"6 de julio de 1997"
16,2,89,1959,396,530,926,"6 de julio de 1997"
16,2,89,1960,384,524,908,"6 de julio de 1997"
16,2,89,1961,393,498,891,"6 de julio de 1997"
16,2,89,1962,383,529,912,"6 de julio de 1997"
16,2,89,1963,413,592,1005,"6 de julio de 1997"
16,2,89,1964,240,302,542,"6 de julio de 1997"
16,2,89,1965,462,552,1014,"6 de julio de 1997"
16,2,89,1966,563,609,1172,"6 de julio de 1997"
16,2,89,1967,766,763,1529,"6 de julio de 1997"
16,2,89,1968,200,283,483,"6 de julio de 1997"
16,2,89,1969,275,380,655,"6 de julio de 1997"
16,2,89,1970,363,430,793,"6 de julio de 1997"
16,2,89,1971,651,643,1294,"6 de julio de 1997"
16,2,89,1972,337,477,814,"6 de julio de 1997"
16,2,89,1973,226,285,511,"6 de julio de 1997"
16,2,89,1974,461,477,938,"6 de julio de 1997"
16,2,89,1975,430,509,939,"6 de julio de 1997"
16,2,89,1976,424,501,925,"6 de julio de 1997"
16,2,89,1977,566,640,1206,"6 de julio de 1997"
16,2,89,1978,269,312,581,"6 de julio de 1997"
16,3,5,52,361,403,764,"6 de julio de 1997"
16,3,5,53,343,355,698,"6 de julio de 1997"
16,3,5,54,297,352,649,"6 de julio de 1997"
16,3,5,55,762,816,1578,"6 de julio de 1997"
16,3,5,56,372,379,751,"6 de julio de 1997"
16,3,5,57,678,690,1368,"6 de julio de 1997"
16,3,7,132,311,344,655,"6 de julio de 1997"
16,3,7,133,252,281,533,"6 de julio de 1997"
16,3,7,134,73,72,145,"6 de julio de 1997"
16,3,7,135,106,108,214,"6 de julio de 1997"
16,3,17,286,640,651,1291,"6 de julio de 1997"
16,3,17,287,230,194,424,"6 de julio de 1997"
16,3,17,288,925,887,1812,"6 de julio de 1997"
16,3,17,289,243,217,460,"6 de julio de 1997"
16,3,17,290,366,308,674,"6 de julio de 1997"
16,3,17,291,335,288,623,"6 de julio de 1997"
16,3,17,292,568,576,1144,"6 de julio de 1997"
16,3,17,293,713,681,1394,"6 de julio de 1997"
16,3,17,294,826,782,1608,"6 de julio de 1997"
16,3,17,295,533,527,1060,"6 de julio de 1997"
16,3,17,296,470,430,900,"6 de julio de 1997"
16,3,17,297,826,812,1638,"6 de julio de 1997"
16,3,17,298,384,425,809,"6 de julio de 1997"
16,3,31,446,356,395,751,"6 de julio de 1997"
16,3,31,447,422,506,928,"6 de julio de 1997"
16,3,31,448,369,372,741,"6 de julio de 1997"
16,3,31,449,375,347,722,"6 de julio de 1997"
16,3,31,450,396,369,765,"6 de julio de 1997"
16,3,31,451,364,341,705,"6 de julio de 1997"
16,3,31,452,302,289,591,"6 de julio de 1997"
16,3,31,453,225,216,441,"6 de julio de 1997"
16,3,31,454,463,400,863,"6 de julio de 1997"
16,3,31,455,623,633,1256,"6 de julio de 1997"
16,3,31,456,448,416,864,"6 de julio de 1997"
16,3,47,774,477,514,991,"6 de julio de 1997"
16,3,47,775,457,506,963,"6 de julio de 1997"
16,3,47,776,134,158,292,"6 de julio de 1997"
16,3,47,777,266,250,516,"6 de julio de 1997"
16,3,47,778,157,143,300,"6 de julio de 1997"
16,3,47,779,165,157,322,"6 de julio de 1997"
16,3,47,780,145,130,275,"6 de julio de 1997"
16,3,47,781,76,75,151,"6 de julio de 1997"
16,3,47,782,129,134,263,"6 de julio de 1997"
16,3,47,783,243,275,518,"6 de julio de 1997"
16,3,47,784,616,686,1302,"6 de julio de 1997"
16,3,47,785,179,186,365,"6 de julio de 1997"
16,3,48,786,456,514,970,"6 de julio de 1997"
16,3,48,787,576,564,1140,"6 de julio de 1997"
16,3,48,788,700,704,1404,"6 de julio de 1997"
16,3,48,789,177,162,339,"6 de julio de 1997"
16,3,48,790,507,507,1014,"6 de julio de 1997"
16,3,48,791,332,318,650,"6 de julio de 1997"
16,3,48,792,362,339,701,"6 de julio de 1997"
16,3,48,793,352,364,716,"6 de julio de 1997"
16,3,48,794,109,100,209,"6 de julio de 1997"
16,3,48,795,178,144,322,"6 de julio de 1997"
16,3,48,796,251,195,446,"6 de julio de 1997"
16,3,48,797,144,127,271,"6 de julio de 1997"
16,3,48,798,199,187,386,"6 de julio de 1997"
16,3,48,799,195,167,362,"6 de julio de 1997"
16,3,48,800,214,185,399,"6 de julio de 1997"
16,3,48,801,61,50,111,"6 de julio de 1997"
16,3,62,1378,404,421,825,"6 de julio de 1997"
16,3,62,1379,435,471,906,"6 de julio de 1997"
16,3,62,1380,262,224,486,"6 de julio de 1997"
16,3,62,1381,436,438,874,"6 de julio de 1997"
16,3,62,1382,119,115,234,"6 de julio de 1997"
16,3,62,1383,347,371,718,"6 de julio de 1997"
16,3,62,1384,500,454,954,"6 de julio de 1997"
16,3,62,1385,538,487,1025,"6 de julio de 1997"
16,3,62,1386,433,372,805,"6 de julio de 1997"
16,3,62,1387,243,215,458,"6 de julio de 1997"
16,3,62,1388,492,501,993,"6 de julio de 1997"
16,3,81,1821,373,414,787,"6 de julio de 1997"
16,3,81,1822,515,588,1103,"6 de julio de 1997"
16,3,81,1823,278,287,565,"6 de julio de 1997"
16,3,81,1824,534,489,1023,"6 de julio de 1997"
16,3,81,1825,732,772,1504,"6 de julio de 1997"
16,3,81,1826,307,333,640,"6 de julio de 1997"
16,3,81,1827,476,464,940,"6 de julio de 1997"
16,3,81,1828,643,641,1284,"6 de julio de 1997"
16,3,81,1829,290,333,623,"6 de julio de 1997"
16,3,81,1830,217,210,427,"6 de julio de 1997"
16,3,81,1831,211,209,420,"6 de julio de 1997"
16,3,82,1832,298,342,640,"6 de julio de 1997"
16,3,82,1833,296,290,586,"6 de julio de 1997"
16,3,82,1834,345,298,643,"6 de julio de 1997"
16,3,82,1835,98,87,185,"6 de julio de 1997"
16,3,82,1836,450,431,881,"6 de julio de 1997"
16,3,82,1837,92,91,183,"6 de julio de 1997"
16,3,82,1838,40,36,76,"6 de julio de 1997"
16,3,82,1839,235,234,469,"6 de julio de 1997"
16,3,82,1840,100,100,200,"6 de julio de 1997"
16,3,82,1841,154,155,309,"6 de julio de 1997"
16,3,82,1842,27,29,56,"6 de julio de 1997"
16,3,82,1843,93,92,185,"6 de julio de 1997"
16,3,94,2025,474,533,1007,"6 de julio de 1997"
16,3,94,2026,521,557,1078,"6 de julio de 1997"
16,3,94,2027,193,241,434,"6 de julio de 1997"
16,3,94,2028,265,245,510,"6 de julio de 1997"
16,3,94,2029,523,595,1118,"6 de julio de 1997"
16,3,94,2030,374,407,781,"6 de julio de 1997"
16,3,94,2031,469,539,1008,"6 de julio de 1997"
16,3,94,2032,417,502,919,"6 de julio de 1997"
16,3,94,2033,695,780,1475,"6 de julio de 1997"
16,3,94,2034,606,713,1319,"6 de julio de 1997"
16,3,94,2035,298,289,587,"6 de julio de 1997"
16,3,94,2036,136,128,264,"6 de julio de 1997"
16,3,94,2037,463,436,899,"6 de julio de 1997"
16,3,94,2038,444,449,893,"6 de julio de 1997"
16,3,94,2039,159,156,315,"6 de julio de 1997"
16,3,99,2113,416,438,854,"6 de julio de 1997"
16,3,99,2114,411,481,892,"6 de julio de 1997"
16,3,99,2115,499,625,1124,"6 de julio de 1997"
16,3,99,2116,616,647,1263,"6 de julio de 1997"
16,3,99,2117,521,581,1102,"6 de julio de 1997"
16,3,99,2118,731,767,1498,"6 de julio de 1997"
16,3,99,2119,422,435,857,"6 de julio de 1997"
16,3,99,2120,250,225,475,"6 de julio de 1997"
16,3,99,2121,322,321,643,"6 de julio de 1997"
16,3,99,2122,283,247,530,"6 de julio de 1997"
16,3,99,2123,428,421,849,"6 de julio de 1997"
16,3,99,2124,109,116,225,"6 de julio de 1997"
16,3,99,2125,192,186,378,"6 de julio de 1997"
16,3,99,2126,207,171,378,"6 de julio de 1997"
16,3,99,2127,254,246,500,"6 de julio de 1997"
16,3,99,2128,100,93,193,"6 de julio de 1997"
16,3,99,2129,82,71,153,"6 de julio de 1997"
16,3,100,2130,332,373,705,"6 de julio de 1997"
16,3,100,2131,500,584,1084,"6 de julio de 1997"
16,3,100,2132,242,157,399,"6 de julio de 1997"
16,3,100,2133,389,360,749,"6 de julio de 1997"
16,3,100,2134,211,187,398,"6 de julio de 1997"
16,3,100,2135,282,267,549,"6 de julio de 1997"
16,3,100,2136,250,212,462,"6 de julio de 1997"
16,3,100,2137,114,108,222,"6 de julio de 1997"
16,3,100,2138,184,189,373,"6 de julio de 1997"
16,3,100,2139,298,301,599,"6 de julio de 1997"
16,3,100,2140,244,245,489,"6 de julio de 1997"
16,3,100,2141,337,340,677,"6 de julio de 1997"
16,3,100,2142,165,158,323,"6 de julio de 1997"
16,3,100,2143,63,57,120,"6 de julio de 1997"
16,3,100,2144,143,144,287,"6 de julio de 1997"
16,3,100,2145,101,109,210,"6 de julio de 1997"
16,3,100,2146,503,504,1007,"6 de julio de 1997"
16,3,100,2147,220,226,446,"6 de julio de 1997"
16,3,100,2148,48,55,103,"6 de julio de 1997"
16,3,100,2149,109,103,212,"6 de julio de 1997"
16,3,100,2150,77,75,152,"6 de julio de 1997"
16,3,113,2578,356,395,751,"6 de julio de 1997"
16,3,113,2579,556,654,1210,"6 de julio de 1997"
16,3,113,2580,398,456,854,"6 de julio de 1997"
16,3,113,2581,422,470,892,"6 de julio de 1997"
16,3,113,2582,395,390,785,"6 de julio de 1997"
16,3,113,2583,597,673,1270,"6 de julio de 1997"
16,3,113,2584,537,596,1133,"6 de julio de 1997"
16,3,113,2585,702,701,1403,"6 de julio de 1997"
16,3,113,2586,340,359,699,"6 de julio de 1997"
16,3,113,2587,492,572,1064,"6 de julio de 1997"
16,3,113,2588,613,689,1302,"6 de julio de 1997"
16,3,113,2589,463,554,1017,"6 de julio de 1997"
16,3,113,2590,313,353,666,"6 de julio de 1997"
16,3,113,2591,478,573,1051,"6 de julio de 1997"
16,3,113,2592,587,698,1285,"6 de julio de 1997"
16,3,113,2593,493,517,1010,"6 de julio de 1997"
16,3,113,2594,591,657,1248,"6 de julio de 1997"
16,3,113,2595,346,369,715,"6 de julio de 1997"
16,3,113,2596,225,253,478,"6 de julio de 1997"
16,3,113,2597,302,349,651,"6 de julio de 1997"
16,3,113,2598,472,586,1058,"6 de julio de 1997"
16,3,113,2599,565,634,1199,"6 de julio de 1997"
16,3,113,2600,407,434,841,"6 de julio de 1997"
16,3,113,2601,308,394,702,"6 de julio de 1997"
16,3,113,2602,483,542,1025,"6 de julio de 1997"
16,3,113,2603,516,576,1092,"6 de julio de 1997"
16,3,113,2604,398,499,897,"6 de julio de 1997"
16,3,113,2605,449,526,975,"6 de julio de 1997"
16,3,113,2606,366,441,807,"6 de julio de 1997"
16,3,113,2607,524,585,1109,"6 de julio de 1997"
16,3,113,2608,407,466,873,"6 de julio de 1997"
16,3,113,2609,437,485,922,"6 de julio de 1997"
16,3,113,2610,505,553,1058,"6 de julio de 1997"
16,3,113,2611,299,359,658,"6 de julio de 1997"
16,3,113,2612,278,328,606,"6 de julio de 1997"
16,3,113,2613,582,622,1204,"6 de julio de 1997"
16,3,113,2614,382,410,792,"6 de julio de 1997"
16,3,113,2615,315,352,667,"6 de julio de 1997"
16,3,113,2616,371,403,774,"6 de julio de 1997"
16,3,113,2617,346,376,722,"6 de julio de 1997"
16,3,113,2618,320,377,697,"6 de julio de 1997"
16,3,113,2619,284,357,641,"6 de julio de 1997"
16,3,113,2620,439,480,919,"6 de julio de 1997"
16,3,113,2621,150,147,297,"6 de julio de 1997"
16,3,113,2622,609,645,1254,"6 de julio de 1997"
16,3,113,2623,418,417,835,"6 de julio de 1997"
16,3,113,2624,50,46,96,"6 de julio de 1997"
16,3,113,2625,407,456,863,"6 de julio de 1997"
16,3,113,2626,371,405,776,"6 de julio de 1997"
16,3,113,2627,154,166,320,"6 de julio de 1997"
16,3,113,2628,484,457,941,"6 de julio de 1997"
16,3,113,2629,737,689,1426,"6 de julio de 1997"
16,3,113,2630,296,280,576,"6 de julio de 1997"
16,3,113,2631,251,240,491,"6 de julio de 1997"
16,3,113,2632,239,253,492,"6 de julio de 1997"
16,3,113,2633,200,221,421,"6 de julio de 1997"
16,3,113,2634,250,285,535,"6 de julio de 1997"
16,3,113,2635,232,273,505,"6 de julio de 1997"
16,3,113,2636,381,386,767,"6 de julio de 1997"
16,3,113,2637,280,310,590,"6 de julio de 1997"
16,3,113,2638,693,683,1376,"6 de julio de 1997"
16,3,113,2639,325,328,653,"6 de julio de 1997"
16,3,113,2640,609,648,1257,"6 de julio de 1997"
16,3,113,2641,475,486,961,"6 de julio de 1997"
16,3,113,2642,527,498,1025,"6 de julio de 1997"
16,3,113,2643,636,623,1259,"6 de julio de 1997"
16,3,113,2644,531,552,1083,"6 de julio de 1997"
16,3,113,2645,449,514,963,"6 de julio de 1997"
16,3,113,2646,413,408,821,"6 de julio de 1997"
16,3,113,2647,241,214,455,"6 de julio de 1997"
16,3,113,2648,116,107,223,"6 de julio de 1997"
16,3,113,2649,379,317,696,"6 de julio de 1997"
16,3,113,2650,519,574,1093,"6 de julio de 1997"
16,3,113,2651,497,447,944,"6 de julio de 1997"
16,3,113,2652,537,531,1068,"6 de julio de 1997"
16,3,113,2653,288,271,559,"6 de julio de 1997"
16,3,113,2654,376,392,768,"6 de julio de 1997"
16,3,113,2655,288,308,596,"6 de julio de 1997"
16,3,113,2656,126,116,242,"6 de julio de 1997"
16,3,113,2657,221,208,429,"6 de julio de 1997"
16,3,113,2658,433,496,929,"6 de julio de 1997"
16,3,113,2659,141,139,280,"6 de julio de 1997"
16,4,19,305,171,221,392,"6 de julio de 1997"
16,4,19,306,275,356,631,"6 de julio de 1997"
16,4,19,307,492,653,1145,"6 de julio de 1997"
16,4,19,308,262,376,638,"6 de julio de 1997"
16,4,19,309,269,363,632,"6 de julio de 1997"
16,4,19,310,369,472,841,"6 de julio de 1997"
16,4,19,311,402,557,959,"6 de julio de 1997"
16,4,19,312,348,454,802,"6 de julio de 1997"
16,4,19,313,440,613,1053,"6 de julio de 1997"
16,4,19,314,380,409,789,"6 de julio de 1997"
16,4,19,315,183,221,404,"6 de julio de 1997"
16,4,19,316,119,190,309,"6 de julio de 1997"
16,4,19,317,121,150,271,"6 de julio de 1997"
16,4,19,318,491,595,1086,"6 de julio de 1997"
16,4,19,319,220,332,552,"6 de julio de 1997"
16,4,19,320,105,108,213,"6 de julio de 1997"
16,4,19,321,376,406,782,"6 de julio de 1997"
16,4,19,322,220,175,395,"6 de julio de 1997"
16,4,19,323,63,30,93,"6 de julio de 1997"
16,4,45,726,175,205,380,"6 de julio de 1997"
16,4,45,727,505,591,1096,"6 de julio de 1997"
16,4,45,728,338,368,706,"6 de julio de 1997"
16,4,45,729,430,547,977,"6 de julio de 1997"
16,4,45,730,365,487,852,"6 de julio de 1997"
16,4,45,731,341,425,766,"6 de julio de 1997"
16,4,45,732,207,259,466,"6 de julio de 1997"
16,4,45,733,479,562,1041,"6 de julio de 1997"
16,4,45,734,509,650,1159,"6 de julio de 1997"
16,4,45,735,327,487,814,"6 de julio de 1997"
16,4,45,736,315,370,685,"6 de julio de 1997"
16,4,45,737,279,448,727,"6 de julio de 1997"
16,4,45,738,597,761,1358,"6 de julio de 1997"
16,4,45,739,281,369,650,"6 de julio de 1997"
16,4,45,740,289,358,647,"6 de julio de 1997"
16,4,45,741,235,307,542,"6 de julio de 1997"
16,4,45,742,513,606,1119,"6 de julio de 1997"
16,4,45,743,328,387,715,"6 de julio de 1997"
16,4,45,744,480,589,1069,"6 de julio de 1997"
16,4,45,745,225,259,484,"6 de julio de 1997"
16,4,45,746,331,385,716,"6 de julio de 1997"
16,4,45,747,486,646,1132,"6 de julio de 1997"
16,4,45,748,155,198,353,"6 de julio de 1997"
16,4,45,749,49,55,104,"6 de julio de 1997"
16,4,45,750,180,234,414,"6 de julio de 1997"
16,4,45,751,429,502,931,"6 de julio de 1997"
16,4,45,752,506,622,1128,"6 de julio de 1997"
16,4,45,753,90,122,212,"6 de julio de 1997"
16,4,45,754,281,399,680,"6 de julio de 1997"
16,4,45,755,59,87,146,"6 de julio de 1997"
16,4,53,929,369,484,853,"6 de julio de 1997"
16,4,53,930,525,633,1158,"6 de julio de 1997"
16,4,53,931,386,423,809,"6 de julio de 1997"
16,4,53,932,339,443,782,"6 de julio de 1997"
16,4,53,933,307,422,729,"6 de julio de 1997"
16,4,53,934,240,309,549,"6 de julio de 1997"
16,4,53,935,36,22,58,"6 de julio de 1997"
16,4,53,936,155,163,318,"6 de julio de 1997"
16,4,53,937,309,395,704,"6 de julio de 1997"
16,4,53,938,104,116,220,"6 de julio de 1997"
16,4,53,939,195,236,431,"6 de julio de 1997"
16,4,53,940,63,79,142,"6 de julio de 1997"
16,4,63,1389,147,165,312,"6 de julio de 1997"
16,4,63,1390,306,408,714,"6 de julio de 1997"
16,4,63,1391,350,420,770,"6 de julio de 1997"
16,4,63,1392,373,453,826,"6 de julio de 1997"
16,4,63,1393,261,261,522,"6 de julio de 1997"
16,4,63,1394,399,464,863,"6 de julio de 1997"
16,4,63,1395,403,463,866,"6 de julio de 1997"
16,4,63,1396,359,458,817,"6 de julio de 1997"
16,4,63,1397,246,310,556,"6 de julio de 1997"
16,4,63,1398,256,317,573,"6 de julio de 1997"
16,4,63,1399,210,285,495,"6 de julio de 1997"
16,4,63,1400,172,237,409,"6 de julio de 1997"
16,4,63,1401,360,354,714,"6 de julio de 1997"
16,4,63,1402,350,332,682,"6 de julio de 1997"
16,4,63,1403,188,258,446,"6 de julio de 1997"
16,4,63,1404,317,493,810,"6 de julio de 1997"
16,4,63,1405,267,430,697,"6 de julio de 1997"
16,4,63,1406,144,171,315,"6 de julio de 1997"
16,4,69,1517,540,568,1108,"6 de julio de 1997"
16,4,69,1518,392,382,774,"6 de julio de 1997"
16,4,69,1519,414,470,884,"6 de julio de 1997"
16,4,69,1520,464,512,976,"6 de julio de 1997"
16,4,69,1521,463,512,975,"6 de julio de 1997"
16,4,69,1522,417,454,871,"6 de julio de 1997"
16,4,69,1523,306,345,651,"6 de julio de 1997"
16,4,69,1524,411,476,887,"6 de julio de 1997"
16,4,69,1525,719,788,1507,"6 de julio de 1997"
16,4,69,1526,358,401,759,"6 de julio de 1997"
16,4,69,1527,228,224,452,"6 de julio de 1997"
16,4,69,1528,175,148,323,"6 de julio de 1997"
16,4,75,1675,281,321,602,"6 de julio de 1997"
16,4,75,1676,296,348,644,"6 de julio de 1997"
16,4,75,1677,185,249,434,"6 de julio de 1997"
16,4,75,1678,299,380,679,"6 de julio de 1997"
16,4,75,1679,345,410,755,"6 de julio de 1997"
16,4,75,1680,377,428,805,"6 de julio de 1997"
16,4,75,1681,308,364,672,"6 de julio de 1997"
16,4,75,1682,234,291,525,"6 de julio de 1997"
16,4,75,1683,341,376,717,"6 de julio de 1997"
16,4,76,1684,575,613,1188,"6 de julio de 1997"
16,4,76,1685,412,439,851,"6 de julio de 1997"
16,4,76,1686,461,496,957,"6 de julio de 1997"
16,4,76,1687,417,447,864,"6 de julio de 1997"
16,4,76,1688,488,561,1049,"6 de julio de 1997"
16,4,76,1689,389,475,864,"6 de julio de 1997"
16,4,76,1690,380,481,861,"6 de julio de 1997"
16,4,76,1691,447,478,925,"6 de julio de 1997"
16,4,76,1692,406,503,909,"6 de julio de 1997"
16,4,76,1693,419,468,887,"6 de julio de 1997"
16,4,76,1694,400,521,921,"6 de julio de 1997"
16,4,76,1695,360,484,844,"6 de julio de 1997"
16,4,76,1696,400,491,891,"6 de julio de 1997"
16,4,76,1697,435,507,942,"6 de julio de 1997"
16,4,76,1698,370,456,826,"6 de julio de 1997"
16,4,76,1699,370,381,751,"6 de julio de 1997"
16,4,76,1700,415,454,869,"6 de julio de 1997"
16,4,76,1701,580,602,1182,"6 de julio de 1997"
16,4,76,1702,426,564,990,"6 de julio de 1997"
16,4,76,1703,423,474,897,"6 de julio de 1997"
16,4,76,1704,470,546,1016,"6 de julio de 1997"
16,4,76,1705,661,773,1434,"6 de julio de 1997"
16,4,76,1706,309,358,667,"6 de julio de 1997"
16,4,76,1707,230,270,500,"6 de julio de 1997"
16,4,76,1708,298,344,642,"6 de julio de 1997"
16,4,76,1709,291,309,600,"6 de julio de 1997"
16,4,76,1710,456,502,958,"6 de julio de 1997"
16,4,76,1711,381,421,802,"6 de julio de 1997"
16,4,76,1712,633,717,1350,"6 de julio de 1997"
16,4,76,1713,330,385,715,"6 de julio de 1997"
16,4,76,1714,324,341,665,"6 de julio de 1997"
16,4,76,1715,201,215,416,"6 de julio de 1997"
16,4,76,1716,413,442,855,"6 de julio de 1997"
16,4,76,1717,659,706,1365,"6 de julio de 1997"
16,4,76,1718,257,294,551,"6 de julio de 1997"
16,4,77,1719,113,128,241,"6 de julio de 1997"
16,4,77,1720,388,414,802,"6 de julio de 1997"
16,4,77,1721,249,304,553,"6 de julio de 1997"
16,4,77,1722,213,255,468,"6 de julio de 1997"
16,4,77,1723,279,368,647,"6 de julio de 1997"
16,4,77,1724,341,418,759,"6 de julio de 1997"
16,4,77,1725,362,383,745,"6 de julio de 1997"
16,4,77,1726,527,661,1188,"6 de julio de 1997"
16,4,77,1727,273,350,623,"6 de julio de 1997"
16,4,77,1728,376,451,827,"6 de julio de 1997"
16,4,77,1729,298,351,649,"6 de julio de 1997"
16,4,77,1730,277,351,628,"6 de julio de 1997"
16,4,77,1731,453,561,1014,"6 de julio de 1997"
16,4,77,1732,258,282,540,"6 de julio de 1997"
16,4,77,1733,457,533,990,"6 de julio de 1997"
16,4,77,1734,402,469,871,"6 de julio de 1997"
16,4,77,1735,259,355,614,"6 de julio de 1997"
16,4,77,1736,260,336,596,"6 de julio de 1997"
16,4,77,1737,356,397,753,"6 de julio de 1997"
16,4,77,1738,563,680,1243,"6 de julio de 1997"
16,4,77,1739,166,227,393,"6 de julio de 1997"
16,4,77,1740,233,258,491,"6 de julio de 1997"
16,4,77,1741,120,158,278,"6 de julio de 1997"
16,4,77,1742,331,389,720,"6 de julio de 1997"
16,4,77,1743,278,306,584,"6 de julio de 1997"
16,4,77,1744,314,355,669,"6 de julio de 1997"
16,4,77,1745,341,406,747,"6 de julio de 1997"
16,4,77,1746,391,466,857,"6 de julio de 1997"
16,4,77,1747,327,435,762,"6 de julio de 1997"
16,4,77,1748,400,472,872,"6 de julio de 1997"
16,4,77,1749,372,439,811,"6 de julio de 1997"
16,4,77,1750,292,343,635,"6 de julio de 1997"
16,4,77,1751,112,142,254,"6 de julio de 1997"
16,4,77,1752,308,354,662,"6 de julio de 1997"
16,4,77,1753,251,289,540,"6 de julio de 1997"
16,4,77,1754,293,341,634,"6 de julio de 1997"
16,4,77,1755,300,403,703,"6 de julio de 1997"
16,4,77,1756,343,366,709,"6 de julio de 1997"
16,4,77,1757,290,341,631,"6 de julio de 1997"
16,4,77,1758,249,308,557,"6 de julio de 1997"
16,4,77,1759,379,389,768,"6 de julio de 1997"
16,4,77,1760,303,358,661,"6 de julio de 1997"
16,4,77,1761,476,583,1059,"6 de julio de 1997"
16,4,77,1762,410,533,943,"6 de julio de 1997"
16,4,77,1763,236,280,516,"6 de julio de 1997"
16,4,77,1764,159,239,398,"6 de julio de 1997"
16,4,77,1765,144,137,281,"6 de julio de 1997"
16,4,77,1766,77,100,177,"6 de julio de 1997"
16,4,77,1767,399,462,861,"6 de julio de 1997"
16,4,92,2002,337,401,738,"6 de julio de 1997"
16,4,92,2003,253,315,568,"6 de julio de 1997"
16,4,92,2004,312,405,717,"6 de julio de 1997"
16,4,92,2005,479,601,1080,"6 de julio de 1997"
16,4,92,2006,350,413,763,"6 de julio de 1997"
16,4,92,2007,281,390,671,"6 de julio de 1997"
16,4,92,2008,320,400,720,"6 de julio de 1997"
16,4,92,2009,485,602,1087,"6 de julio de 1997"
16,4,92,2010,272,299,571,"6 de julio de 1997"
16,4,92,2011,204,238,442,"6 de julio de 1997"
16,4,92,2012,123,125,248,"6 de julio de 1997"
16,4,96,2052,351,393,744,"6 de julio de 1997"
16,4,96,2053,278,292,570,"6 de julio de 1997"
16,4,96,2054,232,256,488,"6 de julio de 1997"
16,4,96,2055,408,441,849,"6 de julio de 1997"
16,4,96,2056,565,594,1159,"6 de julio de 1997"
16,4,96,2057,329,390,719,"6 de julio de 1997"
16,4,96,2058,283,340,623,"6 de julio de 1997"
16,4,96,2059,456,525,981,"6 de julio de 1997"
16,4,96,2060,163,158,321,"6 de julio de 1997"
16,4,96,2061,222,240,462,"6 de julio de 1997"
16,4,96,2062,224,271,495,"6 de julio de 1997"
16,4,96,2063,136,141,277,"6 de julio de 1997"
16,4,96,2064,87,64,151,"6 de julio de 1997"
16,4,104,2317,98,116,214,"6 de julio de 1997"
16,4,104,2318,328,436,764,"6 de julio de 1997"
16,4,104,2319,379,498,877,"6 de julio de 1997"
16,4,104,2320,395,464,859,"6 de julio de 1997"
16,4,104,2321,88,111,199,"6 de julio de 1997"
16,4,104,2322,237,336,573,"6 de julio de 1997"
16,4,104,2323,389,445,834,"6 de julio de 1997"
16,4,104,2324,481,588,1069,"6 de julio de 1997"
16,4,104,2325,250,324,574,"6 de julio de 1997"
16,4,104,2326,315,399,714,"6 de julio de 1997"
16,4,104,2327,181,247,428,"6 de julio de 1997"
16,4,104,2328,326,334,660,"6 de julio de 1997"
16,4,104,2329,410,485,895,"6 de julio de 1997"
16,4,104,2330,268,347,615,"6 de julio de 1997"
16,4,104,2331,297,362,659,"6 de julio de 1997"
16,4,104,2332,339,432,771,"6 de julio de 1997"
16,4,104,2333,267,298,565,"6 de julio de 1997"
16,4,104,2334,245,260,505,"6 de julio de 1997"
16,4,104,2335,364,405,769,"6 de julio de 1997"
16,4,104,2336,146,171,317,"6 de julio de 1997"
16,4,104,2337,199,233,432,"6 de julio de 1997"
16,4,104,2338,289,350,639,"6 de julio de 1997"
16,4,105,2339,407,531,938,"6 de julio de 1997"
16,4,105,2340,429,526,955,"6 de julio de 1997"
16,4,105,2341,513,608,1121,"6 de julio de 1997"
16,4,105,2342,317,391,708,"6 de julio de 1997"
16,4,105,2343,438,545,983,"6 de julio de 1997"
16,4,105,2344,264,342,606,"6 de julio de 1997"
16,4,105,2345,119,143,262,"6 de julio de 1997"
16,4,105,2346,154,217,371,"6 de julio de 1997"
16,4,105,2347,224,269,493,"6 de julio de 1997"
16,4,105,2348,367,426,793,"6 de julio de 1997"
16,4,105,2349,262,288,550,"6 de julio de 1997"
16,4,105,2350,588,734,1322,"6 de julio de 1997"
16,4,105,2351,155,204,359,"6 de julio de 1997"
16,4,105,2352,390,475,865,"6 de julio de 1997"
16,4,105,2353,246,307,553,"6 de julio de 1997"
16,4,105,2354,286,529,815,"6 de julio de 1997"
16,4,105,2355,151,235,386,"6 de julio de 1997"
16,4,105,2356,189,198,387,"6 de julio de 1997"
16,5,23,361,291,369,660,"6 de julio de 1997"
16,5,23,362,276,383,659,"6 de julio de 1997"
16,5,23,363,219,304,523,"6 de julio de 1997"
16,5,23,364,326,382,708,"6 de julio de 1997"
16,5,23,365,255,305,560,"6 de julio de 1997"
16,5,23,366,255,304,559,"6 de julio de 1997"
16,5,23,367,269,330,599,"6 de julio de 1997"
16,5,23,368,210,255,465,"6 de julio de 1997"
16,5,23,369,475,593,1068,"6 de julio de 1997"
16,5,23,370,209,236,445,"6 de julio de 1997"
16,5,23,371,338,415,753,"6 de julio de 1997"
16,5,25,380,415,475,890,"6 de julio de 1997"
16,5,25,381,473,582,1055,"6 de julio de 1997"
16,5,25,382,461,561,1022,"6 de julio de 1997"
16,5,25,383,303,321,624,"6 de julio de 1997"
16,5,25,384,476,601,1077,"6 de julio de 1997"
16,5,25,385,280,323,603,"6 de julio de 1997"
16,5,25,386,458,520,978,"6 de julio de 1997"
16,5,25,387,476,527,1003,"6 de julio de 1997"
16,5,25,388,457,538,995,"6 de julio de 1997"
16,5,25,389,629,709,1338,"6 de julio de 1997"
16,5,25,390,300,285,585,"6 de julio de 1997"
16,5,25,391,421,447,868,"6 de julio de 1997"
16,5,25,392,280,296,576,"6 de julio de 1997"
16,5,25,393,597,624,1221,"6 de julio de 1997"
16,5,25,394,503,511,1014,"6 de julio de 1997"
16,5,25,395,254,308,562,"6 de julio de 1997"
16,5,25,396,142,161,303,"6 de julio de 1997"
16,5,42,673,529,609,1138,"6 de julio de 1997"
16,5,42,674,484,549,1033,"6 de julio de 1997"
16,5,42,675,341,376,717,"6 de julio de 1997"
16,5,42,676,250,282,532,"6 de julio de 1997"
16,5,42,677,283,347,630,"6 de julio de 1997"
16,5,42,678,502,539,1041,"6 de julio de 1997"
16,5,42,679,283,345,628,"6 de julio de 1997"
16,5,42,680,229,257,486,"6 de julio de 1997"
16,5,42,681,333,436,769,"6 de julio de 1997"
16,5,42,682,427,572,999,"6 de julio de 1997"
16,5,42,683,456,575,1031,"6 de julio de 1997"
16,5,42,684,159,252,411,"6 de julio de 1997"
16,5,43,685,329,363,692,"6 de julio de 1997"
16,5,43,686,328,452,780,"6 de julio de 1997"
16,5,43,687,354,412,766,"6 de julio de 1997"
16,5,43,688,557,670,1227,"6 de julio de 1997"
16,5,43,689,478,601,1079,"6 de julio de 1997"
16,5,43,690,489,655,1144,"6 de julio de 1997"
16,5,43,691,397,478,875,"6 de julio de 1997"
16,5,43,692,429,493,922,"6 de julio de 1997"
16,5,43,693,457,568,1025,"6 de julio de 1997"
16,5,43,694,258,350,608,"6 de julio de 1997"
16,5,43,695,518,573,1091,"6 de julio de 1997"
16,5,43,696,455,574,1029,"6 de julio de 1997"
16,5,43,697,400,522,922,"6 de julio de 1997"
16,5,43,698,535,625,1160,"6 de julio de 1997"
16,5,43,699,279,332,611,"6 de julio de 1997"
16,5,43,700,291,363,654,"6 de julio de 1997"
16,5,43,701,398,438,836,"6 de julio de 1997"
16,5,43,702,430,547,977,"6 de julio de 1997"
16,5,43,703,956,1138,2094,"6 de julio de 1997"
16,5,43,704,413,551,964,"6 de julio de 1997"
16,5,43,705,355,445,800,"6 de julio de 1997"
16,5,43,706,325,465,790,"6 de julio de 1997"
16,5,43,707,585,687,1272,"6 de julio de 1997"
16,5,43,708,833,1075,1908,"6 de julio de 1997"
16,5,43,709,447,502,949,"6 de julio de 1997"
16,5,43,710,376,449,825,"6 de julio de 1997"
16,5,43,711,296,390,686,"6 de julio de 1997"
16,5,85,1898,344,366,710,"6 de julio de 1997"
16,5,85,1899,510,575,1085,"6 de julio de 1997"
16,5,85,1900,618,677,1295,"6 de julio de 1997"
16,5,85,1901,422,519,941,"6 de julio de 1997"
16,5,85,1902,379,446,825,"6 de julio de 1997"
16,5,85,1903,410,477,887,"6 de julio de 1997"
16,5,85,1904,421,489,910,"6 de julio de 1997"
16,5,85,1905,461,532,993,"6 de julio de 1997"
16,5,85,1906,315,404,719,"6 de julio de 1997"
16,5,85,1907,308,420,728,"6 de julio de 1997"
16,5,85,1908,404,495,899,"6 de julio de 1997"
16,5,85,1909,477,590,1067,"6 de julio de 1997"
16,5,85,1910,389,416,805,"6 de julio de 1997"
16,5,85,1911,456,547,1003,"6 de julio de 1997"
16,5,86,1912,425,473,898,"6 de julio de 1997"
16,5,86,1913,338,385,723,"6 de julio de 1997"
16,5,86,1914,516,612,1128,"6 de julio de 1997"
16,5,86,1915,318,396,714,"6 de julio de 1997"
16,5,86,1916,419,489,908,"6 de julio de 1997"
16,5,86,1917,241,321,562,"6 de julio de 1997"
16,5,86,1918,261,277,538,"6 de julio de 1997"
16,5,86,1919,387,464,851,"6 de julio de 1997"
16,5,86,1920,692,804,1496,"6 de julio de 1997"
16,5,86,1921,292,363,655,"6 de julio de 1997"
16,5,86,1922,393,474,867,"6 de julio de 1997"
16,5,86,1923,332,390,722,"6 de julio de 1997"
16,5,86,1924,162,200,362,"6 de julio de 1997"
16,5,86,1925,204,321,525,"6 de julio de 1997"
16,5,86,1926,95,99,194,"6 de julio de 1997"
16,5,86,1927,147,171,318,"6 de julio de 1997"
16,5,86,1928,150,168,318,"6 de julio de 1997"
16,5,86,1929,436,610,1046,"6 de julio de 1997"
16,5,86,1930,350,520,870,"6 de julio de 1997"
16,5,86,1931,222,298,520,"6 de julio de 1997"
16,5,86,1932,259,352,611,"6 de julio de 1997"
16,5,86,1933,100,140,240,"6 de julio de 1997"
16,5,86,1934,382,519,901,"6 de julio de 1997"
16,5,86,1935,169,187,356,"6 de julio de 1997"
16,5,86,1936,217,261,478,"6 de julio de 1997"
16,5,86,1937,171,191,362,"6 de julio de 1997"
16,5,86,1938,274,294,568,"6 de julio de 1997"
16,5,109,2436,408,496,904,"6 de julio de 1997"
16,5,109,2437,498,556,1054,"6 de julio de 1997"
16,5,109,2438,595,677,1272,"6 de julio de 1997"
16,5,109,2439,385,429,814,"6 de julio de 1997"
16,5,109,2440,493,542,1035,"6 de julio de 1997"
16,5,109,2441,653,751,1404,"6 de julio de 1997"
16,5,109,2442,542,672,1214,"6 de julio de 1997"
16,5,109,2443,466,549,1015,"6 de julio de 1997"
16,5,109,2444,300,371,671,"6 de julio de 1997"
16,5,109,2445,323,428,751,"6 de julio de 1997"
16,5,109,2446,265,319,584,"6 de julio de 1997"
16,5,109,2447,674,749,1423,"6 de julio de 1997"
16,5,109,2448,539,685,1224,"6 de julio de 1997"
16,5,109,2449,478,580,1058,"6 de julio de 1997"
16,5,109,2450,437,538,975,"6 de julio de 1997"
16,5,109,2451,710,821,1531,"6 de julio de 1997"
16,5,109,2452,355,453,808,"6 de julio de 1997"
16,5,109,2453,369,456,825,"6 de julio de 1997"
16,5,109,2454,592,753,1345,"6 de julio de 1997"
16,5,109,2455,330,403,733,"6 de julio de 1997"
16,5,109,2456,385,484,869,"6 de julio de 1997"
16,5,109,2457,492,572,1064,"6 de julio de 1997"
16,5,109,2458,475,589,1064,"6 de julio de 1997"
16,5,109,2459,631,701,1332,"6 de julio de 1997"
16,5,109,2460,542,701,1243,"6 de julio de 1997"
16,5,109,2461,241,369,610,"6 de julio de 1997"
16,5,109,2462,838,1057,1895,"6 de julio de 1997"
16,5,109,2463,441,501,942,"6 de julio de 1997"
16,5,109,2464,288,391,679,"6 de julio de 1997"
16,5,109,2465,305,373,678,"6 de julio de 1997"
16,5,109,2466,437,503,940,"6 de julio de 1997"
16,5,109,2467,406,512,918,"6 de julio de 1997"
16,5,109,2468,370,453,823,"6 de julio de 1997"
16,5,109,2469,413,415,828,"6 de julio de 1997"
16,5,109,2470,468,563,1031,"6 de julio de 1997"
16,5,109,2471,525,610,1135,"6 de julio de 1997"
16,5,109,2472,596,746,1342,"6 de julio de 1997"
16,5,109,2473,291,345,636,"6 de julio de 1997"
16,5,109,2474,282,467,749,"6 de julio de 1997"
16,5,109,2475,274,325,599,"6 de julio de 1997"
16,5,109,2476,879,1021,1900,"6 de julio de 1997"
16,5,109,2477,689,0,689,"6 de julio de 1997"
16,5,109,2478,393,503,896,"6 de julio de 1997"
16,5,109,2479,179,235,414,"6 de julio de 1997"
16,5,109,2480,354,425,779,"6 de julio de 1997"
16,5,109,2481,257,321,578,"6 de julio de 1997"
16,5,109,2482,285,342,627,"6 de julio de 1997"
16,5,109,2483,168,193,361,"6 de julio de 1997"
16,5,109,2484,223,253,476,"6 de julio de 1997"
16,5,109,2485,414,481,895,"6 de julio de 1997"
16,5,109,2486,402,464,866,"6 de julio de 1997"
16,5,109,2487,491,644,1135,"6 de julio de 1997"
16,5,109,2488,401,504,905,"6 de julio de 1997"
16,5,109,2489,686,841,1527,"6 de julio de 1997"
16,5,109,2490,371,458,829,"6 de julio de 1997"
16,5,109,2491,451,517,968,"6 de julio de 1997"
16,5,109,2492,405,527,932,"6 de julio de 1997"
16,5,109,2493,451,547,998,"6 de julio de 1997"
16,5,109,2494,209,327,536,"6 de julio de 1997"
16,5,109,2495,717,813,1530,"6 de julio de 1997"
16,5,109,2496,422,481,903,"6 de julio de 1997"
16,5,109,2497,615,675,1290,"6 de julio de 1997"
16,5,109,2498,619,725,1344,"6 de julio de 1997"
16,5,109,2499,476,584,1060,"6 de julio de 1997"
16,5,109,2500,382,487,869,"6 de julio de 1997"
16,5,109,2501,267,335,602,"6 de julio de 1997"
16,5,109,2502,362,419,781,"6 de julio de 1997"
16,5,109,2503,538,653,1191,"6 de julio de 1997"
16,5,109,2504,316,377,693,"6 de julio de 1997"
16,5,109,2505,312,348,660,"6 de julio de 1997"
16,5,109,2506,425,480,905,"6 de julio de 1997"
16,5,109,2507,350,462,812,"6 de julio de 1997"
16,5,109,2508,453,542,995,"6 de julio de 1997"
16,5,109,2509,353,458,811,"6 de julio de 1997"
16,5,109,2510,623,759,1382,"6 de julio de 1997"
16,5,109,2511,306,428,734,"6 de julio de 1997"
16,5,109,2512,177,273,450,"6 de julio de 1997"
16,5,109,2513,343,430,773,"6 de julio de 1997"
16,5,109,2514,466,524,990,"6 de julio de 1997"
16,5,109,2515,370,420,790,"6 de julio de 1997"
16,5,109,2516,253,263,516,"6 de julio de 1997"
16,5,109,2517,145,206,351,"6 de julio de 1997"
16,5,109,2518,193,238,431,"6 de julio de 1997"
16,5,109,2519,472,544,1016,"6 de julio de 1997"
16,5,109,2520,469,569,1038,"6 de julio de 1997"
16,5,109,2521,564,656,1220,"6 de julio de 1997"
16,5,109,2522,484,546,1030,"6 de julio de 1997"
16,5,109,2523,333,431,764,"6 de julio de 1997"
16,5,109,2524,242,322,564,"6 de julio de 1997"
16,5,109,2525,477,587,1064,"6 de julio de 1997"
16,5,109,2526,254,399,653,"6 de julio de 1997"
16,5,109,2527,279,373,652,"6 de julio de 1997"
16,5,109,2528,403,490,893,"6 de julio de 1997"
16,5,109,2529,576,751,1327,"6 de julio de 1997"
16,5,109,2530,236,272,508,"6 de julio de 1997"
16,6,22,346,743,823,1566,"6 de julio de 1997"
16,6,22,347,807,973,1780,"6 de julio de 1997"
16,6,22,348,454,478,932,"6 de julio de 1997"
16,6,22,349,456,535,991,"6 de julio de 1997"
16,6,22,350,173,220,393,"6 de julio de 1997"
16,6,22,351,431,508,939,"6 de julio de 1997"
16,6,22,352,313,371,684,"6 de julio de 1997"
16,6,22,353,204,245,449,"6 de julio de 1997"
16,6,22,354,105,98,203,"6 de julio de 1997"
16,6,22,355,88,88,176,"6 de julio de 1997"
16,6,22,356,103,120,223,"6 de julio de 1997"
16,6,22,357,104,88,192,"6 de julio de 1997"
16,6,22,358,108,103,211,"6 de julio de 1997"
16,6,22,359,338,297,635,"6 de julio de 1997"
16,6,22,360,148,144,292,"6 de julio de 1997"
16,6,34,480,559,634,1193,"6 de julio de 1997"
16,6,34,481,568,667,1235,"6 de julio de 1997"
16,6,34,482,749,923,1672,"6 de julio de 1997"
16,6,34,483,668,864,1532,"6 de julio de 1997"
16,6,34,484,728,920,1648,"6 de julio de 1997"
16,6,34,485,508,641,1149,"6 de julio de 1997"
16,6,34,486,784,938,1722,"6 de julio de 1997"
16,6,34,487,620,748,1368,"6 de julio de 1997"
16,6,34,488,681,814,1495,"6 de julio de 1997"
16,6,34,489,576,656,1232,"6 de julio de 1997"
16,6,34,490,491,575,1066,"6 de julio de 1997"
16,6,34,491,739,925,1664,"6 de julio de 1997"
16,6,34,492,517,613,1130,"6 de julio de 1997"
16,6,34,493,670,779,1449,"6 de julio de 1997"
16,6,34,494,833,1047,1880,"6 de julio de 1997"
16,6,34,495,839,960,1799,"6 de julio de 1997"
16,6,34,496,550,683,1233,"6 de julio de 1997"
16,6,34,497,437,567,1004,"6 de julio de 1997"
16,6,34,498,634,817,1451,"6 de julio de 1997"
16,6,34,499,627,769,1396,"6 de julio de 1997"
16,6,34,500,431,490,921,"6 de julio de 1997"
16,6,34,501,409,553,962,"6 de julio de 1997"
16,6,34,502,470,579,1049,"6 de julio de 1997"
16,6,34,503,601,686,1287,"6 de julio de 1997"
16,6,34,504,84,77,161,"6 de julio de 1997"
16,6,34,505,60,47,107,"6 de julio de 1997"
16,6,34,506,74,66,140,"6 de julio de 1997"
16,6,34,507,64,56,120,"6 de julio de 1997"
16,6,34,508,418,471,889,"6 de julio de 1997"
16,6,34,509,75,86,161,"6 de julio de 1997"
16,6,34,510,482,469,951,"6 de julio de 1997"
16,6,34,511,455,441,896,"6 de julio de 1997"
16,6,34,512,216,193,409,"6 de julio de 1997"
16,6,34,513,396,495,891,"6 de julio de 1997"
16,6,34,514,218,215,433,"6 de julio de 1997"
16,6,34,515,124,144,268,"6 de julio de 1997"
16,6,34,516,161,173,334,"6 de julio de 1997"
16,6,34,517,699,887,1586,"6 de julio de 1997"
16,6,34,518,104,125,229,"6 de julio de 1997"
16,6,34,519,45,41,86,"6 de julio de 1997"
16,6,34,520,142,172,314,"6 de julio de 1997"
16,6,34,521,535,580,1115,"6 de julio de 1997"
16,6,34,522,155,197,352,"6 de julio de 1997"
16,6,34,523,163,202,365,"6 de julio de 1997"
16,6,34,524,124,112,236,"6 de julio de 1997"
16,6,34,525,142,130,272,"6 de julio de 1997"
16,6,34,526,457,445,902,"6 de julio de 1997"
16,6,34,527,516,479,995,"6 de julio de 1997"
16,6,34,528,211,219,430,"6 de julio de 1997"
16,6,34,529,185,187,372,"6 de julio de 1997"
16,6,34,530,101,119,220,"6 de julio de 1997"
16,6,34,531,171,156,327,"6 de julio de 1997"
16,6,34,532,288,305,593,"6 de julio de 1997"
16,6,34,533,55,62,117,"6 de julio de 1997"
16,6,34,534,183,199,382,"6 de julio de 1997"
16,6,34,535,53,55,108,"6 de julio de 1997"
16,6,34,536,67,55,122,"6 de julio de 1997"
16,6,34,537,166,157,323,"6 de julio de 1997"
16,6,34,538,108,156,264,"6 de julio de 1997"
16,6,34,539,200,242,442,"6 de julio de 1997"
16,6,34,540,74,78,152,"6 de julio de 1997"
16,6,34,541,89,86,175,"6 de julio de 1997"
16,6,34,542,223,202,425,"6 de julio de 1997"
16,6,34,543,82,75,157,"6 de julio de 1997"
16,6,34,544,208,209,417,"6 de julio de 1997"
16,6,34,545,361,360,721,"6 de julio de 1997"
16,6,34,546,677,672,1349,"6 de julio de 1997"
16,6,34,547,79,71,150,"6 de julio de 1997"
16,6,34,548,240,257,497,"6 de julio de 1997"
16,6,34,549,412,492,904,"6 de julio de 1997"
16,6,34,550,219,222,441,"6 de julio de 1997"
16,6,34,551,92,74,166,"6 de julio de 1997"
16,6,34,552,98,79,177,"6 de julio de 1997"
16,6,34,553,71,55,126,"6 de julio de 1997"
16,6,34,554,30,22,52,"6 de julio de 1997"
16,6,34,555,117,93,210,"6 de julio de 1997"
16,6,34,556,50,38,88,"6 de julio de 1997"
16,6,40,651,693,826,1519,"6 de julio de 1997"
16,6,40,652,455,566,1021,"6 de julio de 1997"
16,6,40,653,442,572,1014,"6 de julio de 1997"
16,6,40,654,400,517,917,"6 de julio de 1997"
16,6,40,655,321,357,678,"6 de julio de 1997"
16,6,40,656,195,221,416,"6 de julio de 1997"
16,6,40,657,213,319,532,"6 de julio de 1997"
16,6,40,658,115,154,269,"6 de julio de 1997"
16,6,40,659,585,586,1171,"6 de julio de 1997"
16,6,40,660,162,188,350,"6 de julio de 1997"
16,6,40,661,97,87,184,"6 de julio de 1997"
16,6,40,662,107,114,221,"6 de julio de 1997"
16,6,40,663,35,28,63,"6 de julio de 1997"
16,6,40,664,67,56,123,"6 de julio de 1997"
16,6,41,665,439,498,937,"6 de julio de 1997"
16,6,41,666,549,620,1169,"6 de julio de 1997"
16,6,41,667,84,99,183,"6 de julio de 1997"
16,6,41,668,352,398,750,"6 de julio de 1997"
16,6,41,669,532,585,1117,"6 de julio de 1997"
16,6,41,670,264,280,544,"6 de julio de 1997"
16,6,41,671,201,238,439,"6 de julio de 1997"
16,6,41,672,529,622,1151,"6 de julio de 1997"
16,6,52,885,364,388,752,"6 de julio de 1997"
16,6,52,886,349,372,721,"6 de julio de 1997"
16,6,52,887,455,501,956,"6 de julio de 1997"
16,6,52,888,365,409,774,"6 de julio de 1997"
16,6,52,889,424,494,918,"6 de julio de 1997"
16,6,52,890,619,690,1309,"6 de julio de 1997"
16,6,52,891,431,474,905,"6 de julio de 1997"
16,6,52,892,385,432,817,"6 de julio de 1997"
16,6,52,893,424,503,927,"6 de julio de 1997"
16,6,52,894,217,254,471,"6 de julio de 1997"
16,6,52,895,368,398,766,"6 de julio de 1997"
16,6,52,896,466,560,1026,"6 de julio de 1997"
16,6,52,897,402,453,855,"6 de julio de 1997"
16,6,52,898,516,564,1080,"6 de julio de 1997"
16,6,52,899,283,308,591,"6 de julio de 1997"
16,6,52,900,448,529,977,"6 de julio de 1997"
16,6,52,901,391,415,806,"6 de julio de 1997"
16,6,52,902,321,400,721,"6 de julio de 1997"
16,6,52,903,734,772,1506,"6 de julio de 1997"
16,6,52,904,380,523,903,"6 de julio de 1997"
16,6,52,905,352,386,738,"6 de julio de 1997"
16,6,52,906,312,352,664,"6 de julio de 1997"
16,6,52,907,148,134,282,"6 de julio de 1997"
16,6,52,908,536,513,1049,"6 de julio de 1997"
16,6,52,909,382,387,769,"6 de julio de 1997"
16,6,52,910,304,300,604,"6 de julio de 1997"
16,6,52,911,320,338,658,"6 de julio de 1997"
16,6,52,912,712,784,1496,"6 de julio de 1997"
16,6,52,913,116,106,222,"6 de julio de 1997"
16,6,52,914,602,581,1183,"6 de julio de 1997"
16,6,52,915,287,299,586,"6 de julio de 1997"
16,6,52,916,435,420,855,"6 de julio de 1997"
16,6,52,917,274,264,538,"6 de julio de 1997"
16,6,52,918,182,199,381,"6 de julio de 1997"
16,6,52,919,382,377,759,"6 de julio de 1997"
16,6,52,920,325,287,612,"6 de julio de 1997"
16,6,52,921,177,188,365,"6 de julio de 1997"
16,6,52,922,540,581,1121,"6 de julio de 1997"
16,6,52,923,305,316,621,"6 de julio de 1997"
16,6,52,924,460,455,915,"6 de julio de 1997"
16,6,52,925,236,222,458,"6 de julio de 1997"
16,6,52,926,208,219,427,"6 de julio de 1997"
16,6,52,927,107,95,202,"6 de julio de 1997"
16,6,52,928,522,566,1088,"6 de julio de 1997"
16,6,73,1647,402,507,909,"6 de julio de 1997"
16,6,73,1648,345,444,789,"6 de julio de 1997"
16,6,73,1649,286,364,650,"6 de julio de 1997"
16,6,73,1650,363,409,772,"6 de julio de 1997"
16,6,73,1651,565,681,1246,"6 de julio de 1997"
16,6,73,1652,331,356,687,"6 de julio de 1997"
16,6,73,1653,105,138,243,"6 de julio de 1997"
16,6,73,1654,135,138,273,"6 de julio de 1997"
16,6,73,1655,177,210,387,"6 de julio de 1997"
16,6,73,1656,415,449,864,"6 de julio de 1997"
16,6,73,1657,97,119,216,"6 de julio de 1997"
16,6,73,1658,138,136,274,"6 de julio de 1997"
16,6,73,1659,132,108,240,"6 de julio de 1997"
16,6,73,1660,87,61,148,"6 de julio de 1997"
16,6,102,2160,235,216,451,"6 de julio de 1997"
16,6,102,2161,311,312,623,"6 de julio de 1997"
16,6,102,2162,75,56,131,"6 de julio de 1997"
16,6,102,2163,130,106,236,"6 de julio de 1997"
16,6,102,2164,115,100,215,"6 de julio de 1997"
16,6,102,2165,90,81,171,"6 de julio de 1997"
16,6,102,2166,340,340,680,"6 de julio de 1997"
16,6,102,2167,121,105,226,"6 de julio de 1997"
16,6,102,2168,302,285,587,"6 de julio de 1997"
16,6,102,2169,404,403,807,"6 de julio de 1997"
16,6,102,2170,286,259,545,"6 de julio de 1997"
16,6,102,2171,236,178,414,"6 de julio de 1997"
16,6,102,2172,137,113,250,"6 de julio de 1997"
16,6,102,2173,163,135,298,"6 de julio de 1997"
16,6,102,2174,54,43,97,"6 de julio de 1997"
16,6,111,2538,365,381,746,"6 de julio de 1997"
16,6,111,2539,223,275,498,"6 de julio de 1997"
16,6,111,2540,472,559,1031,"6 de julio de 1997"
16,6,111,2541,374,445,819,"6 de julio de 1997"
16,6,111,2542,666,800,1466,"6 de julio de 1997"
16,6,111,2543,395,451,846,"6 de julio de 1997"
16,6,111,2544,432,522,954,"6 de julio de 1997"
16,6,111,2545,517,615,1132,"6 de julio de 1997"
16,6,111,2546,482,556,1038,"6 de julio de 1997"
16,6,111,2547,282,378,660,"6 de julio de 1997"
16,6,111,2548,245,309,554,"6 de julio de 1997"
16,6,111,2549,446,527,973,"6 de julio de 1997"
16,6,111,2550,684,801,1485,"6 de julio de 1997"
16,6,111,2551,266,264,530,"6 de julio de 1997"
16,6,111,2552,420,544,964,"6 de julio de 1997"
16,6,111,2553,332,372,704,"6 de julio de 1997"
16,6,111,2554,101,130,231,"6 de julio de 1997"
16,6,111,2555,391,395,786,"6 de julio de 1997"
16,6,111,2556,332,407,739,"6 de julio de 1997"
16,6,111,2557,531,638,1169,"6 de julio de 1997"
16,6,111,2558,273,445,718,"6 de julio de 1997"
16,6,111,2559,382,481,863,"6 de julio de 1997"
16,6,111,2560,487,606,1093,"6 de julio de 1997"
16,6,111,2561,318,435,753,"6 de julio de 1997"
16,6,111,2562,120,148,268,"6 de julio de 1997"
16,6,111,2563,348,420,768,"6 de julio de 1997"
16,6,111,2564,414,504,918,"6 de julio de 1997"
16,6,111,2565,643,703,1346,"6 de julio de 1997"
16,6,111,2566,327,377,704,"6 de julio de 1997"
16,6,111,2567,254,338,592,"6 de julio de 1997"
16,6,111,2568,482,529,1011,"6 de julio de 1997"
16,6,111,2569,183,213,396,"6 de julio de 1997"
16,7,16,257,271,341,612,"6 de julio de 1997"
16,7,16,258,308,386,694,"6 de julio de 1997"
16,7,16,259,477,553,1030,"6 de julio de 1997"
16,7,16,260,336,404,740,"6 de julio de 1997"
16,7,16,261,195,276,471,"6 de julio de 1997"
16,7,16,262,363,550,913,"6 de julio de 1997"
16,7,16,263,246,292,538,"6 de julio de 1997"
16,7,16,264,192,224,416,"6 de julio de 1997"
16,7,16,265,225,294,519,"6 de julio de 1997"
16,7,16,266,70,96,166,"6 de julio de 1997"
16,7,16,267,415,489,904,"6 de julio de 1997"
16,7,16,268,167,197,364,"6 de julio de 1997"
16,7,16,269,178,251,429,"6 de julio de 1997"
16,7,16,270,229,273,502,"6 de julio de 1997"
16,7,16,271,204,275,479,"6 de julio de 1997"
16,7,16,272,207,314,521,"6 de julio de 1997"
16,7,16,273,218,298,516,"6 de julio de 1997"
16,7,16,274,194,231,425,"6 de julio de 1997"
16,7,16,275,164,194,358,"6 de julio de 1997"
16,7,16,276,107,146,253,"6 de julio de 1997"
16,7,16,277,255,353,608,"6 de julio de 1997"
16,7,16,278,304,427,731,"6 de julio de 1997"
16,7,16,279,181,225,406,"6 de julio de 1997"
16,7,16,280,299,380,679,"6 de julio de 1997"
16,7,16,281,185,239,424,"6 de julio de 1997"
16,7,16,282,353,413,766,"6 de julio de 1997"
16,7,16,283,92,86,178,"6 de julio de 1997"
16,7,16,284,216,286,502,"6 de julio de 1997"
16,7,16,285,223,391,614,"6 de julio de 1997"
16,7,24,372,563,677,1240,"6 de julio de 1997"
16,7,24,373,611,734,1345,"6 de julio de 1997"
16,7,24,374,473,564,1037,"6 de julio de 1997"
16,7,24,375,383,484,867,"6 de julio de 1997"
16,7,24,376,562,651,1213,"6 de julio de 1997"
16,7,24,377,382,436,818,"6 de julio de 1997"
16,7,24,378,433,474,907,"6 de julio de 1997"
16,7,24,379,260,302,562,"6 de julio de 1997"
16,7,32,457,655,712,1367,"6 de julio de 1997"
16,7,32,458,345,348,693,"6 de julio de 1997"
16,7,32,459,206,254,460,"6 de julio de 1997"
16,7,32,460,184,184,368,"6 de julio de 1997"
16,7,32,461,488,545,1033,"6 de julio de 1997"
16,7,32,462,168,194,362,"6 de julio de 1997"
16,7,32,463,463,493,956,"6 de julio de 1997"
16,7,32,464,509,485,994,"6 de julio de 1997"
16,7,32,465,299,311,610,"6 de julio de 1997"
16,7,32,466,221,265,486,"6 de julio de 1997"
16,7,37,590,239,312,551,"6 de julio de 1997"
16,7,37,591,210,291,501,"6 de julio de 1997"
16,7,37,592,420,584,1004,"6 de julio de 1997"
16,7,37,593,342,502,844,"6 de julio de 1997"
16,7,37,594,239,338,577,"6 de julio de 1997"
16,7,37,595,145,212,357,"6 de julio de 1997"
16,7,37,596,208,297,505,"6 de julio de 1997"
16,7,37,597,204,295,499,"6 de julio de 1997"
16,7,37,598,413,579,992,"6 de julio de 1997"
16,7,37,599,278,352,630,"6 de julio de 1997"
16,7,37,600,290,345,635,"6 de julio de 1997"
16,7,39,647,750,831,1581,"6 de julio de 1997"
16,7,39,648,225,289,514,"6 de julio de 1997"
16,7,39,649,175,218,393,"6 de julio de 1997"
16,7,39,650,511,541,1052,"6 de julio de 1997"
16,7,44,712,491,557,1048,"6 de julio de 1997"
16,7,44,713,316,441,757,"6 de julio de 1997"
16,7,44,714,509,642,1151,"6 de julio de 1997"
16,7,44,715,365,447,812,"6 de julio de 1997"
16,7,44,716,449,487,936,"6 de julio de 1997"
16,7,44,717,326,397,723,"6 de julio de 1997"
16,7,44,718,278,327,605,"6 de julio de 1997"
16,7,44,719,330,381,711,"6 de julio de 1997"
16,7,44,720,186,229,415,"6 de julio de 1997"
16,7,44,721,261,343,604,"6 de julio de 1997"
16,7,44,722,433,463,896,"6 de julio de 1997"
16,7,44,723,284,327,611,"6 de julio de 1997"
16,7,44,724,140,170,310,"6 de julio de 1997"
16,7,44,725,148,210,358,"6 de julio de 1997"
16,7,49,802,477,532,1009,"6 de julio de 1997"
16,7,49,803,485,536,1021,"6 de julio de 1997"
16,7,49,804,348,370,718,"6 de julio de 1997"
16,7,49,805,289,336,625,"6 de julio de 1997"
16,7,57,1321,513,610,1123,"6 de julio de 1997"
16,7,57,1322,385,458,843,"6 de julio de 1997"
16,7,57,1323,553,622,1175,"6 de julio de 1997"
16,7,57,1324,567,700,1267,"6 de julio de 1997"
16,7,57,1325,221,232,453,"6 de julio de 1997"
16,7,57,1326,367,412,779,"6 de julio de 1997"
16,7,57,1327,399,406,805,"6 de julio de 1997"
16,7,57,1328,516,515,1031,"6 de julio de 1997"
16,7,57,1329,295,300,595,"6 de julio de 1997"
16,7,57,1330,188,219,407,"6 de julio de 1997"
16,7,57,1331,341,352,693,"6 de julio de 1997"
16,7,57,1332,306,324,630,"6 de julio de 1997"
16,7,57,1333,346,388,734,"6 de julio de 1997"
16,7,57,1334,378,428,806,"6 de julio de 1997"
16,7,57,1335,252,268,520,"6 de julio de 1997"
16,7,67,1456,639,778,1417,"6 de julio de 1997"
16,7,67,1457,505,562,1067,"6 de julio de 1997"
16,7,67,1458,703,790,1493,"6 de julio de 1997"
16,7,67,1459,818,949,1767,"6 de julio de 1997"
16,7,67,1460,778,879,1657,"6 de julio de 1997"
16,7,67,1461,360,431,791,"6 de julio de 1997"
16,7,67,1462,532,633,1165,"6 de julio de 1997"
16,7,67,1463,216,286,502,"6 de julio de 1997"
16,7,67,1464,370,487,857,"6 de julio de 1997"
16,7,67,1465,509,577,1086,"6 de julio de 1997"
16,7,67,1466,406,536,942,"6 de julio de 1997"
16,7,67,1467,549,663,1212,"6 de julio de 1997"
16,7,67,1468,233,316,549,"6 de julio de 1997"
16,7,67,1469,445,534,979,"6 de julio de 1997"
16,7,67,1470,669,757,1426,"6 de julio de 1997"
16,7,67,1471,613,687,1300,"6 de julio de 1997"
16,7,67,1472,489,603,1092,"6 de julio de 1997"
16,7,67,1473,654,746,1400,"6 de julio de 1997"
16,7,67,1474,466,515,981,"6 de julio de 1997"
16,7,67,1475,480,561,1041,"6 de julio de 1997"
16,7,67,1476,808,952,1760,"6 de julio de 1997"
16,7,67,1477,643,767,1410,"6 de julio de 1997"
16,7,67,1478,419,502,921,"6 de julio de 1997"
16,7,67,1479,604,655,1259,"6 de julio de 1997"
16,7,67,1480,630,627,1257,"6 de julio de 1997"
16,7,67,1481,285,315,600,"6 de julio de 1997"
16,7,67,1482,280,323,603,"6 de julio de 1997"
16,7,67,1483,500,392,892,"6 de julio de 1997"
16,7,67,1484,231,279,510,"6 de julio de 1997"
16,7,67,1485,320,396,716,"6 de julio de 1997"
16,7,67,1486,337,370,707,"6 de julio de 1997"
16,7,67,1487,328,347,675,"6 de julio de 1997"
16,7,67,1488,196,232,428,"6 de julio de 1997"
16,7,67,1489,287,331,618,"6 de julio de 1997"
16,7,67,1490,335,342,677,"6 de julio de 1997"
16,7,67,1491,369,373,742,"6 de julio de 1997"
16,7,67,1492,304,384,688,"6 de julio de 1997"
16,7,67,1493,400,421,821,"6 de julio de 1997"
16,7,67,1494,103,126,229,"6 de julio de 1997"
16,7,67,1495,76,68,144,"6 de julio de 1997"
16,7,67,1496,335,334,669,"6 de julio de 1997"
16,7,67,1497,393,473,866,"6 de julio de 1997"
16,7,74,1661,558,630,1188,"6 de julio de 1997"
16,7,74,1662,850,951,1801,"6 de julio de 1997"
16,7,74,1663,519,628,1147,"6 de julio de 1997"
16,7,74,1664,597,659,1256,"6 de julio de 1997"
16,7,74,1665,615,751,1366,"6 de julio de 1997"
16,7,74,1666,507,546,1053,"6 de julio de 1997"
16,7,74,1667,324,451,775,"6 de julio de 1997"
16,7,74,1668,277,410,687,"6 de julio de 1997"
16,7,74,1669,535,514,1049,"6 de julio de 1997"
16,7,74,1670,536,501,1037,"6 de julio de 1997"
16,7,74,1671,287,418,705,"6 de julio de 1997"
16,7,74,1672,256,349,605,"6 de julio de 1997"
16,7,74,1673,121,139,260,"6 de julio de 1997"
16,7,74,1674,91,88,179,"6 de julio de 1997"
16,7,101,2151,408,496,904,"6 de julio de 1997"
16,7,101,2152,541,582,1123,"6 de julio de 1997"
16,7,101,2153,385,426,811,"6 de julio de 1997"
16,7,101,2154,209,213,422,"6 de julio de 1997"
16,7,101,2155,326,401,727,"6 de julio de 1997"
16,7,101,2156,89,88,177,"6 de julio de 1997"
16,7,101,2157,283,296,579,"6 de julio de 1997"
16,7,101,2158,442,480,922,"6 de julio de 1997"
16,7,101,2159,356,380,736,"6 de julio de 1997"
16,7,108,2389,530,691,1221,"6 de julio de 1997"
16,7,108,2390,473,563,1036,"6 de julio de 1997"
16,7,108,2391,675,769,1444,"6 de julio de 1997"
16,7,108,2392,582,639,1221,"6 de julio de 1997"
16,7,108,2393,482,561,1043,"6 de julio de 1997"
16,7,108,2394,551,625,1176,"6 de julio de 1997"
16,7,108,2395,316,353,669,"6 de julio de 1997"
16,7,108,2396,377,416,793,"6 de julio de 1997"
16,7,108,2397,444,503,947,"6 de julio de 1997"
16,7,108,2398,392,478,870,"6 de julio de 1997"
16,7,108,2399,685,803,1488,"6 de julio de 1997"
16,7,108,2400,306,398,704,"6 de julio de 1997"
16,7,108,2401,360,403,763,"6 de julio de 1997"
16,7,108,2402,345,394,739,"6 de julio de 1997"
16,7,108,2403,549,654,1203,"6 de julio de 1997"
16,7,108,2404,625,697,1322,"6 de julio de 1997"
16,7,108,2405,399,476,875,"6 de julio de 1997"
16,7,108,2406,671,690,1361,"6 de julio de 1997"
16,7,108,2407,508,534,1042,"6 de julio de 1997"
16,7,108,2408,501,572,1073,"6 de julio de 1997"
16,7,108,2409,405,456,861,"6 de julio de 1997"
16,7,108,2410,483,546,1029,"6 de julio de 1997"
16,7,108,2411,677,743,1420,"6 de julio de 1997"
16,7,108,2412,706,774,1480,"6 de julio de 1997"
16,7,108,2413,332,383,715,"6 de julio de 1997"
16,7,108,2414,307,349,656,"6 de julio de 1997"
16,7,108,2415,287,310,597,"6 de julio de 1997"
16,7,108,2416,643,721,1364,"6 de julio de 1997"
16,7,108,2417,280,304,584,"6 de julio de 1997"
16,7,108,2418,396,505,901,"6 de julio de 1997"
16,7,108,2419,345,405,750,"6 de julio de 1997"
16,7,108,2420,434,468,902,"6 de julio de 1997"
16,7,108,2421,470,637,1107,"6 de julio de 1997"
16,7,108,2422,601,700,1301,"6 de julio de 1997"
16,7,108,2423,512,544,1056,"6 de julio de 1997"
16,7,108,2424,207,252,459,"6 de julio de 1997"
16,7,108,2425,284,317,601,"6 de julio de 1997"
16,7,108,2426,217,278,495,"6 de julio de 1997"
16,7,108,2427,278,347,625,"6 de julio de 1997"
16,7,108,2428,259,336,595,"6 de julio de 1997"
16,7,108,2429,119,120,239,"6 de julio de 1997"
16,7,108,2430,194,207,401,"6 de julio de 1997"
16,7,108,2431,220,266,486,"6 de julio de 1997"
16,7,108,2432,159,186,345,"6 de julio de 1997"
16,7,108,2433,294,320,614,"6 de julio de 1997"
16,7,108,2434,215,271,486,"6 de julio de 1997"
16,7,108,2435,111,99,210,"6 de julio de 1997"
16,8,54,941,437,499,936,"6 de julio de 1997"
16,8,54,942,408,452,860,"6 de julio de 1997"
16,8,54,943,386,411,797,"6 de julio de 1997"
16,8,54,944,466,490,956,"6 de julio de 1997"
16,8,54,945,538,692,1230,"6 de julio de 1997"
16,8,54,946,373,441,814,"6 de julio de 1997"
16,8,54,947,426,491,917,"6 de julio de 1997"
16,8,54,948,482,582,1064,"6 de julio de 1997"
16,8,54,949,737,862,1599,"6 de julio de 1997"
16,8,54,950,431,506,937,"6 de julio de 1997"
16,8,54,951,525,583,1108,"6 de julio de 1997"
16,8,54,952,528,578,1106,"6 de julio de 1997"
16,8,54,953,554,643,1197,"6 de julio de 1997"
16,8,54,954,282,365,647,"6 de julio de 1997"
16,8,54,955,496,567,1063,"6 de julio de 1997"
16,8,54,956,468,562,1030,"6 de julio de 1997"
16,8,54,957,318,391,709,"6 de julio de 1997"
16,8,54,958,723,849,1572,"6 de julio de 1997"
16,8,54,959,424,503,927,"6 de julio de 1997"
16,8,54,960,624,742,1366,"6 de julio de 1997"
16,8,54,961,278,317,595,"6 de julio de 1997"
16,8,54,962,493,539,1032,"6 de julio de 1997"
16,8,54,963,547,659,1206,"6 de julio de 1997"
16,8,54,964,444,512,956,"6 de julio de 1997"
16,8,54,965,459,560,1019,"6 de julio de 1997"
16,8,54,966,493,565,1058,"6 de julio de 1997"
16,8,54,967,464,492,956,"6 de julio de 1997"
16,8,54,968,457,516,973,"6 de julio de 1997"
16,8,54,969,527,651,1178,"6 de julio de 1997"
16,8,54,970,565,590,1155,"6 de julio de 1997"
16,8,54,971,254,282,536,"6 de julio de 1997"
16,8,54,972,517,599,1116,"6 de julio de 1997"
16,8,54,973,324,375,699,"6 de julio de 1997"
16,8,54,974,193,241,434,"6 de julio de 1997"
16,8,54,975,132,170,302,"6 de julio de 1997"
16,8,54,976,216,273,489,"6 de julio de 1997"
16,8,54,977,246,300,546,"6 de julio de 1997"
16,8,54,978,520,608,1128,"6 de julio de 1997"
16,8,54,979,271,319,590,"6 de julio de 1997"
16,8,54,980,254,309,563,"6 de julio de 1997"
16,8,54,981,290,314,604,"6 de julio de 1997"
16,8,54,982,262,289,551,"6 de julio de 1997"
16,8,54,983,436,529,965,"6 de julio de 1997"
16,8,54,984,389,423,812,"6 de julio de 1997"
16,8,54,985,391,441,832,"6 de julio de 1997"
16,8,54,986,243,252,495,"6 de julio de 1997"
16,8,54,987,242,306,548,"6 de julio de 1997"
16,8,54,988,421,515,936,"6 de julio de 1997"
16,8,54,989,400,460,860,"6 de julio de 1997"
16,8,54,990,296,319,615,"6 de julio de 1997"
16,8,54,991,304,368,672,"6 de julio de 1997"
16,8,54,992,395,496,891,"6 de julio de 1997"
16,8,54,993,229,268,497,"6 de julio de 1997"
16,8,54,994,396,478,874,"6 de julio de 1997"
16,8,54,995,463,485,948,"6 de julio de 1997"
16,8,54,996,304,405,709,"6 de julio de 1997"
16,8,54,997,462,544,1006,"6 de julio de 1997"
16,8,54,998,569,663,1232,"6 de julio de 1997"
16,8,54,999,503,582,1085,"6 de julio de 1997"
16,8,54,1000,444,486,930,"6 de julio de 1997"
16,8,54,1001,412,504,916,"6 de julio de 1997"
16,8,54,1002,454,508,962,"6 de julio de 1997"
16,8,54,1003,378,475,853,"6 de julio de 1997"
16,8,54,1004,575,672,1247,"6 de julio de 1997"
16,8,54,1005,493,633,1126,"6 de julio de 1997"
16,8,54,1006,387,473,860,"6 de julio de 1997"
16,8,54,1007,569,638,1207,"6 de julio de 1997"
16,8,54,1008,647,757,1404,"6 de julio de 1997"
16,8,54,1009,412,484,896,"6 de julio de 1997"
16,8,54,1010,477,561,1038,"6 de julio de 1997"
16,8,54,1011,508,621,1129,"6 de julio de 1997"
16,8,54,1012,450,563,1013,"6 de julio de 1997"
16,8,54,1013,458,544,1002,"6 de julio de 1997"
16,8,54,1014,405,476,881,"6 de julio de 1997"
16,8,54,1015,575,679,1254,"6 de julio de 1997"
16,8,54,1016,404,471,875,"6 de julio de 1997"
16,8,54,1017,292,372,664,"6 de julio de 1997"
16,8,54,1018,341,458,799,"6 de julio de 1997"
16,8,54,1019,410,570,980,"6 de julio de 1997"
16,8,54,1020,613,716,1329,"6 de julio de 1997"
16,8,54,1021,313,467,780,"6 de julio de 1997"
16,8,54,1022,216,280,496,"6 de julio de 1997"
16,8,54,1023,263,305,568,"6 de julio de 1997"
16,8,54,1024,181,257,438,"6 de julio de 1997"
16,8,54,1025,227,314,541,"6 de julio de 1997"
16,8,54,1026,283,387,670,"6 de julio de 1997"
16,8,54,1027,166,260,426,"6 de julio de 1997"
16,8,54,1028,202,242,444,"6 de julio de 1997"
16,8,54,1029,288,464,752,"6 de julio de 1997"
16,8,54,1030,404,513,917,"6 de julio de 1997"
16,8,54,1031,457,545,1002,"6 de julio de 1997"
16,8,54,1032,594,666,1260,"6 de julio de 1997"
16,8,54,1033,633,749,1382,"6 de julio de 1997"
16,8,54,1034,555,635,1190,"6 de julio de 1997"
16,8,54,1035,415,548,963,"6 de julio de 1997"
16,8,54,1036,309,389,698,"6 de julio de 1997"
16,8,54,1037,573,663,1236,"6 de julio de 1997"
16,8,54,1038,540,633,1173,"6 de julio de 1997"
16,8,54,1039,512,615,1127,"6 de julio de 1997"
16,8,54,1040,572,652,1224,"6 de julio de 1997"
16,8,54,1041,408,501,909,"6 de julio de 1997"
16,8,54,1042,257,345,602,"6 de julio de 1997"
16,8,54,1088,282,400,682,"6 de julio de 1997"
16,8,54,1089,428,528,956,"6 de julio de 1997"
16,8,54,1090,289,364,653,"6 de julio de 1997"
16,8,54,1091,284,342,626,"6 de julio de 1997"
16,8,54,1092,457,564,1021,"6 de julio de 1997"
16,8,54,1093,484,580,1064,"6 de julio de 1997"
16,8,54,1094,477,542,1019,"6 de julio de 1997"
16,8,54,1095,360,387,747,"6 de julio de 1997"
16,8,54,1096,524,588,1112,"6 de julio de 1997"
16,8,54,1097,531,597,1128,"6 de julio de 1997"
16,8,54,1098,395,440,835,"6 de julio de 1997"
16,8,54,1099,437,477,914,"6 de julio de 1997"
16,8,54,1100,382,439,821,"6 de julio de 1997"
16,8,54,1101,564,701,1265,"6 de julio de 1997"
16,8,54,1102,508,652,1160,"6 de julio de 1997"
16,8,54,1103,491,554,1045,"6 de julio de 1997"
16,8,54,1104,447,510,957,"6 de julio de 1997"
16,8,54,1105,280,373,653,"6 de julio de 1997"
16,8,54,1106,482,579,1061,"6 de julio de 1997"
16,8,54,1191,736,828,1564,"6 de julio de 1997"
16,8,54,1192,1001,1161,2162,"6 de julio de 1997"
16,8,54,1193,720,881,1601,"6 de julio de 1997"
16,8,54,1194,725,844,1569,"6 de julio de 1997"
16,8,54,1195,603,707,1310,"6 de julio de 1997"
16,8,54,1196,930,1125,2055,"6 de julio de 1997"
16,8,54,1197,520,588,1108,"6 de julio de 1997"
16,8,54,1198,607,710,1317,"6 de julio de 1997"
16,8,54,1199,652,738,1390,"6 de julio de 1997"
16,8,54,1200,330,365,695,"6 de julio de 1997"
16,8,54,1201,434,501,935,"6 de julio de 1997"
16,8,54,1202,690,800,1490,"6 de julio de 1997"
16,8,54,1203,541,581,1122,"6 de julio de 1997"
16,8,54,1204,565,694,1259,"6 de julio de 1997"
16,8,54,1205,613,688,1301,"6 de julio de 1997"
16,8,54,1206,770,900,1670,"6 de julio de 1997"
16,8,54,1207,566,672,1238,"6 de julio de 1997"
16,8,54,1208,565,683,1248,"6 de julio de 1997"
16,8,54,1209,631,711,1342,"6 de julio de 1997"
16,8,54,1210,317,375,692,"6 de julio de 1997"
16,8,54,1211,528,686,1214,"6 de julio de 1997"
16,8,54,1212,582,696,1278,"6 de julio de 1997"
16,8,54,1213,411,447,858,"6 de julio de 1997"
16,8,54,1214,477,584,1061,"6 de julio de 1997"
16,8,54,1216,748,884,1632,"6 de julio de 1997"
16,8,54,1217,470,534,1004,"6 de julio de 1997"
16,8,54,1218,564,654,1218,"6 de julio de 1997"
16,8,54,1219,564,656,1220,"6 de julio de 1997"
16,8,54,1220,720,804,1524,"6 de julio de 1997"
16,8,54,1237,391,405,796,"6 de julio de 1997"
16,8,54,1238,280,287,567,"6 de julio de 1997"
16,8,54,1252,592,642,1234,"6 de julio de 1997"
16,8,54,1253,267,277,544,"6 de julio de 1997"
16,8,54,1254,200,210,410,"6 de julio de 1997"
16,8,54,1255,322,353,675,"6 de julio de 1997"
16,8,54,1256,509,511,1020,"6 de julio de 1997"
16,8,54,1257,301,345,646,"6 de julio de 1997"
16,8,54,1258,95,78,173,"6 de julio de 1997"
16,8,54,1259,134,128,262,"6 de julio de 1997"
16,8,54,1260,283,334,617,"6 de julio de 1997"
16,8,54,1261,373,455,828,"6 de julio de 1997"
16,8,54,1262,486,464,950,"6 de julio de 1997"
16,8,54,1263,703,879,1582,"6 de julio de 1997"
16,8,54,1283,944,1169,2113,"6 de julio de 1997"
16,8,54,1284,628,792,1420,"6 de julio de 1997"
16,8,54,1285,535,649,1184,"6 de julio de 1997"
16,9,21,340,334,407,741,"6 de julio de 1997"
16,9,21,341,598,690,1288,"6 de julio de 1997"
16,9,21,342,377,514,891,"6 de julio de 1997"
16,9,21,343,305,462,767,"6 de julio de 1997"
16,9,21,344,420,482,902,"6 de julio de 1997"
16,9,21,345,364,615,979,"6 de julio de 1997"
16,9,59,1349,262,292,554,"6 de julio de 1997"
16,9,59,1350,415,469,884,"6 de julio de 1997"
16,9,59,1351,535,654,1189,"6 de julio de 1997"
16,9,59,1352,495,612,1107,"6 de julio de 1997"
16,9,59,1353,615,704,1319,"6 de julio de 1997"
16,9,59,1354,647,696,1343,"6 de julio de 1997"
16,9,59,1355,190,186,376,"6 de julio de 1997"
16,9,59,1356,307,305,612,"6 de julio de 1997"
16,9,59,1357,263,216,479,"6 de julio de 1997"
16,9,59,1358,43,44,87,"6 de julio de 1997"
16,9,59,1359,81,65,146,"6 de julio de 1997"
16,9,66,1440,496,541,1037,"6 de julio de 1997"
16,9,66,1441,324,373,697,"6 de julio de 1997"
16,9,66,1442,376,443,819,"6 de julio de 1997"
16,9,66,1443,578,616,1194,"6 de julio de 1997"
16,9,66,1444,401,455,856,"6 de julio de 1997"
16,9,66,1445,575,652,1227,"6 de julio de 1997"
16,9,66,1446,696,748,1444,"6 de julio de 1997"
16,9,66,1447,370,428,798,"6 de julio de 1997"
16,9,66,1448,416,482,898,"6 de julio de 1997"
16,9,66,1449,519,695,1214,"6 de julio de 1997"
16,9,66,1450,494,602,1096,"6 de julio de 1997"
16,9,66,1451,526,605,1131,"6 de julio de 1997"
16,9,66,1452,469,590,1059,"6 de julio de 1997"
16,9,66,1453,328,433,761,"6 de julio de 1997"
16,9,66,1454,338,435,773,"6 de julio de 1997"
16,9,66,1455,467,508,975,"6 de julio de 1997"
16,9,88,1950,410,416,826,"6 de julio de 1997"
16,9,88,1951,516,559,1075,"6 de julio de 1997"
16,9,88,1952,541,610,1151,"6 de julio de 1997"
16,9,88,1953,535,564,1099,"6 de julio de 1997"
16,9,88,1954,377,361,738,"6 de julio de 1997"
16,9,88,1955,619,662,1281,"6 de julio de 1997"
16,9,88,1956,305,301,606,"6 de julio de 1997"
16,9,88,1957,288,270,558,"6 de julio de 1997"
16,9,88,1958,84,87,171,"6 de julio de 1997"
16,9,91,1995,295,369,664,"6 de julio de 1997"
16,9,91,1996,514,568,1082,"6 de julio de 1997"
16,9,91,1997,461,524,985,"6 de julio de 1997"
16,9,91,1998,362,420,782,"6 de julio de 1997"
16,9,91,1999,385,394,779,"6 de julio de 1997"
16,9,91,2000,456,504,960,"6 de julio de 1997"
16,9,91,2001,220,206,426,"6 de julio de 1997"
16,9,103,2175,595,731,1326,"6 de julio de 1997"
16,9,103,2176,397,463,860,"6 de julio de 1997"
16,9,103,2177,539,612,1151,"6 de julio de 1997"
16,9,103,2178,299,352,651,"6 de julio de 1997"
16,9,103,2179,532,621,1153,"6 de julio de 1997"
16,9,103,2180,372,433,805,"6 de julio de 1997"
16,9,103,2181,507,622,1129,"6 de julio de 1997"
16,9,103,2182,514,545,1059,"6 de julio de 1997"
16,9,103,2183,323,391,714,"6 de julio de 1997"
16,9,103,2184,594,673,1267,"6 de julio de 1997"
16,9,103,2185,594,646,1240,"6 de julio de 1997"
16,9,103,2186,439,548,987,"6 de julio de 1997"
16,9,103,2187,561,693,1254,"6 de julio de 1997"
16,9,103,2188,511,564,1075,"6 de julio de 1997"
16,9,103,2189,607,683,1290,"6 de julio de 1997"
16,9,103,2190,317,403,720,"6 de julio de 1997"
16,9,103,2191,393,443,836,"6 de julio de 1997"
16,9,103,2192,453,535,988,"6 de julio de 1997"
16,9,103,2193,414,442,856,"6 de julio de 1997"
16,9,103,2194,479,579,1058,"6 de julio de 1997"
16,9,103,2195,563,688,1251,"6 de julio de 1997"
16,9,103,2196,360,422,782,"6 de julio de 1997"
16,9,103,2197,490,499,989,"6 de julio de 1997"
16,9,103,2198,599,659,1258,"6 de julio de 1997"
16,9,103,2199,382,496,878,"6 de julio de 1997"
16,9,103,2200,513,547,1060,"6 de julio de 1997"
16,9,103,2201,487,589,1076,"6 de julio de 1997"
16,9,103,2202,397,491,888,"6 de julio de 1997"
16,9,103,2203,466,552,1018,"6 de julio de 1997"
16,9,103,2204,381,401,782,"6 de julio de 1997"
16,9,103,2205,302,350,652,"6 de julio de 1997"
16,9,103,2206,561,623,1184,"6 de julio de 1997"
16,9,103,2207,414,444,858,"6 de julio de 1997"
16,9,103,2208,523,563,1086,"6 de julio de 1997"
16,9,103,2209,422,485,907,"6 de julio de 1997"
16,9,103,2210,454,534,988,"6 de julio de 1997"
16,9,103,2211,501,577,1078,"6 de julio de 1997"
16,9,103,2212,404,529,933,"6 de julio de 1997"
16,9,103,2213,605,657,1262,"6 de julio de 1997"
16,9,103,2214,487,557,1044,"6 de julio de 1997"
16,9,103,2215,380,506,886,"6 de julio de 1997"
16,9,103,2216,281,413,694,"6 de julio de 1997"
16,9,103,2217,361,414,775,"6 de julio de 1997"
16,9,103,2218,423,471,894,"6 de julio de 1997"
16,9,103,2219,631,724,1355,"6 de julio de 1997"
16,9,103,2220,412,585,997,"6 de julio de 1997"
16,9,103,2221,327,428,755,"6 de julio de 1997"
16,9,103,2222,410,481,891,"6 de julio de 1997"
16,9,103,2223,328,402,730,"6 de julio de 1997"
16,9,103,2224,412,489,901,"6 de julio de 1997"
16,9,103,2225,556,681,1237,"6 de julio de 1997"
16,9,103,2226,683,777,1460,"6 de julio de 1997"
16,9,103,2227,530,635,1165,"6 de julio de 1997"
16,9,103,2228,461,566,1027,"6 de julio de 1997"
16,9,103,2229,590,662,1252,"6 de julio de 1997"
16,9,103,2230,420,446,866,"6 de julio de 1997"
16,9,103,2231,469,540,1009,"6 de julio de 1997"
16,9,103,2232,442,508,950,"6 de julio de 1997"
16,9,103,2233,314,380,694,"6 de julio de 1997"
16,9,103,2234,471,594,1065,"6 de julio de 1997"
16,9,103,2235,444,503,947,"6 de julio de 1997"
16,9,103,2236,356,444,800,"6 de julio de 1997"
16,9,103,2237,221,280,501,"6 de julio de 1997"
16,9,103,2238,489,588,1077,"6 de julio de 1997"
16,9,103,2239,554,682,1236,"6 de julio de 1997"
16,9,103,2240,382,487,869,"6 de julio de 1997"
16,9,103,2241,402,508,910,"6 de julio de 1997"
16,9,103,2242,300,389,689,"6 de julio de 1997"
16,9,103,2243,538,630,1168,"6 de julio de 1997"
16,9,103,2244,446,517,963,"6 de julio de 1997"
16,9,103,2245,305,393,698,"6 de julio de 1997"
16,9,103,2246,333,394,727,"6 de julio de 1997"
16,9,103,2247,335,413,748,"6 de julio de 1997"
16,9,103,2248,446,520,966,"6 de julio de 1997"
16,9,103,2249,446,529,975,"6 de julio de 1997"
16,9,103,2250,479,603,1082,"6 de julio de 1997"
16,9,103,2251,509,601,1110,"6 de julio de 1997"
16,9,103,2252,344,402,746,"6 de julio de 1997"
16,9,103,2253,467,557,1024,"6 de julio de 1997"
16,9,103,2254,450,541,991,"6 de julio de 1997"
16,9,103,2255,543,637,1180,"6 de julio de 1997"
16,9,103,2256,717,844,1561,"6 de julio de 1997"
16,9,103,2257,364,397,761,"6 de julio de 1997"
16,9,103,2258,330,383,713,"6 de julio de 1997"
16,9,103,2259,592,695,1287,"6 de julio de 1997"
16,9,103,2260,505,599,1104,"6 de julio de 1997"
16,9,103,2261,530,572,1102,"6 de julio de 1997"
16,9,103,2262,602,699,1301,"6 de julio de 1997"
16,9,103,2263,645,759,1404,"6 de julio de 1997"
16,9,103,2264,585,680,1265,"6 de julio de 1997"
16,9,103,2265,412,528,940,"6 de julio de 1997"
16,9,103,2266,470,584,1054,"6 de julio de 1997"
16,9,103,2267,502,583,1085,"6 de julio de 1997"
16,9,103,2268,624,762,1386,"6 de julio de 1997"
16,9,103,2269,463,555,1018,"6 de julio de 1997"
16,9,103,2270,342,398,740,"6 de julio de 1997"
16,9,103,2271,473,524,997,"6 de julio de 1997"
16,9,103,2272,510,646,1156,"6 de julio de 1997"
16,9,103,2273,747,822,1569,"6 de julio de 1997"
16,9,103,2274,496,569,1065,"6 de julio de 1997"
16,9,103,2275,511,610,1121,"6 de julio de 1997"
16,9,103,2276,519,580,1099,"6 de julio de 1997"
16,9,103,2277,441,512,953,"6 de julio de 1997"
16,9,103,2278,368,395,763,"6 de julio de 1997"
16,9,103,2279,248,241,489,"6 de julio de 1997"
16,9,103,2280,497,571,1068,"6 de julio de 1997"
16,9,103,2281,350,389,739,"6 de julio de 1997"
16,9,103,2282,448,558,1006,"6 de julio de 1997"
16,9,103,2283,531,644,1175,"6 de julio de 1997"
16,9,103,2284,481,583,1064,"6 de julio de 1997"
16,9,103,2285,598,683,1281,"6 de julio de 1997"
16,9,103,2286,629,715,1344,"6 de julio de 1997"
16,9,103,2287,676,690,1366,"6 de julio de 1997"
16,9,103,2288,511,600,1111,"6 de julio de 1997"
16,9,103,2289,434,536,970,"6 de julio de 1997"
16,9,103,2290,556,704,1260,"6 de julio de 1997"
16,9,103,2291,540,602,1142,"6 de julio de 1997"
16,9,103,2292,521,573,1094,"6 de julio de 1997"
16,9,103,2293,850,972,1822,"6 de julio de 1997"
16,9,103,2294,228,290,518,"6 de julio de 1997"
16,9,103,2295,446,434,880,"6 de julio de 1997"
16,9,103,2296,372,373,745,"6 de julio de 1997"
16,9,103,2297,506,550,1056,"6 de julio de 1997"
16,9,103,2298,371,439,810,"6 de julio de 1997"
16,9,103,2299,524,453,977,"6 de julio de 1997"
16,9,103,2300,590,474,1064,"6 de julio de 1997"
16,9,103,2301,312,327,639,"6 de julio de 1997"
16,9,103,2302,269,293,562,"6 de julio de 1997"
16,9,103,2303,355,343,698,"6 de julio de 1997"
16,9,103,2304,384,390,774,"6 de julio de 1997"
16,9,103,2305,462,516,978,"6 de julio de 1997"
16,9,103,2306,267,252,519,"6 de julio de 1997"
16,9,103,2307,107,91,198,"6 de julio de 1997"
16,9,103,2308,221,257,478,"6 de julio de 1997"
16,9,103,2309,316,344,660,"6 de julio de 1997"
16,9,103,2310,259,260,519,"6 de julio de 1997"
16,9,103,2311,452,518,970,"6 de julio de 1997"
16,9,103,2312,262,256,518,"6 de julio de 1997"
16,9,103,2313,155,137,292,"6 de julio de 1997"
16,9,103,2314,297,256,553,"6 de julio de 1997"
16,9,103,2315,119,84,203,"6 de julio de 1997"
16,9,103,2316,278,287,565,"6 de julio de 1997"
16,9,112,2570,581,597,1178,"6 de julio de 1997"
16,9,112,2571,357,372,729,"6 de julio de 1997"
16,9,112,2572,773,855,1628,"6 de julio de 1997"
16,9,112,2573,491,572,1063,"6 de julio de 1997"
16,9,112,2574,352,364,716,"6 de julio de 1997"
16,9,112,2575,276,279,555,"6 de julio de 1997"
16,9,112,2576,257,272,529,"6 de julio de 1997"
16,9,112,2577,87,89,176,"6 de julio de 1997"
16,10,54,1043,226,317,543,"6 de julio de 1997"
16,10,54,1044,353,486,839,"6 de julio de 1997"
16,10,54,1045,563,601,1164,"6 de julio de 1997"
16,10,54,1046,424,364,788,"6 de julio de 1997"
16,10,54,1047,482,481,963,"6 de julio de 1997"
16,10,54,1048,322,409,731,"6 de julio de 1997"
16,10,54,1049,298,353,651,"6 de julio de 1997"
16,10,54,1050,434,476,910,"6 de julio de 1997"
16,10,54,1051,467,579,1046,"6 de julio de 1997"
16,10,54,1052,505,560,1065,"6 de julio de 1997"
16,10,54,1053,458,515,973,"6 de julio de 1997"
16,10,54,1054,281,328,609,"6 de julio de 1997"
16,10,54,1055,318,393,711,"6 de julio de 1997"
16,10,54,1056,304,368,672,"6 de julio de 1997"
16,10,54,1057,502,572,1074,"6 de julio de 1997"
16,10,54,1058,457,531,988,"6 de julio de 1997"
16,10,54,1059,655,725,1380,"6 de julio de 1997"
16,10,54,1060,432,508,940,"6 de julio de 1997"
16,10,54,1061,166,223,389,"6 de julio de 1997"
16,10,54,1062,484,532,1016,"6 de julio de 1997"
16,10,54,1063,482,581,1063,"6 de julio de 1997"
16,10,54,1064,426,543,969,"6 de julio de 1997"
16,10,54,1065,210,259,469,"6 de julio de 1997"
16,10,54,1066,417,506,923,"6 de julio de 1997"
16,10,54,1067,313,399,712,"6 de julio de 1997"
16,10,54,1068,268,345,613,"6 de julio de 1997"
16,10,54,1069,279,341,620,"6 de julio de 1997"
16,10,54,1070,398,460,858,"6 de julio de 1997"
16,10,54,1071,276,399,675,"6 de julio de 1997"
16,10,54,1072,347,428,775,"6 de julio de 1997"
16,10,54,1073,303,377,680,"6 de julio de 1997"
16,10,54,1074,474,521,995,"6 de julio de 1997"
16,10,54,1075,280,398,678,"6 de julio de 1997"
16,10,54,1076,585,729,1314,"6 de julio de 1997"
16,10,54,1077,710,908,1618,"6 de julio de 1997"
16,10,54,1078,652,762,1414,"6 de julio de 1997"
16,10,54,1079,300,395,695,"6 de julio de 1997"
16,10,54,1080,296,383,679,"6 de julio de 1997"
16,10,54,1081,504,652,1156,"6 de julio de 1997"
16,10,54,1082,497,625,1122,"6 de julio de 1997"
16,10,54,1083,727,311,1038,"6 de julio de 1997"
16,10,54,1084,466,545,1011,"6 de julio de 1997"
16,10,54,1085,523,650,1173,"6 de julio de 1997"
16,10,54,1086,481,552,1033,"6 de julio de 1997"
16,10,54,1087,498,627,1125,"6 de julio de 1997"
16,10,54,1107,584,600,1184,"6 de julio de 1997"
16,10,54,1108,669,751,1420,"6 de julio de 1997"
16,10,54,1109,453,553,1006,"6 de julio de 1997"
16,10,54,1110,482,533,1015,"6 de julio de 1997"
16,10,54,1111,462,539,1001,"6 de julio de 1997"
16,10,54,1112,393,475,868,"6 de julio de 1997"
16,10,54,1113,357,461,818,"6 de julio de 1997"
16,10,54,1114,366,450,816,"6 de julio de 1997"
16,10,54,1115,413,470,883,"6 de julio de 1997"
16,10,54,1116,437,508,945,"6 de julio de 1997"
16,10,54,1117,385,445,830,"6 de julio de 1997"
16,10,54,1118,430,482,912,"6 de julio de 1997"
16,10,54,1119,375,470,845,"6 de julio de 1997"
16,10,54,1120,439,513,952,"6 de julio de 1997"
16,10,54,1121,570,642,1212,"6 de julio de 1997"
16,10,54,1122,464,554,1018,"6 de julio de 1997"
16,10,54,1123,378,457,835,"6 de julio de 1997"
16,10,54,1124,341,422,763,"6 de julio de 1997"
16,10,54,1125,663,754,1417,"6 de julio de 1997"
16,10,54,1126,550,643,1193,"6 de julio de 1997"
16,10,54,1127,398,486,884,"6 de julio de 1997"
16,10,54,1128,597,731,1328,"6 de julio de 1997"
16,10,54,1129,526,562,1088,"6 de julio de 1997"
16,10,54,1130,309,368,677,"6 de julio de 1997"
16,10,54,1131,530,618,1148,"6 de julio de 1997"
16,10,54,1132,303,410,713,"6 de julio de 1997"
16,10,54,1133,418,514,932,"6 de julio de 1997"
16,10,54,1134,366,456,822,"6 de julio de 1997"
16,10,54,1135,496,608,1104,"6 de julio de 1997"
16,10,54,1136,511,592,1103,"6 de julio de 1997"
16,10,54,1137,461,559,1020,"6 de julio de 1997"
16,10,54,1138,446,515,961,"6 de julio de 1997"
16,10,54,1139,403,456,859,"6 de julio de 1997"
16,10,54,1140,264,321,585,"6 de julio de 1997"
16,10,54,1141,590,697,1287,"6 de julio de 1997"
16,10,54,1142,275,307,582,"6 de julio de 1997"
16,10,54,1143,425,509,934,"6 de julio de 1997"
16,10,54,1144,450,558,1008,"6 de julio de 1997"
16,10,54,1145,379,406,785,"6 de julio de 1997"
16,10,54,1146,273,326,599,"6 de julio de 1997"
16,10,54,1147,527,607,1134,"6 de julio de 1997"
16,10,54,1148,416,487,903,"6 de julio de 1997"
16,10,54,1149,282,331,613,"6 de julio de 1997"
16,10,54,1150,482,580,1062,"6 de julio de 1997"
16,10,54,1151,250,294,544,"6 de julio de 1997"
16,10,54,1152,260,299,559,"6 de julio de 1997"
16,10,54,1153,194,227,421,"6 de julio de 1997"
16,10,54,1154,206,276,482,"6 de julio de 1997"
16,10,54,1155,405,524,929,"6 de julio de 1997"
16,10,54,1156,180,231,411,"6 de julio de 1997"
16,10,54,1157,232,282,514,"6 de julio de 1997"
16,10,54,1158,453,510,963,"6 de julio de 1997"
16,10,54,1159,477,529,1006,"6 de julio de 1997"
16,10,54,1160,647,694,1341,"6 de julio de 1997"
16,10,54,1161,381,443,824,"6 de julio de 1997"
16,10,54,1162,253,313,566,"6 de julio de 1997"
16,10,54,1163,208,248,456,"6 de julio de 1997"
16,10,54,1164,299,362,661,"6 de julio de 1997"
16,10,54,1165,507,614,1121,"6 de julio de 1997"
16,10,54,1166,496,586,1082,"6 de julio de 1997"
16,10,54,1167,363,396,759,"6 de julio de 1997"
16,10,54,1168,508,560,1068,"6 de julio de 1997"
16,10,54,1169,527,629,1156,"6 de julio de 1997"
16,10,54,1170,515,602,1117,"6 de julio de 1997"
16,10,54,1171,342,411,753,"6 de julio de 1997"
16,10,54,1172,469,568,1037,"6 de julio de 1997"
16,10,54,1173,282,335,617,"6 de julio de 1997"
16,10,54,1174,311,356,667,"6 de julio de 1997"
16,10,54,1175,451,480,931,"6 de julio de 1997"
16,10,54,1176,268,323,591,"6 de julio de 1997"
16,10,54,1177,423,465,888,"6 de julio de 1997"
16,10,54,1178,411,429,840,"6 de julio de 1997"
16,10,54,1179,665,788,1453,"6 de julio de 1997"
16,10,54,1180,177,233,410,"6 de julio de 1997"
16,10,54,1181,391,470,861,"6 de julio de 1997"
16,10,54,1182,463,585,1048,"6 de julio de 1997"
16,10,54,1183,358,418,776,"6 de julio de 1997"
16,10,54,1184,756,891,1647,"6 de julio de 1997"
16,10,54,1185,460,567,1027,"6 de julio de 1997"
16,10,54,1186,527,608,1135,"6 de julio de 1997"
16,10,54,1187,451,491,942,"6 de julio de 1997"
16,10,54,1188,521,545,1066,"6 de julio de 1997"
16,10,54,1189,361,395,756,"6 de julio de 1997"
16,10,54,1190,349,360,709,"6 de julio de 1997"
16,10,54,1215,667,788,1455,"6 de julio de 1997"
16,10,54,1221,916,1072,1988,"6 de julio de 1997"
16,10,54,1222,578,651,1229,"6 de julio de 1997"
16,10,54,1223,487,379,866,"6 de julio de 1997"
16,10,54,1224,844,1008,1852,"6 de julio de 1997"
16,10,54,1225,786,959,1745,"6 de julio de 1997"
16,10,54,1226,572,706,1278,"6 de julio de 1997"
16,10,54,1227,228,293,521,"6 de julio de 1997"
16,10,54,1228,333,384,717,"6 de julio de 1997"
16,10,54,1229,398,450,848,"6 de julio de 1997"
16,10,54,1230,404,501,905,"6 de julio de 1997"
16,10,54,1231,294,323,617,"6 de julio de 1997"
16,10,54,1232,799,923,1722,"6 de julio de 1997"
16,10,54,1233,474,559,1033,"6 de julio de 1997"
16,10,54,1234,438,524,962,"6 de julio de 1997"
16,10,54,1235,442,518,960,"6 de julio de 1997"
16,10,54,1236,513,592,1105,"6 de julio de 1997"
16,10,54,1239,646,713,1359,"6 de julio de 1997"
16,10,54,1240,445,539,984,"6 de julio de 1997"
16,10,54,1241,565,646,1211,"6 de julio de 1997"
16,10,54,1242,545,602,1147,"6 de julio de 1997"
16,10,54,1243,63,82,145,"6 de julio de 1997"
16,10,54,1244,271,315,586,"6 de julio de 1997"
16,10,54,1245,425,471,896,"6 de julio de 1997"
16,10,54,1246,64,69,133,"6 de julio de 1997"
16,10,54,1247,442,634,1076,"6 de julio de 1997"
16,10,54,1248,263,292,555,"6 de julio de 1997"
16,10,54,1249,216,259,475,"6 de julio de 1997"
16,10,54,1250,712,796,1508,"6 de julio de 1997"
16,10,54,1251,540,621,1161,"6 de julio de 1997"
16,10,54,1264,508,580,1088,"6 de julio de 1997"
16,10,54,1265,284,335,619,"6 de julio de 1997"
16,10,54,1266,359,398,757,"6 de julio de 1997"
16,10,54,1267,406,406,812,"6 de julio de 1997"
16,10,54,1268,620,744,1364,"6 de julio de 1997"
16,10,54,1269,273,253,526,"6 de julio de 1997"
16,10,54,1270,642,659,1301,"6 de julio de 1997"
16,10,54,1271,579,657,1236,"6 de julio de 1997"
16,10,54,1272,178,181,359,"6 de julio de 1997"
16,10,54,1273,244,204,448,"6 de julio de 1997"
16,10,54,1274,53,59,112,"6 de julio de 1997"
16,10,54,1275,143,138,281,"6 de julio de 1997"
16,10,54,1276,551,584,1135,"6 de julio de 1997"
16,10,54,1277,522,540,1062,"6 de julio de 1997"
16,10,54,1278,218,232,450,"6 de julio de 1997"
16,10,54,1279,328,334,662,"6 de julio de 1997"
16,10,54,1280,518,469,987,"6 de julio de 1997"
16,10,54,1281,113,134,247,"6 de julio de 1997"
16,10,54,1282,293,287,580,"6 de julio de 1997"
16,10,54,1286,682,819,1501,"6 de julio de 1997"
16,10,54,1287,173,210,383,"6 de julio de 1997"
16,11,1,1,371,448,819,"6 de julio de 1997"
16,11,1,2,385,455,840,"6 de julio de 1997"
16,11,1,3,363,480,843,"6 de julio de 1997"
16,11,1,4,344,451,795,"6 de julio de 1997"
16,11,1,5,275,321,596,"6 de julio de 1997"
16,11,1,6,145,145,290,"6 de julio de 1997"
16,11,1,7,223,242,465,"6 de julio de 1997"
16,11,1,8,145,132,277,"6 de julio de 1997"
16,11,1,9,93,92,185,"6 de julio de 1997"
16,11,1,10,358,322,680,"6 de julio de 1997"
16,11,9,149,465,606,1071,"6 de julio de 1997"
16,11,9,150,348,374,722,"6 de julio de 1997"
16,11,9,151,675,742,1417,"6 de julio de 1997"
16,11,9,152,258,359,617,"6 de julio de 1997"
16,11,9,153,367,464,831,"6 de julio de 1997"
16,11,9,154,674,821,1495,"6 de julio de 1997"
16,11,9,155,569,708,1277,"6 de julio de 1997"
16,11,9,156,479,570,1049,"6 de julio de 1997"
16,11,9,157,411,418,829,"6 de julio de 1997"
16,11,9,158,321,428,749,"6 de julio de 1997"
16,11,9,159,489,529,1018,"6 de julio de 1997"
16,11,9,160,431,439,870,"6 de julio de 1997"
16,11,9,161,498,513,1011,"6 de julio de 1997"
16,11,9,162,105,95,200,"6 de julio de 1997"
16,11,9,163,356,361,717,"6 de julio de 1997"
16,11,9,164,292,274,566,"6 de julio de 1997"
16,11,9,165,283,277,560,"6 de julio de 1997"
16,11,9,166,353,352,705,"6 de julio de 1997"
16,11,9,167,176,120,296,"6 de julio de 1997"
16,11,9,168,216,207,423,"6 de julio de 1997"
16,11,9,169,131,105,236,"6 de julio de 1997"
16,11,13,213,655,688,1343,"6 de julio de 1997"
16,11,13,214,210,197,407,"6 de julio de 1997"
16,11,13,215,96,85,181,"6 de julio de 1997"
16,11,13,216,119,80,199,"6 de julio de 1997"
16,11,13,217,305,235,540,"6 de julio de 1997"
16,11,13,218,86,83,169,"6 de julio de 1997"
16,11,13,219,518,482,1000,"6 de julio de 1997"
16,11,13,220,138,143,281,"6 de julio de 1997"
16,11,13,221,152,136,288,"6 de julio de 1997"
16,11,13,222,87,73,160,"6 de julio de 1997"
16,11,13,223,111,93,204,"6 de julio de 1997"
16,11,13,224,142,136,278,"6 de julio de 1997"
16,11,29,420,295,281,576,"6 de julio de 1997"
16,11,29,421,422,406,828,"6 de julio de 1997"
16,11,29,422,495,471,966,"6 de julio de 1997"
16,11,29,423,314,297,611,"6 de julio de 1997"
16,11,29,424,302,275,577,"6 de julio de 1997"
16,11,29,425,145,114,259,"6 de julio de 1997"
16,11,29,426,317,347,664,"6 de julio de 1997"
16,11,29,427,193,163,356,"6 de julio de 1997"
16,11,29,428,241,181,422,"6 de julio de 1997"
16,11,29,429,362,290,652,"6 de julio de 1997"
16,11,29,430,226,197,423,"6 de julio de 1997"
16,11,29,431,132,116,248,"6 de julio de 1997"
16,11,29,432,258,215,473,"6 de julio de 1997"
16,11,38,601,177,225,402,"6 de julio de 1997"
16,11,38,602,216,245,461,"6 de julio de 1997"
16,11,38,603,334,386,720,"6 de julio de 1997"
16,11,38,604,330,398,728,"6 de julio de 1997"
16,11,38,605,491,620,1111,"6 de julio de 1997"
16,11,38,606,369,493,862,"6 de julio de 1997"
16,11,38,607,486,600,1086,"6 de julio de 1997"
16,11,38,608,494,543,1037,"6 de julio de 1997"
16,11,38,609,464,534,998,"6 de julio de 1997"
16,11,38,610,361,413,774,"6 de julio de 1997"
16,11,38,611,426,474,900,"6 de julio de 1997"
16,11,38,612,302,387,689,"6 de julio de 1997"
16,11,38,613,505,608,1113,"6 de julio de 1997"
16,11,38,614,313,373,686,"6 de julio de 1997"
16,11,38,615,185,175,360,"6 de julio de 1997"
16,11,38,616,266,281,547,"6 de julio de 1997"
16,11,38,617,120,129,249,"6 de julio de 1997"
16,11,38,618,141,133,274,"6 de julio de 1997"
16,11,38,619,187,227,414,"6 de julio de 1997"
16,11,38,620,32,27,59,"6 de julio de 1997"
16,11,38,621,201,182,383,"6 de julio de 1997"
16,11,38,622,283,300,583,"6 de julio de 1997"
16,11,38,623,274,315,589,"6 de julio de 1997"
16,11,38,624,131,139,270,"6 de julio de 1997"
16,11,38,625,204,229,433,"6 de julio de 1997"
16,11,38,626,61,44,105,"6 de julio de 1997"
16,11,38,627,270,285,555,"6 de julio de 1997"
16,11,38,628,452,504,956,"6 de julio de 1997"
16,11,38,629,299,352,651,"6 de julio de 1997"
16,11,38,630,193,216,409,"6 de julio de 1997"
16,11,38,631,131,190,321,"6 de julio de 1997"
16,11,38,632,338,305,643,"6 de julio de 1997"
16,11,38,633,270,260,530,"6 de julio de 1997"
16,11,38,634,294,364,658,"6 de julio de 1997"
16,11,38,635,236,243,479,"6 de julio de 1997"
16,11,38,636,101,91,192,"6 de julio de 1997"
16,11,38,637,51,55,106,"6 de julio de 1997"
16,11,38,638,111,104,215,"6 de julio de 1997"
16,11,38,639,62,52,114,"6 de julio de 1997"
16,11,38,640,141,119,260,"6 de julio de 1997"
16,11,38,641,81,73,154,"6 de julio de 1997"
16,11,38,642,127,121,248,"6 de julio de 1997"
16,11,38,643,77,77,154,"6 de julio de 1997"
16,11,38,644,118,134,252,"6 de julio de 1997"
16,11,38,645,110,98,208,"6 de julio de 1997"
16,11,38,646,100,97,197,"6 de julio de 1997"
16,11,51,871,829,870,1699,"6 de julio de 1997"
16,11,51,872,415,428,843,"6 de julio de 1997"
16,11,51,873,623,720,1343,"6 de julio de 1997"
16,11,51,874,278,247,525,"6 de julio de 1997"
16,11,51,875,428,429,857,"6 de julio de 1997"
16,11,51,876,164,128,292,"6 de julio de 1997"
16,11,51,877,124,122,246,"6 de julio de 1997"
16,11,51,878,176,122,298,"6 de julio de 1997"
16,11,51,879,100,100,200,"6 de julio de 1997"
16,11,51,880,339,292,631,"6 de julio de 1997"
16,11,51,881,498,448,946,"6 de julio de 1997"
16,11,51,882,226,151,377,"6 de julio de 1997"
16,11,51,883,98,75,173,"6 de julio de 1997"
16,11,51,884,67,56,123,"6 de julio de 1997"
16,11,58,1336,109,103,212,"6 de julio de 1997"
16,11,58,1337,306,330,636,"6 de julio de 1997"
16,11,58,1338,428,420,848,"6 de julio de 1997"
16,11,58,1339,110,98,208,"6 de julio de 1997"
16,11,58,1340,54,45,99,"6 de julio de 1997"
16,11,58,1341,130,113,243,"6 de julio de 1997"
16,11,58,1342,325,314,639,"6 de julio de 1997"
16,11,58,1343,136,141,277,"6 de julio de 1997"
16,11,58,1344,218,164,382,"6 de julio de 1997"
16,11,58,1345,61,52,113,"6 de julio de 1997"
16,11,58,1346,122,99,221,"6 de julio de 1997"
16,11,58,1347,80,63,143,"6 de julio de 1997"
16,11,58,1348,195,167,362,"6 de julio de 1997"
16,11,78,1768,305,373,678,"6 de julio de 1997"
16,11,78,1769,293,312,605,"6 de julio de 1997"
16,11,78,1770,332,384,716,"6 de julio de 1997"
16,11,78,1771,203,239,442,"6 de julio de 1997"
16,11,78,1772,223,189,412,"6 de julio de 1997"
16,11,78,1773,270,311,581,"6 de julio de 1997"
16,11,78,1774,306,329,635,"6 de julio de 1997"
16,11,78,1775,206,241,447,"6 de julio de 1997"
16,11,78,1776,135,153,288,"6 de julio de 1997"
16,11,78,1777,74,85,159,"6 de julio de 1997"
16,11,78,1778,204,274,478,"6 de julio de 1997"
16,11,78,1779,319,410,729,"6 de julio de 1997"
16,11,78,1780,87,104,191,"6 de julio de 1997"
16,11,78,1781,366,460,826,"6 de julio de 1997"
16,11,78,1782,315,323,638,"6 de julio de 1997"
16,11,78,1783,225,309,534,"6 de julio de 1997"
16,11,78,1784,325,399,724,"6 de julio de 1997"
16,11,78,1785,286,290,576,"6 de julio de 1997"
16,11,78,1786,322,424,746,"6 de julio de 1997"
16,11,78,1787,183,220,403,"6 de julio de 1997"
16,11,80,1799,444,487,931,"6 de julio de 1997"
16,11,80,1800,742,835,1577,"6 de julio de 1997"
16,11,80,1801,775,888,1663,"6 de julio de 1997"
16,11,80,1802,789,863,1652,"6 de julio de 1997"
16,11,80,1803,797,1002,1799,"6 de julio de 1997"
16,11,80,1804,673,831,1504,"6 de julio de 1997"
16,11,80,1805,504,567,1071,"6 de julio de 1997"
16,11,80,1806,610,677,1287,"6 de julio de 1997"
16,11,80,1807,163,199,362,"6 de julio de 1997"
16,11,80,1808,194,250,444,"6 de julio de 1997"
16,11,80,1809,170,179,349,"6 de julio de 1997"
16,11,80,1810,288,326,614,"6 de julio de 1997"
16,11,80,1811,165,212,377,"6 de julio de 1997"
16,11,80,1812,316,399,715,"6 de julio de 1997"
16,11,80,1813,200,227,427,"6 de julio de 1997"
16,11,80,1814,188,205,393,"6 de julio de 1997"
16,11,80,1815,347,372,719,"6 de julio de 1997"
16,11,80,1816,205,222,427,"6 de julio de 1997"
16,11,80,1817,276,320,596,"6 de julio de 1997"
16,11,80,1818,320,401,721,"6 de julio de 1997"
16,11,80,1819,226,249,475,"6 de julio de 1997"
16,11,80,1820,349,441,790,"6 de julio de 1997"
16,11,80,2673,185,179,364,"6 de julio de 1997"
16,11,80,2674,186,215,401,"6 de julio de 1997"
16,11,83,1844,438,412,850,"6 de julio de 1997"
16,11,83,1845,496,593,1089,"6 de julio de 1997"
16,11,83,1846,373,405,778,"6 de julio de 1997"
16,11,83,1847,595,715,1310,"6 de julio de 1997"
16,11,83,1848,624,653,1277,"6 de julio de 1997"
16,11,83,1849,499,588,1087,"6 de julio de 1997"
16,11,83,1850,157,216,373,"6 de julio de 1997"
16,11,83,1851,579,751,1330,"6 de julio de 1997"
16,11,83,1852,286,286,572,"6 de julio de 1997"
16,11,83,1853,804,741,1545,"6 de julio de 1997"
16,11,83,1854,488,552,1040,"6 de julio de 1997"
16,11,83,1855,467,449,916,"6 de julio de 1997"
16,11,83,1856,678,698,1376,"6 de julio de 1997"
16,11,83,1857,129,118,247,"6 de julio de 1997"
16,11,83,1858,110,100,210,"6 de julio de 1997"
16,11,83,1859,467,445,912,"6 de julio de 1997"
16,11,83,1860,278,349,627,"6 de julio de 1997"
16,11,83,1861,261,235,496,"6 de julio de 1997"
16,11,83,1862,325,283,608,"6 de julio de 1997"
16,11,83,1863,412,381,793,"6 de julio de 1997"
16,11,83,1864,495,458,953,"6 de julio de 1997"
16,11,83,1865,221,226,447,"6 de julio de 1997"
16,11,83,1866,308,296,604,"6 de julio de 1997"
16,11,83,1867,672,728,1400,"6 de julio de 1997"
16,11,83,1868,532,520,1052,"6 de julio de 1997"
16,11,83,1869,342,330,672,"6 de julio de 1997"
16,11,83,1870,418,347,765,"6 de julio de 1997"
16,11,83,1871,55,39,94,"6 de julio de 1997"
16,11,83,1872,306,267,573,"6 de julio de 1997"
16,11,83,1873,510,535,1045,"6 de julio de 1997"
16,11,83,1874,287,281,568,"6 de julio de 1997"
16,11,83,1875,414,441,855,"6 de julio de 1997"
16,11,83,1876,764,755,1519,"6 de julio de 1997"
16,11,83,1877,429,435,864,"6 de julio de 1997"
16,11,83,1878,326,314,640,"6 de julio de 1997"
16,11,83,1879,498,502,1000,"6 de julio de 1997"
16,11,83,1880,329,346,675,"6 de julio de 1997"
16,11,83,1881,32,26,58,"6 de julio de 1997"
16,11,93,2013,408,447,855,"6 de julio de 1997"
16,11,93,2014,564,582,1146,"6 de julio de 1997"
16,11,93,2015,216,145,361,"6 de julio de 1997"
16,11,93,2016,71,41,112,"6 de julio de 1997"
16,11,93,2017,469,412,881,"6 de julio de 1997"
16,11,93,2018,346,311,657,"6 de julio de 1997"
16,11,93,2019,412,462,874,"6 de julio de 1997"
16,11,93,2020,266,232,498,"6 de julio de 1997"
16,11,93,2021,176,196,372,"6 de julio de 1997"
16,11,93,2022,339,336,675,"6 de julio de 1997"
16,11,93,2023,230,229,459,"6 de julio de 1997"
16,11,93,2024,196,180,376,"6 de julio de 1997"
16,11,98,2075,274,321,595,"6 de julio de 1997"
16,11,98,2076,379,391,770,"6 de julio de 1997"
16,11,98,2077,245,215,460,"6 de julio de 1997"
16,11,98,2078,182,150,332,"6 de julio de 1997"
16,11,98,2079,396,419,815,"6 de julio de 1997"
16,11,98,2080,300,277,577,"6 de julio de 1997"
16,11,98,2081,387,408,795,"6 de julio de 1997"
16,11,98,2082,249,269,518,"6 de julio de 1997"
16,11,98,2083,397,450,847,"6 de julio de 1997"
16,11,98,2084,244,272,516,"6 de julio de 1997"
16,11,98,2085,126,144,270,"6 de julio de 1997"
16,11,98,2086,642,630,1272,"6 de julio de 1997"
16,11,98,2087,254,340,594,"6 de julio de 1997"
16,11,98,2088,286,444,730,"6 de julio de 1997"
16,11,98,2089,230,254,484,"6 de julio de 1997"
16,11,98,2090,142,132,274,"6 de julio de 1997"
16,11,98,2091,206,202,408,"6 de julio de 1997"
16,11,98,2092,284,291,575,"6 de julio de 1997"
16,11,98,2093,228,226,454,"6 de julio de 1997"
16,11,98,2094,166,112,278,"6 de julio de 1997"
16,11,98,2095,168,143,311,"6 de julio de 1997"
16,11,98,2096,481,439,920,"6 de julio de 1997"
16,11,98,2097,367,329,696,"6 de julio de 1997"
16,11,98,2098,153,139,292,"6 de julio de 1997"
16,11,98,2099,214,199,413,"6 de julio de 1997"
16,11,98,2100,48,43,91,"6 de julio de 1997"
16,11,98,2101,74,55,129,"6 de julio de 1997"
16,11,98,2102,345,290,635,"6 de julio de 1997"
16,11,98,2103,55,35,90,"6 de julio de 1997"
16,11,98,2104,139,101,240,"6 de julio de 1997"
16,11,98,2105,72,77,149,"6 de julio de 1997"
16,11,98,2106,27,18,45,"6 de julio de 1997"
16,11,98,2107,86,61,147,"6 de julio de 1997"
16,11,98,2108,69,53,122,"6 de julio de 1997"
16,11,98,2109,158,116,274,"6 de julio de 1997"
16,11,98,2110,230,204,434,"6 de julio de 1997"
16,11,98,2111,94,43,137,"6 de julio de 1997"
16,11,98,2112,101,77,178,"6 de julio de 1997"
16,12,2,11,730,741,1471,"6 de julio de 1997"
16,12,2,12,383,349,732,"6 de julio de 1997"
16,12,2,13,857,935,1792,"6 de julio de 1997"
16,12,2,14,580,584,1164,"6 de julio de 1997"
16,12,2,15,241,194,435,"6 de julio de 1997"
16,12,2,16,920,850,1770,"6 de julio de 1997"
16,12,2,17,320,265,585,"6 de julio de 1997"
16,12,2,18,465,392,857,"6 de julio de 1997"
16,12,2,19,343,330,673,"6 de julio de 1997"
16,12,2,20,219,165,384,"6 de julio de 1997"
16,12,2,21,49,33,82,"6 de julio de 1997"
16,12,2,22,155,90,245,"6 de julio de 1997"
16,12,2,23,90,84,174,"6 de julio de 1997"
16,12,2,24,11,9,20,"6 de julio de 1997"
16,12,2,25,79,45,124,"6 de julio de 1997"
16,12,6,58,303,375,678,"6 de julio de 1997"
16,12,6,59,354,419,773,"6 de julio de 1997"
16,12,6,60,399,419,818,"6 de julio de 1997"
16,12,6,61,345,396,741,"6 de julio de 1997"
16,12,6,62,470,550,1020,"6 de julio de 1997"
16,12,6,63,253,286,539,"6 de julio de 1997"
16,12,6,64,285,322,607,"6 de julio de 1997"
16,12,6,65,353,423,776,"6 de julio de 1997"
16,12,6,66,581,624,1205,"6 de julio de 1997"
16,12,6,67,237,281,518,"6 de julio de 1997"
16,12,6,68,315,366,681,"6 de julio de 1997"
16,12,6,69,352,418,770,"6 de julio de 1997"
16,12,6,70,436,306,742,"6 de julio de 1997"
16,12,6,71,450,519,969,"6 de julio de 1997"
16,12,6,72,315,328,643,"6 de julio de 1997"
16,12,6,73,357,344,701,"6 de julio de 1997"
16,12,6,74,446,544,990,"6 de julio de 1997"
16,12,6,75,402,464,866,"6 de julio de 1997"
16,12,6,76,397,462,859,"6 de julio de 1997"
16,12,6,77,692,802,1494,"6 de julio de 1997"
16,12,6,78,534,591,1125,"6 de julio de 1997"
16,12,6,79,383,459,842,"6 de julio de 1997"
16,12,6,80,433,506,939,"6 de julio de 1997"
16,12,6,81,329,436,765,"6 de julio de 1997"
16,12,6,82,426,525,951,"6 de julio de 1997"
16,12,6,83,330,363,693,"6 de julio de 1997"
16,12,6,84,317,332,649,"6 de julio de 1997"
16,12,6,85,393,487,880,"6 de julio de 1997"
16,12,6,86,320,374,694,"6 de julio de 1997"
16,12,6,87,355,429,784,"6 de julio de 1997"
16,12,6,88,448,508,956,"6 de julio de 1997"
16,12,6,89,326,394,720,"6 de julio de 1997"
16,12,6,90,355,454,809,"6 de julio de 1997"
16,12,6,91,227,271,498,"6 de julio de 1997"
16,12,6,92,383,455,838,"6 de julio de 1997"
16,12,6,93,214,282,496,"6 de julio de 1997"
16,12,6,94,292,332,624,"6 de julio de 1997"
16,12,6,95,336,398,734,"6 de julio de 1997"
16,12,6,96,344,376,720,"6 de julio de 1997"
16,12,6,97,380,384,764,"6 de julio de 1997"
16,12,6,98,552,530,1082,"6 de julio de 1997"
16,12,6,99,433,506,939,"6 de julio de 1997"
16,12,6,100,285,329,614,"6 de julio de 1997"
16,12,6,101,435,515,950,"6 de julio de 1997"
16,12,6,102,347,359,706,"6 de julio de 1997"
16,12,6,103,242,272,514,"6 de julio de 1997"
16,12,6,104,382,450,832,"6 de julio de 1997"
16,12,6,105,596,647,1243,"6 de julio de 1997"
16,12,6,106,330,377,707,"6 de julio de 1997"
16,12,6,107,320,386,706,"6 de julio de 1997"
16,12,6,108,538,649,1187,"6 de julio de 1997"
16,12,6,109,555,647,1202,"6 de julio de 1997"
16,12,6,110,383,421,804,"6 de julio de 1997"
16,12,6,111,366,417,783,"6 de julio de 1997"
16,12,6,112,647,700,1347,"6 de julio de 1997"
16,12,6,113,896,986,1882,"6 de julio de 1997"
16,12,6,114,352,328,680,"6 de julio de 1997"
16,12,6,115,394,378,772,"6 de julio de 1997"
16,12,6,116,272,271,543,"6 de julio de 1997"
16,12,6,117,407,378,785,"6 de julio de 1997"
16,12,6,118,236,225,461,"6 de julio de 1997"
16,12,6,119,478,466,944,"6 de julio de 1997"
16,12,6,120,412,422,834,"6 de julio de 1997"
16,12,6,121,354,280,634,"6 de julio de 1997"
16,12,6,122,265,278,543,"6 de julio de 1997"
16,12,6,123,91,86,177,"6 de julio de 1997"
16,12,6,124,245,233,478,"6 de julio de 1997"
16,12,6,125,312,323,635,"6 de julio de 1997"
16,12,6,126,213,208,421,"6 de julio de 1997"
16,12,6,127,253,254,507,"6 de julio de 1997"
16,12,6,128,306,312,618,"6 de julio de 1997"
16,12,6,129,321,268,589,"6 de julio de 1997"
16,12,6,130,158,101,259,"6 de julio de 1997"
16,12,6,131,94,89,183,"6 de julio de 1997"
16,12,6,2660,88,81,169,"6 de julio de 1997"
16,12,6,2661,146,105,251,"6 de julio de 1997"
16,12,6,2662,213,206,419,"6 de julio de 1997"
16,12,6,2663,77,56,133,"6 de julio de 1997"
16,12,6,2664,89,83,172,"6 de julio de 1997"
16,12,6,2665,144,110,254,"6 de julio de 1997"
16,12,12,190,795,828,1623,"6 de julio de 1997"
16,12,12,191,853,819,1672,"6 de julio de 1997"
16,12,12,192,503,532,1035,"6 de julio de 1997"
16,12,12,193,243,229,472,"6 de julio de 1997"
16,12,12,194,228,219,447,"6 de julio de 1997"
16,12,12,195,262,296,558,"6 de julio de 1997"
16,12,12,196,44,46,90,"6 de julio de 1997"
16,12,12,197,127,125,252,"6 de julio de 1997"
16,12,12,198,464,436,900,"6 de julio de 1997"
16,12,12,199,477,469,946,"6 de julio de 1997"
16,12,12,200,655,629,1284,"6 de julio de 1997"
16,12,12,201,566,587,1153,"6 de julio de 1997"
16,12,12,202,496,503,999,"6 de julio de 1997"
16,12,12,203,481,544,1025,"6 de julio de 1997"
16,12,12,204,669,706,1375,"6 de julio de 1997"
16,12,12,205,589,596,1185,"6 de julio de 1997"
16,12,12,206,285,236,521,"6 de julio de 1997"
16,12,12,207,249,235,484,"6 de julio de 1997"
16,12,12,208,416,398,814,"6 de julio de 1997"
16,12,12,209,644,589,1233,"6 de julio de 1997"
16,12,12,210,280,280,560,"6 de julio de 1997"
16,12,12,211,299,319,618,"6 de julio de 1997"
16,12,12,212,160,153,313,"6 de julio de 1997"
16,12,33,467,572,574,1146,"6 de julio de 1997"
16,12,33,468,243,250,493,"6 de julio de 1997"
16,12,33,469,459,486,945,"6 de julio de 1997"
16,12,33,470,360,367,727,"6 de julio de 1997"
16,12,33,471,499,522,1021,"6 de julio de 1997"
16,12,33,472,455,516,971,"6 de julio de 1997"
16,12,33,473,478,493,971,"6 de julio de 1997"
16,12,33,474,497,484,981,"6 de julio de 1997"
16,12,33,475,375,385,760,"6 de julio de 1997"
16,12,33,476,338,309,647,"6 de julio de 1997"
16,12,33,477,453,417,870,"6 de julio de 1997"
16,12,33,478,394,354,748,"6 de julio de 1997"
16,12,33,479,117,92,209,"6 de julio de 1997"
16,12,35,557,475,490,965,"6 de julio de 1997"
16,12,35,558,491,607,1098,"6 de julio de 1997"
16,12,35,559,500,597,1097,"6 de julio de 1997"
16,12,35,560,419,501,920,"6 de julio de 1997"
16,12,35,561,404,416,820,"6 de julio de 1997"
16,12,35,562,309,344,653,"6 de julio de 1997"
16,12,35,563,100,90,190,"6 de julio de 1997"
16,12,35,564,393,356,749,"6 de julio de 1997"
16,12,35,565,194,184,378,"6 de julio de 1997"
16,12,35,566,301,266,567,"6 de julio de 1997"
16,12,35,567,177,178,355,"6 de julio de 1997"
16,12,35,568,334,325,659,"6 de julio de 1997"
16,12,35,569,264,219,483,"6 de julio de 1997"
16,12,35,570,345,346,691,"6 de julio de 1997"
16,12,35,571,279,274,553,"6 de julio de 1997"
16,12,35,572,675,634,1309,"6 de julio de 1997"
16,12,35,573,485,514,999,"6 de julio de 1997"
16,12,35,574,349,402,751,"6 de julio de 1997"
16,12,35,575,239,213,452,"6 de julio de 1997"
16,12,35,576,136,125,261,"6 de julio de 1997"
16,12,35,577,409,370,779,"6 de julio de 1997"
16,12,35,578,235,227,462,"6 de julio de 1997"
16,12,35,579,260,209,469,"6 de julio de 1997"
16,12,35,2666,103,79,182,"6 de julio de 1997"
16,12,35,2667,120,98,218,"6 de julio de 1997"
16,12,35,2668,214,188,402,"6 de julio de 1997"
16,12,35,2669,272,277,549,"6 de julio de 1997"
16,12,35,2670,226,200,426,"6 de julio de 1997"
16,12,56,1297,248,288,536,"6 de julio de 1997"
16,12,56,1298,545,615,1160,"6 de julio de 1997"
16,12,56,1299,453,483,936,"6 de julio de 1997"
16,12,56,1300,536,567,1103,"6 de julio de 1997"
16,12,56,1301,465,509,974,"6 de julio de 1997"
16,12,56,1302,555,628,1183,"6 de julio de 1997"
16,12,56,1303,515,533,1048,"6 de julio de 1997"
16,12,56,1304,463,504,967,"6 de julio de 1997"
16,12,56,1305,654,660,1314,"6 de julio de 1997"
16,12,56,1306,493,523,1016,"6 de julio de 1997"
16,12,56,1307,543,567,1110,"6 de julio de 1997"
16,12,56,1308,422,448,870,"6 de julio de 1997"
16,12,56,1309,369,409,778,"6 de julio de 1997"
16,12,56,1310,493,497,990,"6 de julio de 1997"
16,12,56,1311,347,372,719,"6 de julio de 1997"
16,12,56,1312,364,410,774,"6 de julio de 1997"
16,12,56,1313,466,562,1028,"6 de julio de 1997"
16,12,56,1314,226,229,455,"6 de julio de 1997"
16,12,56,1315,654,600,1254,"6 de julio de 1997"
16,12,56,1316,332,351,683,"6 de julio de 1997"
16,12,56,1317,441,422,863,"6 de julio de 1997"
16,12,56,1318,533,541,1074,"6 de julio de 1997"
16,12,56,1319,313,314,627,"6 de julio de 1997"
16,12,56,1320,195,210,405,"6 de julio de 1997"
16,12,60,1360,741,648,1389,"6 de julio de 1997"
16,12,60,1361,256,214,470,"6 de julio de 1997"
16,12,60,1362,222,198,420,"6 de julio de 1997"
16,12,60,1363,236,215,451,"6 de julio de 1997"
16,12,60,1364,290,316,606,"6 de julio de 1997"
16,12,60,1365,111,80,191,"6 de julio de 1997"
16,12,60,1366,190,154,344,"6 de julio de 1997"
16,12,60,1367,117,111,228,"6 de julio de 1997"
16,12,60,1368,89,56,145,"6 de julio de 1997"
16,12,65,1426,345,375,720,"6 de julio de 1997"
16,12,65,1427,771,761,1532,"6 de julio de 1997"
16,12,65,1428,432,429,861,"6 de julio de 1997"
16,12,65,1429,205,203,408,"6 de julio de 1997"
16,12,65,1430,310,289,599,"6 de julio de 1997"
16,12,65,1431,411,445,856,"6 de julio de 1997"
16,12,65,1432,384,391,775,"6 de julio de 1997"
16,12,65,1433,451,454,905,"6 de julio de 1997"
16,12,65,1434,600,608,1208,"6 de julio de 1997"
16,12,65,1435,461,483,944,"6 de julio de 1997"
16,12,65,1436,526,511,1037,"6 de julio de 1997"
16,12,65,1437,258,253,511,"6 de julio de 1997"
16,12,65,1438,194,168,362,"6 de julio de 1997"
16,12,65,1439,222,222,444,"6 de julio de 1997"
16,12,65,2671,210,185,395,"6 de julio de 1997"
16,12,65,2672,132,118,250,"6 de julio de 1997"
16,12,84,1882,557,545,1102,"6 de julio de 1997"
16,12,84,1883,347,365,712,"6 de julio de 1997"
16,12,84,1884,653,612,1265,"6 de julio de 1997"
16,12,84,1885,328,375,703,"6 de julio de 1997"
16,12,84,1886,305,335,640,"6 de julio de 1997"
16,12,84,1887,639,747,1386,"6 de julio de 1997"
16,12,84,1888,420,431,851,"6 de julio de 1997"
16,12,84,1889,285,257,542,"6 de julio de 1997"
16,12,84,1890,533,466,999,"6 de julio de 1997"
16,12,84,1891,348,350,698,"6 de julio de 1997"
16,12,84,1892,239,237,476,"6 de julio de 1997"
16,12,84,1893,431,399,830,"6 de julio de 1997"
16,12,84,1894,184,156,340,"6 de julio de 1997"
16,12,84,1895,127,130,257,"6 de julio de 1997"
16,12,84,1896,300,247,547,"6 de julio de 1997"
16,12,84,1897,32,28,60,"6 de julio de 1997"
16,13,8,136,268,259,527,"6 de julio de 1997"
16,13,8,137,552,502,1054,"6 de julio de 1997"
16,13,8,138,320,282,602,"6 de julio de 1997"
16,13,8,139,556,540,1096,"6 de julio de 1997"
16,13,8,140,487,491,978,"6 de julio de 1997"
16,13,8,141,341,175,516,"6 de julio de 1997"
16,13,8,142,518,389,907,"6 de julio de 1997"
16,13,8,143,357,231,588,"6 de julio de 1997"
16,13,8,144,146,31,177,"6 de julio de 1997"
16,13,8,145,495,333,828,"6 de julio de 1997"
16,13,8,146,87,52,139,"6 de julio de 1997"
16,13,8,147,461,453,914,"6 de julio de 1997"
16,13,8,148,247,182,429,"6 de julio de 1997"
16,13,10,170,614,604,1218,"6 de julio de 1997"
16,13,10,171,653,647,1300,"6 de julio de 1997"
16,13,10,172,724,662,1386,"6 de julio de 1997"
16,13,10,173,564,551,1115,"6 de julio de 1997"
16,13,10,174,293,308,601,"6 de julio de 1997"
16,13,10,175,191,128,319,"6 de julio de 1997"
16,13,10,176,580,602,1182,"6 de julio de 1997"
16,13,10,177,255,195,450,"6 de julio de 1997"
16,13,10,178,360,303,663,"6 de julio de 1997"
16,13,10,179,113,40,153,"6 de julio de 1997"
16,13,10,180,307,220,527,"6 de julio de 1997"
16,13,10,181,573,560,1133,"6 de julio de 1997"
16,13,10,182,116,90,206,"6 de julio de 1997"
16,13,10,183,48,30,78,"6 de julio de 1997"
16,13,14,225,346,376,722,"6 de julio de 1997"
16,13,14,226,565,529,1094,"6 de julio de 1997"
16,13,14,227,200,188,388,"6 de julio de 1997"
16,13,14,228,284,260,544,"6 de julio de 1997"
16,13,14,229,583,498,1081,"6 de julio de 1997"
16,13,14,230,64,49,113,"6 de julio de 1997"
16,13,14,231,288,240,528,"6 de julio de 1997"
16,13,14,232,466,474,940,"6 de julio de 1997"
16,13,14,233,290,335,625,"6 de julio de 1997"
16,13,14,234,272,239,511,"6 de julio de 1997"
16,13,14,235,273,253,526,"6 de julio de 1997"
16,13,14,236,62,48,110,"6 de julio de 1997"
16,13,15,237,729,755,1484,"6 de julio de 1997"
16,13,15,238,518,530,1048,"6 de julio de 1997"
16,13,15,239,424,424,848,"6 de julio de 1997"
16,13,15,240,328,298,626,"6 de julio de 1997"
16,13,15,241,240,235,475,"6 de julio de 1997"
16,13,15,242,729,756,1485,"6 de julio de 1997"
16,13,15,243,70,79,149,"6 de julio de 1997"
16,13,15,244,70,62,132,"6 de julio de 1997"
16,13,15,245,439,391,830,"6 de julio de 1997"
16,13,15,246,226,182,408,"6 de julio de 1997"
16,13,15,247,109,95,204,"6 de julio de 1997"
16,13,15,248,74,75,149,"6 de julio de 1997"
16,13,15,249,142,95,237,"6 de julio de 1997"
16,13,15,250,109,61,170,"6 de julio de 1997"
16,13,15,251,70,55,125,"6 de julio de 1997"
16,13,15,252,149,105,254,"6 de julio de 1997"
16,13,15,253,99,82,181,"6 de julio de 1997"
16,13,15,254,86,75,161,"6 de julio de 1997"
16,13,15,255,102,81,183,"6 de julio de 1997"
16,13,15,256,220,158,378,"6 de julio de 1997"
16,13,26,397,479,423,902,"6 de julio de 1997"
16,13,26,398,239,187,426,"6 de julio de 1997"
16,13,26,399,187,150,337,"6 de julio de 1997"
16,13,26,400,127,88,215,"6 de julio de 1997"
16,13,26,401,105,64,169,"6 de julio de 1997"
16,13,26,402,199,185,384,"6 de julio de 1997"
16,13,26,403,271,239,510,"6 de julio de 1997"
16,13,26,404,232,177,409,"6 de julio de 1997"
16,13,50,806,870,915,1785,"6 de julio de 1997"
16,13,50,807,831,884,1715,"6 de julio de 1997"
16,13,50,808,748,756,1504,"6 de julio de 1997"
16,13,50,809,407,402,809,"6 de julio de 1997"
16,13,50,810,381,353,734,"6 de julio de 1997"
16,13,50,811,641,610,1251,"6 de julio de 1997"
16,13,50,812,717,680,1397,"6 de julio de 1997"
16,13,50,813,825,811,1636,"6 de julio de 1997"
16,13,50,814,693,725,1418,"6 de julio de 1997"
16,13,50,815,659,685,1344,"6 de julio de 1997"
16,13,50,816,361,372,733,"6 de julio de 1997"
16,13,50,817,646,591,1237,"6 de julio de 1997"
16,13,50,818,634,580,1214,"6 de julio de 1997"
16,13,50,819,457,460,917,"6 de julio de 1997"
16,13,50,820,611,582,1193,"6 de julio de 1997"
16,13,50,821,784,791,1575,"6 de julio de 1997"
16,13,50,822,452,436,888,"6 de julio de 1997"
16,13,50,823,800,825,1625,"6 de julio de 1997"
16,13,50,824,517,449,966,"6 de julio de 1997"
16,13,50,825,660,555,1215,"6 de julio de 1997"
16,13,50,826,752,672,1424,"6 de julio de 1997"
16,13,50,827,660,557,1217,"6 de julio de 1997"
16,13,50,828,909,943,1852,"6 de julio de 1997"
16,13,50,829,902,443,1345,"6 de julio de 1997"
16,13,50,830,188,157,345,"6 de julio de 1997"
16,13,50,831,299,290,589,"6 de julio de 1997"
16,13,50,832,805,572,1377,"6 de julio de 1997"
16,13,50,833,126,108,234,"6 de julio de 1997"
16,13,50,834,695,576,1271,"6 de julio de 1997"
16,13,50,835,745,728,1473,"6 de julio de 1997"
16,13,50,836,720,702,1422,"6 de julio de 1997"
16,13,50,837,797,778,1575,"6 de julio de 1997"
16,13,50,838,415,444,859,"6 de julio de 1997"
16,13,50,839,617,628,1245,"6 de julio de 1997"
16,13,50,840,545,529,1074,"6 de julio de 1997"
16,13,50,841,913,833,1746,"6 de julio de 1997"
16,13,50,842,620,677,1297,"6 de julio de 1997"
16,13,50,843,400,403,803,"6 de julio de 1997"
16,13,50,844,664,665,1329,"6 de julio de 1997"
16,13,50,845,787,792,1579,"6 de julio de 1997"
16,13,50,846,515,572,1087,"6 de julio de 1997"
16,13,50,847,656,626,1282,"6 de julio de 1997"
16,13,50,848,693,683,1376,"6 de julio de 1997"
16,13,50,849,864,850,1714,"6 de julio de 1997"
16,13,50,850,782,772,1554,"6 de julio de 1997"
16,13,50,851,892,893,1785,"6 de julio de 1997"
16,13,50,852,743,672,1415,"6 de julio de 1997"
16,13,50,853,676,657,1333,"6 de julio de 1997"
16,13,50,854,702,735,1437,"6 de julio de 1997"
16,13,50,855,473,478,951,"6 de julio de 1997"
16,13,50,856,555,522,1077,"6 de julio de 1997"
16,13,50,857,531,502,1033,"6 de julio de 1997"
16,13,50,858,691,663,1354,"6 de julio de 1997"
16,13,50,859,738,699,1437,"6 de julio de 1997"
16,13,50,860,863,839,1702,"6 de julio de 1997"
16,13,50,861,224,215,439,"6 de julio de 1997"
16,13,50,862,522,532,1054,"6 de julio de 1997"
16,13,50,863,776,740,1516,"6 de julio de 1997"
16,13,50,864,217,200,417,"6 de julio de 1997"
16,13,50,865,727,745,1472,"6 de julio de 1997"
16,13,50,866,333,287,620,"6 de julio de 1997"
16,13,50,867,298,261,559,"6 de julio de 1997"
16,13,50,868,1138,1014,2152,"6 de julio de 1997"
16,13,50,869,471,435,906,"6 de julio de 1997"
16,13,50,870,411,366,777,"6 de julio de 1997"
16,13,90,1979,698,715,1413,"6 de julio de 1997"
16,13,90,1980,298,278,576,"6 de julio de 1997"
16,13,90,1981,653,721,1374,"6 de julio de 1997"
16,13,90,1982,720,753,1473,"6 de julio de 1997"
16,13,90,1983,257,257,514,"6 de julio de 1997"
16,13,90,1984,234,227,461,"6 de julio de 1997"
16,13,90,1985,562,631,1193,"6 de julio de 1997"
16,13,90,1986,645,684,1329,"6 de julio de 1997"
16,13,90,1987,140,160,300,"6 de julio de 1997"
16,13,90,1988,266,237,503,"6 de julio de 1997"
16,13,90,1989,706,607,1313,"6 de julio de 1997"
16,13,90,1990,286,268,554,"6 de julio de 1997"
16,13,90,1991,550,471,1021,"6 de julio de 1997"
16,13,90,1992,219,171,390,"6 de julio de 1997"
16,13,90,1993,266,238,504,"6 de julio de 1997"
16,13,90,1994,249,210,459,"6 de julio de 1997"
16,13,97,2065,566,510,1076,"6 de julio de 1997"
16,13,97,2066,354,347,701,"6 de julio de 1997"
16,13,97,2067,293,262,555,"6 de julio de 1997"
16,13,97,2068,603,505,1108,"6 de julio de 1997"
16,13,97,2069,85,64,149,"6 de julio de 1997"
16,13,97,2070,34,25,59,"6 de julio de 1997"
16,13,97,2071,282,181,463,"6 de julio de 1997"
16,13,97,2072,43,43,86,"6 de julio de 1997"
16,13,97,2073,30,21,51,"6 de julio de 1997"
16,13,97,2074,158,104,262,"6 de julio de 1997"
17,1,7,188,786,839,1625,"6 de julio de 1997"
17,1,7,189,385,443,828,"6 de julio de 1997"
17,1,7,190,827,912,1739,"6 de julio de 1997"
17,1,7,191,494,572,1066,"6 de julio de 1997"
17,1,7,192,730,810,1540,"6 de julio de 1997"
17,1,7,193,843,930,1773,"6 de julio de 1997"
17,1,7,194,915,962,1877,"6 de julio de 1997"
17,1,7,195,594,623,1217,"6 de julio de 1997"
17,1,7,196,540,633,1173,"6 de julio de 1997"
17,1,7,197,803,912,1715,"6 de julio de 1997"
17,1,7,198,499,562,1061,"6 de julio de 1997"
17,1,7,199,560,628,1188,"6 de julio de 1997"
17,1,7,200,311,372,683,"6 de julio de 1997"
17,1,7,201,463,532,995,"6 de julio de 1997"
17,1,7,202,876,988,1864,"6 de julio de 1997"
17,1,7,203,406,446,852,"6 de julio de 1997"
17,1,7,204,698,765,1463,"6 de julio de 1997"
17,1,7,205,712,847,1559,"6 de julio de 1997"
17,1,7,206,643,675,1318,"6 de julio de 1997"
17,1,7,207,663,664,1327,"6 de julio de 1997"
17,1,7,208,636,701,1337,"6 de julio de 1997"
17,1,7,209,369,424,793,"6 de julio de 1997"
17,1,7,210,278,310,588,"6 de julio de 1997"
17,1,7,211,457,493,950,"6 de julio de 1997"
17,1,7,212,542,633,1175,"6 de julio de 1997"
17,1,7,213,610,753,1363,"6 de julio de 1997"
17,1,7,214,699,779,1478,"6 de julio de 1997"
17,1,7,215,441,523,964,"6 de julio de 1997"
17,1,7,216,444,504,948,"6 de julio de 1997"
17,1,7,217,311,359,670,"6 de julio de 1997"
17,1,7,218,371,431,802,"6 de julio de 1997"
17,1,7,219,561,656,1217,"6 de julio de 1997"
17,1,7,220,728,838,1566,"6 de julio de 1997"
17,1,7,221,486,506,992,"6 de julio de 1997"
17,1,7,222,787,873,1660,"6 de julio de 1997"
17,1,7,223,509,577,1086,"6 de julio de 1997"
17,1,7,224,496,622,1118,"6 de julio de 1997"
17,1,7,225,475,557,1032,"6 de julio de 1997"
17,1,7,226,569,651,1220,"6 de julio de 1997"
17,1,7,227,691,840,1531,"6 de julio de 1997"
17,1,7,228,137,160,297,"6 de julio de 1997"
17,1,7,229,319,350,669,"6 de julio de 1997"
17,1,7,230,662,760,1422,"6 de julio de 1997"
17,1,7,231,434,483,917,"6 de julio de 1997"
17,1,7,232,764,857,1621,"6 de julio de 1997"
17,1,7,233,416,479,895,"6 de julio de 1997"
17,1,7,234,344,452,796,"6 de julio de 1997"
17,1,7,235,834,114,948,"6 de julio de 1997"
17,1,7,236,192,236,428,"6 de julio de 1997"
17,1,7,237,453,496,949,"6 de julio de 1997"
17,1,7,238,271,338,609,"6 de julio de 1997"
17,1,7,239,614,769,1383,"6 de julio de 1997"
17,1,7,240,475,534,1009,"6 de julio de 1997"
17,1,7,241,529,620,1149,"6 de julio de 1997"
17,1,7,242,426,495,921,"6 de julio de 1997"
17,1,7,243,257,293,550,"6 de julio de 1997"
17,1,7,244,480,540,1020,"6 de julio de 1997"
17,1,7,245,379,435,814,"6 de julio de 1997"
17,1,7,246,540,678,1218,"6 de julio de 1997"
17,1,7,247,547,590,1137,"6 de julio de 1997"
17,1,7,248,646,757,1403,"6 de julio de 1997"
17,1,7,249,264,337,601,"6 de julio de 1997"
17,1,7,250,445,523,968,"6 de julio de 1997"
17,1,7,251,326,376,702,"6 de julio de 1997"
17,1,7,252,479,579,1058,"6 de julio de 1997"
17,1,7,253,527,617,1144,"6 de julio de 1997"
17,1,7,254,566,690,1256,"6 de julio de 1997"
17,1,7,255,854,964,1818,"6 de julio de 1997"
17,1,7,256,628,727,1355,"6 de julio de 1997"
17,1,7,257,944,1036,1980,"6 de julio de 1997"
17,1,7,258,247,296,543,"6 de julio de 1997"
17,1,7,259,198,250,448,"6 de julio de 1997"
17,1,7,260,293,343,636,"6 de julio de 1997"
17,1,7,261,202,272,474,"6 de julio de 1997"
17,1,7,262,279,306,585,"6 de julio de 1997"
17,1,7,263,353,420,773,"6 de julio de 1997"
17,1,7,264,335,389,724,"6 de julio de 1997"
17,1,7,265,267,333,600,"6 de julio de 1997"
17,1,7,266,378,448,826,"6 de julio de 1997"
17,1,7,267,765,926,1691,"6 de julio de 1997"
17,1,7,268,481,586,1067,"6 de julio de 1997"
17,1,7,269,506,617,1123,"6 de julio de 1997"
17,1,7,270,312,389,701,"6 de julio de 1997"
17,1,7,271,419,521,940,"6 de julio de 1997"
17,1,7,272,860,950,1810,"6 de julio de 1997"
17,1,7,273,445,482,927,"6 de julio de 1997"
17,1,7,274,669,793,1462,"6 de julio de 1997"
17,1,7,275,443,536,979,"6 de julio de 1997"
17,1,7,276,446,586,1032,"6 de julio de 1997"
17,1,7,277,321,366,687,"6 de julio de 1997"
17,1,7,278,392,475,867,"6 de julio de 1997"
17,1,7,279,574,676,1250,"6 de julio de 1997"
17,1,7,280,180,213,393,"6 de julio de 1997"
17,1,7,281,392,469,861,"6 de julio de 1997"
17,1,7,282,597,700,1297,"6 de julio de 1997"
17,1,7,283,495,602,1097,"6 de julio de 1997"
17,1,7,284,610,674,1284,"6 de julio de 1997"
17,1,7,285,370,478,848,"6 de julio de 1997"
17,1,7,286,498,523,1021,"6 de julio de 1997"
17,1,7,287,454,479,933,"6 de julio de 1997"
17,1,7,288,749,829,1578,"6 de julio de 1997"
17,1,7,289,272,287,559,"6 de julio de 1997"
17,1,7,290,739,865,1604,"6 de julio de 1997"
17,1,7,291,253,297,550,"6 de julio de 1997"
17,1,7,292,714,902,1616,"6 de julio de 1997"
17,1,7,293,254,358,612,"6 de julio de 1997"
17,1,7,294,460,549,1009,"6 de julio de 1997"
17,1,7,295,358,385,743,"6 de julio de 1997"
17,1,7,296,399,472,871,"6 de julio de 1997"
17,1,7,297,477,528,1005,"6 de julio de 1997"
17,1,7,298,384,443,827,"6 de julio de 1997"
17,1,7,299,201,230,431,"6 de julio de 1997"
17,1,7,300,429,532,961,"6 de julio de 1997"
17,1,7,301,481,588,1069,"6 de julio de 1997"
17,1,7,302,480,549,1029,"6 de julio de 1997"
17,1,7,303,855,988,1843,"6 de julio de 1997"
17,1,7,304,614,698,1312,"6 de julio de 1997"
17,1,7,305,496,585,1081,"6 de julio de 1997"
17,1,7,306,438,516,954,"6 de julio de 1997"
17,1,7,307,344,417,761,"6 de julio de 1997"
17,1,7,308,475,614,1089,"6 de julio de 1997"
17,1,7,309,925,1047,1972,"6 de julio de 1997"
17,1,7,310,348,435,783,"6 de julio de 1997"
17,1,7,311,517,626,1143,"6 de julio de 1997"
17,1,7,312,486,602,1088,"6 de julio de 1997"
17,1,7,313,263,312,575,"6 de julio de 1997"
17,1,7,314,530,587,1117,"6 de julio de 1997"
17,1,7,315,382,452,834,"6 de julio de 1997"
17,1,7,316,468,557,1025,"6 de julio de 1997"
17,1,7,317,801,913,1714,"6 de julio de 1997"
17,1,7,318,572,624,1196,"6 de julio de 1997"
17,1,7,319,187,252,439,"6 de julio de 1997"
17,1,7,320,727,862,1589,"6 de julio de 1997"
17,1,7,321,425,473,898,"6 de julio de 1997"
17,1,7,322,486,587,1073,"6 de julio de 1997"
17,1,7,323,235,291,526,"6 de julio de 1997"
17,1,7,324,493,575,1068,"6 de julio de 1997"
17,1,7,325,181,199,380,"6 de julio de 1997"
17,1,7,326,146,199,345,"6 de julio de 1997"
17,1,7,327,445,545,990,"6 de julio de 1997"
17,1,7,328,369,417,786,"6 de julio de 1997"
17,1,7,329,257,330,587,"6 de julio de 1997"
17,1,7,330,371,491,862,"6 de julio de 1997"
17,1,7,331,352,417,769,"6 de julio de 1997"
17,1,7,332,615,744,1359,"6 de julio de 1997"
17,1,7,333,731,857,1588,"6 de julio de 1997"
17,1,7,334,710,808,1518,"6 de julio de 1997"
17,1,7,335,704,788,1492,"6 de julio de 1997"
17,1,7,336,538,619,1157,"6 de julio de 1997"
17,1,7,337,414,432,846,"6 de julio de 1997"
17,1,7,338,329,359,688,"6 de julio de 1997"
17,1,7,339,460,509,969,"6 de julio de 1997"
17,1,7,340,903,1035,1938,"6 de julio de 1997"
17,1,7,341,255,283,538,"6 de julio de 1997"
17,1,7,342,345,458,803,"6 de julio de 1997"
17,1,7,343,370,471,841,"6 de julio de 1997"
17,1,7,344,596,696,1292,"6 de julio de 1997"
17,1,7,345,263,316,579,"6 de julio de 1997"
17,1,7,346,325,380,705,"6 de julio de 1997"
17,1,7,347,208,246,454,"6 de julio de 1997"
17,1,7,348,546,553,1099,"6 de julio de 1997"
17,1,7,349,484,616,1100,"6 de julio de 1997"
17,1,7,350,555,717,1272,"6 de julio de 1997"
17,1,7,351,249,271,520,"6 de julio de 1997"
17,1,7,352,371,422,793,"6 de julio de 1997"
17,1,7,353,405,445,850,"6 de julio de 1997"
17,1,7,354,494,595,1089,"6 de julio de 1997"
17,1,7,355,616,693,1309,"6 de julio de 1997"
17,1,7,356,558,626,1184,"6 de julio de 1997"
17,1,7,357,369,439,808,"6 de julio de 1997"
17,1,7,358,211,280,491,"6 de julio de 1997"
17,1,7,359,433,547,980,"6 de julio de 1997"
17,1,7,360,562,670,1232,"6 de julio de 1997"
17,1,7,361,506,570,1076,"6 de julio de 1997"
17,1,7,362,252,321,573,"6 de julio de 1997"
17,1,7,363,328,424,752,"6 de julio de 1997"
17,1,7,364,492,536,1028,"6 de julio de 1997"
17,1,7,365,517,587,1104,"6 de julio de 1997"
17,1,7,366,488,553,1041,"6 de julio de 1997"
17,1,7,367,558,653,1211,"6 de julio de 1997"
17,1,7,368,483,539,1022,"6 de julio de 1997"
17,1,7,369,550,701,1251,"6 de julio de 1997"
17,1,7,370,713,798,1511,"6 de julio de 1997"
17,1,7,371,491,560,1051,"6 de julio de 1997"
17,1,7,372,392,497,889,"6 de julio de 1997"
17,1,7,373,540,630,1170,"6 de julio de 1997"
17,1,7,374,388,423,811,"6 de julio de 1997"
17,1,7,375,879,1042,1921,"6 de julio de 1997"
17,1,7,376,271,316,587,"6 de julio de 1997"
17,1,7,377,367,395,762,"6 de julio de 1997"
17,1,7,378,479,500,979,"6 de julio de 1997"
17,1,7,379,437,502,939,"6 de julio de 1997"
17,1,7,380,218,232,450,"6 de julio de 1997"
17,1,7,381,243,289,532,"6 de julio de 1997"
17,1,7,382,866,1055,1921,"6 de julio de 1997"
17,1,7,383,487,543,1030,"6 de julio de 1997"
17,1,7,384,367,472,839,"6 de julio de 1997"
17,1,7,385,737,895,1632,"6 de julio de 1997"
17,1,7,386,640,693,1333,"6 de julio de 1997"
17,1,7,387,502,583,1085,"6 de julio de 1997"
17,1,7,388,856,1009,1865,"6 de julio de 1997"
17,1,7,389,239,248,487,"6 de julio de 1997"
17,1,7,390,596,171,767,"6 de julio de 1997"
17,1,9,412,492,526,1018,"6 de julio de 1997"
17,1,9,413,423,422,845,"6 de julio de 1997"
17,1,9,414,372,389,761,"6 de julio de 1997"
17,1,9,415,39,43,82,"6 de julio de 1997"
17,1,9,416,520,526,1046,"6 de julio de 1997"
17,1,9,417,601,631,1232,"6 de julio de 1997"
17,1,9,418,342,350,692,"6 de julio de 1997"
17,1,9,419,449,453,902,"6 de julio de 1997"
17,1,9,420,181,210,391,"6 de julio de 1997"
17,1,9,421,166,177,343,"6 de julio de 1997"
17,1,9,422,183,192,375,"6 de julio de 1997"
17,2,2,12,661,648,1309,"6 de julio de 1997"
17,2,2,13,569,624,1193,"6 de julio de 1997"
17,2,2,14,510,522,1032,"6 de julio de 1997"
17,2,2,15,448,437,885,"6 de julio de 1997"
17,2,2,16,191,174,365,"6 de julio de 1997"
17,2,2,17,316,352,668,"6 de julio de 1997"
17,2,2,18,234,203,437,"6 de julio de 1997"
17,2,2,19,307,289,596,"6 de julio de 1997"
17,2,2,20,119,120,239,"6 de julio de 1997"
17,2,2,21,106,102,208,"6 de julio de 1997"
17,2,2,22,98,104,202,"6 de julio de 1997"
17,2,2,23,91,108,199,"6 de julio de 1997"
17,2,8,391,456,541,997,"6 de julio de 1997"
17,2,8,392,472,497,969,"6 de julio de 1997"
17,2,8,393,374,383,757,"6 de julio de 1997"
17,2,8,394,542,643,1185,"6 de julio de 1997"
17,2,8,395,422,491,913,"6 de julio de 1997"
17,2,8,396,746,803,1549,"6 de julio de 1997"
17,2,8,397,578,636,1214,"6 de julio de 1997"
17,2,8,398,545,591,1136,"6 de julio de 1997"
17,2,8,399,600,627,1227,"6 de julio de 1997"
17,2,8,400,652,772,1424,"6 de julio de 1997"
17,2,8,401,421,512,933,"6 de julio de 1997"
17,2,8,402,740,815,1555,"6 de julio de 1997"
17,2,8,403,383,432,815,"6 de julio de 1997"
17,2,8,404,610,731,1341,"6 de julio de 1997"
17,2,8,405,386,419,805,"6 de julio de 1997"
17,2,8,406,1036,1142,2178,"6 de julio de 1997"
17,2,8,407,558,682,1240,"6 de julio de 1997"
17,2,8,408,501,523,1024,"6 de julio de 1997"
17,2,8,409,540,573,1113,"6 de julio de 1997"
17,2,8,410,597,678,1275,"6 de julio de 1997"
17,2,8,411,567,658,1225,"6 de julio de 1997"
17,2,11,431,373,417,790,"6 de julio de 1997"
17,2,11,432,345,413,758,"6 de julio de 1997"
17,2,11,433,597,662,1259,"6 de julio de 1997"
17,2,11,434,726,855,1581,"6 de julio de 1997"
17,2,11,435,676,787,1463,"6 de julio de 1997"
17,2,11,436,725,916,1641,"6 de julio de 1997"
17,2,11,437,577,681,1258,"6 de julio de 1997"
17,2,11,438,598,670,1268,"6 de julio de 1997"
17,2,11,439,554,648,1202,"6 de julio de 1997"
17,2,11,440,328,405,733,"6 de julio de 1997"
17,2,11,441,502,568,1070,"6 de julio de 1997"
17,2,11,442,376,445,821,"6 de julio de 1997"
17,2,11,443,466,558,1024,"6 de julio de 1997"
17,2,11,444,649,762,1411,"6 de julio de 1997"
17,2,11,445,562,646,1208,"6 de julio de 1997"
17,2,11,446,403,445,848,"6 de julio de 1997"
17,2,11,447,354,420,774,"6 de julio de 1997"
17,2,11,448,617,673,1290,"6 de julio de 1997"
17,2,11,449,1048,1138,2186,"6 de julio de 1997"
17,2,11,450,641,779,1420,"6 de julio de 1997"
17,2,11,451,526,586,1112,"6 de julio de 1997"
17,2,11,452,513,606,1119,"6 de julio de 1997"
17,2,11,453,814,869,1683,"6 de julio de 1997"
17,2,11,454,855,956,1811,"6 de julio de 1997"
17,2,11,455,1006,1214,2220,"6 de julio de 1997"
17,2,11,456,510,564,1074,"6 de julio de 1997"
17,2,11,457,781,842,1623,"6 de julio de 1997"
17,2,11,458,635,666,1301,"6 de julio de 1997"
17,2,11,459,525,602,1127,"6 de julio de 1997"
17,2,11,460,338,381,719,"6 de julio de 1997"
17,2,11,461,388,528,916,"6 de julio de 1997"
17,2,11,462,444,503,947,"6 de julio de 1997"
17,2,11,463,555,633,1188,"6 de julio de 1997"
17,2,11,464,766,853,1619,"6 de julio de 1997"
17,2,11,465,1347,1545,2892,"6 de julio de 1997"
17,2,11,466,275,324,599,"6 de julio de 1997"
17,2,11,467,397,417,814,"6 de julio de 1997"
17,2,11,468,550,613,1163,"6 de julio de 1997"
17,2,11,469,849,954,1803,"6 de julio de 1997"
17,2,11,470,663,807,1470,"6 de julio de 1997"
17,2,11,471,842,951,1793,"6 de julio de 1997"
17,2,11,472,827,922,1749,"6 de julio de 1997"
17,2,11,473,366,371,737,"6 de julio de 1997"
17,2,11,474,553,612,1165,"6 de julio de 1997"
17,2,11,475,365,440,805,"6 de julio de 1997"
17,2,11,476,316,341,657,"6 de julio de 1997"
17,2,11,477,1008,1160,2168,"6 de julio de 1997"
17,2,11,478,397,457,854,"6 de julio de 1997"
17,2,11,479,409,483,892,"6 de julio de 1997"
17,2,11,480,353,414,767,"6 de julio de 1997"
17,2,11,481,683,713,1396,"6 de julio de 1997"
17,2,11,482,458,525,983,"6 de julio de 1997"
17,2,11,483,806,897,1703,"6 de julio de 1997"
17,2,11,484,883,976,1859,"6 de julio de 1997"
17,2,11,485,852,940,1792,"6 de julio de 1997"
17,2,11,486,1100,1162,2262,"6 de julio de 1997"
17,2,11,487,697,789,1486,"6 de julio de 1997"
17,2,11,488,986,1111,2097,"6 de julio de 1997"
17,2,11,489,587,701,1288,"6 de julio de 1997"
17,2,11,490,280,315,595,"6 de julio de 1997"
17,2,11,491,296,341,637,"6 de julio de 1997"
17,2,11,492,289,345,634,"6 de julio de 1997"
17,2,11,493,394,457,851,"6 de julio de 1997"
17,2,11,494,343,397,740,"6 de julio de 1997"
17,2,11,495,519,562,1081,"6 de julio de 1997"
17,2,11,496,460,457,917,"6 de julio de 1997"
17,2,11,497,822,850,1672,"6 de julio de 1997"
17,2,11,498,535,608,1143,"6 de julio de 1997"
17,2,11,499,545,605,1150,"6 de julio de 1997"
17,2,11,500,209,255,464,"6 de julio de 1997"
17,2,18,611,496,570,1066,"6 de julio de 1997"
17,2,18,612,421,477,898,"6 de julio de 1997"
17,2,18,613,274,315,589,"6 de julio de 1997"
17,2,18,614,333,375,708,"6 de julio de 1997"
17,2,18,615,580,698,1278,"6 de julio de 1997"
17,2,18,616,548,649,1197,"6 de julio de 1997"
17,2,18,617,449,534,983,"6 de julio de 1997"
17,2,18,618,1099,1262,2361,"6 de julio de 1997"
17,2,18,619,624,677,1301,"6 de julio de 1997"
17,2,18,620,528,527,1055,"6 de julio de 1997"
17,2,18,621,525,565,1090,"6 de julio de 1997"
17,2,18,622,665,743,1408,"6 de julio de 1997"
17,2,18,623,638,714,1352,"6 de julio de 1997"
17,2,18,624,513,606,1119,"6 de julio de 1997"
17,2,18,625,485,545,1030,"6 de julio de 1997"
17,2,18,626,606,650,1256,"6 de julio de 1997"
17,2,18,627,526,528,1054,"6 de julio de 1997"
17,2,18,628,545,631,1176,"6 de julio de 1997"
17,2,18,629,256,280,536,"6 de julio de 1997"
17,2,18,630,968,1104,2072,"6 de julio de 1997"
17,2,18,631,570,658,1228,"6 de julio de 1997"
17,2,18,632,404,447,851,"6 de julio de 1997"
17,2,18,633,563,661,1224,"6 de julio de 1997"
17,2,18,634,474,576,1050,"6 de julio de 1997"
17,2,18,635,642,741,1383,"6 de julio de 1997"
17,2,18,636,723,846,1569,"6 de julio de 1997"
17,2,18,637,515,646,1161,"6 de julio de 1997"
17,2,18,638,562,674,1236,"6 de julio de 1997"
17,2,18,639,549,561,1110,"6 de julio de 1997"
17,2,18,640,375,447,822,"6 de julio de 1997"
17,2,18,641,462,547,1009,"6 de julio de 1997"
17,2,18,642,548,607,1155,"6 de julio de 1997"
17,2,18,643,330,392,722,"6 de julio de 1997"
17,2,18,644,674,793,1467,"6 de julio de 1997"
17,2,18,645,572,676,1248,"6 de julio de 1997"
17,2,18,646,451,508,959,"6 de julio de 1997"
17,2,18,647,571,631,1202,"6 de julio de 1997"
17,2,18,648,587,722,1309,"6 de julio de 1997"
17,2,18,649,521,566,1087,"6 de julio de 1997"
17,2,18,650,148,191,339,"6 de julio de 1997"
17,2,18,651,745,779,1524,"6 de julio de 1997"
17,2,18,652,625,671,1296,"6 de julio de 1997"
17,2,18,653,550,591,1141,"6 de julio de 1997"
17,2,20,670,374,380,754,"6 de julio de 1997"
17,2,20,671,393,424,817,"6 de julio de 1997"
17,2,20,672,177,186,363,"6 de julio de 1997"
17,2,20,673,562,649,1211,"6 de julio de 1997"
17,2,20,674,441,466,907,"6 de julio de 1997"
17,2,20,675,534,584,1118,"6 de julio de 1997"
17,2,20,676,514,532,1046,"6 de julio de 1997"
17,2,20,677,410,402,812,"6 de julio de 1997"
17,2,20,678,297,309,606,"6 de julio de 1997"
17,2,20,679,438,466,904,"6 de julio de 1997"
17,2,20,680,424,455,879,"6 de julio de 1997"
17,2,20,681,314,333,647,"6 de julio de 1997"
17,2,20,682,496,502,998,"6 de julio de 1997"
17,2,20,683,611,531,1142,"6 de julio de 1997"
17,2,20,684,242,225,467,"6 de julio de 1997"
17,2,20,685,263,261,524,"6 de julio de 1997"
17,2,20,686,388,408,796,"6 de julio de 1997"
17,2,20,687,352,412,764,"6 de julio de 1997"
17,2,20,688,209,231,440,"6 de julio de 1997"
17,2,23,703,543,564,1107,"6 de julio de 1997"
17,2,23,704,438,454,892,"6 de julio de 1997"
17,2,23,705,251,251,502,"6 de julio de 1997"
17,2,23,706,196,193,389,"6 de julio de 1997"
17,2,26,760,462,456,918,"6 de julio de 1997"
17,2,26,761,668,648,1316,"6 de julio de 1997"
17,2,26,762,563,583,1146,"6 de julio de 1997"
17,2,26,763,408,348,756,"6 de julio de 1997"
17,2,26,764,372,333,705,"6 de julio de 1997"
17,2,26,765,184,184,368,"6 de julio de 1997"
17,2,26,766,385,380,765,"6 de julio de 1997"
17,2,26,767,218,220,438,"6 de julio de 1997"
17,2,26,768,511,512,1023,"6 de julio de 1997"
17,2,27,769,643,628,1271,"6 de julio de 1997"
17,2,27,770,481,515,996,"6 de julio de 1997"
17,2,27,771,462,465,927,"6 de julio de 1997"
17,2,27,772,72,79,151,"6 de julio de 1997"
17,2,27,773,413,434,847,"6 de julio de 1997"
17,2,27,774,92,83,175,"6 de julio de 1997"
17,2,27,775,82,73,155,"6 de julio de 1997"
17,2,29,799,590,689,1279,"6 de julio de 1997"
17,2,29,800,496,507,1003,"6 de julio de 1997"
17,2,29,801,535,525,1060,"6 de julio de 1997"
17,2,29,802,471,501,972,"6 de julio de 1997"
17,2,29,803,422,452,874,"6 de julio de 1997"
17,2,29,804,558,555,1113,"6 de julio de 1997"
17,2,29,805,569,660,1229,"6 de julio de 1997"
17,2,29,806,507,554,1061,"6 de julio de 1997"
17,2,29,807,287,330,617,"6 de julio de 1997"
17,2,29,808,503,596,1099,"6 de julio de 1997"
17,2,29,809,482,563,1045,"6 de julio de 1997"
17,2,29,810,703,836,1539,"6 de julio de 1997"
17,2,29,811,724,876,1600,"6 de julio de 1997"
17,2,29,812,573,632,1205,"6 de julio de 1997"
17,2,29,813,551,616,1167,"6 de julio de 1997"
17,2,29,814,241,236,477,"6 de julio de 1997"
17,2,29,815,414,408,822,"6 de julio de 1997"
17,2,29,816,556,634,1190,"6 de julio de 1997"
17,2,29,817,855,970,1825,"6 de julio de 1997"
17,2,29,818,505,508,1013,"6 de julio de 1997"
17,2,29,819,318,367,685,"6 de julio de 1997"
17,2,29,820,397,445,842,"6 de julio de 1997"
17,2,29,821,228,281,509,"6 de julio de 1997"
17,2,29,822,325,367,692,"6 de julio de 1997"
17,2,29,823,320,346,666,"6 de julio de 1997"
17,2,29,824,385,392,777,"6 de julio de 1997"
17,2,29,825,329,369,698,"6 de julio de 1997"
17,2,29,826,280,323,603,"6 de julio de 1997"
17,2,29,827,260,288,548,"6 de julio de 1997"
17,2,29,828,458,490,948,"6 de julio de 1997"
17,2,29,829,451,489,940,"6 de julio de 1997"
17,2,29,830,374,420,794,"6 de julio de 1997"
17,2,29,831,257,254,511,"6 de julio de 1997"
17,2,29,832,186,203,389,"6 de julio de 1997"
17,2,29,833,296,348,644,"6 de julio de 1997"
17,2,29,834,635,687,1322,"6 de julio de 1997"
17,2,29,835,178,211,389,"6 de julio de 1997"
17,2,29,836,420,459,879,"6 de julio de 1997"
17,2,29,837,320,372,692,"6 de julio de 1997"
17,2,29,838,326,355,681,"6 de julio de 1997"
17,2,29,839,620,699,1319,"6 de julio de 1997"
17,2,29,840,447,474,921,"6 de julio de 1997"
17,2,29,841,111,146,257,"6 de julio de 1997"
17,2,29,842,374,428,802,"6 de julio de 1997"
17,2,29,843,589,675,1264,"6 de julio de 1997"
17,2,29,844,825,942,1767,"6 de julio de 1997"
17,2,29,845,304,341,645,"6 de julio de 1997"
17,2,29,846,270,266,536,"6 de julio de 1997"
17,2,29,847,353,348,701,"6 de julio de 1997"
17,2,29,848,391,387,778,"6 de julio de 1997"
17,2,29,849,200,247,447,"6 de julio de 1997"
17,3,3,24,436,424,860,"6 de julio de 1997"
17,3,3,25,442,464,906,"6 de julio de 1997"
17,3,3,26,737,808,1545,"6 de julio de 1997"
17,3,3,27,452,484,936,"6 de julio de 1997"
17,3,3,28,468,475,943,"6 de julio de 1997"
17,3,3,29,558,627,1185,"6 de julio de 1997"
17,3,3,30,553,626,1179,"6 de julio de 1997"
17,3,3,31,593,723,1316,"6 de julio de 1997"
17,3,3,32,319,346,665,"6 de julio de 1997"
17,3,3,33,581,609,1190,"6 de julio de 1997"
17,3,3,34,78,86,164,"6 de julio de 1997"
17,3,3,35,331,366,697,"6 de julio de 1997"
17,3,3,36,344,343,687,"6 de julio de 1997"
17,3,3,37,280,287,567,"6 de julio de 1997"
17,3,3,38,473,520,993,"6 de julio de 1997"
17,3,3,39,346,385,731,"6 de julio de 1997"
17,3,3,40,364,404,768,"6 de julio de 1997"
17,3,3,41,334,340,674,"6 de julio de 1997"
17,3,3,42,131,141,272,"6 de julio de 1997"
17,3,3,43,260,285,545,"6 de julio de 1997"
17,3,4,44,444,488,932,"6 de julio de 1997"
17,3,4,45,665,805,1470,"6 de julio de 1997"
17,3,4,46,390,440,830,"6 de julio de 1997"
17,3,4,47,503,564,1067,"6 de julio de 1997"
17,3,4,48,452,518,970,"6 de julio de 1997"
17,3,4,49,577,629,1206,"6 de julio de 1997"
17,3,4,50,348,407,755,"6 de julio de 1997"
17,3,4,51,369,416,785,"6 de julio de 1997"
17,3,4,52,475,566,1041,"6 de julio de 1997"
17,3,4,53,112,107,219,"6 de julio de 1997"
17,3,4,54,524,652,1176,"6 de julio de 1997"
17,3,4,55,545,594,1139,"6 de julio de 1997"
17,3,4,56,522,577,1099,"6 de julio de 1997"
17,3,4,57,537,563,1100,"6 de julio de 1997"
17,3,4,58,525,592,1117,"6 de julio de 1997"
17,3,4,59,598,666,1264,"6 de julio de 1997"
17,3,4,60,166,174,340,"6 de julio de 1997"
17,3,4,61,512,614,1126,"6 de julio de 1997"
17,3,4,62,623,716,1339,"6 de julio de 1997"
17,3,4,63,66,81,147,"6 de julio de 1997"
17,3,4,64,139,136,275,"6 de julio de 1997"
17,3,4,65,272,301,573,"6 de julio de 1997"
17,3,4,66,489,548,1037,"6 de julio de 1997"
17,3,4,67,569,602,1171,"6 de julio de 1997"
17,3,4,68,488,560,1048,"6 de julio de 1997"
17,3,4,69,442,516,958,"6 de julio de 1997"
17,3,4,70,519,610,1129,"6 de julio de 1997"
17,3,4,71,467,530,997,"6 de julio de 1997"
17,3,4,72,656,746,1402,"6 de julio de 1997"
17,3,4,73,579,605,1184,"6 de julio de 1997"
17,3,4,74,659,720,1379,"6 de julio de 1997"
17,3,4,75,502,499,1001,"6 de julio de 1997"
17,3,4,76,380,416,796,"6 de julio de 1997"
17,3,4,77,603,621,1224,"6 de julio de 1997"
17,3,4,78,64,75,139,"6 de julio de 1997"
17,3,4,79,251,226,477,"6 de julio de 1997"
17,3,4,80,467,503,970,"6 de julio de 1997"
17,3,4,81,139,141,280,"6 de julio de 1997"
17,3,4,82,70,75,145,"6 de julio de 1997"
17,3,4,83,367,391,758,"6 de julio de 1997"
17,3,4,84,472,462,934,"6 de julio de 1997"
17,3,4,85,230,209,439,"6 de julio de 1997"
17,3,6,97,616,622,1238,"6 de julio de 1997"
17,3,6,98,293,315,608,"6 de julio de 1997"
17,3,6,99,558,599,1157,"6 de julio de 1997"
17,3,6,100,528,513,1041,"6 de julio de 1997"
17,3,6,101,319,359,678,"6 de julio de 1997"
17,3,6,102,543,585,1128,"6 de julio de 1997"
17,3,6,103,415,438,853,"6 de julio de 1997"
17,3,6,104,374,424,798,"6 de julio de 1997"
17,3,6,105,293,354,647,"6 de julio de 1997"
17,3,6,106,330,393,723,"6 de julio de 1997"
17,3,6,107,351,423,774,"6 de julio de 1997"
17,3,6,108,561,647,1208,"6 de julio de 1997"
17,3,6,109,578,637,1215,"6 de julio de 1997"
17,3,6,110,616,669,1285,"6 de julio de 1997"
17,3,6,111,585,683,1268,"6 de julio de 1997"
17,3,6,112,589,644,1233,"6 de julio de 1997"
17,3,6,113,551,599,1150,"6 de julio de 1997"
17,3,6,114,781,830,1611,"6 de julio de 1997"
17,3,6,115,336,366,702,"6 de julio de 1997"
17,3,6,116,510,663,1173,"6 de julio de 1997"
17,3,6,117,407,488,895,"6 de julio de 1997"
17,3,6,118,467,548,1015,"6 de julio de 1997"
17,3,6,119,511,626,1137,"6 de julio de 1997"
17,3,6,120,477,548,1025,"6 de julio de 1997"
17,3,6,121,197,221,418,"6 de julio de 1997"
17,3,6,122,323,379,702,"6 de julio de 1997"
17,3,6,123,690,761,1451,"6 de julio de 1997"
17,3,6,124,491,568,1059,"6 de julio de 1997"
17,3,6,125,723,764,1487,"6 de julio de 1997"
17,3,6,126,470,537,1007,"6 de julio de 1997"
17,3,6,127,542,596,1138,"6 de julio de 1997"
17,3,6,128,471,558,1029,"6 de julio de 1997"
17,3,6,129,490,560,1050,"6 de julio de 1997"
17,3,6,130,401,441,842,"6 de julio de 1997"
17,3,6,131,603,686,1289,"6 de julio de 1997"
17,3,6,132,511,581,1092,"6 de julio de 1997"
17,3,6,133,154,175,329,"6 de julio de 1997"
17,3,6,134,473,503,976,"6 de julio de 1997"
17,3,6,135,922,1064,1986,"6 de julio de 1997"
17,3,6,136,414,535,949,"6 de julio de 1997"
17,3,6,137,1001,506,1507,"6 de julio de 1997"
17,3,6,138,490,579,1069,"6 de julio de 1997"
17,3,6,139,359,436,795,"6 de julio de 1997"
17,3,6,140,523,584,1107,"6 de julio de 1997"
17,3,6,141,394,394,788,"6 de julio de 1997"
17,3,6,142,494,611,1105,"6 de julio de 1997"
17,3,6,143,637,736,1373,"6 de julio de 1997"
17,3,6,144,373,488,861,"6 de julio de 1997"
17,3,6,145,437,525,962,"6 de julio de 1997"
17,3,6,146,541,607,1148,"6 de julio de 1997"
17,3,6,147,511,548,1059,"6 de julio de 1997"
17,3,6,148,492,575,1067,"6 de julio de 1997"
17,3,6,149,328,402,730,"6 de julio de 1997"
17,3,6,150,496,577,1073,"6 de julio de 1997"
17,3,6,151,671,690,1361,"6 de julio de 1997"
17,3,6,152,534,615,1149,"6 de julio de 1997"
17,3,6,153,318,387,705,"6 de julio de 1997"
17,3,6,154,369,445,814,"6 de julio de 1997"
17,3,6,155,493,572,1065,"6 de julio de 1997"
17,3,6,156,395,444,839,"6 de julio de 1997"
17,3,6,157,364,443,807,"6 de julio de 1997"
17,3,6,158,232,313,545,"6 de julio de 1997"
17,3,6,159,656,759,1415,"6 de julio de 1997"
17,3,6,160,353,403,756,"6 de julio de 1997"
17,3,6,161,264,333,597,"6 de julio de 1997"
17,3,6,162,511,594,1105,"6 de julio de 1997"
17,3,6,163,221,247,468,"6 de julio de 1997"
17,3,6,164,198,256,454,"6 de julio de 1997"
17,3,6,165,443,488,931,"6 de julio de 1997"
17,3,6,166,489,580,1069,"6 de julio de 1997"
17,3,6,167,400,453,853,"6 de julio de 1997"
17,3,6,168,377,471,848,"6 de julio de 1997"
17,3,6,169,496,549,1045,"6 de julio de 1997"
17,3,6,170,406,481,887,"6 de julio de 1997"
17,3,6,171,228,280,508,"6 de julio de 1997"
17,3,6,172,315,345,660,"6 de julio de 1997"
17,3,6,173,565,656,1221,"6 de julio de 1997"
17,3,6,174,447,506,953,"6 de julio de 1997"
17,3,6,175,445,515,960,"6 de julio de 1997"
17,3,6,176,298,355,653,"6 de julio de 1997"
17,3,6,177,507,568,1075,"6 de julio de 1997"
17,3,6,178,796,856,1652,"6 de julio de 1997"
17,3,6,179,480,542,1022,"6 de julio de 1997"
17,3,6,180,526,623,1149,"6 de julio de 1997"
17,3,6,181,399,482,881,"6 de julio de 1997"
17,3,6,182,464,497,961,"6 de julio de 1997"
17,3,6,183,479,597,1076,"6 de julio de 1997"
17,3,6,184,230,245,475,"6 de julio de 1997"
17,3,6,185,654,705,1359,"6 de julio de 1997"
17,3,6,186,433,437,870,"6 de julio de 1997"
17,3,6,187,74,79,153,"6 de julio de 1997"
17,3,10,423,401,412,813,"6 de julio de 1997"
17,3,10,424,403,415,818,"6 de julio de 1997"
17,3,10,425,377,461,838,"6 de julio de 1997"
17,3,10,426,628,627,1255,"6 de julio de 1997"
17,3,10,427,492,499,991,"6 de julio de 1997"
17,3,10,428,336,378,714,"6 de julio de 1997"
17,3,10,429,536,579,1115,"6 de julio de 1997"
17,3,10,430,617,654,1271,"6 de julio de 1997"
17,3,13,537,291,375,666,"6 de julio de 1997"
17,3,13,538,475,496,971,"6 de julio de 1997"
17,3,13,539,366,389,755,"6 de julio de 1997"
17,3,13,540,470,525,995,"6 de julio de 1997"
17,3,13,541,373,395,768,"6 de julio de 1997"
17,3,13,542,353,402,755,"6 de julio de 1997"
17,3,13,543,180,179,359,"6 de julio de 1997"
17,3,13,544,523,530,1053,"6 de julio de 1997"
17,3,13,545,280,318,598,"6 de julio de 1997"
17,3,13,546,280,295,575,"6 de julio de 1997"
17,3,13,547,354,375,729,"6 de julio de 1997"
17,3,16,569,635,636,1271,"6 de julio de 1997"
17,3,16,570,313,342,655,"6 de julio de 1997"
17,3,16,571,287,316,603,"6 de julio de 1997"
17,3,16,572,360,402,762,"6 de julio de 1997"
17,3,16,573,308,325,633,"6 de julio de 1997"
17,3,16,574,244,246,490,"6 de julio de 1997"
17,3,16,575,598,640,1238,"6 de julio de 1997"
17,3,16,576,510,528,1038,"6 de julio de 1997"
17,3,16,577,209,221,430,"6 de julio de 1997"
17,3,16,578,545,527,1072,"6 de julio de 1997"
17,3,19,654,732,693,1425,"6 de julio de 1997"
17,3,19,655,547,575,1122,"6 de julio de 1997"
17,3,19,656,477,509,986,"6 de julio de 1997"
17,3,19,657,586,543,1129,"6 de julio de 1997"
17,3,19,658,432,441,873,"6 de julio de 1997"
17,3,19,659,147,163,310,"6 de julio de 1997"
17,3,19,660,509,592,1101,"6 de julio de 1997"
17,3,19,661,385,409,794,"6 de julio de 1997"
17,3,19,662,521,532,1053,"6 de julio de 1997"
17,3,19,663,562,556,1118,"6 de julio de 1997"
17,3,19,664,148,109,257,"6 de julio de 1997"
17,3,19,665,410,405,815,"6 de julio de 1997"
17,3,19,666,58,53,111,"6 de julio de 1997"
17,3,19,667,535,553,1088,"6 de julio de 1997"
17,3,19,668,440,465,905,"6 de julio de 1997"
17,3,19,669,511,502,1013,"6 de julio de 1997"
17,3,22,695,658,710,1368,"6 de julio de 1997"
17,3,22,696,605,589,1194,"6 de julio de 1997"
17,3,22,697,866,967,1833,"6 de julio de 1997"
17,3,22,698,317,333,650,"6 de julio de 1997"
17,3,22,699,387,400,787,"6 de julio de 1997"
17,3,22,700,451,441,892,"6 de julio de 1997"
17,3,22,701,412,433,845,"6 de julio de 1997"
17,3,22,702,359,401,760,"6 de julio de 1997"
17,3,30,850,548,558,1106,"6 de julio de 1997"
17,3,30,851,612,685,1297,"6 de julio de 1997"
17,3,30,852,834,858,1692,"6 de julio de 1997"
17,3,30,853,508,483,991,"6 de julio de 1997"
17,3,30,854,400,388,788,"6 de julio de 1997"
17,3,30,855,527,587,1114,"6 de julio de 1997"
17,3,30,856,636,577,1213,"6 de julio de 1997"
17,3,30,857,446,424,870,"6 de julio de 1997"
17,3,30,858,578,598,1176,"6 de julio de 1997"
17,3,30,859,447,498,945,"6 de julio de 1997"
17,3,30,860,405,475,880,"6 de julio de 1997"
17,3,30,861,441,538,979,"6 de julio de 1997"
17,3,30,862,585,687,1272,"6 de julio de 1997"
17,3,30,863,618,717,1335,"6 de julio de 1997"
17,3,30,864,474,582,1056,"6 de julio de 1997"
17,3,30,865,368,444,812,"6 de julio de 1997"
17,3,30,866,210,231,441,"6 de julio de 1997"
17,3,30,867,319,286,605,"6 de julio de 1997"
17,3,30,868,149,131,280,"6 de julio de 1997"
17,3,32,895,335,372,707,"6 de julio de 1997"
17,3,32,896,442,415,857,"6 de julio de 1997"
17,3,32,897,308,326,634,"6 de julio de 1997"
17,3,32,898,361,383,744,"6 de julio de 1997"
17,3,32,899,433,448,881,"6 de julio de 1997"
17,3,32,900,475,458,933,"6 de julio de 1997"
17,3,33,901,561,606,1167,"6 de julio de 1997"
17,3,33,902,842,839,1681,"6 de julio de 1997"
17,3,33,903,247,222,469,"6 de julio de 1997"
17,3,33,904,355,373,728,"6 de julio de 1997"
17,3,33,905,474,527,1001,"6 de julio de 1997"
17,3,33,906,763,842,1605,"6 de julio de 1997"
17,4,1,1,447,479,926,"6 de julio de 1997"
17,4,1,2,257,293,550,"6 de julio de 1997"
17,4,1,3,430,499,929,"6 de julio de 1997"
17,4,1,4,531,557,1088,"6 de julio de 1997"
17,4,1,5,199,253,452,"6 de julio de 1997"
17,4,1,6,691,745,1436,"6 de julio de 1997"
17,4,1,7,324,379,703,"6 de julio de 1997"
17,4,1,8,414,460,874,"6 de julio de 1997"
17,4,1,9,495,535,1030,"6 de julio de 1997"
17,4,1,10,412,483,895,"6 de julio de 1997"
17,4,1,11,258,278,536,"6 de julio de 1997"
17,4,5,86,330,369,699,"6 de julio de 1997"
17,4,5,87,509,558,1067,"6 de julio de 1997"
17,4,5,88,194,203,397,"6 de julio de 1997"
17,4,5,89,542,512,1054,"6 de julio de 1997"
17,4,5,90,162,182,344,"6 de julio de 1997"
17,4,5,91,107,111,218,"6 de julio de 1997"
17,4,5,92,248,276,524,"6 de julio de 1997"
17,4,5,93,336,347,683,"6 de julio de 1997"
17,4,5,94,239,283,522,"6 de julio de 1997"
17,4,5,95,140,147,287,"6 de julio de 1997"
17,4,5,96,105,97,202,"6 de julio de 1997"
17,4,12,501,614,710,1324,"6 de julio de 1997"
17,4,12,502,404,453,857,"6 de julio de 1997"
17,4,12,503,190,228,418,"6 de julio de 1997"
17,4,12,504,744,835,1579,"6 de julio de 1997"
17,4,12,505,646,743,1389,"6 de julio de 1997"
17,4,12,506,351,373,724,"6 de julio de 1997"
17,4,12,507,383,450,833,"6 de julio de 1997"
17,4,12,508,294,339,633,"6 de julio de 1997"
17,4,12,509,73,73,146,"6 de julio de 1997"
17,4,12,510,311,329,640,"6 de julio de 1997"
17,4,12,511,589,688,1277,"6 de julio de 1997"
17,4,12,512,423,473,896,"6 de julio de 1997"
17,4,12,513,520,583,1103,"6 de julio de 1997"
17,4,12,514,403,440,843,"6 de julio de 1997"
17,4,12,515,362,401,763,"6 de julio de 1997"
17,4,12,516,793,814,1607,"6 de julio de 1997"
17,4,12,517,117,124,241,"6 de julio de 1997"
17,4,12,518,438,447,885,"6 de julio de 1997"
17,4,12,519,493,544,1037,"6 de julio de 1997"
17,4,12,520,313,335,648,"6 de julio de 1997"
17,4,12,521,361,390,751,"6 de julio de 1997"
17,4,12,522,343,384,727,"6 de julio de 1997"
17,4,12,523,381,405,786,"6 de julio de 1997"
17,4,12,524,375,446,821,"6 de julio de 1997"
17,4,12,525,642,682,1324,"6 de julio de 1997"
17,4,12,526,662,677,1339,"6 de julio de 1997"
17,4,12,527,323,331,654,"6 de julio de 1997"
17,4,12,528,513,520,1033,"6 de julio de 1997"
17,4,12,529,620,664,1284,"6 de julio de 1997"
17,4,12,530,713,804,1517,"6 de julio de 1997"
17,4,12,531,524,599,1123,"6 de julio de 1997"
17,4,12,532,353,381,734,"6 de julio de 1997"
17,4,12,533,598,677,1275,"6 de julio de 1997"
17,4,12,534,623,681,1304,"6 de julio de 1997"
17,4,12,535,643,676,1319,"6 de julio de 1997"
17,4,12,536,317,320,637,"6 de julio de 1997"
17,4,14,548,395,416,811,"6 de julio de 1997"
17,4,14,549,548,555,1103,"6 de julio de 1997"
17,4,14,550,314,342,656,"6 de julio de 1997"
17,4,14,551,360,372,732,"6 de julio de 1997"
17,4,14,552,282,310,592,"6 de julio de 1997"
17,4,14,553,281,295,576,"6 de julio de 1997"
17,4,14,554,362,390,752,"6 de julio de 1997"
17,4,15,555,544,570,1114,"6 de julio de 1997"
17,4,15,556,432,480,912,"6 de julio de 1997"
17,4,15,557,528,533,1061,"6 de julio de 1997"
17,4,15,558,531,561,1092,"6 de julio de 1997"
17,4,15,559,303,306,609,"6 de julio de 1997"
17,4,15,560,655,690,1345,"6 de julio de 1997"
17,4,15,561,389,377,766,"6 de julio de 1997"
17,4,15,562,358,380,738,"6 de julio de 1997"
17,4,15,563,255,264,519,"6 de julio de 1997"
17,4,15,564,575,640,1215,"6 de julio de 1997"
17,4,15,565,754,821,1575,"6 de julio de 1997"
17,4,15,566,145,189,334,"6 de julio de 1997"
17,4,15,567,418,471,889,"6 de julio de 1997"
17,4,15,568,532,564,1096,"6 de julio de 1997"
17,4,17,579,323,331,654,"6 de julio de 1997"
17,4,17,580,544,642,1186,"6 de julio de 1997"
17,4,17,581,435,442,877,"6 de julio de 1997"
17,4,17,582,387,423,810,"6 de julio de 1997"
17,4,17,583,517,590,1107,"6 de julio de 1997"
17,4,17,584,418,478,896,"6 de julio de 1997"
17,4,17,585,478,503,981,"6 de julio de 1997"
17,4,17,586,530,605,1135,"6 de julio de 1997"
17,4,17,587,483,520,1003,"6 de julio de 1997"
17,4,17,588,399,462,861,"6 de julio de 1997"
17,4,17,589,343,372,715,"6 de julio de 1997"
17,4,17,590,451,467,918,"6 de julio de 1997"
17,4,17,591,489,522,1011,"6 de julio de 1997"
17,4,17,592,516,516,1032,"6 de julio de 1997"
17,4,17,593,338,350,688,"6 de julio de 1997"
17,4,17,594,413,414,827,"6 de julio de 1997"
17,4,17,595,768,801,1569,"6 de julio de 1997"
17,4,17,596,914,951,1865,"6 de julio de 1997"
17,4,17,597,739,714,1453,"6 de julio de 1997"
17,4,17,598,848,842,1690,"6 de julio de 1997"
17,4,17,599,698,676,1374,"6 de julio de 1997"
17,4,17,600,479,462,941,"6 de julio de 1997"
17,4,17,601,580,654,1234,"6 de julio de 1997"
17,4,17,602,620,617,1237,"6 de julio de 1997"
17,4,17,603,131,112,243,"6 de julio de 1997"
17,4,17,604,139,154,293,"6 de julio de 1997"
17,4,17,605,366,408,774,"6 de julio de 1997"
17,4,17,606,326,371,697,"6 de julio de 1997"
17,4,17,607,346,381,727,"6 de julio de 1997"
17,4,17,608,475,510,985,"6 de julio de 1997"
17,4,17,609,432,428,860,"6 de julio de 1997"
17,4,17,610,135,119,254,"6 de julio de 1997"
17,4,21,689,548,584,1132,"6 de julio de 1997"
17,4,21,690,533,592,1125,"6 de julio de 1997"
17,4,21,691,458,485,943,"6 de julio de 1997"
17,4,21,692,219,216,435,"6 de julio de 1997"
17,4,21,693,244,240,484,"6 de julio de 1997"
17,4,21,694,99,108,207,"6 de julio de 1997"
17,4,24,707,629,666,1295,"6 de julio de 1997"
17,4,24,708,722,757,1479,"6 de julio de 1997"
17,4,24,709,638,735,1373,"6 de julio de 1997"
17,4,24,710,918,885,1803,"6 de julio de 1997"
17,4,24,711,374,414,788,"6 de julio de 1997"
17,4,24,712,238,249,487,"6 de julio de 1997"
17,4,24,713,406,496,902,"6 de julio de 1997"
17,4,24,714,717,744,1461,"6 de julio de 1997"
17,4,24,715,138,154,292,"6 de julio de 1997"
17,4,24,716,441,450,891,"6 de julio de 1997"
17,4,24,717,575,577,1152,"6 de julio de 1997"
17,4,24,718,262,272,534,"6 de julio de 1997"
17,4,24,719,373,384,757,"6 de julio de 1997"
17,4,24,720,169,191,360,"6 de julio de 1997"
17,4,24,721,263,273,536,"6 de julio de 1997"
17,4,24,722,348,353,701,"6 de julio de 1997"
17,4,24,723,570,604,1174,"6 de julio de 1997"
17,4,24,724,478,538,1016,"6 de julio de 1997"
17,4,24,725,756,788,1544,"6 de julio de 1997"
17,4,24,726,459,491,950,"6 de julio de 1997"
17,4,24,727,521,593,1114,"6 de julio de 1997"
17,4,24,728,461,563,1024,"6 de julio de 1997"
17,4,24,729,309,384,693,"6 de julio de 1997"
17,4,24,730,480,553,1033,"6 de julio de 1997"
17,4,24,731,781,830,1611,"6 de julio de 1997"
17,4,24,732,325,326,651,"6 de julio de 1997"
17,4,24,733,173,157,330,"6 de julio de 1997"
17,4,25,734,592,612,1204,"6 de julio de 1997"
17,4,25,735,525,560,1085,"6 de julio de 1997"
17,4,25,736,358,412,770,"6 de julio de 1997"
17,4,25,737,801,780,1581,"6 de julio de 1997"
17,4,25,738,699,786,1485,"6 de julio de 1997"
17,4,25,739,527,600,1127,"6 de julio de 1997"
17,4,25,740,951,1034,1985,"6 de julio de 1997"
17,4,25,741,659,753,1412,"6 de julio de 1997"
17,4,25,742,502,564,1066,"6 de julio de 1997"
17,4,25,743,485,523,1008,"6 de julio de 1997"
17,4,25,744,150,125,275,"6 de julio de 1997"
17,4,25,745,334,293,627,"6 de julio de 1997"
17,4,25,746,259,230,489,"6 de julio de 1997"
17,4,25,747,118,118,236,"6 de julio de 1997"
17,4,25,748,223,204,427,"6 de julio de 1997"
17,4,25,749,372,360,732,"6 de julio de 1997"
17,4,25,750,203,166,369,"6 de julio de 1997"
17,4,25,751,155,146,301,"6 de julio de 1997"
17,4,25,752,71,84,155,"6 de julio de 1997"
17,4,25,753,177,175,352,"6 de julio de 1997"
17,4,25,754,111,91,202,"6 de julio de 1997"
17,4,25,755,137,132,269,"6 de julio de 1997"
17,4,25,756,410,403,813,"6 de julio de 1997"
17,4,25,757,136,124,260,"6 de julio de 1997"
17,4,25,758,73,64,137,"6 de julio de 1997"
17,4,25,759,82,64,146,"6 de julio de 1997"
17,4,28,776,516,617,1133,"6 de julio de 1997"
17,4,28,777,882,1011,1893,"6 de julio de 1997"
17,4,28,778,485,529,1014,"6 de julio de 1997"
17,4,28,779,484,519,1003,"6 de julio de 1997"
17,4,28,780,432,470,902,"6 de julio de 1997"
17,4,28,781,474,543,1017,"6 de julio de 1997"
17,4,28,782,474,516,990,"6 de julio de 1997"
17,4,28,783,651,669,1320,"6 de julio de 1997"
17,4,28,784,371,434,805,"6 de julio de 1997"
17,4,28,785,321,384,705,"6 de julio de 1997"
17,4,28,786,195,203,398,"6 de julio de 1997"
17,4,28,787,635,676,1311,"6 de julio de 1997"
17,4,28,788,441,493,934,"6 de julio de 1997"
17,4,28,789,311,358,669,"6 de julio de 1997"
17,4,28,790,491,516,1007,"6 de julio de 1997"
17,4,28,791,519,537,1056,"6 de julio de 1997"
17,4,28,792,543,516,1059,"6 de julio de 1997"
17,4,28,793,268,238,506,"6 de julio de 1997"
17,4,28,794,661,662,1323,"6 de julio de 1997"
17,4,28,795,606,575,1181,"6 de julio de 1997"
17,4,28,796,623,704,1327,"6 de julio de 1997"
17,4,28,797,598,686,1284,"6 de julio de 1997"
17,4,28,798,455,567,1022,"6 de julio de 1997"
17,4,31,869,488,619,1107,"6 de julio de 1997"
17,4,31,870,619,714,1333,"6 de julio de 1997"
17,4,31,871,591,654,1245,"6 de julio de 1997"
17,4,31,872,192,256,448,"6 de julio de 1997"
17,4,31,873,414,442,856,"6 de julio de 1997"
17,4,31,874,734,807,1541,"6 de julio de 1997"
17,4,31,875,461,528,989,"6 de julio de 1997"
17,4,31,876,388,464,852,"6 de julio de 1997"
17,4,31,877,162,207,369,"6 de julio de 1997"
17,4,31,878,238,252,490,"6 de julio de 1997"
17,4,31,879,497,535,1032,"6 de julio de 1997"
17,4,31,880,332,355,687,"6 de julio de 1997"
17,4,31,881,562,665,1227,"6 de julio de 1997"
17,4,31,882,600,710,1310,"6 de julio de 1997"
17,4,31,883,473,541,1014,"6 de julio de 1997"
17,4,31,884,295,344,639,"6 de julio de 1997"
17,4,31,885,562,635,1197,"6 de julio de 1997"
17,4,31,886,80,92,172,"6 de julio de 1997"
17,4,31,887,263,268,531,"6 de julio de 1997"
17,4,31,888,426,453,879,"6 de julio de 1997"
17,4,31,889,376,442,818,"6 de julio de 1997"
17,4,31,890,373,409,782,"6 de julio de 1997"
17,4,31,891,291,313,604,"6 de julio de 1997"
17,4,31,892,358,408,766,"6 de julio de 1997"
17,4,31,893,467,522,989,"6 de julio de 1997"
17,4,31,894,450,512,962,"6 de julio de 1997"
18,1,1,1,240,228,468,"6 de julio de 1997"
18,1,1,2,259,236,495,"6 de julio de 1997"
18,1,1,3,829,505,1334,"6 de julio de 1997"
18,1,1,4,273,296,569,"6 de julio de 1997"
18,1,1,5,365,413,778,"6 de julio de 1997"
18,1,1,6,252,302,554,"6 de julio de 1997"
18,1,1,7,288,314,602,"6 de julio de 1997"
18,1,1,8,385,432,817,"6 de julio de 1997"
18,1,1,9,234,263,497,"6 de julio de 1997"
18,1,1,10,370,406,776,"6 de julio de 1997"
18,1,1,11,182,226,408,"6 de julio de 1997"
18,1,1,12,344,389,733,"6 de julio de 1997"
18,1,1,13,270,328,598,"6 de julio de 1997"
18,1,1,14,143,185,328,"6 de julio de 1997"
18,1,1,15,239,260,499,"6 de julio de 1997"
18,1,1,16,268,270,538,"6 de julio de 1997"
18,1,1,17,235,270,505,"6 de julio de 1997"
18,1,1,18,240,279,519,"6 de julio de 1997"
18,1,1,19,60,66,126,"6 de julio de 1997"
18,1,1,20,142,106,248,"6 de julio de 1997"
18,1,1,21,224,199,423,"6 de julio de 1997"
18,1,1,22,93,65,158,"6 de julio de 1997"
18,1,1,23,331,315,646,"6 de julio de 1997"
18,1,1,24,357,263,620,"6 de julio de 1997"
18,1,1,25,69,55,124,"6 de julio de 1997"
18,1,1,26,89,70,159,"6 de julio de 1997"
18,1,1,27,195,122,317,"6 de julio de 1997"
18,1,1,28,102,89,191,"6 de julio de 1997"
18,1,1,29,89,63,152,"6 de julio de 1997"
18,1,1,30,109,88,197,"6 de julio de 1997"
18,1,1,31,158,122,280,"6 de julio de 1997"
18,1,1,32,162,153,315,"6 de julio de 1997"
18,1,1,33,279,267,546,"6 de julio de 1997"
18,1,1,34,136,107,243,"6 de julio de 1997"
18,1,1,35,55,45,100,"6 de julio de 1997"
18,1,1,36,364,284,648,"6 de julio de 1997"
18,1,1,37,123,104,227,"6 de julio de 1997"
18,1,1,38,412,363,775,"6 de julio de 1997"
18,1,1,39,349,369,718,"6 de julio de 1997"
18,1,1,40,317,331,648,"6 de julio de 1997"
18,1,1,41,185,152,337,"6 de julio de 1997"
18,1,1,42,55,46,101,"6 de julio de 1997"
18,1,1,43,369,328,697,"6 de julio de 1997"
18,1,1,44,66,50,116,"6 de julio de 1997"
18,1,1,45,129,98,227,"6 de julio de 1997"
18,1,1,46,383,351,734,"6 de julio de 1997"
18,1,1,47,389,351,740,"6 de julio de 1997"
18,1,1,48,59,48,107,"6 de julio de 1997"
18,1,6,196,305,306,611,"6 de julio de 1997"
18,1,6,197,446,414,860,"6 de julio de 1997"
18,1,6,198,90,68,158,"6 de julio de 1997"
18,1,6,199,104,79,183,"6 de julio de 1997"
18,1,6,200,63,58,121,"6 de julio de 1997"
18,1,6,201,67,61,128,"6 de julio de 1997"
18,1,6,202,186,207,393,"6 de julio de 1997"
18,1,6,203,229,174,403,"6 de julio de 1997"
18,1,6,204,84,61,145,"6 de julio de 1997"
18,1,6,205,104,57,161,"6 de julio de 1997"
18,1,6,206,113,72,185,"6 de julio de 1997"
18,1,6,207,102,80,182,"6 de julio de 1997"
18,1,6,208,141,117,258,"6 de julio de 1997"
18,1,6,209,111,78,189,"6 de julio de 1997"
18,1,6,210,111,83,194,"6 de julio de 1997"
18,1,6,211,98,74,172,"6 de julio de 1997"
18,1,6,212,66,49,115,"6 de julio de 1997"
18,1,6,213,97,75,172,"6 de julio de 1997"
18,1,6,214,115,84,199,"6 de julio de 1997"
18,1,10,277,381,364,745,"6 de julio de 1997"
18,1,10,278,189,192,381,"6 de julio de 1997"
18,1,10,279,96,81,177,"6 de julio de 1997"
18,1,10,280,104,98,202,"6 de julio de 1997"
18,1,10,281,228,217,445,"6 de julio de 1997"
18,1,10,282,262,264,526,"6 de julio de 1997"
18,1,10,283,231,159,390,"6 de julio de 1997"
18,1,10,284,81,67,148,"6 de julio de 1997"
18,1,10,285,160,120,280,"6 de julio de 1997"
18,1,10,286,294,248,542,"6 de julio de 1997"
18,1,10,287,182,138,320,"6 de julio de 1997"
18,1,10,288,345,272,617,"6 de julio de 1997"
18,1,10,289,390,348,738,"6 de julio de 1997"
18,1,10,290,258,247,505,"6 de julio de 1997"
18,1,10,291,432,332,764,"6 de julio de 1997"
18,1,10,292,136,110,246,"6 de julio de 1997"
18,1,10,293,92,77,169,"6 de julio de 1997"
18,1,10,294,86,63,149,"6 de julio de 1997"
18,1,10,295,337,282,619,"6 de julio de 1997"
18,1,10,296,326,261,587,"6 de julio de 1997"
18,1,10,297,294,243,537,"6 de julio de 1997"
18,1,10,298,238,262,500,"6 de julio de 1997"
18,1,10,299,238,235,473,"6 de julio de 1997"
18,1,10,300,317,300,617,"6 de julio de 1997"
18,1,10,301,564,460,1024,"6 de julio de 1997"
18,1,10,302,350,336,686,"6 de julio de 1997"
18,1,10,303,261,204,465,"6 de julio de 1997"
18,1,10,304,308,264,572,"6 de julio de 1997"
18,1,10,305,256,248,504,"6 de julio de 1997"
18,1,10,306,367,335,702,"6 de julio de 1997"
18,1,10,307,243,235,478,"6 de julio de 1997"
18,1,10,308,235,255,490,"6 de julio de 1997"
18,1,10,309,366,340,706,"6 de julio de 1997"
18,1,10,310,395,405,800,"6 de julio de 1997"
18,1,10,311,585,585,1170,"6 de julio de 1997"
18,1,10,312,251,290,541,"6 de julio de 1997"
18,1,10,313,260,262,522,"6 de julio de 1997"
18,1,10,314,288,279,567,"6 de julio de 1997"
18,1,10,315,240,219,459,"6 de julio de 1997"
18,1,10,316,138,119,257,"6 de julio de 1997"
18,1,10,317,178,149,327,"6 de julio de 1997"
18,1,10,318,132,110,242,"6 de julio de 1997"
18,1,10,319,115,94,209,"6 de julio de 1997"
18,1,11,320,506,488,994,"6 de julio de 1997"
18,1,11,321,400,412,812,"6 de julio de 1997"
18,1,11,322,406,421,827,"6 de julio de 1997"
18,1,11,323,379,377,756,"6 de julio de 1997"
18,1,11,324,395,368,763,"6 de julio de 1997"
18,1,11,325,220,227,447,"6 de julio de 1997"
18,1,11,326,298,347,645,"6 de julio de 1997"
18,1,11,327,271,271,542,"6 de julio de 1997"
18,1,11,328,319,349,668,"6 de julio de 1997"
18,1,11,329,360,378,738,"6 de julio de 1997"
18,1,11,330,211,210,421,"6 de julio de 1997"
18,1,11,331,253,248,501,"6 de julio de 1997"
18,1,11,332,45,25,70,"6 de julio de 1997"
18,1,11,333,356,309,665,"6 de julio de 1997"
18,1,11,334,120,83,203,"6 de julio de 1997"
18,1,11,335,86,50,136,"6 de julio de 1997"
18,1,11,336,162,122,284,"6 de julio de 1997"
18,1,11,337,339,273,612,"6 de julio de 1997"
18,1,11,338,245,235,480,"6 de julio de 1997"
18,1,11,339,65,48,113,"6 de julio de 1997"
18,1,11,340,129,120,249,"6 de julio de 1997"
18,1,11,341,184,150,334,"6 de julio de 1997"
18,1,11,342,150,120,270,"6 de julio de 1997"
18,1,11,343,347,302,649,"6 de julio de 1997"
18,1,11,344,216,191,407,"6 de julio de 1997"
18,1,11,345,169,132,301,"6 de julio de 1997"
18,1,11,346,216,163,379,"6 de julio de 1997"
18,1,15,435,274,291,565,"6 de julio de 1997"
18,1,15,436,418,456,874,"6 de julio de 1997"
18,1,15,437,515,544,1059,"6 de julio de 1997"
18,1,15,438,289,331,620,"6 de julio de 1997"
18,1,15,439,205,197,402,"6 de julio de 1997"
18,1,15,440,228,263,491,"6 de julio de 1997"
18,1,15,441,347,353,700,"6 de julio de 1997"
18,1,15,442,300,318,618,"6 de julio de 1997"
18,1,15,443,283,319,602,"6 de julio de 1997"
18,1,15,444,184,197,381,"6 de julio de 1997"
18,1,15,445,147,175,322,"6 de julio de 1997"
18,1,15,446,250,289,539,"6 de julio de 1997"
18,1,15,447,389,413,802,"6 de julio de 1997"
18,1,15,448,319,355,674,"6 de julio de 1997"
18,1,15,449,102,133,235,"6 de julio de 1997"
18,1,15,450,262,283,545,"6 de julio de 1997"
18,1,15,451,466,476,942,"6 de julio de 1997"
18,1,15,452,213,193,406,"6 de julio de 1997"
18,1,15,453,134,161,295,"6 de julio de 1997"
18,1,15,454,104,111,215,"6 de julio de 1997"
18,1,15,455,218,263,481,"6 de julio de 1997"
18,1,15,456,139,158,297,"6 de julio de 1997"
18,1,15,457,410,377,787,"6 de julio de 1997"
18,1,15,458,273,221,494,"6 de julio de 1997"
18,1,15,459,479,417,896,"6 de julio de 1997"
18,1,15,460,346,332,678,"6 de julio de 1997"
18,1,15,461,217,192,409,"6 de julio de 1997"
18,1,15,462,88,77,165,"6 de julio de 1997"
18,1,15,463,373,343,716,"6 de julio de 1997"
18,1,15,464,150,99,249,"6 de julio de 1997"
18,1,15,465,289,253,542,"6 de julio de 1997"
18,1,15,466,275,235,510,"6 de julio de 1997"
18,1,15,467,124,134,258,"6 de julio de 1997"
18,1,15,468,193,195,388,"6 de julio de 1997"
18,1,15,469,218,216,434,"6 de julio de 1997"
18,1,15,470,359,334,693,"6 de julio de 1997"
18,1,15,471,173,164,337,"6 de julio de 1997"
18,1,15,472,315,279,594,"6 de julio de 1997"
18,1,15,473,292,282,574,"6 de julio de 1997"
18,1,15,474,326,278,604,"6 de julio de 1997"
18,1,15,475,190,174,364,"6 de julio de 1997"
18,1,15,476,130,143,273,"6 de julio de 1997"
18,1,15,477,159,129,288,"6 de julio de 1997"
18,1,15,478,212,161,373,"6 de julio de 1997"
18,1,15,479,47,38,85,"6 de julio de 1997"
18,1,15,480,240,181,421,"6 de julio de 1997"
18,1,15,481,97,89,186,"6 de julio de 1997"
18,1,15,482,334,344,678,"6 de julio de 1997"
18,1,15,483,473,454,927,"6 de julio de 1997"
18,1,15,484,403,407,810,"6 de julio de 1997"
18,1,15,485,307,330,637,"6 de julio de 1997"
18,1,15,486,155,147,302,"6 de julio de 1997"
18,1,15,487,458,385,843,"6 de julio de 1997"
18,1,15,488,323,300,623,"6 de julio de 1997"
18,1,15,489,305,276,581,"6 de julio de 1997"
18,1,15,490,247,226,473,"6 de julio de 1997"
18,1,15,491,190,175,365,"6 de julio de 1997"
18,1,15,492,152,124,276,"6 de julio de 1997"
18,1,15,493,411,396,807,"6 de julio de 1997"
18,1,15,494,267,237,504,"6 de julio de 1997"
18,1,15,495,314,276,590,"6 de julio de 1997"
18,1,15,496,258,219,477,"6 de julio de 1997"
18,1,15,497,257,243,500,"6 de julio de 1997"
18,1,15,498,276,263,539,"6 de julio de 1997"
18,1,15,499,98,91,189,"6 de julio de 1997"
18,1,15,500,165,129,294,"6 de julio de 1997"
18,1,15,501,227,182,409,"6 de julio de 1997"
18,1,15,502,296,287,583,"6 de julio de 1997"
18,1,15,503,441,412,853,"6 de julio de 1997"
18,1,15,504,329,333,662,"6 de julio de 1997"
18,1,15,505,394,444,838,"6 de julio de 1997"
18,1,15,506,224,220,444,"6 de julio de 1997"
18,1,15,507,292,306,598,"6 de julio de 1997"
18,1,15,508,384,366,750,"6 de julio de 1997"
18,1,15,509,226,196,422,"6 de julio de 1997"
18,1,15,510,188,180,368,"6 de julio de 1997"
18,1,15,511,489,455,944,"6 de julio de 1997"
18,1,15,512,373,341,714,"6 de julio de 1997"
18,1,15,513,292,233,525,"6 de julio de 1997"
18,1,15,514,123,100,223,"6 de julio de 1997"
18,1,15,515,254,219,473,"6 de julio de 1997"
18,1,15,516,282,241,523,"6 de julio de 1997"
18,1,15,517,194,194,388,"6 de julio de 1997"
18,1,15,518,90,79,169,"6 de julio de 1997"
18,1,15,519,156,152,308,"6 de julio de 1997"
18,1,15,520,323,259,582,"6 de julio de 1997"
18,1,15,521,256,241,497,"6 de julio de 1997"
18,1,15,522,383,394,777,"6 de julio de 1997"
18,1,15,523,455,505,960,"6 de julio de 1997"
18,1,15,524,261,286,547,"6 de julio de 1997"
18,1,15,525,205,234,439,"6 de julio de 1997"
18,1,15,526,368,405,773,"6 de julio de 1997"
18,1,15,527,279,300,579,"6 de julio de 1997"
18,1,15,528,466,475,941,"6 de julio de 1997"
18,1,15,529,237,236,473,"6 de julio de 1997"
18,1,15,530,284,269,553,"6 de julio de 1997"
18,1,15,531,397,384,781,"6 de julio de 1997"
18,1,15,532,497,482,979,"6 de julio de 1997"
18,1,15,533,79,58,137,"6 de julio de 1997"
18,1,15,534,146,149,295,"6 de julio de 1997"
18,1,15,535,267,248,515,"6 de julio de 1997"
18,1,15,536,205,202,407,"6 de julio de 1997"
18,1,15,537,267,242,509,"6 de julio de 1997"
18,1,15,538,313,283,596,"6 de julio de 1997"
18,1,15,539,323,281,604,"6 de julio de 1997"
18,1,15,540,324,284,608,"6 de julio de 1997"
18,1,15,541,427,413,840,"6 de julio de 1997"
18,1,15,542,404,372,776,"6 de julio de 1997"
18,1,15,543,481,513,994,"6 de julio de 1997"
18,1,15,544,227,217,444,"6 de julio de 1997"
18,1,15,545,408,382,790,"6 de julio de 1997"
18,1,15,546,313,263,576,"6 de julio de 1997"
18,1,16,547,230,226,456,"6 de julio de 1997"
18,1,16,548,260,273,533,"6 de julio de 1997"
18,1,16,549,285,314,599,"6 de julio de 1997"
18,1,16,550,427,412,839,"6 de julio de 1997"
18,1,16,551,332,358,690,"6 de julio de 1997"
18,1,16,552,331,330,661,"6 de julio de 1997"
18,1,16,553,247,248,495,"6 de julio de 1997"
18,1,16,554,364,355,719,"6 de julio de 1997"
18,1,16,555,243,272,515,"6 de julio de 1997"
18,1,16,556,171,193,364,"6 de julio de 1997"
18,1,16,557,131,156,287,"6 de julio de 1997"
18,1,16,558,207,210,417,"6 de julio de 1997"
18,1,16,559,206,225,431,"6 de julio de 1997"
18,1,16,560,205,253,458,"6 de julio de 1997"
18,1,16,561,200,235,435,"6 de julio de 1997"
18,1,16,562,251,264,515,"6 de julio de 1997"
18,1,16,563,270,295,565,"6 de julio de 1997"
18,1,16,564,328,321,649,"6 de julio de 1997"
18,1,16,565,83,67,150,"6 de julio de 1997"
18,1,16,566,52,42,94,"6 de julio de 1997"
18,1,16,567,388,340,728,"6 de julio de 1997"
18,1,16,568,405,359,764,"6 de julio de 1997"
18,1,16,569,173,143,316,"6 de julio de 1997"
18,1,16,570,506,500,1006,"6 de julio de 1997"
18,1,16,571,376,348,724,"6 de julio de 1997"
18,1,16,572,329,327,656,"6 de julio de 1997"
18,1,16,573,331,343,674,"6 de julio de 1997"
18,1,16,574,319,303,622,"6 de julio de 1997"
18,1,16,575,328,369,697,"6 de julio de 1997"
18,1,16,576,385,373,758,"6 de julio de 1997"
18,1,16,577,246,244,490,"6 de julio de 1997"
18,1,16,578,455,390,845,"6 de julio de 1997"
18,1,16,579,328,301,629,"6 de julio de 1997"
18,1,16,580,384,340,724,"6 de julio de 1997"
18,1,16,581,263,235,498,"6 de julio de 1997"
18,1,16,582,427,393,820,"6 de julio de 1997"
18,1,16,583,396,348,744,"6 de julio de 1997"
18,1,16,584,372,355,727,"6 de julio de 1997"
18,1,16,585,286,242,528,"6 de julio de 1997"
18,1,16,586,260,249,509,"6 de julio de 1997"
18,1,16,587,350,308,658,"6 de julio de 1997"
18,1,16,588,426,400,826,"6 de julio de 1997"
18,1,16,589,157,146,303,"6 de julio de 1997"
18,1,16,590,111,86,197,"6 de julio de 1997"
18,1,16,591,372,341,713,"6 de julio de 1997"
18,1,16,592,123,97,220,"6 de julio de 1997"
18,1,16,593,179,131,310,"6 de julio de 1997"
18,1,16,594,167,118,285,"6 de julio de 1997"
18,1,16,595,176,145,321,"6 de julio de 1997"
18,1,16,596,140,105,245,"6 de julio de 1997"
18,1,18,810,373,404,777,"6 de julio de 1997"
18,1,18,811,318,332,650,"6 de julio de 1997"
18,1,18,812,394,437,831,"6 de julio de 1997"
18,1,18,813,325,365,690,"6 de julio de 1997"
18,1,18,814,321,361,682,"6 de julio de 1997"
18,1,18,815,260,263,523,"6 de julio de 1997"
18,1,18,816,302,317,619,"6 de julio de 1997"
18,1,18,817,179,148,327,"6 de julio de 1997"
18,1,18,818,185,250,435,"6 de julio de 1997"
18,1,18,819,258,285,543,"6 de julio de 1997"
18,1,18,820,179,239,418,"6 de julio de 1997"
18,1,18,821,274,293,567,"6 de julio de 1997"
18,1,18,822,283,298,581,"6 de julio de 1997"
18,1,18,823,333,345,678,"6 de julio de 1997"
18,1,18,824,431,411,842,"6 de julio de 1997"
18,1,18,825,395,385,780,"6 de julio de 1997"
18,1,18,826,198,202,400,"6 de julio de 1997"
18,1,18,827,322,312,634,"6 de julio de 1997"
18,1,18,828,214,208,422,"6 de julio de 1997"
18,1,18,829,162,193,355,"6 de julio de 1997"
18,1,18,830,304,345,649,"6 de julio de 1997"
18,1,18,831,190,205,395,"6 de julio de 1997"
18,1,18,832,265,278,543,"6 de julio de 1997"
18,1,18,833,239,236,475,"6 de julio de 1997"
18,1,18,834,213,217,430,"6 de julio de 1997"
18,1,18,835,280,285,565,"6 de julio de 1997"
18,1,18,836,424,373,797,"6 de julio de 1997"
18,1,18,837,464,460,924,"6 de julio de 1997"
18,1,18,838,458,425,883,"6 de julio de 1997"
18,1,18,839,370,352,722,"6 de julio de 1997"
18,1,18,840,307,322,629,"6 de julio de 1997"
18,1,18,841,278,252,530,"6 de julio de 1997"
18,1,18,842,449,406,855,"6 de julio de 1997"
18,1,18,843,344,349,693,"6 de julio de 1997"
18,2,9,257,209,184,393,"6 de julio de 1997"
18,2,9,258,460,378,838,"6 de julio de 1997"
18,2,9,259,554,351,905,"6 de julio de 1997"
18,2,9,260,288,253,541,"6 de julio de 1997"
18,2,9,261,185,150,335,"6 de julio de 1997"
18,2,9,262,261,158,419,"6 de julio de 1997"
18,2,9,263,50,48,98,"6 de julio de 1997"
18,2,9,264,137,88,225,"6 de julio de 1997"
18,2,9,265,90,63,153,"6 de julio de 1997"
18,2,9,266,143,75,218,"6 de julio de 1997"
18,2,9,267,503,341,844,"6 de julio de 1997"
18,2,9,268,336,241,577,"6 de julio de 1997"
18,2,9,269,218,138,356,"6 de julio de 1997"
18,2,9,270,390,292,682,"6 de julio de 1997"
18,2,9,271,266,228,494,"6 de julio de 1997"
18,2,9,272,82,69,151,"6 de julio de 1997"
18,2,9,273,256,216,472,"6 de julio de 1997"
18,2,9,274,192,127,319,"6 de julio de 1997"
18,2,9,275,110,90,200,"6 de julio de 1997"
18,2,9,276,175,145,320,"6 de julio de 1997"
18,2,17,597,150,193,343,"6 de julio de 1997"
18,2,17,598,904,1022,1926,"6 de julio de 1997"
18,2,17,599,142,176,318,"6 de julio de 1997"
18,2,17,600,343,397,740,"6 de julio de 1997"
18,2,17,601,579,602,1181,"6 de julio de 1997"
18,2,17,602,487,515,1002,"6 de julio de 1997"
18,2,17,603,427,457,884,"6 de julio de 1997"
18,2,17,604,254,268,522,"6 de julio de 1997"
18,2,17,605,329,377,706,"6 de julio de 1997"
18,2,17,606,329,392,721,"6 de julio de 1997"
18,2,17,607,559,599,1158,"6 de julio de 1997"
18,2,17,608,570,577,1147,"6 de julio de 1997"
18,2,17,609,1211,1379,2590,"6 de julio de 1997"
18,2,17,610,663,778,1441,"6 de julio de 1997"
18,2,17,611,1049,1103,2152,"6 de julio de 1997"
18,2,17,612,663,754,1417,"6 de julio de 1997"
18,2,17,613,456,541,997,"6 de julio de 1997"
18,2,17,614,291,342,633,"6 de julio de 1997"
18,2,17,615,412,479,891,"6 de julio de 1997"
18,2,17,616,521,588,1109,"6 de julio de 1997"
18,2,17,617,643,751,1394,"6 de julio de 1997"
18,2,17,618,268,304,572,"6 de julio de 1997"
18,2,17,619,255,284,539,"6 de julio de 1997"
18,2,17,620,401,390,791,"6 de julio de 1997"
18,2,17,621,469,526,995,"6 de julio de 1997"
18,2,17,622,299,372,671,"6 de julio de 1997"
18,2,17,623,458,535,993,"6 de julio de 1997"
18,2,17,624,311,349,660,"6 de julio de 1997"
18,2,17,625,244,297,541,"6 de julio de 1997"
18,2,17,626,591,659,1250,"6 de julio de 1997"
18,2,17,627,513,564,1077,"6 de julio de 1997"
18,2,17,628,404,521,925,"6 de julio de 1997"
18,2,17,629,434,488,922,"6 de julio de 1997"
18,2,17,630,562,596,1158,"6 de julio de 1997"
18,2,17,631,590,672,1262,"6 de julio de 1997"
18,2,17,632,518,563,1081,"6 de julio de 1997"
18,2,17,633,780,868,1648,"6 de julio de 1997"
18,2,17,634,750,938,1688,"6 de julio de 1997"
18,2,17,635,531,600,1131,"6 de julio de 1997"
18,2,17,636,274,356,630,"6 de julio de 1997"
18,2,17,637,368,439,807,"6 de julio de 1997"
18,2,17,638,279,315,594,"6 de julio de 1997"
18,2,17,639,367,454,821,"6 de julio de 1997"
18,2,17,640,437,516,953,"6 de julio de 1997"
18,2,17,641,251,326,577,"6 de julio de 1997"
18,2,17,642,270,340,610,"6 de julio de 1997"
18,2,17,643,408,522,930,"6 de julio de 1997"
18,2,17,644,453,485,938,"6 de julio de 1997"
18,2,17,645,405,486,891,"6 de julio de 1997"
18,2,17,646,492,611,1103,"6 de julio de 1997"
18,2,17,647,251,296,547,"6 de julio de 1997"
18,2,17,648,311,324,635,"6 de julio de 1997"
18,2,17,649,224,304,528,"6 de julio de 1997"
18,2,17,650,276,335,611,"6 de julio de 1997"
18,2,17,651,528,592,1120,"6 de julio de 1997"
18,2,17,652,332,405,737,"6 de julio de 1997"
18,2,17,653,264,329,593,"6 de julio de 1997"
18,2,17,654,268,355,623,"6 de julio de 1997"
18,2,17,655,302,391,693,"6 de julio de 1997"
18,2,17,656,430,463,893,"6 de julio de 1997"
18,2,17,657,330,360,690,"6 de julio de 1997"
18,2,17,658,376,484,860,"6 de julio de 1997"
18,2,17,659,270,299,569,"6 de julio de 1997"
18,2,17,660,320,348,668,"6 de julio de 1997"
18,2,17,661,235,251,486,"6 de julio de 1997"
18,2,17,662,348,420,768,"6 de julio de 1997"
18,2,17,663,404,449,853,"6 de julio de 1997"
18,2,17,664,406,468,874,"6 de julio de 1997"
18,2,17,665,416,496,912,"6 de julio de 1997"
18,2,17,666,401,456,857,"6 de julio de 1997"
18,2,17,667,353,410,763,"6 de julio de 1997"
18,2,17,668,286,321,607,"6 de julio de 1997"
18,2,17,669,309,364,673,"6 de julio de 1997"
18,2,17,670,276,363,639,"6 de julio de 1997"
18,2,17,671,146,210,356,"6 de julio de 1997"
18,2,17,672,74,92,166,"6 de julio de 1997"
18,2,17,673,261,349,610,"6 de julio de 1997"
18,2,17,674,226,279,505,"6 de julio de 1997"
18,2,17,675,216,222,438,"6 de julio de 1997"
18,2,17,676,520,643,1163,"6 de julio de 1997"
18,2,17,677,397,438,835,"6 de julio de 1997"
18,2,17,678,397,441,838,"6 de julio de 1997"
18,2,17,679,531,603,1134,"6 de julio de 1997"
18,2,17,680,350,407,757,"6 de julio de 1997"
18,2,17,681,351,473,824,"6 de julio de 1997"
18,2,17,682,139,203,342,"6 de julio de 1997"
18,2,17,683,119,162,281,"6 de julio de 1997"
18,2,17,684,99,129,228,"6 de julio de 1997"
18,2,17,685,207,278,485,"6 de julio de 1997"
18,2,17,686,147,174,321,"6 de julio de 1997"
18,2,17,687,339,410,749,"6 de julio de 1997"
18,2,17,688,276,345,621,"6 de julio de 1997"
18,2,17,689,229,292,521,"6 de julio de 1997"
18,2,17,690,200,259,459,"6 de julio de 1997"
18,2,17,691,275,350,625,"6 de julio de 1997"
18,2,17,692,318,421,739,"6 de julio de 1997"
18,2,17,693,395,470,865,"6 de julio de 1997"
18,2,17,694,415,463,878,"6 de julio de 1997"
18,2,17,695,734,832,1566,"6 de julio de 1997"
18,2,17,696,445,545,990,"6 de julio de 1997"
18,2,17,697,292,367,659,"6 de julio de 1997"
18,2,17,698,223,268,491,"6 de julio de 1997"
18,2,17,699,222,260,482,"6 de julio de 1997"
18,2,17,700,391,478,869,"6 de julio de 1997"
18,2,17,701,488,583,1071,"6 de julio de 1997"
18,2,17,702,401,525,926,"6 de julio de 1997"
18,2,17,703,327,361,688,"6 de julio de 1997"
18,2,17,704,150,187,337,"6 de julio de 1997"
18,2,17,705,406,415,821,"6 de julio de 1997"
18,2,17,706,345,436,781,"6 de julio de 1997"
18,2,17,707,272,338,610,"6 de julio de 1997"
18,2,17,708,367,448,815,"6 de julio de 1997"
18,2,17,709,611,715,1326,"6 de julio de 1997"
18,2,17,710,434,512,946,"6 de julio de 1997"
18,2,17,711,665,801,1466,"6 de julio de 1997"
18,2,17,712,310,332,642,"6 de julio de 1997"
18,2,17,713,352,399,751,"6 de julio de 1997"
18,2,17,714,284,323,607,"6 de julio de 1997"
18,2,17,715,587,685,1272,"6 de julio de 1997"
18,2,17,716,262,300,562,"6 de julio de 1997"
18,2,17,717,574,95,669,"6 de julio de 1997"
18,2,17,718,266,346,612,"6 de julio de 1997"
18,2,17,719,551,697,1248,"6 de julio de 1997"
18,2,17,720,264,282,546,"6 de julio de 1997"
18,2,17,721,283,338,621,"6 de julio de 1997"
18,2,17,722,338,413,751,"6 de julio de 1997"
18,2,17,723,716,838,1554,"6 de julio de 1997"
18,2,17,724,791,876,1667,"6 de julio de 1997"
18,2,17,725,528,642,1170,"6 de julio de 1997"
18,2,17,726,336,401,737,"6 de julio de 1997"
18,2,17,727,259,326,585,"6 de julio de 1997"
18,2,17,728,344,404,748,"6 de julio de 1997"
18,2,17,729,291,347,638,"6 de julio de 1997"
18,2,17,730,413,493,906,"6 de julio de 1997"
18,2,17,731,307,343,650,"6 de julio de 1997"
18,2,17,732,174,173,347,"6 de julio de 1997"
18,2,17,733,517,645,1162,"6 de julio de 1997"
18,2,17,734,355,412,767,"6 de julio de 1997"
18,2,17,735,365,380,745,"6 de julio de 1997"
18,2,17,736,655,669,1324,"6 de julio de 1997"
18,2,17,737,928,1094,2022,"6 de julio de 1997"
18,2,17,738,626,733,1359,"6 de julio de 1997"
18,2,17,739,663,795,1458,"6 de julio de 1997"
18,2,17,740,406,500,906,"6 de julio de 1997"
18,2,17,741,274,334,608,"6 de julio de 1997"
18,2,17,742,390,473,863,"6 de julio de 1997"
18,2,17,743,290,332,622,"6 de julio de 1997"
18,2,17,744,436,547,983,"6 de julio de 1997"
18,2,17,745,471,572,1043,"6 de julio de 1997"
18,2,17,746,534,632,1166,"6 de julio de 1997"
18,2,17,747,426,506,932,"6 de julio de 1997"
18,2,17,748,439,523,962,"6 de julio de 1997"
18,2,17,749,508,576,1084,"6 de julio de 1997"
18,2,17,750,277,367,644,"6 de julio de 1997"
18,2,17,751,292,359,651,"6 de julio de 1997"
18,2,17,752,491,564,1055,"6 de julio de 1997"
18,2,17,753,373,442,815,"6 de julio de 1997"
18,2,17,754,441,477,918,"6 de julio de 1997"
18,2,17,755,319,381,700,"6 de julio de 1997"
18,2,17,756,417,534,951,"6 de julio de 1997"
18,2,17,757,283,344,627,"6 de julio de 1997"
18,2,17,758,667,696,1363,"6 de julio de 1997"
18,2,17,759,369,407,776,"6 de julio de 1997"
18,2,17,760,237,268,505,"6 de julio de 1997"
18,2,17,761,281,326,607,"6 de julio de 1997"
18,2,17,762,392,467,859,"6 de julio de 1997"
18,2,17,763,447,542,989,"6 de julio de 1997"
18,2,17,764,797,962,1759,"6 de julio de 1997"
18,2,17,765,658,706,1364,"6 de julio de 1997"
18,2,17,766,373,455,828,"6 de julio de 1997"
18,2,17,767,245,296,541,"6 de julio de 1997"
18,2,17,768,70,48,118,"6 de julio de 1997"
18,2,17,769,412,156,568,"6 de julio de 1997"
18,2,17,770,567,544,1111,"6 de julio de 1997"
18,2,17,771,157,117,274,"6 de julio de 1997"
18,2,17,772,195,160,355,"6 de julio de 1997"
18,2,17,773,207,170,377,"6 de julio de 1997"
18,2,17,774,457,413,870,"6 de julio de 1997"
18,2,17,775,132,84,216,"6 de julio de 1997"
18,2,17,776,36,27,63,"6 de julio de 1997"
18,2,17,777,76,44,120,"6 de julio de 1997"
18,2,17,778,168,143,311,"6 de julio de 1997"
18,2,17,779,341,345,686,"6 de julio de 1997"
18,2,17,780,613,530,1143,"6 de julio de 1997"
18,2,17,781,297,265,562,"6 de julio de 1997"
18,2,17,782,375,351,726,"6 de julio de 1997"
18,2,17,783,409,415,824,"6 de julio de 1997"
18,2,17,784,116,102,218,"6 de julio de 1997"
18,2,17,785,432,392,824,"6 de julio de 1997"
18,2,17,786,141,138,279,"6 de julio de 1997"
18,2,17,787,117,115,232,"6 de julio de 1997"
18,2,17,788,371,409,780,"6 de julio de 1997"
18,2,17,789,340,359,699,"6 de julio de 1997"
18,2,17,790,114,96,210,"6 de julio de 1997"
18,2,17,791,62,50,112,"6 de julio de 1997"
18,2,17,792,212,199,411,"6 de julio de 1997"
18,2,17,793,129,114,243,"6 de julio de 1997"
18,2,17,794,126,108,234,"6 de julio de 1997"
18,2,17,795,254,269,523,"6 de julio de 1997"
18,2,17,796,298,263,561,"6 de julio de 1997"
18,2,17,797,251,245,496,"6 de julio de 1997"
18,2,17,798,198,175,373,"6 de julio de 1997"
18,2,17,799,249,244,493,"6 de julio de 1997"
18,2,17,800,161,162,323,"6 de julio de 1997"
18,2,17,801,304,322,626,"6 de julio de 1997"
18,2,17,802,224,192,416,"6 de julio de 1997"
18,2,17,803,318,274,592,"6 de julio de 1997"
18,2,17,804,637,666,1303,"6 de julio de 1997"
18,2,17,805,378,379,757,"6 de julio de 1997"
18,2,17,806,177,156,333,"6 de julio de 1997"
18,2,17,807,686,655,1341,"6 de julio de 1997"
18,2,17,808,205,210,415,"6 de julio de 1997"
18,2,17,809,322,395,717,"6 de julio de 1997"
18,2,20,866,214,190,404,"6 de julio de 1997"
18,2,20,867,301,241,542,"6 de julio de 1997"
18,2,20,868,113,113,226,"6 de julio de 1997"
18,2,20,869,454,427,881,"6 de julio de 1997"
18,2,20,870,402,318,720,"6 de julio de 1997"
18,2,20,871,26,23,49,"6 de julio de 1997"
18,2,20,872,175,119,294,"6 de julio de 1997"
18,2,20,873,196,134,330,"6 de julio de 1997"
18,2,20,874,138,103,241,"6 de julio de 1997"
18,2,20,875,118,106,224,"6 de julio de 1997"
18,2,20,876,51,35,86,"6 de julio de 1997"
18,2,20,877,16,15,31,"6 de julio de 1997"
18,2,20,878,296,228,524,"6 de julio de 1997"
18,3,2,49,211,221,432,"6 de julio de 1997"
18,3,2,50,266,291,557,"6 de julio de 1997"
18,3,2,51,320,341,661,"6 de julio de 1997"
18,3,2,52,348,368,716,"6 de julio de 1997"
18,3,2,53,419,484,903,"6 de julio de 1997"
18,3,2,54,502,586,1088,"6 de julio de 1997"
18,3,2,55,128,118,246,"6 de julio de 1997"
18,3,2,56,370,363,733,"6 de julio de 1997"
18,3,2,57,415,398,813,"6 de julio de 1997"
18,3,2,58,289,261,550,"6 de julio de 1997"
18,3,2,59,530,467,997,"6 de julio de 1997"
18,3,2,60,287,259,546,"6 de julio de 1997"
18,3,2,61,411,383,794,"6 de julio de 1997"
18,3,2,62,119,111,230,"6 de julio de 1997"
18,3,2,63,120,135,255,"6 de julio de 1997"
18,3,2,64,87,77,164,"6 de julio de 1997"
18,3,2,65,274,246,520,"6 de julio de 1997"
18,3,3,66,163,151,314,"6 de julio de 1997"
18,3,3,67,262,233,495,"6 de julio de 1997"
18,3,3,68,295,314,609,"6 de julio de 1997"
18,3,3,69,188,226,414,"6 de julio de 1997"
18,3,3,70,102,98,200,"6 de julio de 1997"
18,3,3,71,79,68,147,"6 de julio de 1997"
18,3,3,72,41,35,76,"6 de julio de 1997"
18,3,3,73,46,38,84,"6 de julio de 1997"
18,3,3,74,232,198,430,"6 de julio de 1997"
18,3,3,75,230,208,438,"6 de julio de 1997"
18,3,3,76,86,66,152,"6 de julio de 1997"
18,3,3,77,218,216,434,"6 de julio de 1997"
18,3,3,78,254,235,489,"6 de julio de 1997"
18,3,3,79,359,389,748,"6 de julio de 1997"
18,3,3,80,223,215,438,"6 de julio de 1997"
18,3,3,81,107,103,210,"6 de julio de 1997"
18,3,3,82,191,184,375,"6 de julio de 1997"
18,3,3,83,219,244,463,"6 de julio de 1997"
18,3,3,84,74,59,133,"6 de julio de 1997"
18,3,3,85,31,33,64,"6 de julio de 1997"
18,3,3,86,106,78,184,"6 de julio de 1997"
18,3,3,87,57,43,100,"6 de julio de 1997"
18,3,3,88,167,117,284,"6 de julio de 1997"
18,3,3,89,180,169,349,"6 de julio de 1997"
18,3,4,90,669,588,1257,"6 de julio de 1997"
18,3,4,91,238,231,469,"6 de julio de 1997"
18,3,4,92,135,136,271,"6 de julio de 1997"
18,3,4,93,103,87,190,"6 de julio de 1997"
18,3,4,94,212,193,405,"6 de julio de 1997"
18,3,4,95,200,175,375,"6 de julio de 1997"
18,3,4,96,286,272,558,"6 de julio de 1997"
18,3,4,97,437,377,814,"6 de julio de 1997"
18,3,4,98,450,403,853,"6 de julio de 1997"
18,3,4,99,211,207,418,"6 de julio de 1997"
18,3,4,100,432,417,849,"6 de julio de 1997"
18,3,4,101,419,391,810,"6 de julio de 1997"
18,3,4,102,335,345,680,"6 de julio de 1997"
18,3,4,103,423,452,875,"6 de julio de 1997"
18,3,4,104,569,585,1154,"6 de julio de 1997"
18,3,4,105,432,404,836,"6 de julio de 1997"
18,3,4,106,387,368,755,"6 de julio de 1997"
18,3,4,107,523,494,1017,"6 de julio de 1997"
18,3,4,108,366,355,721,"6 de julio de 1997"
18,3,4,109,165,140,305,"6 de julio de 1997"
18,3,4,110,339,288,627,"6 de julio de 1997"
18,3,4,111,833,723,1556,"6 de julio de 1997"
18,3,4,112,613,593,1206,"6 de julio de 1997"
18,3,4,113,423,406,829,"6 de julio de 1997"
18,3,4,114,442,422,864,"6 de julio de 1997"
18,3,4,115,546,599,1145,"6 de julio de 1997"
18,3,4,116,537,541,1078,"6 de julio de 1997"
18,3,4,117,382,356,738,"6 de julio de 1997"
18,3,4,118,631,602,1233,"6 de julio de 1997"
18,3,4,119,273,248,521,"6 de julio de 1997"
18,3,4,120,443,391,834,"6 de julio de 1997"
18,3,4,121,384,381,765,"6 de julio de 1997"
18,3,4,122,319,305,624,"6 de julio de 1997"
18,3,4,123,238,197,435,"6 de julio de 1997"
18,3,5,124,249,280,529,"6 de julio de 1997"
18,3,5,125,498,541,1039,"6 de julio de 1997"
18,3,5,126,224,232,456,"6 de julio de 1997"
18,3,5,127,313,381,694,"6 de julio de 1997"
18,3,5,128,350,411,761,"6 de julio de 1997"
18,3,5,129,473,519,992,"6 de julio de 1997"
18,3,5,130,256,278,534,"6 de julio de 1997"
18,3,5,131,276,309,585,"6 de julio de 1997"
18,3,5,132,303,328,631,"6 de julio de 1997"
18,3,5,133,438,391,829,"6 de julio de 1997"
18,3,5,134,373,395,768,"6 de julio de 1997"
18,3,5,135,403,408,811,"6 de julio de 1997"
18,3,5,136,299,344,643,"6 de julio de 1997"
18,3,5,137,315,343,658,"6 de julio de 1997"
18,3,5,138,164,173,337,"6 de julio de 1997"
18,3,5,139,245,228,473,"6 de julio de 1997"
18,3,5,140,263,213,476,"6 de julio de 1997"
18,3,5,141,213,226,439,"6 de julio de 1997"
18,3,5,142,58,67,125,"6 de julio de 1997"
18,3,5,143,164,112,276,"6 de julio de 1997"
18,3,5,144,325,303,628,"6 de julio de 1997"
18,3,5,145,382,348,730,"6 de julio de 1997"
18,3,5,146,125,117,242,"6 de julio de 1997"
18,3,5,147,210,159,369,"6 de julio de 1997"
18,3,5,148,378,381,759,"6 de julio de 1997"
18,3,5,149,300,325,625,"6 de julio de 1997"
18,3,5,150,282,286,568,"6 de julio de 1997"
18,3,5,151,465,430,895,"6 de julio de 1997"
18,3,5,152,287,297,584,"6 de julio de 1997"
18,3,5,153,107,83,190,"6 de julio de 1997"
18,3,5,154,159,153,312,"6 de julio de 1997"
18,3,5,155,189,189,378,"6 de julio de 1997"
18,3,5,156,202,200,402,"6 de julio de 1997"
18,3,5,157,225,209,434,"6 de julio de 1997"
18,3,5,158,267,265,532,"6 de julio de 1997"
18,3,5,159,190,189,379,"6 de julio de 1997"
18,3,5,160,253,290,543,"6 de julio de 1997"
18,3,5,161,368,391,759,"6 de julio de 1997"
18,3,5,162,169,166,335,"6 de julio de 1997"
18,3,5,163,247,248,495,"6 de julio de 1997"
18,3,5,164,272,298,570,"6 de julio de 1997"
18,3,5,165,318,313,631,"6 de julio de 1997"
18,3,5,166,297,284,581,"6 de julio de 1997"
18,3,5,167,329,365,694,"6 de julio de 1997"
18,3,5,168,422,469,891,"6 de julio de 1997"
18,3,5,169,299,307,606,"6 de julio de 1997"
18,3,5,170,67,59,126,"6 de julio de 1997"
18,3,5,171,468,419,887,"6 de julio de 1997"
18,3,5,172,50,42,92,"6 de julio de 1997"
18,3,5,173,439,426,865,"6 de julio de 1997"
18,3,5,174,41,43,84,"6 de julio de 1997"
18,3,5,175,201,204,405,"6 de julio de 1997"
18,3,5,176,242,257,499,"6 de julio de 1997"
18,3,5,177,413,341,754,"6 de julio de 1997"
18,3,5,178,257,195,452,"6 de julio de 1997"
18,3,5,179,129,134,263,"6 de julio de 1997"
18,3,5,180,250,247,497,"6 de julio de 1997"
18,3,5,181,152,137,289,"6 de julio de 1997"
18,3,5,182,94,70,164,"6 de julio de 1997"
18,3,5,183,276,269,545,"6 de julio de 1997"
18,3,5,184,275,281,556,"6 de julio de 1997"
18,3,5,185,261,265,526,"6 de julio de 1997"
18,3,5,186,236,227,463,"6 de julio de 1997"
18,3,5,187,246,273,519,"6 de julio de 1997"
18,3,5,188,293,295,588,"6 de julio de 1997"
18,3,5,189,272,247,519,"6 de julio de 1997"
18,3,5,190,546,524,1070,"6 de julio de 1997"
18,3,5,191,110,84,194,"6 de julio de 1997"
18,3,5,192,347,362,709,"6 de julio de 1997"
18,3,5,193,70,65,135,"6 de julio de 1997"
18,3,5,194,106,88,194,"6 de julio de 1997"
18,3,5,195,117,109,226,"6 de julio de 1997"
18,3,7,215,545,593,1138,"6 de julio de 1997"
18,3,7,216,405,444,849,"6 de julio de 1997"
18,3,7,217,321,388,709,"6 de julio de 1997"
18,3,7,218,522,565,1087,"6 de julio de 1997"
18,3,7,219,316,367,683,"6 de julio de 1997"
18,3,7,220,481,511,992,"6 de julio de 1997"
18,3,7,221,377,413,790,"6 de julio de 1997"
18,3,7,222,388,503,891,"6 de julio de 1997"
18,3,7,223,394,428,822,"6 de julio de 1997"
18,3,7,224,273,297,570,"6 de julio de 1997"
18,3,7,225,303,325,628,"6 de julio de 1997"
18,3,7,226,327,392,719,"6 de julio de 1997"
18,3,7,227,261,315,576,"6 de julio de 1997"
18,3,7,228,247,312,559,"6 de julio de 1997"
18,3,7,229,372,384,756,"6 de julio de 1997"
18,3,7,230,219,228,447,"6 de julio de 1997"
18,3,7,231,349,421,770,"6 de julio de 1997"
18,3,7,232,183,163,346,"6 de julio de 1997"
18,3,7,233,138,136,274,"6 de julio de 1997"
18,3,7,234,120,141,261,"6 de julio de 1997"
18,3,7,235,161,178,339,"6 de julio de 1997"
18,3,7,236,460,491,951,"6 de julio de 1997"
18,3,7,237,82,61,143,"6 de julio de 1997"
18,3,7,238,182,179,361,"6 de julio de 1997"
18,3,8,239,213,217,430,"6 de julio de 1997"
18,3,8,240,251,287,538,"6 de julio de 1997"
18,3,8,241,358,403,761,"6 de julio de 1997"
18,3,8,242,330,361,691,"6 de julio de 1997"
18,3,8,243,272,270,542,"6 de julio de 1997"
18,3,8,244,314,375,689,"6 de julio de 1997"
18,3,8,245,92,87,179,"6 de julio de 1997"
18,3,8,246,117,95,212,"6 de julio de 1997"
18,3,8,247,126,140,266,"6 de julio de 1997"
18,3,8,248,320,331,651,"6 de julio de 1997"
18,3,8,249,241,268,509,"6 de julio de 1997"
18,3,8,250,214,218,432,"6 de julio de 1997"
18,3,8,251,129,134,263,"6 de julio de 1997"
18,3,8,252,410,431,841,"6 de julio de 1997"
18,3,8,253,471,507,978,"6 de julio de 1997"
18,3,8,254,236,267,503,"6 de julio de 1997"
18,3,8,255,193,238,431,"6 de julio de 1997"
18,3,8,256,260,263,523,"6 de julio de 1997"
18,3,12,347,525,569,1094,"6 de julio de 1997"
18,3,12,348,299,312,611,"6 de julio de 1997"
18,3,12,349,308,358,666,"6 de julio de 1997"
18,3,12,350,448,479,927,"6 de julio de 1997"
18,3,12,351,513,400,913,"6 de julio de 1997"
18,3,12,352,324,326,650,"6 de julio de 1997"
18,3,12,353,234,217,451,"6 de julio de 1997"
18,3,12,354,146,138,284,"6 de julio de 1997"
18,3,12,355,147,143,290,"6 de julio de 1997"
18,3,12,356,379,366,745,"6 de julio de 1997"
18,3,12,357,288,324,612,"6 de julio de 1997"
18,3,12,358,214,186,400,"6 de julio de 1997"
18,3,12,359,230,226,456,"6 de julio de 1997"
18,3,12,360,356,352,708,"6 de julio de 1997"
18,3,12,361,309,320,629,"6 de julio de 1997"
18,3,12,362,153,137,290,"6 de julio de 1997"
18,3,12,363,83,64,147,"6 de julio de 1997"
18,3,12,364,59,59,118,"6 de julio de 1997"
18,3,12,365,203,144,347,"6 de julio de 1997"
18,3,12,366,284,256,540,"6 de julio de 1997"
18,3,12,367,506,455,961,"6 de julio de 1997"
18,3,12,368,169,159,328,"6 de julio de 1997"
18,3,12,369,307,303,610,"6 de julio de 1997"
18,3,12,370,203,168,371,"6 de julio de 1997"
18,3,12,371,37,29,66,"6 de julio de 1997"
18,3,12,372,74,54,128,"6 de julio de 1997"
18,3,12,373,171,151,322,"6 de julio de 1997"
18,3,12,374,96,89,185,"6 de julio de 1997"
18,3,12,375,68,54,122,"6 de julio de 1997"
18,3,12,376,478,382,860,"6 de julio de 1997"
18,3,12,377,50,43,93,"6 de julio de 1997"
18,3,12,378,80,48,128,"6 de julio de 1997"
18,3,12,379,37,16,53,"6 de julio de 1997"
18,3,12,380,78,62,140,"6 de julio de 1997"
18,3,12,381,87,63,150,"6 de julio de 1997"
18,3,12,382,446,421,867,"6 de julio de 1997"
18,3,12,383,332,293,625,"6 de julio de 1997"
18,3,12,384,207,194,401,"6 de julio de 1997"
18,3,12,385,358,302,660,"6 de julio de 1997"
18,3,12,386,394,466,860,"6 de julio de 1997"
18,3,12,387,425,397,822,"6 de julio de 1997"
18,3,12,388,245,238,483,"6 de julio de 1997"
18,3,12,389,268,256,524,"6 de julio de 1997"
18,3,12,390,394,370,764,"6 de julio de 1997"
18,3,12,391,121,96,217,"6 de julio de 1997"
18,3,12,392,288,307,595,"6 de julio de 1997"
18,3,12,393,150,147,297,"6 de julio de 1997"
18,3,12,394,158,115,273,"6 de julio de 1997"
18,3,12,395,362,296,658,"6 de julio de 1997"
18,3,12,396,99,87,186,"6 de julio de 1997"
18,3,12,397,58,38,96,"6 de julio de 1997"
18,3,13,398,362,337,699,"6 de julio de 1997"
18,3,13,399,343,378,721,"6 de julio de 1997"
18,3,13,400,266,291,557,"6 de julio de 1997"
18,3,13,401,284,304,588,"6 de julio de 1997"
18,3,13,402,76,71,147,"6 de julio de 1997"
18,3,13,403,96,90,186,"6 de julio de 1997"
18,3,13,404,178,165,343,"6 de julio de 1997"
18,3,13,405,45,34,79,"6 de julio de 1997"
18,3,13,406,217,188,405,"6 de julio de 1997"
18,3,13,407,109,115,224,"6 de julio de 1997"
18,3,13,408,216,206,422,"6 de julio de 1997"
18,3,13,409,149,167,316,"6 de julio de 1997"
18,3,13,410,323,319,642,"6 de julio de 1997"
18,3,14,411,490,483,973,"6 de julio de 1997"
18,3,14,412,581,660,1241,"6 de julio de 1997"
18,3,14,413,90,73,163,"6 de julio de 1997"
18,3,14,414,323,290,613,"6 de julio de 1997"
18,3,14,415,275,250,525,"6 de julio de 1997"
18,3,14,416,524,512,1036,"6 de julio de 1997"
18,3,14,417,100,81,181,"6 de julio de 1997"
18,3,14,418,133,117,250,"6 de julio de 1997"
18,3,14,419,182,174,356,"6 de julio de 1997"
18,3,14,420,135,139,274,"6 de julio de 1997"
18,3,14,421,561,529,1090,"6 de julio de 1997"
18,3,14,422,278,216,494,"6 de julio de 1997"
18,3,14,423,264,250,514,"6 de julio de 1997"
18,3,14,424,182,158,340,"6 de julio de 1997"
18,3,14,425,207,209,416,"6 de julio de 1997"
18,3,14,426,85,66,151,"6 de julio de 1997"
18,3,14,427,310,272,582,"6 de julio de 1997"
18,3,14,428,71,50,121,"6 de julio de 1997"
18,3,14,429,304,313,617,"6 de julio de 1997"
18,3,14,430,254,254,508,"6 de julio de 1997"
18,3,14,431,218,227,445,"6 de julio de 1997"
18,3,14,432,78,75,153,"6 de julio de 1997"
18,3,14,433,454,468,922,"6 de julio de 1997"
18,3,14,434,57,39,96,"6 de julio de 1997"
18,3,19,844,507,598,1105,"6 de julio de 1997"
18,3,19,845,648,806,1454,"6 de julio de 1997"
18,3,19,846,657,739,1396,"6 de julio de 1997"
18,3,19,847,871,1020,1891,"6 de julio de 1997"
18,3,19,848,558,624,1182,"6 de julio de 1997"
18,3,19,849,325,350,675,"6 de julio de 1997"
18,3,19,850,236,254,490,"6 de julio de 1997"
18,3,19,851,226,292,518,"6 de julio de 1997"
18,3,19,852,380,444,824,"6 de julio de 1997"
18,3,19,853,291,328,619,"6 de julio de 1997"
18,3,19,854,425,492,917,"6 de julio de 1997"
18,3,19,855,273,310,583,"6 de julio de 1997"
18,3,19,856,305,258,563,"6 de julio de 1997"
18,3,19,857,471,489,960,"6 de julio de 1997"
18,3,19,858,384,413,797,"6 de julio de 1997"
18,3,19,859,561,559,1120,"6 de julio de 1997"
18,3,19,860,182,158,340,"6 de julio de 1997"
18,3,19,861,287,331,618,"6 de julio de 1997"
18,3,19,862,411,320,731,"6 de julio de 1997"
18,3,19,863,164,129,293,"6 de julio de 1997"
18,3,19,864,530,524,1054,"6 de julio de 1997"
18,3,19,865,415,393,808,"6 de julio de 1997"
19,1,5,39,381,404,785,"6 de julio de 1997"
19,1,5,40,490,554,1044,"6 de julio de 1997"
19,1,5,41,440,480,920,"6 de julio de 1997"
19,1,5,42,298,309,607,"6 de julio de 1997"
19,1,5,43,459,481,940,"6 de julio de 1997"
19,1,5,44,518,526,1044,"6 de julio de 1997"
19,1,5,45,381,401,782,"6 de julio de 1997"
19,1,5,46,367,434,801,"6 de julio de 1997"
19,1,5,47,368,370,738,"6 de julio de 1997"
19,1,5,48,439,468,907,"6 de julio de 1997"
19,1,5,49,239,263,502,"6 de julio de 1997"
19,1,5,50,12,4,16,"6 de julio de 1997"
19,1,5,51,47,36,83,"6 de julio de 1997"
19,1,5,52,69,56,125,"6 de julio de 1997"
19,1,5,53,5,0,5,"6 de julio de 1997"
19,1,5,54,73,23,96,"6 de julio de 1997"
19,1,5,55,129,96,225,"6 de julio de 1997"
19,1,5,56,50,46,96,"6 de julio de 1997"
19,1,5,57,84,48,132,"6 de julio de 1997"
19,1,5,58,54,46,100,"6 de julio de 1997"
19,1,5,59,55,41,96,"6 de julio de 1997"
19,1,5,60,47,45,92,"6 de julio de 1997"
19,1,5,61,237,178,415,"6 de julio de 1997"
19,1,5,62,99,77,176,"6 de julio de 1997"
19,1,8,168,262,251,513,"6 de julio de 1997"
19,1,8,169,309,310,619,"6 de julio de 1997"
19,1,8,170,239,266,505,"6 de julio de 1997"
19,1,8,171,267,254,521,"6 de julio de 1997"
19,1,18,346,609,560,1169,"6 de julio de 1997"
19,1,18,347,1530,1690,3220,"6 de julio de 1997"
19,1,18,348,601,538,1139,"6 de julio de 1997"
19,1,18,349,692,641,1333,"6 de julio de 1997"
19,1,18,350,823,743,1566,"6 de julio de 1997"
19,1,18,351,645,584,1229,"6 de julio de 1997"
19,1,18,352,90,62,152,"6 de julio de 1997"
19,1,18,353,306,144,450,"6 de julio de 1997"
19,1,18,354,120,91,211,"6 de julio de 1997"
19,1,18,355,434,361,795,"6 de julio de 1997"
19,1,19,356,543,541,1084,"6 de julio de 1997"
19,1,19,357,639,651,1290,"6 de julio de 1997"
19,1,19,358,526,488,1014,"6 de julio de 1997"
19,1,19,359,787,856,1643,"6 de julio de 1997"
19,1,19,360,753,776,1529,"6 de julio de 1997"
19,1,19,361,623,662,1285,"6 de julio de 1997"
19,1,19,362,560,597,1157,"6 de julio de 1997"
19,1,19,363,601,618,1219,"6 de julio de 1997"
19,1,19,364,574,636,1210,"6 de julio de 1997"
19,1,19,365,635,646,1281,"6 de julio de 1997"
19,1,19,366,879,863,1742,"6 de julio de 1997"
19,1,19,367,697,763,1460,"6 de julio de 1997"
19,1,19,368,533,588,1121,"6 de julio de 1997"
19,1,19,369,344,343,687,"6 de julio de 1997"
19,1,19,370,561,443,1004,"6 de julio de 1997"
19,1,19,371,708,750,1458,"6 de julio de 1997"
19,1,19,372,489,563,1052,"6 de julio de 1997"
19,1,19,373,690,773,1463,"6 de julio de 1997"
19,1,19,374,847,911,1758,"6 de julio de 1997"
19,1,19,375,664,736,1400,"6 de julio de 1997"
19,1,19,376,483,498,981,"6 de julio de 1997"
19,1,19,377,608,616,1224,"6 de julio de 1997"
19,1,19,378,660,739,1399,"6 de julio de 1997"
19,1,19,379,463,477,940,"6 de julio de 1997"
19,1,19,380,785,849,1634,"6 de julio de 1997"
19,1,19,381,395,361,756,"6 de julio de 1997"
19,1,19,382,573,674,1247,"6 de julio de 1997"
19,1,19,383,500,526,1026,"6 de julio de 1997"
19,1,19,384,573,663,1236,"6 de julio de 1997"
19,1,19,385,659,769,1428,"6 de julio de 1997"
19,1,19,386,592,647,1239,"6 de julio de 1997"
19,1,19,387,556,710,1266,"6 de julio de 1997"
19,1,19,388,750,792,1542,"6 de julio de 1997"
19,1,19,389,875,972,1847,"6 de julio de 1997"
19,1,19,390,760,872,1632,"6 de julio de 1997"
19,1,19,391,600,681,1281,"6 de julio de 1997"
19,1,19,392,634,752,1386,"6 de julio de 1997"
19,1,19,393,573,638,1211,"6 de julio de 1997"
19,1,19,394,467,560,1027,"6 de julio de 1997"
19,1,19,395,399,447,846,"6 de julio de 1997"
19,1,19,396,484,564,1048,"6 de julio de 1997"
19,1,19,397,652,813,1465,"6 de julio de 1997"
19,1,19,398,547,635,1182,"6 de julio de 1997"
19,1,19,399,512,616,1128,"6 de julio de 1997"
19,1,19,400,499,578,1077,"6 de julio de 1997"
19,1,19,401,648,685,1333,"6 de julio de 1997"
19,1,19,402,763,851,1614,"6 de julio de 1997"
19,1,19,403,666,674,1340,"6 de julio de 1997"
19,1,19,404,623,745,1368,"6 de julio de 1997"
19,1,19,405,483,597,1080,"6 de julio de 1997"
19,1,19,406,635,693,1328,"6 de julio de 1997"
19,1,19,407,552,613,1165,"6 de julio de 1997"
19,1,19,408,526,647,1173,"6 de julio de 1997"
19,1,19,409,672,857,1529,"6 de julio de 1997"
19,1,19,410,618,707,1325,"6 de julio de 1997"
19,1,19,411,756,812,1568,"6 de julio de 1997"
19,1,19,412,562,677,1239,"6 de julio de 1997"
19,1,19,413,772,804,1576,"6 de julio de 1997"
19,1,19,414,547,538,1085,"6 de julio de 1997"
19,1,19,415,460,470,930,"6 de julio de 1997"
19,1,19,416,601,665,1266,"6 de julio de 1997"
19,1,19,417,292,336,628,"6 de julio de 1997"
19,1,33,854,240,251,491,"6 de julio de 1997"
19,1,33,855,332,402,734,"6 de julio de 1997"
19,1,33,856,381,396,777,"6 de julio de 1997"
19,1,33,857,350,354,704,"6 de julio de 1997"
19,1,33,858,120,112,232,"6 de julio de 1997"
19,1,33,859,36,28,64,"6 de julio de 1997"
19,1,38,924,642,604,1246,"6 de julio de 1997"
19,1,38,925,378,349,727,"6 de julio de 1997"
19,1,38,926,36,5,41,"6 de julio de 1997"
19,1,38,927,97,68,165,"6 de julio de 1997"
19,1,38,928,118,74,192,"6 de julio de 1997"
19,1,38,929,27,20,47,"6 de julio de 1997"
19,1,38,930,78,61,139,"6 de julio de 1997"
19,1,48,1999,584,588,1172,"6 de julio de 1997"
19,1,48,2000,494,526,1020,"6 de julio de 1997"
19,1,48,2001,584,651,1235,"6 de julio de 1997"
19,1,48,2002,609,615,1224,"6 de julio de 1997"
19,1,48,2003,705,738,1443,"6 de julio de 1997"
19,1,48,2004,637,706,1343,"6 de julio de 1997"
19,1,48,2005,466,532,998,"6 de julio de 1997"
19,1,48,2006,708,743,1451,"6 de julio de 1997"
19,1,48,2007,1007,985,1992,"6 de julio de 1997"
19,1,48,2008,673,679,1352,"6 de julio de 1997"
19,1,48,2009,667,722,1389,"6 de julio de 1997"
19,1,48,2010,541,563,1104,"6 de julio de 1997"
19,1,48,2011,388,455,843,"6 de julio de 1997"
19,1,48,2012,393,434,827,"6 de julio de 1997"
19,1,48,2013,510,567,1077,"6 de julio de 1997"
19,1,48,2014,734,744,1478,"6 de julio de 1997"
19,1,48,2015,686,698,1384,"6 de julio de 1997"
19,1,48,2016,610,674,1284,"6 de julio de 1997"
19,1,48,2017,220,228,448,"6 de julio de 1997"
19,1,48,2018,911,878,1789,"6 de julio de 1997"
19,1,48,2019,991,1034,2025,"6 de julio de 1997"
19,1,48,2020,479,485,964,"6 de julio de 1997"
19,1,48,2021,591,684,1275,"6 de julio de 1997"
19,1,48,2022,434,476,910,"6 de julio de 1997"
19,1,48,2023,479,542,1021,"6 de julio de 1997"
19,1,48,2024,347,392,739,"6 de julio de 1997"
19,1,48,2025,417,478,895,"6 de julio de 1997"
19,1,48,2026,469,503,972,"6 de julio de 1997"
19,1,48,2027,699,693,1392,"6 de julio de 1997"
19,1,48,2028,582,622,1204,"6 de julio de 1997"
19,1,48,2029,861,869,1730,"6 de julio de 1997"
19,1,48,2030,904,911,1815,"6 de julio de 1997"
19,1,48,2031,695,745,1440,"6 de julio de 1997"
19,1,48,2032,644,646,1290,"6 de julio de 1997"
19,1,48,2033,622,641,1263,"6 de julio de 1997"
19,1,48,2034,528,531,1059,"6 de julio de 1997"
19,1,48,2035,513,513,1026,"6 de julio de 1997"
19,1,48,2036,483,510,993,"6 de julio de 1997"
19,1,48,2037,451,500,951,"6 de julio de 1997"
19,1,48,2038,738,679,1417,"6 de julio de 1997"
19,1,48,2039,975,1056,2031,"6 de julio de 1997"
19,1,48,2040,435,386,821,"6 de julio de 1997"
19,1,48,2041,1127,1168,2295,"6 de julio de 1997"
19,1,48,2042,493,523,1016,"6 de julio de 1997"
19,1,48,2043,576,558,1134,"6 de julio de 1997"
19,1,48,2044,663,660,1323,"6 de julio de 1997"
19,1,48,2045,924,927,1851,"6 de julio de 1997"
19,1,48,2046,680,711,1391,"6 de julio de 1997"
19,1,48,2047,1911,1933,3844,"6 de julio de 1997"
19,1,48,2048,625,689,1314,"6 de julio de 1997"
19,1,48,2049,704,734,1438,"6 de julio de 1997"
19,1,48,2050,784,780,1564,"6 de julio de 1997"
19,1,48,2051,1010,989,1999,"6 de julio de 1997"
19,1,48,2052,882,864,1746,"6 de julio de 1997"
19,1,48,2053,939,947,1886,"6 de julio de 1997"
19,1,48,2054,821,845,1666,"6 de julio de 1997"
19,1,48,2055,598,659,1257,"6 de julio de 1997"
19,1,48,2056,741,803,1544,"6 de julio de 1997"
19,1,48,2057,150,172,322,"6 de julio de 1997"
19,1,48,2058,900,919,1819,"6 de julio de 1997"
19,1,48,2059,563,596,1159,"6 de julio de 1997"
19,1,48,2060,652,648,1300,"6 de julio de 1997"
19,1,48,2061,619,631,1250,"6 de julio de 1997"
19,1,48,2062,354,354,708,"6 de julio de 1997"
19,1,48,2063,757,787,1544,"6 de julio de 1997"
19,1,48,2064,852,854,1706,"6 de julio de 1997"
19,1,48,2065,718,757,1475,"6 de julio de 1997"
19,1,48,2066,654,656,1310,"6 de julio de 1997"
19,1,48,2067,643,670,1313,"6 de julio de 1997"
19,1,48,2068,877,866,1743,"6 de julio de 1997"
19,1,48,2069,909,860,1769,"6 de julio de 1997"
19,1,48,2070,693,693,1386,"6 de julio de 1997"
19,1,48,2071,836,838,1674,"6 de julio de 1997"
19,1,48,2072,719,708,1427,"6 de julio de 1997"
19,1,48,2073,802,857,1659,"6 de julio de 1997"
19,1,48,2074,636,654,1290,"6 de julio de 1997"
19,1,48,2075,691,740,1431,"6 de julio de 1997"
19,1,48,2076,897,872,1769,"6 de julio de 1997"
19,1,48,2077,832,802,1634,"6 de julio de 1997"
19,1,48,2078,683,716,1399,"6 de julio de 1997"
19,1,48,2079,771,709,1480,"6 de julio de 1997"
19,1,48,2080,589,572,1161,"6 de julio de 1997"
19,1,48,2081,635,645,1280,"6 de julio de 1997"
19,1,48,2082,452,472,924,"6 de julio de 1997"
19,1,48,2083,521,534,1055,"6 de julio de 1997"
19,1,48,2084,101,72,173,"6 de julio de 1997"
19,1,48,2085,118,62,180,"6 de julio de 1997"
19,2,1,1,162,166,328,"6 de julio de 1997"
19,2,1,2,438,435,873,"6 de julio de 1997"
19,2,2,3,278,275,553,"6 de julio de 1997"
19,2,2,4,153,143,296,"6 de julio de 1997"
19,2,2,5,187,199,386,"6 de julio de 1997"
19,2,2,6,222,211,433,"6 de julio de 1997"
19,2,2,7,115,120,235,"6 de julio de 1997"
19,2,2,8,171,157,328,"6 de julio de 1997"
19,2,2,9,151,140,291,"6 de julio de 1997"
19,2,2,10,141,136,277,"6 de julio de 1997"
19,2,2,11,123,98,221,"6 de julio de 1997"
19,2,3,12,164,186,350,"6 de julio de 1997"
19,2,3,13,228,203,431,"6 de julio de 1997"
19,2,3,14,39,25,64,"6 de julio de 1997"
19,2,3,15,149,129,278,"6 de julio de 1997"
19,2,3,16,194,163,357,"6 de julio de 1997"
19,2,3,17,163,157,320,"6 de julio de 1997"
19,2,3,18,35,19,54,"6 de julio de 1997"
19,2,3,19,77,41,118,"6 de julio de 1997"
19,2,6,63,2242,911,3153,"6 de julio de 1997"
19,2,6,64,574,607,1181,"6 de julio de 1997"
19,2,6,65,1625,1790,3415,"6 de julio de 1997"
19,2,6,66,808,785,1593,"6 de julio de 1997"
19,2,6,67,1179,1247,2426,"6 de julio de 1997"
19,2,6,68,930,941,1871,"6 de julio de 1997"
19,2,6,69,804,849,1653,"6 de julio de 1997"
19,2,6,70,624,686,1310,"6 de julio de 1997"
19,2,6,71,247,277,524,"6 de julio de 1997"
19,2,6,72,202,246,448,"6 de julio de 1997"
19,2,6,73,279,305,584,"6 de julio de 1997"
19,2,6,74,333,358,691,"6 de julio de 1997"
19,2,6,75,291,302,593,"6 de julio de 1997"
19,2,6,76,415,437,852,"6 de julio de 1997"
19,2,6,77,1029,1076,2105,"6 de julio de 1997"
19,2,6,78,565,557,1122,"6 de julio de 1997"
19,2,6,79,607,614,1221,"6 de julio de 1997"
19,2,6,80,309,327,636,"6 de julio de 1997"
19,2,6,81,517,585,1102,"6 de julio de 1997"
19,2,6,82,328,338,666,"6 de julio de 1997"
19,2,6,83,215,241,456,"6 de julio de 1997"
19,2,6,84,1429,1494,2923,"6 de julio de 1997"
19,2,6,85,641,614,1255,"6 de julio de 1997"
19,2,6,86,523,607,1130,"6 de julio de 1997"
19,2,6,87,414,458,872,"6 de julio de 1997"
19,2,6,88,552,556,1108,"6 de julio de 1997"
19,2,6,89,639,663,1302,"6 de julio de 1997"
19,2,6,90,509,541,1050,"6 de julio de 1997"
19,2,6,91,484,504,988,"6 de julio de 1997"
19,2,6,92,612,671,1283,"6 de julio de 1997"
19,2,6,93,532,564,1096,"6 de julio de 1997"
19,2,6,94,743,773,1516,"6 de julio de 1997"
19,2,6,95,619,682,1301,"6 de julio de 1997"
19,2,6,96,909,909,1818,"6 de julio de 1997"
19,2,6,97,608,603,1211,"6 de julio de 1997"
19,2,6,98,814,812,1626,"6 de julio de 1997"
19,2,6,99,545,603,1148,"6 de julio de 1997"
19,2,6,100,690,725,1415,"6 de julio de 1997"
19,2,6,101,857,882,1739,"6 de julio de 1997"
19,2,6,102,821,804,1625,"6 de julio de 1997"
19,2,6,103,817,790,1607,"6 de julio de 1997"
19,2,6,104,220,216,436,"6 de julio de 1997"
19,2,6,105,422,433,855,"6 de julio de 1997"
19,2,6,106,524,530,1054,"6 de julio de 1997"
19,2,6,107,690,715,1405,"6 de julio de 1997"
19,2,6,108,362,360,722,"6 de julio de 1997"
19,2,6,109,875,924,1799,"6 de julio de 1997"
19,2,6,110,279,265,544,"6 de julio de 1997"
19,2,6,111,521,541,1062,"6 de julio de 1997"
19,2,6,112,622,651,1273,"6 de julio de 1997"
19,2,6,113,412,397,809,"6 de julio de 1997"
19,2,6,114,371,384,755,"6 de julio de 1997"
19,2,6,115,765,815,1580,"6 de julio de 1997"
19,2,6,116,610,615,1225,"6 de julio de 1997"
19,2,6,117,580,604,1184,"6 de julio de 1997"
19,2,6,118,487,527,1014,"6 de julio de 1997"
19,2,6,119,510,527,1037,"6 de julio de 1997"
19,2,6,120,666,707,1373,"6 de julio de 1997"
19,2,6,121,689,720,1409,"6 de julio de 1997"
19,2,6,122,560,547,1107,"6 de julio de 1997"
19,2,6,123,482,499,981,"6 de julio de 1997"
19,2,6,124,511,503,1014,"6 de julio de 1997"
19,2,6,125,577,605,1182,"6 de julio de 1997"
19,2,6,126,319,360,679,"6 de julio de 1997"
19,2,6,127,362,358,720,"6 de julio de 1997"
19,2,6,128,358,365,723,"6 de julio de 1997"
19,2,6,129,612,646,1258,"6 de julio de 1997"
19,2,6,130,948,1006,1954,"6 de julio de 1997"
19,2,6,131,942,982,1924,"6 de julio de 1997"
19,2,6,132,198,215,413,"6 de julio de 1997"
19,2,6,133,420,425,845,"6 de julio de 1997"
19,2,6,134,346,375,721,"6 de julio de 1997"
19,2,6,135,589,652,1241,"6 de julio de 1997"
19,2,6,136,644,682,1326,"6 de julio de 1997"
19,2,6,137,647,653,1300,"6 de julio de 1997"
19,2,6,138,637,673,1310,"6 de julio de 1997"
19,2,6,139,596,635,1231,"6 de julio de 1997"
19,2,6,140,392,394,786,"6 de julio de 1997"
19,2,6,141,605,590,1195,"6 de julio de 1997"
19,2,6,142,481,484,965,"6 de julio de 1997"
19,2,6,143,711,705,1416,"6 de julio de 1997"
19,2,6,144,915,854,1769,"6 de julio de 1997"
19,2,6,145,731,732,1463,"6 de julio de 1997"
19,2,6,146,697,710,1407,"6 de julio de 1997"
19,2,6,147,583,597,1180,"6 de julio de 1997"
19,2,6,148,622,624,1246,"6 de julio de 1997"
19,2,6,149,528,502,1030,"6 de julio de 1997"
19,2,6,150,264,261,525,"6 de julio de 1997"
19,2,9,172,486,505,991,"6 de julio de 1997"
19,2,9,173,599,576,1175,"6 de julio de 1997"
19,2,9,174,964,962,1926,"6 de julio de 1997"
19,2,9,175,666,647,1313,"6 de julio de 1997"
19,2,9,176,617,550,1167,"6 de julio de 1997"
19,2,9,177,636,618,1254,"6 de julio de 1997"
19,2,9,178,508,491,999,"6 de julio de 1997"
19,2,9,179,625,639,1264,"6 de julio de 1997"
19,2,9,180,562,572,1134,"6 de julio de 1997"
19,2,9,181,601,655,1256,"6 de julio de 1997"
19,2,9,182,545,528,1073,"6 de julio de 1997"
19,2,9,183,734,780,1514,"6 de julio de 1997"
19,2,9,184,569,603,1172,"6 de julio de 1997"
19,2,9,185,497,522,1019,"6 de julio de 1997"
19,2,9,186,544,490,1034,"6 de julio de 1997"
19,2,9,187,585,636,1221,"6 de julio de 1997"
19,2,9,188,534,514,1048,"6 de julio de 1997"
19,2,9,189,743,712,1455,"6 de julio de 1997"
19,2,9,190,655,699,1354,"6 de julio de 1997"
19,2,9,191,867,847,1714,"6 de julio de 1997"
19,2,9,192,274,241,515,"6 de julio de 1997"
19,2,9,193,332,347,679,"6 de julio de 1997"
19,2,9,194,362,335,697,"6 de julio de 1997"
19,2,9,195,87,64,151,"6 de julio de 1997"
19,2,9,196,115,88,203,"6 de julio de 1997"
19,2,9,197,283,250,533,"6 de julio de 1997"
19,2,9,198,245,272,517,"6 de julio de 1997"
19,2,9,199,306,305,611,"6 de julio de 1997"
19,2,9,200,396,366,762,"6 de julio de 1997"
19,2,9,201,423,397,820,"6 de julio de 1997"
19,2,9,202,107,100,207,"6 de julio de 1997"
19,2,9,203,245,220,465,"6 de julio de 1997"
19,2,9,204,210,182,392,"6 de julio de 1997"
19,2,9,205,331,333,664,"6 de julio de 1997"
19,2,9,206,177,151,328,"6 de julio de 1997"
19,2,9,207,115,69,184,"6 de julio de 1997"
19,2,9,208,57,37,94,"6 de julio de 1997"
19,2,9,209,152,125,277,"6 de julio de 1997"
19,2,9,210,379,317,696,"6 de julio de 1997"
19,2,9,211,181,166,347,"6 de julio de 1997"
19,2,9,212,318,323,641,"6 de julio de 1997"
19,2,9,213,242,208,450,"6 de julio de 1997"
19,2,9,214,189,191,380,"6 de julio de 1997"
19,2,9,215,83,69,152,"6 de julio de 1997"
19,2,9,216,157,169,326,"6 de julio de 1997"
19,2,9,217,433,439,872,"6 de julio de 1997"
19,2,10,218,531,528,1059,"6 de julio de 1997"
19,2,10,219,679,719,1398,"6 de julio de 1997"
19,2,10,220,513,500,1013,"6 de julio de 1997"
19,2,11,221,327,370,697,"6 de julio de 1997"
19,2,11,222,318,338,656,"6 de julio de 1997"
19,2,11,223,401,425,826,"6 de julio de 1997"
19,2,11,224,321,398,719,"6 de julio de 1997"
19,2,11,225,380,394,774,"6 de julio de 1997"
19,2,11,226,313,356,669,"6 de julio de 1997"
19,2,11,227,47,31,78,"6 de julio de 1997"
19,2,11,228,86,70,156,"6 de julio de 1997"
19,2,11,229,27,15,42,"6 de julio de 1997"
19,2,11,230,72,65,137,"6 de julio de 1997"
19,2,11,231,67,56,123,"6 de julio de 1997"
19,2,12,232,883,878,1761,"6 de julio de 1997"
19,2,12,233,651,692,1343,"6 de julio de 1997"
19,2,12,234,432,462,894,"6 de julio de 1997"
19,2,12,235,419,398,817,"6 de julio de 1997"
19,2,12,236,56,43,99,"6 de julio de 1997"
19,2,13,237,206,182,388,"6 de julio de 1997"
19,2,13,238,389,359,748,"6 de julio de 1997"
19,2,13,239,282,296,578,"6 de julio de 1997"
19,2,13,240,327,344,671,"6 de julio de 1997"
19,2,13,241,399,440,839,"6 de julio de 1997"
19,2,13,242,384,369,753,"6 de julio de 1997"
19,2,13,243,315,298,613,"6 de julio de 1997"
19,2,13,244,302,265,567,"6 de julio de 1997"
19,2,13,245,253,279,532,"6 de julio de 1997"
19,2,13,246,15,17,32,"6 de julio de 1997"
19,2,13,247,70,50,120,"6 de julio de 1997"
19,2,13,248,36,28,64,"6 de julio de 1997"
19,2,13,249,25,26,51,"6 de julio de 1997"
19,2,13,250,7,2,9,"6 de julio de 1997"
19,2,13,251,19,6,25,"6 de julio de 1997"
19,2,13,252,84,63,147,"6 de julio de 1997"
19,2,13,253,164,115,279,"6 de julio de 1997"
19,2,13,254,10,5,15,"6 de julio de 1997"
19,2,13,255,14,5,19,"6 de julio de 1997"
19,2,13,256,390,328,718,"6 de julio de 1997"
19,2,15,294,85,82,167,"6 de julio de 1997"
19,2,15,295,369,328,697,"6 de julio de 1997"
19,2,15,296,118,106,224,"6 de julio de 1997"
19,2,15,297,61,50,111,"6 de julio de 1997"
19,2,15,298,24,23,47,"6 de julio de 1997"
19,2,15,299,68,55,123,"6 de julio de 1997"
19,2,15,300,32,32,64,"6 de julio de 1997"
19,2,15,301,31,28,59,"6 de julio de 1997"
19,2,15,302,25,27,52,"6 de julio de 1997"
19,2,15,303,108,96,204,"6 de julio de 1997"
19,2,15,304,127,118,245,"6 de julio de 1997"
19,2,16,305,296,279,575,"6 de julio de 1997"
19,2,16,306,271,286,557,"6 de julio de 1997"
19,2,16,307,207,192,399,"6 de julio de 1997"
19,2,16,308,79,60,139,"6 de julio de 1997"
19,2,20,418,302,281,583,"6 de julio de 1997"
19,2,20,419,151,164,315,"6 de julio de 1997"
19,2,20,420,271,254,525,"6 de julio de 1997"
19,2,20,421,285,283,568,"6 de julio de 1997"
19,2,20,422,364,350,714,"6 de julio de 1997"
19,2,20,423,259,250,509,"6 de julio de 1997"
19,2,20,424,76,40,116,"6 de julio de 1997"
19,2,20,425,19,15,34,"6 de julio de 1997"
19,2,20,426,67,52,119,"6 de julio de 1997"
19,2,20,427,25,20,45,"6 de julio de 1997"
19,2,20,428,23,16,39,"6 de julio de 1997"
19,2,20,429,26,19,45,"6 de julio de 1997"
19,2,23,515,62,64,126,"6 de julio de 1997"
19,2,23,516,253,276,529,"6 de julio de 1997"
19,2,23,517,295,273,568,"6 de julio de 1997"
19,2,25,523,490,497,987,"6 de julio de 1997"
19,2,25,524,559,571,1130,"6 de julio de 1997"
19,2,25,525,618,599,1217,"6 de julio de 1997"
19,2,27,805,146,152,298,"6 de julio de 1997"
19,2,27,806,187,178,365,"6 de julio de 1997"
19,2,27,807,227,229,456,"6 de julio de 1997"
19,2,27,808,245,236,481,"6 de julio de 1997"
19,2,27,809,131,109,240,"6 de julio de 1997"
19,2,27,810,156,112,268,"6 de julio de 1997"
19,2,28,811,468,517,985,"6 de julio de 1997"
19,2,28,812,289,305,594,"6 de julio de 1997"
19,2,28,813,326,373,699,"6 de julio de 1997"
19,2,28,814,289,294,583,"6 de julio de 1997"
19,2,28,815,347,340,687,"6 de julio de 1997"
19,2,28,816,772,823,1595,"6 de julio de 1997"
19,2,28,817,721,725,1446,"6 de julio de 1997"
19,2,28,818,318,334,652,"6 de julio de 1997"
19,2,28,819,324,352,676,"6 de julio de 1997"
19,2,29,820,125,122,247,"6 de julio de 1997"
19,2,29,821,252,270,522,"6 de julio de 1997"
19,2,35,908,289,269,558,"6 de julio de 1997"
19,2,35,909,300,282,582,"6 de julio de 1997"
19,2,35,910,604,607,1211,"6 de julio de 1997"
19,2,36,911,232,203,435,"6 de julio de 1997"
19,2,36,912,180,169,349,"6 de julio de 1997"
19,2,41,1700,111,111,222,"6 de julio de 1997"
19,2,41,1701,250,214,464,"6 de julio de 1997"
19,2,41,1702,170,124,294,"6 de julio de 1997"
19,2,42,1703,538,502,1040,"6 de julio de 1997"
19,2,42,1704,382,339,721,"6 de julio de 1997"
19,2,42,1705,559,574,1133,"6 de julio de 1997"
19,2,42,1706,319,310,629,"6 de julio de 1997"
19,2,42,1707,409,354,763,"6 de julio de 1997"
19,2,42,1708,197,148,345,"6 de julio de 1997"
19,2,42,1709,154,85,239,"6 de julio de 1997"
19,2,42,1710,343,311,654,"6 de julio de 1997"
19,2,42,1711,173,149,322,"6 de julio de 1997"
19,2,43,1712,299,300,599,"6 de julio de 1997"
19,2,43,1713,210,210,420,"6 de julio de 1997"
19,2,43,1714,145,123,268,"6 de julio de 1997"
19,2,43,1715,127,108,235,"6 de julio de 1997"
19,2,43,1716,107,88,195,"6 de julio de 1997"
19,2,43,1717,109,113,222,"6 de julio de 1997"
19,2,43,1718,103,79,182,"6 de julio de 1997"
19,2,43,1719,106,93,199,"6 de julio de 1997"
19,2,43,1720,365,343,708,"6 de julio de 1997"
19,2,43,1721,225,200,425,"6 de julio de 1997"
19,2,43,1722,92,83,175,"6 de julio de 1997"
19,2,43,1723,147,109,256,"6 de julio de 1997"
19,2,45,1729,876,833,1709,"6 de julio de 1997"
19,2,45,1730,505,557,1062,"6 de julio de 1997"
19,2,45,1731,478,512,990,"6 de julio de 1997"
19,2,45,1732,705,723,1428,"6 de julio de 1997"
19,2,45,1733,596,616,1212,"6 de julio de 1997"
19,2,45,1734,475,500,975,"6 de julio de 1997"
19,2,45,1735,375,330,705,"6 de julio de 1997"
19,2,45,1736,372,379,751,"6 de julio de 1997"
19,2,45,1737,551,552,1103,"6 de julio de 1997"
19,2,45,1738,998,1041,2039,"6 de julio de 1997"
19,2,45,1739,669,699,1368,"6 de julio de 1997"
19,2,45,1740,361,379,740,"6 de julio de 1997"
19,2,45,1741,169,166,335,"6 de julio de 1997"
19,2,45,1742,398,447,845,"6 de julio de 1997"
19,2,45,1743,581,606,1187,"6 de julio de 1997"
19,2,45,1744,354,396,750,"6 de julio de 1997"
19,2,45,1745,456,438,894,"6 de julio de 1997"
19,2,45,1746,372,387,759,"6 de julio de 1997"
19,2,45,1747,21,15,36,"6 de julio de 1997"
19,2,45,1748,23,17,40,"6 de julio de 1997"
19,2,45,1749,239,213,452,"6 de julio de 1997"
19,2,45,1750,33,30,63,"6 de julio de 1997"
19,2,45,1751,154,140,294,"6 de julio de 1997"
19,2,46,1752,501,463,964,"6 de julio de 1997"
19,2,46,1753,428,418,846,"6 de julio de 1997"
19,2,46,1754,566,648,1214,"6 de julio de 1997"
19,2,46,1755,503,477,980,"6 de julio de 1997"
19,2,46,1756,108,86,194,"6 de julio de 1997"
19,2,46,1757,43,37,80,"6 de julio de 1997"
19,2,46,1758,338,259,597,"6 de julio de 1997"
19,2,46,1759,308,305,613,"6 de julio de 1997"
19,2,46,1760,1257,1295,2552,"6 de julio de 1997"
19,2,50,2111,86,89,175,"6 de julio de 1997"
19,2,50,2112,66,67,133,"6 de julio de 1997"
19,2,50,2113,52,46,98,"6 de julio de 1997"
19,2,50,2114,71,63,134,"6 de julio de 1997"
19,2,50,2115,176,170,346,"6 de julio de 1997"
19,2,50,2116,133,113,246,"6 de julio de 1997"
19,2,50,2117,221,196,417,"6 de julio de 1997"
19,2,51,2118,660,670,1330,"6 de julio de 1997"
19,2,51,2119,117,135,252,"6 de julio de 1997"
19,2,51,2120,187,180,367,"6 de julio de 1997"
19,2,51,2121,127,119,246,"6 de julio de 1997"
19,2,51,2122,65,54,119,"6 de julio de 1997"
19,2,51,2123,272,263,535,"6 de julio de 1997"
19,3,21,430,435,463,898,"6 de julio de 1997"
19,3,21,431,327,346,673,"6 de julio de 1997"
19,3,21,432,608,661,1269,"6 de julio de 1997"
19,3,21,433,1431,1656,3087,"6 de julio de 1997"
19,3,21,434,617,648,1265,"6 de julio de 1997"
19,3,21,435,503,519,1022,"6 de julio de 1997"
19,3,21,436,505,494,999,"6 de julio de 1997"
19,3,21,437,529,528,1057,"6 de julio de 1997"
19,3,21,438,478,541,1019,"6 de julio de 1997"
19,3,21,439,2433,2999,5432,"6 de julio de 1997"
19,3,21,440,665,704,1369,"6 de julio de 1997"
19,3,21,441,588,531,1119,"6 de julio de 1997"
19,3,21,442,106,90,196,"6 de julio de 1997"
19,3,21,443,743,763,1506,"6 de julio de 1997"
19,3,21,444,901,897,1798,"6 de julio de 1997"
19,3,21,445,563,526,1089,"6 de julio de 1997"
19,3,21,446,468,498,966,"6 de julio de 1997"
19,3,21,447,566,611,1177,"6 de julio de 1997"
19,3,21,448,1058,1135,2193,"6 de julio de 1997"
19,3,21,449,722,832,1554,"6 de julio de 1997"
19,3,21,450,646,651,1297,"6 de julio de 1997"
19,3,21,451,850,807,1657,"6 de julio de 1997"
19,3,21,452,818,851,1669,"6 de julio de 1997"
19,3,21,453,811,841,1652,"6 de julio de 1997"
19,3,21,454,501,542,1043,"6 de julio de 1997"
19,3,21,455,504,546,1050,"6 de julio de 1997"
19,3,21,456,172,174,346,"6 de julio de 1997"
19,3,21,457,1122,1129,2251,"6 de julio de 1997"
19,3,21,458,915,905,1820,"6 de julio de 1997"
19,3,21,459,718,768,1486,"6 de julio de 1997"
19,3,21,460,243,263,506,"6 de julio de 1997"
19,3,21,461,476,477,953,"6 de julio de 1997"
19,3,21,462,608,685,1293,"6 de julio de 1997"
19,3,21,463,760,779,1539,"6 de julio de 1997"
19,3,21,464,447,453,900,"6 de julio de 1997"
19,3,21,465,390,424,814,"6 de julio de 1997"
19,3,21,466,613,674,1287,"6 de julio de 1997"
19,3,21,467,724,709,1433,"6 de julio de 1997"
19,3,21,468,284,300,584,"6 de julio de 1997"
19,3,21,469,734,778,1512,"6 de julio de 1997"
19,3,21,470,826,868,1694,"6 de julio de 1997"
19,3,21,471,546,534,1080,"6 de julio de 1997"
19,3,21,472,1048,1150,2198,"6 de julio de 1997"
19,3,21,473,454,482,936,"6 de julio de 1997"
19,3,21,474,731,780,1511,"6 de julio de 1997"
19,3,21,475,336,356,692,"6 de julio de 1997"
19,3,21,476,850,857,1707,"6 de julio de 1997"
19,3,21,477,521,510,1031,"6 de julio de 1997"
19,3,21,478,313,340,653,"6 de julio de 1997"
19,3,21,479,491,543,1034,"6 de julio de 1997"
19,3,21,480,1333,1404,2737,"6 de julio de 1997"
19,3,21,481,233,266,499,"6 de julio de 1997"
19,3,21,482,784,812,1596,"6 de julio de 1997"
19,3,21,483,1093,1233,2326,"6 de julio de 1997"
19,3,21,484,467,494,961,"6 de julio de 1997"
19,3,21,485,428,446,874,"6 de julio de 1997"
19,3,21,486,413,420,833,"6 de julio de 1997"
19,3,21,487,483,508,991,"6 de julio de 1997"
19,3,21,488,515,492,1007,"6 de julio de 1997"
19,3,21,489,703,722,1425,"6 de julio de 1997"
19,3,21,490,926,926,1852,"6 de julio de 1997"
19,3,21,491,951,1026,1977,"6 de julio de 1997"
19,3,21,492,958,1086,2044,"6 de julio de 1997"
19,3,21,493,456,451,907,"6 de julio de 1997"
19,3,47,1761,554,630,1184,"6 de julio de 1997"
19,3,47,1762,476,463,939,"6 de julio de 1997"
19,3,47,1763,635,665,1300,"6 de julio de 1997"
19,3,47,1764,601,643,1244,"6 de julio de 1997"
19,3,47,1765,535,554,1089,"6 de julio de 1997"
19,3,47,1766,608,670,1278,"6 de julio de 1997"
19,3,47,1767,619,641,1260,"6 de julio de 1997"
19,3,47,1768,509,535,1044,"6 de julio de 1997"
19,3,47,1769,804,875,1679,"6 de julio de 1997"
19,3,47,1770,998,1037,2035,"6 de julio de 1997"
19,3,47,1771,487,481,968,"6 de julio de 1997"
19,3,47,1772,869,867,1736,"6 de julio de 1997"
19,3,47,1773,656,699,1355,"6 de julio de 1997"
19,3,47,1774,580,592,1172,"6 de julio de 1997"
19,3,47,1775,508,531,1039,"6 de julio de 1997"
19,3,47,1776,741,778,1519,"6 de julio de 1997"
19,3,47,1777,710,764,1474,"6 de julio de 1997"
19,3,47,1778,622,684,1306,"6 de julio de 1997"
19,3,47,1779,552,606,1158,"6 de julio de 1997"
19,3,47,1780,658,667,1325,"6 de julio de 1997"
19,3,47,1781,567,630,1197,"6 de julio de 1997"
19,3,47,1782,583,682,1265,"6 de julio de 1997"
19,3,47,1783,780,777,1557,"6 de julio de 1997"
19,3,47,1784,862,852,1714,"6 de julio de 1997"
19,3,47,1785,286,311,597,"6 de julio de 1997"
19,3,47,1786,650,693,1343,"6 de julio de 1997"
19,3,47,1787,780,849,1629,"6 de julio de 1997"
19,3,47,1788,629,635,1264,"6 de julio de 1997"
19,3,47,1789,627,638,1265,"6 de julio de 1997"
19,3,47,1790,543,530,1073,"6 de julio de 1997"
19,3,47,1791,658,713,1371,"6 de julio de 1997"
19,3,47,1792,762,835,1597,"6 de julio de 1997"
19,3,47,1793,718,804,1522,"6 de julio de 1997"
19,3,47,1794,764,817,1581,"6 de julio de 1997"
19,3,47,1795,319,356,675,"6 de julio de 1997"
19,3,47,1796,300,358,658,"6 de julio de 1997"
19,3,47,1797,674,682,1356,"6 de julio de 1997"
19,3,47,1798,198,219,417,"6 de julio de 1997"
19,3,47,1799,220,243,463,"6 de julio de 1997"
19,3,47,1800,428,489,917,"6 de julio de 1997"
19,3,47,1801,318,326,644,"6 de julio de 1997"
19,3,47,1802,336,371,707,"6 de julio de 1997"
19,3,47,1803,499,549,1048,"6 de julio de 1997"
19,3,47,1804,987,985,1972,"6 de julio de 1997"
19,3,47,1805,632,668,1300,"6 de julio de 1997"
19,3,47,1806,649,670,1319,"6 de julio de 1997"
19,3,47,1807,582,619,1201,"6 de julio de 1997"
19,3,47,1808,507,557,1064,"6 de julio de 1997"
19,3,47,1809,595,634,1229,"6 de julio de 1997"
19,3,47,1810,702,735,1437,"6 de julio de 1997"
19,3,47,1811,727,728,1455,"6 de julio de 1997"
19,3,47,1812,648,668,1316,"6 de julio de 1997"
19,3,47,1813,729,726,1455,"6 de julio de 1997"
19,3,47,1814,526,558,1084,"6 de julio de 1997"
19,3,47,1815,663,711,1374,"6 de julio de 1997"
19,3,47,1816,551,582,1133,"6 de julio de 1997"
19,3,47,1817,425,432,857,"6 de julio de 1997"
19,3,47,1818,563,559,1122,"6 de julio de 1997"
19,3,47,1819,795,780,1575,"6 de julio de 1997"
19,3,47,1820,811,784,1595,"6 de julio de 1997"
19,3,47,1821,552,520,1072,"6 de julio de 1997"
19,3,47,1822,402,404,806,"6 de julio de 1997"
19,3,47,1823,375,406,781,"6 de julio de 1997"
19,3,47,1824,314,362,676,"6 de julio de 1997"
19,3,47,1825,407,421,828,"6 de julio de 1997"
19,3,47,1826,619,677,1296,"6 de julio de 1997"
19,3,47,1827,725,787,1512,"6 de julio de 1997"
19,3,47,1828,543,629,1172,"6 de julio de 1997"
19,3,47,1829,515,562,1077,"6 de julio de 1997"
19,3,47,1830,497,555,1052,"6 de julio de 1997"
19,3,47,1831,579,582,1161,"6 de julio de 1997"
19,3,47,1832,654,672,1326,"6 de julio de 1997"
19,3,47,1833,617,673,1290,"6 de julio de 1997"
19,3,47,1838,359,358,717,"6 de julio de 1997"
19,3,47,1839,374,400,774,"6 de julio de 1997"
19,3,47,1840,362,442,804,"6 de julio de 1997"
19,3,47,1841,381,439,820,"6 de julio de 1997"
19,3,47,1842,724,774,1498,"6 de julio de 1997"
19,3,47,1843,317,373,690,"6 de julio de 1997"
19,3,47,1844,883,949,1832,"6 de julio de 1997"
19,3,47,1845,796,856,1652,"6 de julio de 1997"
19,3,47,1846,452,518,970,"6 de julio de 1997"
19,3,47,1847,740,830,1570,"6 de julio de 1997"
19,3,47,1848,792,817,1609,"6 de julio de 1997"
19,3,47,1853,639,652,1291,"6 de julio de 1997"
19,3,47,1854,747,745,1492,"6 de julio de 1997"
19,3,47,1855,734,726,1460,"6 de julio de 1997"
19,4,47,1834,460,507,967,"6 de julio de 1997"
19,4,47,1835,382,415,797,"6 de julio de 1997"
19,4,47,1836,515,607,1122,"6 de julio de 1997"
19,4,47,1837,539,617,1156,"6 de julio de 1997"
19,4,47,1849,564,615,1179,"6 de julio de 1997"
19,4,47,1850,559,609,1168,"6 de julio de 1997"
19,4,47,1851,503,552,1055,"6 de julio de 1997"
19,4,47,1852,684,753,1437,"6 de julio de 1997"
19,4,47,1856,530,554,1084,"6 de julio de 1997"
19,4,47,1857,546,576,1122,"6 de julio de 1997"
19,4,47,1858,649,701,1350,"6 de julio de 1997"
19,4,47,1859,786,843,1629,"6 de julio de 1997"
19,4,47,1860,576,662,1238,"6 de julio de 1997"
19,4,47,1861,783,794,1577,"6 de julio de 1997"
19,4,47,1862,812,792,1604,"6 de julio de 1997"
19,4,47,1863,808,873,1681,"6 de julio de 1997"
19,4,47,1864,816,868,1684,"6 de julio de 1997"
19,4,47,1865,798,871,1669,"6 de julio de 1997"
19,4,47,1866,385,409,794,"6 de julio de 1997"
19,4,47,1867,465,489,954,"6 de julio de 1997"
19,4,47,1868,535,623,1158,"6 de julio de 1997"
19,4,47,1869,888,906,1794,"6 de julio de 1997"
19,4,47,1870,661,747,1408,"6 de julio de 1997"
19,4,47,1871,569,635,1204,"6 de julio de 1997"
19,4,47,1872,403,467,870,"6 de julio de 1997"
19,4,47,1873,420,419,839,"6 de julio de 1997"
19,4,47,1874,600,634,1234,"6 de julio de 1997"
19,4,47,1875,916,947,1863,"6 de julio de 1997"
19,4,47,1876,725,719,1444,"6 de julio de 1997"
19,4,47,1877,143,162,305,"6 de julio de 1997"
19,4,47,1878,651,661,1312,"6 de julio de 1997"
19,4,47,1879,634,647,1281,"6 de julio de 1997"
19,4,47,1880,615,700,1315,"6 de julio de 1997"
19,4,47,1881,683,672,1355,"6 de julio de 1997"
19,4,47,1882,577,602,1179,"6 de julio de 1997"
19,4,47,1883,536,606,1142,"6 de julio de 1997"
19,4,47,1884,745,770,1515,"6 de julio de 1997"
19,4,47,1885,947,945,1892,"6 de julio de 1997"
19,4,47,1886,823,862,1685,"6 de julio de 1997"
19,4,47,1887,675,683,1358,"6 de julio de 1997"
19,4,47,1888,683,709,1392,"6 de julio de 1997"
19,4,47,1889,545,595,1140,"6 de julio de 1997"
19,4,47,1890,424,448,872,"6 de julio de 1997"
19,4,47,1891,747,756,1503,"6 de julio de 1997"
19,4,47,1892,819,825,1644,"6 de julio de 1997"
19,4,47,1893,728,724,1452,"6 de julio de 1997"
19,4,47,1894,364,375,739,"6 de julio de 1997"
19,4,47,1895,474,488,962,"6 de julio de 1997"
19,4,47,1896,743,769,1512,"6 de julio de 1997"
19,4,47,1897,1014,1091,2105,"6 de julio de 1997"
19,4,47,1898,575,638,1213,"6 de julio de 1997"
19,4,47,1899,580,606,1186,"6 de julio de 1997"
19,4,47,1900,377,398,775,"6 de julio de 1997"
19,4,47,1901,1031,1110,2141,"6 de julio de 1997"
19,4,47,1902,966,1018,1984,"6 de julio de 1997"
19,4,47,1903,817,817,1634,"6 de julio de 1997"
19,4,47,1904,832,832,1664,"6 de julio de 1997"
19,4,47,1905,731,757,1488,"6 de julio de 1997"
19,4,47,1906,317,332,649,"6 de julio de 1997"
19,4,47,1907,830,823,1653,"6 de julio de 1997"
19,4,47,1908,837,877,1714,"6 de julio de 1997"
19,4,47,1909,770,854,1624,"6 de julio de 1997"
19,4,47,1910,748,782,1530,"6 de julio de 1997"
19,4,47,1911,743,785,1528,"6 de julio de 1997"
19,4,47,1912,105,96,201,"6 de julio de 1997"
19,4,47,1913,258,239,497,"6 de julio de 1997"
19,4,47,1914,467,552,1019,"6 de julio de 1997"
19,4,47,1915,500,535,1035,"6 de julio de 1997"
19,4,47,1916,445,543,988,"6 de julio de 1997"
19,4,47,1917,577,649,1226,"6 de julio de 1997"
19,4,47,1918,817,854,1671,"6 de julio de 1997"
19,4,47,1919,801,853,1654,"6 de julio de 1997"
19,4,47,1920,914,920,1834,"6 de julio de 1997"
19,4,47,1921,668,676,1344,"6 de julio de 1997"
19,4,47,1922,543,520,1063,"6 de julio de 1997"
19,4,47,1923,540,543,1083,"6 de julio de 1997"
19,4,47,1924,692,726,1418,"6 de julio de 1997"
19,4,47,1925,733,735,1468,"6 de julio de 1997"
19,4,47,1926,734,750,1484,"6 de julio de 1997"
19,4,47,1927,789,803,1592,"6 de julio de 1997"
19,4,47,1928,671,697,1368,"6 de julio de 1997"
19,4,47,1929,884,893,1777,"6 de julio de 1997"
19,4,47,1930,492,471,963,"6 de julio de 1997"
19,4,47,1931,694,658,1352,"6 de julio de 1997"
19,4,47,1932,802,813,1615,"6 de julio de 1997"
19,4,47,1933,534,506,1040,"6 de julio de 1997"
19,4,47,1934,454,414,868,"6 de julio de 1997"
19,4,47,1935,934,927,1861,"6 de julio de 1997"
19,4,47,1936,839,866,1705,"6 de julio de 1997"
19,4,47,1937,869,935,1804,"6 de julio de 1997"
19,4,47,1938,532,545,1077,"6 de julio de 1997"
19,4,47,1939,287,273,560,"6 de julio de 1997"
19,4,47,1940,757,711,1468,"6 de julio de 1997"
19,4,47,1941,390,392,782,"6 de julio de 1997"
19,4,47,1942,532,530,1062,"6 de julio de 1997"
19,4,47,1943,693,761,1454,"6 de julio de 1997"
19,4,47,1944,1014,974,1988,"6 de julio de 1997"
19,4,47,1945,735,765,1500,"6 de julio de 1997"
19,4,47,1946,737,846,1583,"6 de julio de 1997"
19,4,47,1947,533,589,1122,"6 de julio de 1997"
19,4,47,1948,455,474,929,"6 de julio de 1997"
19,4,47,1949,287,341,628,"6 de julio de 1997"
19,4,47,1950,322,346,668,"6 de julio de 1997"
19,4,47,1951,387,399,786,"6 de julio de 1997"
19,4,47,1952,543,617,1160,"6 de julio de 1997"
19,4,47,1953,542,590,1132,"6 de julio de 1997"
19,4,47,1954,1055,1034,2089,"6 de julio de 1997"
19,4,47,1955,899,866,1765,"6 de julio de 1997"
19,4,47,1956,509,532,1041,"6 de julio de 1997"
19,4,47,1957,827,886,1713,"6 de julio de 1997"
19,4,47,1958,994,1000,1994,"6 de julio de 1997"
19,4,47,1959,799,798,1597,"6 de julio de 1997"
19,4,47,1960,640,639,1279,"6 de julio de 1997"
19,4,47,1961,858,958,1816,"6 de julio de 1997"
19,4,47,1962,871,898,1769,"6 de julio de 1997"
19,4,47,1963,992,1056,2048,"6 de julio de 1997"
19,4,47,1964,421,433,854,"6 de julio de 1997"
19,4,47,1965,532,607,1139,"6 de julio de 1997"
19,4,47,1966,583,599,1182,"6 de julio de 1997"
19,4,47,1967,591,600,1191,"6 de julio de 1997"
19,4,47,1968,686,723,1409,"6 de julio de 1997"
19,4,47,1969,782,806,1588,"6 de julio de 1997"
19,4,47,1970,967,989,1956,"6 de julio de 1997"
19,4,47,1971,645,641,1286,"6 de julio de 1997"
19,4,47,1972,876,873,1749,"6 de julio de 1997"
19,4,47,1973,810,807,1617,"6 de julio de 1997"
19,4,47,1974,765,846,1611,"6 de julio de 1997"
19,4,47,1975,519,562,1081,"6 de julio de 1997"
19,4,47,1976,871,927,1798,"6 de julio de 1997"
19,4,47,1977,1147,1170,2317,"6 de julio de 1997"
19,4,47,1978,757,795,1552,"6 de julio de 1997"
19,4,47,1979,750,801,1551,"6 de julio de 1997"
19,4,47,1980,800,781,1581,"6 de julio de 1997"
19,4,47,1981,423,452,875,"6 de julio de 1997"
19,4,47,1982,289,292,581,"6 de julio de 1997"
19,4,47,1983,463,464,927,"6 de julio de 1997"
19,4,47,1984,668,710,1378,"6 de julio de 1997"
19,4,47,1985,762,836,1598,"6 de julio de 1997"
19,4,47,1986,310,277,587,"6 de julio de 1997"
19,4,47,1987,784,779,1563,"6 de julio de 1997"
19,4,47,1988,847,914,1761,"6 de julio de 1997"
19,4,47,1989,683,725,1408,"6 de julio de 1997"
19,4,47,1990,222,253,475,"6 de julio de 1997"
19,4,47,1991,308,349,657,"6 de julio de 1997"
19,4,47,1992,247,289,536,"6 de julio de 1997"
19,4,47,1993,321,334,655,"6 de julio de 1997"
19,4,47,1994,326,366,692,"6 de julio de 1997"
19,4,47,1995,219,224,443,"6 de julio de 1997"
19,4,47,1996,783,813,1596,"6 de julio de 1997"
19,4,47,1997,772,818,1590,"6 de julio de 1997"
19,4,47,1998,619,642,1261,"6 de julio de 1997"
19,5,40,975,321,373,694,"6 de julio de 1997"
19,5,40,976,774,743,1517,"6 de julio de 1997"
19,5,40,977,585,614,1199,"6 de julio de 1997"
19,5,40,978,725,733,1458,"6 de julio de 1997"
19,5,40,979,727,714,1441,"6 de julio de 1997"
19,5,40,980,677,753,1430,"6 de julio de 1997"
19,5,40,981,525,607,1132,"6 de julio de 1997"
19,5,40,982,707,755,1462,"6 de julio de 1997"
19,5,40,983,726,719,1445,"6 de julio de 1997"
19,5,40,984,669,701,1370,"6 de julio de 1997"
19,5,40,985,640,695,1335,"6 de julio de 1997"
19,5,40,986,498,510,1008,"6 de julio de 1997"
19,5,40,987,659,677,1336,"6 de julio de 1997"
19,5,40,990,478,522,1000,"6 de julio de 1997"
19,5,40,1432,677,750,1427,"6 de julio de 1997"
19,5,40,1433,668,737,1405,"6 de julio de 1997"
19,5,40,1434,762,780,1542,"6 de julio de 1997"
19,5,40,1435,958,985,1943,"6 de julio de 1997"
19,5,40,1436,655,674,1329,"6 de julio de 1997"
19,5,40,1437,695,702,1397,"6 de julio de 1997"
19,5,40,1438,765,764,1529,"6 de julio de 1997"
19,5,40,1439,577,608,1185,"6 de julio de 1997"
19,5,40,1440,771,789,1560,"6 de julio de 1997"
19,5,40,1441,714,757,1471,"6 de julio de 1997"
19,5,40,1442,892,917,1809,"6 de julio de 1997"
19,5,40,1443,647,686,1333,"6 de julio de 1997"
19,5,40,1444,542,572,1114,"6 de julio de 1997"
19,5,40,1445,454,495,949,"6 de julio de 1997"
19,5,40,1446,885,876,1761,"6 de julio de 1997"
19,5,40,1447,564,595,1159,"6 de julio de 1997"
19,5,40,1448,892,990,1882,"6 de julio de 1997"
19,5,40,1449,519,543,1062,"6 de julio de 1997"
19,5,40,1450,606,648,1254,"6 de julio de 1997"
19,5,40,1451,636,696,1332,"6 de julio de 1997"
19,5,40,1452,595,646,1241,"6 de julio de 1997"
19,5,40,1453,495,529,1024,"6 de julio de 1997"
19,5,40,1454,700,714,1414,"6 de julio de 1997"
19,5,40,1455,653,688,1341,"6 de julio de 1997"
19,5,40,1456,656,645,1301,"6 de julio de 1997"
19,5,40,1457,609,683,1292,"6 de julio de 1997"
19,5,40,1458,593,671,1264,"6 de julio de 1997"
19,5,40,1459,550,585,1135,"6 de julio de 1997"
19,5,40,1460,530,569,1099,"6 de julio de 1997"
19,5,40,1461,547,574,1121,"6 de julio de 1997"
19,5,40,1462,504,598,1102,"6 de julio de 1997"
19,5,40,1463,571,608,1179,"6 de julio de 1997"
19,5,40,1464,462,503,965,"6 de julio de 1997"
19,5,40,1465,563,617,1180,"6 de julio de 1997"
19,5,40,1466,547,588,1135,"6 de julio de 1997"
19,5,40,1467,499,539,1038,"6 de julio de 1997"
19,5,40,1468,541,564,1105,"6 de julio de 1997"
19,5,40,1469,496,551,1047,"6 de julio de 1997"
19,5,40,1470,661,674,1335,"6 de julio de 1997"
19,5,40,1471,706,748,1454,"6 de julio de 1997"
19,5,40,1472,990,1002,1992,"6 de julio de 1997"
19,5,40,1473,689,704,1393,"6 de julio de 1997"
19,5,40,1474,618,636,1254,"6 de julio de 1997"
19,5,40,1475,837,832,1669,"6 de julio de 1997"
19,5,40,1476,626,657,1283,"6 de julio de 1997"
19,5,40,1477,910,931,1841,"6 de julio de 1997"
19,5,40,1478,793,822,1615,"6 de julio de 1997"
19,5,40,1479,786,820,1606,"6 de julio de 1997"
19,5,40,1480,678,740,1418,"6 de julio de 1997"
19,5,40,1481,896,890,1786,"6 de julio de 1997"
19,5,40,1482,752,793,1545,"6 de julio de 1997"
19,5,40,1483,751,788,1539,"6 de julio de 1997"
19,5,40,1484,769,777,1546,"6 de julio de 1997"
19,5,40,1485,531,563,1094,"6 de julio de 1997"
19,5,40,1486,693,726,1419,"6 de julio de 1997"
19,5,40,1487,470,508,978,"6 de julio de 1997"
19,5,40,1488,559,577,1136,"6 de julio de 1997"
19,5,40,1489,768,786,1554,"6 de julio de 1997"
19,5,40,1490,682,736,1418,"6 de julio de 1997"
19,5,40,1491,869,887,1756,"6 de julio de 1997"
19,5,40,1492,989,1050,2039,"6 de julio de 1997"
19,5,40,1493,582,607,1189,"6 de julio de 1997"
19,5,40,1494,600,640,1240,"6 de julio de 1997"
19,5,40,1495,620,633,1253,"6 de julio de 1997"
19,5,40,1496,781,769,1550,"6 de julio de 1997"
19,5,40,1497,911,943,1854,"6 de julio de 1997"
19,5,40,1498,794,810,1604,"6 de julio de 1997"
19,5,40,1499,974,944,1918,"6 de julio de 1997"
19,5,40,1500,837,887,1724,"6 de julio de 1997"
19,5,40,1501,796,808,1604,"6 de julio de 1997"
19,5,40,1502,750,741,1491,"6 de julio de 1997"
19,5,40,1503,538,591,1129,"6 de julio de 1997"
19,5,40,1504,609,619,1228,"6 de julio de 1997"
19,5,40,1505,737,848,1585,"6 de julio de 1997"
19,5,40,1515,686,745,1431,"6 de julio de 1997"
19,5,40,1517,831,830,1661,"6 de julio de 1997"
19,5,40,1518,888,846,1734,"6 de julio de 1997"
19,5,40,1519,930,997,1927,"6 de julio de 1997"
19,5,40,1520,534,589,1123,"6 de julio de 1997"
19,5,40,1521,647,719,1366,"6 de julio de 1997"
19,5,40,1522,653,706,1359,"6 de julio de 1997"
19,5,40,1523,891,862,1753,"6 de julio de 1997"
19,5,40,1524,827,858,1685,"6 de julio de 1997"
19,5,40,1525,847,852,1699,"6 de julio de 1997"
19,5,40,1544,807,795,1602,"6 de julio de 1997"
19,5,40,1545,926,976,1902,"6 de julio de 1997"
19,5,40,1546,884,886,1770,"6 de julio de 1997"
19,5,40,1547,774,779,1553,"6 de julio de 1997"
19,5,40,1548,837,803,1640,"6 de julio de 1997"
19,5,40,1549,453,482,935,"6 de julio de 1997"
19,5,40,1550,451,479,930,"6 de julio de 1997"
19,5,40,1551,817,845,1662,"6 de julio de 1997"
19,5,40,1552,1020,1031,2051,"6 de julio de 1997"
19,5,40,1553,690,746,1436,"6 de julio de 1997"
19,5,40,1554,605,638,1243,"6 de julio de 1997"
19,5,40,1555,801,821,1622,"6 de julio de 1997"
19,5,40,1556,656,631,1287,"6 de julio de 1997"
19,5,40,1588,806,756,1562,"6 de julio de 1997"
19,5,40,1589,733,741,1474,"6 de julio de 1997"
19,5,40,1590,869,929,1798,"6 de julio de 1997"
19,5,40,1591,927,965,1892,"6 de julio de 1997"
19,5,40,1592,757,738,1495,"6 de julio de 1997"
19,5,40,1593,705,783,1488,"6 de julio de 1997"
19,5,40,1612,773,747,1520,"6 de julio de 1997"
19,5,40,1613,840,945,1785,"6 de julio de 1997"
19,5,40,1614,410,389,799,"6 de julio de 1997"
19,5,40,1615,768,823,1591,"6 de julio de 1997"
19,5,40,1616,797,778,1575,"6 de julio de 1997"
19,5,40,1617,810,868,1678,"6 de julio de 1997"
19,5,40,1618,985,939,1924,"6 de julio de 1997"
19,5,40,1619,895,905,1800,"6 de julio de 1997"
19,5,40,1620,819,848,1667,"6 de julio de 1997"
19,5,40,1621,386,429,815,"6 de julio de 1997"
19,5,40,1622,784,884,1668,"6 de julio de 1997"
19,5,40,1623,772,839,1611,"6 de julio de 1997"
19,5,40,1624,860,815,1675,"6 de julio de 1997"
19,5,40,1625,759,817,1576,"6 de julio de 1997"
19,5,40,1626,837,856,1693,"6 de julio de 1997"
19,5,40,1627,722,695,1417,"6 de julio de 1997"
19,6,40,991,528,591,1119,"6 de julio de 1997"
19,6,40,992,457,531,988,"6 de julio de 1997"
19,6,40,993,462,582,1044,"6 de julio de 1997"
19,6,40,1002,689,756,1445,"6 de julio de 1997"
19,6,40,1003,550,585,1135,"6 de julio de 1997"
19,6,40,1004,515,580,1095,"6 de julio de 1997"
19,6,40,1005,612,689,1301,"6 de julio de 1997"
19,6,40,1006,557,597,1154,"6 de julio de 1997"
19,6,40,1007,493,553,1046,"6 de julio de 1997"
19,6,40,1008,483,506,989,"6 de julio de 1997"
19,6,40,1009,470,504,974,"6 de julio de 1997"
19,6,40,1010,391,410,801,"6 de julio de 1997"
19,6,40,1011,258,301,559,"6 de julio de 1997"
19,6,40,1012,736,826,1562,"6 de julio de 1997"
19,6,40,1013,529,601,1130,"6 de julio de 1997"
19,6,40,1014,706,777,1483,"6 de julio de 1997"
19,6,40,1015,699,750,1449,"6 de julio de 1997"
19,6,40,1016,124,129,253,"6 de julio de 1997"
19,6,40,1017,529,668,1197,"6 de julio de 1997"
19,6,40,1018,562,668,1230,"6 de julio de 1997"
19,6,40,1035,330,406,736,"6 de julio de 1997"
19,6,40,1036,441,506,947,"6 de julio de 1997"
19,6,40,1037,212,229,441,"6 de julio de 1997"
19,6,40,1038,347,360,707,"6 de julio de 1997"
19,6,40,1039,377,404,781,"6 de julio de 1997"
19,6,40,1040,389,420,809,"6 de julio de 1997"
19,6,40,1041,780,913,1693,"6 de julio de 1997"
19,6,40,1042,620,650,1270,"6 de julio de 1997"
19,6,40,1043,643,704,1347,"6 de julio de 1997"
19,6,40,1044,658,734,1392,"6 de julio de 1997"
19,6,40,1045,727,762,1489,"6 de julio de 1997"
19,6,40,1046,616,664,1280,"6 de julio de 1997"
19,6,40,1047,582,651,1233,"6 de julio de 1997"
19,6,40,1048,243,273,516,"6 de julio de 1997"
19,6,40,1049,318,397,715,"6 de julio de 1997"
19,6,40,1050,372,464,836,"6 de julio de 1997"
19,6,40,1051,181,240,421,"6 de julio de 1997"
19,6,40,1071,246,328,574,"6 de julio de 1997"
19,6,40,1082,235,328,563,"6 de julio de 1997"
19,6,40,1083,298,390,688,"6 de julio de 1997"
19,6,40,1084,524,614,1138,"6 de julio de 1997"
19,6,40,1085,442,464,906,"6 de julio de 1997"
19,6,40,1086,314,405,719,"6 de julio de 1997"
19,6,40,1087,289,296,585,"6 de julio de 1997"
19,6,40,1088,414,441,855,"6 de julio de 1997"
19,6,40,1089,350,426,776,"6 de julio de 1997"
19,6,40,1090,610,665,1275,"6 de julio de 1997"
19,6,40,1091,822,875,1697,"6 de julio de 1997"
19,6,40,1092,585,666,1251,"6 de julio de 1997"
19,6,40,1093,629,721,1350,"6 de julio de 1997"
19,6,40,1094,545,612,1157,"6 de julio de 1997"
19,6,40,1095,483,531,1014,"6 de julio de 1997"
19,6,40,1096,484,521,1005,"6 de julio de 1997"
19,6,40,1097,424,475,899,"6 de julio de 1997"
19,6,40,1098,695,803,1498,"6 de julio de 1997"
19,6,40,1506,708,779,1487,"6 de julio de 1997"
19,6,40,1507,865,969,1834,"6 de julio de 1997"
19,6,40,1508,700,770,1470,"6 de julio de 1997"
19,6,40,1509,867,869,1736,"6 de julio de 1997"
19,6,40,1510,993,952,1945,"6 de julio de 1997"
19,6,40,1511,794,824,1618,"6 de julio de 1997"
19,6,40,1512,934,972,1906,"6 de julio de 1997"
19,6,40,1513,534,590,1124,"6 de julio de 1997"
19,6,40,1514,809,801,1610,"6 de julio de 1997"
19,6,40,1516,786,862,1648,"6 de julio de 1997"
19,6,40,1526,732,795,1527,"6 de julio de 1997"
19,6,40,1527,702,740,1442,"6 de julio de 1997"
19,6,40,1528,923,928,1851,"6 de julio de 1997"
19,6,40,1529,886,957,1843,"6 de julio de 1997"
19,6,40,1530,887,915,1802,"6 de julio de 1997"
19,6,40,1531,997,1048,2045,"6 de julio de 1997"
19,6,40,1532,703,731,1434,"6 de julio de 1997"
19,6,40,1533,672,761,1433,"6 de julio de 1997"
19,6,40,1534,645,654,1299,"6 de julio de 1997"
19,6,40,1535,784,867,1651,"6 de julio de 1997"
19,6,40,1536,949,969,1918,"6 de julio de 1997"
19,6,40,1537,824,869,1693,"6 de julio de 1997"
19,6,40,1538,835,842,1677,"6 de julio de 1997"
19,6,40,1539,834,817,1651,"6 de julio de 1997"
19,6,40,1540,811,866,1677,"6 de julio de 1997"
19,6,40,1541,900,956,1856,"6 de julio de 1997"
19,6,40,1542,629,629,1258,"6 de julio de 1997"
19,6,40,1543,679,713,1392,"6 de julio de 1997"
19,6,40,1557,369,415,784,"6 de julio de 1997"
19,6,40,1558,389,418,807,"6 de julio de 1997"
19,6,40,1559,818,843,1661,"6 de julio de 1997"
19,6,40,1560,865,928,1793,"6 de julio de 1997"
19,6,40,1561,671,704,1375,"6 de julio de 1997"
19,6,40,1562,745,783,1528,"6 de julio de 1997"
19,6,40,1563,760,783,1543,"6 de julio de 1997"
19,6,40,1564,931,953,1884,"6 de julio de 1997"
19,6,40,1565,820,807,1627,"6 de julio de 1997"
19,6,40,1566,601,646,1247,"6 de julio de 1997"
19,6,40,1567,780,849,1629,"6 de julio de 1997"
19,6,40,1568,773,835,1608,"6 de julio de 1997"
19,6,40,1569,764,780,1544,"6 de julio de 1997"
19,6,40,1570,433,489,922,"6 de julio de 1997"
19,6,40,1571,735,809,1544,"6 de julio de 1997"
19,6,40,1572,627,668,1295,"6 de julio de 1997"
19,6,40,1573,666,740,1406,"6 de julio de 1997"
19,6,40,1574,620,688,1308,"6 de julio de 1997"
19,6,40,1575,357,414,771,"6 de julio de 1997"
19,6,40,1576,753,860,1613,"6 de julio de 1997"
19,6,40,1577,357,378,735,"6 de julio de 1997"
19,6,40,1578,394,422,816,"6 de julio de 1997"
19,6,40,1579,636,696,1332,"6 de julio de 1997"
19,6,40,1580,597,676,1273,"6 de julio de 1997"
19,6,40,1581,796,878,1674,"6 de julio de 1997"
19,6,40,1582,674,714,1388,"6 de julio de 1997"
19,6,40,1583,609,748,1357,"6 de julio de 1997"
19,6,40,1584,905,929,1834,"6 de julio de 1997"
19,6,40,1585,764,861,1625,"6 de julio de 1997"
19,6,40,1586,744,818,1562,"6 de julio de 1997"
19,6,40,1587,666,741,1407,"6 de julio de 1997"
19,6,40,1594,914,936,1850,"6 de julio de 1997"
19,6,40,1595,943,991,1934,"6 de julio de 1997"
19,6,40,1596,745,750,1495,"6 de julio de 1997"
19,6,40,1597,704,802,1506,"6 de julio de 1997"
19,6,40,1598,735,782,1517,"6 de julio de 1997"
19,6,40,1599,813,886,1699,"6 de julio de 1997"
19,6,40,1600,783,921,1704,"6 de julio de 1997"
19,6,40,1601,795,811,1606,"6 de julio de 1997"
19,6,40,1602,787,870,1657,"6 de julio de 1997"
19,6,40,1603,1000,997,1997,"6 de julio de 1997"
19,6,40,1604,777,854,1631,"6 de julio de 1997"
19,6,40,1605,694,726,1420,"6 de julio de 1997"
19,6,40,1606,245,230,475,"6 de julio de 1997"
19,6,40,1607,672,711,1383,"6 de julio de 1997"
19,6,40,1608,703,793,1496,"6 de julio de 1997"
19,6,40,1609,624,702,1326,"6 de julio de 1997"
19,6,40,1610,616,652,1268,"6 de julio de 1997"
19,6,40,1611,415,494,909,"6 de julio de 1997"
19,7,40,988,667,784,1451,"6 de julio de 1997"
19,7,40,989,705,793,1498,"6 de julio de 1997"
19,7,40,994,373,399,772,"6 de julio de 1997"
19,7,40,995,668,766,1434,"6 de julio de 1997"
19,7,40,996,317,363,680,"6 de julio de 1997"
19,7,40,997,513,514,1027,"6 de julio de 1997"
19,7,40,998,374,425,799,"6 de julio de 1997"
19,7,40,999,359,361,720,"6 de julio de 1997"
19,7,40,1000,343,365,708,"6 de julio de 1997"
19,7,40,1001,414,445,859,"6 de julio de 1997"
19,7,40,1019,318,352,670,"6 de julio de 1997"
19,7,40,1020,301,336,637,"6 de julio de 1997"
19,7,40,1021,306,371,677,"6 de julio de 1997"
19,7,40,1022,139,153,292,"6 de julio de 1997"
19,7,40,1023,418,446,864,"6 de julio de 1997"
19,7,40,1024,308,341,649,"6 de julio de 1997"
19,7,40,1025,454,424,878,"6 de julio de 1997"
19,7,40,1026,252,243,495,"6 de julio de 1997"
19,7,40,1027,234,205,439,"6 de julio de 1997"
19,7,40,1028,183,201,384,"6 de julio de 1997"
19,7,40,1029,484,448,932,"6 de julio de 1997"
19,7,40,1030,273,330,603,"6 de julio de 1997"
19,7,40,1031,362,424,786,"6 de julio de 1997"
19,7,40,1032,370,456,826,"6 de julio de 1997"
19,7,40,1033,350,404,754,"6 de julio de 1997"
19,7,40,1034,417,500,917,"6 de julio de 1997"
19,7,40,1052,457,589,1046,"6 de julio de 1997"
19,7,40,1053,191,213,404,"6 de julio de 1997"
19,7,40,1054,443,485,928,"6 de julio de 1997"
19,7,40,1055,229,276,505,"6 de julio de 1997"
19,7,40,1056,234,227,461,"6 de julio de 1997"
19,7,40,1057,198,224,422,"6 de julio de 1997"
19,7,40,1058,495,502,997,"6 de julio de 1997"
19,7,40,1059,527,560,1087,"6 de julio de 1997"
19,7,40,1060,207,228,435,"6 de julio de 1997"
19,7,40,1061,224,208,432,"6 de julio de 1997"
19,7,40,1062,164,194,358,"6 de julio de 1997"
19,7,40,1063,407,419,826,"6 de julio de 1997"
19,7,40,1064,591,592,1183,"6 de julio de 1997"
19,7,40,1065,875,900,1775,"6 de julio de 1997"
19,7,40,1066,551,602,1153,"6 de julio de 1997"
19,7,40,1067,303,349,652,"6 de julio de 1997"
19,7,40,1068,323,322,645,"6 de julio de 1997"
19,7,40,1069,421,452,873,"6 de julio de 1997"
19,7,40,1070,252,287,539,"6 de julio de 1997"
19,7,40,1072,212,233,445,"6 de julio de 1997"
19,7,40,1073,270,331,601,"6 de julio de 1997"
19,7,40,1074,312,352,664,"6 de julio de 1997"
19,7,40,1075,264,292,556,"6 de julio de 1997"
19,7,40,1076,187,242,429,"6 de julio de 1997"
19,7,40,1077,130,133,263,"6 de julio de 1997"
19,7,40,1078,312,316,628,"6 de julio de 1997"
19,7,40,1079,200,235,435,"6 de julio de 1997"
19,7,40,1080,233,261,494,"6 de julio de 1997"
19,7,40,1081,219,271,490,"6 de julio de 1997"
19,7,40,1099,314,369,683,"6 de julio de 1997"
19,7,40,1100,340,395,735,"6 de julio de 1997"
19,7,40,1101,373,443,816,"6 de julio de 1997"
19,7,40,1102,243,269,512,"6 de julio de 1997"
19,7,40,1103,325,419,744,"6 de julio de 1997"
19,7,40,1104,145,152,297,"6 de julio de 1997"
19,7,40,1105,184,216,400,"6 de julio de 1997"
19,7,40,1106,209,236,445,"6 de julio de 1997"
19,7,40,1107,202,224,426,"6 de julio de 1997"
19,7,40,1108,248,303,551,"6 de julio de 1997"
19,7,40,1109,270,356,626,"6 de julio de 1997"
19,7,40,1110,214,279,493,"6 de julio de 1997"
19,7,40,1111,177,241,418,"6 de julio de 1997"
19,7,40,1112,128,164,292,"6 de julio de 1997"
19,7,40,1113,190,235,425,"6 de julio de 1997"
19,7,40,1114,162,225,387,"6 de julio de 1997"
19,7,40,1115,270,296,566,"6 de julio de 1997"
19,7,40,1116,398,484,882,"6 de julio de 1997"
19,7,40,1117,329,426,755,"6 de julio de 1997"
19,7,40,1118,193,295,488,"6 de julio de 1997"
19,7,40,1119,80,87,167,"6 de julio de 1997"
19,7,40,1120,363,475,838,"6 de julio de 1997"
19,7,40,1121,315,350,665,"6 de julio de 1997"
19,7,40,1122,255,322,577,"6 de julio de 1997"
19,7,40,1123,340,394,734,"6 de julio de 1997"
19,7,40,1124,983,950,1933,"6 de julio de 1997"
19,7,40,1125,610,613,1223,"6 de julio de 1997"
19,7,40,1126,603,676,1279,"6 de julio de 1997"
19,7,40,1127,757,784,1541,"6 de julio de 1997"
19,7,40,1128,458,435,893,"6 de julio de 1997"
19,7,40,1129,348,394,742,"6 de julio de 1997"
19,7,40,1130,331,374,705,"6 de julio de 1997"
19,7,40,1131,100,109,209,"6 de julio de 1997"
19,7,40,1132,88,88,176,"6 de julio de 1997"
19,7,40,1133,210,237,447,"6 de julio de 1997"
19,7,40,1134,581,651,1232,"6 de julio de 1997"
19,7,40,1135,257,258,515,"6 de julio de 1997"
19,7,40,1136,320,295,615,"6 de julio de 1997"
19,7,40,1137,244,270,514,"6 de julio de 1997"
19,7,40,1138,166,183,349,"6 de julio de 1997"
19,7,40,1139,135,149,284,"6 de julio de 1997"
19,7,40,1140,167,159,326,"6 de julio de 1997"
19,7,40,1141,190,238,428,"6 de julio de 1997"
19,7,40,1142,55,65,120,"6 de julio de 1997"
19,7,40,1143,115,157,272,"6 de julio de 1997"
19,7,40,1144,143,171,314,"6 de julio de 1997"
19,7,40,1145,160,143,303,"6 de julio de 1997"
19,7,40,1146,241,272,513,"6 de julio de 1997"
19,7,40,1147,222,249,471,"6 de julio de 1997"
19,7,40,1148,220,302,522,"6 de julio de 1997"
19,7,40,1149,219,240,459,"6 de julio de 1997"
19,7,40,1150,300,367,667,"6 de julio de 1997"
19,7,40,1151,143,177,320,"6 de julio de 1997"
19,7,40,1152,260,274,534,"6 de julio de 1997"
19,7,40,1153,165,150,315,"6 de julio de 1997"
19,7,40,1154,435,471,906,"6 de julio de 1997"
19,7,40,1155,171,189,360,"6 de julio de 1997"
19,7,40,1156,213,195,408,"6 de julio de 1997"
19,7,40,1157,252,245,497,"6 de julio de 1997"
19,7,40,1158,232,243,475,"6 de julio de 1997"
19,7,40,1159,149,174,323,"6 de julio de 1997"
19,7,40,1160,137,125,262,"6 de julio de 1997"
19,7,40,1161,168,145,313,"6 de julio de 1997"
19,7,40,1162,184,146,330,"6 de julio de 1997"
19,7,40,1163,187,192,379,"6 de julio de 1997"
19,7,40,1164,114,136,250,"6 de julio de 1997"
19,7,40,1165,140,151,291,"6 de julio de 1997"
19,7,40,1166,274,277,551,"6 de julio de 1997"
19,7,40,1167,232,231,463,"6 de julio de 1997"
19,7,40,1168,57,82,139,"6 de julio de 1997"
19,7,40,1169,67,59,126,"6 de julio de 1997"
19,7,40,1170,46,27,73,"6 de julio de 1997"
19,7,40,1171,83,87,170,"6 de julio de 1997"
19,7,40,1172,47,27,74,"6 de julio de 1997"
19,7,40,1173,118,96,214,"6 de julio de 1997"
19,7,40,1174,138,122,260,"6 de julio de 1997"
19,7,40,1175,240,278,518,"6 de julio de 1997"
19,7,40,1176,150,138,288,"6 de julio de 1997"
19,7,40,1177,117,93,210,"6 de julio de 1997"
19,7,40,1178,137,114,251,"6 de julio de 1997"
19,7,40,1179,41,35,76,"6 de julio de 1997"
19,7,40,1180,144,138,282,"6 de julio de 1997"
19,7,40,1181,109,113,222,"6 de julio de 1997"
19,7,40,1182,101,127,228,"6 de julio de 1997"
19,7,40,1183,179,169,348,"6 de julio de 1997"
19,7,40,1184,89,82,171,"6 de julio de 1997"
19,7,40,1185,40,42,82,"6 de julio de 1997"
19,7,40,1186,117,130,247,"6 de julio de 1997"
19,7,40,1187,117,137,254,"6 de julio de 1997"
19,7,40,1188,149,173,322,"6 de julio de 1997"
19,7,40,1189,200,210,410,"6 de julio de 1997"
19,7,40,1190,45,52,97,"6 de julio de 1997"
19,7,40,1191,135,144,279,"6 de julio de 1997"
19,7,40,1192,54,46,100,"6 de julio de 1997"
19,7,40,1193,98,111,209,"6 de julio de 1997"
19,7,40,1194,52,71,123,"6 de julio de 1997"
19,7,40,1195,132,160,292,"6 de julio de 1997"
19,7,40,1196,270,315,585,"6 de julio de 1997"
19,7,40,1197,61,70,131,"6 de julio de 1997"
19,7,40,1198,61,64,125,"6 de julio de 1997"
19,7,40,1199,80,83,163,"6 de julio de 1997"
19,7,40,1200,43,31,74,"6 de julio de 1997"
19,7,40,1201,87,81,168,"6 de julio de 1997"
19,7,40,1202,112,111,223,"6 de julio de 1997"
19,7,40,1203,49,62,111,"6 de julio de 1997"
19,7,40,1204,90,78,168,"6 de julio de 1997"
19,7,40,1205,347,351,698,"6 de julio de 1997"
19,7,40,1206,226,289,515,"6 de julio de 1997"
19,7,40,1207,329,327,656,"6 de julio de 1997"
19,7,40,1208,320,310,630,"6 de julio de 1997"
19,7,40,1209,283,316,599,"6 de julio de 1997"
19,7,40,1210,221,237,458,"6 de julio de 1997"
19,7,40,1211,303,339,642,"6 de julio de 1997"
19,7,40,1212,223,234,457,"6 de julio de 1997"
19,7,40,1213,262,270,532,"6 de julio de 1997"
19,7,40,1214,177,187,364,"6 de julio de 1997"
19,7,40,1215,216,228,444,"6 de julio de 1997"
19,7,40,1216,168,188,356,"6 de julio de 1997"
19,7,40,1217,195,202,397,"6 de julio de 1997"
19,7,40,1218,325,346,671,"6 de julio de 1997"
19,7,40,1219,355,389,744,"6 de julio de 1997"
19,7,40,1220,407,490,897,"6 de julio de 1997"
19,7,40,1221,302,324,626,"6 de julio de 1997"
19,7,40,1222,436,439,875,"6 de julio de 1997"
19,7,40,1223,411,451,862,"6 de julio de 1997"
19,7,40,1224,308,331,639,"6 de julio de 1997"
19,7,40,1225,539,545,1084,"6 de julio de 1997"
19,7,40,1226,256,268,524,"6 de julio de 1997"
19,7,40,1227,451,473,924,"6 de julio de 1997"
19,7,40,1228,540,550,1090,"6 de julio de 1997"
19,7,40,1229,390,378,768,"6 de julio de 1997"
19,7,40,1230,667,696,1363,"6 de julio de 1997"
19,7,40,1231,488,526,1014,"6 de julio de 1997"
19,7,40,1232,518,573,1091,"6 de julio de 1997"
19,7,40,1233,614,611,1225,"6 de julio de 1997"
19,7,40,1234,317,306,623,"6 de julio de 1997"
19,7,40,1235,694,697,1391,"6 de julio de 1997"
19,7,40,1236,537,529,1066,"6 de julio de 1997"
19,7,40,1237,568,581,1149,"6 de julio de 1997"
19,7,40,1238,595,570,1165,"6 de julio de 1997"
19,7,40,1239,356,379,735,"6 de julio de 1997"
19,7,40,1240,420,425,845,"6 de julio de 1997"
19,7,40,1241,297,284,581,"6 de julio de 1997"
19,7,40,1242,279,274,553,"6 de julio de 1997"
19,7,40,1243,378,441,819,"6 de julio de 1997"
19,7,40,1244,359,369,728,"6 de julio de 1997"
19,7,40,1245,162,163,325,"6 de julio de 1997"
19,7,40,1246,311,357,668,"6 de julio de 1997"
19,7,40,1247,518,500,1018,"6 de julio de 1997"
19,7,40,1248,381,399,780,"6 de julio de 1997"
19,7,40,1249,195,224,419,"6 de julio de 1997"
19,7,40,1250,310,327,637,"6 de julio de 1997"
19,7,40,1251,238,265,503,"6 de julio de 1997"
19,7,40,1252,268,268,536,"6 de julio de 1997"
19,7,40,1253,385,435,820,"6 de julio de 1997"
19,7,40,1254,178,197,375,"6 de julio de 1997"
19,7,40,1255,224,237,461,"6 de julio de 1997"
19,7,40,1256,202,233,435,"6 de julio de 1997"
19,7,40,1257,273,317,590,"6 de julio de 1997"
19,7,40,1258,329,362,691,"6 de julio de 1997"
19,7,40,1259,222,264,486,"6 de julio de 1997"
19,7,40,1260,195,226,421,"6 de julio de 1997"
19,7,40,1261,190,196,386,"6 de julio de 1997"
19,7,40,1262,116,132,248,"6 de julio de 1997"
19,7,40,1628,683,669,1352,"6 de julio de 1997"
19,7,40,1629,41,43,84,"6 de julio de 1997"
19,7,40,1630,531,538,1069,"6 de julio de 1997"
19,7,40,1631,201,193,394,"6 de julio de 1997"
19,7,40,1632,350,353,703,"6 de julio de 1997"
19,7,40,1633,576,589,1165,"6 de julio de 1997"
19,7,40,1634,135,151,286,"6 de julio de 1997"
19,7,40,1635,476,505,981,"6 de julio de 1997"
19,7,40,1636,471,517,988,"6 de julio de 1997"
19,7,40,1637,464,520,984,"6 de julio de 1997"
19,7,40,1638,483,519,1002,"6 de julio de 1997"
19,7,40,1639,230,208,438,"6 de julio de 1997"
19,7,40,1640,227,67,294,"6 de julio de 1997"
19,7,40,1641,80,74,154,"6 de julio de 1997"
19,7,40,1642,671,716,1387,"6 de julio de 1997"
19,7,40,1643,363,364,727,"6 de julio de 1997"
19,7,40,1644,227,266,493,"6 de julio de 1997"
19,7,40,1645,254,284,538,"6 de julio de 1997"
19,7,40,1646,206,208,414,"6 de julio de 1997"
19,7,40,1647,234,243,477,"6 de julio de 1997"
19,7,40,1648,406,402,808,"6 de julio de 1997"
19,7,40,1649,405,381,786,"6 de julio de 1997"
19,7,40,1650,133,146,279,"6 de julio de 1997"
19,7,40,1651,396,410,806,"6 de julio de 1997"
19,7,40,1652,344,420,764,"6 de julio de 1997"
19,7,40,1653,500,550,1050,"6 de julio de 1997"
19,7,40,1654,371,400,771,"6 de julio de 1997"
19,7,40,1655,443,459,902,"6 de julio de 1997"
19,7,40,1656,445,483,928,"6 de julio de 1997"
19,7,40,1657,628,705,1333,"6 de julio de 1997"
19,7,40,1658,628,644,1272,"6 de julio de 1997"
19,7,40,1659,769,746,1515,"6 de julio de 1997"
19,7,40,1660,463,448,911,"6 de julio de 1997"
19,7,40,1661,481,449,930,"6 de julio de 1997"
19,7,40,1662,407,433,840,"6 de julio de 1997"
19,7,40,1663,411,430,841,"6 de julio de 1997"
19,7,40,1664,392,348,740,"6 de julio de 1997"
19,7,40,1665,281,250,531,"6 de julio de 1997"
19,7,40,1666,266,265,531,"6 de julio de 1997"
19,7,40,1667,483,423,906,"6 de julio de 1997"
19,7,40,1668,299,322,621,"6 de julio de 1997"
19,7,40,1669,231,256,487,"6 de julio de 1997"
19,7,40,1670,406,456,862,"6 de julio de 1997"
19,7,40,1671,468,482,950,"6 de julio de 1997"
19,7,40,1672,426,412,838,"6 de julio de 1997"
19,7,40,1673,701,725,1426,"6 de julio de 1997"
19,7,40,1674,540,549,1089,"6 de julio de 1997"
19,7,40,1675,549,608,1157,"6 de julio de 1997"
19,7,40,1676,596,612,1208,"6 de julio de 1997"
19,7,40,1677,214,242,456,"6 de julio de 1997"
19,7,40,1678,372,374,746,"6 de julio de 1997"
19,7,40,1679,579,582,1161,"6 de julio de 1997"
19,7,40,1680,657,679,1336,"6 de julio de 1997"
19,7,40,1681,537,590,1127,"6 de julio de 1997"
19,7,40,1682,689,778,1467,"6 de julio de 1997"
19,7,40,1683,234,262,496,"6 de julio de 1997"
19,7,40,1684,400,425,825,"6 de julio de 1997"
19,7,40,1685,629,669,1298,"6 de julio de 1997"
19,7,40,1686,830,913,1743,"6 de julio de 1997"
19,7,40,1687,422,508,930,"6 de julio de 1997"
19,7,40,1688,256,264,520,"6 de julio de 1997"
19,7,40,1689,276,272,548,"6 de julio de 1997"
19,7,40,1690,438,458,896,"6 de julio de 1997"
19,7,40,1691,566,577,1143,"6 de julio de 1997"
19,7,40,1692,317,334,651,"6 de julio de 1997"
19,7,40,1693,226,232,458,"6 de julio de 1997"
19,7,40,1694,398,404,802,"6 de julio de 1997"
19,7,40,1695,310,368,678,"6 de julio de 1997"
19,7,40,1696,219,229,448,"6 de julio de 1997"
19,7,40,1697,576,627,1203,"6 de julio de 1997"
19,7,40,1698,295,323,618,"6 de julio de 1997"
19,7,40,1699,117,132,249,"6 de julio de 1997"
19,8,26,530,238,206,444,"6 de julio de 1997"
19,8,26,531,339,323,662,"6 de julio de 1997"
19,8,26,532,361,361,722,"6 de julio de 1997"
19,8,26,533,647,658,1305,"6 de julio de 1997"
19,8,26,534,343,373,716,"6 de julio de 1997"
19,8,26,535,577,622,1199,"6 de julio de 1997"
19,8,26,536,526,590,1116,"6 de julio de 1997"
19,8,26,537,871,951,1822,"6 de julio de 1997"
19,8,26,538,845,924,1769,"6 de julio de 1997"
19,8,26,539,757,806,1563,"6 de julio de 1997"
19,8,26,540,495,479,974,"6 de julio de 1997"
19,8,26,541,679,702,1381,"6 de julio de 1997"
19,8,26,542,594,576,1170,"6 de julio de 1997"
19,8,26,543,547,536,1083,"6 de julio de 1997"
19,8,26,544,843,847,1690,"6 de julio de 1997"
19,8,26,545,223,222,445,"6 de julio de 1997"
19,8,26,546,870,867,1737,"6 de julio de 1997"
19,8,26,547,365,374,739,"6 de julio de 1997"
19,8,26,548,815,795,1610,"6 de julio de 1997"
19,8,26,549,633,694,1327,"6 de julio de 1997"
19,8,26,550,441,450,891,"6 de julio de 1997"
19,8,26,551,479,547,1026,"6 de julio de 1997"
19,8,26,552,719,714,1433,"6 de julio de 1997"
19,8,26,553,367,419,786,"6 de julio de 1997"
19,8,26,554,699,770,1469,"6 de julio de 1997"
19,8,26,555,751,732,1483,"6 de julio de 1997"
19,8,26,556,589,682,1271,"6 de julio de 1997"
19,8,26,557,365,366,731,"6 de julio de 1997"
19,8,26,558,473,516,989,"6 de julio de 1997"
19,8,26,604,658,677,1335,"6 de julio de 1997"
19,8,26,605,550,582,1132,"6 de julio de 1997"
19,8,26,606,568,606,1174,"6 de julio de 1997"
19,8,26,607,1552,1683,3235,"6 de julio de 1997"
19,8,26,608,678,746,1424,"6 de julio de 1997"
19,8,26,609,661,659,1320,"6 de julio de 1997"
19,8,26,610,721,762,1483,"6 de julio de 1997"
19,8,26,611,746,786,1532,"6 de julio de 1997"
19,8,26,612,643,693,1336,"6 de julio de 1997"
19,8,26,613,671,686,1357,"6 de julio de 1997"
19,8,26,614,661,683,1344,"6 de julio de 1997"
19,8,26,615,707,713,1420,"6 de julio de 1997"
19,8,26,616,257,285,542,"6 de julio de 1997"
19,8,26,617,599,648,1247,"6 de julio de 1997"
19,8,26,618,544,586,1130,"6 de julio de 1997"
19,8,26,619,672,709,1381,"6 de julio de 1997"
19,8,26,620,506,482,988,"6 de julio de 1997"
19,8,26,621,953,967,1920,"6 de julio de 1997"
19,8,26,622,669,686,1355,"6 de julio de 1997"
19,8,26,623,1203,1238,2441,"6 de julio de 1997"
19,8,26,624,823,861,1684,"6 de julio de 1997"
19,8,26,625,873,940,1813,"6 de julio de 1997"
19,8,26,626,714,792,1506,"6 de julio de 1997"
19,8,26,627,644,693,1337,"6 de julio de 1997"
19,8,26,628,456,506,962,"6 de julio de 1997"
19,8,26,629,677,732,1409,"6 de julio de 1997"
19,8,26,630,701,759,1460,"6 de julio de 1997"
19,8,26,631,521,467,988,"6 de julio de 1997"
19,8,26,632,632,622,1254,"6 de julio de 1997"
19,8,26,633,487,504,991,"6 de julio de 1997"
19,8,26,634,539,584,1123,"6 de julio de 1997"
19,8,26,635,729,768,1497,"6 de julio de 1997"
19,8,26,636,771,739,1510,"6 de julio de 1997"
19,8,26,637,500,537,1037,"6 de julio de 1997"
19,8,26,638,446,538,984,"6 de julio de 1997"
19,8,26,639,511,554,1065,"6 de julio de 1997"
19,8,26,640,688,822,1510,"6 de julio de 1997"
19,8,26,641,826,836,1662,"6 de julio de 1997"
19,8,26,642,950,970,1920,"6 de julio de 1997"
19,8,26,643,977,970,1947,"6 de julio de 1997"
19,8,26,644,557,598,1155,"6 de julio de 1997"
19,8,26,645,620,640,1260,"6 de julio de 1997"
19,8,26,646,544,606,1150,"6 de julio de 1997"
19,8,26,647,612,649,1261,"6 de julio de 1997"
19,8,26,648,1099,1104,2203,"6 de julio de 1997"
19,8,26,649,637,623,1260,"6 de julio de 1997"
19,8,26,650,711,729,1440,"6 de julio de 1997"
19,8,26,651,572,592,1164,"6 de julio de 1997"
19,8,26,652,508,592,1100,"6 de julio de 1997"
19,8,26,653,747,742,1489,"6 de julio de 1997"
19,8,26,654,716,778,1494,"6 de julio de 1997"
19,8,26,655,541,620,1161,"6 de julio de 1997"
19,8,26,656,525,616,1141,"6 de julio de 1997"
19,8,26,657,322,344,666,"6 de julio de 1997"
19,8,26,658,307,388,695,"6 de julio de 1997"
19,8,26,659,378,423,801,"6 de julio de 1997"
19,8,26,660,394,498,892,"6 de julio de 1997"
19,8,26,661,529,622,1151,"6 de julio de 1997"
19,8,26,662,297,355,652,"6 de julio de 1997"
19,8,26,663,526,587,1113,"6 de julio de 1997"
19,8,26,664,514,584,1098,"6 de julio de 1997"
19,8,26,665,479,533,1012,"6 de julio de 1997"
19,8,26,666,427,501,928,"6 de julio de 1997"
19,8,26,667,776,755,1531,"6 de julio de 1997"
19,8,26,668,826,857,1683,"6 de julio de 1997"
19,8,26,669,682,746,1428,"6 de julio de 1997"
19,8,26,670,858,930,1788,"6 de julio de 1997"
19,8,26,671,953,1010,1963,"6 de julio de 1997"
19,8,26,672,891,907,1798,"6 de julio de 1997"
19,8,26,673,757,774,1531,"6 de julio de 1997"
19,8,26,674,850,886,1736,"6 de julio de 1997"
19,8,26,675,724,700,1424,"6 de julio de 1997"
19,8,26,676,702,708,1410,"6 de julio de 1997"
19,8,26,677,250,271,521,"6 de julio de 1997"
19,8,26,678,977,943,1920,"6 de julio de 1997"
19,8,26,679,876,886,1762,"6 de julio de 1997"
19,8,26,680,785,824,1609,"6 de julio de 1997"
19,8,26,681,529,560,1089,"6 de julio de 1997"
19,8,26,682,863,829,1692,"6 de julio de 1997"
19,8,26,683,851,852,1703,"6 de julio de 1997"
19,8,26,684,800,815,1615,"6 de julio de 1997"
19,8,26,685,651,711,1362,"6 de julio de 1997"
19,8,26,686,565,630,1195,"6 de julio de 1997"
19,8,26,687,602,600,1202,"6 de julio de 1997"
19,8,26,688,875,886,1761,"6 de julio de 1997"
19,8,26,689,928,984,1912,"6 de julio de 1997"
19,8,26,690,956,978,1934,"6 de julio de 1997"
19,8,26,691,794,844,1638,"6 de julio de 1997"
19,8,26,692,643,679,1322,"6 de julio de 1997"
19,8,26,693,734,769,1503,"6 de julio de 1997"
19,8,26,694,630,609,1239,"6 de julio de 1997"
19,8,26,695,804,818,1622,"6 de julio de 1997"
19,8,26,696,700,705,1405,"6 de julio de 1997"
19,8,26,697,765,814,1579,"6 de julio de 1997"
19,8,26,698,679,702,1381,"6 de julio de 1997"
19,8,26,699,1003,1026,2029,"6 de julio de 1997"
19,8,26,700,494,527,1021,"6 de julio de 1997"
19,8,26,701,469,502,971,"6 de julio de 1997"
19,8,26,702,471,500,971,"6 de julio de 1997"
19,8,26,703,1366,1518,2884,"6 de julio de 1997"
19,8,26,704,580,521,1101,"6 de julio de 1997"
19,8,26,705,818,811,1629,"6 de julio de 1997"
19,8,26,706,957,1039,1996,"6 de julio de 1997"
19,8,26,718,724,806,1530,"6 de julio de 1997"
19,8,26,719,711,731,1442,"6 de julio de 1997"
19,8,26,720,875,917,1792,"6 de julio de 1997"
19,9,4,20,605,575,1180,"6 de julio de 1997"
19,9,4,21,618,650,1268,"6 de julio de 1997"
19,9,4,22,585,584,1169,"6 de julio de 1997"
19,9,4,23,628,631,1259,"6 de julio de 1997"
19,9,4,24,327,348,675,"6 de julio de 1997"
19,9,4,25,465,515,980,"6 de julio de 1997"
19,9,4,26,425,424,849,"6 de julio de 1997"
19,9,4,27,484,506,990,"6 de julio de 1997"
19,9,4,28,529,537,1066,"6 de julio de 1997"
19,9,4,29,608,591,1199,"6 de julio de 1997"
19,9,4,30,625,678,1303,"6 de julio de 1997"
19,9,4,31,282,284,566,"6 de julio de 1997"
19,9,4,32,281,280,561,"6 de julio de 1997"
19,9,4,33,389,391,780,"6 de julio de 1997"
19,9,4,34,284,268,552,"6 de julio de 1997"
19,9,4,35,106,96,202,"6 de julio de 1997"
19,9,4,36,108,99,207,"6 de julio de 1997"
19,9,4,37,200,180,380,"6 de julio de 1997"
19,9,4,38,260,240,500,"6 de julio de 1997"
19,9,7,151,415,377,792,"6 de julio de 1997"
19,9,7,152,535,472,1007,"6 de julio de 1997"
19,9,7,153,205,147,352,"6 de julio de 1997"
19,9,7,154,160,107,267,"6 de julio de 1997"
19,9,7,155,253,179,432,"6 de julio de 1997"
19,9,7,156,292,291,583,"6 de julio de 1997"
19,9,7,157,247,250,497,"6 de julio de 1997"
19,9,7,158,289,277,566,"6 de julio de 1997"
19,9,7,159,102,62,164,"6 de julio de 1997"
19,9,7,160,236,175,411,"6 de julio de 1997"
19,9,7,161,318,261,579,"6 de julio de 1997"
19,9,7,162,354,281,635,"6 de julio de 1997"
19,9,7,163,201,159,360,"6 de julio de 1997"
19,9,7,164,177,131,308,"6 de julio de 1997"
19,9,7,165,288,245,533,"6 de julio de 1997"
19,9,7,166,211,188,399,"6 de julio de 1997"
19,9,7,167,120,104,224,"6 de julio de 1997"
19,9,14,257,294,262,556,"6 de julio de 1997"
19,9,14,258,572,612,1184,"6 de julio de 1997"
19,9,14,259,324,362,686,"6 de julio de 1997"
19,9,14,260,361,398,759,"6 de julio de 1997"
19,9,14,261,363,386,749,"6 de julio de 1997"
19,9,14,262,298,277,575,"6 de julio de 1997"
19,9,14,263,272,313,585,"6 de julio de 1997"
19,9,14,264,73,61,134,"6 de julio de 1997"
19,9,14,265,238,196,434,"6 de julio de 1997"
19,9,14,266,257,215,472,"6 de julio de 1997"
19,9,14,267,169,147,316,"6 de julio de 1997"
19,9,14,268,562,495,1057,"6 de julio de 1997"
19,9,14,269,257,231,488,"6 de julio de 1997"
19,9,14,270,288,229,517,"6 de julio de 1997"
19,9,14,271,466,381,847,"6 de julio de 1997"
19,9,14,272,266,230,496,"6 de julio de 1997"
19,9,14,273,201,170,371,"6 de julio de 1997"
19,9,14,274,273,203,476,"6 de julio de 1997"
19,9,14,275,341,296,637,"6 de julio de 1997"
19,9,14,276,399,357,756,"6 de julio de 1997"
19,9,14,277,321,292,613,"6 de julio de 1997"
19,9,14,278,112,99,211,"6 de julio de 1997"
19,9,14,279,226,184,410,"6 de julio de 1997"
19,9,14,280,176,156,332,"6 de julio de 1997"
19,9,14,281,112,96,208,"6 de julio de 1997"
19,9,14,282,252,241,493,"6 de julio de 1997"
19,9,14,283,271,228,499,"6 de julio de 1997"
19,9,14,284,163,138,301,"6 de julio de 1997"
19,9,14,285,120,122,242,"6 de julio de 1997"
19,9,14,286,167,222,389,"6 de julio de 1997"
19,9,14,287,198,189,387,"6 de julio de 1997"
19,9,14,288,246,240,486,"6 de julio de 1997"
19,9,14,289,198,156,354,"6 de julio de 1997"
19,9,14,290,178,141,319,"6 de julio de 1997"
19,9,14,291,264,229,493,"6 de julio de 1997"
19,9,14,292,309,275,584,"6 de julio de 1997"
19,9,14,293,100,77,177,"6 de julio de 1997"
19,9,17,309,563,633,1196,"6 de julio de 1997"
19,9,17,310,505,595,1100,"6 de julio de 1997"
19,9,17,311,483,555,1038,"6 de julio de 1997"
19,9,17,312,533,505,1038,"6 de julio de 1997"
19,9,17,313,351,259,610,"6 de julio de 1997"
19,9,17,314,98,93,191,"6 de julio de 1997"
19,9,17,315,233,163,396,"6 de julio de 1997"
19,9,17,316,479,334,813,"6 de julio de 1997"
19,9,17,317,394,267,661,"6 de julio de 1997"
19,9,17,318,308,313,621,"6 de julio de 1997"
19,9,17,319,378,288,666,"6 de julio de 1997"
19,9,17,320,458,403,861,"6 de julio de 1997"
19,9,17,321,441,422,863,"6 de julio de 1997"
19,9,17,322,418,414,832,"6 de julio de 1997"
19,9,17,323,340,240,580,"6 de julio de 1997"
19,9,17,324,138,125,263,"6 de julio de 1997"
19,9,17,325,357,297,654,"6 de julio de 1997"
19,9,17,326,587,468,1055,"6 de julio de 1997"
19,9,17,327,228,179,407,"6 de julio de 1997"
19,9,17,328,492,446,938,"6 de julio de 1997"
19,9,17,329,448,360,808,"6 de julio de 1997"
19,9,17,330,117,77,194,"6 de julio de 1997"
19,9,17,331,216,147,363,"6 de julio de 1997"
19,9,17,332,286,200,486,"6 de julio de 1997"
19,9,17,333,106,79,185,"6 de julio de 1997"
19,9,17,334,316,247,563,"6 de julio de 1997"
19,9,17,335,173,153,326,"6 de julio de 1997"
19,9,17,336,218,215,433,"6 de julio de 1997"
19,9,17,337,73,77,150,"6 de julio de 1997"
19,9,17,338,130,104,234,"6 de julio de 1997"
19,9,17,339,104,92,196,"6 de julio de 1997"
19,9,17,340,371,325,696,"6 de julio de 1997"
19,9,17,341,145,109,254,"6 de julio de 1997"
19,9,17,342,448,401,849,"6 de julio de 1997"
19,9,17,343,566,514,1080,"6 de julio de 1997"
19,9,17,344,102,88,190,"6 de julio de 1997"
19,9,17,345,397,278,675,"6 de julio de 1997"
19,9,22,494,555,666,1221,"6 de julio de 1997"
19,9,22,495,581,606,1187,"6 de julio de 1997"
19,9,22,496,441,480,921,"6 de julio de 1997"
19,9,22,497,448,454,902,"6 de julio de 1997"
19,9,22,498,68,69,137,"6 de julio de 1997"
19,9,22,499,49,47,96,"6 de julio de 1997"
19,9,22,500,22,9,31,"6 de julio de 1997"
19,9,22,501,25,18,43,"6 de julio de 1997"
19,9,22,502,326,311,637,"6 de julio de 1997"
19,9,22,503,259,209,468,"6 de julio de 1997"
19,9,22,504,150,136,286,"6 de julio de 1997"
19,9,22,505,363,347,710,"6 de julio de 1997"
19,9,22,506,218,210,428,"6 de julio de 1997"
19,9,22,507,309,287,596,"6 de julio de 1997"
19,9,22,508,361,349,710,"6 de julio de 1997"
19,9,22,509,348,298,646,"6 de julio de 1997"
19,9,22,510,44,34,78,"6 de julio de 1997"
19,9,22,511,42,29,71,"6 de julio de 1997"
19,9,22,512,41,33,74,"6 de julio de 1997"
19,9,22,513,147,140,287,"6 de julio de 1997"
19,9,22,514,224,224,448,"6 de julio de 1997"
19,9,24,518,387,361,748,"6 de julio de 1997"
19,9,24,519,534,454,988,"6 de julio de 1997"
19,9,24,520,113,75,188,"6 de julio de 1997"
19,9,24,521,125,81,206,"6 de julio de 1997"
19,9,24,522,342,246,588,"6 de julio de 1997"
19,9,30,822,302,324,626,"6 de julio de 1997"
19,9,30,823,334,363,697,"6 de julio de 1997"
19,9,30,824,273,291,564,"6 de julio de 1997"
19,9,30,825,294,314,608,"6 de julio de 1997"
19,9,30,826,436,464,900,"6 de julio de 1997"
19,9,30,827,192,167,359,"6 de julio de 1997"
19,9,30,828,107,90,197,"6 de julio de 1997"
19,9,30,829,56,55,111,"6 de julio de 1997"
19,9,30,830,50,43,93,"6 de julio de 1997"
19,9,31,831,468,425,893,"6 de julio de 1997"
19,9,31,832,308,344,652,"6 de julio de 1997"
19,9,31,833,139,101,240,"6 de julio de 1997"
19,9,31,834,215,168,383,"6 de julio de 1997"
19,9,32,835,800,865,1665,"6 de julio de 1997"
19,9,32,836,780,780,1560,"6 de julio de 1997"
19,9,32,837,413,457,870,"6 de julio de 1997"
19,9,32,838,705,670,1375,"6 de julio de 1997"
19,9,32,839,472,496,968,"6 de julio de 1997"
19,9,32,840,359,310,669,"6 de julio de 1997"
19,9,32,841,976,994,1970,"6 de julio de 1997"
19,9,32,842,530,562,1092,"6 de julio de 1997"
19,9,32,843,235,239,474,"6 de julio de 1997"
19,9,32,844,741,807,1548,"6 de julio de 1997"
19,9,32,845,1159,1247,2406,"6 de julio de 1997"
19,9,32,846,520,538,1058,"6 de julio de 1997"
19,9,32,847,466,493,959,"6 de julio de 1997"
19,9,32,848,76,72,148,"6 de julio de 1997"
19,9,32,849,274,298,572,"6 de julio de 1997"
19,9,32,850,988,1170,2158,"6 de julio de 1997"
19,9,32,851,186,135,321,"6 de julio de 1997"
19,9,32,852,59,53,112,"6 de julio de 1997"
19,9,32,853,116,98,214,"6 de julio de 1997"
19,9,34,860,360,392,752,"6 de julio de 1997"
19,9,34,861,455,474,929,"6 de julio de 1997"
19,9,34,862,461,509,970,"6 de julio de 1997"
19,9,34,863,827,830,1657,"6 de julio de 1997"
19,9,34,864,726,832,1558,"6 de julio de 1997"
19,9,34,865,949,998,1947,"6 de julio de 1997"
19,9,34,866,851,894,1745,"6 de julio de 1997"
19,9,34,867,514,557,1071,"6 de julio de 1997"
19,9,34,868,331,383,714,"6 de julio de 1997"
19,9,34,869,568,643,1211,"6 de julio de 1997"
19,9,34,870,172,147,319,"6 de julio de 1997"
19,9,34,871,669,804,1473,"6 de julio de 1997"
19,9,34,872,551,616,1167,"6 de julio de 1997"
19,9,34,873,557,708,1265,"6 de julio de 1997"
19,9,34,874,275,289,564,"6 de julio de 1997"
19,9,34,875,351,396,747,"6 de julio de 1997"
19,9,34,876,572,664,1236,"6 de julio de 1997"
19,9,34,877,251,277,528,"6 de julio de 1997"
19,9,34,878,284,335,619,"6 de julio de 1997"
19,9,34,879,561,619,1180,"6 de julio de 1997"
19,9,34,880,418,470,888,"6 de julio de 1997"
19,9,34,881,574,607,1181,"6 de julio de 1997"
19,9,34,882,472,449,921,"6 de julio de 1997"
19,9,34,883,425,429,854,"6 de julio de 1997"
19,9,34,884,454,511,965,"6 de julio de 1997"
19,9,34,885,413,447,860,"6 de julio de 1997"
19,9,34,886,792,834,1626,"6 de julio de 1997"
19,9,34,887,564,587,1151,"6 de julio de 1997"
19,9,34,888,425,370,795,"6 de julio de 1997"
19,9,34,889,341,325,666,"6 de julio de 1997"
19,9,34,890,82,66,148,"6 de julio de 1997"
19,9,34,891,122,84,206,"6 de julio de 1997"
19,9,34,892,222,168,390,"6 de julio de 1997"
19,9,34,893,174,142,316,"6 de julio de 1997"
19,9,34,894,142,119,261,"6 de julio de 1997"
19,9,34,895,257,233,490,"6 de julio de 1997"
19,9,34,896,149,116,265,"6 de julio de 1997"
19,9,34,897,593,502,1095,"6 de julio de 1997"
19,9,34,898,441,400,841,"6 de julio de 1997"
19,9,34,899,212,165,377,"6 de julio de 1997"
19,9,34,900,277,214,491,"6 de julio de 1997"
19,9,34,901,231,191,422,"6 de julio de 1997"
19,9,34,902,630,541,1171,"6 de julio de 1997"
19,9,34,903,136,128,264,"6 de julio de 1997"
19,9,34,904,207,185,392,"6 de julio de 1997"
19,9,34,905,21,27,48,"6 de julio de 1997"
19,9,34,906,220,163,383,"6 de julio de 1997"
19,9,34,907,428,319,747,"6 de julio de 1997"
19,9,37,913,299,297,596,"6 de julio de 1997"
19,9,37,914,159,174,333,"6 de julio de 1997"
19,9,37,915,260,247,507,"6 de julio de 1997"
19,9,37,916,107,113,220,"6 de julio de 1997"
19,9,37,917,257,220,477,"6 de julio de 1997"
19,9,37,918,147,143,290,"6 de julio de 1997"
19,9,37,919,319,262,581,"6 de julio de 1997"
19,9,37,920,176,167,343,"6 de julio de 1997"
19,9,37,921,40,50,90,"6 de julio de 1997"
19,9,37,922,71,60,131,"6 de julio de 1997"
19,9,37,923,31,26,57,"6 de julio de 1997"
19,9,39,931,643,613,1256,"6 de julio de 1997"
19,9,39,932,475,559,1034,"6 de julio de 1997"
19,9,39,933,717,773,1490,"6 de julio de 1997"
19,9,39,934,531,604,1135,"6 de julio de 1997"
19,9,39,935,589,618,1207,"6 de julio de 1997"
19,9,39,936,446,494,940,"6 de julio de 1997"
19,9,39,937,385,484,869,"6 de julio de 1997"
19,9,39,938,678,716,1394,"6 de julio de 1997"
19,9,39,939,1072,1134,2206,"6 de julio de 1997"
19,9,39,940,581,602,1183,"6 de julio de 1997"
19,9,39,941,514,553,1067,"6 de julio de 1997"
19,9,39,942,547,573,1120,"6 de julio de 1997"
19,9,39,943,137,178,315,"6 de julio de 1997"
19,9,39,944,541,570,1111,"6 de julio de 1997"
19,9,39,945,319,322,641,"6 de julio de 1997"
19,9,39,946,399,394,793,"6 de julio de 1997"
19,9,39,947,484,471,955,"6 de julio de 1997"
19,9,39,948,617,608,1225,"6 de julio de 1997"
19,9,39,949,439,448,887,"6 de julio de 1997"
19,9,39,950,536,624,1160,"6 de julio de 1997"
19,9,39,951,705,745,1450,"6 de julio de 1997"
19,9,39,952,513,513,1026,"6 de julio de 1997"
19,9,39,953,136,110,246,"6 de julio de 1997"
19,9,39,954,305,285,590,"6 de julio de 1997"
19,9,39,955,11,13,24,"6 de julio de 1997"
19,9,39,956,182,146,328,"6 de julio de 1997"
19,9,39,957,103,75,178,"6 de julio de 1997"
19,9,39,958,308,260,568,"6 de julio de 1997"
19,9,39,959,50,42,92,"6 de julio de 1997"
19,9,39,960,136,100,236,"6 de julio de 1997"
19,9,39,961,285,242,527,"6 de julio de 1997"
19,9,39,962,178,169,347,"6 de julio de 1997"
19,9,39,963,602,568,1170,"6 de julio de 1997"
19,9,39,964,485,471,956,"6 de julio de 1997"
19,9,39,965,306,286,592,"6 de julio de 1997"
19,9,39,966,98,101,199,"6 de julio de 1997"
19,9,39,967,65,54,119,"6 de julio de 1997"
19,9,39,968,83,48,131,"6 de julio de 1997"
19,9,39,969,246,203,449,"6 de julio de 1997"
19,9,39,970,108,89,197,"6 de julio de 1997"
19,9,39,971,160,126,286,"6 de julio de 1997"
19,9,39,972,134,120,254,"6 de julio de 1997"
19,9,39,973,177,140,317,"6 de julio de 1997"
19,9,39,974,35,19,54,"6 de julio de 1997"
19,9,44,1724,370,319,689,"6 de julio de 1997"
19,9,44,1725,255,205,460,"6 de julio de 1997"
19,9,44,1726,136,87,223,"6 de julio de 1997"
19,9,44,1727,139,97,236,"6 de julio de 1997"
19,9,44,1728,135,99,234,"6 de julio de 1997"
19,9,49,2086,765,750,1515,"6 de julio de 1997"
19,9,49,2087,622,655,1277,"6 de julio de 1997"
19,9,49,2088,554,568,1122,"6 de julio de 1997"
19,9,49,2089,597,617,1214,"6 de julio de 1997"
19,9,49,2090,334,395,729,"6 de julio de 1997"
19,9,49,2091,490,519,1009,"6 de julio de 1997"
19,9,49,2092,550,547,1097,"6 de julio de 1997"
19,9,49,2093,360,371,731,"6 de julio de 1997"
19,9,49,2094,535,483,1018,"6 de julio de 1997"
19,9,49,2095,753,747,1500,"6 de julio de 1997"
19,9,49,2096,566,553,1119,"6 de julio de 1997"
19,9,49,2097,629,615,1244,"6 de julio de 1997"
19,9,49,2098,667,627,1294,"6 de julio de 1997"
19,9,49,2099,603,585,1188,"6 de julio de 1997"
19,9,49,2100,48,43,91,"6 de julio de 1997"
19,9,49,2101,652,558,1210,"6 de julio de 1997"
19,9,49,2102,208,216,424,"6 de julio de 1997"
19,9,49,2103,433,398,831,"6 de julio de 1997"
19,9,49,2104,464,426,890,"6 de julio de 1997"
19,9,49,2105,541,513,1054,"6 de julio de 1997"
19,9,49,2106,102,86,188,"6 de julio de 1997"
19,9,49,2107,40,18,58,"6 de julio de 1997"
19,9,49,2108,101,74,175,"6 de julio de 1997"
19,9,49,2109,291,209,500,"6 de julio de 1997"
19,9,49,2110,167,120,287,"6 de julio de 1997"
19,10,40,1263,224,232,456,"6 de julio de 1997"
19,10,40,1264,254,289,543,"6 de julio de 1997"
19,10,40,1265,41,51,92,"6 de julio de 1997"
19,10,40,1266,232,253,485,"6 de julio de 1997"
19,10,40,1267,345,392,737,"6 de julio de 1997"
19,10,40,1268,122,162,284,"6 de julio de 1997"
19,10,40,1269,198,230,428,"6 de julio de 1997"
19,10,40,1270,165,209,374,"6 de julio de 1997"
19,10,40,1271,118,140,258,"6 de julio de 1997"
19,10,40,1272,123,156,279,"6 de julio de 1997"
19,10,40,1273,147,154,301,"6 de julio de 1997"
19,10,40,1274,315,333,648,"6 de julio de 1997"
19,10,40,1275,302,310,612,"6 de julio de 1997"
19,10,40,1276,176,200,376,"6 de julio de 1997"
19,10,40,1277,197,233,430,"6 de julio de 1997"
19,10,40,1278,169,211,380,"6 de julio de 1997"
19,10,40,1279,189,216,405,"6 de julio de 1997"
19,10,40,1280,93,88,181,"6 de julio de 1997"
19,10,40,1281,315,325,640,"6 de julio de 1997"
19,10,40,1282,214,243,457,"6 de julio de 1997"
19,10,40,1283,93,122,215,"6 de julio de 1997"
19,10,40,1284,253,284,537,"6 de julio de 1997"
19,10,40,1285,506,634,1140,"6 de julio de 1997"
19,10,40,1286,425,536,961,"6 de julio de 1997"
19,10,40,1287,148,208,356,"6 de julio de 1997"
19,10,40,1288,365,368,733,"6 de julio de 1997"
19,10,40,1289,427,453,880,"6 de julio de 1997"
19,10,40,1290,266,284,550,"6 de julio de 1997"
19,10,40,1291,369,406,775,"6 de julio de 1997"
19,10,40,1292,668,706,1374,"6 de julio de 1997"
19,10,40,1293,299,308,607,"6 de julio de 1997"
19,10,40,1294,365,444,809,"6 de julio de 1997"
19,10,40,1295,243,264,507,"6 de julio de 1997"
19,10,40,1296,381,418,799,"6 de julio de 1997"
19,10,40,1297,227,260,487,"6 de julio de 1997"
19,10,40,1298,224,244,468,"6 de julio de 1997"
19,10,40,1299,624,694,1318,"6 de julio de 1997"
19,10,40,1300,326,395,721,"6 de julio de 1997"
19,10,40,1301,387,423,810,"6 de julio de 1997"
19,10,40,1302,304,273,577,"6 de julio de 1997"
19,10,40,1303,225,229,454,"6 de julio de 1997"
19,10,40,1304,439,478,917,"6 de julio de 1997"
19,10,40,1305,467,455,922,"6 de julio de 1997"
19,10,40,1306,299,297,596,"6 de julio de 1997"
19,10,40,1307,692,772,1464,"6 de julio de 1997"
19,10,40,1308,343,369,712,"6 de julio de 1997"
19,10,40,1309,517,617,1134,"6 de julio de 1997"
19,10,40,1310,717,742,1459,"6 de julio de 1997"
19,10,40,1311,421,471,892,"6 de julio de 1997"
19,10,40,1312,580,631,1211,"6 de julio de 1997"
19,10,40,1313,432,404,836,"6 de julio de 1997"
19,10,40,1314,636,643,1279,"6 de julio de 1997"
19,10,40,1315,657,774,1431,"6 de julio de 1997"
19,10,40,1316,642,711,1353,"6 de julio de 1997"
19,10,40,1317,304,351,655,"6 de julio de 1997"
19,10,40,1318,528,659,1187,"6 de julio de 1997"
19,10,40,1319,441,470,911,"6 de julio de 1997"
19,10,40,1320,394,409,803,"6 de julio de 1997"
19,10,40,1321,349,338,687,"6 de julio de 1997"
19,10,40,1322,231,241,472,"6 de julio de 1997"
19,10,40,1323,191,201,392,"6 de julio de 1997"
19,10,40,1324,246,252,498,"6 de julio de 1997"
19,10,40,1325,426,446,872,"6 de julio de 1997"
19,10,40,1326,727,839,1566,"6 de julio de 1997"
19,10,40,1327,318,298,616,"6 de julio de 1997"
19,10,40,1328,176,189,365,"6 de julio de 1997"
19,10,40,1329,638,773,1411,"6 de julio de 1997"
19,10,40,1330,566,612,1178,"6 de julio de 1997"
19,10,40,1331,815,878,1693,"6 de julio de 1997"
19,10,40,1332,777,826,1603,"6 de julio de 1997"
19,10,40,1333,781,865,1646,"6 de julio de 1997"
19,10,40,1334,738,911,1649,"6 de julio de 1997"
19,10,40,1335,567,628,1195,"6 de julio de 1997"
19,10,40,1336,781,841,1622,"6 de julio de 1997"
19,10,40,1337,445,485,930,"6 de julio de 1997"
19,10,40,1338,600,708,1308,"6 de julio de 1997"
19,10,40,1339,463,478,941,"6 de julio de 1997"
19,10,40,1340,184,223,407,"6 de julio de 1997"
19,10,40,1341,317,364,681,"6 de julio de 1997"
19,10,40,1342,427,468,895,"6 de julio de 1997"
19,10,40,1343,497,530,1027,"6 de julio de 1997"
19,10,40,1344,354,357,711,"6 de julio de 1997"
19,10,40,1345,320,383,703,"6 de julio de 1997"
19,10,40,1346,613,620,1233,"6 de julio de 1997"
19,10,40,1347,507,411,918,"6 de julio de 1997"
19,10,40,1348,337,298,635,"6 de julio de 1997"
19,10,40,1349,349,389,738,"6 de julio de 1997"
19,10,40,1350,726,790,1516,"6 de julio de 1997"
19,10,40,1351,686,724,1410,"6 de julio de 1997"
19,10,40,1352,737,858,1595,"6 de julio de 1997"
19,10,40,1353,507,550,1057,"6 de julio de 1997"
19,10,40,1354,459,520,979,"6 de julio de 1997"
19,10,40,1355,841,846,1687,"6 de julio de 1997"
19,10,40,1356,1032,998,2030,"6 de julio de 1997"
19,10,40,1357,685,758,1443,"6 de julio de 1997"
19,10,40,1358,784,840,1624,"6 de julio de 1997"
19,10,40,1359,787,852,1639,"6 de julio de 1997"
19,10,40,1360,683,766,1449,"6 de julio de 1997"
19,10,40,1361,410,463,873,"6 de julio de 1997"
19,10,40,1362,483,505,988,"6 de julio de 1997"
19,10,40,1363,470,502,972,"6 de julio de 1997"
19,10,40,1364,734,847,1581,"6 de julio de 1997"
19,10,40,1365,666,723,1389,"6 de julio de 1997"
19,10,40,1366,527,545,1072,"6 de julio de 1997"
19,10,40,1367,483,570,1053,"6 de julio de 1997"
19,10,40,1368,474,536,1010,"6 de julio de 1997"
19,10,40,1369,524,571,1095,"6 de julio de 1997"
19,10,40,1370,391,384,775,"6 de julio de 1997"
19,10,40,1371,532,545,1077,"6 de julio de 1997"
19,10,40,1372,468,553,1021,"6 de julio de 1997"
19,10,40,1373,525,530,1055,"6 de julio de 1997"
19,10,40,1374,569,614,1183,"6 de julio de 1997"
19,10,40,1375,613,610,1223,"6 de julio de 1997"
19,10,40,1376,838,868,1706,"6 de julio de 1997"
19,10,40,1377,439,510,949,"6 de julio de 1997"
19,10,40,1378,495,489,984,"6 de julio de 1997"
19,10,40,1379,405,412,817,"6 de julio de 1997"
19,10,40,1380,639,671,1310,"6 de julio de 1997"
19,10,40,1381,457,494,951,"6 de julio de 1997"
19,10,40,1382,780,831,1611,"6 de julio de 1997"
19,10,40,1383,666,674,1340,"6 de julio de 1997"
19,10,40,1384,473,507,980,"6 de julio de 1997"
19,10,40,1385,780,813,1593,"6 de julio de 1997"
19,10,40,1386,625,629,1254,"6 de julio de 1997"
19,10,40,1387,554,604,1158,"6 de julio de 1997"
19,10,40,1388,660,743,1403,"6 de julio de 1997"
19,10,40,1389,708,720,1428,"6 de julio de 1997"
19,10,40,1390,551,606,1157,"6 de julio de 1997"
19,10,40,1391,575,651,1226,"6 de julio de 1997"
19,10,40,1392,580,670,1250,"6 de julio de 1997"
19,10,40,1393,951,953,1904,"6 de julio de 1997"
19,10,40,1394,830,857,1687,"6 de julio de 1997"
19,10,40,1395,422,388,810,"6 de julio de 1997"
19,10,40,1396,544,610,1154,"6 de julio de 1997"
19,10,40,1397,663,613,1276,"6 de julio de 1997"
19,10,40,1398,674,660,1334,"6 de julio de 1997"
19,10,40,1399,825,816,1641,"6 de julio de 1997"
19,10,40,1400,858,921,1779,"6 de julio de 1997"
19,10,40,1401,716,747,1463,"6 de julio de 1997"
19,10,40,1402,791,738,1529,"6 de julio de 1997"
19,10,40,1403,302,328,630,"6 de julio de 1997"
19,10,40,1404,808,807,1615,"6 de julio de 1997"
19,10,40,1405,570,638,1208,"6 de julio de 1997"
19,10,40,1406,527,539,1066,"6 de julio de 1997"
19,10,40,1407,383,406,789,"6 de julio de 1997"
19,10,40,1408,654,692,1346,"6 de julio de 1997"
19,10,40,1409,961,1023,1984,"6 de julio de 1997"
19,10,40,1410,743,823,1566,"6 de julio de 1997"
19,10,40,1411,621,703,1324,"6 de julio de 1997"
19,10,40,1412,756,821,1577,"6 de julio de 1997"
19,10,40,1413,920,993,1913,"6 de julio de 1997"
19,10,40,1414,744,820,1564,"6 de julio de 1997"
19,10,40,1415,514,551,1065,"6 de julio de 1997"
19,10,40,1416,635,690,1325,"6 de julio de 1997"
19,10,40,1417,567,661,1228,"6 de julio de 1997"
19,10,40,1418,794,864,1658,"6 de julio de 1997"
19,10,40,1419,331,354,685,"6 de julio de 1997"
19,10,40,1420,526,590,1116,"6 de julio de 1997"
19,10,40,1421,594,584,1178,"6 de julio de 1997"
19,10,40,1422,558,542,1100,"6 de julio de 1997"
19,10,40,1423,523,513,1036,"6 de julio de 1997"
19,10,40,1424,489,493,982,"6 de julio de 1997"
19,10,40,1425,437,458,895,"6 de julio de 1997"
19,10,40,1426,356,367,723,"6 de julio de 1997"
19,10,40,1427,414,420,834,"6 de julio de 1997"
19,10,40,1428,537,569,1106,"6 de julio de 1997"
19,10,40,1429,354,388,742,"6 de julio de 1997"
19,10,40,1430,40,45,85,"6 de julio de 1997"
19,10,40,1431,293,321,614,"6 de julio de 1997"
19,11,26,526,181,182,363,"6 de julio de 1997"
19,11,26,527,352,368,720,"6 de julio de 1997"
19,11,26,528,460,473,933,"6 de julio de 1997"
19,11,26,529,248,248,496,"6 de julio de 1997"
19,11,26,559,345,357,702,"6 de julio de 1997"
19,11,26,560,776,905,1681,"6 de julio de 1997"
19,11,26,561,332,335,667,"6 de julio de 1997"
19,11,26,562,379,362,741,"6 de julio de 1997"
19,11,26,563,410,453,863,"6 de julio de 1997"
19,11,26,564,344,386,730,"6 de julio de 1997"
19,11,26,565,314,354,668,"6 de julio de 1997"
19,11,26,566,296,301,597,"6 de julio de 1997"
19,11,26,567,286,316,602,"6 de julio de 1997"
19,11,26,568,606,637,1243,"6 de julio de 1997"
19,11,26,569,534,575,1109,"6 de julio de 1997"
19,11,26,570,472,499,971,"6 de julio de 1997"
19,11,26,571,621,662,1283,"6 de julio de 1997"
19,11,26,572,437,467,904,"6 de julio de 1997"
19,11,26,573,344,357,701,"6 de julio de 1997"
19,11,26,574,284,347,631,"6 de julio de 1997"
19,11,26,575,300,343,643,"6 de julio de 1997"
19,11,26,576,644,637,1281,"6 de julio de 1997"
19,11,26,577,779,854,1633,"6 de julio de 1997"
19,11,26,578,611,637,1248,"6 de julio de 1997"
19,11,26,579,442,436,878,"6 de julio de 1997"
19,11,26,580,186,186,372,"6 de julio de 1997"
19,11,26,581,826,938,1764,"6 de julio de 1997"
19,11,26,582,776,797,1573,"6 de julio de 1997"
19,11,26,583,913,932,1845,"6 de julio de 1997"
19,11,26,584,936,1001,1937,"6 de julio de 1997"
19,11,26,585,616,645,1261,"6 de julio de 1997"
19,11,26,586,760,811,1571,"6 de julio de 1997"
19,11,26,587,649,661,1310,"6 de julio de 1997"
19,11,26,588,414,480,894,"6 de julio de 1997"
19,11,26,589,157,169,326,"6 de julio de 1997"
19,11,26,590,589,658,1247,"6 de julio de 1997"
19,11,26,591,213,255,468,"6 de julio de 1997"
19,11,26,592,554,609,1163,"6 de julio de 1997"
19,11,26,593,682,771,1453,"6 de julio de 1997"
19,11,26,594,811,875,1686,"6 de julio de 1997"
19,11,26,595,691,715,1406,"6 de julio de 1997"
19,11,26,596,853,903,1756,"6 de julio de 1997"
19,11,26,597,842,852,1694,"6 de julio de 1997"
19,11,26,598,693,802,1495,"6 de julio de 1997"
19,11,26,599,505,542,1047,"6 de julio de 1997"
19,11,26,600,822,915,1737,"6 de julio de 1997"
19,11,26,601,799,913,1712,"6 de julio de 1997"
19,11,26,602,909,889,1798,"6 de julio de 1997"
19,11,26,603,764,791,1555,"6 de julio de 1997"
19,11,26,707,542,521,1063,"6 de julio de 1997"
19,11,26,708,453,443,896,"6 de julio de 1997"
19,11,26,709,622,668,1290,"6 de julio de 1997"
19,11,26,710,426,469,895,"6 de julio de 1997"
19,11,26,711,582,622,1204,"6 de julio de 1997"
19,11,26,712,994,1063,2057,"6 de julio de 1997"
19,11,26,713,885,897,1782,"6 de julio de 1997"
19,11,26,714,706,749,1455,"6 de julio de 1997"
19,11,26,715,693,660,1353,"6 de julio de 1997"
19,11,26,716,593,596,1189,"6 de julio de 1997"
19,11,26,717,640,669,1309,"6 de julio de 1997"
19,11,26,721,747,766,1513,"6 de julio de 1997"
19,11,26,722,939,941,1880,"6 de julio de 1997"
19,11,26,723,864,850,1714,"6 de julio de 1997"
19,11,26,724,718,769,1487,"6 de julio de 1997"
19,11,26,725,677,669,1346,"6 de julio de 1997"
19,11,26,726,742,747,1489,"6 de julio de 1997"
19,11,26,727,675,697,1372,"6 de julio de 1997"
19,11,26,728,825,855,1680,"6 de julio de 1997"
19,11,26,729,919,955,1874,"6 de julio de 1997"
19,11,26,730,797,854,1651,"6 de julio de 1997"
19,11,26,731,624,687,1311,"6 de julio de 1997"
19,11,26,732,820,869,1689,"6 de julio de 1997"
19,11,26,733,748,779,1527,"6 de julio de 1997"
19,11,26,734,1065,1086,2151,"6 de julio de 1997"
19,11,26,735,794,795,1589,"6 de julio de 1997"
19,11,26,736,612,615,1227,"6 de julio de 1997"
19,11,26,737,647,678,1325,"6 de julio de 1997"
19,11,26,738,575,641,1216,"6 de julio de 1997"
19,11,26,739,1134,1245,2379,"6 de julio de 1997"
19,11,26,740,497,498,995,"6 de julio de 1997"
19,11,26,741,953,915,1868,"6 de julio de 1997"
19,11,26,742,1260,1321,2581,"6 de julio de 1997"
19,11,26,743,431,472,903,"6 de julio de 1997"
19,11,26,744,738,766,1504,"6 de julio de 1997"
19,11,26,745,469,556,1025,"6 de julio de 1997"
19,11,26,746,521,613,1134,"6 de julio de 1997"
19,11,26,747,541,569,1110,"6 de julio de 1997"
19,11,26,748,448,525,973,"6 de julio de 1997"
19,11,26,749,550,585,1135,"6 de julio de 1997"
19,11,26,750,675,733,1408,"6 de julio de 1997"
19,11,26,751,728,792,1520,"6 de julio de 1997"
19,11,26,752,664,715,1379,"6 de julio de 1997"
19,11,26,753,956,948,1904,"6 de julio de 1997"
19,11,26,754,818,851,1669,"6 de julio de 1997"
19,11,26,755,1040,1099,2139,"6 de julio de 1997"
19,11,26,756,648,695,1343,"6 de julio de 1997"
19,11,26,757,722,748,1470,"6 de julio de 1997"
19,11,26,758,746,768,1514,"6 de julio de 1997"
19,11,26,759,1133,1201,2334,"6 de julio de 1997"
19,11,26,760,655,670,1325,"6 de julio de 1997"
19,11,26,761,417,444,861,"6 de julio de 1997"
19,11,26,762,494,530,1024,"6 de julio de 1997"
19,11,26,763,785,799,1584,"6 de julio de 1997"
19,11,26,764,868,887,1755,"6 de julio de 1997"
19,11,26,765,870,918,1788,"6 de julio de 1997"
19,11,26,766,961,969,1930,"6 de julio de 1997"
19,11,26,767,1100,1080,2180,"6 de julio de 1997"
19,11,26,768,790,810,1600,"6 de julio de 1997"
19,11,26,769,662,711,1373,"6 de julio de 1997"
19,11,26,770,895,913,1808,"6 de julio de 1997"
19,11,26,771,927,891,1818,"6 de julio de 1997"
19,11,26,772,690,693,1383,"6 de julio de 1997"
19,11,26,773,998,993,1991,"6 de julio de 1997"
19,11,26,774,557,546,1103,"6 de julio de 1997"
19,11,26,775,660,676,1336,"6 de julio de 1997"
19,11,26,776,1035,1047,2082,"6 de julio de 1997"
19,11,26,777,857,897,1754,"6 de julio de 1997"
19,11,26,778,452,500,952,"6 de julio de 1997"
19,11,26,779,869,895,1764,"6 de julio de 1997"
19,11,26,780,707,714,1421,"6 de julio de 1997"
19,11,26,781,442,494,936,"6 de julio de 1997"
19,11,26,782,591,648,1239,"6 de julio de 1997"
19,11,26,783,849,898,1747,"6 de julio de 1997"
19,11,26,784,562,600,1162,"6 de julio de 1997"
19,11,26,785,845,888,1733,"6 de julio de 1997"
19,11,26,786,689,706,1395,"6 de julio de 1997"
19,11,26,787,661,704,1365,"6 de julio de 1997"
19,11,26,788,751,777,1528,"6 de julio de 1997"
19,11,26,789,662,709,1371,"6 de julio de 1997"
19,11,26,790,895,884,1779,"6 de julio de 1997"
19,11,26,791,924,899,1823,"6 de julio de 1997"
19,11,26,792,910,939,1849,"6 de julio de 1997"
19,11,26,793,688,735,1423,"6 de julio de 1997"
19,11,26,794,659,686,1345,"6 de julio de 1997"
19,11,26,795,676,735,1411,"6 de julio de 1997"
19,11,26,796,610,649,1259,"6 de julio de 1997"
19,11,26,797,545,560,1105,"6 de julio de 1997"
19,11,26,798,281,331,612,"6 de julio de 1997"
19,11,26,799,745,788,1533,"6 de julio de 1997"
19,11,26,800,931,1049,1980,"6 de julio de 1997"
19,11,26,801,600,638,1238,"6 de julio de 1997"
19,11,26,802,516,547,1063,"6 de julio de 1997"
19,11,26,803,745,798,1543,"6 de julio de 1997"
19,11,26,804,574,629,1203,"6 de julio de 1997"
20,1,2,2,287,296,583,"6 de julio de 1997"
20,1,2,3,530,609,1139,"6 de julio de 1997"
20,1,2,4,450,511,961,"6 de julio de 1997"
20,1,2,5,331,318,649,"6 de julio de 1997"
20,1,2,6,592,632,1224,"6 de julio de 1997"
20,1,2,7,345,314,659,"6 de julio de 1997"
20,1,2,8,231,228,459,"6 de julio de 1997"
20,1,2,9,344,391,735,"6 de julio de 1997"
20,1,2,10,470,547,1017,"6 de julio de 1997"
20,1,2,11,544,572,1116,"6 de julio de 1997"
20,1,2,12,527,572,1099,"6 de julio de 1997"
20,1,2,13,258,241,499,"6 de julio de 1997"
20,1,2,14,308,248,556,"6 de julio de 1997"
20,1,2,15,328,271,599,"6 de julio de 1997"
20,1,2,16,135,111,246,"6 de julio de 1997"
20,1,2,17,439,488,927,"6 de julio de 1997"
20,1,2,18,183,173,356,"6 de julio de 1997"
20,1,2,19,201,213,414,"6 de julio de 1997"
20,1,2,20,248,252,500,"6 de julio de 1997"
20,1,2,21,441,388,829,"6 de julio de 1997"
20,1,2,22,226,203,429,"6 de julio de 1997"
20,1,2,23,240,261,501,"6 de julio de 1997"
20,1,2,24,463,404,867,"6 de julio de 1997"
20,1,2,25,278,243,521,"6 de julio de 1997"
20,1,2,26,385,369,754,"6 de julio de 1997"
20,1,2,27,291,278,569,"6 de julio de 1997"
20,1,2,28,300,289,589,"6 de julio de 1997"
20,1,2,29,479,420,899,"6 de julio de 1997"
20,1,2,30,300,282,582,"6 de julio de 1997"
20,1,2,31,598,600,1198,"6 de julio de 1997"
20,1,2,32,104,97,201,"6 de julio de 1997"
20,1,2,33,476,478,954,"6 de julio de 1997"
20,1,2,34,478,441,919,"6 de julio de 1997"
20,1,24,134,394,453,847,"6 de julio de 1997"
20,1,24,135,557,611,1168,"6 de julio de 1997"
20,1,24,136,524,543,1067,"6 de julio de 1997"
20,1,24,137,255,267,522,"6 de julio de 1997"
20,1,24,138,371,351,722,"6 de julio de 1997"
20,1,24,139,454,472,926,"6 de julio de 1997"
20,1,24,140,226,184,410,"6 de julio de 1997"
20,1,24,141,308,305,613,"6 de julio de 1997"
20,1,24,142,194,142,336,"6 de julio de 1997"
20,1,24,143,336,364,700,"6 de julio de 1997"
20,1,44,333,283,310,593,"6 de julio de 1997"
20,1,44,334,331,363,694,"6 de julio de 1997"
20,1,44,335,269,288,557,"6 de julio de 1997"
20,1,44,336,291,323,614,"6 de julio de 1997"
20,1,44,337,400,495,895,"6 de julio de 1997"
20,1,44,338,500,537,1037,"6 de julio de 1997"
20,1,44,339,463,517,980,"6 de julio de 1997"
20,1,44,340,292,310,602,"6 de julio de 1997"
20,1,44,341,279,258,537,"6 de julio de 1997"
20,1,44,342,459,561,1020,"6 de julio de 1997"
20,1,44,343,411,447,858,"6 de julio de 1997"
20,1,44,344,329,401,730,"6 de julio de 1997"
20,1,44,345,462,488,950,"6 de julio de 1997"
20,1,44,346,224,226,450,"6 de julio de 1997"
20,1,44,347,286,281,567,"6 de julio de 1997"
20,1,44,348,467,526,993,"6 de julio de 1997"
20,1,44,349,256,314,570,"6 de julio de 1997"
20,1,44,350,190,240,430,"6 de julio de 1997"
20,1,44,351,476,533,1009,"6 de julio de 1997"
20,1,44,352,528,575,1103,"6 de julio de 1997"
20,1,44,353,192,201,393,"6 de julio de 1997"
20,1,44,354,430,494,924,"6 de julio de 1997"
20,1,44,355,225,243,468,"6 de julio de 1997"
20,1,44,356,140,161,301,"6 de julio de 1997"
20,1,44,357,426,428,854,"6 de julio de 1997"
20,1,44,358,256,211,467,"6 de julio de 1997"
20,1,44,359,377,344,721,"6 de julio de 1997"
20,1,44,360,471,393,864,"6 de julio de 1997"
20,1,44,361,403,378,781,"6 de julio de 1997"
20,1,44,362,460,417,877,"6 de julio de 1997"
20,1,44,363,237,254,491,"6 de julio de 1997"
20,1,44,364,153,151,304,"6 de julio de 1997"
20,1,131,851,374,363,737,"6 de julio de 1997"
20,1,131,852,386,431,817,"6 de julio de 1997"
20,1,131,853,453,462,915,"6 de julio de 1997"
20,1,131,854,657,736,1393,"6 de julio de 1997"
20,1,131,855,206,207,413,"6 de julio de 1997"
20,1,131,856,656,601,1257,"6 de julio de 1997"
20,1,131,857,648,616,1264,"6 de julio de 1997"
20,1,131,858,542,570,1112,"6 de julio de 1997"
20,1,131,859,262,260,522,"6 de julio de 1997"
20,1,131,860,169,166,335,"6 de julio de 1997"
20,1,131,861,520,512,1032,"6 de julio de 1997"
20,1,133,866,624,684,1308,"6 de julio de 1997"
20,1,133,867,620,625,1245,"6 de julio de 1997"
20,1,133,868,689,717,1406,"6 de julio de 1997"
20,1,133,869,424,404,828,"6 de julio de 1997"
20,1,133,870,187,172,359,"6 de julio de 1997"
20,1,167,952,649,662,1311,"6 de julio de 1997"
20,1,167,953,144,137,281,"6 de julio de 1997"
20,1,167,954,232,215,447,"6 de julio de 1997"
20,1,182,1010,530,561,1091,"6 de julio de 1997"
20,1,182,1011,324,319,643,"6 de julio de 1997"
20,1,182,1012,320,346,666,"6 de julio de 1997"
20,1,182,1013,369,403,772,"6 de julio de 1997"
20,1,182,1014,434,455,889,"6 de julio de 1997"
20,1,182,1015,515,554,1069,"6 de julio de 1997"
20,1,182,1016,440,518,958,"6 de julio de 1997"
20,1,182,1017,565,645,1210,"6 de julio de 1997"
20,1,182,1018,544,540,1084,"6 de julio de 1997"
20,1,182,1019,561,566,1127,"6 de julio de 1997"
20,1,182,1020,569,656,1225,"6 de julio de 1997"
20,1,182,1021,506,595,1101,"6 de julio de 1997"
20,1,182,1022,816,957,1773,"6 de julio de 1997"
20,1,182,1023,558,645,1203,"6 de julio de 1997"
20,1,182,1024,597,713,1310,"6 de julio de 1997"
20,1,182,1025,461,504,965,"6 de julio de 1997"
20,1,182,1026,248,284,532,"6 de julio de 1997"
20,1,182,1027,335,378,713,"6 de julio de 1997"
20,1,182,1028,542,612,1154,"6 de julio de 1997"
20,1,182,1029,578,649,1227,"6 de julio de 1997"
20,1,182,1030,454,509,963,"6 de julio de 1997"
20,1,182,1031,582,642,1224,"6 de julio de 1997"
20,1,182,1032,384,356,740,"6 de julio de 1997"
20,1,182,1033,545,603,1148,"6 de julio de 1997"
20,1,182,1034,461,472,933,"6 de julio de 1997"
20,1,182,1035,621,674,1295,"6 de julio de 1997"
20,1,182,1036,584,624,1208,"6 de julio de 1997"
20,1,182,1037,282,258,540,"6 de julio de 1997"
20,1,182,1038,618,673,1291,"6 de julio de 1997"
20,1,182,1039,595,615,1210,"6 de julio de 1997"
20,1,182,1040,267,293,560,"6 de julio de 1997"
20,1,182,1041,292,292,584,"6 de julio de 1997"
20,1,182,1042,991,1024,2015,"6 de julio de 1997"
20,1,182,1043,483,523,1006,"6 de julio de 1997"
20,1,182,1044,412,402,814,"6 de julio de 1997"
20,1,182,1045,394,392,786,"6 de julio de 1997"
20,1,182,1046,356,403,759,"6 de julio de 1997"
20,1,182,1047,308,371,679,"6 de julio de 1997"
20,1,182,1048,695,709,1404,"6 de julio de 1997"
20,1,182,1049,263,246,509,"6 de julio de 1997"
20,1,182,1050,376,362,738,"6 de julio de 1997"
20,1,182,1051,537,521,1058,"6 de julio de 1997"
20,1,182,1052,648,652,1300,"6 de julio de 1997"
20,1,182,1053,679,672,1351,"6 de julio de 1997"
20,1,182,1054,528,604,1132,"6 de julio de 1997"
20,1,182,1055,524,607,1131,"6 de julio de 1997"
20,1,182,1056,724,698,1422,"6 de julio de 1997"
20,1,182,1057,421,351,772,"6 de julio de 1997"
20,1,182,1058,555,492,1047,"6 de julio de 1997"
20,1,182,1059,265,256,521,"6 de julio de 1997"
20,1,182,1060,484,475,959,"6 de julio de 1997"
20,1,182,1061,395,352,747,"6 de julio de 1997"
20,1,182,1062,422,400,822,"6 de julio de 1997"
20,1,182,1063,244,224,468,"6 de julio de 1997"
20,1,182,1064,739,709,1448,"6 de julio de 1997"
20,1,182,1065,399,300,699,"6 de julio de 1997"
20,1,182,1066,426,408,834,"6 de julio de 1997"
20,1,182,1067,318,314,632,"6 de julio de 1997"
20,1,182,1068,356,351,707,"6 de julio de 1997"
20,1,182,1069,802,833,1635,"6 de julio de 1997"
20,1,182,1070,550,454,1004,"6 de julio de 1997"
20,1,182,1071,254,227,481,"6 de julio de 1997"
20,1,182,1072,371,367,738,"6 de julio de 1997"
20,1,182,1073,468,477,945,"6 de julio de 1997"
20,1,182,1074,370,386,756,"6 de julio de 1997"
20,1,182,1075,495,437,932,"6 de julio de 1997"
20,1,182,1076,415,341,756,"6 de julio de 1997"
20,1,182,1077,226,181,407,"6 de julio de 1997"
20,1,182,1078,548,499,1047,"6 de julio de 1997"
20,1,182,1079,556,544,1100,"6 de julio de 1997"
20,1,182,1080,372,337,709,"6 de julio de 1997"
20,1,182,1081,590,569,1159,"6 de julio de 1997"
20,1,182,1082,270,273,543,"6 de julio de 1997"
20,1,182,1083,342,399,741,"6 de julio de 1997"
20,1,232,1254,243,264,507,"6 de julio de 1997"
20,1,232,1255,428,547,975,"6 de julio de 1997"
20,1,232,1256,396,466,862,"6 de julio de 1997"
20,1,232,1257,313,322,635,"6 de julio de 1997"
20,1,232,1258,397,453,850,"6 de julio de 1997"
20,1,232,1259,525,533,1058,"6 de julio de 1997"
20,1,232,1260,335,345,680,"6 de julio de 1997"
20,1,232,1261,433,454,887,"6 de julio de 1997"
20,1,232,1262,276,281,557,"6 de julio de 1997"
20,1,232,1263,544,550,1094,"6 de julio de 1997"
20,1,232,1264,383,310,693,"6 de julio de 1997"
20,1,232,1265,213,188,401,"6 de julio de 1997"
20,1,276,1372,387,386,773,"6 de julio de 1997"
20,1,276,1373,332,342,674,"6 de julio de 1997"
20,1,276,1374,401,423,824,"6 de julio de 1997"
20,1,276,1375,353,406,759,"6 de julio de 1997"
20,1,276,1376,374,355,729,"6 de julio de 1997"
20,1,276,1377,351,298,649,"6 de julio de 1997"
20,1,276,1378,140,96,236,"6 de julio de 1997"
20,1,276,1379,467,413,880,"6 de julio de 1997"
20,1,276,1380,289,218,507,"6 de julio de 1997"
20,1,276,1381,261,246,507,"6 de julio de 1997"
20,1,276,1382,347,312,659,"6 de julio de 1997"
20,1,276,1383,522,542,1064,"6 de julio de 1997"
20,1,276,1384,317,317,634,"6 de julio de 1997"
20,1,276,1385,408,400,808,"6 de julio de 1997"
20,1,276,1386,560,508,1068,"6 de julio de 1997"
20,1,276,1387,284,245,529,"6 de julio de 1997"
20,1,276,1388,481,392,873,"6 de julio de 1997"
20,1,276,1389,268,252,520,"6 de julio de 1997"
20,1,276,1390,251,208,459,"6 de julio de 1997"
20,1,276,1391,374,360,734,"6 de julio de 1997"
20,1,276,1392,456,453,909,"6 de julio de 1997"
20,1,276,1393,370,373,743,"6 de julio de 1997"
20,1,276,1394,198,175,373,"6 de julio de 1997"
20,1,276,1395,351,283,634,"6 de julio de 1997"
20,1,307,1473,395,443,838,"6 de julio de 1997"
20,1,307,1474,527,562,1089,"6 de julio de 1997"
20,1,307,1475,140,132,272,"6 de julio de 1997"
20,1,307,1476,297,275,572,"6 de julio de 1997"
20,1,307,1477,157,154,311,"6 de julio de 1997"
20,1,307,1478,343,380,723,"6 de julio de 1997"
20,1,307,1479,198,194,392,"6 de julio de 1997"
20,1,307,1480,255,258,513,"6 de julio de 1997"
20,1,307,1481,191,194,385,"6 de julio de 1997"
20,2,22,127,414,440,854,"6 de julio de 1997"
20,2,22,128,145,133,278,"6 de julio de 1997"
20,2,22,129,34,30,64,"6 de julio de 1997"
20,2,22,130,262,226,488,"6 de julio de 1997"
20,2,27,153,361,336,697,"6 de julio de 1997"
20,2,27,154,109,105,214,"6 de julio de 1997"
20,2,27,155,393,318,711,"6 de julio de 1997"
20,2,27,156,152,137,289,"6 de julio de 1997"
20,2,29,176,393,488,881,"6 de julio de 1997"
20,2,29,177,47,58,105,"6 de julio de 1997"
20,2,29,178,114,92,206,"6 de julio de 1997"
20,2,29,179,237,265,502,"6 de julio de 1997"
20,2,33,192,517,600,1117,"6 de julio de 1997"
20,2,38,232,471,476,947,"6 de julio de 1997"
20,2,38,233,132,133,265,"6 de julio de 1997"
20,2,38,234,275,284,559,"6 de julio de 1997"
20,2,38,235,402,482,884,"6 de julio de 1997"
20,2,39,236,510,604,1114,"6 de julio de 1997"
20,2,39,237,388,442,830,"6 de julio de 1997"
20,2,39,238,354,418,772,"6 de julio de 1997"
20,2,39,239,439,541,980,"6 de julio de 1997"
20,2,39,240,338,370,708,"6 de julio de 1997"
20,2,39,241,298,376,674,"6 de julio de 1997"
20,2,39,242,148,179,327,"6 de julio de 1997"
20,2,39,243,258,290,548,"6 de julio de 1997"
20,2,39,244,367,472,839,"6 de julio de 1997"
20,2,39,245,154,158,312,"6 de julio de 1997"
20,2,39,246,371,360,731,"6 de julio de 1997"
20,2,39,247,777,752,1529,"6 de julio de 1997"
20,2,39,248,550,580,1130,"6 de julio de 1997"
20,2,39,249,228,260,488,"6 de julio de 1997"
20,2,39,250,703,783,1486,"6 de julio de 1997"
20,2,39,251,347,404,751,"6 de julio de 1997"
20,2,39,252,357,368,725,"6 de julio de 1997"
20,2,39,253,366,398,764,"6 de julio de 1997"
20,2,39,254,223,284,507,"6 de julio de 1997"
20,2,45,365,336,375,711,"6 de julio de 1997"
20,2,45,366,407,454,861,"6 de julio de 1997"
20,2,45,367,133,140,273,"6 de julio de 1997"
20,2,45,368,159,163,322,"6 de julio de 1997"
20,2,58,422,574,608,1182,"6 de julio de 1997"
20,2,58,423,225,209,434,"6 de julio de 1997"
20,2,58,424,233,237,470,"6 de julio de 1997"
20,2,58,425,275,212,487,"6 de julio de 1997"
20,2,58,426,435,367,802,"6 de julio de 1997"
20,2,58,427,178,170,348,"6 de julio de 1997"
20,2,58,428,226,196,422,"6 de julio de 1997"
20,2,58,429,214,177,391,"6 de julio de 1997"
20,2,58,430,197,170,367,"6 de julio de 1997"
20,2,58,431,252,228,480,"6 de julio de 1997"
20,2,63,459,454,517,971,"6 de julio de 1997"
20,2,63,460,509,563,1072,"6 de julio de 1997"
20,2,74,666,439,493,932,"6 de julio de 1997"
20,2,74,667,317,334,651,"6 de julio de 1997"
20,2,81,719,427,420,847,"6 de julio de 1997"
20,2,81,720,391,421,812,"6 de julio de 1997"
20,2,95,759,635,640,1275,"6 de julio de 1997"
20,2,95,760,287,282,569,"6 de julio de 1997"
20,2,99,764,494,555,1049,"6 de julio de 1997"
20,2,99,765,293,346,639,"6 de julio de 1997"
20,2,106,788,380,399,779,"6 de julio de 1997"
20,2,115,804,358,404,762,"6 de julio de 1997"
20,2,115,805,273,327,600,"6 de julio de 1997"
20,2,115,806,181,166,347,"6 de julio de 1997"
20,2,132,862,381,364,745,"6 de julio de 1997"
20,2,132,863,425,454,879,"6 de julio de 1997"
20,2,132,864,342,343,685,"6 de julio de 1997"
20,2,132,865,271,325,596,"6 de julio de 1997"
20,2,136,875,382,401,783,"6 de julio de 1997"
20,2,139,882,352,432,784,"6 de julio de 1997"
20,2,147,900,485,532,1017,"6 de julio de 1997"
20,2,147,901,440,524,964,"6 de julio de 1997"
20,2,147,902,565,576,1141,"6 de julio de 1997"
20,2,147,903,641,745,1386,"6 de julio de 1997"
20,2,147,904,75,87,162,"6 de julio de 1997"
20,2,147,905,101,113,214,"6 de julio de 1997"
20,2,158,927,156,198,354,"6 de julio de 1997"
20,2,158,928,119,113,232,"6 de julio de 1997"
20,2,158,929,273,300,573,"6 de julio de 1997"
20,2,158,930,169,205,374,"6 de julio de 1997"
20,2,160,932,306,351,657,"6 de julio de 1997"
20,2,160,933,44,53,97,"6 de julio de 1997"
20,2,170,962,593,674,1267,"6 de julio de 1997"
20,2,170,963,171,179,350,"6 de julio de 1997"
20,2,170,964,165,170,335,"6 de julio de 1997"
20,2,170,965,172,140,312,"6 de julio de 1997"
20,2,170,966,367,274,641,"6 de julio de 1997"
20,2,170,967,311,297,608,"6 de julio de 1997"
20,2,170,968,114,93,207,"6 de julio de 1997"
20,2,170,969,198,209,407,"6 de julio de 1997"
20,2,170,970,328,357,685,"6 de julio de 1997"
20,2,170,971,67,80,147,"6 de julio de 1997"
20,2,170,972,519,516,1035,"6 de julio de 1997"
20,2,170,973,142,145,287,"6 de julio de 1997"
20,2,170,974,155,161,316,"6 de julio de 1997"
20,2,170,975,234,212,446,"6 de julio de 1997"
20,2,170,976,298,267,565,"6 de julio de 1997"
20,2,170,977,308,256,564,"6 de julio de 1997"
20,2,173,981,382,397,779,"6 de julio de 1997"
20,2,175,986,343,335,678,"6 de julio de 1997"
20,2,175,987,369,384,753,"6 de julio de 1997"
20,2,175,988,308,340,648,"6 de julio de 1997"
20,2,175,989,164,137,301,"6 de julio de 1997"
20,2,175,990,103,97,200,"6 de julio de 1997"
20,2,175,991,77,76,153,"6 de julio de 1997"
20,2,175,992,94,106,200,"6 de julio de 1997"
20,2,175,993,325,320,645,"6 de julio de 1997"
20,2,175,994,188,126,314,"6 de julio de 1997"
20,2,175,995,220,255,475,"6 de julio de 1997"
20,2,175,996,171,173,344,"6 de julio de 1997"
20,2,175,997,125,103,228,"6 de julio de 1997"
20,2,175,998,63,85,148,"6 de julio de 1997"
20,2,176,999,260,297,557,"6 de julio de 1997"
20,2,176,1000,238,318,556,"6 de julio de 1997"
20,2,176,1001,434,475,909,"6 de julio de 1997"
20,2,177,1002,396,366,762,"6 de julio de 1997"
20,2,181,1009,495,517,1012,"6 de julio de 1997"
20,2,187,1108,324,442,766,"6 de julio de 1997"
20,2,187,1109,294,309,603,"6 de julio de 1997"
20,2,189,1111,578,634,1212,"6 de julio de 1997"
20,2,193,1129,499,432,931,"6 de julio de 1997"
20,2,193,1130,197,152,349,"6 de julio de 1997"
20,2,194,1131,309,324,633,"6 de julio de 1997"
20,2,194,1132,313,350,663,"6 de julio de 1997"
20,2,220,1228,173,162,335,"6 de julio de 1997"
20,2,220,1229,284,235,519,"6 de julio de 1997"
20,2,220,1230,165,142,307,"6 de julio de 1997"
20,2,220,1231,177,166,343,"6 de julio de 1997"
20,2,227,1243,732,787,1519,"6 de julio de 1997"
20,2,227,1244,373,399,772,"6 de julio de 1997"
20,2,227,1245,396,444,840,"6 de julio de 1997"
20,2,227,1246,502,589,1091,"6 de julio de 1997"
20,2,227,1247,301,316,617,"6 de julio de 1997"
20,2,228,1248,195,182,377,"6 de julio de 1997"
20,2,234,1267,445,438,883,"6 de julio de 1997"
20,2,234,1268,238,241,479,"6 de julio de 1997"
20,2,234,1269,351,357,708,"6 de julio de 1997"
20,2,234,1270,465,393,858,"6 de julio de 1997"
20,2,244,1292,468,487,955,"6 de julio de 1997"
20,2,244,1293,322,280,602,"6 de julio de 1997"
20,2,255,1316,379,391,770,"6 de julio de 1997"
20,2,255,1317,285,288,573,"6 de julio de 1997"
20,2,259,1322,433,441,874,"6 de julio de 1997"
20,2,259,1323,151,156,307,"6 de julio de 1997"
20,2,275,1371,241,242,483,"6 de julio de 1997"
20,2,292,1426,264,311,575,"6 de julio de 1997"
20,2,292,1427,387,437,824,"6 de julio de 1997"
20,2,292,1428,340,376,716,"6 de julio de 1997"
20,2,292,1429,385,445,830,"6 de julio de 1997"
20,2,292,1430,56,62,118,"6 de julio de 1997"
20,2,309,1484,156,162,318,"6 de julio de 1997"
20,2,311,1492,294,335,629,"6 de julio de 1997"
20,2,320,1514,204,231,435,"6 de julio de 1997"
20,2,324,1541,486,522,1008,"6 de julio de 1997"
20,2,324,1542,223,221,444,"6 de julio de 1997"
20,2,324,1543,232,215,447,"6 de julio de 1997"
20,2,328,1555,390,399,789,"6 de julio de 1997"
20,2,328,1556,406,332,738,"6 de julio de 1997"
20,2,328,1557,100,89,189,"6 de julio de 1997"
20,2,354,1642,138,145,283,"6 de julio de 1997"
20,2,355,1643,248,236,484,"6 de julio de 1997"
20,2,359,1649,293,358,651,"6 de julio de 1997"
20,2,375,1685,256,288,544,"6 de julio de 1997"
20,2,399,1782,369,531,900,"6 de julio de 1997"
20,2,399,1783,281,375,656,"6 de julio de 1997"
20,2,404,1793,445,466,911,"6 de julio de 1997"
20,2,404,1794,376,342,718,"6 de julio de 1997"
20,2,404,1795,489,472,961,"6 de julio de 1997"
20,2,404,1796,474,387,861,"6 de julio de 1997"
20,2,404,1797,274,237,511,"6 de julio de 1997"
20,2,404,1798,376,373,749,"6 de julio de 1997"
20,2,404,1799,189,173,362,"6 de julio de 1997"
20,2,404,1800,265,252,517,"6 de julio de 1997"
20,2,404,1801,66,51,117,"6 de julio de 1997"
20,2,404,1802,261,246,507,"6 de julio de 1997"
20,2,404,1803,301,263,564,"6 de julio de 1997"
20,2,404,1804,90,83,173,"6 de julio de 1997"
20,2,404,1805,377,356,733,"6 de julio de 1997"
20,2,404,1806,112,100,212,"6 de julio de 1997"
20,2,404,1807,105,98,203,"6 de julio de 1997"
20,2,404,1808,199,183,382,"6 de julio de 1997"
20,2,404,1809,282,313,595,"6 de julio de 1997"
20,2,417,1859,195,216,411,"6 de julio de 1997"
20,2,426,1887,536,486,1022,"6 de julio de 1997"
20,2,432,1906,523,500,1023,"6 de julio de 1997"
20,2,435,1909,349,457,806,"6 de julio de 1997"
20,2,435,1910,331,413,744,"6 de julio de 1997"
20,2,437,1913,277,284,561,"6 de julio de 1997"
20,2,439,1918,299,296,595,"6 de julio de 1997"
20,2,479,2072,292,306,598,"6 de julio de 1997"
20,2,479,2073,123,121,244,"6 de julio de 1997"
20,2,479,2074,170,168,338,"6 de julio de 1997"
20,2,479,2075,132,111,243,"6 de julio de 1997"
20,2,485,2112,522,603,1125,"6 de julio de 1997"
20,2,485,2113,430,450,880,"6 de julio de 1997"
20,2,485,2114,406,444,850,"6 de julio de 1997"
20,2,485,2115,169,167,336,"6 de julio de 1997"
20,2,485,2116,274,306,580,"6 de julio de 1997"
20,2,488,2125,208,218,426,"6 de julio de 1997"
20,2,488,2126,249,236,485,"6 de julio de 1997"
20,2,491,2131,337,403,740,"6 de julio de 1997"
20,2,491,2132,189,235,424,"6 de julio de 1997"
20,2,527,2261,471,440,911,"6 de julio de 1997"
20,2,531,2272,547,530,1077,"6 de julio de 1997"
20,2,537,2301,438,500,938,"6 de julio de 1997"
20,2,537,2302,229,238,467,"6 de julio de 1997"
20,2,537,2303,382,419,801,"6 de julio de 1997"
20,2,544,2324,436,532,968,"6 de julio de 1997"
20,2,545,2325,379,390,769,"6 de julio de 1997"
20,2,545,2326,475,560,1035,"6 de julio de 1997"
20,2,545,2327,421,493,914,"6 de julio de 1997"
20,2,545,2328,377,409,786,"6 de julio de 1997"
20,2,545,2329,129,121,250,"6 de julio de 1997"
20,2,545,2330,167,177,344,"6 de julio de 1997"
20,2,558,2405,255,290,545,"6 de julio de 1997"
20,2,558,2406,175,187,362,"6 de julio de 1997"
20,2,560,2408,358,418,776,"6 de julio de 1997"
20,2,560,2409,479,563,1042,"6 de julio de 1997"
20,2,560,2410,523,596,1119,"6 de julio de 1997"
20,2,560,2411,459,522,981,"6 de julio de 1997"
20,3,5,42,258,298,556,"6 de julio de 1997"
20,3,13,87,183,173,356,"6 de julio de 1997"
20,3,13,88,62,62,124,"6 de julio de 1997"
20,3,13,89,76,87,163,"6 de julio de 1997"
20,3,19,117,310,308,618,"6 de julio de 1997"
20,3,19,118,96,84,180,"6 de julio de 1997"
20,3,19,119,594,524,1118,"6 de julio de 1997"
20,3,19,120,268,147,415,"6 de julio de 1997"
20,3,21,125,116,124,240,"6 de julio de 1997"
20,3,21,126,107,128,235,"6 de julio de 1997"
20,3,25,144,136,169,305,"6 de julio de 1997"
20,3,25,145,92,112,204,"6 de julio de 1997"
20,3,25,146,44,53,97,"6 de julio de 1997"
20,3,31,187,113,129,242,"6 de julio de 1997"
20,3,31,188,121,145,266,"6 de julio de 1997"
20,3,32,189,120,143,263,"6 de julio de 1997"
20,3,32,190,98,109,207,"6 de julio de 1997"
20,3,32,191,105,120,225,"6 de julio de 1997"
20,3,37,201,313,350,663,"6 de julio de 1997"
20,3,37,202,559,663,1222,"6 de julio de 1997"
20,3,37,203,346,441,787,"6 de julio de 1997"
20,3,37,204,512,654,1166,"6 de julio de 1997"
20,3,37,205,568,726,1294,"6 de julio de 1997"
20,3,37,206,637,787,1424,"6 de julio de 1997"
20,3,37,207,697,867,1564,"6 de julio de 1997"
20,3,37,208,289,333,622,"6 de julio de 1997"
20,3,37,209,478,618,1096,"6 de julio de 1997"
20,3,37,210,478,608,1086,"6 de julio de 1997"
20,3,37,211,294,365,659,"6 de julio de 1997"
20,3,37,212,436,569,1005,"6 de julio de 1997"
20,3,37,213,432,548,980,"6 de julio de 1997"
20,3,37,214,407,538,945,"6 de julio de 1997"
20,3,37,215,261,382,643,"6 de julio de 1997"
20,3,37,216,575,697,1272,"6 de julio de 1997"
20,3,37,217,503,592,1095,"6 de julio de 1997"
20,3,37,218,585,558,1143,"6 de julio de 1997"
20,3,37,219,656,835,1491,"6 de julio de 1997"
20,3,37,220,486,597,1083,"6 de julio de 1997"
20,3,37,221,263,332,595,"6 de julio de 1997"
20,3,37,222,251,290,541,"6 de julio de 1997"
20,3,37,223,121,159,280,"6 de julio de 1997"
20,3,37,224,57,84,141,"6 de julio de 1997"
20,3,37,225,97,105,202,"6 de julio de 1997"
20,3,37,226,154,184,338,"6 de julio de 1997"
20,3,37,227,290,364,654,"6 de julio de 1997"
20,3,37,228,542,708,1250,"6 de julio de 1997"
20,3,37,229,48,61,109,"6 de julio de 1997"
20,3,37,230,81,109,190,"6 de julio de 1997"
20,3,37,231,353,389,742,"6 de julio de 1997"
20,3,40,255,256,377,633,"6 de julio de 1997"
20,3,40,256,63,68,131,"6 de julio de 1997"
20,3,40,257,69,93,162,"6 de julio de 1997"
20,3,55,389,260,261,521,"6 de julio de 1997"
20,3,55,390,116,133,249,"6 de julio de 1997"
20,3,55,391,143,172,315,"6 de julio de 1997"
20,3,55,392,29,59,88,"6 de julio de 1997"
20,3,55,393,128,168,296,"6 de julio de 1997"
20,3,55,394,74,102,176,"6 de julio de 1997"
20,3,55,395,71,76,147,"6 de julio de 1997"
20,3,78,712,299,435,734,"6 de julio de 1997"
20,3,78,713,113,161,274,"6 de julio de 1997"
20,3,86,741,334,389,723,"6 de julio de 1997"
20,3,86,742,126,134,260,"6 de julio de 1997"
20,3,86,743,56,63,119,"6 de julio de 1997"
20,3,90,750,180,204,384,"6 de julio de 1997"
20,3,96,761,110,138,248,"6 de julio de 1997"
20,3,102,772,432,543,975,"6 de julio de 1997"
20,3,102,773,146,167,313,"6 de julio de 1997"
20,3,102,774,338,393,731,"6 de julio de 1997"
20,3,102,775,299,373,672,"6 de julio de 1997"
20,3,103,776,87,95,182,"6 de julio de 1997"
20,3,113,801,196,244,440,"6 de julio de 1997"
20,3,113,802,47,58,105,"6 de julio de 1997"
20,3,126,837,94,109,203,"6 de julio de 1997"
20,3,148,906,124,115,239,"6 de julio de 1997"
20,3,149,907,426,441,867,"6 de julio de 1997"
20,3,157,924,181,201,382,"6 de julio de 1997"
20,3,157,925,161,210,371,"6 de julio de 1997"
20,3,157,926,106,133,239,"6 de julio de 1997"
20,3,162,938,264,327,591,"6 de julio de 1997"
20,3,162,939,116,166,282,"6 de julio de 1997"
20,3,162,940,75,98,173,"6 de julio de 1997"
20,3,163,941,155,193,348,"6 de julio de 1997"
20,3,163,942,129,152,281,"6 de julio de 1997"
20,3,174,982,180,207,387,"6 de julio de 1997"
20,3,174,983,167,177,344,"6 de julio de 1997"
20,3,174,984,249,252,501,"6 de julio de 1997"
20,3,174,985,248,241,489,"6 de julio de 1997"
20,3,179,1005,118,121,239,"6 de julio de 1997"
20,3,179,1006,45,55,100,"6 de julio de 1997"
20,3,180,1007,193,238,431,"6 de julio de 1997"
20,3,180,1008,104,117,221,"6 de julio de 1997"
20,3,188,1110,180,188,368,"6 de julio de 1997"
20,3,200,1162,108,135,243,"6 de julio de 1997"
20,3,200,1163,71,82,153,"6 de julio de 1997"
20,3,221,1232,276,279,555,"6 de julio de 1997"
20,3,221,1233,159,153,312,"6 de julio de 1997"
20,3,224,1237,235,255,490,"6 de julio de 1997"
20,3,230,1251,151,195,346,"6 de julio de 1997"
20,3,230,1252,98,116,214,"6 de julio de 1997"
20,3,237,1278,180,242,422,"6 de julio de 1997"
20,3,237,1279,110,170,280,"6 de julio de 1997"
20,3,237,1280,135,161,296,"6 de julio de 1997"
20,3,237,1281,61,55,116,"6 de julio de 1997"
20,3,242,1286,331,339,670,"6 de julio de 1997"
20,3,242,1287,419,397,816,"6 de julio de 1997"
20,3,242,1288,239,211,450,"6 de julio de 1997"
20,3,242,1289,248,197,445,"6 de julio de 1997"
20,3,242,1290,564,539,1103,"6 de julio de 1997"
20,3,245,1294,234,229,463,"6 de julio de 1997"
20,3,245,1295,107,140,247,"6 de julio de 1997"
20,3,249,1303,224,271,495,"6 de julio de 1997"
20,3,254,1315,80,75,155,"6 de julio de 1997"
20,3,258,1320,490,502,992,"6 de julio de 1997"
20,3,258,1321,116,114,230,"6 de julio de 1997"
20,3,260,1324,228,247,475,"6 de julio de 1997"
20,3,260,1325,261,321,582,"6 de julio de 1997"
20,3,260,1326,236,258,494,"6 de julio de 1997"
20,3,260,1327,148,160,308,"6 de julio de 1997"
20,3,260,1328,48,54,102,"6 de julio de 1997"
20,3,260,1329,61,66,127,"6 de julio de 1997"
20,3,260,1330,84,80,164,"6 de julio de 1997"
20,3,260,1331,111,96,207,"6 de julio de 1997"
20,3,260,1332,64,76,140,"6 de julio de 1997"
20,3,262,1336,246,295,541,"6 de julio de 1997"
20,3,262,1337,201,250,451,"6 de julio de 1997"
20,3,269,1359,194,217,411,"6 de julio de 1997"
20,3,269,1360,208,256,464,"6 de julio de 1997"
20,3,281,1404,205,188,393,"6 de julio de 1997"
20,3,281,1405,49,41,90,"6 de julio de 1997"
20,3,281,1406,56,52,108,"6 de julio de 1997"
20,3,284,1411,228,305,533,"6 de julio de 1997"
20,3,284,1412,178,242,420,"6 de julio de 1997"
20,3,284,1413,75,114,189,"6 de julio de 1997"
20,3,284,1414,142,199,341,"6 de julio de 1997"
20,3,285,1415,139,182,321,"6 de julio de 1997"
20,3,288,1418,226,253,479,"6 de julio de 1997"
20,3,319,1513,212,226,438,"6 de julio de 1997"
20,3,334,1589,306,348,654,"6 de julio de 1997"
20,3,334,1590,338,406,744,"6 de julio de 1997"
20,3,334,1591,132,139,271,"6 de julio de 1997"
20,3,334,1592,224,262,486,"6 de julio de 1997"
20,3,334,1593,24,20,44,"6 de julio de 1997"
20,3,335,1594,183,241,424,"6 de julio de 1997"
20,3,335,1595,39,45,84,"6 de julio de 1997"
20,3,335,1596,85,110,195,"6 de julio de 1997"
20,3,335,1597,56,76,132,"6 de julio de 1997"
20,3,335,1598,119,165,284,"6 de julio de 1997"
20,3,335,1599,50,61,111,"6 de julio de 1997"
20,3,335,1600,71,123,194,"6 de julio de 1997"
20,3,338,1604,69,87,156,"6 de julio de 1997"
20,3,343,1613,446,536,982,"6 de julio de 1997"
20,3,345,1617,343,466,809,"6 de julio de 1997"
20,3,345,1618,253,310,563,"6 de julio de 1997"
20,3,345,1619,249,283,532,"6 de julio de 1997"
20,3,345,1620,83,135,218,"6 de julio de 1997"
20,3,345,1621,131,163,294,"6 de julio de 1997"
20,3,345,1622,82,104,186,"6 de julio de 1997"
20,3,345,1623,89,102,191,"6 de julio de 1997"
20,3,345,1624,326,322,648,"6 de julio de 1997"
20,3,345,1625,140,134,274,"6 de julio de 1997"
20,3,349,1636,451,319,770,"6 de julio de 1997"
20,3,374,1683,146,163,309,"6 de julio de 1997"
20,3,374,1684,40,50,90,"6 de julio de 1997"
20,3,377,1690,110,133,243,"6 de julio de 1997"
20,3,382,1704,282,350,632,"6 de julio de 1997"
20,3,382,1705,210,255,465,"6 de julio de 1997"
20,3,382,1706,118,142,260,"6 de julio de 1997"
20,3,396,1777,33,52,85,"6 de julio de 1997"
20,3,401,1787,212,260,472,"6 de julio de 1997"
20,3,401,1788,198,251,449,"6 de julio de 1997"
20,3,402,1789,236,259,495,"6 de julio de 1997"
20,3,403,1790,152,288,440,"6 de julio de 1997"
20,3,403,1791,181,285,466,"6 de julio de 1997"
20,3,403,1792,42,52,94,"6 de julio de 1997"
20,3,423,1878,72,94,166,"6 de julio de 1997"
20,3,423,1879,99,147,246,"6 de julio de 1997"
20,3,452,1960,189,176,365,"6 de julio de 1997"
20,3,452,1961,200,260,460,"6 de julio de 1997"
20,3,456,1971,333,370,703,"6 de julio de 1997"
20,3,456,1972,128,133,261,"6 de julio de 1997"
20,3,457,1973,170,191,361,"6 de julio de 1997"
20,3,457,1974,135,137,272,"6 de julio de 1997"
20,3,457,1975,102,115,217,"6 de julio de 1997"
20,3,459,1978,274,368,642,"6 de julio de 1997"
20,3,459,1979,265,333,598,"6 de julio de 1997"
20,3,459,1980,122,162,284,"6 de julio de 1997"
20,3,459,1981,99,102,201,"6 de julio de 1997"
20,3,459,1982,122,126,248,"6 de julio de 1997"
20,3,459,1983,98,98,196,"6 de julio de 1997"
20,3,459,1984,51,43,94,"6 de julio de 1997"
20,3,459,1985,79,120,199,"6 de julio de 1997"
20,3,459,1986,132,127,259,"6 de julio de 1997"
20,3,462,1993,172,197,369,"6 de julio de 1997"
20,3,462,1994,52,73,125,"6 de julio de 1997"
20,3,463,1995,502,627,1129,"6 de julio de 1997"
20,3,463,1996,89,144,233,"6 de julio de 1997"
20,3,463,1997,295,336,631,"6 de julio de 1997"
20,3,463,1998,232,240,472,"6 de julio de 1997"
20,3,465,2002,88,103,191,"6 de julio de 1997"
20,3,465,2003,48,70,118,"6 de julio de 1997"
20,3,470,2033,359,429,788,"6 de julio de 1997"
20,3,470,2034,546,428,974,"6 de julio de 1997"
20,3,470,2035,430,505,935,"6 de julio de 1997"
20,3,470,2036,365,475,840,"6 de julio de 1997"
20,3,470,2037,259,390,649,"6 de julio de 1997"
20,3,470,2038,164,220,384,"6 de julio de 1997"
20,3,470,2039,316,426,742,"6 de julio de 1997"
20,3,470,2040,184,280,464,"6 de julio de 1997"
20,3,470,2041,242,289,531,"6 de julio de 1997"
20,3,470,2042,486,614,1100,"6 de julio de 1997"
20,3,470,2043,357,303,660,"6 de julio de 1997"
20,3,470,2044,175,221,396,"6 de julio de 1997"
20,3,470,2045,275,399,674,"6 de julio de 1997"
20,3,470,2046,318,458,776,"6 de julio de 1997"
20,3,470,2047,194,283,477,"6 de julio de 1997"
20,3,470,2048,196,183,379,"6 de julio de 1997"
20,3,470,2049,41,70,111,"6 de julio de 1997"
20,3,477,2070,111,145,256,"6 de julio de 1997"
20,3,486,2117,212,257,469,"6 de julio de 1997"
20,3,486,2118,226,268,494,"6 de julio de 1997"
20,3,486,2119,143,185,328,"6 de julio de 1997"
20,3,486,2120,99,80,179,"6 de julio de 1997"
20,3,486,2121,89,100,189,"6 de julio de 1997"
20,3,486,2122,131,151,282,"6 de julio de 1997"
20,3,489,2127,44,52,96,"6 de julio de 1997"
20,3,500,2156,241,290,531,"6 de julio de 1997"
20,3,500,2157,194,223,417,"6 de julio de 1997"
20,3,502,2165,155,179,334,"6 de julio de 1997"
20,3,502,2166,108,157,265,"6 de julio de 1997"
20,3,520,2237,219,283,502,"6 de julio de 1997"
20,3,520,2238,228,261,489,"6 de julio de 1997"
20,3,520,2239,228,272,500,"6 de julio de 1997"
20,3,520,2240,135,101,236,"6 de julio de 1997"
20,3,520,2241,34,25,59,"6 de julio de 1997"
20,3,520,2242,296,316,612,"6 de julio de 1997"
20,3,520,2243,260,335,595,"6 de julio de 1997"
20,3,521,2244,89,141,230,"6 de julio de 1997"
20,3,523,2246,394,441,835,"6 de julio de 1997"
20,3,523,2247,46,60,106,"6 de julio de 1997"
20,3,524,2248,144,184,328,"6 de julio de 1997"
20,3,532,2273,303,448,751,"6 de julio de 1997"
20,3,533,2274,186,192,378,"6 de julio de 1997"
20,3,534,2275,366,432,798,"6 de julio de 1997"
20,3,534,2276,266,341,607,"6 de julio de 1997"
20,3,534,2277,102,112,214,"6 de julio de 1997"
20,3,534,2278,111,176,287,"6 de julio de 1997"
20,3,534,2279,116,144,260,"6 de julio de 1997"
20,3,534,2280,25,41,66,"6 de julio de 1997"
20,3,534,2281,89,121,210,"6 de julio de 1997"
20,3,534,2282,108,152,260,"6 de julio de 1997"
20,3,534,2283,52,79,131,"6 de julio de 1997"
20,3,534,2284,71,83,154,"6 de julio de 1997"
20,3,534,2285,100,99,199,"6 de julio de 1997"
20,3,534,2286,74,103,177,"6 de julio de 1997"
20,3,534,2287,73,69,142,"6 de julio de 1997"
20,3,534,2288,37,49,86,"6 de julio de 1997"
20,3,534,2289,114,102,216,"6 de julio de 1997"
20,3,539,2305,286,335,621,"6 de julio de 1997"
20,3,539,2306,316,385,701,"6 de julio de 1997"
20,3,539,2307,230,312,542,"6 de julio de 1997"
20,3,539,2308,244,306,550,"6 de julio de 1997"
20,3,539,2309,222,389,611,"6 de julio de 1997"
20,3,539,2310,54,34,88,"6 de julio de 1997"
20,3,543,2321,190,195,385,"6 de julio de 1997"
20,3,543,2322,235,235,470,"6 de julio de 1997"
20,3,543,2323,152,145,297,"6 de julio de 1997"
20,3,547,2335,266,309,575,"6 de julio de 1997"
20,3,548,2336,173,237,410,"6 de julio de 1997"
20,3,548,2337,66,56,122,"6 de julio de 1997"
20,3,548,2338,93,102,195,"6 de julio de 1997"
20,3,549,2339,330,500,830,"6 de julio de 1997"
20,3,549,2340,142,182,324,"6 de julio de 1997"
20,3,549,2341,228,381,609,"6 de julio de 1997"
20,3,549,2342,93,145,238,"6 de julio de 1997"
20,3,549,2343,163,248,411,"6 de julio de 1997"
20,3,549,2344,178,261,439,"6 de julio de 1997"
20,3,549,2345,249,264,513,"6 de julio de 1997"
20,3,549,2346,357,393,750,"6 de julio de 1997"
20,3,549,2347,70,84,154,"6 de julio de 1997"
20,3,549,2348,180,230,410,"6 de julio de 1997"
20,3,549,2349,49,50,99,"6 de julio de 1997"
20,3,549,2350,151,186,337,"6 de julio de 1997"
20,3,549,2351,199,255,454,"6 de julio de 1997"
20,3,551,2362,124,144,268,"6 de julio de 1997"
20,3,556,2393,87,99,186,"6 de julio de 1997"
20,3,568,2432,319,372,691,"6 de julio de 1997"
20,3,568,2433,256,330,586,"6 de julio de 1997"
20,3,568,2434,140,181,321,"6 de julio de 1997"
20,3,569,2435,390,440,830,"6 de julio de 1997"
20,4,1,1,323,239,562,"6 de julio de 1997"
20,4,4,39,189,261,450,"6 de julio de 1997"
20,4,4,40,127,105,232,"6 de julio de 1997"
20,4,4,41,207,178,385,"6 de julio de 1997"
20,4,11,74,388,389,777,"6 de julio de 1997"
20,4,11,75,552,548,1100,"6 de julio de 1997"
20,4,11,76,287,286,573,"6 de julio de 1997"
20,4,34,193,151,157,308,"6 de julio de 1997"
20,4,42,276,299,340,639,"6 de julio de 1997"
20,4,42,277,373,411,784,"6 de julio de 1997"
20,4,42,278,254,205,459,"6 de julio de 1997"
20,4,42,279,137,100,237,"6 de julio de 1997"
20,4,42,280,146,138,284,"6 de julio de 1997"
20,4,42,281,251,236,487,"6 de julio de 1997"
20,4,42,282,259,240,499,"6 de julio de 1997"
20,4,50,378,405,436,841,"6 de julio de 1997"
20,4,50,379,416,418,834,"6 de julio de 1997"
20,4,60,454,293,251,544,"6 de julio de 1997"
20,4,60,455,178,165,343,"6 de julio de 1997"
20,4,62,458,175,220,395,"6 de julio de 1997"
20,4,65,469,394,441,835,"6 de julio de 1997"
20,4,94,757,363,384,747,"6 de julio de 1997"
20,4,94,758,225,215,440,"6 de julio de 1997"
20,4,97,762,164,187,351,"6 de julio de 1997"
20,4,111,795,122,141,263,"6 de julio de 1997"
20,4,111,796,72,67,139,"6 de julio de 1997"
20,4,111,797,67,88,155,"6 de julio de 1997"
20,4,117,809,582,854,1436,"6 de julio de 1997"
20,4,119,811,147,184,331,"6 de julio de 1997"
20,4,125,836,401,463,864,"6 de julio de 1997"
20,4,128,841,612,633,1245,"6 de julio de 1997"
20,4,128,842,775,777,1552,"6 de julio de 1997"
20,4,128,843,343,406,749,"6 de julio de 1997"
20,4,128,844,172,202,374,"6 de julio de 1997"
20,4,128,845,304,340,644,"6 de julio de 1997"
20,4,135,874,173,198,371,"6 de julio de 1997"
20,4,142,893,416,403,819,"6 de julio de 1997"
20,4,153,914,453,458,911,"6 de julio de 1997"
20,4,153,915,231,211,442,"6 de julio de 1997"
20,4,153,916,182,208,390,"6 de julio de 1997"
20,4,164,943,700,687,1387,"6 de julio de 1997"
20,4,164,944,459,450,909,"6 de julio de 1997"
20,4,164,945,249,239,488,"6 de julio de 1997"
20,4,164,946,413,406,819,"6 de julio de 1997"
20,4,164,947,441,428,869,"6 de julio de 1997"
20,4,164,948,363,395,758,"6 de julio de 1997"
20,4,172,979,231,229,460,"6 de julio de 1997"
20,4,172,980,222,254,476,"6 de julio de 1997"
20,4,183,1084,487,457,944,"6 de julio de 1997"
20,4,183,1085,399,378,777,"6 de julio de 1997"
20,4,183,1086,438,456,894,"6 de julio de 1997"
20,4,183,1087,555,523,1078,"6 de julio de 1997"
20,4,183,1088,456,373,829,"6 de julio de 1997"
20,4,183,1089,453,456,909,"6 de julio de 1997"
20,4,183,1090,502,463,965,"6 de julio de 1997"
20,4,183,1091,474,442,916,"6 de julio de 1997"
20,4,183,1092,253,217,470,"6 de julio de 1997"
20,4,183,1093,234,175,409,"6 de julio de 1997"
20,4,183,1094,337,325,662,"6 de julio de 1997"
20,4,183,1095,409,405,814,"6 de julio de 1997"
20,4,183,1096,291,259,550,"6 de julio de 1997"
20,4,183,1097,202,209,411,"6 de julio de 1997"
20,4,183,1098,265,221,486,"6 de julio de 1997"
20,4,185,1106,119,132,251,"6 de julio de 1997"
20,4,191,1117,309,286,595,"6 de julio de 1997"
20,4,191,1118,190,169,359,"6 de julio de 1997"
20,4,195,1133,373,440,813,"6 de julio de 1997"
20,4,197,1136,154,168,322,"6 de julio de 1997"
20,4,198,1137,476,550,1026,"6 de julio de 1997"
20,4,198,1138,311,378,689,"6 de julio de 1997"
20,4,201,1164,229,254,483,"6 de julio de 1997"
20,4,201,1165,250,300,550,"6 de julio de 1997"
20,4,201,1166,112,120,232,"6 de julio de 1997"
20,4,201,1167,232,155,387,"6 de julio de 1997"
20,4,202,1168,214,213,427,"6 de julio de 1997"
20,4,202,1169,227,252,479,"6 de julio de 1997"
20,4,206,1177,385,359,744,"6 de julio de 1997"
20,4,206,1178,545,518,1063,"6 de julio de 1997"
20,4,206,1179,534,517,1051,"6 de julio de 1997"
20,4,206,1180,339,338,677,"6 de julio de 1997"
20,4,206,1181,293,261,554,"6 de julio de 1997"
20,4,206,1182,710,708,1418,"6 de julio de 1997"
20,4,206,1183,724,711,1435,"6 de julio de 1997"
20,4,212,1213,250,272,522,"6 de julio de 1997"
20,4,212,1214,222,116,338,"6 de julio de 1997"
20,4,214,1217,387,485,872,"6 de julio de 1997"
20,4,214,1218,110,103,213,"6 de julio de 1997"
20,4,216,1220,294,299,593,"6 de julio de 1997"
20,4,219,1226,428,527,955,"6 de julio de 1997"
20,4,219,1227,369,433,802,"6 de julio de 1997"
20,4,222,1234,304,377,681,"6 de julio de 1997"
20,4,222,1235,108,98,206,"6 de julio de 1997"
20,4,223,1236,118,110,228,"6 de julio de 1997"
20,4,226,1241,588,555,1143,"6 de julio de 1997"
20,4,226,1242,138,121,259,"6 de julio de 1997"
20,4,231,1253,496,462,958,"6 de julio de 1997"
20,4,233,1266,473,737,1210,"6 de julio de 1997"
20,4,246,1296,153,172,325,"6 de julio de 1997"
20,4,256,1318,289,330,619,"6 de julio de 1997"
20,4,261,1333,103,120,223,"6 de julio de 1997"
20,4,261,1334,28,24,52,"6 de julio de 1997"
20,4,261,1335,192,187,379,"6 de julio de 1997"
20,4,266,1352,90,113,203,"6 de julio de 1997"
20,4,274,1368,481,392,873,"6 de julio de 1997"
20,4,274,1369,543,446,989,"6 de julio de 1997"
20,4,274,1370,364,264,628,"6 de julio de 1997"
20,4,278,1398,280,344,624,"6 de julio de 1997"
20,4,278,1399,265,314,579,"6 de julio de 1997"
20,4,278,1400,185,189,374,"6 de julio de 1997"
20,4,286,1416,137,121,258,"6 de julio de 1997"
20,4,294,1437,314,337,651,"6 de julio de 1997"
20,4,296,1440,392,506,898,"6 de julio de 1997"
20,4,296,1441,341,446,787,"6 de julio de 1997"
20,4,296,1442,365,442,807,"6 de julio de 1997"
20,4,296,1443,342,449,791,"6 de julio de 1997"
20,4,296,1444,555,640,1195,"6 de julio de 1997"
20,4,296,1445,173,179,352,"6 de julio de 1997"
20,4,296,1446,179,188,367,"6 de julio de 1997"
20,4,296,1447,356,358,714,"6 de julio de 1997"
20,4,297,1448,251,261,512,"6 de julio de 1997"
20,4,301,1458,283,394,677,"6 de julio de 1997"
20,4,321,1515,423,373,796,"6 de julio de 1997"
20,4,333,1585,278,297,575,"6 de julio de 1997"
20,4,333,1586,288,335,623,"6 de julio de 1997"
20,4,333,1587,272,196,468,"6 de julio de 1997"
20,4,333,1588,105,108,213,"6 de julio de 1997"
20,4,336,1601,236,210,446,"6 de julio de 1997"
20,4,337,1602,432,498,930,"6 de julio de 1997"
20,4,337,1603,69,61,130,"6 de julio de 1997"
20,4,346,1626,552,635,1187,"6 de julio de 1997"
20,4,356,1644,296,376,672,"6 de julio de 1997"
20,4,356,1645,293,340,633,"6 de julio de 1997"
20,4,363,1654,324,331,655,"6 de julio de 1997"
20,4,363,1655,169,155,324,"6 de julio de 1997"
20,4,363,1656,101,90,191,"6 de julio de 1997"
20,4,363,1657,162,114,276,"6 de julio de 1997"
20,4,365,1665,76,96,172,"6 de julio de 1997"
20,4,365,1666,230,235,465,"6 de julio de 1997"
20,4,365,1667,145,122,267,"6 de julio de 1997"
20,4,381,1703,457,451,908,"6 de julio de 1997"
20,4,397,1778,448,403,851,"6 de julio de 1997"
20,4,397,1779,233,261,494,"6 de julio de 1997"
20,4,418,1860,725,683,1408,"6 de julio de 1997"
20,4,418,1861,382,330,712,"6 de julio de 1997"
20,4,418,1862,407,389,796,"6 de julio de 1997"
20,4,418,1863,94,95,189,"6 de julio de 1997"
20,4,418,1864,380,393,773,"6 de julio de 1997"
20,4,418,1865,353,339,692,"6 de julio de 1997"
20,4,420,1873,179,197,376,"6 de julio de 1997"
20,4,433,1907,238,222,460,"6 de julio de 1997"
20,4,436,1911,240,251,491,"6 de julio de 1997"
20,4,436,1912,154,125,279,"6 de julio de 1997"
20,4,438,1914,364,344,708,"6 de julio de 1997"
20,4,438,1915,423,463,886,"6 de julio de 1997"
20,4,438,1916,263,227,490,"6 de julio de 1997"
20,4,438,1917,272,213,485,"6 de julio de 1997"
20,4,443,1933,123,135,258,"6 de julio de 1997"
20,4,444,1934,151,146,297,"6 de julio de 1997"
20,4,455,1969,294,246,540,"6 de julio de 1997"
20,4,455,1970,324,258,582,"6 de julio de 1997"
20,4,458,1976,326,286,612,"6 de julio de 1997"
20,4,458,1977,434,330,764,"6 de julio de 1997"
20,4,460,1987,395,380,775,"6 de julio de 1997"
20,4,460,1988,350,348,698,"6 de julio de 1997"
20,4,460,1989,101,95,196,"6 de julio de 1997"
20,4,460,1990,270,276,546,"6 de julio de 1997"
20,4,461,1991,309,307,616,"6 de julio de 1997"
20,4,461,1992,129,120,249,"6 de julio de 1997"
20,4,469,2025,446,418,864,"6 de julio de 1997"
20,4,469,2026,305,272,577,"6 de julio de 1997"
20,4,469,2027,160,113,273,"6 de julio de 1997"
20,4,469,2028,53,50,103,"6 de julio de 1997"
20,4,469,2029,349,338,687,"6 de julio de 1997"
20,4,469,2030,372,318,690,"6 de julio de 1997"
20,4,469,2031,399,453,852,"6 de julio de 1997"
20,4,469,2032,378,359,737,"6 de julio de 1997"
20,4,472,2056,143,141,284,"6 de julio de 1997"
20,4,474,2060,220,235,455,"6 de julio de 1997"
20,4,474,2061,161,183,344,"6 de julio de 1997"
20,4,476,2065,344,448,792,"6 de julio de 1997"
20,4,476,2066,199,263,462,"6 de julio de 1997"
20,4,476,2067,261,373,634,"6 de julio de 1997"
20,4,476,2068,296,375,671,"6 de julio de 1997"
20,4,476,2069,718,787,1505,"6 de julio de 1997"
20,4,497,2148,250,269,519,"6 de julio de 1997"
20,4,497,2149,318,342,660,"6 de julio de 1997"
20,4,503,2167,268,259,527,"6 de julio de 1997"
20,4,503,2168,416,429,845,"6 de julio de 1997"
20,4,503,2169,300,270,570,"6 de julio de 1997"
20,4,503,2170,309,283,592,"6 de julio de 1997"
20,4,504,2171,139,139,278,"6 de julio de 1997"
20,4,505,2172,195,209,404,"6 de julio de 1997"
20,4,514,2199,204,205,409,"6 de julio de 1997"
20,4,517,2231,450,441,891,"6 de julio de 1997"
20,4,517,2232,279,247,526,"6 de julio de 1997"
20,4,517,2233,121,90,211,"6 de julio de 1997"
20,4,522,2245,253,277,530,"6 de julio de 1997"
20,4,540,2311,306,326,632,"6 de julio de 1997"
20,4,540,2312,239,261,500,"6 de julio de 1997"
20,4,540,2313,196,180,376,"6 de julio de 1997"
20,4,540,2314,257,294,551,"6 de julio de 1997"
20,4,540,2315,144,133,277,"6 de julio de 1997"
20,4,541,2316,263,263,526,"6 de julio de 1997"
20,4,541,2317,246,248,494,"6 de julio de 1997"
20,4,546,2331,458,508,966,"6 de julio de 1997"
20,4,546,2332,390,461,851,"6 de julio de 1997"
20,4,546,2333,484,556,1040,"6 de julio de 1997"
20,4,546,2334,186,199,385,"6 de julio de 1997"
20,4,550,2352,475,586,1061,"6 de julio de 1997"
20,4,550,2353,273,360,633,"6 de julio de 1997"
20,4,550,2354,353,414,767,"6 de julio de 1997"
20,4,550,2355,452,615,1067,"6 de julio de 1997"
20,4,550,2356,319,428,747,"6 de julio de 1997"
20,4,550,2357,512,670,1182,"6 de julio de 1997"
20,4,550,2358,388,536,924,"6 de julio de 1997"
20,4,550,2359,140,221,361,"6 de julio de 1997"
20,4,550,2360,275,539,814,"6 de julio de 1997"
20,4,550,2361,136,111,247,"6 de julio de 1997"
20,4,554,2386,292,352,644,"6 de julio de 1997"
20,4,554,2387,248,270,518,"6 de julio de 1997"
20,4,554,2388,252,232,484,"6 de julio de 1997"
20,4,554,2389,265,239,504,"6 de julio de 1997"
20,4,554,2390,104,107,211,"6 de julio de 1997"
20,4,559,2407,356,423,779,"6 de julio de 1997"
20,4,561,2412,458,494,952,"6 de julio de 1997"
20,4,561,2413,417,466,883,"6 de julio de 1997"
20,4,561,2414,297,345,642,"6 de julio de 1997"
20,4,561,2415,341,440,781,"6 de julio de 1997"
20,4,561,2416,91,99,190,"6 de julio de 1997"
20,4,562,2417,233,271,504,"6 de julio de 1997"
20,4,562,2418,287,305,592,"6 de julio de 1997"
20,5,9,68,178,197,375,"6 de julio de 1997"
20,5,9,69,86,64,150,"6 de julio de 1997"
20,5,35,194,432,341,773,"6 de julio de 1997"
20,5,35,195,347,286,633,"6 de julio de 1997"
20,5,35,196,477,382,859,"6 de julio de 1997"
20,5,35,197,256,263,519,"6 de julio de 1997"
20,5,51,380,506,478,984,"6 de julio de 1997"
20,5,51,381,566,551,1117,"6 de julio de 1997"
20,5,51,382,646,634,1280,"6 de julio de 1997"
20,5,51,383,70,64,134,"6 de julio de 1997"
20,5,51,384,42,37,79,"6 de julio de 1997"
20,5,51,385,257,212,469,"6 de julio de 1997"
20,5,52,386,403,426,829,"6 de julio de 1997"
20,5,64,461,274,273,547,"6 de julio de 1997"
20,5,64,462,297,287,584,"6 de julio de 1997"
20,5,64,463,307,329,636,"6 de julio de 1997"
20,5,64,464,278,293,571,"6 de julio de 1997"
20,5,64,465,409,223,632,"6 de julio de 1997"
20,5,64,466,256,231,487,"6 de julio de 1997"
20,5,64,467,121,82,203,"6 de julio de 1997"
20,5,64,468,144,153,297,"6 de julio de 1997"
20,5,76,669,800,807,1607,"6 de julio de 1997"
20,5,76,670,648,656,1304,"6 de julio de 1997"
20,5,76,671,431,491,922,"6 de julio de 1997"
20,5,76,672,634,693,1327,"6 de julio de 1997"
20,5,76,673,794,861,1655,"6 de julio de 1997"
20,5,76,674,584,615,1199,"6 de julio de 1997"
20,5,76,675,617,673,1290,"6 de julio de 1997"
20,5,76,676,561,590,1151,"6 de julio de 1997"
20,5,76,677,575,581,1156,"6 de julio de 1997"
20,5,76,678,640,668,1308,"6 de julio de 1997"
20,5,76,679,776,874,1650,"6 de julio de 1997"
20,5,76,680,574,631,1205,"6 de julio de 1997"
20,5,76,681,495,505,1000,"6 de julio de 1997"
20,5,76,682,476,468,944,"6 de julio de 1997"
20,5,76,683,507,509,1016,"6 de julio de 1997"
20,5,76,684,423,432,855,"6 de julio de 1997"
20,5,76,685,727,759,1486,"6 de julio de 1997"
20,5,76,686,594,671,1265,"6 de julio de 1997"
20,5,76,687,677,675,1352,"6 de julio de 1997"
20,5,76,688,726,763,1489,"6 de julio de 1997"
20,5,76,689,533,574,1107,"6 de julio de 1997"
20,5,76,690,293,344,637,"6 de julio de 1997"
20,5,76,691,552,569,1121,"6 de julio de 1997"
20,5,76,692,513,585,1098,"6 de julio de 1997"
20,5,76,693,588,575,1163,"6 de julio de 1997"
20,5,76,694,657,605,1262,"6 de julio de 1997"
20,5,76,695,492,524,1016,"6 de julio de 1997"
20,5,76,696,546,564,1110,"6 de julio de 1997"
20,5,76,697,656,712,1368,"6 de julio de 1997"
20,5,76,698,676,161,837,"6 de julio de 1997"
20,5,76,699,554,568,1122,"6 de julio de 1997"
20,5,76,700,423,455,878,"6 de julio de 1997"
20,5,76,701,537,504,1041,"6 de julio de 1997"
20,5,76,702,603,490,1093,"6 de julio de 1997"
20,5,76,703,661,626,1287,"6 de julio de 1997"
20,5,76,704,140,136,276,"6 de julio de 1997"
20,5,76,705,81,67,148,"6 de julio de 1997"
20,5,76,706,187,154,341,"6 de julio de 1997"
20,5,76,707,230,209,439,"6 de julio de 1997"
20,5,76,708,542,478,1020,"6 de julio de 1997"
20,5,76,709,442,485,927,"6 de julio de 1997"
20,5,114,803,238,215,453,"6 de julio de 1997"
20,5,121,814,605,596,1201,"6 de julio de 1997"
20,5,121,815,728,694,1422,"6 de julio de 1997"
20,5,121,816,770,833,1603,"6 de julio de 1997"
20,5,121,817,672,688,1360,"6 de julio de 1997"
20,5,121,818,776,760,1536,"6 de julio de 1997"
20,5,121,819,658,685,1343,"6 de julio de 1997"
20,5,122,820,241,228,469,"6 de julio de 1997"
20,5,122,821,347,139,486,"6 de julio de 1997"
20,5,122,822,154,121,275,"6 de julio de 1997"
20,5,122,823,282,79,361,"6 de julio de 1997"
20,5,122,824,351,332,683,"6 de julio de 1997"
20,5,122,825,183,162,345,"6 de julio de 1997"
20,5,122,826,257,211,468,"6 de julio de 1997"
20,5,122,827,173,131,304,"6 de julio de 1997"
20,5,122,828,166,158,324,"6 de julio de 1997"
20,5,122,829,411,369,780,"6 de julio de 1997"
20,5,122,830,60,60,120,"6 de julio de 1997"
20,5,192,1119,507,376,883,"6 de julio de 1997"
20,5,192,1120,631,568,1199,"6 de julio de 1997"
20,5,192,1121,430,390,820,"6 de julio de 1997"
20,5,192,1122,664,657,1321,"6 de julio de 1997"
20,5,192,1123,646,599,1245,"6 de julio de 1997"
20,5,192,1124,850,850,1700,"6 de julio de 1997"
20,5,192,1125,412,365,777,"6 de julio de 1997"
20,5,192,1126,427,349,776,"6 de julio de 1997"
20,5,192,1127,470,499,969,"6 de julio de 1997"
20,5,192,1128,151,125,276,"6 de julio de 1997"
20,5,205,1176,175,237,412,"6 de julio de 1997"
20,5,207,1184,422,390,812,"6 de julio de 1997"
20,5,207,1185,512,442,954,"6 de julio de 1997"
20,5,207,1186,627,556,1183,"6 de julio de 1997"
20,5,207,1187,427,392,819,"6 de julio de 1997"
20,5,207,1188,153,152,305,"6 de julio de 1997"
20,5,207,1189,447,386,833,"6 de julio de 1997"
20,5,207,1190,298,280,578,"6 de julio de 1997"
20,5,207,1191,307,253,560,"6 de julio de 1997"
20,5,207,1192,225,215,440,"6 de julio de 1997"
20,5,247,1297,648,543,1191,"6 de julio de 1997"
20,5,247,1298,561,468,1029,"6 de julio de 1997"
20,5,247,1299,465,420,885,"6 de julio de 1997"
20,5,247,1300,591,527,1118,"6 de julio de 1997"
20,5,247,1301,527,433,960,"6 de julio de 1997"
20,5,280,1402,209,194,403,"6 de julio de 1997"
20,5,280,1403,49,21,70,"6 de julio de 1997"
20,5,303,1461,709,802,1511,"6 de julio de 1997"
20,5,303,1462,497,560,1057,"6 de julio de 1997"
20,5,305,1465,267,286,553,"6 de julio de 1997"
20,5,305,1466,284,285,569,"6 de julio de 1997"
20,5,305,1467,86,67,153,"6 de julio de 1997"
20,5,305,1468,348,266,614,"6 de julio de 1997"
20,5,305,1469,86,93,179,"6 de julio de 1997"
20,5,305,1470,585,493,1078,"6 de julio de 1997"
20,5,305,1471,483,388,871,"6 de julio de 1997"
20,5,306,1472,671,632,1303,"6 de julio de 1997"
20,5,323,1535,301,296,597,"6 de julio de 1997"
20,5,323,1536,363,340,703,"6 de julio de 1997"
20,5,323,1537,384,347,731,"6 de julio de 1997"
20,5,323,1538,273,264,537,"6 de julio de 1997"
20,5,323,1539,350,288,638,"6 de julio de 1997"
20,5,323,1540,386,397,783,"6 de julio de 1997"
20,5,331,1561,433,498,931,"6 de julio de 1997"
20,5,331,1562,227,274,501,"6 de julio de 1997"
20,5,331,1563,144,147,291,"6 de julio de 1997"
20,5,357,1646,280,282,562,"6 de julio de 1997"
20,5,411,1834,270,282,552,"6 de julio de 1997"
20,5,411,1835,161,127,288,"6 de julio de 1997"
20,5,411,1836,235,223,458,"6 de julio de 1997"
20,5,411,1837,267,219,486,"6 de julio de 1997"
20,5,413,1839,511,457,968,"6 de julio de 1997"
20,5,413,1840,197,85,282,"6 de julio de 1997"
20,5,419,1866,550,620,1170,"6 de julio de 1997"
20,5,419,1867,431,508,939,"6 de julio de 1997"
20,5,419,1868,481,530,1011,"6 de julio de 1997"
20,5,419,1869,392,442,834,"6 de julio de 1997"
20,5,419,1870,482,563,1045,"6 de julio de 1997"
20,5,419,1871,232,178,410,"6 de julio de 1997"
20,5,419,1872,314,334,648,"6 de julio de 1997"
20,5,422,1875,338,363,701,"6 de julio de 1997"
20,5,422,1876,447,490,937,"6 de julio de 1997"
20,5,422,1877,359,377,736,"6 de julio de 1997"
20,5,429,1903,342,289,631,"6 de julio de 1997"
20,5,441,1928,271,303,574,"6 de julio de 1997"
20,5,454,1965,321,299,620,"6 de julio de 1997"
20,5,454,1966,271,264,535,"6 de julio de 1997"
20,5,454,1967,75,51,126,"6 de julio de 1997"
20,5,454,1968,213,171,384,"6 de julio de 1997"
20,5,466,2004,286,303,589,"6 de julio de 1997"
20,5,471,2050,357,278,635,"6 de julio de 1997"
20,5,471,2051,327,251,578,"6 de julio de 1997"
20,5,471,2052,242,238,480,"6 de julio de 1997"
20,5,471,2053,194,183,377,"6 de julio de 1997"
20,5,471,2054,210,172,382,"6 de julio de 1997"
20,5,471,2055,140,115,255,"6 de julio de 1997"
20,5,473,2057,352,354,706,"6 de julio de 1997"
20,5,473,2058,487,503,990,"6 de julio de 1997"
20,5,473,2059,102,87,189,"6 de julio de 1997"
20,5,499,2151,234,211,445,"6 de julio de 1997"
20,5,499,2152,183,143,326,"6 de julio de 1997"
20,5,499,2153,487,402,889,"6 de julio de 1997"
20,5,499,2154,265,274,539,"6 de julio de 1997"
20,5,499,2155,345,328,673,"6 de julio de 1997"
20,5,507,2175,486,490,976,"6 de julio de 1997"
20,5,515,2200,628,642,1270,"6 de julio de 1997"
20,5,515,2201,503,475,978,"6 de julio de 1997"
20,5,515,2202,729,788,1517,"6 de julio de 1997"
20,5,515,2203,480,564,1044,"6 de julio de 1997"
20,5,515,2204,420,445,865,"6 de julio de 1997"
20,5,515,2205,506,539,1045,"6 de julio de 1997"
20,5,515,2206,564,618,1182,"6 de julio de 1997"
20,5,515,2207,953,919,1872,"6 de julio de 1997"
20,5,515,2208,368,393,761,"6 de julio de 1997"
20,5,515,2209,484,546,1030,"6 de julio de 1997"
20,5,515,2210,659,710,1369,"6 de julio de 1997"
20,5,515,2211,217,217,434,"6 de julio de 1997"
20,5,515,2212,439,501,940,"6 de julio de 1997"
20,5,515,2213,444,489,933,"6 de julio de 1997"
20,5,515,2214,717,736,1453,"6 de julio de 1997"
20,5,515,2215,653,698,1351,"6 de julio de 1997"
20,5,515,2216,682,680,1362,"6 de julio de 1997"
20,5,515,2217,672,688,1360,"6 de julio de 1997"
20,5,515,2218,669,639,1308,"6 de julio de 1997"
20,5,515,2219,532,532,1064,"6 de julio de 1997"
20,5,515,2220,291,310,601,"6 de julio de 1997"
20,5,515,2221,457,508,965,"6 de julio de 1997"
20,5,515,2222,347,279,626,"6 de julio de 1997"
20,5,515,2223,233,193,426,"6 de julio de 1997"
20,5,515,2224,451,421,872,"6 de julio de 1997"
20,5,515,2225,133,110,243,"6 de julio de 1997"
20,5,515,2226,562,520,1082,"6 de julio de 1997"
20,5,515,2227,498,421,919,"6 de julio de 1997"
20,5,515,2228,497,445,942,"6 de julio de 1997"
20,6,7,57,479,550,1029,"6 de julio de 1997"
20,6,7,58,539,643,1182,"6 de julio de 1997"
20,6,7,59,592,661,1253,"6 de julio de 1997"
20,6,7,60,585,635,1220,"6 de julio de 1997"
20,6,7,61,308,299,607,"6 de julio de 1997"
20,6,7,62,200,201,401,"6 de julio de 1997"
20,6,7,63,217,230,447,"6 de julio de 1997"
20,6,7,64,161,191,352,"6 de julio de 1997"
20,6,16,104,289,307,596,"6 de julio de 1997"
20,6,16,105,219,266,485,"6 de julio de 1997"
20,6,16,106,230,243,473,"6 de julio de 1997"
20,6,16,107,292,350,642,"6 de julio de 1997"
20,6,16,108,194,220,414,"6 de julio de 1997"
20,6,16,109,267,295,562,"6 de julio de 1997"
20,6,16,110,326,355,681,"6 de julio de 1997"
20,6,23,131,233,269,502,"6 de julio de 1997"
20,6,23,132,151,148,299,"6 de julio de 1997"
20,6,23,133,131,163,294,"6 de julio de 1997"
20,6,36,198,566,678,1244,"6 de julio de 1997"
20,6,36,199,89,117,206,"6 de julio de 1997"
20,6,36,200,269,288,557,"6 de julio de 1997"
20,6,46,369,394,408,802,"6 de julio de 1997"
20,6,46,370,186,191,377,"6 de julio de 1997"
20,6,46,371,308,350,658,"6 de julio de 1997"
20,6,46,372,118,117,235,"6 de julio de 1997"
20,6,49,375,235,222,457,"6 de julio de 1997"
20,6,49,376,189,165,354,"6 de julio de 1997"
20,6,49,377,232,189,421,"6 de julio de 1997"
20,6,53,387,303,305,608,"6 de julio de 1997"
20,6,54,388,146,157,303,"6 de julio de 1997"
20,6,71,643,514,646,1160,"6 de julio de 1997"
20,6,71,644,372,419,791,"6 de julio de 1997"
20,6,71,645,530,570,1100,"6 de julio de 1997"
20,6,71,646,420,524,944,"6 de julio de 1997"
20,6,71,647,425,539,964,"6 de julio de 1997"
20,6,71,648,468,563,1031,"6 de julio de 1997"
20,6,71,649,222,310,532,"6 de julio de 1997"
20,6,71,650,245,310,555,"6 de julio de 1997"
20,6,71,651,121,183,304,"6 de julio de 1997"
20,6,71,652,183,216,399,"6 de julio de 1997"
20,6,71,653,222,276,498,"6 de julio de 1997"
20,6,71,654,461,540,1001,"6 de julio de 1997"
20,6,71,655,330,395,725,"6 de julio de 1997"
20,6,71,656,307,330,637,"6 de julio de 1997"
20,6,71,657,356,371,727,"6 de julio de 1997"
20,6,71,658,165,163,328,"6 de julio de 1997"
20,6,71,659,486,497,983,"6 de julio de 1997"
20,6,71,660,246,275,521,"6 de julio de 1997"
20,6,73,663,267,327,594,"6 de julio de 1997"
20,6,73,664,195,285,480,"6 de julio de 1997"
20,6,73,665,182,170,352,"6 de julio de 1997"
20,6,83,734,101,128,229,"6 de julio de 1997"
20,6,83,735,99,136,235,"6 de julio de 1997"
20,6,85,738,269,268,537,"6 de julio de 1997"
20,6,85,739,162,156,318,"6 de julio de 1997"
20,6,85,740,202,191,393,"6 de julio de 1997"
20,6,91,751,241,276,517,"6 de julio de 1997"
20,6,91,752,251,256,507,"6 de julio de 1997"
20,6,93,756,209,225,434,"6 de julio de 1997"
20,6,107,789,233,274,507,"6 de julio de 1997"
20,6,118,810,112,156,268,"6 de julio de 1997"
20,6,124,835,230,192,422,"6 de julio de 1997"
20,6,130,847,220,235,455,"6 de julio de 1997"
20,6,130,848,154,147,301,"6 de julio de 1997"
20,6,130,849,189,164,353,"6 de julio de 1997"
20,6,130,850,171,178,349,"6 de julio de 1997"
20,6,137,876,198,199,397,"6 de julio de 1997"
20,6,141,891,168,162,330,"6 de julio de 1997"
20,6,141,892,200,219,419,"6 de julio de 1997"
20,6,144,896,117,104,221,"6 de julio de 1997"
20,6,171,978,159,188,347,"6 de julio de 1997"
20,6,196,1134,271,287,558,"6 de julio de 1997"
20,6,196,1135,158,192,350,"6 de julio de 1997"
20,6,208,1193,87,131,218,"6 de julio de 1997"
20,6,208,1194,124,184,308,"6 de julio de 1997"
20,6,208,1195,317,413,730,"6 de julio de 1997"
20,6,208,1196,107,125,232,"6 de julio de 1997"
20,6,208,1197,62,71,133,"6 de julio de 1997"
20,6,208,1198,173,214,387,"6 de julio de 1997"
20,6,208,1199,382,495,877,"6 de julio de 1997"
20,6,208,1200,162,216,378,"6 de julio de 1997"
20,6,208,1201,184,237,421,"6 de julio de 1997"
20,6,208,1202,219,269,488,"6 de julio de 1997"
20,6,208,1203,138,216,354,"6 de julio de 1997"
20,6,210,1205,247,291,538,"6 de julio de 1997"
20,6,210,1206,317,406,723,"6 de julio de 1997"
20,6,210,1207,229,303,532,"6 de julio de 1997"
20,6,210,1208,223,264,487,"6 de julio de 1997"
20,6,210,1209,188,224,412,"6 de julio de 1997"
20,6,215,1219,198,214,412,"6 de julio de 1997"
20,6,217,1221,150,144,294,"6 de julio de 1997"
20,6,217,1222,185,202,387,"6 de julio de 1997"
20,6,217,1223,268,287,555,"6 de julio de 1997"
20,6,217,1224,118,125,243,"6 de julio de 1997"
20,6,218,1225,151,138,289,"6 de julio de 1997"
20,6,239,1283,283,334,617,"6 de julio de 1997"
20,6,240,1284,449,621,1070,"6 de julio de 1997"
20,6,248,1302,301,283,584,"6 de julio de 1997"
20,6,250,1304,231,305,536,"6 de julio de 1997"
20,6,250,1305,139,103,242,"6 de julio de 1997"
20,6,253,1314,416,415,831,"6 de julio de 1997"
20,6,257,1319,249,267,516,"6 de julio de 1997"
20,6,268,1354,149,189,338,"6 de julio de 1997"
20,6,268,1355,188,233,421,"6 de julio de 1997"
20,6,268,1356,160,219,379,"6 de julio de 1997"
20,6,268,1357,160,226,386,"6 de julio de 1997"
20,6,268,1358,170,205,375,"6 de julio de 1997"
20,6,273,1367,338,356,694,"6 de julio de 1997"
20,6,279,1401,76,85,161,"6 de julio de 1997"
20,6,295,1438,205,157,362,"6 de julio de 1997"
20,6,295,1439,191,136,327,"6 de julio de 1997"
20,6,298,1449,537,600,1137,"6 de julio de 1997"
20,6,298,1450,334,369,703,"6 de julio de 1997"
20,6,298,1451,322,377,699,"6 de julio de 1997"
20,6,302,1459,223,237,460,"6 de julio de 1997"
20,6,302,1460,74,67,141,"6 de julio de 1997"
20,6,315,1496,215,255,470,"6 de julio de 1997"
20,6,315,1497,110,125,235,"6 de julio de 1997"
20,6,318,1512,176,204,380,"6 de julio de 1997"
20,6,327,1554,324,314,638,"6 de julio de 1997"
20,6,329,1558,125,124,249,"6 de julio de 1997"
20,6,329,1559,103,136,239,"6 de julio de 1997"
20,6,330,1560,155,155,310,"6 de julio de 1997"
20,6,352,1640,176,187,363,"6 de julio de 1997"
20,6,371,1677,180,200,380,"6 de julio de 1997"
20,6,372,1678,56,88,144,"6 de julio de 1997"
20,6,372,1679,109,156,265,"6 de julio de 1997"
20,6,373,1680,160,189,349,"6 de julio de 1997"
20,6,373,1681,82,101,183,"6 de julio de 1997"
20,6,373,1682,170,184,354,"6 de julio de 1997"
20,6,378,1691,256,291,547,"6 de julio de 1997"
20,6,378,1692,160,154,314,"6 de julio de 1997"
20,6,378,1693,366,306,672,"6 de julio de 1997"
20,6,378,1694,82,79,161,"6 de julio de 1997"
20,6,378,1695,430,463,893,"6 de julio de 1997"
20,6,378,1696,177,163,340,"6 de julio de 1997"
20,6,378,1697,241,197,438,"6 de julio de 1997"
20,6,378,1698,384,356,740,"6 de julio de 1997"
20,6,380,1702,503,603,1106,"6 de julio de 1997"
20,6,383,1707,288,324,612,"6 de julio de 1997"
20,6,384,1708,139,140,279,"6 de julio de 1997"
20,6,391,1743,186,190,376,"6 de julio de 1997"
20,6,391,1744,188,203,391,"6 de julio de 1997"
20,6,391,1745,173,195,368,"6 de julio de 1997"
20,6,394,1771,238,273,511,"6 de julio de 1997"
20,6,394,1772,208,217,425,"6 de julio de 1997"
20,6,394,1773,282,303,585,"6 de julio de 1997"
20,6,394,1774,301,310,611,"6 de julio de 1997"
20,6,394,1775,299,333,632,"6 de julio de 1997"
20,6,398,1780,310,346,656,"6 de julio de 1997"
20,6,398,1781,197,226,423,"6 de julio de 1997"
20,6,409,1828,111,109,220,"6 de julio de 1997"
20,6,416,1856,407,419,826,"6 de julio de 1997"
20,6,416,1857,310,306,616,"6 de julio de 1997"
20,6,416,1858,230,315,545,"6 de julio de 1997"
20,6,424,1880,112,130,242,"6 de julio de 1997"
20,6,424,1881,101,94,195,"6 de julio de 1997"
20,6,428,1898,269,307,576,"6 de julio de 1997"
20,6,428,1899,335,339,674,"6 de julio de 1997"
20,6,428,1900,274,295,569,"6 de julio de 1997"
20,6,428,1901,301,298,599,"6 de julio de 1997"
20,6,428,1902,243,258,501,"6 de julio de 1997"
20,6,431,1905,79,98,177,"6 de julio de 1997"
20,6,445,1935,110,124,234,"6 de julio de 1997"
20,6,446,1936,286,326,612,"6 de julio de 1997"
20,6,447,1937,472,473,945,"6 de julio de 1997"
20,6,447,1938,571,506,1077,"6 de julio de 1997"
20,6,447,1939,448,413,861,"6 de julio de 1997"
20,6,448,1940,287,441,728,"6 de julio de 1997"
20,6,448,1941,309,402,711,"6 de julio de 1997"
20,6,448,1942,375,463,838,"6 de julio de 1997"
20,6,448,1943,304,311,615,"6 de julio de 1997"
20,6,448,1944,254,317,571,"6 de julio de 1997"
20,6,448,1945,216,236,452,"6 de julio de 1997"
20,6,448,1946,306,368,674,"6 de julio de 1997"
20,6,448,1947,295,326,621,"6 de julio de 1997"
20,6,448,1948,189,176,365,"6 de julio de 1997"
20,6,448,1949,172,222,394,"6 de julio de 1997"
20,6,464,1999,173,196,369,"6 de julio de 1997"
20,6,464,2000,33,29,62,"6 de julio de 1997"
20,6,464,2001,58,51,109,"6 de julio de 1997"
20,6,480,2076,110,96,206,"6 de julio de 1997"
20,6,482,2084,131,133,264,"6 de julio de 1997"
20,6,482,2085,96,87,183,"6 de julio de 1997"
20,6,483,2086,387,407,794,"6 de julio de 1997"
20,6,483,2087,323,318,641,"6 de julio de 1997"
20,6,493,2135,231,260,491,"6 de julio de 1997"
20,6,493,2136,168,189,357,"6 de julio de 1997"
20,6,493,2137,296,323,619,"6 de julio de 1997"
20,6,493,2138,219,216,435,"6 de julio de 1997"
20,6,494,2139,168,166,334,"6 de julio de 1997"
20,6,495,2140,276,339,615,"6 de julio de 1997"
20,6,495,2141,243,270,513,"6 de julio de 1997"
20,6,495,2142,251,307,558,"6 de julio de 1997"
20,6,495,2143,159,223,382,"6 de julio de 1997"
20,6,501,2158,240,302,542,"6 de julio de 1997"
20,6,501,2159,163,207,370,"6 de julio de 1997"
20,6,501,2160,297,378,675,"6 de julio de 1997"
20,6,501,2161,119,128,247,"6 de julio de 1997"
20,6,501,2162,293,324,617,"6 de julio de 1997"
20,6,501,2163,236,228,464,"6 de julio de 1997"
20,6,501,2164,341,298,639,"6 de julio de 1997"
20,6,510,2185,166,204,370,"6 de julio de 1997"
20,6,511,2186,168,150,318,"6 de julio de 1997"
20,6,511,2187,187,167,354,"6 de julio de 1997"
20,6,511,2188,389,373,762,"6 de julio de 1997"
20,6,518,2234,61,64,125,"6 de julio de 1997"
20,6,528,2262,398,474,872,"6 de julio de 1997"
20,6,528,2263,423,461,884,"6 de julio de 1997"
20,6,553,2367,613,692,1305,"6 de julio de 1997"
20,6,553,2368,504,540,1044,"6 de julio de 1997"
20,6,553,2369,352,374,726,"6 de julio de 1997"
20,6,553,2370,283,339,622,"6 de julio de 1997"
20,6,553,2371,462,546,1008,"6 de julio de 1997"
20,6,553,2372,489,568,1057,"6 de julio de 1997"
20,6,553,2373,636,728,1364,"6 de julio de 1997"
20,6,553,2374,419,457,876,"6 de julio de 1997"
20,6,553,2375,587,591,1178,"6 de julio de 1997"
20,6,553,2376,484,458,942,"6 de julio de 1997"
20,6,553,2377,128,149,277,"6 de julio de 1997"
20,6,553,2378,63,62,125,"6 de julio de 1997"
20,6,553,2379,183,182,365,"6 de julio de 1997"
20,6,553,2380,383,339,722,"6 de julio de 1997"
20,6,553,2381,316,330,646,"6 de julio de 1997"
20,6,553,2382,361,408,769,"6 de julio de 1997"
20,6,553,2383,328,361,689,"6 de julio de 1997"
20,6,553,2384,61,60,121,"6 de julio de 1997"
20,6,553,2385,94,123,217,"6 de julio de 1997"
20,6,565,2422,291,332,623,"6 de julio de 1997"
20,7,6,43,319,260,579,"6 de julio de 1997"
20,7,6,44,348,324,672,"6 de julio de 1997"
20,7,6,45,309,330,639,"6 de julio de 1997"
20,7,6,46,346,348,694,"6 de julio de 1997"
20,7,6,47,503,476,979,"6 de julio de 1997"
20,7,6,48,276,289,565,"6 de julio de 1997"
20,7,6,49,347,371,718,"6 de julio de 1997"
20,7,6,50,326,345,671,"6 de julio de 1997"
20,7,6,51,412,370,782,"6 de julio de 1997"
20,7,6,52,330,345,675,"6 de julio de 1997"
20,7,6,53,290,238,528,"6 de julio de 1997"
20,7,6,54,307,278,585,"6 de julio de 1997"
20,7,6,55,121,105,226,"6 de julio de 1997"
20,7,6,56,384,329,713,"6 de julio de 1997"
20,7,12,77,465,475,940,"6 de julio de 1997"
20,7,12,78,421,419,840,"6 de julio de 1997"
20,7,12,79,574,554,1128,"6 de julio de 1997"
20,7,12,80,532,567,1099,"6 de julio de 1997"
20,7,12,81,82,54,136,"6 de julio de 1997"
20,7,12,82,362,341,703,"6 de julio de 1997"
20,7,12,83,222,260,482,"6 de julio de 1997"
20,7,12,84,456,433,889,"6 de julio de 1997"
20,7,12,85,172,140,312,"6 de julio de 1997"
20,7,12,86,415,419,834,"6 de julio de 1997"
20,7,15,97,300,247,547,"6 de julio de 1997"
20,7,15,98,368,320,688,"6 de julio de 1997"
20,7,15,99,368,370,738,"6 de julio de 1997"
20,7,15,100,407,367,774,"6 de julio de 1997"
20,7,15,101,486,485,971,"6 de julio de 1997"
20,7,15,102,485,513,998,"6 de julio de 1997"
20,7,15,103,371,326,697,"6 de julio de 1997"
20,7,30,180,379,370,749,"6 de julio de 1997"
20,7,30,181,334,355,689,"6 de julio de 1997"
20,7,30,182,307,323,630,"6 de julio de 1997"
20,7,30,183,338,334,672,"6 de julio de 1997"
20,7,30,184,334,350,684,"6 de julio de 1997"
20,7,30,185,335,374,709,"6 de julio de 1997"
20,7,30,186,339,344,683,"6 de julio de 1997"
20,7,41,258,552,595,1147,"6 de julio de 1997"
20,7,41,259,416,496,912,"6 de julio de 1997"
20,7,41,260,349,390,739,"6 de julio de 1997"
20,7,41,261,436,485,921,"6 de julio de 1997"
20,7,41,262,381,395,776,"6 de julio de 1997"
20,7,41,263,340,411,751,"6 de julio de 1997"
20,7,41,264,422,426,848,"6 de julio de 1997"
20,7,41,265,344,354,698,"6 de julio de 1997"
20,7,41,266,291,377,668,"6 de julio de 1997"
20,7,41,267,343,387,730,"6 de julio de 1997"
20,7,41,268,326,383,709,"6 de julio de 1997"
20,7,41,269,405,441,846,"6 de julio de 1997"
20,7,41,270,323,387,710,"6 de julio de 1997"
20,7,41,271,343,288,631,"6 de julio de 1997"
20,7,41,272,379,409,788,"6 de julio de 1997"
20,7,41,273,359,446,805,"6 de julio de 1997"
20,7,41,274,389,367,756,"6 de julio de 1997"
20,7,41,275,44,42,86,"6 de julio de 1997"
20,7,43,283,373,351,724,"6 de julio de 1997"
20,7,43,284,512,563,1075,"6 de julio de 1997"
20,7,43,285,458,488,946,"6 de julio de 1997"
20,7,43,286,407,447,854,"6 de julio de 1997"
20,7,43,287,426,416,842,"6 de julio de 1997"
20,7,43,288,476,510,986,"6 de julio de 1997"
20,7,43,289,621,647,1268,"6 de julio de 1997"
20,7,43,290,515,539,1054,"6 de julio de 1997"
20,7,43,291,545,502,1047,"6 de julio de 1997"
20,7,43,292,523,559,1082,"6 de julio de 1997"
20,7,43,293,674,712,1386,"6 de julio de 1997"
20,7,43,294,546,552,1098,"6 de julio de 1997"
20,7,43,295,221,245,466,"6 de julio de 1997"
20,7,43,296,405,454,859,"6 de julio de 1997"
20,7,43,297,348,404,752,"6 de julio de 1997"
20,7,43,298,288,338,626,"6 de julio de 1997"
20,7,43,299,483,467,950,"6 de julio de 1997"
20,7,43,300,318,337,655,"6 de julio de 1997"
20,7,43,301,433,443,876,"6 de julio de 1997"
20,7,43,302,532,572,1104,"6 de julio de 1997"
20,7,43,303,420,412,832,"6 de julio de 1997"
20,7,43,304,536,517,1053,"6 de julio de 1997"
20,7,43,305,344,423,767,"6 de julio de 1997"
20,7,43,306,375,383,758,"6 de julio de 1997"
20,7,43,307,449,472,921,"6 de julio de 1997"
20,7,43,308,406,436,842,"6 de julio de 1997"
20,7,43,309,339,387,726,"6 de julio de 1997"
20,7,43,310,625,602,1227,"6 de julio de 1997"
20,7,43,311,479,457,936,"6 de julio de 1997"
20,7,43,312,542,481,1023,"6 de julio de 1997"
20,7,43,313,511,548,1059,"6 de julio de 1997"
20,7,43,314,431,441,872,"6 de julio de 1997"
20,7,43,315,416,426,842,"6 de julio de 1997"
20,7,43,316,572,544,1116,"6 de julio de 1997"
20,7,43,317,384,360,744,"6 de julio de 1997"
20,7,43,318,405,385,790,"6 de julio de 1997"
20,7,43,319,326,278,604,"6 de julio de 1997"
20,7,43,320,425,338,763,"6 de julio de 1997"
20,7,43,321,561,501,1062,"6 de julio de 1997"
20,7,43,322,389,346,735,"6 de julio de 1997"
20,7,43,323,363,372,735,"6 de julio de 1997"
20,7,43,324,318,285,603,"6 de julio de 1997"
20,7,43,325,590,616,1206,"6 de julio de 1997"
20,7,43,326,516,524,1040,"6 de julio de 1997"
20,7,43,327,271,262,533,"6 de julio de 1997"
20,7,43,328,231,261,492,"6 de julio de 1997"
20,7,43,329,307,358,665,"6 de julio de 1997"
20,7,43,330,544,491,1035,"6 de julio de 1997"
20,7,43,331,483,404,887,"6 de julio de 1997"
20,7,43,332,234,205,439,"6 de julio de 1997"
20,7,57,397,589,660,1249,"6 de julio de 1997"
20,7,57,398,377,434,811,"6 de julio de 1997"
20,7,57,399,391,465,856,"6 de julio de 1997"
20,7,57,400,524,583,1107,"6 de julio de 1997"
20,7,57,401,417,448,865,"6 de julio de 1997"
20,7,57,402,510,542,1052,"6 de julio de 1997"
20,7,57,403,454,541,995,"6 de julio de 1997"
20,7,57,404,406,469,875,"6 de julio de 1997"
20,7,57,405,495,587,1082,"6 de julio de 1997"
20,7,57,406,467,516,983,"6 de julio de 1997"
20,7,57,407,613,663,1276,"6 de julio de 1997"
20,7,57,408,483,535,1018,"6 de julio de 1997"
20,7,57,409,490,511,1001,"6 de julio de 1997"
20,7,57,410,465,502,967,"6 de julio de 1997"
20,7,57,411,256,278,534,"6 de julio de 1997"
20,7,57,412,456,430,886,"6 de julio de 1997"
20,7,57,413,157,132,289,"6 de julio de 1997"
20,7,57,414,442,413,855,"6 de julio de 1997"
20,7,57,415,638,643,1281,"6 de julio de 1997"
20,7,57,416,466,437,903,"6 de julio de 1997"
20,7,57,417,346,342,688,"6 de julio de 1997"
20,7,57,418,88,89,177,"6 de julio de 1997"
20,7,57,419,246,172,418,"6 de julio de 1997"
20,7,57,420,787,628,1415,"6 de julio de 1997"
20,7,57,421,66,64,130,"6 de julio de 1997"
20,7,72,661,388,362,750,"6 de julio de 1997"
20,7,72,662,460,423,883,"6 de julio de 1997"
20,7,127,838,518,458,976,"6 de julio de 1997"
20,7,127,839,385,321,706,"6 de julio de 1997"
20,7,127,840,403,376,779,"6 de julio de 1997"
20,7,138,877,499,455,954,"6 de julio de 1997"
20,7,138,878,420,426,846,"6 de julio de 1997"
20,7,138,879,300,227,527,"6 de julio de 1997"
20,7,138,880,83,72,155,"6 de julio de 1997"
20,7,138,881,298,196,494,"6 de julio de 1997"
20,7,140,883,456,407,863,"6 de julio de 1997"
20,7,140,884,444,382,826,"6 de julio de 1997"
20,7,140,885,441,423,864,"6 de julio de 1997"
20,7,140,886,382,384,766,"6 de julio de 1997"
20,7,140,887,389,321,710,"6 de julio de 1997"
20,7,140,888,63,58,121,"6 de julio de 1997"
20,7,140,889,281,253,534,"6 de julio de 1997"
20,7,140,890,81,44,125,"6 de julio de 1997"
20,7,199,1139,342,388,730,"6 de julio de 1997"
20,7,199,1140,325,383,708,"6 de julio de 1997"
20,7,199,1141,421,542,963,"6 de julio de 1997"
20,7,199,1142,416,568,984,"6 de julio de 1997"
20,7,199,1143,175,159,334,"6 de julio de 1997"
20,7,199,1144,366,316,682,"6 de julio de 1997"
20,7,199,1145,310,311,621,"6 de julio de 1997"
20,7,199,1146,197,160,357,"6 de julio de 1997"
20,7,199,1147,146,143,289,"6 de julio de 1997"
20,7,199,1148,245,277,522,"6 de julio de 1997"
20,7,199,1149,338,374,712,"6 de julio de 1997"
20,7,199,1150,305,336,641,"6 de julio de 1997"
20,7,199,1151,337,381,718,"6 de julio de 1997"
20,7,199,1152,212,188,400,"6 de julio de 1997"
20,7,199,1153,217,277,494,"6 de julio de 1997"
20,7,199,1154,368,442,810,"6 de julio de 1997"
20,7,199,1155,292,405,697,"6 de julio de 1997"
20,7,199,1156,321,374,695,"6 de julio de 1997"
20,7,199,1157,471,510,981,"6 de julio de 1997"
20,7,199,1158,387,525,912,"6 de julio de 1997"
20,7,199,1159,329,375,704,"6 de julio de 1997"
20,7,199,1160,373,420,793,"6 de julio de 1997"
20,7,199,1161,378,403,781,"6 de julio de 1997"
20,7,263,1338,288,276,564,"6 de julio de 1997"
20,7,263,1339,237,199,436,"6 de julio de 1997"
20,7,263,1340,134,100,234,"6 de julio de 1997"
20,7,263,1341,26,24,50,"6 de julio de 1997"
20,7,263,1342,109,116,225,"6 de julio de 1997"
20,7,263,1343,291,281,572,"6 de julio de 1997"
20,7,263,1344,495,445,940,"6 de julio de 1997"
20,7,325,1544,397,394,791,"6 de julio de 1997"
20,7,325,1545,521,573,1094,"6 de julio de 1997"
20,7,325,1546,301,325,626,"6 de julio de 1997"
20,7,325,1547,321,285,606,"6 de julio de 1997"
20,7,325,1548,349,346,695,"6 de julio de 1997"
20,7,325,1549,482,400,882,"6 de julio de 1997"
20,7,325,1550,671,602,1273,"6 de julio de 1997"
20,7,325,1551,93,64,157,"6 de julio de 1997"
20,7,325,1552,228,171,399,"6 de julio de 1997"
20,7,405,1810,739,637,1376,"6 de julio de 1997"
20,7,405,1811,264,236,500,"6 de julio de 1997"
20,7,405,1812,244,218,462,"6 de julio de 1997"
20,7,405,1813,59,54,113,"6 de julio de 1997"
20,7,405,1814,53,47,100,"6 de julio de 1997"
20,7,405,1815,303,232,535,"6 de julio de 1997"
20,7,427,1888,239,225,464,"6 de julio de 1997"
20,7,427,1889,355,369,724,"6 de julio de 1997"
20,7,427,1890,280,284,564,"6 de julio de 1997"
20,7,427,1891,463,521,984,"6 de julio de 1997"
20,7,427,1892,256,277,533,"6 de julio de 1997"
20,7,427,1893,451,340,791,"6 de julio de 1997"
20,7,427,1894,361,367,728,"6 de julio de 1997"
20,7,427,1895,355,309,664,"6 de julio de 1997"
20,7,427,1896,231,236,467,"6 de julio de 1997"
20,7,427,1897,191,164,355,"6 de julio de 1997"
20,7,442,1929,375,368,743,"6 de julio de 1997"
20,7,442,1930,521,507,1028,"6 de julio de 1997"
20,7,442,1931,420,392,812,"6 de julio de 1997"
20,7,442,1932,372,369,741,"6 de julio de 1997"
20,7,481,2077,215,194,409,"6 de julio de 1997"
20,7,481,2078,318,343,661,"6 de julio de 1997"
20,7,481,2079,387,413,800,"6 de julio de 1997"
20,7,481,2080,264,244,508,"6 de julio de 1997"
20,7,481,2081,217,155,372,"6 de julio de 1997"
20,7,481,2082,105,84,189,"6 de julio de 1997"
20,7,481,2083,197,146,343,"6 de julio de 1997"
20,7,509,2180,378,379,757,"6 de julio de 1997"
20,7,509,2181,616,625,1241,"6 de julio de 1997"
20,7,509,2182,548,549,1097,"6 de julio de 1997"
20,7,509,2183,316,321,637,"6 de julio de 1997"
20,7,509,2184,516,474,990,"6 de julio de 1997"
20,7,513,2190,273,246,519,"6 de julio de 1997"
20,7,513,2191,302,301,603,"6 de julio de 1997"
20,7,513,2192,347,335,682,"6 de julio de 1997"
20,7,513,2193,373,350,723,"6 de julio de 1997"
20,7,513,2194,239,217,456,"6 de julio de 1997"
20,7,513,2195,255,214,469,"6 de julio de 1997"
20,7,513,2196,157,119,276,"6 de julio de 1997"
20,7,513,2197,78,71,149,"6 de julio de 1997"
20,7,513,2198,101,97,198,"6 de julio de 1997"
20,7,525,2249,466,470,936,"6 de julio de 1997"
20,7,525,2250,440,418,858,"6 de julio de 1997"
20,7,525,2251,374,343,717,"6 de julio de 1997"
20,7,525,2252,364,359,723,"6 de julio de 1997"
20,7,525,2253,441,445,886,"6 de julio de 1997"
20,7,525,2254,233,195,428,"6 de julio de 1997"
20,7,525,2255,249,250,499,"6 de julio de 1997"
20,7,525,2256,59,43,102,"6 de julio de 1997"
20,7,525,2257,378,327,705,"6 de julio de 1997"
20,7,557,2394,296,304,600,"6 de julio de 1997"
20,7,557,2395,344,343,687,"6 de julio de 1997"
20,7,557,2396,326,334,660,"6 de julio de 1997"
20,7,557,2397,314,320,634,"6 de julio de 1997"
20,7,557,2398,295,335,630,"6 de julio de 1997"
20,7,557,2399,304,329,633,"6 de julio de 1997"
20,7,557,2400,360,348,708,"6 de julio de 1997"
20,7,557,2401,448,435,883,"6 de julio de 1997"
20,7,557,2402,450,414,864,"6 de julio de 1997"
20,7,557,2403,391,445,836,"6 de julio de 1997"
20,7,557,2404,320,326,646,"6 de julio de 1997"
20,8,3,35,294,306,600,"6 de julio de 1997"
20,8,3,36,392,453,845,"6 de julio de 1997"
20,8,3,37,394,481,875,"6 de julio de 1997"
20,8,3,38,323,365,688,"6 de julio de 1997"
20,8,66,470,741,803,1544,"6 de julio de 1997"
20,8,66,471,1003,1100,2103,"6 de julio de 1997"
20,8,66,472,669,769,1438,"6 de julio de 1997"
20,8,66,473,341,365,706,"6 de julio de 1997"
20,8,66,474,440,488,928,"6 de julio de 1997"
20,8,66,475,401,502,903,"6 de julio de 1997"
20,8,66,476,407,469,876,"6 de julio de 1997"
20,8,66,477,386,413,799,"6 de julio de 1997"
20,8,66,478,436,470,906,"6 de julio de 1997"
20,8,66,479,471,569,1040,"6 de julio de 1997"
20,8,66,480,483,559,1042,"6 de julio de 1997"
20,8,66,481,791,907,1698,"6 de julio de 1997"
20,8,66,482,945,1075,2020,"6 de julio de 1997"
20,8,66,483,422,550,972,"6 de julio de 1997"
20,8,66,484,461,516,977,"6 de julio de 1997"
20,8,66,485,447,553,1000,"6 de julio de 1997"
20,8,66,486,410,481,891,"6 de julio de 1997"
20,8,66,487,430,516,946,"6 de julio de 1997"
20,8,66,488,383,478,861,"6 de julio de 1997"
20,8,66,489,562,681,1243,"6 de julio de 1997"
20,8,66,490,492,571,1063,"6 de julio de 1997"
20,8,66,491,490,552,1042,"6 de julio de 1997"
20,8,66,492,448,528,976,"6 de julio de 1997"
20,8,66,493,602,602,1204,"6 de julio de 1997"
20,8,66,494,521,601,1122,"6 de julio de 1997"
20,8,66,495,577,679,1256,"6 de julio de 1997"
20,8,66,496,451,494,945,"6 de julio de 1997"
20,8,66,497,518,585,1103,"6 de julio de 1997"
20,8,66,498,497,641,1138,"6 de julio de 1997"
20,8,66,499,669,789,1458,"6 de julio de 1997"
20,8,66,500,741,947,1688,"6 de julio de 1997"
20,8,66,501,451,511,962,"6 de julio de 1997"
20,8,66,502,650,725,1375,"6 de julio de 1997"
20,8,66,503,380,503,883,"6 de julio de 1997"
20,8,66,504,625,696,1321,"6 de julio de 1997"
20,8,66,505,512,564,1076,"6 de julio de 1997"
20,8,66,506,421,517,938,"6 de julio de 1997"
20,8,66,507,500,643,1143,"6 de julio de 1997"
20,8,66,508,411,518,929,"6 de julio de 1997"
20,8,66,509,614,761,1375,"6 de julio de 1997"
20,8,66,510,621,796,1417,"6 de julio de 1997"
20,8,66,511,712,896,1608,"6 de julio de 1997"
20,8,66,512,544,706,1250,"6 de julio de 1997"
20,8,66,513,429,497,926,"6 de julio de 1997"
20,8,66,514,484,591,1075,"6 de julio de 1997"
20,8,66,515,348,449,797,"6 de julio de 1997"
20,8,66,516,369,426,795,"6 de julio de 1997"
20,8,66,517,392,509,901,"6 de julio de 1997"
20,8,66,518,349,455,804,"6 de julio de 1997"
20,8,66,519,518,671,1189,"6 de julio de 1997"
20,8,66,520,495,597,1092,"6 de julio de 1997"
20,8,66,521,395,535,930,"6 de julio de 1997"
20,8,66,522,412,495,907,"6 de julio de 1997"
20,8,66,523,497,566,1063,"6 de julio de 1997"
20,8,66,524,580,671,1251,"6 de julio de 1997"
20,8,66,525,440,486,926,"6 de julio de 1997"
20,8,66,526,369,446,815,"6 de julio de 1997"
20,8,66,527,422,501,923,"6 de julio de 1997"
20,8,66,528,637,691,1328,"6 de julio de 1997"
20,8,66,529,567,628,1195,"6 de julio de 1997"
20,8,66,530,424,554,978,"6 de julio de 1997"
20,8,66,531,308,359,667,"6 de julio de 1997"
20,8,66,532,448,555,1003,"6 de julio de 1997"
20,8,66,533,262,325,587,"6 de julio de 1997"
20,8,66,534,459,663,1122,"6 de julio de 1997"
20,8,66,535,529,606,1135,"6 de julio de 1997"
20,8,66,536,322,365,687,"6 de julio de 1997"
20,8,66,537,467,524,991,"6 de julio de 1997"
20,8,66,538,453,546,999,"6 de julio de 1997"
20,8,66,539,326,380,706,"6 de julio de 1997"
20,8,66,540,346,389,735,"6 de julio de 1997"
20,8,66,541,461,528,989,"6 de julio de 1997"
20,8,66,542,328,403,731,"6 de julio de 1997"
20,8,66,543,653,787,1440,"6 de julio de 1997"
20,8,66,544,387,440,827,"6 de julio de 1997"
20,8,66,545,327,407,734,"6 de julio de 1997"
20,8,66,546,251,298,549,"6 de julio de 1997"
20,8,66,547,535,690,1225,"6 de julio de 1997"
20,8,66,548,475,525,1000,"6 de julio de 1997"
20,8,66,549,250,301,551,"6 de julio de 1997"
20,8,66,550,291,370,661,"6 de julio de 1997"
20,8,66,551,490,578,1068,"6 de julio de 1997"
20,8,66,552,491,592,1083,"6 de julio de 1997"
20,8,66,553,606,704,1310,"6 de julio de 1997"
20,8,66,554,421,591,1012,"6 de julio de 1997"
20,8,66,555,632,612,1244,"6 de julio de 1997"
20,8,66,556,375,467,842,"6 de julio de 1997"
20,8,66,557,370,444,814,"6 de julio de 1997"
20,8,66,558,338,348,686,"6 de julio de 1997"
20,8,66,559,429,455,884,"6 de julio de 1997"
20,8,66,560,570,643,1213,"6 de julio de 1997"
20,8,66,561,400,451,851,"6 de julio de 1997"
20,8,66,562,419,461,880,"6 de julio de 1997"
20,8,66,563,376,423,799,"6 de julio de 1997"
20,8,66,564,488,589,1077,"6 de julio de 1997"
20,8,66,565,355,412,767,"6 de julio de 1997"
20,8,66,566,555,657,1212,"6 de julio de 1997"
20,8,66,567,368,464,832,"6 de julio de 1997"
20,8,66,568,633,802,1435,"6 de julio de 1997"
20,8,66,569,446,521,967,"6 de julio de 1997"
20,8,66,570,453,544,997,"6 de julio de 1997"
20,8,66,571,392,492,884,"6 de julio de 1997"
20,8,66,572,527,627,1154,"6 de julio de 1997"
20,8,66,573,503,519,1022,"6 de julio de 1997"
20,8,66,574,739,865,1604,"6 de julio de 1997"
20,8,66,575,425,451,876,"6 de julio de 1997"
20,8,66,576,552,589,1141,"6 de julio de 1997"
20,8,66,577,484,521,1005,"6 de julio de 1997"
20,8,66,578,448,497,945,"6 de julio de 1997"
20,8,66,579,440,496,936,"6 de julio de 1997"
20,8,66,580,392,455,847,"6 de julio de 1997"
20,8,66,581,689,748,1437,"6 de julio de 1997"
20,8,66,582,628,738,1366,"6 de julio de 1997"
20,8,66,583,691,694,1385,"6 de julio de 1997"
20,8,66,584,463,616,1079,"6 de julio de 1997"
20,8,66,585,454,583,1037,"6 de julio de 1997"
20,8,66,586,495,611,1106,"6 de julio de 1997"
20,8,66,587,501,599,1100,"6 de julio de 1997"
20,8,66,588,419,507,926,"6 de julio de 1997"
20,8,66,589,676,773,1449,"6 de julio de 1997"
20,8,66,590,527,622,1149,"6 de julio de 1997"
20,8,66,591,401,442,843,"6 de julio de 1997"
20,8,66,592,474,586,1060,"6 de julio de 1997"
20,8,66,593,611,693,1304,"6 de julio de 1997"
20,8,66,594,486,555,1041,"6 de julio de 1997"
20,8,66,595,413,389,802,"6 de julio de 1997"
20,8,66,596,475,549,1024,"6 de julio de 1997"
20,8,66,597,539,606,1145,"6 de julio de 1997"
20,8,66,598,313,425,738,"6 de julio de 1997"
20,8,66,599,363,430,793,"6 de julio de 1997"
20,8,66,600,639,788,1427,"6 de julio de 1997"
20,8,66,601,403,454,857,"6 de julio de 1997"
20,8,66,602,483,537,1020,"6 de julio de 1997"
20,8,66,603,276,328,604,"6 de julio de 1997"
20,8,66,604,491,587,1078,"6 de julio de 1997"
20,8,66,605,478,589,1067,"6 de julio de 1997"
20,8,66,606,477,577,1054,"6 de julio de 1997"
20,8,66,607,595,532,1127,"6 de julio de 1997"
20,8,66,608,367,439,806,"6 de julio de 1997"
20,8,66,609,340,385,725,"6 de julio de 1997"
20,8,66,610,340,394,734,"6 de julio de 1997"
20,8,66,611,430,498,928,"6 de julio de 1997"
20,8,66,612,535,630,1165,"6 de julio de 1997"
20,8,66,613,358,402,760,"6 de julio de 1997"
20,8,66,614,386,389,775,"6 de julio de 1997"
20,8,66,615,228,228,456,"6 de julio de 1997"
20,8,66,616,385,411,796,"6 de julio de 1997"
20,8,75,668,355,348,703,"6 de julio de 1997"
20,8,80,717,482,544,1026,"6 de julio de 1997"
20,8,80,718,383,391,774,"6 de julio de 1997"
20,8,84,736,403,503,906,"6 de julio de 1997"
20,8,84,737,270,345,615,"6 de julio de 1997"
20,8,88,747,327,318,645,"6 de julio de 1997"
20,8,88,748,395,468,863,"6 de julio de 1997"
20,8,89,749,416,468,884,"6 de julio de 1997"
20,8,104,777,633,673,1306,"6 de julio de 1997"
20,8,104,778,534,565,1099,"6 de julio de 1997"
20,8,104,779,457,508,965,"6 de julio de 1997"
20,8,104,780,486,559,1045,"6 de julio de 1997"
20,8,104,781,542,603,1145,"6 de julio de 1997"
20,8,112,798,362,402,764,"6 de julio de 1997"
20,8,112,799,482,537,1019,"6 de julio de 1997"
20,8,112,800,291,336,627,"6 de julio de 1997"
20,8,154,917,592,692,1284,"6 de julio de 1997"
20,8,154,918,456,476,932,"6 de julio de 1997"
20,8,154,919,381,402,783,"6 de julio de 1997"
20,8,161,934,342,381,723,"6 de julio de 1997"
20,8,161,935,270,308,578,"6 de julio de 1997"
20,8,161,936,337,375,712,"6 de julio de 1997"
20,8,161,937,260,356,616,"6 de julio de 1997"
20,8,291,1423,303,352,655,"6 de julio de 1997"
20,8,291,1424,335,337,672,"6 de julio de 1997"
20,8,291,1425,548,597,1145,"6 de julio de 1997"
20,8,308,1482,410,415,825,"6 de julio de 1997"
20,8,308,1483,404,426,830,"6 de julio de 1997"
20,8,339,1605,415,488,903,"6 de julio de 1997"
20,8,340,1606,554,630,1184,"6 de julio de 1997"
20,8,347,1627,814,905,1719,"6 de julio de 1997"
20,8,347,1628,361,429,790,"6 de julio de 1997"
20,8,347,1629,235,307,542,"6 de julio de 1997"
20,8,347,1630,288,404,692,"6 de julio de 1997"
20,8,347,1631,289,361,650,"6 de julio de 1997"
20,8,347,1632,283,383,666,"6 de julio de 1997"
20,8,347,1633,206,282,488,"6 de julio de 1997"
20,8,376,1686,404,415,819,"6 de julio de 1997"
20,8,376,1687,396,437,833,"6 de julio de 1997"
20,8,376,1688,414,546,960,"6 de julio de 1997"
20,8,376,1689,321,426,747,"6 de julio de 1997"
20,8,392,1746,393,537,930,"6 de julio de 1997"
20,8,392,1747,615,75,690,"6 de julio de 1997"
20,8,392,1748,380,445,825,"6 de julio de 1997"
20,8,392,1749,340,441,781,"6 de julio de 1997"
20,8,392,1750,440,535,975,"6 de julio de 1997"
20,8,392,1751,431,475,906,"6 de julio de 1997"
20,8,392,1752,455,522,977,"6 de julio de 1997"
20,8,392,1753,404,497,901,"6 de julio de 1997"
20,8,392,1754,447,531,978,"6 de julio de 1997"
20,8,392,1755,495,601,1096,"6 de julio de 1997"
20,8,392,1756,391,452,843,"6 de julio de 1997"
20,8,392,1757,598,690,1288,"6 de julio de 1997"
20,8,392,1758,660,764,1424,"6 de julio de 1997"
20,8,392,1759,513,605,1118,"6 de julio de 1997"
20,8,392,1760,480,536,1016,"6 de julio de 1997"
20,8,392,1761,560,629,1189,"6 de julio de 1997"
20,8,392,1762,691,758,1449,"6 de julio de 1997"
20,8,392,1763,384,406,790,"6 de julio de 1997"
20,8,392,1764,403,450,853,"6 de julio de 1997"
20,8,392,1765,468,504,972,"6 de julio de 1997"
20,8,392,1766,385,431,816,"6 de julio de 1997"
20,8,392,1767,473,542,1015,"6 de julio de 1997"
20,8,392,1768,431,407,838,"6 de julio de 1997"
20,8,400,1784,500,574,1074,"6 de julio de 1997"
20,8,400,1785,1174,1240,2414,"6 de julio de 1997"
20,8,400,1786,518,591,1109,"6 de julio de 1997"
20,8,408,1827,401,394,795,"6 de julio de 1997"
20,8,410,1829,387,458,845,"6 de julio de 1997"
20,8,410,1830,310,411,721,"6 de julio de 1997"
20,8,410,1831,383,482,865,"6 de julio de 1997"
20,8,410,1832,408,432,840,"6 de julio de 1997"
20,8,410,1833,280,294,574,"6 de julio de 1997"
20,8,412,1838,198,231,429,"6 de julio de 1997"
20,8,519,2235,337,349,686,"6 de julio de 1997"
20,8,519,2236,335,321,656,"6 de julio de 1997"
20,8,552,2363,271,294,565,"6 de julio de 1997"
20,8,552,2364,482,448,930,"6 de julio de 1997"
20,8,552,2365,340,356,696,"6 de julio de 1997"
20,8,552,2366,348,400,748,"6 de julio de 1997"
20,9,8,65,341,462,803,"6 de julio de 1997"
20,9,8,66,291,388,679,"6 de julio de 1997"
20,9,8,67,230,281,511,"6 de julio de 1997"
20,9,10,70,481,593,1074,"6 de julio de 1997"
20,9,10,71,349,442,791,"6 de julio de 1997"
20,9,10,72,365,483,848,"6 de julio de 1997"
20,9,10,73,92,116,208,"6 de julio de 1997"
20,9,17,111,394,580,974,"6 de julio de 1997"
20,9,17,112,328,488,816,"6 de julio de 1997"
20,9,26,147,559,583,1142,"6 de julio de 1997"
20,9,26,148,594,640,1234,"6 de julio de 1997"
20,9,26,149,422,462,884,"6 de julio de 1997"
20,9,26,150,409,422,831,"6 de julio de 1997"
20,9,26,151,676,806,1482,"6 de julio de 1997"
20,9,26,152,401,466,867,"6 de julio de 1997"
20,9,47,373,225,232,457,"6 de julio de 1997"
20,9,48,374,249,275,524,"6 de julio de 1997"
20,9,67,617,490,527,1017,"6 de julio de 1997"
20,9,67,618,402,414,816,"6 de julio de 1997"
20,9,67,619,537,580,1117,"6 de julio de 1997"
20,9,67,620,605,663,1268,"6 de julio de 1997"
20,9,67,621,507,579,1086,"6 de julio de 1997"
20,9,67,622,588,610,1198,"6 de julio de 1997"
20,9,67,623,276,309,585,"6 de julio de 1997"
20,9,67,624,193,207,400,"6 de julio de 1997"
20,9,67,625,161,211,372,"6 de julio de 1997"
20,9,67,626,104,101,205,"6 de julio de 1997"
20,9,67,627,82,88,170,"6 de julio de 1997"
20,9,67,628,280,345,625,"6 de julio de 1997"
20,9,67,629,81,116,197,"6 de julio de 1997"
20,9,67,630,268,241,509,"6 de julio de 1997"
20,9,67,631,138,143,281,"6 de julio de 1997"
20,9,98,763,203,316,519,"6 de julio de 1997"
20,9,100,766,339,333,672,"6 de julio de 1997"
20,9,100,767,261,243,504,"6 de julio de 1997"
20,9,100,768,256,312,568,"6 de julio de 1997"
20,9,100,769,322,272,594,"6 de julio de 1997"
20,9,101,770,407,405,812,"6 de julio de 1997"
20,9,101,771,107,124,231,"6 de julio de 1997"
20,9,105,782,213,276,489,"6 de julio de 1997"
20,9,105,783,247,265,512,"6 de julio de 1997"
20,9,105,784,255,252,507,"6 de julio de 1997"
20,9,105,785,65,96,161,"6 de julio de 1997"
20,9,105,786,117,139,256,"6 de julio de 1997"
20,9,105,787,107,133,240,"6 de julio de 1997"
20,9,109,792,390,467,857,"6 de julio de 1997"
20,9,109,793,380,468,848,"6 de julio de 1997"
20,9,120,812,307,298,605,"6 de julio de 1997"
20,9,120,813,326,371,697,"6 de julio de 1997"
20,9,129,846,309,378,687,"6 de julio de 1997"
20,9,134,871,277,273,550,"6 de julio de 1997"
20,9,134,872,131,138,269,"6 de julio de 1997"
20,9,134,873,277,254,531,"6 de julio de 1997"
20,9,146,899,310,323,633,"6 de julio de 1997"
20,9,152,913,184,158,342,"6 de julio de 1997"
20,9,155,920,495,454,949,"6 de julio de 1997"
20,9,159,931,308,335,643,"6 de julio de 1997"
20,9,169,958,430,436,866,"6 de julio de 1997"
20,9,169,959,358,393,751,"6 de julio de 1997"
20,9,169,960,298,295,593,"6 de julio de 1997"
20,9,169,961,255,256,511,"6 de julio de 1997"
20,9,186,1107,404,456,860,"6 de julio de 1997"
20,9,229,1249,596,654,1250,"6 de julio de 1997"
20,9,229,1250,466,446,912,"6 de julio de 1997"
20,9,241,1285,284,374,658,"6 de julio de 1997"
20,9,243,1291,472,520,992,"6 de julio de 1997"
20,9,270,1361,305,308,613,"6 de julio de 1997"
20,9,270,1362,264,270,534,"6 de julio de 1997"
20,9,272,1365,402,424,826,"6 de julio de 1997"
20,9,272,1366,378,384,762,"6 de julio de 1997"
20,9,282,1407,548,581,1129,"6 de julio de 1997"
20,9,282,1408,195,214,409,"6 de julio de 1997"
20,9,290,1422,320,324,644,"6 de julio de 1997"
20,9,293,1431,335,416,751,"6 de julio de 1997"
20,9,293,1432,405,555,960,"6 de julio de 1997"
20,9,293,1433,360,469,829,"6 de julio de 1997"
20,9,293,1434,277,365,642,"6 de julio de 1997"
20,9,293,1435,290,372,662,"6 de julio de 1997"
20,9,293,1436,321,400,721,"6 de julio de 1997"
20,9,299,1452,196,240,436,"6 de julio de 1997"
20,9,299,1453,237,332,569,"6 de julio de 1997"
20,9,313,1494,410,587,997,"6 de julio de 1997"
20,9,326,1553,212,210,422,"6 de julio de 1997"
20,9,351,1639,458,465,923,"6 de julio de 1997"
20,9,358,1647,333,460,793,"6 de julio de 1997"
20,9,358,1648,220,268,488,"6 de julio de 1997"
20,9,360,1650,431,557,988,"6 de julio de 1997"
20,9,360,1651,325,364,689,"6 de julio de 1997"
20,9,368,1673,198,191,389,"6 de julio de 1997"
20,9,368,1674,187,182,369,"6 de julio de 1997"
20,9,369,1675,428,531,959,"6 de julio de 1997"
20,9,379,1699,315,348,663,"6 de julio de 1997"
20,9,379,1700,118,124,242,"6 de julio de 1997"
20,9,379,1701,349,390,739,"6 de julio de 1997"
20,9,386,1712,488,574,1062,"6 de julio de 1997"
20,9,386,1713,562,704,1266,"6 de julio de 1997"
20,9,386,1714,468,551,1019,"6 de julio de 1997"
20,9,386,1715,477,527,1004,"6 de julio de 1997"
20,9,386,1716,624,713,1337,"6 de julio de 1997"
20,9,386,1717,573,627,1200,"6 de julio de 1997"
20,9,386,1718,682,710,1392,"6 de julio de 1997"
20,9,386,1719,498,578,1076,"6 de julio de 1997"
20,9,386,1720,523,591,1114,"6 de julio de 1997"
20,9,386,1721,540,593,1133,"6 de julio de 1997"
20,9,386,1722,662,689,1351,"6 de julio de 1997"
20,9,386,1723,468,487,955,"6 de julio de 1997"
20,9,386,1724,507,612,1119,"6 de julio de 1997"
20,9,386,1725,599,646,1245,"6 de julio de 1997"
20,9,386,1726,682,738,1420,"6 de julio de 1997"
20,9,386,1727,581,633,1214,"6 de julio de 1997"
20,9,386,1728,266,273,539,"6 de julio de 1997"
20,9,386,1729,438,514,952,"6 de julio de 1997"
20,9,387,1730,360,344,704,"6 de julio de 1997"
20,9,387,1731,287,314,601,"6 de julio de 1997"
20,9,387,1732,419,349,768,"6 de julio de 1997"
20,9,387,1733,490,502,992,"6 de julio de 1997"
20,9,387,1734,459,434,893,"6 de julio de 1997"
20,9,387,1735,211,160,371,"6 de julio de 1997"
20,9,387,1736,400,369,769,"6 de julio de 1997"
20,9,387,1737,504,374,878,"6 de julio de 1997"
20,9,388,1738,304,399,703,"6 de julio de 1997"
20,9,388,1739,302,394,696,"6 de julio de 1997"
20,9,388,1740,101,127,228,"6 de julio de 1997"
20,9,389,1741,430,466,896,"6 de julio de 1997"
20,9,390,1742,223,372,595,"6 de julio de 1997"
20,9,395,1776,812,900,1712,"6 de julio de 1997"
20,9,421,1874,243,229,472,"6 de julio de 1997"
20,9,430,1904,406,402,808,"6 de julio de 1997"
20,9,449,1950,296,257,553,"6 de julio de 1997"
20,9,451,1955,366,368,734,"6 de julio de 1997"
20,9,451,1956,333,356,689,"6 de julio de 1997"
20,9,451,1957,339,284,623,"6 de julio de 1997"
20,9,451,1958,313,248,561,"6 de julio de 1997"
20,9,451,1959,300,288,588,"6 de julio de 1997"
20,9,453,1962,235,304,539,"6 de julio de 1997"
20,9,453,1963,353,429,782,"6 de julio de 1997"
20,9,453,1964,316,345,661,"6 de julio de 1997"
20,9,492,2133,528,490,1018,"6 de julio de 1997"
20,9,492,2134,141,120,261,"6 de julio de 1997"
20,9,516,2229,492,501,993,"6 de julio de 1997"
20,9,516,2230,375,331,706,"6 de julio de 1997"
20,9,526,2258,118,156,274,"6 de julio de 1997"
20,9,526,2259,133,152,285,"6 de julio de 1997"
20,9,526,2260,386,368,754,"6 de julio de 1997"
20,9,536,2291,194,188,382,"6 de julio de 1997"
20,9,536,2292,468,542,1010,"6 de julio de 1997"
20,9,536,2293,383,394,777,"6 de julio de 1997"
20,9,536,2294,279,262,541,"6 de julio de 1997"
20,9,536,2295,268,239,507,"6 de julio de 1997"
20,9,536,2296,190,158,348,"6 de julio de 1997"
20,9,536,2297,257,235,492,"6 de julio de 1997"
20,9,536,2298,311,311,622,"6 de julio de 1997"
20,9,536,2299,306,241,547,"6 de julio de 1997"
20,9,536,2300,301,246,547,"6 de julio de 1997"
20,9,555,2391,396,497,893,"6 de julio de 1997"
20,9,555,2392,361,414,775,"6 de julio de 1997"
20,9,563,2419,252,265,517,"6 de julio de 1997"
20,9,563,2420,262,277,539,"6 de julio de 1997"
20,9,566,2423,620,767,1387,"6 de julio de 1997"
20,9,566,2424,596,684,1280,"6 de julio de 1997"
20,9,566,2425,510,667,1177,"6 de julio de 1997"
20,9,566,2426,608,720,1328,"6 de julio de 1997"
20,9,566,2427,482,545,1027,"6 de julio de 1997"
20,9,566,2428,600,711,1311,"6 de julio de 1997"
20,9,566,2429,100,106,206,"6 de julio de 1997"
20,9,567,2430,149,164,313,"6 de julio de 1997"
20,9,567,2431,481,446,927,"6 de julio de 1997"
20,9,570,2436,250,332,582,"6 de julio de 1997"
20,9,570,2437,504,588,1092,"6 de julio de 1997"
20,9,570,2438,268,367,635,"6 de julio de 1997"
20,9,570,2439,402,474,876,"6 de julio de 1997"
20,9,570,2440,437,535,972,"6 de julio de 1997"
20,9,570,2441,520,616,1136,"6 de julio de 1997"
20,9,570,2442,471,515,986,"6 de julio de 1997"
20,9,570,2443,166,172,338,"6 de julio de 1997"
20,9,570,2444,110,129,239,"6 de julio de 1997"
20,9,570,2445,181,171,352,"6 de julio de 1997"
20,9,570,2446,143,191,334,"6 de julio de 1997"
20,9,570,2447,331,419,750,"6 de julio de 1997"
20,9,570,2448,141,187,328,"6 de julio de 1997"
20,9,570,2449,44,50,94,"6 de julio de 1997"
20,10,14,90,534,548,1082,"6 de julio de 1997"
20,10,14,91,464,427,891,"6 de julio de 1997"
20,10,14,92,42,38,80,"6 de julio de 1997"
20,10,14,93,261,258,519,"6 de julio de 1997"
20,10,14,94,151,143,294,"6 de julio de 1997"
20,10,14,95,442,426,868,"6 de julio de 1997"
20,10,14,96,359,286,645,"6 de julio de 1997"
20,10,18,113,322,311,633,"6 de julio de 1997"
20,10,18,114,390,297,687,"6 de julio de 1997"
20,10,18,115,206,224,430,"6 de julio de 1997"
20,10,18,116,281,274,555,"6 de julio de 1997"
20,10,20,121,295,359,654,"6 de julio de 1997"
20,10,20,122,135,147,282,"6 de julio de 1997"
20,10,20,123,283,368,651,"6 de julio de 1997"
20,10,20,124,218,265,483,"6 de julio de 1997"
20,10,28,157,614,729,1343,"6 de julio de 1997"
20,10,28,158,537,658,1195,"6 de julio de 1997"
20,10,28,159,353,455,808,"6 de julio de 1997"
20,10,28,160,555,622,1177,"6 de julio de 1997"
20,10,28,161,309,365,674,"6 de julio de 1997"
20,10,28,162,117,119,236,"6 de julio de 1997"
20,10,28,163,103,101,204,"6 de julio de 1997"
20,10,28,164,165,168,333,"6 de julio de 1997"
20,10,28,165,29,35,64,"6 de julio de 1997"
20,10,28,166,391,412,803,"6 de julio de 1997"
20,10,28,167,230,253,483,"6 de julio de 1997"
20,10,28,168,188,231,419,"6 de julio de 1997"
20,10,28,169,256,302,558,"6 de julio de 1997"
20,10,28,170,220,198,418,"6 de julio de 1997"
20,10,28,171,80,78,158,"6 de julio de 1997"
20,10,28,172,96,102,198,"6 de julio de 1997"
20,10,28,173,359,369,728,"6 de julio de 1997"
20,10,28,174,172,194,366,"6 de julio de 1997"
20,10,28,175,186,189,375,"6 de julio de 1997"
20,10,59,432,385,427,812,"6 de julio de 1997"
20,10,59,433,491,521,1012,"6 de julio de 1997"
20,10,59,434,509,603,1112,"6 de julio de 1997"
20,10,59,435,263,337,600,"6 de julio de 1997"
20,10,59,436,263,370,633,"6 de julio de 1997"
20,10,59,437,387,455,842,"6 de julio de 1997"
20,10,59,438,428,434,862,"6 de julio de 1997"
20,10,59,439,474,514,988,"6 de julio de 1997"
20,10,59,440,478,479,957,"6 de julio de 1997"
20,10,59,441,550,584,1134,"6 de julio de 1997"
20,10,59,442,587,553,1140,"6 de julio de 1997"
20,10,59,443,94,110,204,"6 de julio de 1997"
20,10,59,444,357,356,713,"6 de julio de 1997"
20,10,59,445,374,392,766,"6 de julio de 1997"
20,10,59,446,510,652,1162,"6 de julio de 1997"
20,10,59,447,281,275,556,"6 de julio de 1997"
20,10,59,448,152,198,350,"6 de julio de 1997"
20,10,59,449,346,296,642,"6 de julio de 1997"
20,10,59,450,193,138,331,"6 de julio de 1997"
20,10,59,451,172,190,362,"6 de julio de 1997"
20,10,59,452,228,233,461,"6 de julio de 1997"
20,10,59,453,69,63,132,"6 de julio de 1997"
20,10,61,456,280,344,624,"6 de julio de 1997"
20,10,61,457,282,294,576,"6 de julio de 1997"
20,10,68,632,415,518,933,"6 de julio de 1997"
20,10,70,638,444,438,882,"6 de julio de 1997"
20,10,70,639,47,43,90,"6 de julio de 1997"
20,10,70,640,92,74,166,"6 de julio de 1997"
20,10,70,641,100,75,175,"6 de julio de 1997"
20,10,70,642,181,137,318,"6 de julio de 1997"
20,10,77,710,251,325,576,"6 de julio de 1997"
20,10,77,711,258,291,549,"6 de julio de 1997"
20,10,82,721,256,272,528,"6 de julio de 1997"
20,10,82,722,339,396,735,"6 de julio de 1997"
20,10,82,723,485,426,911,"6 de julio de 1997"
20,10,82,724,401,392,793,"6 de julio de 1997"
20,10,82,725,294,285,579,"6 de julio de 1997"
20,10,82,726,273,244,517,"6 de julio de 1997"
20,10,82,727,296,256,552,"6 de julio de 1997"
20,10,82,728,421,432,853,"6 de julio de 1997"
20,10,82,729,628,627,1255,"6 de julio de 1997"
20,10,82,730,337,351,688,"6 de julio de 1997"
20,10,82,731,282,231,513,"6 de julio de 1997"
20,10,82,732,441,398,839,"6 de julio de 1997"
20,10,82,733,208,257,465,"6 de julio de 1997"
20,10,92,753,443,394,837,"6 de julio de 1997"
20,10,92,754,254,196,450,"6 de julio de 1997"
20,10,92,755,147,98,245,"6 de julio de 1997"
20,10,110,794,586,600,1186,"6 de julio de 1997"
20,10,116,807,247,202,449,"6 de julio de 1997"
20,10,116,808,271,228,499,"6 de julio de 1997"
20,10,123,831,351,397,748,"6 de julio de 1997"
20,10,123,832,330,365,695,"6 de julio de 1997"
20,10,123,833,35,40,75,"6 de julio de 1997"
20,10,123,834,157,174,331,"6 de julio de 1997"
20,10,143,894,218,238,456,"6 de julio de 1997"
20,10,143,895,189,208,397,"6 de julio de 1997"
20,10,145,897,296,291,587,"6 de julio de 1997"
20,10,145,898,171,164,335,"6 de julio de 1997"
20,10,151,911,289,328,617,"6 de julio de 1997"
20,10,151,912,235,168,403,"6 de julio de 1997"
20,10,156,921,476,400,876,"6 de julio de 1997"
20,10,156,922,214,185,399,"6 de julio de 1997"
20,10,156,923,311,279,590,"6 de julio de 1997"
20,10,165,949,359,338,697,"6 de julio de 1997"
20,10,165,950,87,70,157,"6 de julio de 1997"
20,10,168,955,392,454,846,"6 de julio de 1997"
20,10,168,956,171,169,340,"6 de julio de 1997"
20,10,168,957,235,234,469,"6 de julio de 1997"
20,10,204,1172,204,212,416,"6 de julio de 1997"
20,10,204,1173,140,133,273,"6 de julio de 1997"
20,10,204,1174,278,260,538,"6 de julio de 1997"
20,10,204,1175,117,121,238,"6 de julio de 1997"
20,10,209,1204,168,234,402,"6 de julio de 1997"
20,10,211,1210,200,210,410,"6 de julio de 1997"
20,10,211,1211,94,82,176,"6 de julio de 1997"
20,10,211,1212,278,227,505,"6 de julio de 1997"
20,10,235,1271,197,277,474,"6 de julio de 1997"
20,10,235,1272,168,216,384,"6 de julio de 1997"
20,10,235,1273,203,188,391,"6 de julio de 1997"
20,10,235,1274,237,272,509,"6 de julio de 1997"
20,10,235,1275,44,43,87,"6 de julio de 1997"
20,10,236,1276,212,205,417,"6 de julio de 1997"
20,10,236,1277,199,184,383,"6 de julio de 1997"
20,10,238,1282,232,243,475,"6 de julio de 1997"
20,10,251,1306,297,283,580,"6 de julio de 1997"
20,10,251,1307,212,195,407,"6 de julio de 1997"
20,10,251,1308,123,94,217,"6 de julio de 1997"
20,10,251,1309,110,111,221,"6 de julio de 1997"
20,10,252,1310,407,441,848,"6 de julio de 1997"
20,10,252,1311,223,195,418,"6 de julio de 1997"
20,10,252,1312,119,108,227,"6 de julio de 1997"
20,10,252,1313,150,94,244,"6 de julio de 1997"
20,10,264,1345,301,257,558,"6 de julio de 1997"
20,10,264,1346,325,278,603,"6 de julio de 1997"
20,10,265,1347,414,335,749,"6 de julio de 1997"
20,10,265,1348,555,576,1131,"6 de julio de 1997"
20,10,265,1349,141,107,248,"6 de julio de 1997"
20,10,265,1350,343,296,639,"6 de julio de 1997"
20,10,265,1351,189,154,343,"6 de julio de 1997"
20,10,267,1353,191,238,429,"6 de julio de 1997"
20,10,277,1396,306,328,634,"6 de julio de 1997"
20,10,277,1397,326,308,634,"6 de julio de 1997"
20,10,287,1417,332,370,702,"6 de julio de 1997"
20,10,289,1419,374,419,793,"6 de julio de 1997"
20,10,289,1420,215,218,433,"6 de julio de 1997"
20,10,289,1421,323,323,646,"6 de julio de 1997"
20,10,304,1463,427,436,863,"6 de julio de 1997"
20,10,304,1464,305,261,566,"6 de julio de 1997"
20,10,314,1495,194,211,405,"6 de julio de 1997"
20,10,317,1511,296,289,585,"6 de julio de 1997"
20,10,322,1516,461,429,890,"6 de julio de 1997"
20,10,322,1517,446,424,870,"6 de julio de 1997"
20,10,322,1518,810,822,1632,"6 de julio de 1997"
20,10,322,1519,810,801,1611,"6 de julio de 1997"
20,10,322,1520,598,561,1159,"6 de julio de 1997"
20,10,322,1521,318,307,625,"6 de julio de 1997"
20,10,322,1522,577,567,1144,"6 de julio de 1997"
20,10,322,1523,263,243,506,"6 de julio de 1997"
20,10,322,1524,247,221,468,"6 de julio de 1997"
20,10,322,1525,433,400,833,"6 de julio de 1997"
20,10,322,1526,28,21,49,"6 de julio de 1997"
20,10,322,1527,586,611,1197,"6 de julio de 1997"
20,10,322,1528,479,476,955,"6 de julio de 1997"
20,10,322,1529,647,569,1216,"6 de julio de 1997"
20,10,322,1530,449,389,838,"6 de julio de 1997"
20,10,322,1531,478,503,981,"6 de julio de 1997"
20,10,322,1532,442,326,768,"6 de julio de 1997"
20,10,322,1533,679,514,1193,"6 de julio de 1997"
20,10,322,1534,518,478,996,"6 de julio de 1997"
20,10,341,1607,294,355,649,"6 de julio de 1997"
20,10,341,1608,221,199,420,"6 de julio de 1997"
20,10,344,1614,337,289,626,"6 de julio de 1997"
20,10,344,1615,179,182,361,"6 de julio de 1997"
20,10,344,1616,284,276,560,"6 de julio de 1997"
20,10,348,1634,421,529,950,"6 de julio de 1997"
20,10,348,1635,271,307,578,"6 de julio de 1997"
20,10,350,1637,367,453,820,"6 de julio de 1997"
20,10,350,1638,400,416,816,"6 de julio de 1997"
20,10,353,1641,414,448,862,"6 de julio de 1997"
20,10,361,1652,263,263,526,"6 de julio de 1997"
20,10,362,1653,441,523,964,"6 de julio de 1997"
20,10,366,1668,342,336,678,"6 de julio de 1997"
20,10,366,1669,267,248,515,"6 de julio de 1997"
20,10,366,1670,297,281,578,"6 de julio de 1997"
20,10,370,1676,113,119,232,"6 de julio de 1997"
20,10,385,1709,394,386,780,"6 de julio de 1997"
20,10,385,1710,386,377,763,"6 de julio de 1997"
20,10,385,1711,160,221,381,"6 de julio de 1997"
20,10,393,1769,173,96,269,"6 de julio de 1997"
20,10,393,1770,235,139,374,"6 de julio de 1997"
20,10,414,1841,546,520,1066,"6 de julio de 1997"
20,10,414,1842,937,911,1848,"6 de julio de 1997"
20,10,414,1843,158,119,277,"6 de julio de 1997"
20,10,414,1844,613,533,1146,"6 de julio de 1997"
20,10,414,1845,631,527,1158,"6 de julio de 1997"
20,10,414,1846,1411,1302,2713,"6 de julio de 1997"
20,10,414,1847,305,274,579,"6 de julio de 1997"
20,10,414,1848,633,543,1176,"6 de julio de 1997"
20,10,414,1849,470,437,907,"6 de julio de 1997"
20,10,414,1850,585,522,1107,"6 de julio de 1997"
20,10,425,1882,242,249,491,"6 de julio de 1997"
20,10,425,1883,117,103,220,"6 de julio de 1997"
20,10,425,1884,179,181,360,"6 de julio de 1997"
20,10,425,1885,182,191,373,"6 de julio de 1997"
20,10,425,1886,224,218,442,"6 de julio de 1997"
20,10,440,1919,726,602,1328,"6 de julio de 1997"
20,10,440,1920,369,333,702,"6 de julio de 1997"
20,10,440,1921,265,251,516,"6 de julio de 1997"
20,10,440,1922,545,578,1123,"6 de julio de 1997"
20,10,440,1923,434,371,805,"6 de julio de 1997"
20,10,440,1924,391,294,685,"6 de julio de 1997"
20,10,440,1925,664,551,1215,"6 de julio de 1997"
20,10,440,1926,487,440,927,"6 de julio de 1997"
20,10,440,1927,664,614,1278,"6 de julio de 1997"
20,10,450,1951,351,349,700,"6 de julio de 1997"
20,10,450,1952,343,391,734,"6 de julio de 1997"
20,10,450,1953,215,211,426,"6 de julio de 1997"
20,10,450,1954,151,155,306,"6 de julio de 1997"
20,10,496,2144,238,203,441,"6 de julio de 1997"
20,10,496,2145,83,90,173,"6 de julio de 1997"
20,10,496,2146,178,141,319,"6 de julio de 1997"
20,10,496,2147,220,208,428,"6 de julio de 1997"
20,10,508,2176,394,389,783,"6 de julio de 1997"
20,10,508,2177,478,442,920,"6 de julio de 1997"
20,10,508,2178,375,316,691,"6 de julio de 1997"
20,10,508,2179,373,323,696,"6 de julio de 1997"
20,10,512,2189,221,239,460,"6 de julio de 1997"
20,10,529,2264,431,438,869,"6 de julio de 1997"
20,10,535,2290,171,186,357,"6 de julio de 1997"
20,10,538,2304,220,308,528,"6 de julio de 1997"
20,10,564,2421,421,488,909,"6 de julio de 1997"
20,11,56,396,318,338,656,"6 de julio de 1997"
20,11,69,633,331,381,712,"6 de julio de 1997"
20,11,69,634,304,341,645,"6 de julio de 1997"
20,11,69,635,248,233,481,"6 de julio de 1997"
20,11,69,636,255,257,512,"6 de julio de 1997"
20,11,69,637,255,241,496,"6 de julio de 1997"
20,11,79,714,323,316,639,"6 de julio de 1997"
20,11,79,715,356,340,696,"6 de julio de 1997"
20,11,79,716,286,283,569,"6 de julio de 1997"
20,11,87,744,465,460,925,"6 de julio de 1997"
20,11,87,745,402,436,838,"6 de julio de 1997"
20,11,87,746,443,445,888,"6 de julio de 1997"
20,11,108,790,442,433,875,"6 de julio de 1997"
20,11,108,791,254,212,466,"6 de julio de 1997"
20,11,150,908,254,255,509,"6 de julio de 1997"
20,11,150,909,279,288,567,"6 de julio de 1997"
20,11,150,910,310,280,590,"6 de julio de 1997"
20,11,166,951,188,188,376,"6 de julio de 1997"
20,11,178,1003,293,286,579,"6 de julio de 1997"
20,11,178,1004,342,355,697,"6 de julio de 1997"
20,11,184,1099,376,439,815,"6 de julio de 1997"
20,11,184,1100,458,519,977,"6 de julio de 1997"
20,11,184,1101,232,265,497,"6 de julio de 1997"
20,11,184,1102,263,282,545,"6 de julio de 1997"
20,11,184,1103,184,193,377,"6 de julio de 1997"
20,11,184,1104,126,129,255,"6 de julio de 1997"
20,11,184,1105,91,99,190,"6 de julio de 1997"
20,11,190,1112,456,498,954,"6 de julio de 1997"
20,11,190,1113,433,535,968,"6 de julio de 1997"
20,11,190,1114,287,311,598,"6 de julio de 1997"
20,11,190,1115,388,367,755,"6 de julio de 1997"
20,11,190,1116,172,165,337,"6 de julio de 1997"
20,11,203,1170,453,406,859,"6 de julio de 1997"
20,11,203,1171,359,342,701,"6 de julio de 1997"
20,11,213,1215,380,430,810,"6 de julio de 1997"
20,11,213,1216,243,258,501,"6 de julio de 1997"
20,11,225,1238,388,380,768,"6 de julio de 1997"
20,11,225,1239,371,332,703,"6 de julio de 1997"
20,11,225,1240,402,469,871,"6 de julio de 1997"
20,11,271,1363,413,449,862,"6 de julio de 1997"
20,11,271,1364,524,617,1141,"6 de julio de 1997"
20,11,283,1409,403,421,824,"6 de julio de 1997"
20,11,283,1410,270,237,507,"6 de julio de 1997"
20,11,300,1454,201,238,439,"6 de julio de 1997"
20,11,300,1455,319,373,692,"6 de julio de 1997"
20,11,300,1456,81,77,158,"6 de julio de 1997"
20,11,300,1457,60,54,114,"6 de julio de 1997"
20,11,310,1485,326,329,655,"6 de julio de 1997"
20,11,310,1486,320,360,680,"6 de julio de 1997"
20,11,310,1487,254,254,508,"6 de julio de 1997"
20,11,310,1488,258,252,510,"6 de julio de 1997"
20,11,310,1489,331,351,682,"6 de julio de 1997"
20,11,310,1490,194,202,396,"6 de julio de 1997"
20,11,310,1491,209,229,438,"6 de julio de 1997"
20,11,312,1493,368,418,786,"6 de julio de 1997"
20,11,316,1498,621,631,1252,"6 de julio de 1997"
20,11,316,1499,679,601,1280,"6 de julio de 1997"
20,11,316,1500,561,583,1144,"6 de julio de 1997"
20,11,316,1501,445,485,930,"6 de julio de 1997"
20,11,316,1502,382,367,749,"6 de julio de 1997"
20,11,316,1503,782,819,1601,"6 de julio de 1997"
20,11,316,1504,202,182,384,"6 de julio de 1997"
20,11,316,1505,732,774,1506,"6 de julio de 1997"
20,11,316,1506,726,763,1489,"6 de julio de 1997"
20,11,316,1507,552,615,1167,"6 de julio de 1997"
20,11,316,1508,206,190,396,"6 de julio de 1997"
20,11,316,1509,391,374,765,"6 de julio de 1997"
20,11,316,1510,378,415,793,"6 de julio de 1997"
20,11,332,1564,423,399,822,"6 de julio de 1997"
20,11,332,1565,392,384,776,"6 de julio de 1997"
20,11,332,1566,389,442,831,"6 de julio de 1997"
20,11,332,1567,317,339,656,"6 de julio de 1997"
20,11,332,1568,470,424,894,"6 de julio de 1997"
20,11,332,1569,305,336,641,"6 de julio de 1997"
20,11,332,1570,568,589,1157,"6 de julio de 1997"
20,11,332,1571,403,398,801,"6 de julio de 1997"
20,11,332,1572,481,471,952,"6 de julio de 1997"
20,11,332,1573,539,554,1093,"6 de julio de 1997"
20,11,332,1574,393,422,815,"6 de julio de 1997"
20,11,332,1575,519,447,966,"6 de julio de 1997"
20,11,332,1576,946,959,1905,"6 de julio de 1997"
20,11,332,1577,359,359,718,"6 de julio de 1997"
20,11,332,1578,519,476,995,"6 de julio de 1997"
20,11,332,1579,403,338,741,"6 de julio de 1997"
20,11,332,1580,417,384,801,"6 de julio de 1997"
20,11,332,1581,466,394,860,"6 de julio de 1997"
20,11,332,1582,251,216,467,"6 de julio de 1997"
20,11,332,1583,395,353,748,"6 de julio de 1997"
20,11,332,1584,310,236,546,"6 de julio de 1997"
20,11,342,1609,296,307,603,"6 de julio de 1997"
20,11,342,1610,242,275,517,"6 de julio de 1997"
20,11,342,1611,111,108,219,"6 de julio de 1997"
20,11,342,1612,226,205,431,"6 de julio de 1997"
20,11,364,1658,469,481,950,"6 de julio de 1997"
20,11,364,1659,685,790,1475,"6 de julio de 1997"
20,11,364,1660,297,251,548,"6 de julio de 1997"
20,11,364,1661,384,357,741,"6 de julio de 1997"
20,11,364,1662,271,282,553,"6 de julio de 1997"
20,11,364,1663,387,263,650,"6 de julio de 1997"
20,11,364,1664,270,202,472,"6 de julio de 1997"
20,11,367,1671,392,428,820,"6 de julio de 1997"
20,11,367,1672,399,409,808,"6 de julio de 1997"
20,11,406,1816,365,361,726,"6 de julio de 1997"
20,11,406,1817,912,611,1523,"6 de julio de 1997"
20,11,406,1818,288,317,605,"6 de julio de 1997"
20,11,406,1819,213,247,460,"6 de julio de 1997"
20,11,406,1820,243,240,483,"6 de julio de 1997"
20,11,406,1821,312,245,557,"6 de julio de 1997"
20,11,406,1822,379,287,666,"6 de julio de 1997"
20,11,406,1823,305,233,538,"6 de julio de 1997"
20,11,406,1824,452,450,902,"6 de julio de 1997"
20,11,406,1825,437,412,849,"6 de julio de 1997"
20,11,407,1826,259,268,527,"6 de julio de 1997"
20,11,415,1851,647,614,1261,"6 de julio de 1997"
20,11,415,1852,637,656,1293,"6 de julio de 1997"
20,11,415,1853,408,363,771,"6 de julio de 1997"
20,11,415,1854,506,459,965,"6 de julio de 1997"
20,11,415,1855,356,326,682,"6 de julio de 1997"
20,11,434,1908,437,453,890,"6 de julio de 1997"
20,11,467,2005,538,492,1030,"6 de julio de 1997"
20,11,467,2006,66,49,115,"6 de julio de 1997"
20,11,467,2007,282,257,539,"6 de julio de 1997"
20,11,467,2008,126,131,257,"6 de julio de 1997"
20,11,467,2009,328,294,622,"6 de julio de 1997"
20,11,467,2010,432,463,895,"6 de julio de 1997"
20,11,467,2011,156,173,329,"6 de julio de 1997"
20,11,468,2012,308,329,637,"6 de julio de 1997"
20,11,468,2013,656,741,1397,"6 de julio de 1997"
20,11,468,2014,338,362,700,"6 de julio de 1997"
20,11,468,2015,342,341,683,"6 de julio de 1997"
20,11,468,2016,401,468,869,"6 de julio de 1997"
20,11,468,2017,340,339,679,"6 de julio de 1997"
20,11,468,2018,489,451,940,"6 de julio de 1997"
20,11,468,2019,169,178,347,"6 de julio de 1997"
20,11,468,2020,252,245,497,"6 de julio de 1997"
20,11,468,2021,245,256,501,"6 de julio de 1997"
20,11,468,2022,332,340,672,"6 de julio de 1997"
20,11,468,2023,275,284,559,"6 de julio de 1997"
20,11,468,2024,216,169,385,"6 de julio de 1997"
20,11,475,2062,506,554,1060,"6 de julio de 1997"
20,11,475,2063,147,165,312,"6 de julio de 1997"
20,11,475,2064,214,205,419,"6 de julio de 1997"
20,11,478,2071,358,270,628,"6 de julio de 1997"
20,11,484,2088,328,341,669,"6 de julio de 1997"
20,11,484,2089,367,408,775,"6 de julio de 1997"
20,11,484,2090,267,307,574,"6 de julio de 1997"
20,11,484,2091,314,326,640,"6 de julio de 1997"
20,11,484,2092,680,694,1374,"6 de julio de 1997"
20,11,484,2093,507,564,1071,"6 de julio de 1997"
20,11,484,2094,914,431,1345,"6 de julio de 1997"
20,11,484,2095,462,543,1005,"6 de julio de 1997"
20,11,484,2096,534,629,1163,"6 de julio de 1997"
20,11,484,2097,553,616,1169,"6 de julio de 1997"
20,11,484,2098,370,376,746,"6 de julio de 1997"
20,11,484,2099,567,533,1100,"6 de julio de 1997"
20,11,484,2100,482,490,972,"6 de julio de 1997"
20,11,484,2101,341,318,659,"6 de julio de 1997"
20,11,484,2102,226,233,459,"6 de julio de 1997"
20,11,484,2103,354,363,717,"6 de julio de 1997"
20,11,484,2104,367,347,714,"6 de julio de 1997"
20,11,484,2105,352,374,726,"6 de julio de 1997"
20,11,484,2106,431,377,808,"6 de julio de 1997"
20,11,484,2107,305,237,542,"6 de julio de 1997"
20,11,484,2108,409,348,757,"6 de julio de 1997"
20,11,484,2109,317,321,638,"6 de julio de 1997"
20,11,484,2110,354,350,704,"6 de julio de 1997"
20,11,484,2111,465,479,944,"6 de julio de 1997"
20,11,487,2123,406,317,723,"6 de julio de 1997"
20,11,487,2124,364,301,665,"6 de julio de 1997"
20,11,490,2128,432,384,816,"6 de julio de 1997"
20,11,490,2129,404,357,761,"6 de julio de 1997"
20,11,490,2130,307,251,558,"6 de julio de 1997"
20,11,498,2150,642,638,1280,"6 de julio de 1997"
20,11,506,2173,383,358,741,"6 de julio de 1997"
20,11,506,2174,385,330,715,"6 de julio de 1997"
20,11,530,2265,479,490,969,"6 de julio de 1997"
20,11,530,2266,331,315,646,"6 de julio de 1997"
20,11,530,2267,259,306,565,"6 de julio de 1997"
20,11,530,2268,443,397,840,"6 de julio de 1997"
20,11,530,2269,446,346,792,"6 de julio de 1997"
20,11,530,2270,415,365,780,"6 de julio de 1997"
20,11,530,2271,362,338,700,"6 de julio de 1997"
20,11,542,2318,521,455,976,"6 de julio de 1997"
20,11,542,2319,258,267,525,"6 de julio de 1997"
20,11,542,2320,371,344,715,"6 de julio de 1997"
21,1,50,423,429,542,971,"6 de julio de 1997"
21,1,50,424,558,527,1085,"6 de julio de 1997"
21,1,50,425,172,169,341,"6 de julio de 1997"
21,1,50,426,292,294,586,"6 de julio de 1997"
21,1,50,427,271,261,532,"6 de julio de 1997"
21,1,50,428,449,469,918,"6 de julio de 1997"
21,1,50,429,211,163,374,"6 de julio de 1997"
21,1,58,502,511,535,1046,"6 de julio de 1997"
21,1,58,503,406,387,793,"6 de julio de 1997"
21,1,58,504,693,679,1372,"6 de julio de 1997"
21,1,65,535,658,679,1337,"6 de julio de 1997"
21,1,65,536,514,530,1044,"6 de julio de 1997"
21,1,65,537,564,486,1050,"6 de julio de 1997"
21,1,65,538,589,484,1073,"6 de julio de 1997"
21,1,65,539,297,290,587,"6 de julio de 1997"
21,1,65,540,321,293,614,"6 de julio de 1997"
21,1,65,541,482,470,952,"6 de julio de 1997"
21,1,65,542,404,388,792,"6 de julio de 1997"
21,1,65,543,234,257,491,"6 de julio de 1997"
21,1,72,594,446,575,1021,"6 de julio de 1997"
21,1,72,595,366,404,770,"6 de julio de 1997"
21,1,72,596,602,610,1212,"6 de julio de 1997"
21,1,72,597,576,660,1236,"6 de julio de 1997"
21,1,72,598,768,897,1665,"6 de julio de 1997"
21,1,72,599,590,684,1274,"6 de julio de 1997"
21,1,72,600,622,729,1351,"6 de julio de 1997"
21,1,72,601,446,538,984,"6 de julio de 1997"
21,1,72,602,432,495,927,"6 de julio de 1997"
21,1,72,603,989,1158,2147,"6 de julio de 1997"
21,1,72,604,834,976,1810,"6 de julio de 1997"
21,1,72,605,410,462,872,"6 de julio de 1997"
21,1,72,606,344,375,719,"6 de julio de 1997"
21,1,72,607,679,788,1467,"6 de julio de 1997"
21,1,72,608,495,559,1054,"6 de julio de 1997"
21,1,72,609,808,804,1612,"6 de julio de 1997"
21,1,72,610,532,571,1103,"6 de julio de 1997"
21,1,72,611,672,752,1424,"6 de julio de 1997"
21,1,72,612,873,950,1823,"6 de julio de 1997"
21,1,72,613,348,292,640,"6 de julio de 1997"
21,1,72,614,362,400,762,"6 de julio de 1997"
21,1,72,615,651,758,1409,"6 de julio de 1997"
21,1,72,616,882,891,1773,"6 de julio de 1997"
21,1,72,617,286,292,578,"6 de julio de 1997"
21,1,72,618,562,551,1113,"6 de julio de 1997"
21,1,72,619,413,428,841,"6 de julio de 1997"
21,1,72,620,168,169,337,"6 de julio de 1997"
21,1,72,621,146,123,269,"6 de julio de 1997"
21,1,72,622,335,385,720,"6 de julio de 1997"
21,1,72,623,588,634,1222,"6 de julio de 1997"
21,1,72,624,371,421,792,"6 de julio de 1997"
21,1,72,625,166,194,360,"6 de julio de 1997"
21,1,72,626,302,259,561,"6 de julio de 1997"
21,1,72,627,385,301,686,"6 de julio de 1997"
21,1,72,628,448,330,778,"6 de julio de 1997"
21,1,72,629,660,572,1232,"6 de julio de 1997"
21,1,72,630,259,213,472,"6 de julio de 1997"
21,1,88,764,568,523,1091,"6 de julio de 1997"
21,1,88,765,565,485,1050,"6 de julio de 1997"
21,1,88,766,305,256,561,"6 de julio de 1997"
21,1,88,767,535,582,1117,"6 de julio de 1997"
21,1,88,768,556,572,1128,"6 de julio de 1997"
21,1,88,769,200,175,375,"6 de julio de 1997"
21,1,93,792,610,730,1340,"6 de julio de 1997"
21,1,93,793,623,732,1355,"6 de julio de 1997"
21,1,93,794,357,429,786,"6 de julio de 1997"
21,1,93,795,266,318,584,"6 de julio de 1997"
21,1,93,796,116,118,234,"6 de julio de 1997"
21,1,101,830,311,344,655,"6 de julio de 1997"
21,1,101,831,366,301,667,"6 de julio de 1997"
21,1,101,832,424,405,829,"6 de julio de 1997"
21,1,101,833,354,388,742,"6 de julio de 1997"
21,1,101,834,428,532,960,"6 de julio de 1997"
21,1,110,883,342,378,720,"6 de julio de 1997"
21,1,110,884,364,382,746,"6 de julio de 1997"
21,1,110,885,255,257,512,"6 de julio de 1997"
21,1,110,886,109,84,193,"6 de julio de 1997"
21,1,110,887,363,325,688,"6 de julio de 1997"
21,1,110,888,261,243,504,"6 de julio de 1997"
21,1,110,889,381,348,729,"6 de julio de 1997"
21,1,110,890,527,615,1142,"6 de julio de 1997"
21,1,110,891,122,134,256,"6 de julio de 1997"
21,1,110,892,92,96,188,"6 de julio de 1997"
21,1,110,893,334,359,693,"6 de julio de 1997"
21,1,110,894,189,198,387,"6 de julio de 1997"
21,1,110,895,97,104,201,"6 de julio de 1997"
21,1,110,896,426,497,923,"6 de julio de 1997"
21,1,112,912,319,325,644,"6 de julio de 1997"
21,1,112,913,678,653,1331,"6 de julio de 1997"
21,1,112,914,291,275,566,"6 de julio de 1997"
21,1,112,915,451,410,861,"6 de julio de 1997"
21,1,112,916,282,289,571,"6 de julio de 1997"
21,1,112,917,548,541,1089,"6 de julio de 1997"
21,1,112,918,430,444,874,"6 de julio de 1997"
21,1,112,919,524,526,1050,"6 de julio de 1997"
21,1,112,920,513,520,1033,"6 de julio de 1997"
21,1,112,921,419,367,786,"6 de julio de 1997"
21,1,178,2209,587,514,1101,"6 de julio de 1997"
21,1,178,2210,374,322,696,"6 de julio de 1997"
21,1,178,2211,322,323,645,"6 de julio de 1997"
21,1,178,2212,568,484,1052,"6 de julio de 1997"
21,1,178,2213,419,463,882,"6 de julio de 1997"
21,1,178,2214,241,193,434,"6 de julio de 1997"
21,1,178,2215,468,447,915,"6 de julio de 1997"
21,1,178,2216,258,188,446,"6 de julio de 1997"
21,1,178,2217,322,268,590,"6 de julio de 1997"
21,1,178,2218,362,311,673,"6 de julio de 1997"
21,1,183,2253,334,368,702,"6 de julio de 1997"
21,1,183,2254,667,651,1318,"6 de julio de 1997"
21,1,183,2255,272,260,532,"6 de julio de 1997"
21,1,183,2256,127,132,259,"6 de julio de 1997"
21,1,183,2257,698,692,1390,"6 de julio de 1997"
21,1,183,2258,362,359,721,"6 de julio de 1997"
21,1,183,2259,558,517,1075,"6 de julio de 1997"
21,1,183,2260,437,464,901,"6 de julio de 1997"
21,1,183,2261,240,279,519,"6 de julio de 1997"
21,1,184,2262,336,288,624,"6 de julio de 1997"
21,1,184,2263,201,161,362,"6 de julio de 1997"
21,1,184,2264,420,358,778,"6 de julio de 1997"
21,1,184,2265,192,152,344,"6 de julio de 1997"
21,1,184,2266,203,177,380,"6 de julio de 1997"
21,1,187,2295,355,332,687,"6 de julio de 1997"
21,1,187,2296,387,342,729,"6 de julio de 1997"
21,1,187,2297,422,324,746,"6 de julio de 1997"
21,1,187,2298,306,261,567,"6 de julio de 1997"
21,1,194,2333,487,551,1038,"6 de julio de 1997"
21,1,194,2334,350,381,731,"6 de julio de 1997"
21,1,194,2335,413,462,875,"6 de julio de 1997"
21,1,194,2336,387,424,811,"6 de julio de 1997"
21,1,194,2337,97,105,202,"6 de julio de 1997"
21,1,194,2338,400,337,737,"6 de julio de 1997"
21,1,194,2339,192,178,370,"6 de julio de 1997"
21,1,194,2340,213,172,385,"6 de julio de 1997"
21,1,194,2341,95,90,185,"6 de julio de 1997"
21,1,194,2342,584,652,1236,"6 de julio de 1997"
21,1,194,2343,550,644,1194,"6 de julio de 1997"
21,1,194,2344,552,559,1111,"6 de julio de 1997"
21,1,194,2345,675,654,1329,"6 de julio de 1997"
21,1,194,2346,406,429,835,"6 de julio de 1997"
21,1,194,2347,295,364,659,"6 de julio de 1997"
21,1,194,2348,308,331,639,"6 de julio de 1997"
21,1,197,2362,481,505,986,"6 de julio de 1997"
21,1,197,2363,630,614,1244,"6 de julio de 1997"
21,1,197,2364,532,580,1112,"6 de julio de 1997"
21,1,197,2365,582,728,1310,"6 de julio de 1997"
21,1,197,2366,821,902,1723,"6 de julio de 1997"
21,1,197,2367,729,812,1541,"6 de julio de 1997"
21,1,197,2368,367,436,803,"6 de julio de 1997"
21,1,197,2369,595,692,1287,"6 de julio de 1997"
21,1,197,2370,688,806,1494,"6 de julio de 1997"
21,1,197,2371,611,690,1301,"6 de julio de 1997"
21,1,197,2372,535,617,1152,"6 de julio de 1997"
21,1,197,2373,805,932,1737,"6 de julio de 1997"
21,1,197,2374,390,460,850,"6 de julio de 1997"
21,1,197,2375,464,527,991,"6 de julio de 1997"
21,1,197,2376,740,786,1526,"6 de julio de 1997"
21,1,197,2377,643,702,1345,"6 de julio de 1997"
21,1,197,2378,600,696,1296,"6 de julio de 1997"
21,1,197,2379,403,474,877,"6 de julio de 1997"
21,1,197,2380,673,813,1486,"6 de julio de 1997"
21,1,197,2381,313,353,666,"6 de julio de 1997"
21,1,197,2382,416,384,800,"6 de julio de 1997"
21,1,197,2383,625,567,1192,"6 de julio de 1997"
21,1,197,2384,318,278,596,"6 de julio de 1997"
21,1,197,2385,460,450,910,"6 de julio de 1997"
21,1,197,2386,269,212,481,"6 de julio de 1997"
21,1,197,2387,279,253,532,"6 de julio de 1997"
21,1,197,2388,309,323,632,"6 de julio de 1997"
21,1,197,2389,558,501,1059,"6 de julio de 1997"
21,1,197,2390,332,343,675,"6 de julio de 1997"
21,1,213,2520,546,532,1078,"6 de julio de 1997"
21,1,213,2521,228,193,421,"6 de julio de 1997"
21,1,213,2522,479,438,917,"6 de julio de 1997"
21,1,213,2523,353,307,660,"6 de julio de 1997"
21,1,213,2524,431,409,840,"6 de julio de 1997"
21,1,213,2525,184,164,348,"6 de julio de 1997"
21,1,213,2526,563,551,1114,"6 de julio de 1997"
21,2,6,64,367,386,753,"6 de julio de 1997"
21,2,6,65,463,507,970,"6 de julio de 1997"
21,2,6,66,484,409,893,"6 de julio de 1997"
21,2,6,67,480,482,962,"6 de julio de 1997"
21,2,6,68,374,401,775,"6 de julio de 1997"
21,2,6,69,247,261,508,"6 de julio de 1997"
21,2,6,70,398,519,917,"6 de julio de 1997"
21,2,8,75,480,456,936,"6 de julio de 1997"
21,2,8,76,612,610,1222,"6 de julio de 1997"
21,2,8,77,732,772,1504,"6 de julio de 1997"
21,2,8,78,321,299,620,"6 de julio de 1997"
21,2,14,113,540,554,1094,"6 de julio de 1997"
21,2,14,114,198,210,408,"6 de julio de 1997"
21,2,14,115,412,430,842,"6 de julio de 1997"
21,2,16,134,620,622,1242,"6 de julio de 1997"
21,2,16,135,202,216,418,"6 de julio de 1997"
21,2,16,136,463,461,924,"6 de julio de 1997"
21,2,16,137,427,431,858,"6 de julio de 1997"
21,2,16,138,276,234,510,"6 de julio de 1997"
21,2,28,260,339,331,670,"6 de julio de 1997"
21,2,28,261,109,119,228,"6 de julio de 1997"
21,2,30,271,556,553,1109,"6 de julio de 1997"
21,2,30,272,322,349,671,"6 de julio de 1997"
21,2,31,273,202,213,415,"6 de julio de 1997"
21,2,40,319,717,747,1464,"6 de julio de 1997"
21,2,40,320,420,433,853,"6 de julio de 1997"
21,2,40,321,358,362,720,"6 de julio de 1997"
21,2,40,322,243,302,545,"6 de julio de 1997"
21,2,54,461,514,622,1136,"6 de julio de 1997"
21,2,54,462,413,445,858,"6 de julio de 1997"
21,2,54,463,399,428,827,"6 de julio de 1997"
21,2,54,464,478,527,1005,"6 de julio de 1997"
21,2,54,465,404,465,869,"6 de julio de 1997"
21,2,54,466,456,496,952,"6 de julio de 1997"
21,2,54,467,636,793,1429,"6 de julio de 1997"
21,2,54,468,485,557,1042,"6 de julio de 1997"
21,2,54,469,437,405,842,"6 de julio de 1997"
21,2,54,470,527,454,981,"6 de julio de 1997"
21,2,54,471,458,411,869,"6 de julio de 1997"
21,2,54,472,315,309,624,"6 de julio de 1997"
21,2,54,473,252,214,466,"6 de julio de 1997"
21,2,54,474,415,368,783,"6 de julio de 1997"
21,2,54,475,325,311,636,"6 de julio de 1997"
21,2,54,476,467,455,922,"6 de julio de 1997"
21,2,54,477,152,139,291,"6 de julio de 1997"
21,2,54,478,285,236,521,"6 de julio de 1997"
21,2,54,479,560,579,1139,"6 de julio de 1997"
21,2,54,480,303,283,586,"6 de julio de 1997"
21,2,54,481,434,384,818,"6 de julio de 1997"
21,2,54,482,618,604,1222,"6 de julio de 1997"
21,2,54,483,539,518,1057,"6 de julio de 1997"
21,2,54,484,394,387,781,"6 de julio de 1997"
21,2,54,485,396,365,761,"6 de julio de 1997"
21,2,54,486,453,450,903,"6 de julio de 1997"
21,2,54,487,479,466,945,"6 de julio de 1997"
21,2,54,488,567,533,1100,"6 de julio de 1997"
21,2,69,565,724,640,1364,"6 de julio de 1997"
21,2,69,566,401,367,768,"6 de julio de 1997"
21,2,69,567,227,217,444,"6 de julio de 1997"
21,2,69,568,479,371,850,"6 de julio de 1997"
21,2,73,631,509,493,1002,"6 de julio de 1997"
21,2,73,632,559,609,1168,"6 de julio de 1997"
21,2,73,633,367,361,728,"6 de julio de 1997"
21,2,73,634,371,360,731,"6 de julio de 1997"
21,2,73,635,220,213,433,"6 de julio de 1997"
21,2,73,636,607,520,1127,"6 de julio de 1997"
21,2,73,637,414,398,812,"6 de julio de 1997"
21,2,73,638,377,303,680,"6 de julio de 1997"
21,2,73,639,407,412,819,"6 de julio de 1997"
21,2,79,693,402,357,759,"6 de julio de 1997"
21,2,79,694,217,204,421,"6 de julio de 1997"
21,2,79,695,579,477,1056,"6 de julio de 1997"
21,2,80,696,716,700,1416,"6 de julio de 1997"
21,2,80,697,240,226,466,"6 de julio de 1997"
21,2,80,698,560,541,1101,"6 de julio de 1997"
21,2,80,699,313,266,579,"6 de julio de 1997"
21,2,80,700,469,404,873,"6 de julio de 1997"
21,2,82,704,375,405,780,"6 de julio de 1997"
21,2,82,705,257,289,546,"6 de julio de 1997"
21,2,86,727,548,590,1138,"6 de julio de 1997"
21,2,86,728,824,925,1749,"6 de julio de 1997"
21,2,86,729,129,120,249,"6 de julio de 1997"
21,2,90,776,396,440,836,"6 de julio de 1997"
21,2,90,777,212,199,411,"6 de julio de 1997"
21,2,90,778,583,526,1109,"6 de julio de 1997"
21,2,91,779,554,621,1175,"6 de julio de 1997"
21,2,91,780,462,424,886,"6 de julio de 1997"
21,2,91,781,296,297,593,"6 de julio de 1997"
21,2,91,782,262,207,469,"6 de julio de 1997"
21,2,91,783,379,314,693,"6 de julio de 1997"
21,2,91,784,91,83,174,"6 de julio de 1997"
21,2,91,785,450,375,825,"6 de julio de 1997"
21,2,102,835,561,612,1173,"6 de julio de 1997"
21,2,102,836,241,239,480,"6 de julio de 1997"
21,2,102,837,131,151,282,"6 de julio de 1997"
21,2,108,867,417,440,857,"6 de julio de 1997"
21,2,108,868,442,514,956,"6 de julio de 1997"
21,2,108,869,500,464,964,"6 de julio de 1997"
21,2,108,870,236,247,483,"6 de julio de 1997"
21,2,108,871,445,447,892,"6 de julio de 1997"
21,2,108,872,312,301,613,"6 de julio de 1997"
21,2,108,873,184,190,374,"6 de julio de 1997"
21,2,108,874,226,191,417,"6 de julio de 1997"
21,2,124,1682,496,452,948,"6 de julio de 1997"
21,2,124,1683,297,292,589,"6 de julio de 1997"
21,2,124,1684,292,227,519,"6 de julio de 1997"
21,2,161,2049,418,416,834,"6 de julio de 1997"
21,2,161,2050,451,465,916,"6 de julio de 1997"
21,2,166,2089,291,343,634,"6 de julio de 1997"
21,2,166,2090,386,441,827,"6 de julio de 1997"
21,2,166,2091,185,225,410,"6 de julio de 1997"
21,2,166,2092,371,399,770,"6 de julio de 1997"
21,2,166,2093,455,590,1045,"6 de julio de 1997"
21,2,166,2094,144,194,338,"6 de julio de 1997"
21,2,171,2117,482,570,1052,"6 de julio de 1997"
21,2,171,2118,601,673,1274,"6 de julio de 1997"
21,2,171,2119,433,379,812,"6 de julio de 1997"
21,2,171,2120,404,324,728,"6 de julio de 1997"
21,2,171,2121,118,126,244,"6 de julio de 1997"
21,2,171,2122,696,727,1423,"6 de julio de 1997"
21,2,171,2123,241,231,472,"6 de julio de 1997"
21,2,171,2124,344,374,718,"6 de julio de 1997"
21,2,171,2125,428,479,907,"6 de julio de 1997"
21,2,171,2126,572,609,1181,"6 de julio de 1997"
21,2,171,2127,433,420,853,"6 de julio de 1997"
21,2,171,2128,331,313,644,"6 de julio de 1997"
21,2,171,2129,501,457,958,"6 de julio de 1997"
21,2,171,2130,170,164,334,"6 de julio de 1997"
21,2,171,2131,326,238,564,"6 de julio de 1997"
21,2,192,2326,477,545,1022,"6 de julio de 1997"
21,2,192,2327,504,506,1010,"6 de julio de 1997"
21,2,192,2328,465,467,932,"6 de julio de 1997"
21,2,202,2409,729,668,1397,"6 de julio de 1997"
21,2,202,2410,566,594,1160,"6 de julio de 1997"
21,2,202,2411,619,735,1354,"6 de julio de 1997"
21,2,202,2412,551,626,1177,"6 de julio de 1997"
21,2,208,2460,489,632,1121,"6 de julio de 1997"
21,2,208,2461,573,718,1291,"6 de julio de 1997"
21,2,208,2462,446,590,1036,"6 de julio de 1997"
21,2,208,2463,555,684,1239,"6 de julio de 1997"
21,2,208,2464,302,365,667,"6 de julio de 1997"
21,2,208,2465,563,698,1261,"6 de julio de 1997"
21,2,208,2466,446,568,1014,"6 de julio de 1997"
21,2,208,2467,394,473,867,"6 de julio de 1997"
21,2,208,2468,791,989,1780,"6 de julio de 1997"
21,2,208,2469,436,533,969,"6 de julio de 1997"
21,2,208,2470,498,493,991,"6 de julio de 1997"
21,2,208,2471,581,643,1224,"6 de julio de 1997"
21,2,208,2472,547,585,1132,"6 de julio de 1997"
21,2,208,2473,488,507,995,"6 de julio de 1997"
21,2,208,2474,529,523,1052,"6 de julio de 1997"
21,2,208,2475,566,560,1126,"6 de julio de 1997"
21,2,208,2476,454,424,878,"6 de julio de 1997"
21,2,208,2477,332,347,679,"6 de julio de 1997"
21,2,208,2478,713,745,1458,"6 de julio de 1997"
21,2,208,2479,674,764,1438,"6 de julio de 1997"
21,2,208,2480,747,828,1575,"6 de julio de 1997"
21,2,208,2481,594,671,1265,"6 de julio de 1997"
21,2,208,2482,438,479,917,"6 de julio de 1997"
21,2,208,2483,372,394,766,"6 de julio de 1997"
21,2,208,2484,669,734,1403,"6 de julio de 1997"
21,2,208,2485,447,494,941,"6 de julio de 1997"
21,2,208,2486,496,480,976,"6 de julio de 1997"
21,2,208,2487,469,589,1058,"6 de julio de 1997"
21,2,208,2488,248,253,501,"6 de julio de 1997"
21,2,208,2489,347,372,719,"6 de julio de 1997"
21,2,210,2499,489,489,978,"6 de julio de 1997"
21,2,210,2500,280,235,515,"6 de julio de 1997"
21,2,210,2501,502,492,994,"6 de julio de 1997"
21,2,215,2533,641,687,1328,"6 de julio de 1997"
21,2,215,2534,369,381,750,"6 de julio de 1997"
21,2,216,2535,489,537,1026,"6 de julio de 1997"
21,2,216,2536,150,189,339,"6 de julio de 1997"
21,3,2,20,486,474,960,"6 de julio de 1997"
21,3,2,21,408,413,821,"6 de julio de 1997"
21,3,2,22,194,182,376,"6 de julio de 1997"
21,3,2,23,219,200,419,"6 de julio de 1997"
21,3,2,24,251,212,463,"6 de julio de 1997"
21,3,2,25,101,75,176,"6 de julio de 1997"
21,3,2,26,324,306,630,"6 de julio de 1997"
21,3,2,27,388,309,697,"6 de julio de 1997"
21,3,17,139,564,629,1193,"6 de julio de 1997"
21,3,17,140,577,626,1203,"6 de julio de 1997"
21,3,17,141,223,238,461,"6 de julio de 1997"
21,3,17,142,35,33,68,"6 de julio de 1997"
21,3,17,143,576,510,1086,"6 de julio de 1997"
21,3,17,144,474,498,972,"6 de julio de 1997"
21,3,17,145,670,706,1376,"6 de julio de 1997"
21,3,17,146,375,363,738,"6 de julio de 1997"
21,3,17,147,92,97,189,"6 de julio de 1997"
21,3,25,241,455,493,948,"6 de julio de 1997"
21,3,25,242,519,495,1014,"6 de julio de 1997"
21,3,25,243,352,303,655,"6 de julio de 1997"
21,3,25,244,366,325,691,"6 de julio de 1997"
21,3,44,344,331,412,743,"6 de julio de 1997"
21,3,44,345,317,360,677,"6 de julio de 1997"
21,3,44,346,471,548,1019,"6 de julio de 1997"
21,3,44,347,264,302,566,"6 de julio de 1997"
21,3,44,348,391,354,745,"6 de julio de 1997"
21,3,44,349,628,577,1205,"6 de julio de 1997"
21,3,44,350,404,373,777,"6 de julio de 1997"
21,3,44,351,539,537,1076,"6 de julio de 1997"
21,3,44,352,792,679,1471,"6 de julio de 1997"
21,3,44,353,423,402,825,"6 de julio de 1997"
21,3,44,354,660,657,1317,"6 de julio de 1997"
21,3,44,355,790,784,1574,"6 de julio de 1997"
21,3,44,356,424,389,813,"6 de julio de 1997"
21,3,44,357,377,379,756,"6 de julio de 1997"
21,3,44,358,414,376,790,"6 de julio de 1997"
21,3,44,359,844,703,1547,"6 de julio de 1997"
21,3,44,360,531,510,1041,"6 de julio de 1997"
21,3,44,361,333,339,672,"6 de julio de 1997"
21,3,44,362,337,323,660,"6 de julio de 1997"
21,3,44,363,533,420,953,"6 de julio de 1997"
21,3,55,489,641,716,1357,"6 de julio de 1997"
21,3,55,490,575,571,1146,"6 de julio de 1997"
21,3,55,491,650,693,1343,"6 de julio de 1997"
21,3,55,492,608,568,1176,"6 de julio de 1997"
21,3,55,493,774,786,1560,"6 de julio de 1997"
21,3,55,494,648,640,1288,"6 de julio de 1997"
21,3,55,495,465,455,920,"6 de julio de 1997"
21,3,77,673,380,393,773,"6 de julio de 1997"
21,3,77,674,589,646,1235,"6 de julio de 1997"
21,3,77,675,117,92,209,"6 de julio de 1997"
21,3,77,676,358,333,691,"6 de julio de 1997"
21,3,77,677,468,471,939,"6 de julio de 1997"
21,3,78,678,607,635,1242,"6 de julio de 1997"
21,3,78,679,432,456,888,"6 de julio de 1997"
21,3,78,680,106,105,211,"6 de julio de 1997"
21,3,78,681,472,403,875,"6 de julio de 1997"
21,3,78,682,669,573,1242,"6 de julio de 1997"
21,3,78,683,528,478,1006,"6 de julio de 1997"
21,3,78,684,197,195,392,"6 de julio de 1997"
21,3,78,685,520,450,970,"6 de julio de 1997"
21,3,78,686,487,425,912,"6 de julio de 1997"
21,3,78,687,614,547,1161,"6 de julio de 1997"
21,3,78,688,319,254,573,"6 de julio de 1997"
21,3,78,689,73,71,144,"6 de julio de 1997"
21,3,78,690,614,552,1166,"6 de julio de 1997"
21,3,78,691,232,204,436,"6 de julio de 1997"
21,3,78,692,351,353,704,"6 de julio de 1997"
21,3,157,2025,422,411,833,"6 de julio de 1997"
21,3,157,2026,554,530,1084,"6 de julio de 1997"
21,3,157,2027,359,331,690,"6 de julio de 1997"
21,3,157,2028,108,105,213,"6 de julio de 1997"
21,3,157,2029,123,134,257,"6 de julio de 1997"
21,3,157,2030,114,124,238,"6 de julio de 1997"
21,3,157,2031,226,153,379,"6 de julio de 1997"
21,3,157,2032,92,74,166,"6 de julio de 1997"
21,3,172,2132,521,675,1196,"6 de julio de 1997"
21,3,172,2133,480,520,1000,"6 de julio de 1997"
21,3,173,2134,383,451,834,"6 de julio de 1997"
21,3,173,2135,289,352,641,"6 de julio de 1997"
21,3,173,2136,609,603,1212,"6 de julio de 1997"
21,3,173,2137,727,873,1600,"6 de julio de 1997"
21,3,173,2138,420,545,965,"6 de julio de 1997"
21,3,173,2139,384,485,869,"6 de julio de 1997"
21,3,173,2140,465,532,997,"6 de julio de 1997"
21,3,173,2141,237,258,495,"6 de julio de 1997"
21,3,173,2142,751,908,1659,"6 de julio de 1997"
21,3,173,2143,263,322,585,"6 de julio de 1997"
21,3,173,2144,372,453,825,"6 de julio de 1997"
21,3,173,2145,157,199,356,"6 de julio de 1997"
21,3,173,2146,619,684,1303,"6 de julio de 1997"
21,3,173,2147,610,772,1382,"6 de julio de 1997"
21,3,173,2148,397,546,943,"6 de julio de 1997"
21,3,173,2149,437,493,930,"6 de julio de 1997"
21,3,173,2150,513,589,1102,"6 de julio de 1997"
21,3,173,2151,529,681,1210,"6 de julio de 1997"
21,3,173,2152,219,313,532,"6 de julio de 1997"
21,3,173,2153,504,604,1108,"6 de julio de 1997"
21,3,173,2154,530,618,1148,"6 de julio de 1997"
21,3,173,2155,260,296,556,"6 de julio de 1997"
21,3,173,2156,495,585,1080,"6 de julio de 1997"
21,3,173,2157,525,634,1159,"6 de julio de 1997"
21,3,173,2158,637,754,1391,"6 de julio de 1997"
21,3,173,2159,319,389,708,"6 de julio de 1997"
21,3,173,2160,420,492,912,"6 de julio de 1997"
21,3,173,2161,411,441,852,"6 de julio de 1997"
21,3,173,2162,580,709,1289,"6 de julio de 1997"
21,3,173,2163,691,786,1477,"6 de julio de 1997"
21,3,173,2164,687,746,1433,"6 de julio de 1997"
21,3,173,2165,157,197,354,"6 de julio de 1997"
21,3,173,2166,309,302,611,"6 de julio de 1997"
21,3,173,2167,650,685,1335,"6 de julio de 1997"
21,3,173,2168,439,441,880,"6 de julio de 1997"
21,3,173,2169,546,575,1121,"6 de julio de 1997"
21,3,173,2170,316,354,670,"6 de julio de 1997"
21,3,173,2171,165,154,319,"6 de julio de 1997"
21,3,173,2172,427,446,873,"6 de julio de 1997"
21,3,173,2173,756,773,1529,"6 de julio de 1997"
21,3,173,2174,396,421,817,"6 de julio de 1997"
21,3,186,2272,494,597,1091,"6 de julio de 1997"
21,3,186,2273,573,680,1253,"6 de julio de 1997"
21,3,186,2274,584,705,1289,"6 de julio de 1997"
21,3,186,2275,579,680,1259,"6 de julio de 1997"
21,3,186,2276,483,422,905,"6 de julio de 1997"
21,3,186,2277,253,194,447,"6 de julio de 1997"
21,3,186,2278,183,157,340,"6 de julio de 1997"
21,3,186,2279,515,411,926,"6 de julio de 1997"
21,3,186,2280,495,428,923,"6 de julio de 1997"
21,3,186,2281,374,350,724,"6 de julio de 1997"
21,3,186,2282,609,634,1243,"6 de julio de 1997"
21,3,186,2283,507,571,1078,"6 de julio de 1997"
21,3,186,2284,363,419,782,"6 de julio de 1997"
21,3,186,2285,287,290,577,"6 de julio de 1997"
21,3,186,2286,777,867,1644,"6 de julio de 1997"
21,3,186,2287,342,358,700,"6 de julio de 1997"
21,3,186,2288,458,513,971,"6 de julio de 1997"
21,3,186,2289,528,666,1194,"6 de julio de 1997"
21,3,186,2290,281,291,572,"6 de julio de 1997"
21,3,186,2291,597,631,1228,"6 de julio de 1997"
21,3,186,2292,275,303,578,"6 de julio de 1997"
21,3,186,2293,404,391,795,"6 de julio de 1997"
21,3,186,2294,411,409,820,"6 de julio de 1997"
21,3,199,2393,645,643,1288,"6 de julio de 1997"
21,3,199,2394,610,631,1241,"6 de julio de 1997"
21,3,199,2395,458,521,979,"6 de julio de 1997"
21,3,199,2396,369,361,730,"6 de julio de 1997"
21,3,199,2397,534,585,1119,"6 de julio de 1997"
21,3,199,2398,404,420,824,"6 de julio de 1997"
21,3,199,2399,604,632,1236,"6 de julio de 1997"
21,3,199,2400,631,641,1272,"6 de julio de 1997"
21,3,199,2401,606,613,1219,"6 de julio de 1997"
21,3,199,2402,465,460,925,"6 de julio de 1997"
21,3,199,2403,462,412,874,"6 de julio de 1997"
21,3,199,2404,298,279,577,"6 de julio de 1997"
21,3,200,2405,584,674,1258,"6 de julio de 1997"
21,3,200,2406,368,333,701,"6 de julio de 1997"
21,3,204,2416,272,306,578,"6 de julio de 1997"
21,3,204,2417,353,365,718,"6 de julio de 1997"
21,3,204,2418,261,238,499,"6 de julio de 1997"
21,3,204,2419,503,497,1000,"6 de julio de 1997"
21,3,207,2433,410,490,900,"6 de julio de 1997"
21,3,207,2434,423,489,912,"6 de julio de 1997"
21,3,207,2435,515,573,1088,"6 de julio de 1997"
21,3,207,2436,704,813,1517,"6 de julio de 1997"
21,3,207,2437,494,593,1087,"6 de julio de 1997"
21,3,207,2438,408,412,820,"6 de julio de 1997"
21,3,207,2439,387,326,713,"6 de julio de 1997"
21,3,207,2440,750,710,1460,"6 de julio de 1997"
21,3,207,2441,169,189,358,"6 de julio de 1997"
21,3,207,2442,158,172,330,"6 de julio de 1997"
21,3,207,2443,317,352,669,"6 de julio de 1997"
21,3,207,2444,144,165,309,"6 de julio de 1997"
21,3,207,2445,731,701,1432,"6 de julio de 1997"
21,3,207,2446,421,380,801,"6 de julio de 1997"
21,3,207,2447,429,393,822,"6 de julio de 1997"
21,3,207,2448,185,200,385,"6 de julio de 1997"
21,3,207,2449,405,448,853,"6 de julio de 1997"
21,3,207,2450,223,225,448,"6 de julio de 1997"
21,3,207,2451,219,200,419,"6 de julio de 1997"
21,3,207,2452,581,627,1208,"6 de julio de 1997"
21,3,207,2453,104,108,212,"6 de julio de 1997"
21,3,207,2454,201,220,421,"6 de julio de 1997"
21,3,207,2455,135,149,284,"6 de julio de 1997"
21,3,207,2456,150,153,303,"6 de julio de 1997"
21,3,207,2457,233,289,522,"6 de julio de 1997"
21,3,207,2458,433,505,938,"6 de julio de 1997"
21,3,207,2459,129,159,288,"6 de julio de 1997"
21,3,211,2502,399,488,887,"6 de julio de 1997"
21,3,211,2503,543,622,1165,"6 de julio de 1997"
21,3,211,2504,637,762,1399,"6 de julio de 1997"
21,3,211,2505,676,823,1499,"6 de julio de 1997"
21,3,211,2506,363,416,779,"6 de julio de 1997"
21,3,211,2507,276,350,626,"6 de julio de 1997"
21,4,45,364,440,487,927,"6 de julio de 1997"
21,4,45,365,692,680,1372,"6 de julio de 1997"
21,4,45,366,380,342,722,"6 de julio de 1997"
21,4,45,367,603,643,1246,"6 de julio de 1997"
21,4,45,368,341,361,702,"6 de julio de 1997"
21,4,45,369,540,531,1071,"6 de julio de 1997"
21,4,45,370,467,486,953,"6 de julio de 1997"
21,4,51,430,731,723,1454,"6 de julio de 1997"
21,4,51,431,178,136,314,"6 de julio de 1997"
21,4,51,432,385,364,749,"6 de julio de 1997"
21,4,51,433,568,630,1198,"6 de julio de 1997"
21,4,51,434,109,110,219,"6 de julio de 1997"
21,4,51,435,443,401,844,"6 de julio de 1997"
21,4,51,436,448,417,865,"6 de julio de 1997"
21,4,51,437,351,352,703,"6 de julio de 1997"
21,4,51,438,547,537,1084,"6 de julio de 1997"
21,4,59,505,455,436,891,"6 de julio de 1997"
21,4,59,506,570,547,1117,"6 de julio de 1997"
21,4,59,507,456,429,885,"6 de julio de 1997"
21,4,59,508,452,408,860,"6 de julio de 1997"
21,4,59,509,656,587,1243,"6 de julio de 1997"
21,4,59,510,821,738,1559,"6 de julio de 1997"
21,4,59,511,536,463,999,"6 de julio de 1997"
21,4,68,555,594,693,1287,"6 de julio de 1997"
21,4,68,556,480,513,993,"6 de julio de 1997"
21,4,68,557,325,417,742,"6 de julio de 1997"
21,4,68,558,378,417,795,"6 de julio de 1997"
21,4,68,559,507,518,1025,"6 de julio de 1997"
21,4,68,560,158,151,309,"6 de julio de 1997"
21,4,68,561,275,287,562,"6 de julio de 1997"
21,4,68,562,133,130,263,"6 de julio de 1997"
21,4,68,563,191,146,337,"6 de julio de 1997"
21,4,68,564,166,121,287,"6 de julio de 1997"
21,4,85,712,345,323,668,"6 de julio de 1997"
21,4,85,713,573,503,1076,"6 de julio de 1997"
21,4,85,714,403,318,721,"6 de julio de 1997"
21,4,85,715,581,490,1071,"6 de julio de 1997"
21,4,85,716,711,567,1278,"6 de julio de 1997"
21,4,85,717,410,348,758,"6 de julio de 1997"
21,4,85,718,374,412,786,"6 de julio de 1997"
21,4,85,719,540,534,1074,"6 de julio de 1997"
21,4,85,720,477,414,891,"6 de julio de 1997"
21,4,85,721,405,356,761,"6 de julio de 1997"
21,4,85,722,348,369,717,"6 de julio de 1997"
21,4,85,723,639,674,1313,"6 de julio de 1997"
21,4,85,724,245,249,494,"6 de julio de 1997"
21,4,85,725,374,320,694,"6 de julio de 1997"
21,4,85,726,499,431,930,"6 de julio de 1997"
21,4,95,801,356,353,709,"6 de julio de 1997"
21,4,95,802,573,586,1159,"6 de julio de 1997"
21,4,95,803,89,85,174,"6 de julio de 1997"
21,4,95,804,312,297,609,"6 de julio de 1997"
21,4,95,805,274,236,510,"6 de julio de 1997"
21,4,95,806,151,124,275,"6 de julio de 1997"
21,4,95,807,552,552,1104,"6 de julio de 1997"
21,4,95,808,466,442,908,"6 de julio de 1997"
21,4,96,809,602,685,1287,"6 de julio de 1997"
21,4,96,810,799,865,1664,"6 de julio de 1997"
21,4,96,811,663,722,1385,"6 de julio de 1997"
21,4,96,812,367,407,774,"6 de julio de 1997"
21,4,96,813,379,388,767,"6 de julio de 1997"
21,4,96,814,548,499,1047,"6 de julio de 1997"
21,4,96,815,560,589,1149,"6 de julio de 1997"
21,4,96,816,548,500,1048,"6 de julio de 1997"
21,4,96,817,381,366,747,"6 de julio de 1997"
21,4,96,818,289,289,578,"6 de julio de 1997"
21,4,96,819,569,615,1184,"6 de julio de 1997"
21,4,105,846,534,539,1073,"6 de julio de 1997"
21,4,105,847,675,737,1412,"6 de julio de 1997"
21,4,105,848,447,479,926,"6 de julio de 1997"
21,4,105,849,44,49,93,"6 de julio de 1997"
21,4,105,850,629,613,1242,"6 de julio de 1997"
21,4,105,851,618,615,1233,"6 de julio de 1997"
21,4,105,852,899,888,1787,"6 de julio de 1997"
21,4,105,853,260,219,479,"6 de julio de 1997"
21,4,106,854,475,470,945,"6 de julio de 1997"
21,4,106,855,522,541,1063,"6 de julio de 1997"
21,4,106,856,233,196,429,"6 de julio de 1997"
21,4,109,875,488,540,1028,"6 de julio de 1997"
21,4,109,876,542,568,1110,"6 de julio de 1997"
21,4,109,877,524,581,1105,"6 de julio de 1997"
21,4,109,878,337,381,718,"6 de julio de 1997"
21,4,109,879,412,440,852,"6 de julio de 1997"
21,4,109,880,337,386,723,"6 de julio de 1997"
21,4,109,881,309,272,581,"6 de julio de 1997"
21,4,109,882,211,211,422,"6 de julio de 1997"
21,4,117,1626,481,509,990,"6 de julio de 1997"
21,4,117,1627,272,248,520,"6 de julio de 1997"
21,4,117,1628,139,108,247,"6 de julio de 1997"
21,4,117,1629,540,462,1002,"6 de julio de 1997"
21,4,117,1630,308,257,565,"6 de julio de 1997"
21,4,117,1631,261,252,513,"6 de julio de 1997"
21,4,117,1632,494,529,1023,"6 de julio de 1997"
21,4,117,1633,354,291,645,"6 de julio de 1997"
21,4,117,1634,524,458,982,"6 de julio de 1997"
21,4,117,1635,591,539,1130,"6 de julio de 1997"
21,4,118,1636,513,545,1058,"6 de julio de 1997"
21,4,118,1637,444,500,944,"6 de julio de 1997"
21,4,118,1638,444,507,951,"6 de julio de 1997"
21,4,118,1639,344,388,732,"6 de julio de 1997"
21,4,118,1640,284,310,594,"6 de julio de 1997"
21,4,118,1641,572,635,1207,"6 de julio de 1997"
21,4,118,1642,603,619,1222,"6 de julio de 1997"
21,4,129,1702,235,250,485,"6 de julio de 1997"
21,4,129,1703,250,269,519,"6 de julio de 1997"
21,4,129,1704,295,284,579,"6 de julio de 1997"
21,4,129,1705,178,171,349,"6 de julio de 1997"
21,4,129,1706,361,350,711,"6 de julio de 1997"
21,4,129,1707,192,181,373,"6 de julio de 1997"
21,4,138,1789,519,511,1030,"6 de julio de 1997"
21,4,138,1790,540,548,1088,"6 de julio de 1997"
21,4,138,1791,696,641,1337,"6 de julio de 1997"
21,4,138,1792,383,365,748,"6 de julio de 1997"
21,4,143,1848,529,439,968,"6 de julio de 1997"
21,4,143,1849,567,563,1130,"6 de julio de 1997"
21,4,143,1850,521,505,1026,"6 de julio de 1997"
21,4,143,1851,477,474,951,"6 de julio de 1997"
21,4,143,1852,605,587,1192,"6 de julio de 1997"
21,4,143,1853,373,360,733,"6 de julio de 1997"
21,4,143,1854,413,431,844,"6 de julio de 1997"
21,4,143,1855,885,900,1785,"6 de julio de 1997"
21,4,143,1856,724,747,1471,"6 de julio de 1997"
21,4,143,1857,524,531,1055,"6 de julio de 1997"
21,4,169,2109,658,685,1343,"6 de julio de 1997"
21,4,169,2110,577,520,1097,"6 de julio de 1997"
21,4,169,2111,399,364,763,"6 de julio de 1997"
21,4,169,2112,637,636,1273,"6 de julio de 1997"
21,4,169,2113,500,456,956,"6 de julio de 1997"
21,4,169,2114,576,503,1079,"6 de julio de 1997"
21,4,169,2115,438,381,819,"6 de julio de 1997"
21,4,212,2508,297,351,648,"6 de julio de 1997"
21,4,212,2509,165,219,384,"6 de julio de 1997"
21,4,212,2510,324,384,708,"6 de julio de 1997"
21,4,212,2511,363,421,784,"6 de julio de 1997"
21,4,212,2512,356,406,762,"6 de julio de 1997"
21,4,212,2513,427,585,1012,"6 de julio de 1997"
21,4,212,2514,140,178,318,"6 de julio de 1997"
21,4,212,2515,576,634,1210,"6 de julio de 1997"
21,4,212,2516,580,652,1232,"6 de julio de 1997"
21,4,212,2517,215,244,459,"6 de julio de 1997"
21,4,212,2518,287,326,613,"6 de julio de 1997"
21,4,212,2519,347,473,820,"6 de julio de 1997"
21,5,26,245,254,336,590,"6 de julio de 1997"
21,5,26,246,466,509,975,"6 de julio de 1997"
21,5,26,247,416,441,857,"6 de julio de 1997"
21,5,26,248,644,707,1351,"6 de julio de 1997"
21,5,26,249,339,360,699,"6 de julio de 1997"
21,5,26,250,320,345,665,"6 de julio de 1997"
21,5,26,251,304,240,544,"6 de julio de 1997"
21,5,26,252,209,197,406,"6 de julio de 1997"
21,5,35,282,371,376,747,"6 de julio de 1997"
21,5,35,283,713,706,1419,"6 de julio de 1997"
21,5,35,284,552,534,1086,"6 de julio de 1997"
21,5,35,285,586,597,1183,"6 de julio de 1997"
21,5,35,286,334,353,687,"6 de julio de 1997"
21,5,35,287,549,573,1122,"6 de julio de 1997"
21,5,35,288,320,330,650,"6 de julio de 1997"
21,5,35,289,568,524,1092,"6 de julio de 1997"
21,5,35,290,453,472,925,"6 de julio de 1997"
21,5,35,291,634,597,1231,"6 de julio de 1997"
21,5,35,292,522,466,988,"6 de julio de 1997"
21,5,35,293,603,654,1257,"6 de julio de 1997"
21,5,42,325,828,830,1658,"6 de julio de 1997"
21,5,42,326,660,678,1338,"6 de julio de 1997"
21,5,42,327,668,706,1374,"6 de julio de 1997"
21,5,42,328,760,784,1544,"6 de julio de 1997"
21,5,42,329,555,586,1141,"6 de julio de 1997"
21,5,42,330,647,671,1318,"6 de julio de 1997"
21,5,42,331,435,468,903,"6 de julio de 1997"
21,5,42,332,575,633,1208,"6 de julio de 1997"
21,5,42,333,550,614,1164,"6 de julio de 1997"
21,5,42,334,305,306,611,"6 de julio de 1997"
21,5,42,335,167,186,353,"6 de julio de 1997"
21,5,42,336,559,661,1220,"6 de julio de 1997"
21,5,42,337,546,561,1107,"6 de julio de 1997"
21,5,42,338,582,597,1179,"6 de julio de 1997"
21,5,42,339,582,612,1194,"6 de julio de 1997"
21,5,49,415,665,745,1410,"6 de julio de 1997"
21,5,49,416,466,476,942,"6 de julio de 1997"
21,5,49,417,432,480,912,"6 de julio de 1997"
21,5,49,418,673,613,1286,"6 de julio de 1997"
21,5,49,419,410,447,857,"6 de julio de 1997"
21,5,49,420,669,648,1317,"6 de julio de 1997"
21,5,49,421,358,421,779,"6 de julio de 1997"
21,5,49,422,438,505,943,"6 de julio de 1997"
21,5,61,515,334,369,703,"6 de julio de 1997"
21,5,61,516,563,582,1145,"6 de julio de 1997"
21,5,61,517,446,475,921,"6 de julio de 1997"
21,5,76,651,446,478,924,"6 de julio de 1997"
21,5,76,652,616,630,1246,"6 de julio de 1997"
21,5,76,653,605,660,1265,"6 de julio de 1997"
21,5,76,654,531,603,1134,"6 de julio de 1997"
21,5,76,655,537,602,1139,"6 de julio de 1997"
21,5,76,656,484,529,1013,"6 de julio de 1997"
21,5,76,657,801,921,1722,"6 de julio de 1997"
21,5,76,658,420,422,842,"6 de julio de 1997"
21,5,76,659,471,532,1003,"6 de julio de 1997"
21,5,76,660,473,488,961,"6 de julio de 1997"
21,5,76,661,717,786,1503,"6 de julio de 1997"
21,5,76,662,540,580,1120,"6 de julio de 1997"
21,5,76,663,501,544,1045,"6 de julio de 1997"
21,5,76,664,563,600,1163,"6 de julio de 1997"
21,5,76,665,530,498,1028,"6 de julio de 1997"
21,5,76,666,511,586,1097,"6 de julio de 1997"
21,5,76,667,482,541,1023,"6 de julio de 1997"
21,5,76,668,628,640,1268,"6 de julio de 1997"
21,5,76,669,167,141,308,"6 de julio de 1997"
21,5,76,670,566,551,1117,"6 de julio de 1997"
21,5,76,671,258,252,510,"6 de julio de 1997"
21,5,76,672,773,714,1487,"6 de julio de 1997"
21,5,92,786,890,885,1775,"6 de julio de 1997"
21,5,92,787,353,385,738,"6 de julio de 1997"
21,5,92,788,441,496,937,"6 de julio de 1997"
21,5,92,789,494,524,1018,"6 de julio de 1997"
21,5,92,790,681,744,1425,"6 de julio de 1997"
21,5,92,791,723,717,1440,"6 de julio de 1997"
21,5,123,1677,421,433,854,"6 de julio de 1997"
21,5,123,1678,526,535,1061,"6 de julio de 1997"
21,5,123,1679,432,463,895,"6 de julio de 1997"
21,5,123,1680,588,558,1146,"6 de julio de 1997"
21,5,123,1681,179,177,356,"6 de julio de 1997"
21,5,133,1720,901,967,1868,"6 de julio de 1997"
21,5,133,1721,576,628,1204,"6 de julio de 1997"
21,5,133,1722,431,461,892,"6 de julio de 1997"
21,5,133,1723,546,602,1148,"6 de julio de 1997"
21,5,133,1724,603,705,1308,"6 de julio de 1997"
21,5,133,1725,666,741,1407,"6 de julio de 1997"
21,5,133,1726,429,460,889,"6 de julio de 1997"
21,5,133,1727,629,672,1301,"6 de julio de 1997"
21,5,133,1728,473,555,1028,"6 de julio de 1997"
21,5,133,1729,471,518,989,"6 de julio de 1997"
21,5,133,1730,445,492,937,"6 de julio de 1997"
21,5,133,1731,205,240,445,"6 de julio de 1997"
21,5,133,1732,397,477,874,"6 de julio de 1997"
21,5,133,1733,644,801,1445,"6 de julio de 1997"
21,5,133,1734,609,631,1240,"6 de julio de 1997"
21,5,133,1735,550,643,1193,"6 de julio de 1997"
21,5,133,1736,271,316,587,"6 de julio de 1997"
21,5,133,1737,300,330,630,"6 de julio de 1997"
21,5,133,1738,320,369,689,"6 de julio de 1997"
21,5,133,1739,426,474,900,"6 de julio de 1997"
21,5,133,1740,447,527,974,"6 de julio de 1997"
21,5,133,1741,402,486,888,"6 de julio de 1997"
21,5,133,1742,464,466,930,"6 de julio de 1997"
21,5,133,1743,625,661,1286,"6 de julio de 1997"
21,5,133,1744,519,554,1073,"6 de julio de 1997"
21,5,133,1745,394,448,842,"6 de julio de 1997"
21,5,133,1746,593,588,1181,"6 de julio de 1997"
21,5,133,1747,484,455,939,"6 de julio de 1997"
21,5,133,1748,836,781,1617,"6 de julio de 1997"
21,5,133,1749,264,301,565,"6 de julio de 1997"
21,5,133,1750,1046,998,2044,"6 de julio de 1997"
21,5,133,1751,662,620,1282,"6 de julio de 1997"
21,5,133,1752,543,528,1071,"6 de julio de 1997"
21,5,133,1753,368,390,758,"6 de julio de 1997"
21,5,133,1754,732,839,1571,"6 de julio de 1997"
21,5,133,1755,767,801,1568,"6 de julio de 1997"
21,5,133,1756,1065,1164,2229,"6 de julio de 1997"
21,5,133,1757,430,484,914,"6 de julio de 1997"
21,5,133,1758,645,690,1335,"6 de julio de 1997"
21,5,133,1759,638,648,1286,"6 de julio de 1997"
21,5,133,1760,679,694,1373,"6 de julio de 1997"
21,5,133,1761,496,525,1021,"6 de julio de 1997"
21,5,133,1762,616,662,1278,"6 de julio de 1997"
21,5,133,1763,568,603,1171,"6 de julio de 1997"
21,5,133,1764,440,458,898,"6 de julio de 1997"
21,5,133,1765,284,318,602,"6 de julio de 1997"
21,5,133,1766,731,797,1528,"6 de julio de 1997"
21,5,133,1767,502,579,1081,"6 de julio de 1997"
21,5,133,1768,459,490,949,"6 de julio de 1997"
21,5,133,1769,390,420,810,"6 de julio de 1997"
21,5,133,1770,665,777,1442,"6 de julio de 1997"
21,5,133,1771,931,992,1923,"6 de julio de 1997"
21,5,133,1772,387,441,828,"6 de julio de 1997"
21,5,133,1773,544,598,1142,"6 de julio de 1997"
21,5,135,1775,613,635,1248,"6 de julio de 1997"
21,5,135,1776,533,513,1046,"6 de julio de 1997"
21,5,135,1777,623,653,1276,"6 de julio de 1997"
21,5,135,1778,644,697,1341,"6 de julio de 1997"
21,5,135,1779,406,430,836,"6 de julio de 1997"
21,5,135,1780,330,340,670,"6 de julio de 1997"
21,5,135,1781,444,467,911,"6 de julio de 1997"
21,5,135,1782,289,285,574,"6 de julio de 1997"
21,5,135,1783,288,300,588,"6 de julio de 1997"
21,5,137,1785,620,653,1273,"6 de julio de 1997"
21,5,137,1786,612,625,1237,"6 de julio de 1997"
21,5,137,1787,466,474,940,"6 de julio de 1997"
21,5,137,1788,673,665,1338,"6 de julio de 1997"
21,5,139,1793,406,336,742,"6 de julio de 1997"
21,5,139,1794,636,557,1193,"6 de julio de 1997"
21,5,139,1795,251,232,483,"6 de julio de 1997"
21,5,139,1796,512,497,1009,"6 de julio de 1997"
21,5,139,1797,418,292,710,"6 de julio de 1997"
21,5,144,1858,656,704,1360,"6 de julio de 1997"
21,5,144,1859,490,475,965,"6 de julio de 1997"
21,5,144,1860,495,543,1038,"6 de julio de 1997"
21,5,144,1861,546,545,1091,"6 de julio de 1997"
21,5,144,1862,427,422,849,"6 de julio de 1997"
21,5,144,1863,511,513,1024,"6 de julio de 1997"
21,5,144,1864,422,410,832,"6 de julio de 1997"
21,5,144,1865,467,459,926,"6 de julio de 1997"
21,5,144,1866,585,595,1180,"6 de julio de 1997"
21,5,144,1867,776,753,1529,"6 de julio de 1997"
21,5,180,2233,756,773,1529,"6 de julio de 1997"
21,5,180,2234,649,650,1299,"6 de julio de 1997"
21,5,180,2235,334,358,692,"6 de julio de 1997"
21,5,180,2236,270,298,568,"6 de julio de 1997"
21,5,180,2237,214,190,404,"6 de julio de 1997"
21,5,180,2238,410,355,765,"6 de julio de 1997"
21,5,180,2239,551,521,1072,"6 de julio de 1997"
21,5,180,2240,605,610,1215,"6 de julio de 1997"
21,5,180,2241,325,339,664,"6 de julio de 1997"
21,5,180,2242,231,213,444,"6 de julio de 1997"
21,5,180,2243,264,254,518,"6 de julio de 1997"
21,5,180,2244,596,632,1228,"6 de julio de 1997"
21,5,180,2245,679,652,1331,"6 de julio de 1997"
21,5,180,2246,729,641,1370,"6 de julio de 1997"
21,5,180,2247,817,722,1539,"6 de julio de 1997"
21,5,181,2248,292,329,621,"6 de julio de 1997"
21,5,181,2249,453,491,944,"6 de julio de 1997"
21,5,181,2250,376,398,774,"6 de julio de 1997"
21,6,115,1261,184,203,387,"6 de julio de 1997"
21,6,115,1262,219,235,454,"6 de julio de 1997"
21,6,115,1263,234,276,510,"6 de julio de 1997"
21,6,115,1264,245,299,544,"6 de julio de 1997"
21,6,115,1265,207,260,467,"6 de julio de 1997"
21,6,115,1266,186,201,387,"6 de julio de 1997"
21,6,115,1267,362,410,772,"6 de julio de 1997"
21,6,115,1268,347,454,801,"6 de julio de 1997"
21,6,115,1269,252,327,579,"6 de julio de 1997"
21,6,115,1270,251,274,525,"6 de julio de 1997"
21,6,115,1271,423,499,922,"6 de julio de 1997"
21,6,115,1272,211,247,458,"6 de julio de 1997"
21,6,115,1273,263,336,599,"6 de julio de 1997"
21,6,115,1274,233,313,546,"6 de julio de 1997"
21,6,115,1275,79,96,175,"6 de julio de 1997"
21,6,115,1276,433,514,947,"6 de julio de 1997"
21,6,115,1277,189,219,408,"6 de julio de 1997"
21,6,115,1278,343,398,741,"6 de julio de 1997"
21,6,115,1279,312,371,683,"6 de julio de 1997"
21,6,115,1280,272,331,603,"6 de julio de 1997"
21,6,115,1281,440,501,941,"6 de julio de 1997"
21,6,115,1282,357,476,833,"6 de julio de 1997"
21,6,115,1283,217,294,511,"6 de julio de 1997"
21,6,115,1284,151,180,331,"6 de julio de 1997"
21,6,115,1285,239,244,483,"6 de julio de 1997"
21,6,115,1286,355,407,762,"6 de julio de 1997"
21,6,115,1287,480,555,1035,"6 de julio de 1997"
21,6,115,1288,498,593,1091,"6 de julio de 1997"
21,6,115,1289,469,543,1012,"6 de julio de 1997"
21,6,115,1290,429,520,949,"6 de julio de 1997"
21,6,115,1291,600,677,1277,"6 de julio de 1997"
21,6,115,1292,679,827,1506,"6 de julio de 1997"
21,6,115,1293,483,521,1004,"6 de julio de 1997"
21,6,115,1294,408,468,876,"6 de julio de 1997"
21,6,115,1295,622,646,1268,"6 de julio de 1997"
21,6,115,1296,633,710,1343,"6 de julio de 1997"
21,6,115,1297,390,419,809,"6 de julio de 1997"
21,6,115,1298,257,257,514,"6 de julio de 1997"
21,6,115,1299,592,682,1274,"6 de julio de 1997"
21,6,115,1300,461,557,1018,"6 de julio de 1997"
21,6,115,1301,432,453,885,"6 de julio de 1997"
21,6,115,1302,289,444,733,"6 de julio de 1997"
21,6,115,1303,697,796,1493,"6 de julio de 1997"
21,6,115,1304,756,789,1545,"6 de julio de 1997"
21,6,115,1305,532,618,1150,"6 de julio de 1997"
21,6,115,1306,606,635,1241,"6 de julio de 1997"
21,6,115,1307,685,781,1466,"6 de julio de 1997"
21,6,115,1308,483,566,1049,"6 de julio de 1997"
21,6,115,1313,744,832,1576,"6 de julio de 1997"
21,6,115,1314,578,734,1312,"6 de julio de 1997"
21,6,115,1315,434,478,912,"6 de julio de 1997"
21,6,115,1316,479,544,1023,"6 de julio de 1997"
21,6,115,1317,392,404,796,"6 de julio de 1997"
21,6,115,1318,101,20,121,"6 de julio de 1997"
21,6,115,1319,622,792,1414,"6 de julio de 1997"
21,6,115,1320,799,972,1771,"6 de julio de 1997"
21,6,115,1321,540,604,1144,"6 de julio de 1997"
21,6,115,1322,624,651,1275,"6 de julio de 1997"
21,6,115,1323,573,650,1223,"6 de julio de 1997"
21,6,115,1324,545,592,1137,"6 de julio de 1997"
21,6,115,1325,480,503,983,"6 de julio de 1997"
21,6,115,1331,511,592,1103,"6 de julio de 1997"
21,6,115,1332,365,447,812,"6 de julio de 1997"
21,6,115,1333,441,494,935,"6 de julio de 1997"
21,6,115,1334,527,554,1081,"6 de julio de 1997"
21,6,115,1335,314,402,716,"6 de julio de 1997"
21,6,115,1336,198,222,420,"6 de julio de 1997"
21,6,115,1337,222,295,517,"6 de julio de 1997"
21,6,115,1338,632,713,1345,"6 de julio de 1997"
21,6,115,1339,721,843,1564,"6 de julio de 1997"
21,6,115,1340,696,748,1444,"6 de julio de 1997"
21,6,115,1341,432,449,881,"6 de julio de 1997"
21,6,115,1342,417,479,896,"6 de julio de 1997"
21,6,115,1343,164,222,386,"6 de julio de 1997"
21,6,115,1344,290,331,621,"6 de julio de 1997"
21,6,115,1345,574,647,1221,"6 de julio de 1997"
21,6,115,1346,588,590,1178,"6 de julio de 1997"
21,6,115,1347,656,686,1342,"6 de julio de 1997"
21,6,115,1353,543,609,1152,"6 de julio de 1997"
21,6,115,1354,545,584,1129,"6 de julio de 1997"
21,6,115,1355,768,908,1676,"6 de julio de 1997"
21,6,115,1356,534,640,1174,"6 de julio de 1997"
21,6,115,1357,548,603,1151,"6 de julio de 1997"
21,6,115,1358,692,805,1497,"6 de julio de 1997"
21,6,115,1359,747,823,1570,"6 de julio de 1997"
21,6,115,1360,484,583,1067,"6 de julio de 1997"
21,6,115,1361,696,862,1558,"6 de julio de 1997"
21,6,115,1362,469,533,1002,"6 de julio de 1997"
21,6,115,1370,727,845,1572,"6 de julio de 1997"
21,6,115,1371,542,616,1158,"6 de julio de 1997"
21,6,115,1372,634,731,1365,"6 de julio de 1997"
21,6,115,1373,468,534,1002,"6 de julio de 1997"
21,6,115,1374,780,914,1694,"6 de julio de 1997"
21,6,115,1375,728,787,1515,"6 de julio de 1997"
21,6,115,1376,728,814,1542,"6 de julio de 1997"
21,6,115,1382,713,767,1480,"6 de julio de 1997"
21,6,115,1383,391,473,864,"6 de julio de 1997"
21,6,115,1384,360,464,824,"6 de julio de 1997"
21,6,115,1385,393,454,847,"6 de julio de 1997"
21,6,115,1386,659,686,1345,"6 de julio de 1997"
21,6,115,1387,420,479,899,"6 de julio de 1997"
21,6,115,1388,460,561,1021,"6 de julio de 1997"
21,6,115,1389,632,703,1335,"6 de julio de 1997"
21,6,115,1396,778,866,1644,"6 de julio de 1997"
21,6,115,1397,959,1095,2054,"6 de julio de 1997"
21,6,115,1398,858,924,1782,"6 de julio de 1997"
21,6,115,1399,480,567,1047,"6 de julio de 1997"
21,6,115,1400,744,932,1676,"6 de julio de 1997"
21,6,115,1401,354,400,754,"6 de julio de 1997"
21,6,115,1402,495,580,1075,"6 de julio de 1997"
21,6,115,1403,453,537,990,"6 de julio de 1997"
21,6,115,1404,480,577,1057,"6 de julio de 1997"
21,6,115,1405,1460,1797,3257,"6 de julio de 1997"
21,6,115,1408,832,937,1769,"6 de julio de 1997"
21,6,115,1410,527,562,1089,"6 de julio de 1997"
21,6,115,1411,874,880,1754,"6 de julio de 1997"
21,6,115,1412,578,561,1139,"6 de julio de 1997"
21,6,115,1413,1396,1371,2767,"6 de julio de 1997"
21,6,115,1414,786,805,1591,"6 de julio de 1997"
21,6,115,1415,594,615,1209,"6 de julio de 1997"
21,6,115,1416,855,943,1798,"6 de julio de 1997"
21,6,115,1417,678,699,1377,"6 de julio de 1997"
21,6,115,1418,616,685,1301,"6 de julio de 1997"
21,6,115,1419,635,658,1293,"6 de julio de 1997"
21,6,115,1420,642,680,1322,"6 de julio de 1997"
21,6,115,1421,453,473,926,"6 de julio de 1997"
21,6,115,1422,491,503,994,"6 de julio de 1997"
21,6,115,1541,410,476,886,"6 de julio de 1997"
21,6,115,1542,435,501,936,"6 de julio de 1997"
21,6,115,1543,542,552,1094,"6 de julio de 1997"
21,6,115,1544,548,542,1090,"6 de julio de 1997"
21,6,115,1545,613,624,1237,"6 de julio de 1997"
21,6,115,1546,574,628,1202,"6 de julio de 1997"
21,6,115,1547,567,575,1142,"6 de julio de 1997"
21,6,115,1548,662,759,1421,"6 de julio de 1997"
21,6,115,1549,454,525,979,"6 de julio de 1997"
21,6,115,1550,704,822,1526,"6 de julio de 1997"
21,6,115,1551,659,743,1402,"6 de julio de 1997"
21,6,115,1568,553,589,1142,"6 de julio de 1997"
21,6,115,1569,693,808,1501,"6 de julio de 1997"
21,6,115,1570,601,612,1213,"6 de julio de 1997"
21,6,115,1571,514,564,1078,"6 de julio de 1997"
21,6,115,1572,705,745,1450,"6 de julio de 1997"
21,6,115,1573,691,729,1420,"6 de julio de 1997"
21,6,115,1574,835,827,1662,"6 de julio de 1997"
21,6,115,1575,892,917,1809,"6 de julio de 1997"
21,6,115,1576,569,630,1199,"6 de julio de 1997"
21,6,115,1577,422,502,924,"6 de julio de 1997"
21,6,115,1578,757,832,1589,"6 de julio de 1997"
21,6,115,1579,590,676,1266,"6 de julio de 1997"
21,6,115,1580,517,569,1086,"6 de julio de 1997"
21,6,115,1581,450,473,923,"6 de julio de 1997"
21,6,115,1582,509,556,1065,"6 de julio de 1997"
21,6,115,1583,603,683,1286,"6 de julio de 1997"
21,6,115,1584,704,713,1417,"6 de julio de 1997"
21,6,115,1585,541,625,1166,"6 de julio de 1997"
21,6,115,1586,506,567,1073,"6 de julio de 1997"
21,6,115,1587,773,878,1651,"6 de julio de 1997"
21,6,115,1588,906,944,1850,"6 de julio de 1997"
21,6,115,1589,809,946,1755,"6 de julio de 1997"
21,6,115,1594,632,698,1330,"6 de julio de 1997"
21,6,115,1595,655,721,1376,"6 de julio de 1997"
21,6,115,1596,1202,1344,2546,"6 de julio de 1997"
21,6,115,1597,328,355,683,"6 de julio de 1997"
21,6,115,1598,254,264,518,"6 de julio de 1997"
21,6,115,1601,308,342,650,"6 de julio de 1997"
21,7,1,1,537,564,1101,"6 de julio de 1997"
21,7,1,2,562,571,1133,"6 de julio de 1997"
21,7,1,3,456,483,939,"6 de julio de 1997"
21,7,1,4,581,601,1182,"6 de julio de 1997"
21,7,1,5,686,709,1395,"6 de julio de 1997"
21,7,1,6,477,470,947,"6 de julio de 1997"
21,7,1,7,604,605,1209,"6 de julio de 1997"
21,7,1,8,548,607,1155,"6 de julio de 1997"
21,7,1,9,493,470,963,"6 de julio de 1997"
21,7,1,10,672,778,1450,"6 de julio de 1997"
21,7,1,11,600,709,1309,"6 de julio de 1997"
21,7,1,12,450,552,1002,"6 de julio de 1997"
21,7,1,13,388,479,867,"6 de julio de 1997"
21,7,1,14,495,513,1008,"6 de julio de 1997"
21,7,1,15,772,891,1663,"6 de julio de 1997"
21,7,1,16,787,936,1723,"6 de julio de 1997"
21,7,1,17,756,923,1679,"6 de julio de 1997"
21,7,1,18,611,713,1324,"6 de julio de 1997"
21,7,1,19,423,553,976,"6 de julio de 1997"
21,7,4,45,665,681,1346,"6 de julio de 1997"
21,7,4,46,879,751,1630,"6 de julio de 1997"
21,7,4,47,577,605,1182,"6 de julio de 1997"
21,7,4,48,353,333,686,"6 de julio de 1997"
21,7,4,49,530,585,1115,"6 de julio de 1997"
21,7,4,50,553,497,1050,"6 de julio de 1997"
21,7,4,51,528,550,1078,"6 de julio de 1997"
21,7,4,52,640,698,1338,"6 de julio de 1997"
21,7,4,53,465,439,904,"6 de julio de 1997"
21,7,4,54,283,263,546,"6 de julio de 1997"
21,7,4,55,472,503,975,"6 de julio de 1997"
21,7,4,56,141,130,271,"6 de julio de 1997"
21,7,4,57,662,603,1265,"6 de julio de 1997"
21,7,4,58,525,447,972,"6 de julio de 1997"
21,7,4,59,501,441,942,"6 de julio de 1997"
21,7,4,60,501,490,991,"6 de julio de 1997"
21,7,15,116,818,819,1637,"6 de julio de 1997"
21,7,15,117,499,522,1021,"6 de julio de 1997"
21,7,15,118,583,599,1182,"6 de julio de 1997"
21,7,15,119,557,596,1153,"6 de julio de 1997"
21,7,15,120,537,515,1052,"6 de julio de 1997"
21,7,15,121,530,531,1061,"6 de julio de 1997"
21,7,15,122,670,658,1328,"6 de julio de 1997"
21,7,15,123,384,409,793,"6 de julio de 1997"
21,7,15,124,425,480,905,"6 de julio de 1997"
21,7,15,125,608,658,1266,"6 de julio de 1997"
21,7,15,126,506,550,1056,"6 de julio de 1997"
21,7,15,127,828,880,1708,"6 de julio de 1997"
21,7,15,128,404,472,876,"6 de julio de 1997"
21,7,15,129,950,1025,1975,"6 de julio de 1997"
21,7,15,130,484,477,961,"6 de julio de 1997"
21,7,15,131,668,673,1341,"6 de julio de 1997"
21,7,15,132,642,631,1273,"6 de julio de 1997"
21,7,15,133,335,318,653,"6 de julio de 1997"
21,7,39,317,763,772,1535,"6 de julio de 1997"
21,7,39,318,568,561,1129,"6 de julio de 1997"
21,7,41,323,718,696,1414,"6 de julio de 1997"
21,7,41,324,704,708,1412,"6 de julio de 1997"
21,7,66,544,608,637,1245,"6 de julio de 1997"
21,7,66,545,515,557,1072,"6 de julio de 1997"
21,7,66,546,338,404,742,"6 de julio de 1997"
21,7,66,547,590,660,1250,"6 de julio de 1997"
21,7,66,548,481,551,1032,"6 de julio de 1997"
21,7,66,549,462,504,966,"6 de julio de 1997"
21,7,66,550,657,676,1333,"6 de julio de 1997"
21,7,98,821,223,226,449,"6 de julio de 1997"
21,7,98,822,356,382,738,"6 de julio de 1997"
21,7,99,823,293,352,645,"6 de julio de 1997"
21,7,99,824,138,175,313,"6 de julio de 1997"
21,7,119,1643,402,391,793,"6 de julio de 1997"
21,7,119,1644,529,523,1052,"6 de julio de 1997"
21,7,119,1645,516,507,1023,"6 de julio de 1997"
21,7,119,1646,595,558,1153,"6 de julio de 1997"
21,7,119,1647,162,158,320,"6 de julio de 1997"
21,7,119,1648,650,588,1238,"6 de julio de 1997"
21,7,119,1649,593,557,1150,"6 de julio de 1997"
21,7,119,1650,737,777,1514,"6 de julio de 1997"
21,7,145,1868,533,468,1001,"6 de julio de 1997"
21,7,145,1869,505,470,975,"6 de julio de 1997"
21,7,145,1870,573,546,1119,"6 de julio de 1997"
21,7,145,1871,468,415,883,"6 de julio de 1997"
21,7,150,1888,440,481,921,"6 de julio de 1997"
21,7,150,1889,538,582,1120,"6 de julio de 1997"
21,7,150,1890,555,612,1167,"6 de julio de 1997"
21,7,151,1891,231,237,468,"6 de julio de 1997"
21,7,151,1892,747,788,1535,"6 de julio de 1997"
21,7,151,1893,405,435,840,"6 de julio de 1997"
21,7,151,1894,479,459,938,"6 de julio de 1997"
21,7,151,1895,437,401,838,"6 de julio de 1997"
21,7,151,1896,501,441,942,"6 de julio de 1997"
21,7,152,1897,621,638,1259,"6 de julio de 1997"
21,7,152,1898,647,662,1309,"6 de julio de 1997"
21,7,152,1899,253,222,475,"6 de julio de 1997"
21,7,152,1900,306,332,638,"6 de julio de 1997"
21,7,152,1901,464,451,915,"6 de julio de 1997"
21,7,152,1902,334,381,715,"6 de julio de 1997"
21,7,152,1903,532,489,1021,"6 de julio de 1997"
21,7,152,1904,383,403,786,"6 de julio de 1997"
21,7,152,1905,482,511,993,"6 de julio de 1997"
21,7,162,2051,504,591,1095,"6 de julio de 1997"
21,7,162,2052,392,485,877,"6 de julio de 1997"
21,7,162,2053,431,529,960,"6 de julio de 1997"
21,7,162,2054,474,600,1074,"6 de julio de 1997"
21,7,162,2055,615,730,1345,"6 de julio de 1997"
21,7,162,2056,360,441,801,"6 de julio de 1997"
21,7,162,2057,312,372,684,"6 de julio de 1997"
21,7,163,2058,272,301,573,"6 de julio de 1997"
21,7,163,2059,786,787,1573,"6 de julio de 1997"
21,7,163,2060,543,629,1172,"6 de julio de 1997"
21,7,163,2061,440,532,972,"6 de julio de 1997"
21,7,163,2062,668,700,1368,"6 de julio de 1997"
21,7,163,2063,492,503,995,"6 de julio de 1997"
21,7,163,2064,675,756,1431,"6 de julio de 1997"
21,7,163,2065,672,728,1400,"6 de julio de 1997"
21,7,163,2066,747,798,1545,"6 de julio de 1997"
21,7,163,2067,495,529,1024,"6 de julio de 1997"
21,7,163,2068,709,649,1358,"6 de julio de 1997"
21,7,163,2069,438,457,895,"6 de julio de 1997"
21,7,163,2070,530,663,1193,"6 de julio de 1997"
21,7,163,2071,465,399,864,"6 de julio de 1997"
21,7,163,2072,662,755,1417,"6 de julio de 1997"
21,7,163,2073,545,613,1158,"6 de julio de 1997"
21,7,163,2074,537,595,1132,"6 de julio de 1997"
21,7,163,2075,755,756,1511,"6 de julio de 1997"
21,7,163,2076,562,604,1166,"6 de julio de 1997"
21,7,163,2077,522,574,1096,"6 de julio de 1997"
21,7,163,2078,398,475,873,"6 de julio de 1997"
21,7,163,2079,342,324,666,"6 de julio de 1997"
21,7,163,2080,684,654,1338,"6 de julio de 1997"
21,7,163,2081,581,556,1137,"6 de julio de 1997"
21,7,182,2251,421,449,870,"6 de julio de 1997"
21,7,182,2252,367,435,802,"6 de julio de 1997"
21,7,189,2310,782,826,1608,"6 de julio de 1997"
21,7,189,2311,663,689,1352,"6 de julio de 1997"
21,7,189,2312,549,536,1085,"6 de julio de 1997"
21,7,189,2313,502,546,1048,"6 de julio de 1997"
21,7,189,2314,462,457,919,"6 de julio de 1997"
21,7,189,2315,359,349,708,"6 de julio de 1997"
21,7,189,2316,430,385,815,"6 de julio de 1997"
21,8,12,103,410,440,850,"6 de julio de 1997"
21,8,12,104,547,642,1189,"6 de julio de 1997"
21,8,12,105,465,494,959,"6 de julio de 1997"
21,8,12,106,302,313,615,"6 de julio de 1997"
21,8,23,234,484,495,979,"6 de julio de 1997"
21,8,23,235,371,332,703,"6 de julio de 1997"
21,8,23,236,193,203,396,"6 de julio de 1997"
21,8,23,237,464,397,861,"6 de julio de 1997"
21,8,23,238,259,259,518,"6 de julio de 1997"
21,8,29,262,433,488,921,"6 de julio de 1997"
21,8,29,263,357,394,751,"6 de julio de 1997"
21,8,29,264,409,333,742,"6 de julio de 1997"
21,8,29,265,734,637,1371,"6 de julio de 1997"
21,8,29,266,146,129,275,"6 de julio de 1997"
21,8,29,267,279,275,554,"6 de julio de 1997"
21,8,29,268,393,362,755,"6 de julio de 1997"
21,8,29,269,136,141,277,"6 de julio de 1997"
21,8,29,270,703,644,1347,"6 de julio de 1997"
21,8,46,371,576,588,1164,"6 de julio de 1997"
21,8,46,372,533,546,1079,"6 de julio de 1997"
21,8,46,373,579,637,1216,"6 de julio de 1997"
21,8,46,374,670,793,1463,"6 de julio de 1997"
21,8,46,375,633,725,1358,"6 de julio de 1997"
21,8,46,376,368,443,811,"6 de julio de 1997"
21,8,46,377,397,456,853,"6 de julio de 1997"
21,8,46,378,361,415,776,"6 de julio de 1997"
21,8,46,379,620,661,1281,"6 de julio de 1997"
21,8,46,380,592,709,1301,"6 de julio de 1997"
21,8,46,381,452,462,914,"6 de julio de 1997"
21,8,46,382,350,319,669,"6 de julio de 1997"
21,8,46,383,156,166,322,"6 de julio de 1997"
21,8,46,384,212,196,408,"6 de julio de 1997"
21,8,46,385,341,324,665,"6 de julio de 1997"
21,8,46,386,657,695,1352,"6 de julio de 1997"
21,8,46,387,166,175,341,"6 de julio de 1997"
21,8,46,388,395,408,803,"6 de julio de 1997"
21,8,46,389,355,342,697,"6 de julio de 1997"
21,8,46,390,499,471,970,"6 de julio de 1997"
21,8,46,391,443,418,861,"6 de julio de 1997"
21,8,46,392,210,177,387,"6 de julio de 1997"
21,8,46,393,310,292,602,"6 de julio de 1997"
21,8,46,394,77,63,140,"6 de julio de 1997"
21,8,47,395,628,760,1388,"6 de julio de 1997"
21,8,47,396,317,341,658,"6 de julio de 1997"
21,8,47,397,161,143,304,"6 de julio de 1997"
21,8,64,526,488,502,990,"6 de julio de 1997"
21,8,64,527,329,360,689,"6 de julio de 1997"
21,8,64,528,398,421,819,"6 de julio de 1997"
21,8,64,529,540,535,1075,"6 de julio de 1997"
21,8,64,530,192,169,361,"6 de julio de 1997"
21,8,64,531,551,486,1037,"6 de julio de 1997"
21,8,64,532,332,314,646,"6 de julio de 1997"
21,8,64,533,115,102,217,"6 de julio de 1997"
21,8,64,534,137,128,265,"6 de julio de 1997"
21,8,104,842,157,131,288,"6 de julio de 1997"
21,8,104,843,254,196,450,"6 de julio de 1997"
21,8,104,844,552,542,1094,"6 de julio de 1997"
21,8,104,845,84,101,185,"6 de julio de 1997"
21,8,111,897,403,452,855,"6 de julio de 1997"
21,8,111,898,282,266,548,"6 de julio de 1997"
21,8,111,899,466,446,912,"6 de julio de 1997"
21,8,111,900,513,457,970,"6 de julio de 1997"
21,8,111,901,577,462,1039,"6 de julio de 1997"
21,8,111,902,402,375,777,"6 de julio de 1997"
21,8,111,903,339,315,654,"6 de julio de 1997"
21,8,111,904,651,584,1235,"6 de julio de 1997"
21,8,111,905,558,493,1051,"6 de julio de 1997"
21,8,111,906,172,158,330,"6 de julio de 1997"
21,8,111,907,516,483,999,"6 de julio de 1997"
21,8,111,908,254,299,553,"6 de julio de 1997"
21,8,111,909,353,373,726,"6 de julio de 1997"
21,8,111,910,425,462,887,"6 de julio de 1997"
21,8,111,911,273,302,575,"6 de julio de 1997"
21,8,116,1610,560,572,1132,"6 de julio de 1997"
21,8,116,1611,440,485,925,"6 de julio de 1997"
21,8,116,1612,369,368,737,"6 de julio de 1997"
21,8,116,1613,565,593,1158,"6 de julio de 1997"
21,8,116,1614,449,487,936,"6 de julio de 1997"
21,8,116,1615,484,553,1037,"6 de julio de 1997"
21,8,116,1616,649,666,1315,"6 de julio de 1997"
21,8,116,1617,704,728,1432,"6 de julio de 1997"
21,8,116,1618,319,327,646,"6 de julio de 1997"
21,8,116,1619,827,848,1675,"6 de julio de 1997"
21,8,116,1620,311,289,600,"6 de julio de 1997"
21,8,116,1621,391,402,793,"6 de julio de 1997"
21,8,116,1622,508,527,1035,"6 de julio de 1997"
21,8,116,1623,524,537,1061,"6 de julio de 1997"
21,8,116,1624,197,181,378,"6 de julio de 1997"
21,8,116,1625,339,354,693,"6 de julio de 1997"
21,8,131,1715,241,278,519,"6 de julio de 1997"
21,8,131,1716,437,486,923,"6 de julio de 1997"
21,8,131,1717,186,184,370,"6 de julio de 1997"
21,8,131,1718,200,201,401,"6 de julio de 1997"
21,8,149,1882,537,550,1087,"6 de julio de 1997"
21,8,149,1883,503,578,1081,"6 de julio de 1997"
21,8,149,1884,750,849,1599,"6 de julio de 1997"
21,8,149,1885,553,627,1180,"6 de julio de 1997"
21,8,149,1886,106,94,200,"6 de julio de 1997"
21,8,149,1887,158,189,347,"6 de julio de 1997"
21,8,153,1906,514,522,1036,"6 de julio de 1997"
21,8,153,1907,520,559,1079,"6 de julio de 1997"
21,8,153,1908,548,630,1178,"6 de julio de 1997"
21,8,153,1909,503,595,1098,"6 de julio de 1997"
21,8,153,1910,781,854,1635,"6 de julio de 1997"
21,8,153,1911,776,856,1632,"6 de julio de 1997"
21,8,153,1912,786,796,1582,"6 de julio de 1997"
21,8,153,1913,565,584,1149,"6 de julio de 1997"
21,8,153,1914,518,545,1063,"6 de julio de 1997"
21,8,153,1915,396,402,798,"6 de julio de 1997"
21,8,153,1916,484,496,980,"6 de julio de 1997"
21,8,153,1917,373,388,761,"6 de julio de 1997"
21,8,153,1918,403,431,834,"6 de julio de 1997"
21,8,153,1919,734,792,1526,"6 de julio de 1997"
21,8,153,1920,719,682,1401,"6 de julio de 1997"
21,8,153,1921,359,326,685,"6 de julio de 1997"
21,8,153,1922,318,337,655,"6 de julio de 1997"
21,8,153,1923,210,199,409,"6 de julio de 1997"
21,8,153,1924,267,248,515,"6 de julio de 1997"
21,8,153,1925,834,829,1663,"6 de julio de 1997"
21,8,153,1926,727,665,1392,"6 de julio de 1997"
21,8,153,1927,470,470,940,"6 de julio de 1997"
21,8,153,1928,474,431,905,"6 de julio de 1997"
21,8,179,2219,571,595,1166,"6 de julio de 1997"
21,8,179,2220,454,454,908,"6 de julio de 1997"
21,8,179,2221,425,427,852,"6 de julio de 1997"
21,8,179,2222,358,361,719,"6 de julio de 1997"
21,8,179,2223,321,283,604,"6 de julio de 1997"
21,8,179,2224,656,656,1312,"6 de julio de 1997"
21,8,179,2225,433,414,847,"6 de julio de 1997"
21,8,179,2226,339,344,683,"6 de julio de 1997"
21,8,179,2227,522,495,1017,"6 de julio de 1997"
21,8,179,2228,616,604,1220,"6 de julio de 1997"
21,8,179,2229,427,352,779,"6 de julio de 1997"
21,8,179,2230,385,335,720,"6 de julio de 1997"
21,8,179,2231,465,461,926,"6 de julio de 1997"
21,8,179,2232,459,379,838,"6 de julio de 1997"
21,8,195,2349,451,485,936,"6 de julio de 1997"
21,8,195,2350,261,286,547,"6 de julio de 1997"
21,8,195,2351,436,361,797,"6 de julio de 1997"
21,8,195,2352,307,251,558,"6 de julio de 1997"
21,8,195,2353,384,409,793,"6 de julio de 1997"
21,8,195,2354,192,134,326,"6 de julio de 1997"
21,8,195,2355,710,678,1388,"6 de julio de 1997"
21,8,195,2356,372,354,726,"6 de julio de 1997"
21,8,195,2357,766,734,1500,"6 de julio de 1997"
21,8,195,2358,129,91,220,"6 de julio de 1997"
21,8,195,2359,525,599,1124,"6 de julio de 1997"
21,8,205,2420,547,581,1128,"6 de julio de 1997"
21,8,205,2421,569,531,1100,"6 de julio de 1997"
21,8,205,2422,240,220,460,"6 de julio de 1997"
21,8,205,2423,422,434,856,"6 de julio de 1997"
21,8,205,2424,402,418,820,"6 de julio de 1997"
21,8,205,2425,504,520,1024,"6 de julio de 1997"
21,8,205,2426,484,510,994,"6 de julio de 1997"
21,8,205,2427,105,118,223,"6 de julio de 1997"
21,8,205,2428,283,291,574,"6 de julio de 1997"
21,9,115,933,219,256,475,"6 de julio de 1997"
21,9,115,934,231,259,490,"6 de julio de 1997"
21,9,115,935,313,345,658,"6 de julio de 1997"
21,9,115,936,274,289,563,"6 de julio de 1997"
21,9,115,937,367,383,750,"6 de julio de 1997"
21,9,115,938,164,165,329,"6 de julio de 1997"
21,9,115,939,213,222,435,"6 de julio de 1997"
21,9,115,940,418,474,892,"6 de julio de 1997"
21,9,115,941,305,366,671,"6 de julio de 1997"
21,9,115,942,556,698,1254,"6 de julio de 1997"
21,9,115,943,482,563,1045,"6 de julio de 1997"
21,9,115,944,641,700,1341,"6 de julio de 1997"
21,9,115,945,451,525,976,"6 de julio de 1997"
21,9,115,946,343,401,744,"6 de julio de 1997"
21,9,115,947,525,593,1118,"6 de julio de 1997"
21,9,115,948,680,747,1427,"6 de julio de 1997"
21,9,115,949,364,419,783,"6 de julio de 1997"
21,9,115,950,295,310,605,"6 de julio de 1997"
21,9,115,951,512,571,1083,"6 de julio de 1997"
21,9,115,952,438,489,927,"6 de julio de 1997"
21,9,115,953,497,572,1069,"6 de julio de 1997"
21,9,115,954,422,477,899,"6 de julio de 1997"
21,9,115,955,371,417,788,"6 de julio de 1997"
21,9,115,956,387,464,851,"6 de julio de 1997"
21,9,115,957,348,446,794,"6 de julio de 1997"
21,9,115,958,538,613,1151,"6 de julio de 1997"
21,9,115,959,522,676,1198,"6 de julio de 1997"
21,9,115,960,405,500,905,"6 de julio de 1997"
21,9,115,961,646,749,1395,"6 de julio de 1997"
21,9,115,962,584,668,1252,"6 de julio de 1997"
21,9,115,963,409,491,900,"6 de julio de 1997"
21,9,115,964,315,381,696,"6 de julio de 1997"
21,9,115,965,321,362,683,"6 de julio de 1997"
21,9,115,966,170,208,378,"6 de julio de 1997"
21,9,115,967,251,307,558,"6 de julio de 1997"
21,9,115,968,352,397,749,"6 de julio de 1997"
21,9,115,969,231,260,491,"6 de julio de 1997"
21,9,115,970,391,475,866,"6 de julio de 1997"
21,9,115,971,278,309,587,"6 de julio de 1997"
21,9,115,972,466,474,940,"6 de julio de 1997"
21,9,115,973,654,703,1357,"6 de julio de 1997"
21,9,115,974,460,466,926,"6 de julio de 1997"
21,9,115,975,329,375,704,"6 de julio de 1997"
21,9,115,976,642,686,1328,"6 de julio de 1997"
21,9,115,977,751,853,1604,"6 de julio de 1997"
21,9,115,978,503,568,1071,"6 de julio de 1997"
21,9,115,979,433,504,937,"6 de julio de 1997"
21,9,115,980,537,590,1127,"6 de julio de 1997"
21,9,115,981,553,575,1128,"6 de julio de 1997"
21,9,115,982,588,684,1272,"6 de julio de 1997"
21,9,115,983,574,697,1271,"6 de julio de 1997"
21,9,115,984,447,496,943,"6 de julio de 1997"
21,9,115,985,354,444,798,"6 de julio de 1997"
21,9,115,986,440,561,1001,"6 de julio de 1997"
21,9,115,987,273,283,556,"6 de julio de 1997"
21,9,115,988,280,286,566,"6 de julio de 1997"
21,9,115,989,202,241,443,"6 de julio de 1997"
21,9,115,990,230,247,477,"6 de julio de 1997"
21,9,115,991,275,310,585,"6 de julio de 1997"
21,9,115,992,291,328,619,"6 de julio de 1997"
21,9,115,993,466,545,1011,"6 de julio de 1997"
21,9,115,994,314,331,645,"6 de julio de 1997"
21,9,115,995,368,490,858,"6 de julio de 1997"
21,9,115,996,553,672,1225,"6 de julio de 1997"
21,9,115,997,284,336,620,"6 de julio de 1997"
21,9,115,998,408,521,929,"6 de julio de 1997"
21,9,115,999,274,374,648,"6 de julio de 1997"
21,9,115,1000,537,704,1241,"6 de julio de 1997"
21,9,115,1001,396,432,828,"6 de julio de 1997"
21,9,115,1002,612,650,1262,"6 de julio de 1997"
21,9,115,1003,568,629,1197,"6 de julio de 1997"
21,9,115,1004,647,675,1322,"6 de julio de 1997"
21,9,115,1005,386,478,864,"6 de julio de 1997"
21,9,115,1006,405,451,856,"6 de julio de 1997"
21,9,115,1007,473,504,977,"6 de julio de 1997"
21,9,115,1008,721,760,1481,"6 de julio de 1997"
21,9,115,1009,438,519,957,"6 de julio de 1997"
21,9,115,1010,701,731,1432,"6 de julio de 1997"
21,9,115,1011,716,804,1520,"6 de julio de 1997"
21,9,115,1012,292,374,666,"6 de julio de 1997"
21,9,115,1013,563,725,1288,"6 de julio de 1997"
21,9,115,1014,309,387,696,"6 de julio de 1997"
21,9,115,1015,506,548,1054,"6 de julio de 1997"
21,9,115,1016,338,412,750,"6 de julio de 1997"
21,9,115,1017,369,452,821,"6 de julio de 1997"
21,9,115,1018,427,502,929,"6 de julio de 1997"
21,9,115,1019,401,481,882,"6 de julio de 1997"
21,9,115,1020,363,438,801,"6 de julio de 1997"
21,9,115,1021,286,365,651,"6 de julio de 1997"
21,9,115,1022,400,473,873,"6 de julio de 1997"
21,9,115,1023,368,454,822,"6 de julio de 1997"
21,9,115,1024,338,413,751,"6 de julio de 1997"
21,9,115,1025,634,682,1316,"6 de julio de 1997"
21,9,115,1026,531,589,1120,"6 de julio de 1997"
21,9,115,1027,483,442,925,"6 de julio de 1997"
21,9,115,1028,746,756,1502,"6 de julio de 1997"
21,9,115,1029,316,349,665,"6 de julio de 1997"
21,9,115,1030,498,520,1018,"6 de julio de 1997"
21,9,115,1031,623,687,1310,"6 de julio de 1997"
21,9,115,1032,522,618,1140,"6 de julio de 1997"
21,9,115,1033,524,515,1039,"6 de julio de 1997"
21,9,115,1034,762,876,1638,"6 de julio de 1997"
21,9,115,1035,845,981,1826,"6 de julio de 1997"
21,9,115,1036,741,825,1566,"6 de julio de 1997"
21,9,115,1037,417,476,893,"6 de julio de 1997"
21,9,115,1038,509,546,1055,"6 de julio de 1997"
21,9,115,1039,435,570,1005,"6 de julio de 1997"
21,9,115,1040,295,337,632,"6 de julio de 1997"
21,9,115,1041,473,552,1025,"6 de julio de 1997"
21,9,115,1042,481,554,1035,"6 de julio de 1997"
21,9,115,1043,549,589,1138,"6 de julio de 1997"
21,9,115,1044,546,612,1158,"6 de julio de 1997"
21,9,115,1045,510,577,1087,"6 de julio de 1997"
21,9,115,1046,237,242,479,"6 de julio de 1997"
21,9,115,1047,845,817,1662,"6 de julio de 1997"
21,9,115,1048,133,142,275,"6 de julio de 1997"
21,9,115,1049,666,722,1388,"6 de julio de 1997"
21,9,115,1050,690,754,1444,"6 de julio de 1997"
21,9,115,1051,722,814,1536,"6 de julio de 1997"
21,9,115,1052,516,544,1060,"6 de julio de 1997"
21,9,115,1053,429,500,929,"6 de julio de 1997"
21,9,115,1054,605,674,1279,"6 de julio de 1997"
21,9,115,1055,930,998,1928,"6 de julio de 1997"
21,9,115,1056,508,593,1101,"6 de julio de 1997"
21,9,115,1057,434,472,906,"6 de julio de 1997"
21,9,115,1058,711,855,1566,"6 de julio de 1997"
21,9,115,1059,589,592,1181,"6 de julio de 1997"
21,9,115,1060,562,623,1185,"6 de julio de 1997"
21,9,115,1061,471,581,1052,"6 de julio de 1997"
21,9,115,1062,797,811,1608,"6 de julio de 1997"
21,9,115,1063,586,635,1221,"6 de julio de 1997"
21,9,115,1064,604,632,1236,"6 de julio de 1997"
21,9,115,1065,1541,1822,3363,"6 de julio de 1997"
21,9,115,1066,246,208,454,"6 de julio de 1997"
21,9,115,1067,618,610,1228,"6 de julio de 1997"
21,9,115,1068,609,667,1276,"6 de julio de 1997"
21,9,115,1069,418,483,901,"6 de julio de 1997"
21,9,115,1070,711,798,1509,"6 de julio de 1997"
21,9,115,1071,450,491,941,"6 de julio de 1997"
21,9,115,1072,986,1039,2025,"6 de julio de 1997"
21,9,115,1073,475,493,968,"6 de julio de 1997"
21,9,115,1074,402,416,818,"6 de julio de 1997"
21,9,115,1075,228,214,442,"6 de julio de 1997"
21,9,115,1076,530,564,1094,"6 de julio de 1997"
21,9,115,1077,347,394,741,"6 de julio de 1997"
21,9,115,1078,344,382,726,"6 de julio de 1997"
21,9,115,1079,277,283,560,"6 de julio de 1997"
21,9,115,1309,481,577,1058,"6 de julio de 1997"
21,9,115,1310,512,589,1101,"6 de julio de 1997"
21,9,115,1311,431,481,912,"6 de julio de 1997"
21,9,115,1312,279,318,597,"6 de julio de 1997"
21,9,115,1326,436,446,882,"6 de julio de 1997"
21,9,115,1327,691,743,1434,"6 de julio de 1997"
21,9,115,1328,711,848,1559,"6 de julio de 1997"
21,9,115,1329,793,931,1724,"6 de julio de 1997"
21,9,115,1330,376,420,796,"6 de julio de 1997"
21,9,115,1348,626,699,1325,"6 de julio de 1997"
21,9,115,1349,463,493,956,"6 de julio de 1997"
21,9,115,1350,558,615,1173,"6 de julio de 1997"
21,9,115,1351,603,681,1284,"6 de julio de 1997"
21,9,115,1352,621,651,1272,"6 de julio de 1997"
21,9,115,1363,468,514,982,"6 de julio de 1997"
21,9,115,1364,422,455,877,"6 de julio de 1997"
21,9,115,1365,754,844,1598,"6 de julio de 1997"
21,9,115,1366,641,744,1385,"6 de julio de 1997"
21,9,115,1367,442,525,967,"6 de julio de 1997"
21,9,115,1368,292,291,583,"6 de julio de 1997"
21,9,115,1369,908,968,1876,"6 de julio de 1997"
21,9,115,1377,693,739,1432,"6 de julio de 1997"
21,9,115,1378,588,685,1273,"6 de julio de 1997"
21,9,115,1379,630,705,1335,"6 de julio de 1997"
21,9,115,1380,668,716,1384,"6 de julio de 1997"
21,9,115,1381,244,249,493,"6 de julio de 1997"
21,9,115,1390,919,1026,1945,"6 de julio de 1997"
21,9,115,1391,835,851,1686,"6 de julio de 1997"
21,9,115,1392,347,407,754,"6 de julio de 1997"
21,9,115,1393,455,556,1011,"6 de julio de 1997"
21,9,115,1394,411,434,845,"6 de julio de 1997"
21,9,115,1395,433,526,959,"6 de julio de 1997"
21,9,115,1406,451,573,1024,"6 de julio de 1997"
21,9,115,1407,928,999,1927,"6 de julio de 1997"
21,9,115,1409,467,501,968,"6 de julio de 1997"
21,10,19,154,583,638,1221,"6 de julio de 1997"
21,10,19,155,124,149,273,"6 de julio de 1997"
21,10,19,156,82,106,188,"6 de julio de 1997"
21,10,19,157,286,318,604,"6 de julio de 1997"
21,10,19,158,358,423,781,"6 de julio de 1997"
21,10,19,159,418,439,857,"6 de julio de 1997"
21,10,19,160,597,689,1286,"6 de julio de 1997"
21,10,19,161,440,545,985,"6 de julio de 1997"
21,10,19,162,525,630,1155,"6 de julio de 1997"
21,10,19,163,847,1023,1870,"6 de julio de 1997"
21,10,19,164,694,809,1503,"6 de julio de 1997"
21,10,19,165,636,743,1379,"6 de julio de 1997"
21,10,19,166,589,735,1324,"6 de julio de 1997"
21,10,19,167,486,611,1097,"6 de julio de 1997"
21,10,19,168,629,814,1443,"6 de julio de 1997"
21,10,19,169,443,555,998,"6 de julio de 1997"
21,10,19,170,431,536,967,"6 de julio de 1997"
21,10,19,171,208,280,488,"6 de julio de 1997"
21,10,19,172,89,105,194,"6 de julio de 1997"
21,10,19,173,353,391,744,"6 de julio de 1997"
21,10,19,174,601,742,1343,"6 de julio de 1997"
21,10,19,175,325,394,719,"6 de julio de 1997"
21,10,19,176,328,364,692,"6 de julio de 1997"
21,10,19,177,650,793,1443,"6 de julio de 1997"
21,10,19,178,507,662,1169,"6 de julio de 1997"
21,10,19,179,292,384,676,"6 de julio de 1997"
21,10,19,180,345,426,771,"6 de julio de 1997"
21,10,19,181,231,286,517,"6 de julio de 1997"
21,10,19,182,233,342,575,"6 de julio de 1997"
21,10,19,183,217,285,502,"6 de julio de 1997"
21,10,19,184,271,338,609,"6 de julio de 1997"
21,10,19,185,628,825,1453,"6 de julio de 1997"
21,10,19,186,675,757,1432,"6 de julio de 1997"
21,10,19,187,352,461,813,"6 de julio de 1997"
21,10,19,188,426,552,978,"6 de julio de 1997"
21,10,19,189,529,626,1155,"6 de julio de 1997"
21,10,19,190,392,492,884,"6 de julio de 1997"
21,10,19,191,419,544,963,"6 de julio de 1997"
21,10,19,192,367,457,824,"6 de julio de 1997"
21,10,19,193,611,741,1352,"6 de julio de 1997"
21,10,19,194,303,388,691,"6 de julio de 1997"
21,10,19,195,126,129,255,"6 de julio de 1997"
21,10,19,196,364,422,786,"6 de julio de 1997"
21,10,19,197,562,684,1246,"6 de julio de 1997"
21,10,19,198,451,588,1039,"6 de julio de 1997"
21,10,19,199,452,545,997,"6 de julio de 1997"
21,10,19,200,458,219,677,"6 de julio de 1997"
21,10,19,201,477,583,1060,"6 de julio de 1997"
21,10,19,202,365,440,805,"6 de julio de 1997"
21,10,19,203,297,381,678,"6 de julio de 1997"
21,10,19,204,327,476,803,"6 de julio de 1997"
21,10,19,205,375,543,918,"6 de julio de 1997"
21,10,19,206,368,477,845,"6 de julio de 1997"
21,10,19,207,499,606,1105,"6 de julio de 1997"
21,10,19,208,481,481,962,"6 de julio de 1997"
21,10,19,209,321,324,645,"6 de julio de 1997"
21,10,19,210,105,136,241,"6 de julio de 1997"
21,10,19,211,205,294,499,"6 de julio de 1997"
21,10,19,212,564,736,1300,"6 de julio de 1997"
21,10,19,213,343,513,856,"6 de julio de 1997"
21,10,19,214,457,469,926,"6 de julio de 1997"
21,10,19,215,530,608,1138,"6 de julio de 1997"
21,10,19,216,448,467,915,"6 de julio de 1997"
21,10,19,217,381,468,849,"6 de julio de 1997"
21,10,19,218,319,359,678,"6 de julio de 1997"
21,10,19,219,488,602,1090,"6 de julio de 1997"
21,10,19,220,157,208,365,"6 de julio de 1997"
21,10,19,221,260,286,546,"6 de julio de 1997"
21,10,22,225,247,275,522,"6 de julio de 1997"
21,10,22,226,447,474,921,"6 de julio de 1997"
21,10,22,227,357,369,726,"6 de julio de 1997"
21,10,22,228,316,384,700,"6 de julio de 1997"
21,10,22,229,265,336,601,"6 de julio de 1997"
21,10,22,230,242,248,490,"6 de julio de 1997"
21,10,22,231,160,149,309,"6 de julio de 1997"
21,10,22,232,296,291,587,"6 de julio de 1997"
21,10,22,233,193,184,377,"6 de julio de 1997"
21,10,103,838,447,491,938,"6 de julio de 1997"
21,10,103,839,377,427,804,"6 de julio de 1997"
21,10,103,840,462,501,963,"6 de julio de 1997"
21,10,103,841,635,713,1348,"6 de julio de 1997"
21,10,107,857,511,524,1035,"6 de julio de 1997"
21,10,107,858,460,442,902,"6 de julio de 1997"
21,10,107,859,650,662,1312,"6 de julio de 1997"
21,10,107,860,286,252,538,"6 de julio de 1997"
21,10,107,861,325,309,634,"6 de julio de 1997"
21,10,107,862,307,246,553,"6 de julio de 1997"
21,10,107,863,112,129,241,"6 de julio de 1997"
21,10,107,864,437,427,864,"6 de julio de 1997"
21,10,107,865,421,397,818,"6 de julio de 1997"
21,10,107,866,326,359,685,"6 de julio de 1997"
21,10,120,1651,586,616,1202,"6 de julio de 1997"
21,10,120,1652,758,831,1589,"6 de julio de 1997"
21,10,120,1653,518,493,1011,"6 de julio de 1997"
21,10,120,1654,597,602,1199,"6 de julio de 1997"
21,10,120,1655,463,477,940,"6 de julio de 1997"
21,10,120,1656,326,313,639,"6 de julio de 1997"
21,10,120,1657,567,517,1084,"6 de julio de 1997"
21,10,120,1658,487,472,959,"6 de julio de 1997"
21,10,120,1659,471,476,947,"6 de julio de 1997"
21,10,120,1660,738,782,1520,"6 de julio de 1997"
21,10,120,1661,493,476,969,"6 de julio de 1997"
21,10,120,1662,411,452,863,"6 de julio de 1997"
21,10,120,1663,857,930,1787,"6 de julio de 1997"
21,10,120,1664,567,608,1175,"6 de julio de 1997"
21,10,120,1665,503,562,1065,"6 de julio de 1997"
21,10,120,1666,396,431,827,"6 de julio de 1997"
21,10,120,1667,624,638,1262,"6 de julio de 1997"
21,10,120,1668,598,627,1225,"6 de julio de 1997"
21,10,120,1669,460,465,925,"6 de julio de 1997"
21,10,120,1670,444,467,911,"6 de julio de 1997"
21,10,120,1671,591,587,1178,"6 de julio de 1997"
21,10,126,1691,303,270,573,"6 de julio de 1997"
21,10,126,1692,513,488,1001,"6 de julio de 1997"
21,10,126,1693,566,573,1139,"6 de julio de 1997"
21,10,126,1694,403,436,839,"6 de julio de 1997"
21,10,127,1695,525,542,1067,"6 de julio de 1997"
21,10,127,1696,241,157,398,"6 de julio de 1997"
21,10,127,1697,315,295,610,"6 de julio de 1997"
21,10,141,1800,509,547,1056,"6 de julio de 1997"
21,10,141,1801,461,498,959,"6 de julio de 1997"
21,10,141,1802,476,501,977,"6 de julio de 1997"
21,10,141,1803,670,700,1370,"6 de julio de 1997"
21,10,141,1804,631,690,1321,"6 de julio de 1997"
21,10,141,1805,634,703,1337,"6 de julio de 1997"
21,10,141,1806,280,314,594,"6 de julio de 1997"
21,10,141,1807,665,667,1332,"6 de julio de 1997"
21,10,141,1808,391,442,833,"6 de julio de 1997"
21,10,141,1809,402,450,852,"6 de julio de 1997"
21,10,141,1810,409,467,876,"6 de julio de 1997"
21,10,141,1811,506,584,1090,"6 de julio de 1997"
21,10,141,1812,541,543,1084,"6 de julio de 1997"
21,10,141,1813,407,427,834,"6 de julio de 1997"
21,10,141,1814,269,315,584,"6 de julio de 1997"
21,10,141,1815,731,845,1576,"6 de julio de 1997"
21,10,141,1816,665,783,1448,"6 de julio de 1997"
21,10,141,1817,439,451,890,"6 de julio de 1997"
21,10,141,1818,619,642,1261,"6 de julio de 1997"
21,10,141,1819,425,441,866,"6 de julio de 1997"
21,10,141,1820,717,765,1482,"6 de julio de 1997"
21,10,141,1821,672,665,1337,"6 de julio de 1997"
21,10,141,1822,465,456,921,"6 de julio de 1997"
21,10,141,1823,379,347,726,"6 de julio de 1997"
21,10,141,1824,874,977,1851,"6 de julio de 1997"
21,10,141,1825,376,374,750,"6 de julio de 1997"
21,10,141,1826,701,737,1438,"6 de julio de 1997"
21,10,141,1827,512,506,1018,"6 de julio de 1997"
21,10,141,1828,595,559,1154,"6 de julio de 1997"
21,10,141,1829,480,418,898,"6 de julio de 1997"
21,10,141,1830,690,674,1364,"6 de julio de 1997"
21,10,141,1831,400,455,855,"6 de julio de 1997"
21,10,141,1832,315,337,652,"6 de julio de 1997"
21,10,141,1833,400,427,827,"6 de julio de 1997"
21,10,141,1834,437,503,940,"6 de julio de 1997"
21,10,141,1835,310,361,671,"6 de julio de 1997"
21,10,141,1836,388,428,816,"6 de julio de 1997"
21,10,141,1837,458,466,924,"6 de julio de 1997"
21,10,141,1838,351,384,735,"6 de julio de 1997"
21,10,141,1839,696,709,1405,"6 de julio de 1997"
21,10,141,1840,737,763,1500,"6 de julio de 1997"
21,10,141,1841,439,477,916,"6 de julio de 1997"
21,10,141,1842,441,488,929,"6 de julio de 1997"
21,10,141,1843,549,591,1140,"6 de julio de 1997"
21,10,141,1844,424,445,869,"6 de julio de 1997"
21,10,141,1845,446,490,936,"6 de julio de 1997"
21,10,148,1877,435,495,930,"6 de julio de 1997"
21,10,148,1878,348,384,732,"6 de julio de 1997"
21,10,148,1879,123,130,253,"6 de julio de 1997"
21,10,148,1880,459,533,992,"6 de julio de 1997"
21,10,148,1881,471,472,943,"6 de julio de 1997"
21,10,174,2175,253,248,501,"6 de julio de 1997"
21,10,174,2176,515,586,1101,"6 de julio de 1997"
21,10,174,2177,397,395,792,"6 de julio de 1997"
21,10,174,2178,305,367,672,"6 de julio de 1997"
21,10,174,2179,236,260,496,"6 de julio de 1997"
21,10,174,2180,273,294,567,"6 de julio de 1997"
21,10,188,2299,356,400,756,"6 de julio de 1997"
21,10,188,2300,535,671,1206,"6 de julio de 1997"
21,10,188,2301,527,638,1165,"6 de julio de 1997"
21,10,188,2302,236,236,472,"6 de julio de 1997"
21,10,188,2303,302,307,609,"6 de julio de 1997"
21,10,188,2304,187,225,412,"6 de julio de 1997"
21,10,188,2305,304,327,631,"6 de julio de 1997"
21,10,188,2306,562,563,1125,"6 de julio de 1997"
21,10,188,2307,182,189,371,"6 de julio de 1997"
21,10,188,2308,206,189,395,"6 de julio de 1997"
21,10,188,2309,283,320,603,"6 de julio de 1997"
21,11,115,1082,150,208,358,"6 de julio de 1997"
21,11,115,1083,126,147,273,"6 de julio de 1997"
21,11,115,1084,225,259,484,"6 de julio de 1997"
21,11,115,1085,244,328,572,"6 de julio de 1997"
21,11,115,1086,486,685,1171,"6 de julio de 1997"
21,11,115,1087,333,430,763,"6 de julio de 1997"
21,11,115,1088,461,601,1062,"6 de julio de 1997"
21,11,115,1089,489,629,1118,"6 de julio de 1997"
21,11,115,1090,474,583,1057,"6 de julio de 1997"
21,11,115,1091,744,875,1619,"6 de julio de 1997"
21,11,115,1092,635,762,1397,"6 de julio de 1997"
21,11,115,1093,561,605,1166,"6 de julio de 1997"
21,11,115,1094,500,568,1068,"6 de julio de 1997"
21,11,115,1095,278,279,557,"6 de julio de 1997"
21,11,115,1096,600,627,1227,"6 de julio de 1997"
21,11,115,1097,503,583,1086,"6 de julio de 1997"
21,11,115,1098,362,406,768,"6 de julio de 1997"
21,11,115,1099,761,930,1691,"6 de julio de 1997"
21,11,115,1100,462,583,1045,"6 de julio de 1997"
21,11,115,1101,779,905,1684,"6 de julio de 1997"
21,11,115,1102,501,596,1097,"6 de julio de 1997"
21,11,115,1103,265,322,587,"6 de julio de 1997"
21,11,115,1104,255,323,578,"6 de julio de 1997"
21,11,115,1105,514,639,1153,"6 de julio de 1997"
21,11,115,1106,304,368,672,"6 de julio de 1997"
21,11,115,1107,253,248,501,"6 de julio de 1997"
21,11,115,1108,148,185,333,"6 de julio de 1997"
21,11,115,1113,200,218,418,"6 de julio de 1997"
21,11,115,1114,251,356,607,"6 de julio de 1997"
21,11,115,1115,236,281,517,"6 de julio de 1997"
21,11,115,1116,249,291,540,"6 de julio de 1997"
21,11,115,1117,342,427,769,"6 de julio de 1997"
21,11,115,1118,445,559,1004,"6 de julio de 1997"
21,11,115,1119,218,236,454,"6 de julio de 1997"
21,11,115,1120,520,614,1134,"6 de julio de 1997"
21,11,115,1121,569,708,1277,"6 de julio de 1997"
21,11,115,1122,392,452,844,"6 de julio de 1997"
21,11,115,1123,263,291,554,"6 de julio de 1997"
21,11,115,1124,586,633,1219,"6 de julio de 1997"
21,11,115,1125,437,527,964,"6 de julio de 1997"
21,11,115,1126,357,387,744,"6 de julio de 1997"
21,11,115,1127,895,959,1854,"6 de julio de 1997"
21,11,115,1128,906,958,1864,"6 de julio de 1997"
21,11,115,1129,454,521,975,"6 de julio de 1997"
21,11,115,1130,531,641,1172,"6 de julio de 1997"
21,11,115,1131,650,772,1422,"6 de julio de 1997"
21,11,115,1132,412,481,893,"6 de julio de 1997"
21,11,115,1133,497,600,1097,"6 de julio de 1997"
21,11,115,1134,562,667,1229,"6 de julio de 1997"
21,11,115,1135,420,531,951,"6 de julio de 1997"
21,11,115,1136,471,592,1063,"6 de julio de 1997"
21,11,115,1137,562,663,1225,"6 de julio de 1997"
21,11,115,1138,313,460,773,"6 de julio de 1997"
21,11,115,1139,257,349,606,"6 de julio de 1997"
21,11,115,1140,493,635,1128,"6 de julio de 1997"
21,11,115,1141,329,482,811,"6 de julio de 1997"
21,11,115,1143,283,383,666,"6 de julio de 1997"
21,11,115,1144,321,437,758,"6 de julio de 1997"
21,11,115,1145,358,454,812,"6 de julio de 1997"
21,11,115,1146,384,521,905,"6 de julio de 1997"
21,11,115,1147,394,601,995,"6 de julio de 1997"
21,11,115,1148,618,723,1341,"6 de julio de 1997"
21,11,115,1149,465,566,1031,"6 de julio de 1997"
21,11,115,1150,551,587,1138,"6 de julio de 1997"
21,11,115,1151,498,568,1066,"6 de julio de 1997"
21,11,115,1152,328,395,723,"6 de julio de 1997"
21,11,115,1153,574,642,1216,"6 de julio de 1997"
21,11,115,1154,691,746,1437,"6 de julio de 1997"
21,11,115,1155,447,531,978,"6 de julio de 1997"
21,11,115,1156,443,519,962,"6 de julio de 1997"
21,11,115,1157,531,608,1139,"6 de julio de 1997"
21,11,115,1158,456,601,1057,"6 de julio de 1997"
21,11,115,1159,533,592,1125,"6 de julio de 1997"
21,11,115,1160,373,482,855,"6 de julio de 1997"
21,11,115,1161,392,496,888,"6 de julio de 1997"
21,11,115,1162,447,523,970,"6 de julio de 1997"
21,11,115,1163,510,617,1127,"6 de julio de 1997"
21,11,115,1164,553,663,1216,"6 de julio de 1997"
21,11,115,1165,549,632,1181,"6 de julio de 1997"
21,11,115,1166,374,418,792,"6 de julio de 1997"
21,11,115,1167,411,498,909,"6 de julio de 1997"
21,11,115,1168,511,581,1092,"6 de julio de 1997"
21,11,115,1169,680,738,1418,"6 de julio de 1997"
21,11,115,1170,396,449,845,"6 de julio de 1997"
21,11,115,1171,481,619,1100,"6 de julio de 1997"
21,11,115,1172,532,634,1166,"6 de julio de 1997"
21,11,115,1173,566,640,1206,"6 de julio de 1997"
21,11,115,1174,503,615,1118,"6 de julio de 1997"
21,11,115,1175,598,657,1255,"6 de julio de 1997"
21,11,115,1176,744,871,1615,"6 de julio de 1997"
21,11,115,1177,544,628,1172,"6 de julio de 1997"
21,11,115,1178,672,705,1377,"6 de julio de 1997"
21,11,115,1179,526,640,1166,"6 de julio de 1997"
21,11,115,1180,408,479,887,"6 de julio de 1997"
21,11,115,1182,656,783,1439,"6 de julio de 1997"
21,11,115,1183,371,436,807,"6 de julio de 1997"
21,11,115,1184,357,405,762,"6 de julio de 1997"
21,11,115,1185,543,608,1151,"6 de julio de 1997"
21,11,115,1186,597,711,1308,"6 de julio de 1997"
21,11,115,1187,637,779,1416,"6 de julio de 1997"
21,11,115,1188,714,865,1579,"6 de julio de 1997"
21,11,115,1189,447,560,1007,"6 de julio de 1997"
21,11,115,1190,708,894,1602,"6 de julio de 1997"
21,11,115,1191,629,660,1289,"6 de julio de 1997"
21,11,115,1192,640,762,1402,"6 de julio de 1997"
21,11,115,1193,716,861,1577,"6 de julio de 1997"
21,11,115,1194,831,939,1770,"6 de julio de 1997"
21,11,115,1195,715,802,1517,"6 de julio de 1997"
21,11,115,1196,791,905,1696,"6 de julio de 1997"
21,11,115,1201,733,871,1604,"6 de julio de 1997"
21,11,115,1202,515,570,1085,"6 de julio de 1997"
21,11,115,1203,489,563,1052,"6 de julio de 1997"
21,11,115,1204,952,1088,2040,"6 de julio de 1997"
21,11,115,1205,476,589,1065,"6 de julio de 1997"
21,11,115,1206,863,999,1862,"6 de julio de 1997"
21,11,115,1207,453,515,968,"6 de julio de 1997"
21,11,115,1208,424,476,900,"6 de julio de 1997"
21,11,115,1209,712,792,1504,"6 de julio de 1997"
21,11,115,1210,596,639,1235,"6 de julio de 1997"
21,11,115,1211,681,727,1408,"6 de julio de 1997"
21,11,115,1212,472,506,978,"6 de julio de 1997"
21,11,115,1215,546,586,1132,"6 de julio de 1997"
21,11,115,1216,643,696,1339,"6 de julio de 1997"
21,11,115,1217,827,908,1735,"6 de julio de 1997"
21,11,115,1218,574,702,1276,"6 de julio de 1997"
21,11,115,1219,935,993,1928,"6 de julio de 1997"
21,11,115,1220,579,678,1257,"6 de julio de 1997"
21,11,115,1221,830,913,1743,"6 de julio de 1997"
21,11,115,1222,527,607,1134,"6 de julio de 1997"
21,11,115,1223,252,254,506,"6 de julio de 1997"
21,11,115,1224,547,588,1135,"6 de julio de 1997"
21,11,115,1225,547,628,1175,"6 de julio de 1997"
21,11,115,1226,338,406,744,"6 de julio de 1997"
21,11,115,1227,418,516,934,"6 de julio de 1997"
21,11,115,1228,389,438,827,"6 de julio de 1997"
21,11,115,1229,413,475,888,"6 de julio de 1997"
21,11,115,1230,394,482,876,"6 de julio de 1997"
21,11,115,1231,325,376,701,"6 de julio de 1997"
21,11,115,1232,566,616,1182,"6 de julio de 1997"
21,11,115,1233,657,763,1420,"6 de julio de 1997"
21,11,115,1234,2699,3192,5891,"6 de julio de 1997"
21,11,115,1235,304,369,673,"6 de julio de 1997"
21,11,115,1236,285,347,632,"6 de julio de 1997"
21,11,115,1237,264,323,587,"6 de julio de 1997"
21,11,115,1238,1154,1370,2524,"6 de julio de 1997"
21,11,115,1239,305,387,692,"6 de julio de 1997"
21,11,115,1240,257,349,606,"6 de julio de 1997"
21,11,115,1241,205,246,451,"6 de julio de 1997"
21,11,115,1242,620,728,1348,"6 de julio de 1997"
21,11,115,1243,668,775,1443,"6 de julio de 1997"
21,11,115,1244,728,854,1582,"6 de julio de 1997"
21,11,115,1245,583,640,1223,"6 de julio de 1997"
21,11,115,1246,566,643,1209,"6 de julio de 1997"
21,11,115,1247,1547,1906,3453,"6 de julio de 1997"
21,11,115,1248,502,594,1096,"6 de julio de 1997"
21,11,115,1249,574,637,1211,"6 de julio de 1997"
21,11,115,1250,585,627,1212,"6 de julio de 1997"
21,11,115,1251,431,487,918,"6 de julio de 1997"
21,11,115,1252,327,352,679,"6 de julio de 1997"
21,11,115,1253,796,927,1723,"6 de julio de 1997"
21,11,115,1254,456,563,1019,"6 de julio de 1997"
21,11,115,1255,462,541,1003,"6 de julio de 1997"
21,11,115,1259,756,703,1459,"6 de julio de 1997"
21,12,115,1080,138,161,299,"6 de julio de 1997"
21,12,115,1081,207,247,454,"6 de julio de 1997"
21,12,115,1109,197,312,509,"6 de julio de 1997"
21,12,115,1110,179,258,437,"6 de julio de 1997"
21,12,115,1111,522,660,1182,"6 de julio de 1997"
21,12,115,1112,215,242,457,"6 de julio de 1997"
21,12,115,1142,608,792,1400,"6 de julio de 1997"
21,12,115,1181,486,541,1027,"6 de julio de 1997"
21,12,115,1197,495,530,1025,"6 de julio de 1997"
21,12,115,1198,508,537,1045,"6 de julio de 1997"
21,12,115,1199,466,503,969,"6 de julio de 1997"
21,12,115,1200,497,536,1033,"6 de julio de 1997"
21,12,115,1213,517,550,1067,"6 de julio de 1997"
21,12,115,1214,882,973,1855,"6 de julio de 1997"
21,12,115,1256,324,320,644,"6 de julio de 1997"
21,12,115,1257,400,391,791,"6 de julio de 1997"
21,12,115,1258,293,266,559,"6 de julio de 1997"
21,12,115,1260,603,599,1202,"6 de julio de 1997"
21,12,115,1423,198,164,362,"6 de julio de 1997"
21,12,115,1424,123,145,268,"6 de julio de 1997"
21,12,115,1425,233,275,508,"6 de julio de 1997"
21,12,115,1426,330,377,707,"6 de julio de 1997"
21,12,115,1427,363,408,771,"6 de julio de 1997"
21,12,115,1428,304,365,669,"6 de julio de 1997"
21,12,115,1429,252,287,539,"6 de julio de 1997"
21,12,115,1430,432,474,906,"6 de julio de 1997"
21,12,115,1431,355,444,799,"6 de julio de 1997"
21,12,115,1432,304,321,625,"6 de julio de 1997"
21,12,115,1433,593,671,1264,"6 de julio de 1997"
21,12,115,1434,615,737,1352,"6 de julio de 1997"
21,12,115,1435,383,569,952,"6 de julio de 1997"
21,12,115,1436,443,498,941,"6 de julio de 1997"
21,12,115,1437,529,707,1236,"6 de julio de 1997"
21,12,115,1438,461,594,1055,"6 de julio de 1997"
21,12,115,1439,305,340,645,"6 de julio de 1997"
21,12,115,1440,336,436,772,"6 de julio de 1997"
21,12,115,1441,476,562,1038,"6 de julio de 1997"
21,12,115,1442,385,479,864,"6 de julio de 1997"
21,12,115,1443,563,639,1202,"6 de julio de 1997"
21,12,115,1444,388,436,824,"6 de julio de 1997"
21,12,115,1445,340,438,778,"6 de julio de 1997"
21,12,115,1446,488,546,1034,"6 de julio de 1997"
21,12,115,1447,503,623,1126,"6 de julio de 1997"
21,12,115,1448,546,679,1225,"6 de julio de 1997"
21,12,115,1449,446,597,1043,"6 de julio de 1997"
21,12,115,1450,381,478,859,"6 de julio de 1997"
21,12,115,1451,317,368,685,"6 de julio de 1997"
21,12,115,1452,472,572,1044,"6 de julio de 1997"
21,12,115,1453,840,934,1774,"6 de julio de 1997"
21,12,115,1454,602,719,1321,"6 de julio de 1997"
21,12,115,1455,569,698,1267,"6 de julio de 1997"
21,12,115,1456,468,595,1063,"6 de julio de 1997"
21,12,115,1457,488,620,1108,"6 de julio de 1997"
21,12,115,1458,568,649,1217,"6 de julio de 1997"
21,12,115,1459,658,736,1394,"6 de julio de 1997"
21,12,115,1460,644,708,1352,"6 de julio de 1997"
21,12,115,1461,330,395,725,"6 de julio de 1997"
21,12,115,1462,413,503,916,"6 de julio de 1997"
21,12,115,1463,386,435,821,"6 de julio de 1997"
21,12,115,1464,502,632,1134,"6 de julio de 1997"
21,12,115,1465,547,675,1222,"6 de julio de 1997"
21,12,115,1466,507,599,1106,"6 de julio de 1997"
21,12,115,1467,542,645,1187,"6 de julio de 1997"
21,12,115,1468,486,522,1008,"6 de julio de 1997"
21,12,115,1469,484,547,1031,"6 de julio de 1997"
21,12,115,1470,456,563,1019,"6 de julio de 1997"
21,12,115,1471,694,746,1440,"6 de julio de 1997"
21,12,115,1472,600,723,1323,"6 de julio de 1997"
21,12,115,1473,769,829,1598,"6 de julio de 1997"
21,12,115,1474,563,605,1168,"6 de julio de 1997"
21,12,115,1475,488,554,1042,"6 de julio de 1997"
21,12,115,1476,478,468,946,"6 de julio de 1997"
21,12,115,1477,689,752,1441,"6 de julio de 1997"
21,12,115,1478,418,547,965,"6 de julio de 1997"
21,12,115,1479,428,517,945,"6 de julio de 1997"
21,12,115,1480,487,601,1088,"6 de julio de 1997"
21,12,115,1481,455,559,1014,"6 de julio de 1997"
21,12,115,1482,511,625,1136,"6 de julio de 1997"
21,12,115,1483,479,554,1033,"6 de julio de 1997"
21,12,115,1484,534,659,1193,"6 de julio de 1997"
21,12,115,1485,432,513,945,"6 de julio de 1997"
21,12,115,1486,442,499,941,"6 de julio de 1997"
21,12,115,1487,405,475,880,"6 de julio de 1997"
21,12,115,1488,485,579,1064,"6 de julio de 1997"
21,12,115,1489,529,628,1157,"6 de julio de 1997"
21,12,115,1490,489,566,1055,"6 de julio de 1997"
21,12,115,1491,715,842,1557,"6 de julio de 1997"
21,12,115,1492,1357,30,1387,"6 de julio de 1997"
21,12,115,1493,761,13,774,"6 de julio de 1997"
21,12,115,1494,546,641,1187,"6 de julio de 1997"
21,12,115,1495,311,347,658,"6 de julio de 1997"
21,12,115,1496,298,333,631,"6 de julio de 1997"
21,12,115,1497,367,459,826,"6 de julio de 1997"
21,12,115,1498,530,589,1119,"6 de julio de 1997"
21,12,115,1499,355,387,742,"6 de julio de 1997"
21,12,115,1500,559,648,1207,"6 de julio de 1997"
21,12,115,1501,728,844,1572,"6 de julio de 1997"
21,12,115,1502,498,613,1111,"6 de julio de 1997"
21,12,115,1503,481,576,1057,"6 de julio de 1997"
21,12,115,1504,366,439,805,"6 de julio de 1997"
21,12,115,1505,657,734,1391,"6 de julio de 1997"
21,12,115,1506,510,662,1172,"6 de julio de 1997"
21,12,115,1507,488,594,1082,"6 de julio de 1997"
21,12,115,1508,449,598,1047,"6 de julio de 1997"
21,12,115,1509,621,778,1399,"6 de julio de 1997"
21,12,115,1510,534,680,1214,"6 de julio de 1997"
21,12,115,1511,588,725,1313,"6 de julio de 1997"
21,12,115,1512,566,684,1250,"6 de julio de 1997"
21,12,115,1513,628,730,1358,"6 de julio de 1997"
21,12,115,1514,386,461,847,"6 de julio de 1997"
21,12,115,1515,254,311,565,"6 de julio de 1997"
21,12,115,1516,521,545,1066,"6 de julio de 1997"
21,12,115,1517,351,371,722,"6 de julio de 1997"
21,12,115,1518,503,561,1064,"6 de julio de 1997"
21,12,115,1519,449,496,945,"6 de julio de 1997"
21,12,115,1520,561,654,1215,"6 de julio de 1997"
21,12,115,1521,337,394,731,"6 de julio de 1997"
21,12,115,1522,639,672,1311,"6 de julio de 1997"
21,12,115,1523,435,517,952,"6 de julio de 1997"
21,12,115,1524,566,697,1263,"6 de julio de 1997"
21,12,115,1525,361,482,843,"6 de julio de 1997"
21,12,115,1526,396,467,863,"6 de julio de 1997"
21,12,115,1527,364,431,795,"6 de julio de 1997"
21,12,115,1528,356,381,737,"6 de julio de 1997"
21,12,115,1529,622,707,1329,"6 de julio de 1997"
21,12,115,1530,693,770,1463,"6 de julio de 1997"
21,12,115,1531,641,723,1364,"6 de julio de 1997"
21,12,115,1532,624,688,1312,"6 de julio de 1997"
21,12,115,1533,524,676,1200,"6 de julio de 1997"
21,12,115,1534,966,1088,2054,"6 de julio de 1997"
21,12,115,1535,477,515,992,"6 de julio de 1997"
21,12,115,1536,553,631,1184,"6 de julio de 1997"
21,12,115,1537,718,780,1498,"6 de julio de 1997"
21,12,115,1538,565,639,1204,"6 de julio de 1997"
21,12,115,1539,749,773,1522,"6 de julio de 1997"
21,12,115,1540,508,535,1043,"6 de julio de 1997"
21,12,115,1552,466,575,1041,"6 de julio de 1997"
21,12,115,1553,429,498,927,"6 de julio de 1997"
21,12,115,1554,396,468,864,"6 de julio de 1997"
21,12,115,1555,674,803,1477,"6 de julio de 1997"
21,12,115,1556,507,619,1126,"6 de julio de 1997"
21,12,115,1557,541,577,1118,"6 de julio de 1997"
21,12,115,1558,412,472,884,"6 de julio de 1997"
21,12,115,1559,326,414,740,"6 de julio de 1997"
21,12,115,1560,296,315,611,"6 de julio de 1997"
21,12,115,1561,430,465,895,"6 de julio de 1997"
21,12,115,1562,831,890,1721,"6 de julio de 1997"
21,12,115,1563,531,535,1066,"6 de julio de 1997"
21,12,115,1564,385,447,832,"6 de julio de 1997"
21,12,115,1565,612,640,1252,"6 de julio de 1997"
21,12,115,1566,516,595,1111,"6 de julio de 1997"
21,12,115,1567,626,749,1375,"6 de julio de 1997"
21,12,115,1590,639,657,1296,"6 de julio de 1997"
21,12,115,1591,206,267,473,"6 de julio de 1997"
21,12,115,1592,511,582,1093,"6 de julio de 1997"
21,12,115,1593,706,750,1456,"6 de julio de 1997"
21,12,115,1599,375,355,730,"6 de julio de 1997"
21,12,115,1600,161,176,337,"6 de julio de 1997"
21,12,115,1602,83,94,177,"6 de julio de 1997"
21,12,115,1603,645,636,1281,"6 de julio de 1997"
21,12,115,1604,613,598,1211,"6 de julio de 1997"
21,12,115,1605,606,682,1288,"6 de julio de 1997"
21,12,115,1606,776,837,1613,"6 de julio de 1997"
21,12,115,1607,494,574,1068,"6 de julio de 1997"
21,12,115,1608,392,412,804,"6 de julio de 1997"
21,12,115,1609,533,541,1074,"6 de julio de 1997"
21,13,3,28,510,676,1186,"6 de julio de 1997"
21,13,3,29,634,814,1448,"6 de julio de 1997"
21,13,3,30,519,656,1175,"6 de julio de 1997"
21,13,3,31,630,901,1531,"6 de julio de 1997"
21,13,3,32,550,642,1192,"6 de julio de 1997"
21,13,3,33,517,653,1170,"6 de julio de 1997"
21,13,3,34,641,763,1404,"6 de julio de 1997"
21,13,3,35,632,767,1399,"6 de julio de 1997"
21,13,3,36,316,331,647,"6 de julio de 1997"
21,13,3,37,553,692,1245,"6 de julio de 1997"
21,13,3,38,363,490,853,"6 de julio de 1997"
21,13,3,39,510,683,1193,"6 de julio de 1997"
21,13,3,40,479,637,1116,"6 de julio de 1997"
21,13,3,41,158,185,343,"6 de julio de 1997"
21,13,3,42,79,101,180,"6 de julio de 1997"
21,13,3,43,122,185,307,"6 de julio de 1997"
21,13,3,44,317,402,719,"6 de julio de 1997"
21,13,9,79,522,739,1261,"6 de julio de 1997"
21,13,18,148,236,236,472,"6 de julio de 1997"
21,13,18,149,86,67,153,"6 de julio de 1997"
21,13,18,150,85,78,163,"6 de julio de 1997"
21,13,18,151,111,128,239,"6 de julio de 1997"
21,13,18,152,137,126,263,"6 de julio de 1997"
21,13,18,153,90,101,191,"6 de julio de 1997"
21,13,20,222,513,537,1050,"6 de julio de 1997"
21,13,20,223,740,665,1405,"6 de julio de 1997"
21,13,24,239,181,208,389,"6 de julio de 1997"
21,13,24,240,117,166,283,"6 de julio de 1997"
21,13,38,314,324,384,708,"6 de julio de 1997"
21,13,38,315,118,114,232,"6 de julio de 1997"
21,13,38,316,179,205,384,"6 de julio de 1997"
21,13,43,340,395,445,840,"6 de julio de 1997"
21,13,43,341,228,298,526,"6 de julio de 1997"
21,13,43,342,183,183,366,"6 de julio de 1997"
21,13,43,343,123,134,257,"6 de julio de 1997"
21,13,53,459,176,209,385,"6 de julio de 1997"
21,13,53,460,149,176,325,"6 de julio de 1997"
21,13,56,496,472,522,994,"6 de julio de 1997"
21,13,56,497,331,376,707,"6 de julio de 1997"
21,13,56,498,276,333,609,"6 de julio de 1997"
21,13,56,499,84,81,165,"6 de julio de 1997"
21,13,60,512,343,444,787,"6 de julio de 1997"
21,13,60,513,106,141,247,"6 de julio de 1997"
21,13,60,514,79,122,201,"6 de julio de 1997"
21,13,67,551,499,640,1139,"6 de julio de 1997"
21,13,67,552,307,441,748,"6 de julio de 1997"
21,13,67,553,419,537,956,"6 de julio de 1997"
21,13,67,554,352,469,821,"6 de julio de 1997"
21,13,71,588,234,287,521,"6 de julio de 1997"
21,13,71,589,157,174,331,"6 de julio de 1997"
21,13,71,590,350,354,704,"6 de julio de 1997"
21,13,71,591,267,295,562,"6 de julio de 1997"
21,13,71,592,459,615,1074,"6 de julio de 1997"
21,13,71,593,85,52,137,"6 de julio de 1997"
21,13,75,646,355,400,755,"6 de julio de 1997"
21,13,75,647,461,489,950,"6 de julio de 1997"
21,13,75,648,408,376,784,"6 de julio de 1997"
21,13,75,649,165,182,347,"6 de julio de 1997"
21,13,75,650,122,144,266,"6 de julio de 1997"
21,13,81,701,402,421,823,"6 de julio de 1997"
21,13,81,702,390,440,830,"6 de julio de 1997"
21,13,81,703,306,318,624,"6 de julio de 1997"
21,13,84,709,707,775,1482,"6 de julio de 1997"
21,13,84,710,580,612,1192,"6 de julio de 1997"
21,13,84,711,275,238,513,"6 de julio de 1997"
21,13,94,797,193,186,379,"6 de julio de 1997"
21,13,94,798,222,204,426,"6 de julio de 1997"
21,13,94,799,225,243,468,"6 de julio de 1997"
21,13,94,800,435,388,823,"6 de julio de 1997"
21,13,97,820,117,123,240,"6 de julio de 1997"
21,13,100,825,393,486,879,"6 de julio de 1997"
21,13,100,826,384,469,853,"6 de julio de 1997"
21,13,100,827,223,261,484,"6 de julio de 1997"
21,13,100,828,136,121,257,"6 de julio de 1997"
21,13,100,829,243,252,495,"6 de julio de 1997"
21,13,113,922,457,494,951,"6 de julio de 1997"
21,13,113,923,289,379,668,"6 de julio de 1997"
21,13,113,924,301,296,597,"6 de julio de 1997"
21,13,113,925,360,424,784,"6 de julio de 1997"
21,13,113,926,282,361,643,"6 de julio de 1997"
21,13,113,927,342,325,667,"6 de julio de 1997"
21,13,114,928,544,650,1194,"6 de julio de 1997"
21,13,114,929,190,216,406,"6 de julio de 1997"
21,13,114,930,73,76,149,"6 de julio de 1997"
21,13,114,931,109,139,248,"6 de julio de 1997"
21,13,114,932,390,516,906,"6 de julio de 1997"
21,13,128,1698,282,338,620,"6 de julio de 1997"
21,13,128,1699,239,276,515,"6 de julio de 1997"
21,13,128,1700,201,248,449,"6 de julio de 1997"
21,13,128,1701,275,317,592,"6 de julio de 1997"
21,13,132,1719,176,164,340,"6 de julio de 1997"
21,13,136,1784,190,223,413,"6 de julio de 1997"
21,13,140,1798,675,741,1416,"6 de julio de 1997"
21,13,140,1799,220,260,480,"6 de julio de 1997"
21,13,142,1846,407,443,850,"6 de julio de 1997"
21,13,142,1847,449,531,980,"6 de julio de 1997"
21,13,146,1872,202,237,439,"6 de julio de 1997"
21,13,147,1873,405,482,887,"6 de julio de 1997"
21,13,147,1874,212,250,462,"6 de julio de 1997"
21,13,147,1875,356,434,790,"6 de julio de 1997"
21,13,147,1876,427,400,827,"6 de julio de 1997"
21,13,154,1929,318,443,761,"6 de julio de 1997"
21,13,154,1930,336,312,648,"6 de julio de 1997"
21,13,154,1931,266,378,644,"6 de julio de 1997"
21,13,154,1932,62,83,145,"6 de julio de 1997"
21,13,154,1933,350,442,792,"6 de julio de 1997"
21,13,156,2017,563,677,1240,"6 de julio de 1997"
21,13,156,2018,525,656,1181,"6 de julio de 1997"
21,13,156,2019,517,629,1146,"6 de julio de 1997"
21,13,156,2020,334,407,741,"6 de julio de 1997"
21,13,156,2021,307,389,696,"6 de julio de 1997"
21,13,156,2022,279,360,639,"6 de julio de 1997"
21,13,156,2023,417,530,947,"6 de julio de 1997"
21,13,156,2024,161,220,381,"6 de julio de 1997"
21,13,160,2042,521,637,1158,"6 de julio de 1997"
21,13,160,2043,325,389,714,"6 de julio de 1997"
21,13,160,2044,477,480,957,"6 de julio de 1997"
21,13,160,2045,381,412,793,"6 de julio de 1997"
21,13,160,2046,310,349,659,"6 de julio de 1997"
21,13,160,2047,583,549,1132,"6 de julio de 1997"
21,13,160,2048,401,433,834,"6 de julio de 1997"
21,13,168,2098,413,454,867,"6 de julio de 1997"
21,13,168,2099,604,625,1229,"6 de julio de 1997"
21,13,168,2100,122,96,218,"6 de julio de 1997"
21,13,168,2101,164,161,325,"6 de julio de 1997"
21,13,168,2102,328,358,686,"6 de julio de 1997"
21,13,168,2103,214,236,450,"6 de julio de 1997"
21,13,168,2104,479,536,1015,"6 de julio de 1997"
21,13,168,2105,297,316,613,"6 de julio de 1997"
21,13,168,2106,401,395,796,"6 de julio de 1997"
21,13,168,2107,420,448,868,"6 de julio de 1997"
21,13,168,2108,482,501,983,"6 de julio de 1997"
21,13,170,2116,680,681,1361,"6 de julio de 1997"
21,13,176,2184,442,542,984,"6 de julio de 1997"
21,13,176,2185,413,516,929,"6 de julio de 1997"
21,13,176,2186,271,294,565,"6 de julio de 1997"
21,13,176,2187,227,201,428,"6 de julio de 1997"
21,13,176,2188,681,635,1316,"6 de julio de 1997"
21,13,176,2189,669,595,1264,"6 de julio de 1997"
21,13,176,2190,688,672,1360,"6 de julio de 1997"
21,13,176,2191,514,540,1054,"6 de julio de 1997"
21,13,176,2192,325,380,705,"6 de julio de 1997"
21,13,176,2193,519,500,1019,"6 de julio de 1997"
21,13,176,2194,366,324,690,"6 de julio de 1997"
21,13,176,2195,355,350,705,"6 de julio de 1997"
21,13,176,2196,397,406,803,"6 de julio de 1997"
21,13,176,2197,385,398,783,"6 de julio de 1997"
21,13,176,2198,397,435,832,"6 de julio de 1997"
21,13,176,2199,704,714,1418,"6 de julio de 1997"
21,13,176,2200,374,383,757,"6 de julio de 1997"
21,13,190,2317,213,256,469,"6 de julio de 1997"
21,13,190,2318,75,60,135,"6 de julio de 1997"
21,13,191,2319,280,358,638,"6 de julio de 1997"
21,13,191,2320,283,390,673,"6 de julio de 1997"
21,13,191,2321,537,647,1184,"6 de julio de 1997"
21,13,191,2322,249,329,578,"6 de julio de 1997"
21,13,191,2323,177,246,423,"6 de julio de 1997"
21,13,191,2324,272,379,651,"6 de julio de 1997"
21,13,191,2325,129,180,309,"6 de julio de 1997"
21,13,193,2329,325,342,667,"6 de julio de 1997"
21,13,193,2330,366,312,678,"6 de julio de 1997"
21,13,193,2331,335,402,737,"6 de julio de 1997"
21,13,193,2332,356,297,653,"6 de julio de 1997"
21,13,196,2360,206,255,461,"6 de julio de 1997"
21,13,196,2361,190,232,422,"6 de julio de 1997"
21,13,203,2413,493,509,1002,"6 de julio de 1997"
21,13,203,2414,397,433,830,"6 de julio de 1997"
21,13,203,2415,81,83,164,"6 de julio de 1997"
21,13,206,2429,263,366,629,"6 de julio de 1997"
21,13,206,2430,150,197,347,"6 de julio de 1997"
21,13,206,2431,337,344,681,"6 de julio de 1997"
21,13,206,2432,153,139,292,"6 de julio de 1997"
21,14,5,61,395,421,816,"6 de julio de 1997"
21,14,5,62,283,282,565,"6 de julio de 1997"
21,14,5,63,196,189,385,"6 de julio de 1997"
21,14,7,71,197,198,395,"6 de julio de 1997"
21,14,7,72,173,202,375,"6 de julio de 1997"
21,14,7,73,187,284,471,"6 de julio de 1997"
21,14,7,74,183,188,371,"6 de julio de 1997"
21,14,11,102,332,514,846,"6 de julio de 1997"
21,14,21,224,324,328,652,"6 de julio de 1997"
21,14,32,274,228,279,507,"6 de julio de 1997"
21,14,32,275,366,473,839,"6 de julio de 1997"
21,14,32,276,120,136,256,"6 de julio de 1997"
21,14,33,277,311,368,679,"6 de julio de 1997"
21,14,33,278,130,139,269,"6 de julio de 1997"
21,14,34,279,449,424,873,"6 de julio de 1997"
21,14,34,280,424,443,867,"6 de julio de 1997"
21,14,34,281,195,187,382,"6 de julio de 1997"
21,14,48,398,590,719,1309,"6 de julio de 1997"
21,14,48,399,298,375,673,"6 de julio de 1997"
21,14,48,400,418,549,967,"6 de julio de 1997"
21,14,48,401,302,318,620,"6 de julio de 1997"
21,14,48,402,393,481,874,"6 de julio de 1997"
21,14,48,403,394,474,868,"6 de julio de 1997"
21,14,48,404,501,577,1078,"6 de julio de 1997"
21,14,48,405,398,422,820,"6 de julio de 1997"
21,14,48,406,242,285,527,"6 de julio de 1997"
21,14,48,407,93,114,207,"6 de julio de 1997"
21,14,48,408,222,227,449,"6 de julio de 1997"
21,14,48,409,96,110,206,"6 de julio de 1997"
21,14,48,410,72,67,139,"6 de julio de 1997"
21,14,48,411,34,37,71,"6 de julio de 1997"
21,14,48,412,380,380,760,"6 de julio de 1997"
21,14,48,413,62,75,137,"6 de julio de 1997"
21,14,48,414,97,93,190,"6 de julio de 1997"
21,14,52,439,478,581,1059,"6 de julio de 1997"
21,14,52,440,449,525,974,"6 de julio de 1997"
21,14,52,441,579,670,1249,"6 de julio de 1997"
21,14,52,442,339,328,667,"6 de julio de 1997"
21,14,52,443,326,388,714,"6 de julio de 1997"
21,14,52,444,565,697,1262,"6 de julio de 1997"
21,14,52,445,385,458,843,"6 de julio de 1997"
21,14,52,446,490,563,1053,"6 de julio de 1997"
21,14,52,447,654,787,1441,"6 de julio de 1997"
21,14,52,448,384,455,839,"6 de julio de 1997"
21,14,52,449,544,622,1166,"6 de julio de 1997"
21,14,52,450,679,795,1474,"6 de julio de 1997"
21,14,52,451,312,334,646,"6 de julio de 1997"
21,14,52,452,654,737,1391,"6 de julio de 1997"
21,14,52,453,499,618,1117,"6 de julio de 1997"
21,14,52,454,336,378,714,"6 de julio de 1997"
21,14,52,455,300,328,628,"6 de julio de 1997"
21,14,52,456,295,334,629,"6 de julio de 1997"
21,14,52,457,309,316,625,"6 de julio de 1997"
21,14,52,458,556,614,1170,"6 de julio de 1997"
21,14,57,500,267,353,620,"6 de julio de 1997"
21,14,57,501,145,200,345,"6 de julio de 1997"
21,14,63,524,500,671,1171,"6 de julio de 1997"
21,14,63,525,554,677,1231,"6 de julio de 1997"
21,14,70,569,439,534,973,"6 de julio de 1997"
21,14,70,570,263,317,580,"6 de julio de 1997"
21,14,70,571,218,313,531,"6 de julio de 1997"
21,14,70,572,236,309,545,"6 de julio de 1997"
21,14,70,573,224,308,532,"6 de julio de 1997"
21,14,70,574,432,504,936,"6 de julio de 1997"
21,14,70,575,347,387,734,"6 de julio de 1997"
21,14,70,576,392,457,849,"6 de julio de 1997"
21,14,70,577,222,275,497,"6 de julio de 1997"
21,14,70,578,364,487,851,"6 de julio de 1997"
21,14,70,579,445,466,911,"6 de julio de 1997"
21,14,70,580,334,358,692,"6 de julio de 1997"
21,14,70,581,170,224,394,"6 de julio de 1997"
21,14,70,582,388,411,799,"6 de julio de 1997"
21,14,70,583,297,371,668,"6 de julio de 1997"
21,14,70,584,168,246,414,"6 de julio de 1997"
21,14,70,585,458,551,1009,"6 de julio de 1997"
21,14,70,586,232,237,469,"6 de julio de 1997"
21,14,70,587,108,104,212,"6 de julio de 1997"
21,14,74,640,610,713,1323,"6 de julio de 1997"
21,14,74,641,596,722,1318,"6 de julio de 1997"
21,14,74,642,374,418,792,"6 de julio de 1997"
21,14,74,643,369,442,811,"6 de julio de 1997"
21,14,74,644,78,85,163,"6 de julio de 1997"
21,14,74,645,148,201,349,"6 de julio de 1997"
21,14,83,706,395,496,891,"6 de julio de 1997"
21,14,83,707,297,326,623,"6 de julio de 1997"
21,14,83,708,262,303,565,"6 de julio de 1997"
21,14,87,730,399,462,861,"6 de julio de 1997"
21,14,87,731,409,536,945,"6 de julio de 1997"
21,14,87,732,575,628,1203,"6 de julio de 1997"
21,14,87,733,454,574,1028,"6 de julio de 1997"
21,14,87,734,476,585,1061,"6 de julio de 1997"
21,14,87,735,561,669,1230,"6 de julio de 1997"
21,14,87,736,548,652,1200,"6 de julio de 1997"
21,14,87,737,570,668,1238,"6 de julio de 1997"
21,14,87,738,356,397,753,"6 de julio de 1997"
21,14,87,739,514,659,1173,"6 de julio de 1997"
21,14,87,740,613,698,1311,"6 de julio de 1997"
21,14,87,741,434,522,956,"6 de julio de 1997"
21,14,87,742,442,526,968,"6 de julio de 1997"
21,14,87,743,515,589,1104,"6 de julio de 1997"
21,14,87,744,433,518,951,"6 de julio de 1997"
21,14,87,745,668,782,1450,"6 de julio de 1997"
21,14,87,746,602,680,1282,"6 de julio de 1997"
21,14,87,747,306,420,726,"6 de julio de 1997"
21,14,87,748,444,529,973,"6 de julio de 1997"
21,14,87,749,520,565,1085,"6 de julio de 1997"
21,14,87,750,264,318,582,"6 de julio de 1997"
21,14,87,751,364,488,852,"6 de julio de 1997"
21,14,87,752,584,712,1296,"6 de julio de 1997"
21,14,87,753,586,741,1327,"6 de julio de 1997"
21,14,87,754,424,593,1017,"6 de julio de 1997"
21,14,87,755,353,465,818,"6 de julio de 1997"
21,14,87,756,400,519,919,"6 de julio de 1997"
21,14,87,757,301,408,709,"6 de julio de 1997"
21,14,87,758,670,876,1546,"6 de julio de 1997"
21,14,87,759,389,542,931,"6 de julio de 1997"
21,14,87,760,348,447,795,"6 de julio de 1997"
21,14,87,761,309,362,671,"6 de julio de 1997"
21,14,87,762,515,701,1216,"6 de julio de 1997"
21,14,87,763,380,456,836,"6 de julio de 1997"
21,14,89,770,741,796,1537,"6 de julio de 1997"
21,14,89,771,564,674,1238,"6 de julio de 1997"
21,14,89,772,373,380,753,"6 de julio de 1997"
21,14,89,773,580,611,1191,"6 de julio de 1997"
21,14,89,774,276,367,643,"6 de julio de 1997"
21,14,89,775,249,250,499,"6 de julio de 1997"
21,14,122,1674,149,156,305,"6 de julio de 1997"
21,14,122,1675,74,59,133,"6 de julio de 1997"
21,14,122,1676,52,66,118,"6 de julio de 1997"
21,14,134,1774,159,206,365,"6 de julio de 1997"
21,14,158,2033,490,705,1195,"6 de julio de 1997"
21,14,158,2034,391,586,977,"6 de julio de 1997"
21,14,158,2035,178,170,348,"6 de julio de 1997"
21,14,158,2036,79,98,177,"6 de julio de 1997"
21,14,158,2037,106,125,231,"6 de julio de 1997"
21,14,159,2038,378,380,758,"6 de julio de 1997"
21,14,159,2039,212,218,430,"6 de julio de 1997"
21,14,159,2040,174,214,388,"6 de julio de 1997"
21,14,159,2041,75,84,159,"6 de julio de 1997"
21,14,164,2082,296,252,548,"6 de julio de 1997"
21,14,165,2083,320,420,740,"6 de julio de 1997"
21,14,165,2084,429,477,906,"6 de julio de 1997"
21,14,165,2085,476,627,1103,"6 de julio de 1997"
21,14,165,2086,208,280,488,"6 de julio de 1997"
21,14,165,2087,299,479,778,"6 de julio de 1997"
21,14,165,2088,108,140,248,"6 de julio de 1997"
21,14,167,2095,408,436,844,"6 de julio de 1997"
21,14,167,2096,425,476,901,"6 de julio de 1997"
21,14,167,2097,447,495,942,"6 de julio de 1997"
21,14,175,2181,708,837,1545,"6 de julio de 1997"
21,14,175,2182,547,619,1166,"6 de julio de 1997"
21,14,175,2183,590,723,1313,"6 de julio de 1997"
21,14,185,2267,414,537,951,"6 de julio de 1997"
21,14,185,2268,288,355,643,"6 de julio de 1997"
21,14,185,2269,351,461,812,"6 de julio de 1997"
21,14,185,2270,422,536,958,"6 de julio de 1997"
21,14,185,2271,303,346,649,"6 de julio de 1997"
21,14,198,2391,171,223,394,"6 de julio de 1997"
21,14,198,2392,159,182,341,"6 de julio de 1997"
21,14,201,2407,494,623,1117,"6 de julio de 1997"
21,14,201,2408,206,277,483,"6 de julio de 1997"
21,15,10,80,616,546,1162,"6 de julio de 1997"
21,15,10,81,550,487,1037,"6 de julio de 1997"
21,15,10,82,633,596,1229,"6 de julio de 1997"
21,15,10,83,589,564,1153,"6 de julio de 1997"
21,15,10,84,668,634,1302,"6 de julio de 1997"
21,15,10,85,640,642,1282,"6 de julio de 1997"
21,15,10,86,307,303,610,"6 de julio de 1997"
21,15,10,87,355,367,722,"6 de julio de 1997"
21,15,10,88,175,172,347,"6 de julio de 1997"
21,15,10,89,357,343,700,"6 de julio de 1997"
21,15,10,90,438,382,820,"6 de julio de 1997"
21,15,10,91,349,341,690,"6 de julio de 1997"
21,15,10,92,92,64,156,"6 de julio de 1997"
21,15,10,93,43,35,78,"6 de julio de 1997"
21,15,10,94,492,417,909,"6 de julio de 1997"
21,15,10,95,371,361,732,"6 de julio de 1997"
21,15,10,96,672,745,1417,"6 de julio de 1997"
21,15,10,97,384,382,766,"6 de julio de 1997"
21,15,10,98,101,102,203,"6 de julio de 1997"
21,15,10,99,208,152,360,"6 de julio de 1997"
21,15,10,100,242,238,480,"6 de julio de 1997"
21,15,10,101,325,279,604,"6 de julio de 1997"
21,15,13,107,578,527,1105,"6 de julio de 1997"
21,15,13,108,424,377,801,"6 de julio de 1997"
21,15,13,109,480,458,938,"6 de julio de 1997"
21,15,13,110,567,545,1112,"6 de julio de 1997"
21,15,13,111,398,366,764,"6 de julio de 1997"
21,15,13,112,487,459,946,"6 de julio de 1997"
21,15,27,253,211,230,441,"6 de julio de 1997"
21,15,27,254,250,289,539,"6 de julio de 1997"
21,15,27,255,114,140,254,"6 de julio de 1997"
21,15,27,256,255,277,532,"6 de julio de 1997"
21,15,27,257,92,81,173,"6 de julio de 1997"
21,15,27,258,142,135,277,"6 de julio de 1997"
21,15,27,259,29,31,60,"6 de julio de 1997"
21,15,36,294,276,298,574,"6 de julio de 1997"
21,15,36,295,189,223,412,"6 de julio de 1997"
21,15,36,296,551,600,1151,"6 de julio de 1997"
21,15,36,297,321,337,658,"6 de julio de 1997"
21,15,36,298,423,394,817,"6 de julio de 1997"
21,15,36,299,430,384,814,"6 de julio de 1997"
21,15,36,300,657,782,1439,"6 de julio de 1997"
21,15,36,301,503,514,1017,"6 de julio de 1997"
21,15,36,302,303,300,603,"6 de julio de 1997"
21,15,36,303,167,186,353,"6 de julio de 1997"
21,15,36,304,138,119,257,"6 de julio de 1997"
21,15,36,305,467,524,991,"6 de julio de 1997"
21,15,37,306,512,689,1201,"6 de julio de 1997"
21,15,37,307,429,506,935,"6 de julio de 1997"
21,15,37,308,368,313,681,"6 de julio de 1997"
21,15,37,309,72,98,170,"6 de julio de 1997"
21,15,37,310,448,448,896,"6 de julio de 1997"
21,15,37,311,245,323,568,"6 de julio de 1997"
21,15,37,312,70,62,132,"6 de julio de 1997"
21,15,37,313,270,360,630,"6 de julio de 1997"
21,15,62,518,355,301,656,"6 de julio de 1997"
21,15,62,519,742,714,1456,"6 de julio de 1997"
21,15,62,520,268,237,505,"6 de julio de 1997"
21,15,62,521,422,384,806,"6 de julio de 1997"
21,15,62,522,348,333,681,"6 de julio de 1997"
21,15,62,523,219,213,432,"6 de julio de 1997"
21,15,121,1672,486,552,1038,"6 de julio de 1997"
21,15,121,1673,277,267,544,"6 de julio de 1997"
21,15,125,1685,578,605,1183,"6 de julio de 1997"
21,15,125,1686,528,540,1068,"6 de julio de 1997"
21,15,125,1687,561,641,1202,"6 de julio de 1997"
21,15,125,1688,206,225,431,"6 de julio de 1997"
21,15,125,1689,499,538,1037,"6 de julio de 1997"
21,15,125,1690,331,168,499,"6 de julio de 1997"
21,15,130,1708,423,374,797,"6 de julio de 1997"
21,15,130,1709,562,526,1088,"6 de julio de 1997"
21,15,130,1710,443,447,890,"6 de julio de 1997"
21,15,130,1711,162,156,318,"6 de julio de 1997"
21,15,130,1712,194,211,405,"6 de julio de 1997"
21,15,130,1713,251,172,423,"6 de julio de 1997"
21,15,130,1714,302,237,539,"6 de julio de 1997"
21,15,155,1934,1164,1243,2407,"6 de julio de 1997"
21,15,155,1935,539,631,1170,"6 de julio de 1997"
21,15,155,1936,759,824,1583,"6 de julio de 1997"
21,15,155,1937,773,846,1619,"6 de julio de 1997"
21,15,155,1938,864,924,1788,"6 de julio de 1997"
21,15,155,1939,252,268,520,"6 de julio de 1997"
21,15,155,1940,192,184,376,"6 de julio de 1997"
21,15,155,1941,506,562,1068,"6 de julio de 1997"
21,15,155,1942,811,857,1668,"6 de julio de 1997"
21,15,155,1943,602,685,1287,"6 de julio de 1997"
21,15,155,1944,544,298,842,"6 de julio de 1997"
21,15,155,1945,584,608,1192,"6 de julio de 1997"
21,15,155,1946,419,469,888,"6 de julio de 1997"
21,15,155,1947,349,447,796,"6 de julio de 1997"
21,15,155,1948,512,607,1119,"6 de julio de 1997"
21,15,155,1949,371,440,811,"6 de julio de 1997"
21,15,155,1950,466,512,978,"6 de julio de 1997"
21,15,155,1951,612,688,1300,"6 de julio de 1997"
21,15,155,1952,1278,1387,2665,"6 de julio de 1997"
21,15,155,1953,662,792,1454,"6 de julio de 1997"
21,15,155,1954,428,520,948,"6 de julio de 1997"
21,15,155,1955,773,973,1746,"6 de julio de 1997"
21,15,155,1956,479,599,1078,"6 de julio de 1997"
21,15,155,1957,578,688,1266,"6 de julio de 1997"
21,15,155,1958,552,663,1215,"6 de julio de 1997"
21,15,155,1959,651,754,1405,"6 de julio de 1997"
21,15,155,1960,566,635,1201,"6 de julio de 1997"
21,15,155,1961,626,721,1347,"6 de julio de 1997"
21,15,155,1962,543,633,1176,"6 de julio de 1997"
21,15,155,1963,412,422,834,"6 de julio de 1997"
21,15,155,1964,426,460,886,"6 de julio de 1997"
21,15,155,1965,283,326,609,"6 de julio de 1997"
21,15,155,1966,440,514,954,"6 de julio de 1997"
21,15,155,1967,314,404,718,"6 de julio de 1997"
21,15,155,1968,477,554,1031,"6 de julio de 1997"
21,15,155,1969,338,379,717,"6 de julio de 1997"
21,15,155,1970,606,711,1317,"6 de julio de 1997"
21,15,155,1971,717,846,1563,"6 de julio de 1997"
21,15,155,1972,569,710,1279,"6 de julio de 1997"
21,15,155,1973,594,661,1255,"6 de julio de 1997"
21,15,155,1974,272,319,591,"6 de julio de 1997"
21,15,155,1975,280,333,613,"6 de julio de 1997"
21,15,155,1976,500,539,1039,"6 de julio de 1997"
21,15,155,1977,538,628,1166,"6 de julio de 1997"
21,15,155,1978,733,857,1590,"6 de julio de 1997"
21,15,155,1979,707,818,1525,"6 de julio de 1997"
21,15,155,1980,411,481,892,"6 de julio de 1997"
21,15,155,1981,458,570,1028,"6 de julio de 1997"
21,15,155,1982,480,565,1045,"6 de julio de 1997"
21,15,155,1983,194,228,422,"6 de julio de 1997"
21,15,155,1984,256,305,561,"6 de julio de 1997"
21,15,155,1985,753,918,1671,"6 de julio de 1997"
21,15,155,1986,818,835,1653,"6 de julio de 1997"
21,15,155,1987,620,693,1313,"6 de julio de 1997"
21,15,155,1988,819,795,1614,"6 de julio de 1997"
21,15,155,1989,545,609,1154,"6 de julio de 1997"
21,15,155,1990,733,804,1537,"6 de julio de 1997"
21,15,155,1991,574,669,1243,"6 de julio de 1997"
21,15,155,1992,347,398,745,"6 de julio de 1997"
21,15,155,1993,574,696,1270,"6 de julio de 1997"
21,15,155,1994,663,728,1391,"6 de julio de 1997"
21,15,155,1995,474,524,998,"6 de julio de 1997"
21,15,155,1996,637,672,1309,"6 de julio de 1997"
21,15,155,1997,225,243,468,"6 de julio de 1997"
21,15,155,1998,557,582,1139,"6 de julio de 1997"
21,15,155,1999,765,831,1596,"6 de julio de 1997"
21,15,155,2000,581,620,1201,"6 de julio de 1997"
21,15,155,2001,398,399,797,"6 de julio de 1997"
21,15,155,2002,678,741,1419,"6 de julio de 1997"
21,15,155,2003,822,913,1735,"6 de julio de 1997"
21,15,155,2004,328,363,691,"6 de julio de 1997"
21,15,155,2005,689,755,1444,"6 de julio de 1997"
21,15,155,2006,784,853,1637,"6 de julio de 1997"
21,15,155,2007,564,603,1167,"6 de julio de 1997"
21,15,155,2008,862,1042,1904,"6 de julio de 1997"
21,15,155,2009,604,672,1276,"6 de julio de 1997"
21,15,155,2010,341,297,638,"6 de julio de 1997"
21,15,155,2011,412,406,818,"6 de julio de 1997"
21,15,155,2012,830,861,1691,"6 de julio de 1997"
21,15,155,2013,427,453,880,"6 de julio de 1997"
21,15,155,2014,291,298,589,"6 de julio de 1997"
21,15,155,2015,352,377,729,"6 de julio de 1997"
21,15,155,2016,345,301,646,"6 de julio de 1997"
21,15,177,2201,651,620,1271,"6 de julio de 1997"
21,15,177,2202,160,107,267,"6 de julio de 1997"
21,15,177,2203,376,326,702,"6 de julio de 1997"
21,15,177,2204,386,321,707,"6 de julio de 1997"
21,15,177,2205,206,162,368,"6 de julio de 1997"
21,15,177,2206,430,445,875,"6 de julio de 1997"
21,15,177,2207,301,326,627,"6 de julio de 1997"
21,15,177,2208,208,201,409,"6 de julio de 1997"
21,15,209,2490,590,706,1296,"6 de julio de 1997"
21,15,209,2491,261,313,574,"6 de julio de 1997"
21,15,209,2492,104,90,194,"6 de julio de 1997"
21,15,209,2493,66,64,130,"6 de julio de 1997"
21,15,209,2494,329,332,661,"6 de julio de 1997"
21,15,209,2495,43,48,91,"6 de julio de 1997"
21,15,209,2496,198,219,417,"6 de julio de 1997"
21,15,209,2497,82,94,176,"6 de julio de 1997"
21,15,209,2498,25,39,64,"6 de julio de 1997"
21,15,214,2527,612,755,1367,"6 de julio de 1997"
21,15,214,2528,554,660,1214,"6 de julio de 1997"
21,15,214,2529,306,383,689,"6 de julio de 1997"
21,15,214,2530,324,380,704,"6 de julio de 1997"
21,15,214,2531,323,344,667,"6 de julio de 1997"
21,15,214,2532,593,668,1261,"6 de julio de 1997"
21,15,217,2537,359,364,723,"6 de julio de 1997"
21,15,217,2538,364,450,814,"6 de julio de 1997"
21,15,217,2539,464,556,1020,"6 de julio de 1997"
21,15,217,2540,78,78,156,"6 de julio de 1997"
21,15,217,2541,432,372,804,"6 de julio de 1997"
21,15,217,2542,170,145,315,"6 de julio de 1997"
21,15,217,2543,168,140,308,"6 de julio de 1997"
21,15,217,2544,184,199,383,"6 de julio de 1997"
21,15,217,2545,675,775,1450,"6 de julio de 1997"
21,15,217,2546,115,93,208,"6 de julio de 1997"
21,15,217,2547,365,331,696,"6 de julio de 1997"
21,15,217,2548,450,541,991,"6 de julio de 1997"
22,1,2,35,492,524,1016,"6 de julio de 1997"
22,1,2,36,249,270,519,"6 de julio de 1997"
22,1,2,37,91,97,188,"6 de julio de 1997"
22,1,2,38,89,114,203,"6 de julio de 1997"
22,1,2,39,511,533,1044,"6 de julio de 1997"
22,1,2,40,143,132,275,"6 de julio de 1997"
22,1,2,41,374,340,714,"6 de julio de 1997"
22,1,2,42,291,319,610,"6 de julio de 1997"
22,1,2,43,263,308,571,"6 de julio de 1997"
22,1,2,44,138,130,268,"6 de julio de 1997"
22,1,2,45,614,699,1313,"6 de julio de 1997"
22,1,3,46,625,722,1347,"6 de julio de 1997"
22,1,3,47,481,575,1056,"6 de julio de 1997"
22,1,3,48,427,459,886,"6 de julio de 1997"
22,1,3,49,499,567,1066,"6 de julio de 1997"
22,1,3,50,616,742,1358,"6 de julio de 1997"
22,1,3,51,505,574,1079,"6 de julio de 1997"
22,1,3,52,274,316,590,"6 de julio de 1997"
22,1,3,53,250,269,519,"6 de julio de 1997"
22,1,3,54,246,246,492,"6 de julio de 1997"
22,1,3,55,377,442,819,"6 de julio de 1997"
22,1,3,56,320,332,652,"6 de julio de 1997"
22,1,3,57,260,251,511,"6 de julio de 1997"
22,1,3,58,354,314,668,"6 de julio de 1997"
22,1,3,59,353,386,739,"6 de julio de 1997"
22,1,3,60,492,455,947,"6 de julio de 1997"
22,1,3,61,566,628,1194,"6 de julio de 1997"
22,1,3,62,140,139,279,"6 de julio de 1997"
22,1,3,63,282,283,565,"6 de julio de 1997"
22,1,3,64,250,253,503,"6 de julio de 1997"
22,1,3,65,481,480,961,"6 de julio de 1997"
22,1,3,66,823,853,1676,"6 de julio de 1997"
22,1,3,67,273,325,598,"6 de julio de 1997"
22,1,3,68,189,179,368,"6 de julio de 1997"
22,1,3,69,584,685,1269,"6 de julio de 1997"
22,1,3,70,742,883,1625,"6 de julio de 1997"
22,1,3,71,520,629,1149,"6 de julio de 1997"
22,1,3,72,357,438,795,"6 de julio de 1997"
22,1,3,73,689,735,1424,"6 de julio de 1997"
22,1,3,74,238,205,443,"6 de julio de 1997"
22,1,3,75,509,512,1021,"6 de julio de 1997"
22,1,4,76,496,522,1018,"6 de julio de 1997"
22,1,4,77,449,471,920,"6 de julio de 1997"
22,1,4,78,397,448,845,"6 de julio de 1997"
22,1,4,79,648,694,1342,"6 de julio de 1997"
22,1,4,80,217,207,424,"6 de julio de 1997"
22,1,4,81,450,429,879,"6 de julio de 1997"
22,1,4,82,338,352,690,"6 de julio de 1997"
22,1,4,83,681,670,1351,"6 de julio de 1997"
22,1,4,84,349,317,666,"6 de julio de 1997"
22,1,4,85,256,326,582,"6 de julio de 1997"
22,1,4,86,408,342,750,"6 de julio de 1997"
22,1,4,87,491,492,983,"6 de julio de 1997"
22,1,4,88,654,659,1313,"6 de julio de 1997"
22,1,4,89,718,656,1374,"6 de julio de 1997"
22,1,4,90,278,349,627,"6 de julio de 1997"
22,1,4,91,344,415,759,"6 de julio de 1997"
22,1,4,92,924,882,1806,"6 de julio de 1997"
22,1,4,93,753,771,1524,"6 de julio de 1997"
22,1,4,94,594,613,1207,"6 de julio de 1997"
22,1,4,95,501,417,918,"6 de julio de 1997"
22,1,4,96,663,627,1290,"6 de julio de 1997"
22,1,6,122,480,560,1040,"6 de julio de 1997"
22,1,6,123,315,392,707,"6 de julio de 1997"
22,1,6,124,426,512,938,"6 de julio de 1997"
22,1,6,125,375,505,880,"6 de julio de 1997"
22,1,6,126,491,545,1036,"6 de julio de 1997"
22,1,6,127,396,472,868,"6 de julio de 1997"
22,1,6,128,545,658,1203,"6 de julio de 1997"
22,1,6,129,353,402,755,"6 de julio de 1997"
22,1,6,130,357,400,757,"6 de julio de 1997"
22,1,6,131,258,302,560,"6 de julio de 1997"
22,1,6,132,274,300,574,"6 de julio de 1997"
22,1,6,133,317,512,829,"6 de julio de 1997"
22,1,6,134,285,371,656,"6 de julio de 1997"
22,1,6,135,325,450,775,"6 de julio de 1997"
22,1,6,136,302,419,721,"6 de julio de 1997"
22,1,6,137,325,370,695,"6 de julio de 1997"
22,1,6,138,180,173,353,"6 de julio de 1997"
22,1,8,153,482,579,1061,"6 de julio de 1997"
22,1,8,154,530,623,1153,"6 de julio de 1997"
22,1,8,155,358,402,760,"6 de julio de 1997"
22,1,8,156,400,487,887,"6 de julio de 1997"
22,1,8,157,308,278,586,"6 de julio de 1997"
22,1,8,158,405,446,851,"6 de julio de 1997"
22,1,8,159,176,178,354,"6 de julio de 1997"
22,1,8,160,205,218,423,"6 de julio de 1997"
22,1,8,161,347,361,708,"6 de julio de 1997"
22,1,8,162,224,264,488,"6 de julio de 1997"
22,1,8,163,341,385,726,"6 de julio de 1997"
22,1,8,164,290,297,587,"6 de julio de 1997"
22,1,8,165,219,214,433,"6 de julio de 1997"
22,1,8,166,221,231,452,"6 de julio de 1997"
22,1,8,167,466,465,931,"6 de julio de 1997"
22,1,9,168,505,577,1082,"6 de julio de 1997"
22,1,9,169,267,287,554,"6 de julio de 1997"
22,1,9,170,241,275,516,"6 de julio de 1997"
22,1,9,171,468,524,992,"6 de julio de 1997"
22,1,9,172,227,257,484,"6 de julio de 1997"
22,1,9,173,205,196,401,"6 de julio de 1997"
22,1,9,174,333,362,695,"6 de julio de 1997"
22,1,9,175,281,297,578,"6 de julio de 1997"
22,1,9,176,541,573,1114,"6 de julio de 1997"
22,1,9,177,204,165,369,"6 de julio de 1997"
22,1,9,178,168,188,356,"6 de julio de 1997"
22,1,9,179,111,131,242,"6 de julio de 1997"
22,1,9,180,471,485,956,"6 de julio de 1997"
22,1,9,181,129,151,280,"6 de julio de 1997"
22,1,11,210,446,489,935,"6 de julio de 1997"
22,1,11,211,478,486,964,"6 de julio de 1997"
22,1,11,212,453,511,964,"6 de julio de 1997"
22,1,11,213,443,450,893,"6 de julio de 1997"
22,1,11,214,433,465,898,"6 de julio de 1997"
22,1,11,215,507,513,1020,"6 de julio de 1997"
22,1,11,216,648,648,1296,"6 de julio de 1997"
22,1,11,217,497,520,1017,"6 de julio de 1997"
22,1,11,218,339,348,687,"6 de julio de 1997"
22,1,11,219,439,434,873,"6 de julio de 1997"
22,1,11,220,464,455,919,"6 de julio de 1997"
22,1,11,221,523,494,1017,"6 de julio de 1997"
22,1,11,222,669,693,1362,"6 de julio de 1997"
22,1,11,223,559,570,1129,"6 de julio de 1997"
22,1,11,224,702,705,1407,"6 de julio de 1997"
22,1,11,225,490,505,995,"6 de julio de 1997"
22,1,11,226,574,574,1148,"6 de julio de 1997"
22,1,11,227,607,648,1255,"6 de julio de 1997"
22,1,11,228,513,525,1038,"6 de julio de 1997"
22,1,11,229,266,254,520,"6 de julio de 1997"
22,1,11,230,935,929,1864,"6 de julio de 1997"
22,1,11,231,681,682,1363,"6 de julio de 1997"
22,1,11,232,239,206,445,"6 de julio de 1997"
22,1,11,233,467,485,952,"6 de julio de 1997"
22,1,12,234,416,438,854,"6 de julio de 1997"
22,1,12,235,164,140,304,"6 de julio de 1997"
22,1,12,236,135,132,267,"6 de julio de 1997"
22,1,12,237,559,547,1106,"6 de julio de 1997"
22,1,12,238,185,228,413,"6 de julio de 1997"
22,1,12,239,171,170,341,"6 de julio de 1997"
22,1,12,240,389,430,819,"6 de julio de 1997"
22,1,12,241,349,371,720,"6 de julio de 1997"
22,1,12,242,315,381,696,"6 de julio de 1997"
22,1,12,243,227,218,445,"6 de julio de 1997"
22,1,12,244,147,158,305,"6 de julio de 1997"
22,1,12,245,543,560,1103,"6 de julio de 1997"
22,1,12,246,50,38,88,"6 de julio de 1997"
22,1,12,247,540,498,1038,"6 de julio de 1997"
22,1,13,248,515,537,1052,"6 de julio de 1997"
22,1,13,249,335,321,656,"6 de julio de 1997"
22,1,13,250,459,502,961,"6 de julio de 1997"
22,1,13,251,489,482,971,"6 de julio de 1997"
22,1,13,252,237,237,474,"6 de julio de 1997"
22,1,13,253,538,622,1160,"6 de julio de 1997"
22,1,13,254,365,391,756,"6 de julio de 1997"
22,1,13,255,133,122,255,"6 de julio de 1997"
22,1,13,256,286,298,584,"6 de julio de 1997"
22,1,13,257,143,128,271,"6 de julio de 1997"
22,1,13,258,406,401,807,"6 de julio de 1997"
22,1,13,259,313,386,699,"6 de julio de 1997"
22,1,13,260,403,459,862,"6 de julio de 1997"
22,1,13,261,370,452,822,"6 de julio de 1997"
22,1,13,262,516,498,1014,"6 de julio de 1997"
22,1,13,263,245,234,479,"6 de julio de 1997"
22,1,13,264,234,233,467,"6 de julio de 1997"
22,1,13,265,113,105,218,"6 de julio de 1997"
22,1,15,556,371,406,777,"6 de julio de 1997"
22,1,15,557,469,513,982,"6 de julio de 1997"
22,1,15,558,217,244,461,"6 de julio de 1997"
22,1,15,559,165,182,347,"6 de julio de 1997"
22,1,15,560,263,310,573,"6 de julio de 1997"
22,1,15,561,97,110,207,"6 de julio de 1997"
22,1,15,562,108,96,204,"6 de julio de 1997"
22,1,17,644,94,104,198,"6 de julio de 1997"
22,1,17,645,298,325,623,"6 de julio de 1997"
22,1,17,646,513,511,1024,"6 de julio de 1997"
22,1,17,647,560,594,1154,"6 de julio de 1997"
22,1,17,648,394,472,866,"6 de julio de 1997"
22,1,17,649,389,400,789,"6 de julio de 1997"
22,1,17,650,481,583,1064,"6 de julio de 1997"
22,1,17,651,378,409,787,"6 de julio de 1997"
22,1,17,652,176,206,382,"6 de julio de 1997"
22,1,17,653,420,443,863,"6 de julio de 1997"
22,1,17,654,428,486,914,"6 de julio de 1997"
22,1,17,655,344,410,754,"6 de julio de 1997"
22,1,17,656,642,787,1429,"6 de julio de 1997"
22,1,17,657,402,448,850,"6 de julio de 1997"
22,1,17,658,487,525,1012,"6 de julio de 1997"
22,1,17,659,530,544,1074,"6 de julio de 1997"
22,1,17,660,573,571,1144,"6 de julio de 1997"
22,1,17,661,383,409,792,"6 de julio de 1997"
22,1,17,662,263,347,610,"6 de julio de 1997"
22,1,17,663,262,296,558,"6 de julio de 1997"
22,1,17,664,98,104,202,"6 de julio de 1997"
22,1,17,665,420,446,866,"6 de julio de 1997"
22,1,17,666,509,508,1017,"6 de julio de 1997"
22,1,17,667,544,573,1117,"6 de julio de 1997"
22,1,17,668,637,647,1284,"6 de julio de 1997"
22,1,17,669,370,387,757,"6 de julio de 1997"
22,1,17,670,398,390,788,"6 de julio de 1997"
22,1,17,671,425,414,839,"6 de julio de 1997"
22,1,17,672,533,489,1022,"6 de julio de 1997"
22,1,17,673,519,527,1046,"6 de julio de 1997"
22,1,18,674,391,482,873,"6 de julio de 1997"
22,1,18,675,350,390,740,"6 de julio de 1997"
22,1,18,676,111,115,226,"6 de julio de 1997"
22,1,18,677,380,368,748,"6 de julio de 1997"
22,1,18,678,251,239,490,"6 de julio de 1997"
22,1,18,679,514,592,1106,"6 de julio de 1997"
22,1,18,680,238,264,502,"6 de julio de 1997"
22,1,18,681,290,383,673,"6 de julio de 1997"
22,1,18,682,572,638,1210,"6 de julio de 1997"
22,1,18,683,455,525,980,"6 de julio de 1997"
22,1,18,684,727,919,1646,"6 de julio de 1997"
22,1,18,685,31,27,58,"6 de julio de 1997"
22,1,18,686,224,214,438,"6 de julio de 1997"
22,1,18,687,372,414,786,"6 de julio de 1997"
22,2,1,1,410,442,852,"6 de julio de 1997"
22,2,1,2,330,396,726,"6 de julio de 1997"
22,2,1,3,433,466,899,"6 de julio de 1997"
22,2,1,4,429,493,922,"6 de julio de 1997"
22,2,1,5,341,426,767,"6 de julio de 1997"
22,2,1,6,303,297,600,"6 de julio de 1997"
22,2,1,7,178,151,329,"6 de julio de 1997"
22,2,1,8,364,357,721,"6 de julio de 1997"
22,2,1,9,435,536,971,"6 de julio de 1997"
22,2,1,10,348,345,693,"6 de julio de 1997"
22,2,1,11,258,248,506,"6 de julio de 1997"
22,2,1,12,257,245,502,"6 de julio de 1997"
22,2,1,13,549,522,1071,"6 de julio de 1997"
22,2,1,14,500,509,1009,"6 de julio de 1997"
22,2,1,15,417,410,827,"6 de julio de 1997"
22,2,1,16,324,328,652,"6 de julio de 1997"
22,2,1,17,360,350,710,"6 de julio de 1997"
22,2,1,18,227,201,428,"6 de julio de 1997"
22,2,1,19,584,570,1154,"6 de julio de 1997"
22,2,1,20,298,297,595,"6 de julio de 1997"
22,2,1,21,156,181,337,"6 de julio de 1997"
22,2,1,22,517,507,1024,"6 de julio de 1997"
22,2,1,23,581,571,1152,"6 de julio de 1997"
22,2,1,24,463,487,950,"6 de julio de 1997"
22,2,1,25,417,434,851,"6 de julio de 1997"
22,2,1,26,430,410,840,"6 de julio de 1997"
22,2,1,27,335,342,677,"6 de julio de 1997"
22,2,1,28,305,316,621,"6 de julio de 1997"
22,2,1,29,282,306,588,"6 de julio de 1997"
22,2,1,30,427,461,888,"6 de julio de 1997"
22,2,1,31,227,243,470,"6 de julio de 1997"
22,2,1,32,314,318,632,"6 de julio de 1997"
22,2,1,33,634,618,1252,"6 de julio de 1997"
22,2,1,34,298,282,580,"6 de julio de 1997"
22,2,5,97,594,683,1277,"6 de julio de 1997"
22,2,5,98,657,722,1379,"6 de julio de 1997"
22,2,5,99,720,688,1408,"6 de julio de 1997"
22,2,5,100,675,723,1398,"6 de julio de 1997"
22,2,5,101,586,637,1223,"6 de julio de 1997"
22,2,5,102,577,623,1200,"6 de julio de 1997"
22,2,5,103,588,625,1213,"6 de julio de 1997"
22,2,5,104,618,657,1275,"6 de julio de 1997"
22,2,5,105,673,721,1394,"6 de julio de 1997"
22,2,5,106,643,691,1334,"6 de julio de 1997"
22,2,5,107,581,652,1233,"6 de julio de 1997"
22,2,5,108,567,634,1201,"6 de julio de 1997"
22,2,5,109,599,628,1227,"6 de julio de 1997"
22,2,5,110,627,658,1285,"6 de julio de 1997"
22,2,5,111,548,609,1157,"6 de julio de 1997"
22,2,5,112,847,922,1769,"6 de julio de 1997"
22,2,5,113,1282,1412,2694,"6 de julio de 1997"
22,2,5,114,667,711,1378,"6 de julio de 1997"
22,2,5,115,902,939,1841,"6 de julio de 1997"
22,2,5,116,431,428,859,"6 de julio de 1997"
22,2,5,117,209,230,439,"6 de julio de 1997"
22,2,5,118,522,564,1086,"6 de julio de 1997"
22,2,5,119,278,284,562,"6 de julio de 1997"
22,2,5,120,672,662,1334,"6 de julio de 1997"
22,2,5,121,743,804,1547,"6 de julio de 1997"
22,2,7,139,542,619,1161,"6 de julio de 1997"
22,2,7,140,387,480,867,"6 de julio de 1997"
22,2,7,141,592,556,1148,"6 de julio de 1997"
22,2,7,142,265,202,467,"6 de julio de 1997"
22,2,7,143,478,450,928,"6 de julio de 1997"
22,2,7,144,500,465,965,"6 de julio de 1997"
22,2,7,145,515,488,1003,"6 de julio de 1997"
22,2,7,146,293,280,573,"6 de julio de 1997"
22,2,7,147,706,719,1425,"6 de julio de 1997"
22,2,7,148,375,353,728,"6 de julio de 1997"
22,2,7,149,343,352,695,"6 de julio de 1997"
22,2,7,150,486,523,1009,"6 de julio de 1997"
22,2,7,151,333,349,682,"6 de julio de 1997"
22,2,7,152,569,651,1220,"6 de julio de 1997"
22,2,10,182,694,668,1362,"6 de julio de 1997"
22,2,10,183,696,766,1462,"6 de julio de 1997"
22,2,10,184,552,561,1113,"6 de julio de 1997"
22,2,10,185,657,648,1305,"6 de julio de 1997"
22,2,10,186,155,180,335,"6 de julio de 1997"
22,2,10,187,252,228,480,"6 de julio de 1997"
22,2,10,188,746,831,1577,"6 de julio de 1997"
22,2,10,189,616,595,1211,"6 de julio de 1997"
22,2,10,190,685,671,1356,"6 de julio de 1997"
22,2,10,191,860,832,1692,"6 de julio de 1997"
22,2,10,192,579,595,1174,"6 de julio de 1997"
22,2,10,193,427,431,858,"6 de julio de 1997"
22,2,10,194,415,336,751,"6 de julio de 1997"
22,2,10,195,666,653,1319,"6 de julio de 1997"
22,2,10,196,622,673,1295,"6 de julio de 1997"
22,2,10,197,524,529,1053,"6 de julio de 1997"
22,2,10,198,507,564,1071,"6 de julio de 1997"
22,2,10,199,644,591,1235,"6 de julio de 1997"
22,2,10,200,522,478,1000,"6 de julio de 1997"
22,2,10,201,748,740,1488,"6 de julio de 1997"
22,2,10,202,857,775,1632,"6 de julio de 1997"
22,2,10,203,838,812,1650,"6 de julio de 1997"
22,2,10,204,638,674,1312,"6 de julio de 1997"
22,2,10,205,796,804,1600,"6 de julio de 1997"
22,2,10,206,505,512,1017,"6 de julio de 1997"
22,2,10,207,556,621,1177,"6 de julio de 1997"
22,2,10,208,673,693,1366,"6 de julio de 1997"
22,2,10,209,447,447,894,"6 de julio de 1997"
22,2,16,563,533,615,1148,"6 de julio de 1997"
22,2,16,564,618,656,1274,"6 de julio de 1997"
22,2,16,565,280,288,568,"6 de julio de 1997"
22,2,16,566,1397,1522,2919,"6 de julio de 1997"
22,2,16,567,647,695,1342,"6 de julio de 1997"
22,2,16,568,529,547,1076,"6 de julio de 1997"
22,2,16,569,391,472,863,"6 de julio de 1997"
22,2,16,570,563,561,1124,"6 de julio de 1997"
22,2,16,571,545,626,1171,"6 de julio de 1997"
22,2,16,572,456,491,947,"6 de julio de 1997"
22,2,16,573,326,392,718,"6 de julio de 1997"
22,2,16,574,499,515,1014,"6 de julio de 1997"
22,2,16,575,352,368,720,"6 de julio de 1997"
22,2,16,576,554,647,1201,"6 de julio de 1997"
22,2,16,577,557,608,1165,"6 de julio de 1997"
22,2,16,578,373,406,779,"6 de julio de 1997"
22,2,16,579,508,601,1109,"6 de julio de 1997"
22,2,16,580,442,511,953,"6 de julio de 1997"
22,2,16,581,392,457,849,"6 de julio de 1997"
22,2,16,582,408,474,882,"6 de julio de 1997"
22,2,16,583,422,509,931,"6 de julio de 1997"
22,2,16,584,856,993,1849,"6 de julio de 1997"
22,2,16,585,653,742,1395,"6 de julio de 1997"
22,2,16,586,702,783,1485,"6 de julio de 1997"
22,2,16,587,476,520,996,"6 de julio de 1997"
22,2,16,588,325,372,697,"6 de julio de 1997"
22,2,16,589,441,509,950,"6 de julio de 1997"
22,2,16,590,609,756,1365,"6 de julio de 1997"
22,2,16,591,510,633,1143,"6 de julio de 1997"
22,2,16,592,452,518,970,"6 de julio de 1997"
22,2,16,593,457,554,1011,"6 de julio de 1997"
22,2,16,594,502,591,1093,"6 de julio de 1997"
22,2,16,595,659,741,1400,"6 de julio de 1997"
22,2,16,596,301,360,661,"6 de julio de 1997"
22,2,16,597,321,384,705,"6 de julio de 1997"
22,2,16,598,328,416,744,"6 de julio de 1997"
22,2,16,599,500,605,1105,"6 de julio de 1997"
22,2,16,600,669,852,1521,"6 de julio de 1997"
22,2,16,601,321,425,746,"6 de julio de 1997"
22,2,16,602,503,577,1080,"6 de julio de 1997"
22,2,16,603,477,522,999,"6 de julio de 1997"
22,2,16,604,458,506,964,"6 de julio de 1997"
22,2,16,605,497,527,1024,"6 de julio de 1997"
22,2,16,606,357,376,733,"6 de julio de 1997"
22,2,16,607,470,476,946,"6 de julio de 1997"
22,2,16,608,556,595,1151,"6 de julio de 1997"
22,2,16,609,624,691,1315,"6 de julio de 1997"
22,2,16,610,365,375,740,"6 de julio de 1997"
22,2,16,611,641,640,1281,"6 de julio de 1997"
22,2,16,612,607,666,1273,"6 de julio de 1997"
22,2,16,613,1064,602,1666,"6 de julio de 1997"
22,2,16,614,647,612,1259,"6 de julio de 1997"
22,2,16,615,679,692,1371,"6 de julio de 1997"
22,2,16,616,562,593,1155,"6 de julio de 1997"
22,2,16,617,777,740,1517,"6 de julio de 1997"
22,2,16,618,675,606,1281,"6 de julio de 1997"
22,2,16,619,708,744,1452,"6 de julio de 1997"
22,2,16,620,597,616,1213,"6 de julio de 1997"
22,2,16,621,297,275,572,"6 de julio de 1997"
22,2,16,622,587,618,1205,"6 de julio de 1997"
22,2,16,623,632,669,1301,"6 de julio de 1997"
22,2,16,624,596,606,1202,"6 de julio de 1997"
22,2,16,625,384,430,814,"6 de julio de 1997"
22,2,16,626,402,447,849,"6 de julio de 1997"
22,2,16,627,470,524,994,"6 de julio de 1997"
22,2,16,628,286,312,598,"6 de julio de 1997"
22,2,16,629,504,467,971,"6 de julio de 1997"
22,2,16,630,478,433,911,"6 de julio de 1997"
22,2,16,631,369,366,735,"6 de julio de 1997"
22,2,16,632,551,526,1077,"6 de julio de 1997"
22,2,16,633,517,474,991,"6 de julio de 1997"
22,2,16,634,597,554,1151,"6 de julio de 1997"
22,2,16,635,496,496,992,"6 de julio de 1997"
22,2,16,636,376,355,731,"6 de julio de 1997"
22,2,16,637,477,483,960,"6 de julio de 1997"
22,2,16,638,427,453,880,"6 de julio de 1997"
22,2,16,639,648,671,1319,"6 de julio de 1997"
22,2,16,640,734,743,1477,"6 de julio de 1997"
22,2,16,641,522,489,1011,"6 de julio de 1997"
22,2,16,642,599,608,1207,"6 de julio de 1997"
22,2,16,643,371,311,682,"6 de julio de 1997"
22,3,14,266,797,801,1598,"6 de julio de 1997"
22,3,14,267,545,550,1095,"6 de julio de 1997"
22,3,14,268,532,643,1175,"6 de julio de 1997"
22,3,14,269,587,573,1160,"6 de julio de 1997"
22,3,14,270,716,747,1463,"6 de julio de 1997"
22,3,14,271,2629,3092,5721,"6 de julio de 1997"
22,3,14,272,567,597,1164,"6 de julio de 1997"
22,3,14,273,981,1070,2051,"6 de julio de 1997"
22,3,14,274,717,755,1472,"6 de julio de 1997"
22,3,14,275,452,541,993,"6 de julio de 1997"
22,3,14,276,692,763,1455,"6 de julio de 1997"
22,3,14,277,889,1020,1909,"6 de julio de 1997"
22,3,14,278,515,567,1082,"6 de julio de 1997"
22,3,14,279,341,398,739,"6 de julio de 1997"
22,3,14,280,593,618,1211,"6 de julio de 1997"
22,3,14,281,678,687,1365,"6 de julio de 1997"
22,3,14,282,755,882,1637,"6 de julio de 1997"
22,3,14,283,497,545,1042,"6 de julio de 1997"
22,3,14,284,486,559,1045,"6 de julio de 1997"
22,3,14,285,540,579,1119,"6 de julio de 1997"
22,3,14,286,413,480,893,"6 de julio de 1997"
22,3,14,287,505,577,1082,"6 de julio de 1997"
22,3,14,288,708,776,1484,"6 de julio de 1997"
22,3,14,289,458,495,953,"6 de julio de 1997"
22,3,14,290,386,437,823,"6 de julio de 1997"
22,3,14,291,401,481,882,"6 de julio de 1997"
22,3,14,292,592,585,1177,"6 de julio de 1997"
22,3,14,293,845,942,1787,"6 de julio de 1997"
22,3,14,294,417,405,822,"6 de julio de 1997"
22,3,14,295,540,572,1112,"6 de julio de 1997"
22,3,14,296,430,498,928,"6 de julio de 1997"
22,3,14,297,601,627,1228,"6 de julio de 1997"
22,3,14,298,429,454,883,"6 de julio de 1997"
22,3,14,299,464,492,956,"6 de julio de 1997"
22,3,14,300,419,482,901,"6 de julio de 1997"
22,3,14,301,452,469,921,"6 de julio de 1997"
22,3,14,302,521,609,1130,"6 de julio de 1997"
22,3,14,303,570,583,1153,"6 de julio de 1997"
22,3,14,304,633,735,1368,"6 de julio de 1997"
22,3,14,305,607,705,1312,"6 de julio de 1997"
22,3,14,306,426,472,898,"6 de julio de 1997"
22,3,14,307,391,425,816,"6 de julio de 1997"
22,3,14,308,872,997,1869,"6 de julio de 1997"
22,3,14,309,393,428,821,"6 de julio de 1997"
22,3,14,310,397,456,853,"6 de julio de 1997"
22,3,14,311,364,379,743,"6 de julio de 1997"
22,3,14,312,410,471,881,"6 de julio de 1997"
22,3,14,313,461,564,1025,"6 de julio de 1997"
22,3,14,314,393,461,854,"6 de julio de 1997"
22,3,14,315,321,392,713,"6 de julio de 1997"
22,3,14,316,613,668,1281,"6 de julio de 1997"
22,3,14,317,341,371,712,"6 de julio de 1997"
22,3,14,318,929,1095,2024,"6 de julio de 1997"
22,3,14,319,1093,1325,2418,"6 de julio de 1997"
22,3,14,320,661,720,1381,"6 de julio de 1997"
22,3,14,321,307,338,645,"6 de julio de 1997"
22,3,14,322,333,387,720,"6 de julio de 1997"
22,3,14,323,793,874,1667,"6 de julio de 1997"
22,3,14,324,488,524,1012,"6 de julio de 1997"
22,3,14,325,532,615,1147,"6 de julio de 1997"
22,3,14,326,721,749,1470,"6 de julio de 1997"
22,3,14,327,438,473,911,"6 de julio de 1997"
22,3,14,328,743,838,1581,"6 de julio de 1997"
22,3,14,329,801,868,1669,"6 de julio de 1997"
22,3,14,330,440,485,925,"6 de julio de 1997"
22,3,14,331,745,759,1504,"6 de julio de 1997"
22,3,14,332,618,675,1293,"6 de julio de 1997"
22,3,14,333,469,580,1049,"6 de julio de 1997"
22,3,14,334,530,574,1104,"6 de julio de 1997"
22,3,14,335,498,587,1085,"6 de julio de 1997"
22,3,14,336,567,634,1201,"6 de julio de 1997"
22,3,14,337,494,479,973,"6 de julio de 1997"
22,3,14,338,809,989,1798,"6 de julio de 1997"
22,3,14,339,389,434,823,"6 de julio de 1997"
22,3,14,340,722,764,1486,"6 de julio de 1997"
22,3,14,341,432,488,920,"6 de julio de 1997"
22,3,14,342,311,391,702,"6 de julio de 1997"
22,3,14,343,545,614,1159,"6 de julio de 1997"
22,3,14,344,1262,1408,2670,"6 de julio de 1997"
22,3,14,345,667,716,1383,"6 de julio de 1997"
22,3,14,346,630,665,1295,"6 de julio de 1997"
22,3,14,347,522,569,1091,"6 de julio de 1997"
22,3,14,348,573,580,1153,"6 de julio de 1997"
22,3,14,349,525,589,1114,"6 de julio de 1997"
22,3,14,350,513,608,1121,"6 de julio de 1997"
22,3,14,351,552,596,1148,"6 de julio de 1997"
22,3,14,352,419,416,835,"6 de julio de 1997"
22,3,14,353,568,598,1166,"6 de julio de 1997"
22,3,14,354,503,609,1112,"6 de julio de 1997"
22,3,14,355,511,611,1122,"6 de julio de 1997"
22,3,14,356,659,751,1410,"6 de julio de 1997"
22,3,14,357,591,672,1263,"6 de julio de 1997"
22,3,14,358,330,363,693,"6 de julio de 1997"
22,3,14,359,561,701,1262,"6 de julio de 1997"
22,3,14,360,649,741,1390,"6 de julio de 1997"
22,3,14,361,471,502,973,"6 de julio de 1997"
22,3,14,362,481,529,1010,"6 de julio de 1997"
22,3,14,363,551,616,1167,"6 de julio de 1997"
22,3,14,364,489,526,1015,"6 de julio de 1997"
22,3,14,365,406,466,872,"6 de julio de 1997"
22,3,14,366,314,332,646,"6 de julio de 1997"
22,3,14,367,306,357,663,"6 de julio de 1997"
22,3,14,368,626,600,1226,"6 de julio de 1997"
22,3,14,369,412,432,844,"6 de julio de 1997"
22,3,14,370,376,462,838,"6 de julio de 1997"
22,3,14,371,364,372,736,"6 de julio de 1997"
22,3,14,376,543,549,1092,"6 de julio de 1997"
22,3,14,377,553,625,1178,"6 de julio de 1997"
22,3,14,378,365,386,751,"6 de julio de 1997"
22,3,14,379,423,444,867,"6 de julio de 1997"
22,3,14,380,643,716,1359,"6 de julio de 1997"
22,3,14,516,400,380,780,"6 de julio de 1997"
22,3,14,517,625,633,1258,"6 de julio de 1997"
22,3,14,518,772,738,1510,"6 de julio de 1997"
22,3,14,519,596,575,1171,"6 de julio de 1997"
22,3,14,520,349,308,657,"6 de julio de 1997"
22,3,14,521,280,284,564,"6 de julio de 1997"
22,3,14,522,952,965,1917,"6 de julio de 1997"
22,3,14,523,367,345,712,"6 de julio de 1997"
22,3,14,524,531,554,1085,"6 de julio de 1997"
22,3,14,525,491,474,965,"6 de julio de 1997"
22,3,14,526,433,441,874,"6 de julio de 1997"
22,3,14,527,1082,1098,2180,"6 de julio de 1997"
22,3,14,528,371,410,781,"6 de julio de 1997"
22,3,14,529,828,882,1710,"6 de julio de 1997"
22,3,14,530,333,352,685,"6 de julio de 1997"
22,3,14,531,365,392,757,"6 de julio de 1997"
22,3,14,532,516,589,1105,"6 de julio de 1997"
22,3,14,533,320,333,653,"6 de julio de 1997"
22,3,14,534,577,649,1226,"6 de julio de 1997"
22,3,14,535,358,402,760,"6 de julio de 1997"
22,3,14,536,544,617,1161,"6 de julio de 1997"
22,3,14,537,529,646,1175,"6 de julio de 1997"
22,3,14,538,394,403,797,"6 de julio de 1997"
22,3,14,539,736,667,1403,"6 de julio de 1997"
22,3,14,540,494,513,1007,"6 de julio de 1997"
22,3,14,541,396,452,848,"6 de julio de 1997"
22,3,14,542,564,581,1145,"6 de julio de 1997"
22,3,14,543,333,315,648,"6 de julio de 1997"
22,3,14,544,428,437,865,"6 de julio de 1997"
22,3,14,545,395,387,782,"6 de julio de 1997"
22,3,14,546,621,596,1217,"6 de julio de 1997"
22,3,14,547,587,609,1196,"6 de julio de 1997"
22,3,14,548,420,430,850,"6 de julio de 1997"
22,3,14,549,793,817,1610,"6 de julio de 1997"
22,3,14,550,437,416,853,"6 de julio de 1997"
22,4,14,372,578,666,1244,"6 de julio de 1997"
22,4,14,373,554,552,1106,"6 de julio de 1997"
22,4,14,374,430,494,924,"6 de julio de 1997"
22,4,14,375,557,603,1160,"6 de julio de 1997"
22,4,14,381,467,490,957,"6 de julio de 1997"
22,4,14,382,638,738,1376,"6 de julio de 1997"
22,4,14,383,408,454,862,"6 de julio de 1997"
22,4,14,384,317,380,697,"6 de julio de 1997"
22,4,14,385,254,355,609,"6 de julio de 1997"
22,4,14,386,610,559,1169,"6 de julio de 1997"
22,4,14,387,486,511,997,"6 de julio de 1997"
22,4,14,388,550,586,1136,"6 de julio de 1997"
22,4,14,389,526,524,1050,"6 de julio de 1997"
22,4,14,390,264,322,586,"6 de julio de 1997"
22,4,14,391,282,297,579,"6 de julio de 1997"
22,4,14,392,525,570,1095,"6 de julio de 1997"
22,4,14,393,731,826,1557,"6 de julio de 1997"
22,4,14,394,515,577,1092,"6 de julio de 1997"
22,4,14,395,514,535,1049,"6 de julio de 1997"
22,4,14,396,465,539,1004,"6 de julio de 1997"
22,4,14,397,367,432,799,"6 de julio de 1997"
22,4,14,398,311,356,667,"6 de julio de 1997"
22,4,14,399,494,544,1038,"6 de julio de 1997"
22,4,14,400,269,304,573,"6 de julio de 1997"
22,4,14,401,445,517,962,"6 de julio de 1997"
22,4,14,402,437,507,944,"6 de julio de 1997"
22,4,14,403,493,517,1010,"6 de julio de 1997"
22,4,14,404,487,557,1044,"6 de julio de 1997"
22,4,14,405,406,480,886,"6 de julio de 1997"
22,4,14,406,341,389,730,"6 de julio de 1997"
22,4,14,407,653,689,1342,"6 de julio de 1997"
22,4,14,408,526,563,1089,"6 de julio de 1997"
22,4,14,409,243,260,503,"6 de julio de 1997"
22,4,14,410,469,703,1172,"6 de julio de 1997"
22,4,14,411,300,332,632,"6 de julio de 1997"
22,4,14,412,298,361,659,"6 de julio de 1997"
22,4,14,413,378,494,872,"6 de julio de 1997"
22,4,14,414,405,414,819,"6 de julio de 1997"
22,4,14,415,387,454,841,"6 de julio de 1997"
22,4,14,416,1155,797,1952,"6 de julio de 1997"
22,4,14,417,380,430,810,"6 de julio de 1997"
22,4,14,418,445,513,958,"6 de julio de 1997"
22,4,14,419,266,381,647,"6 de julio de 1997"
22,4,14,420,502,566,1068,"6 de julio de 1997"
22,4,14,421,515,590,1105,"6 de julio de 1997"
22,4,14,422,406,487,893,"6 de julio de 1997"
22,4,14,423,336,405,741,"6 de julio de 1997"
22,4,14,424,346,469,815,"6 de julio de 1997"
22,4,14,425,429,618,1047,"6 de julio de 1997"
22,4,14,426,542,669,1211,"6 de julio de 1997"
22,4,14,427,349,387,736,"6 de julio de 1997"
22,4,14,428,417,528,945,"6 de julio de 1997"
22,4,14,429,373,465,838,"6 de julio de 1997"
22,4,14,430,554,667,1221,"6 de julio de 1997"
22,4,14,431,322,395,717,"6 de julio de 1997"
22,4,14,432,283,358,641,"6 de julio de 1997"
22,4,14,433,318,365,683,"6 de julio de 1997"
22,4,14,434,440,470,910,"6 de julio de 1997"
22,4,14,435,570,678,1248,"6 de julio de 1997"
22,4,14,436,375,444,819,"6 de julio de 1997"
22,4,14,437,494,580,1074,"6 de julio de 1997"
22,4,14,438,376,454,830,"6 de julio de 1997"
22,4,14,439,478,560,1038,"6 de julio de 1997"
22,4,14,440,582,658,1240,"6 de julio de 1997"
22,4,14,441,244,278,522,"6 de julio de 1997"
22,4,14,442,545,617,1162,"6 de julio de 1997"
22,4,14,443,432,467,899,"6 de julio de 1997"
22,4,14,444,737,806,1543,"6 de julio de 1997"
22,4,14,445,643,719,1362,"6 de julio de 1997"
22,4,14,446,446,561,1007,"6 de julio de 1997"
22,4,14,447,230,257,487,"6 de julio de 1997"
22,4,14,448,439,510,949,"6 de julio de 1997"
22,4,14,449,427,464,891,"6 de julio de 1997"
22,4,14,450,380,454,834,"6 de julio de 1997"
22,4,14,451,343,369,712,"6 de julio de 1997"
22,4,14,452,526,606,1132,"6 de julio de 1997"
22,4,14,453,419,500,919,"6 de julio de 1997"
22,4,14,454,544,680,1224,"6 de julio de 1997"
22,4,14,455,539,562,1101,"6 de julio de 1997"
22,4,14,456,482,559,1041,"6 de julio de 1997"
22,4,14,457,496,572,1068,"6 de julio de 1997"
22,4,14,458,543,666,1209,"6 de julio de 1997"
22,4,14,459,336,379,715,"6 de julio de 1997"
22,4,14,460,495,580,1075,"6 de julio de 1997"
22,4,14,461,543,576,1119,"6 de julio de 1997"
22,4,14,462,471,499,970,"6 de julio de 1997"
22,4,14,463,542,607,1149,"6 de julio de 1997"
22,4,14,464,547,573,1120,"6 de julio de 1997"
22,4,14,465,494,504,998,"6 de julio de 1997"
22,4,14,466,591,656,1247,"6 de julio de 1997"
22,4,14,467,503,539,1042,"6 de julio de 1997"
22,4,14,468,524,588,1112,"6 de julio de 1997"
22,4,14,469,414,469,883,"6 de julio de 1997"
22,4,14,470,434,511,945,"6 de julio de 1997"
22,4,14,471,419,505,924,"6 de julio de 1997"
22,4,14,472,597,658,1255,"6 de julio de 1997"
22,4,14,473,445,528,973,"6 de julio de 1997"
22,4,14,474,408,474,882,"6 de julio de 1997"
22,4,14,475,1444,1623,3067,"6 de julio de 1997"
22,4,14,476,528,595,1123,"6 de julio de 1997"
22,4,14,477,613,651,1264,"6 de julio de 1997"
22,4,14,478,524,578,1102,"6 de julio de 1997"
22,4,14,479,562,663,1225,"6 de julio de 1997"
22,4,14,480,490,561,1051,"6 de julio de 1997"
22,4,14,481,784,949,1733,"6 de julio de 1997"
22,4,14,482,440,474,914,"6 de julio de 1997"
22,4,14,483,238,280,518,"6 de julio de 1997"
22,4,14,484,471,523,994,"6 de julio de 1997"
22,4,14,485,271,332,603,"6 de julio de 1997"
22,4,14,486,633,669,1302,"6 de julio de 1997"
22,4,14,487,603,651,1254,"6 de julio de 1997"
22,4,14,488,847,893,1740,"6 de julio de 1997"
22,4,14,489,561,613,1174,"6 de julio de 1997"
22,4,14,490,523,527,1050,"6 de julio de 1997"
22,4,14,491,912,1007,1919,"6 de julio de 1997"
22,4,14,492,571,625,1196,"6 de julio de 1997"
22,4,14,493,573,683,1256,"6 de julio de 1997"
22,4,14,494,583,653,1236,"6 de julio de 1997"
22,4,14,495,862,1045,1907,"6 de julio de 1997"
22,4,14,496,640,709,1349,"6 de julio de 1997"
22,4,14,497,603,668,1271,"6 de julio de 1997"
22,4,14,498,600,671,1271,"6 de julio de 1997"
22,4,14,499,540,602,1142,"6 de julio de 1997"
22,4,14,500,605,613,1218,"6 de julio de 1997"
22,4,14,501,495,530,1025,"6 de julio de 1997"
22,4,14,502,527,618,1145,"6 de julio de 1997"
22,4,14,503,517,595,1112,"6 de julio de 1997"
22,4,14,504,540,582,1122,"6 de julio de 1997"
22,4,14,505,578,628,1206,"6 de julio de 1997"
22,4,14,506,405,482,887,"6 de julio de 1997"
22,4,14,507,403,494,897,"6 de julio de 1997"
22,4,14,508,561,641,1202,"6 de julio de 1997"
22,4,14,509,475,573,1048,"6 de julio de 1997"
22,4,14,510,685,767,1452,"6 de julio de 1997"
22,4,14,511,523,599,1122,"6 de julio de 1997"
22,4,14,512,488,528,1016,"6 de julio de 1997"
22,4,14,513,818,972,1790,"6 de julio de 1997"
22,4,14,514,427,502,929,"6 de julio de 1997"
22,4,14,515,436,496,932,"6 de julio de 1997"
22,4,14,551,744,818,1562,"6 de julio de 1997"
22,4,14,552,950,1009,1959,"6 de julio de 1997"
22,4,14,553,873,927,1800,"6 de julio de 1997"
22,4,14,554,553,578,1131,"6 de julio de 1997"
22,4,14,555,279,256,535,"6 de julio de 1997"
23,1,1,1,1313,1233,2546,"6 de julio de 1997"
23,1,1,2,1818,1660,3478,"6 de julio de 1997"
23,1,1,3,1901,1871,3772,"6 de julio de 1997"
23,1,1,4,339,347,686,"6 de julio de 1997"
23,1,1,5,389,418,807,"6 de julio de 1997"
23,1,1,6,327,336,663,"6 de julio de 1997"
23,1,1,7,595,539,1134,"6 de julio de 1997"
23,1,1,8,414,346,760,"6 de julio de 1997"
23,1,1,9,391,270,661,"6 de julio de 1997"
23,1,1,10,373,339,712,"6 de julio de 1997"
23,1,1,11,4455,4333,8788,"6 de julio de 1997"
23,1,1,12,1089,1021,2110,"6 de julio de 1997"
23,1,1,13,697,613,1310,"6 de julio de 1997"
23,1,1,14,317,272,589,"6 de julio de 1997"
23,1,1,15,524,503,1027,"6 de julio de 1997"
23,1,1,16,655,648,1303,"6 de julio de 1997"
23,1,1,17,577,599,1176,"6 de julio de 1997"
23,1,1,18,589,547,1136,"6 de julio de 1997"
23,1,1,19,675,577,1252,"6 de julio de 1997"
23,1,1,20,233,208,441,"6 de julio de 1997"
23,1,1,21,435,435,870,"6 de julio de 1997"
23,1,1,22,376,298,674,"6 de julio de 1997"
23,1,1,23,372,342,714,"6 de julio de 1997"
23,1,1,24,318,328,646,"6 de julio de 1997"
23,1,1,25,308,265,573,"6 de julio de 1997"
23,1,1,26,300,303,603,"6 de julio de 1997"
23,1,1,27,458,422,880,"6 de julio de 1997"
23,1,1,28,465,435,900,"6 de julio de 1997"
23,1,1,29,393,355,748,"6 de julio de 1997"
23,1,1,30,335,269,604,"6 de julio de 1997"
23,1,1,31,383,300,683,"6 de julio de 1997"
23,1,1,32,486,352,838,"6 de julio de 1997"
23,1,1,33,361,254,615,"6 de julio de 1997"
23,1,1,34,429,329,758,"6 de julio de 1997"
23,1,1,35,483,390,873,"6 de julio de 1997"
23,1,1,36,500,456,956,"6 de julio de 1997"
23,1,1,37,365,310,675,"6 de julio de 1997"
23,1,1,38,545,440,985,"6 de julio de 1997"
23,1,1,39,323,270,593,"6 de julio de 1997"
23,1,1,40,556,407,963,"6 de julio de 1997"
23,1,1,41,311,230,541,"6 de julio de 1997"
23,1,1,42,334,293,627,"6 de julio de 1997"
23,1,1,43,413,337,750,"6 de julio de 1997"
23,1,1,44,583,485,1068,"6 de julio de 1997"
23,1,1,45,564,579,1143,"6 de julio de 1997"
23,1,1,46,606,547,1153,"6 de julio de 1997"
23,1,1,47,540,493,1033,"6 de julio de 1997"
23,1,1,48,465,461,926,"6 de julio de 1997"
23,1,1,49,471,433,904,"6 de julio de 1997"
23,1,1,50,657,647,1304,"6 de julio de 1997"
23,1,1,51,419,388,807,"6 de julio de 1997"
23,1,1,52,519,480,999,"6 de julio de 1997"
23,1,1,53,850,776,1626,"6 de julio de 1997"
23,1,1,54,874,775,1649,"6 de julio de 1997"
23,1,1,55,501,455,956,"6 de julio de 1997"
23,1,1,56,468,402,870,"6 de julio de 1997"
23,1,1,57,323,337,660,"6 de julio de 1997"
23,1,1,58,260,266,526,"6 de julio de 1997"
23,1,1,59,261,248,509,"6 de julio de 1997"
23,1,1,60,185,187,372,"6 de julio de 1997"
23,1,1,61,358,339,697,"6 de julio de 1997"
23,1,1,62,353,325,678,"6 de julio de 1997"
23,1,1,63,347,316,663,"6 de julio de 1997"
23,1,1,64,404,346,750,"6 de julio de 1997"
23,1,1,65,588,515,1103,"6 de julio de 1997"
23,1,1,66,367,251,618,"6 de julio de 1997"
23,1,1,67,399,264,663,"6 de julio de 1997"
23,1,1,68,482,320,802,"6 de julio de 1997"
23,1,1,69,418,334,752,"6 de julio de 1997"
23,1,1,70,408,345,753,"6 de julio de 1997"
23,1,1,71,454,427,881,"6 de julio de 1997"
23,1,1,72,762,707,1469,"6 de julio de 1997"
23,1,1,73,736,666,1402,"6 de julio de 1997"
23,1,1,74,587,530,1117,"6 de julio de 1997"
23,1,1,75,427,381,808,"6 de julio de 1997"
23,1,1,76,436,468,904,"6 de julio de 1997"
23,1,1,77,229,233,462,"6 de julio de 1997"
23,1,1,78,121,121,242,"6 de julio de 1997"
23,1,1,79,386,349,735,"6 de julio de 1997"
23,1,1,80,318,318,636,"6 de julio de 1997"
23,1,1,81,437,332,769,"6 de julio de 1997"
23,1,1,82,345,309,654,"6 de julio de 1997"
23,1,1,83,542,386,928,"6 de julio de 1997"
23,1,1,84,559,331,890,"6 de julio de 1997"
23,1,1,85,406,271,677,"6 de julio de 1997"
23,1,1,86,433,359,792,"6 de julio de 1997"
23,1,1,87,365,296,661,"6 de julio de 1997"
23,1,1,88,366,278,644,"6 de julio de 1997"
23,1,1,89,302,231,533,"6 de julio de 1997"
23,1,1,90,560,536,1096,"6 de julio de 1997"
23,1,1,91,567,544,1111,"6 de julio de 1997"
23,1,1,92,354,310,664,"6 de julio de 1997"
23,1,1,93,415,407,822,"6 de julio de 1997"
23,1,1,94,674,684,1358,"6 de julio de 1997"
23,1,1,95,318,273,591,"6 de julio de 1997"
23,1,1,96,330,293,623,"6 de julio de 1997"
23,1,1,97,337,238,575,"6 de julio de 1997"
23,1,1,98,397,324,721,"6 de julio de 1997"
23,1,1,99,321,255,576,"6 de julio de 1997"
23,1,1,100,253,257,510,"6 de julio de 1997"
23,1,1,101,332,267,599,"6 de julio de 1997"
23,1,1,102,313,289,602,"6 de julio de 1997"
23,1,1,103,160,155,315,"6 de julio de 1997"
23,1,1,104,441,434,875,"6 de julio de 1997"
23,1,1,105,390,425,815,"6 de julio de 1997"
23,1,1,106,311,299,610,"6 de julio de 1997"
23,1,1,107,478,405,883,"6 de julio de 1997"
23,1,1,108,431,330,761,"6 de julio de 1997"
23,1,1,109,518,413,931,"6 de julio de 1997"
23,1,1,110,342,266,608,"6 de julio de 1997"
23,1,1,111,209,185,394,"6 de julio de 1997"
23,1,1,112,263,223,486,"6 de julio de 1997"
23,1,1,113,354,222,576,"6 de julio de 1997"
23,1,1,114,301,196,497,"6 de julio de 1997"
23,1,1,115,349,231,580,"6 de julio de 1997"
23,1,1,116,384,345,729,"6 de julio de 1997"
23,1,1,117,541,520,1061,"6 de julio de 1997"
23,1,1,118,218,204,422,"6 de julio de 1997"
23,1,1,119,178,209,387,"6 de julio de 1997"
23,1,1,120,406,331,737,"6 de julio de 1997"
23,1,1,121,337,321,658,"6 de julio de 1997"
23,1,1,122,304,309,613,"6 de julio de 1997"
23,1,1,123,285,326,611,"6 de julio de 1997"
23,1,1,124,368,393,761,"6 de julio de 1997"
23,1,1,125,346,368,714,"6 de julio de 1997"
23,1,1,126,679,748,1427,"6 de julio de 1997"
23,1,1,127,763,690,1453,"6 de julio de 1997"
23,1,1,128,286,271,557,"6 de julio de 1997"
23,1,1,129,145,160,305,"6 de julio de 1997"
23,1,1,130,219,254,473,"6 de julio de 1997"
23,1,1,131,321,383,704,"6 de julio de 1997"
23,1,1,132,338,367,705,"6 de julio de 1997"
23,1,1,133,378,409,787,"6 de julio de 1997"
23,1,1,134,352,296,648,"6 de julio de 1997"
23,1,1,135,395,335,730,"6 de julio de 1997"
23,1,1,136,245,229,474,"6 de julio de 1997"
23,1,1,137,378,319,697,"6 de julio de 1997"
23,1,1,138,279,264,543,"6 de julio de 1997"
23,1,1,139,348,320,668,"6 de julio de 1997"
23,1,1,140,215,223,438,"6 de julio de 1997"
23,1,1,141,268,250,518,"6 de julio de 1997"
23,1,1,142,249,250,499,"6 de julio de 1997"
23,1,1,143,318,291,609,"6 de julio de 1997"
23,1,1,144,292,241,533,"6 de julio de 1997"
23,1,1,145,235,232,467,"6 de julio de 1997"
23,1,1,146,461,549,1010,"6 de julio de 1997"
23,1,1,147,1105,1191,2296,"6 de julio de 1997"
23,1,1,148,478,415,893,"6 de julio de 1997"
23,1,1,149,85,83,168,"6 de julio de 1997"
23,1,1,150,15,33,48,"6 de julio de 1997"
23,1,1,151,491,470,961,"6 de julio de 1997"
23,1,1,152,625,556,1181,"6 de julio de 1997"
23,1,1,153,534,517,1051,"6 de julio de 1997"
23,1,1,154,987,527,1514,"6 de julio de 1997"
23,1,1,155,444,433,877,"6 de julio de 1997"
23,1,1,156,501,486,987,"6 de julio de 1997"
23,1,1,157,551,530,1081,"6 de julio de 1997"
23,1,1,158,414,388,802,"6 de julio de 1997"
23,1,1,159,548,479,1027,"6 de julio de 1997"
23,1,1,160,1109,1148,2257,"6 de julio de 1997"
23,1,1,161,496,586,1082,"6 de julio de 1997"
23,1,1,162,189,175,364,"6 de julio de 1997"
23,1,1,163,816,765,1581,"6 de julio de 1997"
23,1,1,164,520,533,1053,"6 de julio de 1997"
23,1,1,165,371,372,743,"6 de julio de 1997"
23,1,1,166,600,583,1183,"6 de julio de 1997"
23,1,1,167,549,484,1033,"6 de julio de 1997"
23,1,1,168,602,623,1225,"6 de julio de 1997"
23,1,1,169,225,134,359,"6 de julio de 1997"
23,1,1,170,309,324,633,"6 de julio de 1997"
23,1,1,171,56,37,93,"6 de julio de 1997"
23,1,1,172,16,14,30,"6 de julio de 1997"
23,1,1,173,669,584,1253,"6 de julio de 1997"
23,1,1,174,407,366,773,"6 de julio de 1997"
23,1,1,175,438,370,808,"6 de julio de 1997"
23,1,1,176,27,16,43,"6 de julio de 1997"
23,1,1,177,430,377,807,"6 de julio de 1997"
23,1,1,178,338,266,604,"6 de julio de 1997"
23,1,1,179,300,252,552,"6 de julio de 1997"
23,1,1,180,321,263,584,"6 de julio de 1997"
23,1,1,181,441,379,820,"6 de julio de 1997"
23,1,2,182,651,541,1192,"6 de julio de 1997"
23,1,2,183,676,593,1269,"6 de julio de 1997"
23,1,2,184,691,596,1287,"6 de julio de 1997"
23,1,2,185,652,593,1245,"6 de julio de 1997"
23,1,2,186,265,263,528,"6 de julio de 1997"
23,1,2,187,469,399,868,"6 de julio de 1997"
23,1,2,188,663,547,1210,"6 de julio de 1997"
23,1,2,189,655,602,1257,"6 de julio de 1997"
23,1,2,190,632,548,1180,"6 de julio de 1997"
23,1,2,191,447,406,853,"6 de julio de 1997"
23,1,2,192,547,533,1080,"6 de julio de 1997"
23,1,2,193,616,521,1137,"6 de julio de 1997"
23,1,2,194,494,433,927,"6 de julio de 1997"
23,1,2,195,489,432,921,"6 de julio de 1997"
23,1,2,196,372,388,760,"6 de julio de 1997"
23,1,2,197,697,681,1378,"6 de julio de 1997"
23,1,2,198,829,629,1458,"6 de julio de 1997"
23,1,2,199,586,529,1115,"6 de julio de 1997"
23,1,2,200,634,553,1187,"6 de julio de 1997"
23,1,2,201,577,494,1071,"6 de julio de 1997"
23,1,2,202,692,642,1334,"6 de julio de 1997"
23,1,2,203,1303,1168,2471,"6 de julio de 1997"
23,1,4,252,457,373,830,"6 de julio de 1997"
23,1,4,253,694,337,1031,"6 de julio de 1997"
23,1,4,254,215,197,412,"6 de julio de 1997"
23,1,4,255,397,359,756,"6 de julio de 1997"
23,1,4,256,241,211,452,"6 de julio de 1997"
23,1,4,257,254,222,476,"6 de julio de 1997"
23,1,4,258,609,526,1135,"6 de julio de 1997"
23,1,4,259,181,145,326,"6 de julio de 1997"
23,1,4,260,38,21,59,"6 de julio de 1997"
23,1,4,261,171,115,286,"6 de julio de 1997"
23,1,6,284,363,282,645,"6 de julio de 1997"
23,1,6,285,367,322,689,"6 de julio de 1997"
23,1,6,286,693,612,1305,"6 de julio de 1997"
23,1,6,287,346,253,599,"6 de julio de 1997"
23,1,6,288,435,342,777,"6 de julio de 1997"
23,1,6,289,193,155,348,"6 de julio de 1997"
23,1,6,290,445,386,831,"6 de julio de 1997"
23,1,6,291,274,219,493,"6 de julio de 1997"
23,1,6,292,413,368,781,"6 de julio de 1997"
23,1,6,293,350,321,671,"6 de julio de 1997"
23,1,6,294,220,187,407,"6 de julio de 1997"
23,1,6,295,223,196,419,"6 de julio de 1997"
23,1,6,296,356,273,629,"6 de julio de 1997"
23,1,6,297,176,138,314,"6 de julio de 1997"
23,1,8,204,2177,1950,4127,"6 de julio de 1997"
23,1,8,205,1011,690,1701,"6 de julio de 1997"
23,1,8,206,982,627,1609,"6 de julio de 1997"
23,1,8,207,1061,647,1708,"6 de julio de 1997"
23,1,8,208,366,231,597,"6 de julio de 1997"
23,1,8,209,930,686,1616,"6 de julio de 1997"
23,1,8,210,381,310,691,"6 de julio de 1997"
23,1,8,211,588,565,1153,"6 de julio de 1997"
23,1,8,212,34,36,70,"6 de julio de 1997"
23,1,8,213,36,15,51,"6 de julio de 1997"
23,1,8,214,116,83,199,"6 de julio de 1997"
23,2,3,215,318,299,617,"6 de julio de 1997"
23,2,3,216,220,221,441,"6 de julio de 1997"
23,2,3,217,197,236,433,"6 de julio de 1997"
23,2,3,218,505,533,1038,"6 de julio de 1997"
23,2,3,219,181,186,367,"6 de julio de 1997"
23,2,3,220,320,289,609,"6 de julio de 1997"
23,2,3,221,385,390,775,"6 de julio de 1997"
23,2,3,222,581,596,1177,"6 de julio de 1997"
23,2,3,223,307,333,640,"6 de julio de 1997"
23,2,3,224,302,270,572,"6 de julio de 1997"
23,2,3,225,415,412,827,"6 de julio de 1997"
23,2,3,226,294,285,579,"6 de julio de 1997"
23,2,3,227,550,532,1082,"6 de julio de 1997"
23,2,3,228,414,380,794,"6 de julio de 1997"
23,2,3,229,501,487,988,"6 de julio de 1997"
23,2,3,230,210,159,369,"6 de julio de 1997"
23,2,3,231,276,230,506,"6 de julio de 1997"
23,2,3,232,486,422,908,"6 de julio de 1997"
23,2,3,233,285,239,524,"6 de julio de 1997"
23,2,3,234,740,640,1380,"6 de julio de 1997"
23,2,3,235,410,352,762,"6 de julio de 1997"
23,2,3,236,30,31,61,"6 de julio de 1997"
23,2,3,237,293,273,566,"6 de julio de 1997"
23,2,3,238,496,460,956,"6 de julio de 1997"
23,2,3,239,517,453,970,"6 de julio de 1997"
23,2,3,240,292,245,537,"6 de julio de 1997"
23,2,3,241,589,554,1143,"6 de julio de 1997"
23,2,3,242,418,373,791,"6 de julio de 1997"
23,2,3,243,160,113,273,"6 de julio de 1997"
23,2,3,244,450,388,838,"6 de julio de 1997"
23,2,3,245,202,173,375,"6 de julio de 1997"
23,2,3,246,13,4,17,"6 de julio de 1997"
23,2,3,247,636,520,1156,"6 de julio de 1997"
23,2,3,248,124,90,214,"6 de julio de 1997"
23,2,3,249,636,521,1157,"6 de julio de 1997"
23,2,3,250,272,230,502,"6 de julio de 1997"
23,2,3,251,546,482,1028,"6 de julio de 1997"
23,2,5,262,520,462,982,"6 de julio de 1997"
23,2,5,263,424,360,784,"6 de julio de 1997"
23,2,5,264,466,431,897,"6 de julio de 1997"
23,2,5,265,590,522,1112,"6 de julio de 1997"
23,2,5,266,281,249,530,"6 de julio de 1997"
23,2,5,267,225,170,395,"6 de julio de 1997"
23,2,5,268,631,573,1204,"6 de julio de 1997"
23,2,5,269,296,231,527,"6 de julio de 1997"
23,2,5,270,436,403,839,"6 de julio de 1997"
23,2,5,271,362,334,696,"6 de julio de 1997"
23,2,5,272,199,154,353,"6 de julio de 1997"
23,2,5,273,488,431,919,"6 de julio de 1997"
23,2,5,274,374,350,724,"6 de julio de 1997"
23,2,5,275,365,280,645,"6 de julio de 1997"
23,2,5,276,368,317,685,"6 de julio de 1997"
23,2,5,277,155,103,258,"6 de julio de 1997"
23,2,5,278,254,175,429,"6 de julio de 1997"
23,2,5,279,196,142,338,"6 de julio de 1997"
23,2,5,280,167,123,290,"6 de julio de 1997"
23,2,5,281,72,58,130,"6 de julio de 1997"
23,2,5,282,240,178,418,"6 de julio de 1997"
23,2,5,283,234,159,393,"6 de julio de 1997"
23,2,7,298,139,144,283,"6 de julio de 1997"
23,2,7,299,99,94,193,"6 de julio de 1997"
23,2,7,300,398,464,862,"6 de julio de 1997"
23,2,7,301,49,75,124,"6 de julio de 1997"
23,2,7,302,260,285,545,"6 de julio de 1997"
23,2,7,303,456,443,899,"6 de julio de 1997"
23,2,7,304,434,429,863,"6 de julio de 1997"
23,2,7,305,376,406,782,"6 de julio de 1997"
23,2,7,306,340,365,705,"6 de julio de 1997"
23,2,7,307,953,1003,1956,"6 de julio de 1997"
23,2,7,308,455,458,913,"6 de julio de 1997"
23,2,7,309,592,616,1208,"6 de julio de 1997"
23,2,7,310,572,565,1137,"6 de julio de 1997"
23,2,7,311,563,562,1125,"6 de julio de 1997"
23,2,7,312,521,529,1050,"6 de julio de 1997"
23,2,7,313,213,242,455,"6 de julio de 1997"
23,2,7,314,241,231,472,"6 de julio de 1997"
23,2,7,315,570,561,1131,"6 de julio de 1997"
23,2,7,316,131,1,132,"6 de julio de 1997"
23,2,7,317,289,296,585,"6 de julio de 1997"
23,2,7,318,472,465,937,"6 de julio de 1997"
23,2,7,319,294,349,643,"6 de julio de 1997"
23,2,7,320,306,396,702,"6 de julio de 1997"
23,2,7,321,257,308,565,"6 de julio de 1997"
23,2,7,322,205,224,429,"6 de julio de 1997"
23,2,7,323,329,347,676,"6 de julio de 1997"
23,2,7,324,82,86,168,"6 de julio de 1997"
23,2,7,325,376,395,771,"6 de julio de 1997"
23,2,7,326,523,561,1084,"6 de julio de 1997"
23,2,7,327,324,354,678,"6 de julio de 1997"
23,2,7,328,357,434,791,"6 de julio de 1997"
23,2,7,329,401,377,778,"6 de julio de 1997"
23,2,7,330,570,620,1190,"6 de julio de 1997"
23,2,7,331,374,397,771,"6 de julio de 1997"
23,2,7,332,384,438,822,"6 de julio de 1997"
23,2,7,333,473,535,1008,"6 de julio de 1997"
23,2,7,334,420,443,863,"6 de julio de 1997"
23,2,7,335,449,475,924,"6 de julio de 1997"
23,2,7,336,246,258,504,"6 de julio de 1997"
23,2,7,337,323,337,660,"6 de julio de 1997"
23,2,7,338,312,337,649,"6 de julio de 1997"
23,2,7,339,339,353,692,"6 de julio de 1997"
23,2,7,340,168,186,354,"6 de julio de 1997"
23,2,7,341,242,280,522,"6 de julio de 1997"
23,2,7,342,387,411,798,"6 de julio de 1997"
23,2,7,343,509,551,1060,"6 de julio de 1997"
23,2,7,344,536,487,1023,"6 de julio de 1997"
23,2,7,345,299,295,594,"6 de julio de 1997"
23,2,7,346,479,447,926,"6 de julio de 1997"
23,2,7,347,575,636,1211,"6 de julio de 1997"
23,2,7,348,348,373,721,"6 de julio de 1997"
23,2,7,349,372,416,788,"6 de julio de 1997"
23,2,7,350,170,172,342,"6 de julio de 1997"
23,2,7,351,156,155,311,"6 de julio de 1997"
23,2,7,352,311,375,686,"6 de julio de 1997"
23,2,7,353,423,400,823,"6 de julio de 1997"
23,2,7,354,413,462,875,"6 de julio de 1997"
23,2,7,355,301,302,603,"6 de julio de 1997"
23,2,7,356,294,311,605,"6 de julio de 1997"
23,2,7,357,530,593,1123,"6 de julio de 1997"
23,2,7,358,411,418,829,"6 de julio de 1997"
23,2,7,359,427,462,889,"6 de julio de 1997"
23,2,7,360,268,277,545,"6 de julio de 1997"
23,2,7,361,477,463,940,"6 de julio de 1997"
23,2,7,362,337,371,708,"6 de julio de 1997"
23,2,7,363,491,543,1034,"6 de julio de 1997"
23,2,7,364,293,307,600,"6 de julio de 1997"
23,2,7,365,534,605,1139,"6 de julio de 1997"
23,2,7,366,321,321,642,"6 de julio de 1997"
23,2,7,367,339,394,733,"6 de julio de 1997"
23,2,7,368,467,480,947,"6 de julio de 1997"
23,2,7,369,235,264,499,"6 de julio de 1997"
23,2,7,370,312,317,629,"6 de julio de 1997"
23,2,7,371,630,682,1312,"6 de julio de 1997"
23,2,7,372,231,241,472,"6 de julio de 1997"
23,2,7,373,43,2,45,"6 de julio de 1997"
23,2,7,374,361,365,726,"6 de julio de 1997"
23,2,7,375,499,495,994,"6 de julio de 1997"
23,2,7,376,383,1,384,"6 de julio de 1997"
23,2,7,377,604,779,1383,"6 de julio de 1997"
23,2,7,378,382,428,810,"6 de julio de 1997"
23,2,7,379,331,324,655,"6 de julio de 1997"
23,2,7,380,462,458,920,"6 de julio de 1997"
23,2,7,381,263,272,535,"6 de julio de 1997"
23,2,7,382,452,463,915,"6 de julio de 1997"
23,2,7,383,374,362,736,"6 de julio de 1997"
23,2,7,384,306,249,555,"6 de julio de 1997"
23,2,7,385,409,332,741,"6 de julio de 1997"
23,2,7,386,187,159,346,"6 de julio de 1997"
23,2,7,387,270,187,457,"6 de julio de 1997"
23,2,7,388,171,143,314,"6 de julio de 1997"
23,2,7,389,245,215,460,"6 de julio de 1997"
23,2,7,390,215,197,412,"6 de julio de 1997"
23,2,7,391,234,184,418,"6 de julio de 1997"
23,2,7,392,513,409,922,"6 de julio de 1997"
23,2,7,393,31,6,37,"6 de julio de 1997"
23,2,7,394,262,225,487,"6 de julio de 1997"
23,2,7,395,204,169,373,"6 de julio de 1997"
23,2,7,396,162,99,261,"6 de julio de 1997"
23,2,7,397,236,193,429,"6 de julio de 1997"
23,2,7,398,135,108,243,"6 de julio de 1997"
23,2,7,399,55,53,108,"6 de julio de 1997"
23,2,7,400,220,158,378,"6 de julio de 1997"
23,2,7,401,196,151,347,"6 de julio de 1997"
23,2,7,402,264,203,467,"6 de julio de 1997"
23,2,7,403,439,351,790,"6 de julio de 1997"
23,2,7,404,338,271,609,"6 de julio de 1997"
23,2,7,405,531,490,1021,"6 de julio de 1997"
23,2,7,406,381,383,764,"6 de julio de 1997"
23,2,7,407,507,467,974,"6 de julio de 1997"
23,2,7,408,550,535,1085,"6 de julio de 1997"
23,2,7,409,291,301,592,"6 de julio de 1997"
23,2,7,410,171,96,267,"6 de julio de 1997"
23,2,7,411,219,178,397,"6 de julio de 1997"
23,2,7,412,227,182,409,"6 de julio de 1997"
23,2,7,413,604,524,1128,"6 de julio de 1997"
23,2,7,414,516,392,908,"6 de julio de 1997"
23,2,7,415,710,557,1267,"6 de julio de 1997"
23,2,7,416,264,221,485,"6 de julio de 1997"
23,2,7,417,491,389,880,"6 de julio de 1997"
23,2,7,418,534,429,963,"6 de julio de 1997"
23,2,7,419,563,459,1022,"6 de julio de 1997"
23,2,7,420,510,394,904,"6 de julio de 1997"
23,2,7,421,415,349,764,"6 de julio de 1997"
23,2,7,422,498,430,928,"6 de julio de 1997"
23,2,7,423,545,453,998,"6 de julio de 1997"
23,2,7,424,309,291,600,"6 de julio de 1997"
23,2,7,425,512,460,972,"6 de julio de 1997"
23,2,7,426,404,369,773,"6 de julio de 1997"
23,2,7,427,452,467,919,"6 de julio de 1997"
23,2,7,428,341,354,695,"6 de julio de 1997"
23,2,7,429,719,540,1259,"6 de julio de 1997"
23,2,7,430,241,161,402,"6 de julio de 1997"
23,2,7,431,396,321,717,"6 de julio de 1997"
23,2,7,432,327,256,583,"6 de julio de 1997"
23,2,7,433,556,416,972,"6 de julio de 1997"
23,2,7,434,49,34,83,"6 de julio de 1997"
23,2,7,435,253,205,458,"6 de julio de 1997"
23,2,7,436,282,203,485,"6 de julio de 1997"
23,2,7,437,616,520,1136,"6 de julio de 1997"
23,2,7,438,522,412,934,"6 de julio de 1997"
23,2,7,439,467,350,817,"6 de julio de 1997"
23,2,7,440,258,212,470,"6 de julio de 1997"
23,2,7,441,534,398,932,"6 de julio de 1997"
23,2,7,442,104,73,177,"6 de julio de 1997"
23,2,7,443,227,169,396,"6 de julio de 1997"
23,2,7,444,302,240,542,"6 de julio de 1997"
23,2,7,445,83,84,167,"6 de julio de 1997"
23,2,7,446,450,335,785,"6 de julio de 1997"
23,2,7,447,214,142,356,"6 de julio de 1997"
23,2,7,448,420,333,753,"6 de julio de 1997"
23,2,7,449,1348,1538,2886,"6 de julio de 1997"
23,2,7,450,262,247,509,"6 de julio de 1997"
24,1,6,98,277,261,538,"6 de julio de 1997"
24,1,6,99,50,46,96,"6 de julio de 1997"
24,1,6,100,29,25,54,"6 de julio de 1997"
24,1,6,101,106,66,172,"6 de julio de 1997"
24,1,6,102,120,91,211,"6 de julio de 1997"
24,1,6,103,176,156,332,"6 de julio de 1997"
24,1,6,104,30,23,53,"6 de julio de 1997"
24,1,6,105,158,104,262,"6 de julio de 1997"
24,1,6,106,354,330,684,"6 de julio de 1997"
24,1,6,107,81,57,138,"6 de julio de 1997"
24,1,6,108,195,178,373,"6 de julio de 1997"
24,1,6,109,46,51,97,"6 de julio de 1997"
24,1,6,110,83,78,161,"6 de julio de 1997"
24,1,6,111,136,116,252,"6 de julio de 1997"
24,1,6,112,240,234,474,"6 de julio de 1997"
24,1,6,113,124,123,247,"6 de julio de 1997"
24,1,6,114,70,69,139,"6 de julio de 1997"
24,1,6,115,102,94,196,"6 de julio de 1997"
24,1,6,116,167,144,311,"6 de julio de 1997"
24,1,6,117,108,109,217,"6 de julio de 1997"
24,1,6,118,198,166,364,"6 de julio de 1997"
24,1,7,119,695,750,1445,"6 de julio de 1997"
24,1,7,120,520,548,1068,"6 de julio de 1997"
24,1,7,121,566,682,1248,"6 de julio de 1997"
24,1,7,122,474,515,989,"6 de julio de 1997"
24,1,7,123,94,73,167,"6 de julio de 1997"
24,1,7,124,148,122,270,"6 de julio de 1997"
24,1,7,125,205,172,377,"6 de julio de 1997"
24,1,7,126,204,166,370,"6 de julio de 1997"
24,1,7,127,185,146,331,"6 de julio de 1997"
24,1,7,128,212,193,405,"6 de julio de 1997"
24,1,7,129,74,67,141,"6 de julio de 1997"
24,1,7,130,116,94,210,"6 de julio de 1997"
24,1,7,131,318,274,592,"6 de julio de 1997"
24,1,7,132,111,100,211,"6 de julio de 1997"
24,1,7,133,164,142,306,"6 de julio de 1997"
24,1,7,134,144,115,259,"6 de julio de 1997"
24,1,7,135,218,195,413,"6 de julio de 1997"
24,1,15,384,408,413,821,"6 de julio de 1997"
24,1,15,385,204,261,465,"6 de julio de 1997"
24,1,15,386,303,347,650,"6 de julio de 1997"
24,1,15,387,383,398,781,"6 de julio de 1997"
24,1,15,388,349,377,726,"6 de julio de 1997"
24,1,15,389,293,344,637,"6 de julio de 1997"
24,1,15,390,296,323,619,"6 de julio de 1997"
24,1,15,391,360,398,758,"6 de julio de 1997"
24,1,15,392,525,555,1080,"6 de julio de 1997"
24,1,15,393,123,98,221,"6 de julio de 1997"
24,1,15,394,323,252,575,"6 de julio de 1997"
24,1,15,395,148,93,241,"6 de julio de 1997"
24,1,15,396,559,447,1006,"6 de julio de 1997"
24,1,15,397,163,128,291,"6 de julio de 1997"
24,1,15,398,185,169,354,"6 de julio de 1997"
24,1,15,399,93,71,164,"6 de julio de 1997"
24,1,15,400,80,69,149,"6 de julio de 1997"
24,1,15,401,383,339,722,"6 de julio de 1997"
24,1,15,402,449,390,839,"6 de julio de 1997"
24,1,15,403,369,348,717,"6 de julio de 1997"
24,1,15,404,252,206,458,"6 de julio de 1997"
24,1,17,437,247,231,478,"6 de julio de 1997"
24,1,17,438,52,55,107,"6 de julio de 1997"
24,1,17,439,230,237,467,"6 de julio de 1997"
24,1,17,440,237,185,422,"6 de julio de 1997"
24,1,17,441,438,362,800,"6 de julio de 1997"
24,1,17,442,103,103,206,"6 de julio de 1997"
24,1,17,443,277,229,506,"6 de julio de 1997"
24,1,17,444,121,93,214,"6 de julio de 1997"
24,1,17,445,201,181,382,"6 de julio de 1997"
24,1,17,446,263,208,471,"6 de julio de 1997"
24,1,17,447,495,514,1009,"6 de julio de 1997"
24,1,17,448,257,213,470,"6 de julio de 1997"
24,1,17,449,295,247,542,"6 de julio de 1997"
24,1,17,450,303,290,593,"6 de julio de 1997"
24,1,17,451,611,516,1127,"6 de julio de 1997"
24,1,17,452,148,144,292,"6 de julio de 1997"
24,1,17,453,78,69,147,"6 de julio de 1997"
24,1,17,454,303,265,568,"6 de julio de 1997"
24,1,17,455,57,49,106,"6 de julio de 1997"
24,1,17,456,77,64,141,"6 de julio de 1997"
24,1,17,457,168,160,328,"6 de julio de 1997"
24,1,17,458,190,186,376,"6 de julio de 1997"
24,1,17,459,58,52,110,"6 de julio de 1997"
24,1,17,460,87,94,181,"6 de julio de 1997"
24,1,17,461,107,119,226,"6 de julio de 1997"
24,1,17,462,292,303,595,"6 de julio de 1997"
24,1,17,463,292,254,546,"6 de julio de 1997"
24,1,17,464,157,148,305,"6 de julio de 1997"
24,1,17,465,283,361,644,"6 de julio de 1997"
24,1,17,466,470,487,957,"6 de julio de 1997"
24,1,17,467,113,106,219,"6 de julio de 1997"
24,1,20,490,407,467,874,"6 de julio de 1997"
24,1,20,491,346,375,721,"6 de julio de 1997"
24,1,20,492,35,34,69,"6 de julio de 1997"
24,1,20,493,230,294,524,"6 de julio de 1997"
24,1,20,494,244,285,529,"6 de julio de 1997"
24,1,20,495,231,291,522,"6 de julio de 1997"
24,1,20,496,303,378,681,"6 de julio de 1997"
24,1,20,497,242,271,513,"6 de julio de 1997"
24,1,20,498,443,516,959,"6 de julio de 1997"
24,1,20,499,236,267,503,"6 de julio de 1997"
24,1,20,500,116,126,242,"6 de julio de 1997"
24,1,20,501,748,853,1601,"6 de julio de 1997"
24,1,20,502,538,610,1148,"6 de julio de 1997"
24,1,20,503,315,336,651,"6 de julio de 1997"
24,1,20,504,635,687,1322,"6 de julio de 1997"
24,1,20,505,527,620,1147,"6 de julio de 1997"
24,1,20,506,405,526,931,"6 de julio de 1997"
24,1,20,507,524,684,1208,"6 de julio de 1997"
24,1,20,508,463,636,1099,"6 de julio de 1997"
24,1,20,509,603,710,1313,"6 de julio de 1997"
24,1,20,510,279,330,609,"6 de julio de 1997"
24,1,20,511,565,701,1266,"6 de julio de 1997"
24,1,20,512,472,567,1039,"6 de julio de 1997"
24,1,20,513,527,632,1159,"6 de julio de 1997"
24,1,20,514,278,355,633,"6 de julio de 1997"
24,1,20,515,271,342,613,"6 de julio de 1997"
24,1,20,516,376,464,840,"6 de julio de 1997"
24,1,20,517,485,639,1124,"6 de julio de 1997"
24,1,20,518,590,669,1259,"6 de julio de 1997"
24,1,20,519,372,434,806,"6 de julio de 1997"
24,1,20,520,443,571,1014,"6 de julio de 1997"
24,1,20,521,229,312,541,"6 de julio de 1997"
24,1,20,522,371,442,813,"6 de julio de 1997"
24,1,20,523,404,512,916,"6 de julio de 1997"
24,1,20,524,480,592,1072,"6 de julio de 1997"
24,1,20,525,603,686,1289,"6 de julio de 1997"
24,1,20,526,542,643,1185,"6 de julio de 1997"
24,1,20,527,451,504,955,"6 de julio de 1997"
24,1,20,528,192,194,386,"6 de julio de 1997"
24,1,20,529,217,192,409,"6 de julio de 1997"
24,1,20,530,136,113,249,"6 de julio de 1997"
24,1,20,531,406,404,810,"6 de julio de 1997"
24,1,20,532,292,303,595,"6 de julio de 1997"
24,1,20,533,163,189,352,"6 de julio de 1997"
24,1,20,534,87,93,180,"6 de julio de 1997"
24,1,20,535,68,59,127,"6 de julio de 1997"
24,1,20,536,211,220,431,"6 de julio de 1997"
24,1,20,537,53,39,92,"6 de julio de 1997"
24,1,20,538,57,43,100,"6 de julio de 1997"
24,1,20,539,157,133,290,"6 de julio de 1997"
24,1,20,540,184,205,389,"6 de julio de 1997"
24,1,20,541,169,161,330,"6 de julio de 1997"
24,1,20,542,82,72,154,"6 de julio de 1997"
24,1,20,543,83,70,153,"6 de julio de 1997"
24,1,20,544,164,154,318,"6 de julio de 1997"
24,1,20,545,341,381,722,"6 de julio de 1997"
24,1,20,546,131,120,251,"6 de julio de 1997"
24,1,20,547,184,158,342,"6 de julio de 1997"
24,1,20,548,142,141,283,"6 de julio de 1997"
24,1,20,549,200,198,398,"6 de julio de 1997"
24,1,20,550,142,146,288,"6 de julio de 1997"
24,1,20,551,88,95,183,"6 de julio de 1997"
24,1,20,552,242,210,452,"6 de julio de 1997"
24,1,20,553,304,237,541,"6 de julio de 1997"
24,1,20,554,182,166,348,"6 de julio de 1997"
24,1,22,591,216,268,484,"6 de julio de 1997"
24,1,22,592,354,397,751,"6 de julio de 1997"
24,1,22,593,475,533,1008,"6 de julio de 1997"
24,1,22,594,55,49,104,"6 de julio de 1997"
24,1,22,595,40,21,61,"6 de julio de 1997"
24,1,22,596,82,79,161,"6 de julio de 1997"
24,1,22,597,156,147,303,"6 de julio de 1997"
24,1,22,598,200,173,373,"6 de julio de 1997"
24,1,22,599,113,109,222,"6 de julio de 1997"
24,1,22,600,141,129,270,"6 de julio de 1997"
24,1,22,601,263,259,522,"6 de julio de 1997"
24,1,22,602,110,118,228,"6 de julio de 1997"
24,1,22,603,146,140,286,"6 de julio de 1997"
24,1,22,604,165,161,326,"6 de julio de 1997"
24,1,22,605,164,150,314,"6 de julio de 1997"
24,1,22,606,234,272,506,"6 de julio de 1997"
24,1,22,607,280,288,568,"6 de julio de 1997"
24,1,22,608,264,260,524,"6 de julio de 1997"
24,1,22,609,223,248,471,"6 de julio de 1997"
24,1,22,610,150,166,316,"6 de julio de 1997"
24,1,22,611,155,187,342,"6 de julio de 1997"
24,1,22,612,203,215,418,"6 de julio de 1997"
24,1,22,613,279,321,600,"6 de julio de 1997"
24,1,22,614,84,85,169,"6 de julio de 1997"
24,1,22,615,146,191,337,"6 de julio de 1997"
24,1,25,724,524,557,1081,"6 de julio de 1997"
24,1,25,725,525,611,1136,"6 de julio de 1997"
24,1,25,726,351,386,737,"6 de julio de 1997"
24,1,25,727,300,338,638,"6 de julio de 1997"
24,1,25,728,443,537,980,"6 de julio de 1997"
24,1,25,729,254,335,589,"6 de julio de 1997"
24,1,25,730,631,776,1407,"6 de julio de 1997"
24,1,25,731,178,183,361,"6 de julio de 1997"
24,1,25,732,119,97,216,"6 de julio de 1997"
24,1,25,733,194,197,391,"6 de julio de 1997"
24,1,25,734,81,61,142,"6 de julio de 1997"
24,1,25,735,255,287,542,"6 de julio de 1997"
24,1,25,736,140,132,272,"6 de julio de 1997"
24,1,25,737,101,83,184,"6 de julio de 1997"
24,1,25,738,72,63,135,"6 de julio de 1997"
24,1,25,739,26,19,45,"6 de julio de 1997"
24,1,25,740,470,485,955,"6 de julio de 1997"
24,1,25,741,104,136,240,"6 de julio de 1997"
24,1,25,742,256,298,554,"6 de julio de 1997"
24,1,25,743,100,79,179,"6 de julio de 1997"
24,1,25,744,143,201,344,"6 de julio de 1997"
24,1,25,745,65,75,140,"6 de julio de 1997"
24,1,25,746,487,468,955,"6 de julio de 1997"
24,1,25,747,179,160,339,"6 de julio de 1997"
24,1,34,1221,216,232,448,"6 de julio de 1997"
24,1,34,1222,50,36,86,"6 de julio de 1997"
24,1,34,1223,176,141,317,"6 de julio de 1997"
24,1,34,1224,74,85,159,"6 de julio de 1997"
24,1,34,1225,134,122,256,"6 de julio de 1997"
24,1,34,1226,187,235,422,"6 de julio de 1997"
24,1,34,1227,179,171,350,"6 de julio de 1997"
24,1,34,1228,129,119,248,"6 de julio de 1997"
24,1,34,1229,212,163,375,"6 de julio de 1997"
24,1,34,1230,76,65,141,"6 de julio de 1997"
24,1,34,1231,70,56,126,"6 de julio de 1997"
24,1,34,1232,64,71,135,"6 de julio de 1997"
24,1,34,1233,152,162,314,"6 de julio de 1997"
24,1,34,1234,131,124,255,"6 de julio de 1997"
24,1,34,1235,103,111,214,"6 de julio de 1997"
24,1,34,1236,124,117,241,"6 de julio de 1997"
24,1,34,1237,243,242,485,"6 de julio de 1997"
24,1,34,1238,678,667,1345,"6 de julio de 1997"
24,1,34,1239,84,72,156,"6 de julio de 1997"
24,1,34,1240,481,392,873,"6 de julio de 1997"
24,1,34,1241,105,105,210,"6 de julio de 1997"
24,1,44,1520,309,324,633,"6 de julio de 1997"
24,1,44,1521,170,165,335,"6 de julio de 1997"
24,1,44,1522,318,337,655,"6 de julio de 1997"
24,1,44,1523,56,44,100,"6 de julio de 1997"
24,1,44,1524,95,65,160,"6 de julio de 1997"
24,1,44,1525,223,161,384,"6 de julio de 1997"
24,1,44,1526,130,106,236,"6 de julio de 1997"
24,1,44,1527,223,160,383,"6 de julio de 1997"
24,1,44,1528,108,98,206,"6 de julio de 1997"
24,1,44,1529,34,36,70,"6 de julio de 1997"
24,1,44,1530,74,64,138,"6 de julio de 1997"
24,1,44,1531,155,126,281,"6 de julio de 1997"
24,1,44,1532,115,98,213,"6 de julio de 1997"
24,1,44,1533,78,73,151,"6 de julio de 1997"
24,1,44,1534,134,122,256,"6 de julio de 1997"
24,1,44,1535,38,24,62,"6 de julio de 1997"
24,1,45,1536,298,326,624,"6 de julio de 1997"
24,1,45,1537,263,278,541,"6 de julio de 1997"
24,1,45,1538,371,426,797,"6 de julio de 1997"
24,1,45,1539,367,442,809,"6 de julio de 1997"
24,1,45,1540,181,160,341,"6 de julio de 1997"
24,1,45,1541,178,163,341,"6 de julio de 1997"
24,1,45,1542,122,90,212,"6 de julio de 1997"
24,1,45,1543,116,98,214,"6 de julio de 1997"
24,1,45,1544,468,438,906,"6 de julio de 1997"
24,1,45,1545,347,334,681,"6 de julio de 1997"
24,1,45,1546,217,199,416,"6 de julio de 1997"
24,1,45,1547,127,159,286,"6 de julio de 1997"
24,1,45,1548,59,67,126,"6 de julio de 1997"
24,1,45,1549,97,97,194,"6 de julio de 1997"
24,1,45,1550,178,168,346,"6 de julio de 1997"
24,1,45,1551,175,156,331,"6 de julio de 1997"
24,1,45,1552,105,121,226,"6 de julio de 1997"
24,1,45,1553,145,144,289,"6 de julio de 1997"
24,1,45,1554,126,114,240,"6 de julio de 1997"
24,1,45,1555,158,127,285,"6 de julio de 1997"
24,1,46,1556,635,654,1289,"6 de julio de 1997"
24,1,46,1557,617,607,1224,"6 de julio de 1997"
24,1,46,1558,379,404,783,"6 de julio de 1997"
24,1,46,1559,82,77,159,"6 de julio de 1997"
24,1,46,1560,79,61,140,"6 de julio de 1997"
24,1,46,1561,277,239,516,"6 de julio de 1997"
24,1,46,1562,166,155,321,"6 de julio de 1997"
24,1,46,1563,110,101,211,"6 de julio de 1997"
24,1,46,1564,177,187,364,"6 de julio de 1997"
24,1,46,1565,480,421,901,"6 de julio de 1997"
24,1,46,1566,116,103,219,"6 de julio de 1997"
24,1,46,1567,321,328,649,"6 de julio de 1997"
24,1,46,1568,129,124,253,"6 de julio de 1997"
24,1,48,1587,327,365,692,"6 de julio de 1997"
24,1,48,1588,212,238,450,"6 de julio de 1997"
24,1,48,1589,105,100,205,"6 de julio de 1997"
24,1,48,1590,249,247,496,"6 de julio de 1997"
24,1,48,1591,96,126,222,"6 de julio de 1997"
24,1,48,1592,33,40,73,"6 de julio de 1997"
24,1,48,1593,149,168,317,"6 de julio de 1997"
24,1,48,1594,54,47,101,"6 de julio de 1997"
24,1,48,1595,39,47,86,"6 de julio de 1997"
24,1,48,1596,166,166,332,"6 de julio de 1997"
24,1,48,1597,192,153,345,"6 de julio de 1997"
24,1,48,1598,408,367,775,"6 de julio de 1997"
24,1,48,1599,227,191,418,"6 de julio de 1997"
24,1,48,1600,95,77,172,"6 de julio de 1997"
24,1,48,1601,354,288,642,"6 de julio de 1997"
24,1,48,1602,118,97,215,"6 de julio de 1997"
24,1,48,1603,121,114,235,"6 de julio de 1997"
24,1,49,1604,89,108,197,"6 de julio de 1997"
24,1,49,1605,405,431,836,"6 de julio de 1997"
24,1,49,1606,232,246,478,"6 de julio de 1997"
24,1,49,1607,226,204,430,"6 de julio de 1997"
24,1,49,1608,174,201,375,"6 de julio de 1997"
24,1,49,1609,115,129,244,"6 de julio de 1997"
24,1,49,1610,177,173,350,"6 de julio de 1997"
24,1,49,1611,133,131,264,"6 de julio de 1997"
24,1,50,1612,450,466,916,"6 de julio de 1997"
24,1,50,1613,518,573,1091,"6 de julio de 1997"
24,1,50,1614,101,82,183,"6 de julio de 1997"
24,1,50,1615,554,512,1066,"6 de julio de 1997"
24,1,50,1616,492,464,956,"6 de julio de 1997"
24,1,50,1617,336,365,701,"6 de julio de 1997"
24,1,50,1618,380,343,723,"6 de julio de 1997"
24,1,50,1619,391,360,751,"6 de julio de 1997"
24,1,50,1620,443,404,847,"6 de julio de 1997"
24,1,50,1621,104,87,191,"6 de julio de 1997"
24,1,50,1622,616,538,1154,"6 de julio de 1997"
24,1,50,1623,589,536,1125,"6 de julio de 1997"
24,1,50,1624,135,131,266,"6 de julio de 1997"
24,1,50,1625,132,122,254,"6 de julio de 1997"
24,1,50,1626,53,51,104,"6 de julio de 1997"
24,1,50,1627,182,195,377,"6 de julio de 1997"
24,1,50,1628,312,378,690,"6 de julio de 1997"
24,1,50,1629,597,695,1292,"6 de julio de 1997"
24,1,50,1630,226,248,474,"6 de julio de 1997"
24,1,50,1631,521,583,1104,"6 de julio de 1997"
24,1,50,1632,369,407,776,"6 de julio de 1997"
24,1,50,1633,302,312,614,"6 de julio de 1997"
24,1,50,1634,106,109,215,"6 de julio de 1997"
24,1,50,1635,96,106,202,"6 de julio de 1997"
24,1,50,1636,9,23,32,"6 de julio de 1997"
24,1,50,1637,67,81,148,"6 de julio de 1997"
24,2,1,1,317,440,757,"6 de julio de 1997"
24,2,1,2,409,503,912,"6 de julio de 1997"
24,2,1,3,117,132,249,"6 de julio de 1997"
24,2,1,4,178,190,368,"6 de julio de 1997"
24,2,1,5,128,135,263,"6 de julio de 1997"
24,2,1,6,475,582,1057,"6 de julio de 1997"
24,2,1,7,410,537,947,"6 de julio de 1997"
24,2,1,8,501,679,1180,"6 de julio de 1997"
24,2,1,9,92,92,184,"6 de julio de 1997"
24,2,1,10,61,76,137,"6 de julio de 1997"
24,2,1,11,424,458,882,"6 de julio de 1997"
24,2,1,12,236,288,524,"6 de julio de 1997"
24,2,1,13,271,326,597,"6 de julio de 1997"
24,2,1,14,589,541,1130,"6 de julio de 1997"
24,2,4,60,156,138,294,"6 de julio de 1997"
24,2,4,61,49,45,94,"6 de julio de 1997"
24,2,4,62,58,48,106,"6 de julio de 1997"
24,2,4,63,32,28,60,"6 de julio de 1997"
24,2,4,64,176,147,323,"6 de julio de 1997"
24,2,4,65,102,89,191,"6 de julio de 1997"
24,2,4,66,50,43,93,"6 de julio de 1997"
24,2,4,67,40,31,71,"6 de julio de 1997"
24,2,4,68,214,230,444,"6 de julio de 1997"
24,2,4,69,87,71,158,"6 de julio de 1997"
24,2,4,70,187,165,352,"6 de julio de 1997"
24,2,4,71,74,79,153,"6 de julio de 1997"
24,2,4,72,73,76,149,"6 de julio de 1997"
24,2,4,73,43,39,82,"6 de julio de 1997"
24,2,4,74,28,27,55,"6 de julio de 1997"
24,2,4,75,41,42,83,"6 de julio de 1997"
24,2,4,76,47,40,87,"6 de julio de 1997"
24,2,4,77,121,107,228,"6 de julio de 1997"
24,2,9,165,96,72,168,"6 de julio de 1997"
24,2,9,166,44,35,79,"6 de julio de 1997"
24,2,9,167,54,56,110,"6 de julio de 1997"
24,2,9,168,33,30,63,"6 de julio de 1997"
24,2,9,169,40,49,89,"6 de julio de 1997"
24,2,9,170,41,23,64,"6 de julio de 1997"
24,2,9,171,345,327,672,"6 de julio de 1997"
24,2,9,172,93,88,181,"6 de julio de 1997"
24,2,21,555,436,424,860,"6 de julio de 1997"
24,2,21,556,547,642,1189,"6 de julio de 1997"
24,2,21,557,240,259,499,"6 de julio de 1997"
24,2,21,558,247,336,583,"6 de julio de 1997"
24,2,21,559,515,666,1181,"6 de julio de 1997"
24,2,21,560,343,381,724,"6 de julio de 1997"
24,2,21,561,388,457,845,"6 de julio de 1997"
24,2,21,562,338,331,669,"6 de julio de 1997"
24,2,21,563,73,66,139,"6 de julio de 1997"
24,2,21,564,123,146,269,"6 de julio de 1997"
24,2,21,565,436,436,872,"6 de julio de 1997"
24,2,21,566,273,305,578,"6 de julio de 1997"
24,2,21,567,115,118,233,"6 de julio de 1997"
24,2,21,568,286,302,588,"6 de julio de 1997"
24,2,21,569,88,79,167,"6 de julio de 1997"
24,2,21,570,202,189,391,"6 de julio de 1997"
24,2,21,571,202,221,423,"6 de julio de 1997"
24,2,21,572,431,418,849,"6 de julio de 1997"
24,2,21,573,475,490,965,"6 de julio de 1997"
24,2,21,574,227,221,448,"6 de julio de 1997"
24,2,21,575,107,115,222,"6 de julio de 1997"
24,2,21,576,108,113,221,"6 de julio de 1997"
24,2,21,577,286,289,575,"6 de julio de 1997"
24,2,21,578,291,287,578,"6 de julio de 1997"
24,2,21,579,306,315,621,"6 de julio de 1997"
24,2,21,580,423,447,870,"6 de julio de 1997"
24,2,21,581,284,287,571,"6 de julio de 1997"
24,2,21,582,310,310,620,"6 de julio de 1997"
24,2,21,583,265,266,531,"6 de julio de 1997"
24,2,21,584,268,248,516,"6 de julio de 1997"
24,2,21,585,256,345,601,"6 de julio de 1997"
24,2,21,586,430,580,1010,"6 de julio de 1997"
24,2,21,587,299,322,621,"6 de julio de 1997"
24,2,21,588,389,419,808,"6 de julio de 1997"
24,2,21,589,382,430,812,"6 de julio de 1997"
24,2,21,590,309,330,639,"6 de julio de 1997"
24,2,33,1188,389,493,882,"6 de julio de 1997"
24,2,33,1189,398,561,959,"6 de julio de 1997"
24,2,33,1190,292,363,655,"6 de julio de 1997"
24,2,33,1191,380,504,884,"6 de julio de 1997"
24,2,33,1192,508,662,1170,"6 de julio de 1997"
24,2,33,1193,584,741,1325,"6 de julio de 1997"
24,2,33,1194,424,455,879,"6 de julio de 1997"
24,2,33,1195,212,222,434,"6 de julio de 1997"
24,2,33,1196,214,252,466,"6 de julio de 1997"
24,2,33,1197,69,67,136,"6 de julio de 1997"
24,2,33,1198,71,57,128,"6 de julio de 1997"
24,2,33,1199,43,40,83,"6 de julio de 1997"
24,2,33,1200,105,137,242,"6 de julio de 1997"
24,2,33,1201,318,365,683,"6 de julio de 1997"
24,2,33,1202,172,191,363,"6 de julio de 1997"
24,2,33,1203,253,296,549,"6 de julio de 1997"
24,2,33,1204,275,306,581,"6 de julio de 1997"
24,2,33,1205,469,509,978,"6 de julio de 1997"
24,2,33,1206,324,384,708,"6 de julio de 1997"
24,2,33,1207,273,294,567,"6 de julio de 1997"
24,2,33,1208,211,230,441,"6 de julio de 1997"
24,2,33,1209,35,35,70,"6 de julio de 1997"
24,2,33,1210,118,131,249,"6 de julio de 1997"
24,2,33,1211,226,245,471,"6 de julio de 1997"
24,2,33,1212,294,268,562,"6 de julio de 1997"
24,2,33,1213,136,139,275,"6 de julio de 1997"
24,2,33,1214,427,466,893,"6 de julio de 1997"
24,2,33,1215,209,193,402,"6 de julio de 1997"
24,2,33,1216,234,231,465,"6 de julio de 1997"
24,2,33,1217,182,208,390,"6 de julio de 1997"
24,2,33,1218,330,348,678,"6 de julio de 1997"
24,2,33,1219,380,402,782,"6 de julio de 1997"
24,2,33,1220,194,221,415,"6 de julio de 1997"
24,2,35,1242,223,253,476,"6 de julio de 1997"
24,2,35,1243,188,223,411,"6 de julio de 1997"
24,2,35,1244,419,483,902,"6 de julio de 1997"
24,2,35,1245,441,510,951,"6 de julio de 1997"
24,2,35,1246,602,730,1332,"6 de julio de 1997"
24,2,35,1247,518,591,1109,"6 de julio de 1997"
24,2,35,1248,724,846,1570,"6 de julio de 1997"
24,2,35,1249,517,591,1108,"6 de julio de 1997"
24,2,35,1250,540,630,1170,"6 de julio de 1997"
24,2,35,1251,535,645,1180,"6 de julio de 1997"
24,2,35,1252,380,485,865,"6 de julio de 1997"
24,2,35,1253,765,992,1757,"6 de julio de 1997"
24,2,35,1254,490,579,1069,"6 de julio de 1997"
24,2,35,1255,431,512,943,"6 de julio de 1997"
24,2,35,1256,694,701,1395,"6 de julio de 1997"
24,2,35,1257,428,519,947,"6 de julio de 1997"
24,2,35,1258,565,644,1209,"6 de julio de 1997"
24,2,35,1259,460,542,1002,"6 de julio de 1997"
24,2,35,1260,556,666,1222,"6 de julio de 1997"
24,2,35,1261,603,765,1368,"6 de julio de 1997"
24,2,35,1262,266,306,572,"6 de julio de 1997"
24,2,35,1263,225,295,520,"6 de julio de 1997"
24,2,35,1264,342,394,736,"6 de julio de 1997"
24,2,35,1265,237,297,534,"6 de julio de 1997"
24,2,35,1266,286,322,608,"6 de julio de 1997"
24,2,35,1267,354,413,767,"6 de julio de 1997"
24,2,35,1268,386,435,821,"6 de julio de 1997"
24,2,35,1269,228,267,495,"6 de julio de 1997"
24,2,35,1270,155,171,326,"6 de julio de 1997"
24,2,35,1271,567,684,1251,"6 de julio de 1997"
24,2,35,1272,647,731,1378,"6 de julio de 1997"
24,2,35,1273,361,416,777,"6 de julio de 1997"
24,2,35,1274,892,948,1840,"6 de julio de 1997"
24,2,35,1275,787,858,1645,"6 de julio de 1997"
24,2,35,1276,765,878,1643,"6 de julio de 1997"
24,2,35,1277,111,139,250,"6 de julio de 1997"
24,2,35,1278,773,926,1699,"6 de julio de 1997"
24,2,35,1279,470,549,1019,"6 de julio de 1997"
24,2,35,1280,636,736,1372,"6 de julio de 1997"
24,2,35,1281,370,475,845,"6 de julio de 1997"
24,2,35,1282,683,764,1447,"6 de julio de 1997"
24,2,35,1283,723,795,1518,"6 de julio de 1997"
24,2,35,1284,442,543,985,"6 de julio de 1997"
24,2,35,1285,597,684,1281,"6 de julio de 1997"
24,2,35,1286,667,788,1455,"6 de julio de 1997"
24,2,35,1287,704,802,1506,"6 de julio de 1997"
24,2,35,1288,242,293,535,"6 de julio de 1997"
24,2,35,1289,242,282,524,"6 de julio de 1997"
24,2,35,1290,479,608,1087,"6 de julio de 1997"
24,2,35,1291,842,932,1774,"6 de julio de 1997"
24,2,35,1292,809,906,1715,"6 de julio de 1997"
24,2,35,1293,961,1107,2068,"6 de julio de 1997"
24,2,35,1294,850,904,1754,"6 de julio de 1997"
24,2,35,1295,610,624,1234,"6 de julio de 1997"
24,2,35,1296,615,661,1276,"6 de julio de 1997"
24,2,35,1297,710,757,1467,"6 de julio de 1997"
24,2,35,1298,560,698,1258,"6 de julio de 1997"
24,2,35,1299,760,886,1646,"6 de julio de 1997"
24,2,35,1300,609,726,1335,"6 de julio de 1997"
24,2,35,1301,552,716,1268,"6 de julio de 1997"
24,2,35,1302,392,435,827,"6 de julio de 1997"
24,2,35,1303,277,324,601,"6 de julio de 1997"
24,2,35,1304,1218,1442,2660,"6 de julio de 1997"
24,2,35,1305,523,613,1136,"6 de julio de 1997"
24,2,35,1306,426,495,921,"6 de julio de 1997"
24,2,35,1307,203,256,459,"6 de julio de 1997"
24,2,35,1308,195,260,455,"6 de julio de 1997"
24,2,35,1309,140,139,279,"6 de julio de 1997"
24,2,35,1310,249,290,539,"6 de julio de 1997"
24,2,35,1311,158,156,314,"6 de julio de 1997"
24,2,35,1312,369,502,871,"6 de julio de 1997"
24,2,35,1313,225,305,530,"6 de julio de 1997"
24,2,35,1314,632,715,1347,"6 de julio de 1997"
24,2,35,1315,117,116,233,"6 de julio de 1997"
24,2,35,1316,375,430,805,"6 de julio de 1997"
24,2,35,1317,233,233,466,"6 de julio de 1997"
24,2,35,1318,371,433,804,"6 de julio de 1997"
24,2,43,1507,192,220,412,"6 de julio de 1997"
24,2,43,1508,347,426,773,"6 de julio de 1997"
24,2,43,1509,335,471,806,"6 de julio de 1997"
24,2,43,1510,197,249,446,"6 de julio de 1997"
24,2,43,1511,358,471,829,"6 de julio de 1997"
24,2,43,1512,265,300,565,"6 de julio de 1997"
24,2,43,1513,128,142,270,"6 de julio de 1997"
24,2,43,1514,117,117,234,"6 de julio de 1997"
24,2,43,1515,99,83,182,"6 de julio de 1997"
24,2,43,1516,101,105,206,"6 de julio de 1997"
24,2,43,1517,61,61,122,"6 de julio de 1997"
24,2,43,1518,41,44,85,"6 de julio de 1997"
24,2,43,1519,26,27,53,"6 de julio de 1997"
24,2,47,1569,377,423,800,"6 de julio de 1997"
24,2,47,1570,370,391,761,"6 de julio de 1997"
24,2,47,1571,313,342,655,"6 de julio de 1997"
24,2,47,1572,156,143,299,"6 de julio de 1997"
24,2,47,1573,52,61,113,"6 de julio de 1997"
24,2,47,1574,178,167,345,"6 de julio de 1997"
24,2,47,1575,313,293,606,"6 de julio de 1997"
24,2,47,1576,350,291,641,"6 de julio de 1997"
24,2,47,1577,98,91,189,"6 de julio de 1997"
24,2,47,1578,111,92,203,"6 de julio de 1997"
24,2,47,1579,352,331,683,"6 de julio de 1997"
24,2,47,1580,137,114,251,"6 de julio de 1997"
24,2,47,1581,258,248,506,"6 de julio de 1997"
24,2,47,1582,90,59,149,"6 de julio de 1997"
24,2,47,1583,85,78,163,"6 de julio de 1997"
24,2,47,1584,169,159,328,"6 de julio de 1997"
24,2,47,1585,85,85,170,"6 de julio de 1997"
24,2,47,1586,76,87,163,"6 de julio de 1997"
24,2,51,1638,309,307,616,"6 de julio de 1997"
24,2,51,1639,337,372,709,"6 de julio de 1997"
24,2,51,1640,251,274,525,"6 de julio de 1997"
24,2,51,1641,359,389,748,"6 de julio de 1997"
24,2,51,1642,314,360,674,"6 de julio de 1997"
24,2,51,1643,396,394,790,"6 de julio de 1997"
24,2,51,1644,89,66,155,"6 de julio de 1997"
24,2,51,1645,598,677,1275,"6 de julio de 1997"
24,2,51,1646,384,419,803,"6 de julio de 1997"
24,2,51,1647,273,278,551,"6 de julio de 1997"
24,2,51,1648,291,267,558,"6 de julio de 1997"
24,2,51,1649,188,213,401,"6 de julio de 1997"
24,2,51,1650,46,51,97,"6 de julio de 1997"
24,2,51,1651,142,143,285,"6 de julio de 1997"
24,2,51,1652,502,572,1074,"6 de julio de 1997"
24,2,51,1653,598,611,1209,"6 de julio de 1997"
24,2,51,1654,179,183,362,"6 de julio de 1997"
24,2,51,1655,353,334,687,"6 de julio de 1997"
24,2,51,1656,262,253,515,"6 de julio de 1997"
24,2,51,1657,158,159,317,"6 de julio de 1997"
24,2,51,1658,305,297,602,"6 de julio de 1997"
24,2,51,1659,336,354,690,"6 de julio de 1997"
24,2,51,1660,239,227,466,"6 de julio de 1997"
24,2,51,1661,290,297,587,"6 de julio de 1997"
24,2,51,1662,97,103,200,"6 de julio de 1997"
24,2,51,1663,101,107,208,"6 de julio de 1997"
24,2,51,1664,73,62,135,"6 de julio de 1997"
24,2,51,1665,258,253,511,"6 de julio de 1997"
24,2,51,1666,488,461,949,"6 de julio de 1997"
24,2,51,1667,227,263,490,"6 de julio de 1997"
24,2,51,1668,692,719,1411,"6 de julio de 1997"
24,2,51,1669,133,131,264,"6 de julio de 1997"
24,2,52,1670,324,383,707,"6 de julio de 1997"
24,2,52,1671,307,347,654,"6 de julio de 1997"
24,2,52,1672,250,296,546,"6 de julio de 1997"
24,2,52,1673,263,231,494,"6 de julio de 1997"
24,2,52,1674,387,303,690,"6 de julio de 1997"
24,2,52,1675,258,262,520,"6 de julio de 1997"
24,2,52,1676,205,235,440,"6 de julio de 1997"
24,2,52,1677,247,245,492,"6 de julio de 1997"
24,2,52,1678,93,88,181,"6 de julio de 1997"
24,2,52,1679,190,191,381,"6 de julio de 1997"
24,2,52,1680,415,428,843,"6 de julio de 1997"
24,2,52,1681,116,109,225,"6 de julio de 1997"
24,2,52,1682,122,124,246,"6 de julio de 1997"
24,2,52,1683,169,190,359,"6 de julio de 1997"
24,2,52,1684,102,105,207,"6 de julio de 1997"
24,2,52,1685,438,436,874,"6 de julio de 1997"
24,2,52,1686,180,165,345,"6 de julio de 1997"
24,2,52,1687,180,158,338,"6 de julio de 1997"
24,2,52,1688,121,124,245,"6 de julio de 1997"
24,2,56,1773,525,557,1082,"6 de julio de 1997"
24,2,56,1774,408,385,793,"6 de julio de 1997"
24,2,56,1775,510,557,1067,"6 de julio de 1997"
24,2,56,1776,753,663,1416,"6 de julio de 1997"
24,2,56,1777,79,67,146,"6 de julio de 1997"
24,2,56,1778,140,156,296,"6 de julio de 1997"
24,2,56,1779,297,343,640,"6 de julio de 1997"
24,2,56,1780,53,57,110,"6 de julio de 1997"
24,2,56,1781,153,158,311,"6 de julio de 1997"
24,2,56,1782,80,85,165,"6 de julio de 1997"
24,2,56,1783,122,142,264,"6 de julio de 1997"
24,2,56,1784,162,167,329,"6 de julio de 1997"
24,2,56,1785,176,175,351,"6 de julio de 1997"
24,2,56,1786,114,108,222,"6 de julio de 1997"
24,2,56,1787,310,327,637,"6 de julio de 1997"
24,2,56,1788,98,82,180,"6 de julio de 1997"
24,2,56,1789,58,63,121,"6 de julio de 1997"
24,2,56,1790,180,159,339,"6 de julio de 1997"
24,2,56,1791,80,99,179,"6 de julio de 1997"
24,2,56,1792,123,149,272,"6 de julio de 1997"
24,2,56,1793,180,183,363,"6 de julio de 1997"
24,2,56,1794,69,87,156,"6 de julio de 1997"
24,2,56,1795,131,130,261,"6 de julio de 1997"
24,3,2,15,120,129,249,"6 de julio de 1997"
24,3,2,16,105,104,209,"6 de julio de 1997"
24,3,2,17,92,108,200,"6 de julio de 1997"
24,3,2,18,58,65,123,"6 de julio de 1997"
24,3,2,19,132,121,253,"6 de julio de 1997"
24,3,2,20,75,68,143,"6 de julio de 1997"
24,3,2,21,66,64,130,"6 de julio de 1997"
24,3,2,22,93,99,192,"6 de julio de 1997"
24,3,2,23,220,205,425,"6 de julio de 1997"
24,3,2,24,53,51,104,"6 de julio de 1997"
24,3,2,25,44,37,81,"6 de julio de 1997"
24,3,2,26,311,338,649,"6 de julio de 1997"
24,3,2,27,47,63,110,"6 de julio de 1997"
24,3,2,28,243,273,516,"6 de julio de 1997"
24,3,2,29,61,71,132,"6 de julio de 1997"
24,3,2,30,182,179,361,"6 de julio de 1997"
24,3,2,31,137,120,257,"6 de julio de 1997"
24,3,2,32,165,132,297,"6 de julio de 1997"
24,3,2,33,106,92,198,"6 de julio de 1997"
24,3,5,78,188,213,401,"6 de julio de 1997"
24,3,5,79,484,556,1040,"6 de julio de 1997"
24,3,5,80,379,471,850,"6 de julio de 1997"
24,3,5,81,283,324,607,"6 de julio de 1997"
24,3,5,82,205,260,465,"6 de julio de 1997"
24,3,5,83,297,356,653,"6 de julio de 1997"
24,3,5,84,405,488,893,"6 de julio de 1997"
24,3,5,85,468,530,998,"6 de julio de 1997"
24,3,5,86,269,283,552,"6 de julio de 1997"
24,3,5,87,198,260,458,"6 de julio de 1997"
24,3,5,88,223,251,474,"6 de julio de 1997"
24,3,5,89,198,276,474,"6 de julio de 1997"
24,3,5,90,359,401,760,"6 de julio de 1997"
24,3,5,91,136,135,271,"6 de julio de 1997"
24,3,5,92,123,106,229,"6 de julio de 1997"
24,3,5,93,305,307,612,"6 de julio de 1997"
24,3,5,94,122,124,246,"6 de julio de 1997"
24,3,5,95,158,206,364,"6 de julio de 1997"
24,3,5,96,125,124,249,"6 de julio de 1997"
24,3,5,97,90,107,197,"6 de julio de 1997"
24,3,8,136,233,308,541,"6 de julio de 1997"
24,3,8,137,375,463,838,"6 de julio de 1997"
24,3,8,138,236,279,515,"6 de julio de 1997"
24,3,8,139,395,455,850,"6 de julio de 1997"
24,3,8,140,364,427,791,"6 de julio de 1997"
24,3,8,141,441,573,1014,"6 de julio de 1997"
24,3,8,142,302,384,686,"6 de julio de 1997"
24,3,8,143,542,630,1172,"6 de julio de 1997"
24,3,8,144,523,568,1091,"6 de julio de 1997"
24,3,8,145,81,76,157,"6 de julio de 1997"
24,3,8,146,34,43,77,"6 de julio de 1997"
24,3,8,147,202,206,408,"6 de julio de 1997"
24,3,8,148,137,169,306,"6 de julio de 1997"
24,3,8,149,94,84,178,"6 de julio de 1997"
24,3,8,150,69,67,136,"6 de julio de 1997"
24,3,8,151,45,60,105,"6 de julio de 1997"
24,3,8,152,284,298,582,"6 de julio de 1997"
24,3,8,153,89,101,190,"6 de julio de 1997"
24,3,8,154,60,63,123,"6 de julio de 1997"
24,3,8,155,121,124,245,"6 de julio de 1997"
24,3,8,156,272,301,573,"6 de julio de 1997"
24,3,8,157,56,47,103,"6 de julio de 1997"
24,3,8,158,181,228,409,"6 de julio de 1997"
24,3,8,159,37,43,80,"6 de julio de 1997"
24,3,8,160,87,73,160,"6 de julio de 1997"
24,3,8,161,160,169,329,"6 de julio de 1997"
24,3,8,162,57,46,103,"6 de julio de 1997"
24,3,8,163,147,171,318,"6 de julio de 1997"
24,3,8,164,54,49,103,"6 de julio de 1997"
24,3,10,173,467,449,916,"6 de julio de 1997"
24,3,10,174,340,357,697,"6 de julio de 1997"
24,3,10,175,418,437,855,"6 de julio de 1997"
24,3,10,176,461,490,951,"6 de julio de 1997"
24,3,10,177,274,287,561,"6 de julio de 1997"
24,3,10,178,162,172,334,"6 de julio de 1997"
24,3,10,179,360,384,744,"6 de julio de 1997"
24,3,10,181,180,153,333,"6 de julio de 1997"
24,3,10,182,480,506,986,"6 de julio de 1997"
24,3,10,183,153,145,298,"6 de julio de 1997"
24,3,10,184,388,346,734,"6 de julio de 1997"
24,3,10,185,358,353,711,"6 de julio de 1997"
24,3,10,196,136,90,226,"6 de julio de 1997"
24,3,10,197,270,212,482,"6 de julio de 1997"
24,3,10,198,452,439,891,"6 de julio de 1997"
24,3,10,199,115,120,235,"6 de julio de 1997"
24,3,10,200,80,82,162,"6 de julio de 1997"
24,3,10,201,537,504,1041,"6 de julio de 1997"
24,3,10,202,463,390,853,"6 de julio de 1997"
24,3,10,206,182,142,324,"6 de julio de 1997"
24,3,10,207,95,74,169,"6 de julio de 1997"
24,3,10,208,214,191,405,"6 de julio de 1997"
24,3,10,209,176,182,358,"6 de julio de 1997"
24,3,10,210,190,146,336,"6 de julio de 1997"
24,3,10,211,256,223,479,"6 de julio de 1997"
24,3,10,214,232,189,421,"6 de julio de 1997"
24,3,10,215,218,177,395,"6 de julio de 1997"
24,3,10,216,166,171,337,"6 de julio de 1997"
24,3,10,217,429,412,841,"6 de julio de 1997"
24,3,10,218,100,68,168,"6 de julio de 1997"
24,3,11,220,264,321,585,"6 de julio de 1997"
24,3,11,221,386,454,840,"6 de julio de 1997"
24,3,11,222,428,427,855,"6 de julio de 1997"
24,3,11,223,317,384,701,"6 de julio de 1997"
24,3,11,224,382,439,821,"6 de julio de 1997"
24,3,11,225,556,670,1226,"6 de julio de 1997"
24,3,11,226,388,471,859,"6 de julio de 1997"
24,3,11,227,333,363,696,"6 de julio de 1997"
24,3,11,228,578,677,1255,"6 de julio de 1997"
24,3,11,229,259,288,547,"6 de julio de 1997"
24,3,11,230,403,477,880,"6 de julio de 1997"
24,3,11,231,389,487,876,"6 de julio de 1997"
24,3,11,232,471,501,972,"6 de julio de 1997"
24,3,11,233,317,397,714,"6 de julio de 1997"
24,3,11,234,388,391,779,"6 de julio de 1997"
24,3,11,235,88,102,190,"6 de julio de 1997"
24,3,11,236,148,149,297,"6 de julio de 1997"
24,3,11,237,98,90,188,"6 de julio de 1997"
24,3,11,238,93,104,197,"6 de julio de 1997"
24,3,11,239,60,56,116,"6 de julio de 1997"
24,3,11,240,55,62,117,"6 de julio de 1997"
24,3,11,241,301,278,579,"6 de julio de 1997"
24,3,11,242,172,214,386,"6 de julio de 1997"
24,3,11,243,491,560,1051,"6 de julio de 1997"
24,3,11,244,80,106,186,"6 de julio de 1997"
24,3,11,245,291,304,595,"6 de julio de 1997"
24,3,11,246,424,435,859,"6 de julio de 1997"
24,3,11,247,293,331,624,"6 de julio de 1997"
24,3,11,248,186,195,381,"6 de julio de 1997"
24,3,11,249,230,232,462,"6 de julio de 1997"
24,3,11,250,166,186,352,"6 de julio de 1997"
24,3,19,478,74,89,163,"6 de julio de 1997"
24,3,19,479,101,104,205,"6 de julio de 1997"
24,3,19,480,42,64,106,"6 de julio de 1997"
24,3,19,481,240,244,484,"6 de julio de 1997"
24,3,19,482,340,363,703,"6 de julio de 1997"
24,3,19,483,137,142,279,"6 de julio de 1997"
24,3,19,484,70,63,133,"6 de julio de 1997"
24,3,19,485,371,346,717,"6 de julio de 1997"
24,3,19,486,188,173,361,"6 de julio de 1997"
24,3,19,487,92,129,221,"6 de julio de 1997"
24,3,19,488,137,143,280,"6 de julio de 1997"
24,3,19,489,95,86,181,"6 de julio de 1997"
24,3,23,616,532,610,1142,"6 de julio de 1997"
24,3,23,617,460,532,992,"6 de julio de 1997"
24,3,23,618,383,454,837,"6 de julio de 1997"
24,3,23,619,217,236,453,"6 de julio de 1997"
24,3,23,620,222,258,480,"6 de julio de 1997"
24,3,23,621,246,273,519,"6 de julio de 1997"
24,3,23,622,245,224,469,"6 de julio de 1997"
24,3,23,623,421,406,827,"6 de julio de 1997"
24,3,23,624,160,184,344,"6 de julio de 1997"
24,3,23,625,123,126,249,"6 de julio de 1997"
24,3,23,626,251,192,443,"6 de julio de 1997"
24,3,23,627,318,295,613,"6 de julio de 1997"
24,3,23,628,195,193,388,"6 de julio de 1997"
24,3,23,629,72,62,134,"6 de julio de 1997"
24,3,23,630,87,59,146,"6 de julio de 1997"
24,3,23,631,65,73,138,"6 de julio de 1997"
24,3,23,632,60,56,116,"6 de julio de 1997"
24,3,23,633,314,331,645,"6 de julio de 1997"
24,3,24,634,288,324,612,"6 de julio de 1997"
24,3,24,635,223,234,457,"6 de julio de 1997"
24,3,24,636,423,505,928,"6 de julio de 1997"
24,3,24,637,387,461,848,"6 de julio de 1997"
24,3,24,638,705,836,1541,"6 de julio de 1997"
24,3,24,639,370,472,842,"6 de julio de 1997"
24,3,24,640,373,455,828,"6 de julio de 1997"
24,3,24,641,627,782,1409,"6 de julio de 1997"
24,3,24,642,426,501,927,"6 de julio de 1997"
24,3,24,643,381,474,855,"6 de julio de 1997"
24,3,24,644,241,286,527,"6 de julio de 1997"
24,3,24,645,343,422,765,"6 de julio de 1997"
24,3,24,646,470,531,1001,"6 de julio de 1997"
24,3,24,647,407,518,925,"6 de julio de 1997"
24,3,24,648,395,519,914,"6 de julio de 1997"
24,3,24,649,353,419,772,"6 de julio de 1997"
24,3,24,650,460,521,981,"6 de julio de 1997"
24,3,24,651,459,551,1010,"6 de julio de 1997"
24,3,24,652,305,337,642,"6 de julio de 1997"
24,3,24,653,361,423,784,"6 de julio de 1997"
24,3,24,654,317,379,696,"6 de julio de 1997"
24,3,24,655,340,371,711,"6 de julio de 1997"
24,3,24,656,254,276,530,"6 de julio de 1997"
24,3,24,657,584,706,1290,"6 de julio de 1997"
24,3,24,658,468,548,1016,"6 de julio de 1997"
24,3,24,659,518,594,1112,"6 de julio de 1997"
24,3,24,660,369,436,805,"6 de julio de 1997"
24,3,24,661,395,410,805,"6 de julio de 1997"
24,3,24,662,376,380,756,"6 de julio de 1997"
24,3,24,663,247,236,483,"6 de julio de 1997"
24,3,24,664,125,121,246,"6 de julio de 1997"
24,3,24,665,334,315,649,"6 de julio de 1997"
24,3,24,666,305,320,625,"6 de julio de 1997"
24,3,24,667,101,72,173,"6 de julio de 1997"
24,3,24,668,262,224,486,"6 de julio de 1997"
24,3,24,669,36,30,66,"6 de julio de 1997"
24,3,24,670,436,458,894,"6 de julio de 1997"
24,3,24,671,167,162,329,"6 de julio de 1997"
24,3,24,672,121,144,265,"6 de julio de 1997"
24,3,24,673,165,180,345,"6 de julio de 1997"
24,3,24,674,120,114,234,"6 de julio de 1997"
24,3,24,675,161,164,325,"6 de julio de 1997"
24,3,24,676,163,172,335,"6 de julio de 1997"
24,3,24,677,122,130,252,"6 de julio de 1997"
24,3,24,678,208,216,424,"6 de julio de 1997"
24,3,24,679,137,140,277,"6 de julio de 1997"
24,3,24,680,54,62,116,"6 de julio de 1997"
24,3,24,681,238,263,501,"6 de julio de 1997"
24,3,24,682,80,71,151,"6 de julio de 1997"
24,3,24,683,293,332,625,"6 de julio de 1997"
24,3,24,684,154,134,288,"6 de julio de 1997"
24,3,24,685,158,201,359,"6 de julio de 1997"
24,3,24,686,260,291,551,"6 de julio de 1997"
24,3,24,687,76,72,148,"6 de julio de 1997"
24,3,24,688,167,145,312,"6 de julio de 1997"
24,3,24,689,453,428,881,"6 de julio de 1997"
24,3,24,690,199,231,430,"6 de julio de 1997"
24,3,24,691,88,88,176,"6 de julio de 1997"
24,3,24,692,167,162,329,"6 de julio de 1997"
24,3,24,693,185,152,337,"6 de julio de 1997"
24,3,24,694,49,53,102,"6 de julio de 1997"
24,3,24,695,384,427,811,"6 de julio de 1997"
24,3,24,696,549,550,1099,"6 de julio de 1997"
24,3,24,697,424,446,870,"6 de julio de 1997"
24,3,24,698,215,232,447,"6 de julio de 1997"
24,3,24,699,167,194,361,"6 de julio de 1997"
24,3,24,700,256,248,504,"6 de julio de 1997"
24,3,24,701,119,145,264,"6 de julio de 1997"
24,3,24,702,71,68,139,"6 de julio de 1997"
24,3,24,703,151,128,279,"6 de julio de 1997"
24,3,24,704,104,76,180,"6 de julio de 1997"
24,3,24,705,148,170,318,"6 de julio de 1997"
24,3,24,706,570,583,1153,"6 de julio de 1997"
24,3,24,707,155,172,327,"6 de julio de 1997"
24,3,24,708,64,62,126,"6 de julio de 1997"
24,3,24,709,335,330,665,"6 de julio de 1997"
24,3,24,710,83,81,164,"6 de julio de 1997"
24,3,24,711,478,464,942,"6 de julio de 1997"
24,3,24,712,40,45,85,"6 de julio de 1997"
24,3,24,713,186,164,350,"6 de julio de 1997"
24,3,24,714,73,89,162,"6 de julio de 1997"
24,3,24,715,156,136,292,"6 de julio de 1997"
24,3,24,716,122,106,228,"6 de julio de 1997"
24,3,24,717,184,194,378,"6 de julio de 1997"
24,3,24,718,86,76,162,"6 de julio de 1997"
24,3,24,719,28,30,58,"6 de julio de 1997"
24,3,24,720,190,176,366,"6 de julio de 1997"
24,3,24,721,67,58,125,"6 de julio de 1997"
24,3,24,722,137,125,262,"6 de julio de 1997"
24,3,24,723,74,66,140,"6 de julio de 1997"
24,3,27,757,284,299,583,"6 de julio de 1997"
24,3,27,758,295,349,644,"6 de julio de 1997"
24,3,27,759,337,400,737,"6 de julio de 1997"
24,3,27,760,182,176,358,"6 de julio de 1997"
24,3,27,761,270,300,570,"6 de julio de 1997"
24,3,27,762,231,284,515,"6 de julio de 1997"
24,3,27,763,233,233,466,"6 de julio de 1997"
24,3,27,764,154,195,349,"6 de julio de 1997"
24,3,27,765,54,57,111,"6 de julio de 1997"
24,3,27,766,87,97,184,"6 de julio de 1997"
24,3,27,767,173,190,363,"6 de julio de 1997"
24,3,27,768,61,60,121,"6 de julio de 1997"
24,3,27,769,176,141,317,"6 de julio de 1997"
24,3,27,770,78,74,152,"6 de julio de 1997"
24,3,27,771,149,181,330,"6 de julio de 1997"
24,3,27,772,176,175,351,"6 de julio de 1997"
24,3,30,1148,221,249,470,"6 de julio de 1997"
24,3,30,1149,89,108,197,"6 de julio de 1997"
24,3,30,1150,66,100,166,"6 de julio de 1997"
24,3,30,1151,99,124,223,"6 de julio de 1997"
24,3,30,1152,121,160,281,"6 de julio de 1997"
24,3,30,1153,241,254,495,"6 de julio de 1997"
24,3,30,1154,33,53,86,"6 de julio de 1997"
24,3,30,1155,141,178,319,"6 de julio de 1997"
24,3,30,1156,126,160,286,"6 de julio de 1997"
24,3,30,1157,43,41,84,"6 de julio de 1997"
24,3,30,1158,141,145,286,"6 de julio de 1997"
24,3,30,1159,506,596,1102,"6 de julio de 1997"
24,3,32,1179,74,64,138,"6 de julio de 1997"
24,3,32,1180,363,337,700,"6 de julio de 1997"
24,3,32,1181,314,303,617,"6 de julio de 1997"
24,3,32,1182,54,68,122,"6 de julio de 1997"
24,3,32,1183,355,316,671,"6 de julio de 1997"
24,3,32,1184,229,255,484,"6 de julio de 1997"
24,3,32,1185,214,210,424,"6 de julio de 1997"
24,3,32,1186,311,288,599,"6 de julio de 1997"
24,3,32,1187,529,459,988,"6 de julio de 1997"
24,3,36,1319,519,531,1050,"6 de julio de 1997"
24,3,36,1320,341,375,716,"6 de julio de 1997"
24,3,36,1321,330,327,657,"6 de julio de 1997"
24,3,36,1322,205,151,356,"6 de julio de 1997"
24,3,36,1323,273,214,487,"6 de julio de 1997"
24,3,36,1324,608,574,1182,"6 de julio de 1997"
24,3,36,1325,239,176,415,"6 de julio de 1997"
24,3,36,1326,709,667,1376,"6 de julio de 1997"
24,3,36,1327,675,667,1342,"6 de julio de 1997"
24,3,36,1328,553,501,1054,"6 de julio de 1997"
24,3,36,1329,419,392,811,"6 de julio de 1997"
24,3,36,1330,589,531,1120,"6 de julio de 1997"
24,3,36,1331,303,242,545,"6 de julio de 1997"
24,3,36,1332,434,309,743,"6 de julio de 1997"
24,3,36,1333,502,402,904,"6 de julio de 1997"
24,3,36,1334,288,265,553,"6 de julio de 1997"
24,3,36,1335,455,471,926,"6 de julio de 1997"
24,3,53,1689,250,293,543,"6 de julio de 1997"
24,3,53,1690,205,245,450,"6 de julio de 1997"
24,3,53,1691,255,293,548,"6 de julio de 1997"
24,3,53,1692,182,240,422,"6 de julio de 1997"
24,3,53,1693,125,175,300,"6 de julio de 1997"
24,3,53,1694,80,98,178,"6 de julio de 1997"
24,3,53,1695,268,337,605,"6 de julio de 1997"
24,3,53,1696,91,92,183,"6 de julio de 1997"
24,3,53,1697,398,473,871,"6 de julio de 1997"
24,3,53,1698,337,364,701,"6 de julio de 1997"
24,3,53,1699,128,188,316,"6 de julio de 1997"
24,3,53,1700,205,201,406,"6 de julio de 1997"
24,3,53,1701,65,55,120,"6 de julio de 1997"
24,3,53,1702,86,85,171,"6 de julio de 1997"
24,3,53,1703,44,44,88,"6 de julio de 1997"
24,3,53,1704,234,248,482,"6 de julio de 1997"
24,4,13,266,709,782,1491,"6 de julio de 1997"
24,4,13,267,474,522,996,"6 de julio de 1997"
24,4,13,268,303,362,665,"6 de julio de 1997"
24,4,13,269,313,393,706,"6 de julio de 1997"
24,4,13,270,340,417,757,"6 de julio de 1997"
24,4,13,271,328,456,784,"6 de julio de 1997"
24,4,13,272,222,207,429,"6 de julio de 1997"
24,4,13,273,388,425,813,"6 de julio de 1997"
24,4,13,274,466,500,966,"6 de julio de 1997"
24,4,13,275,651,729,1380,"6 de julio de 1997"
24,4,13,276,671,695,1366,"6 de julio de 1997"
24,4,13,277,639,699,1338,"6 de julio de 1997"
24,4,13,278,445,511,956,"6 de julio de 1997"
24,4,13,279,434,485,919,"6 de julio de 1997"
24,4,13,280,480,532,1012,"6 de julio de 1997"
24,4,13,281,437,510,947,"6 de julio de 1997"
24,4,13,282,743,868,1611,"6 de julio de 1997"
24,4,13,283,789,899,1688,"6 de julio de 1997"
24,4,13,284,553,658,1211,"6 de julio de 1997"
24,4,13,285,368,365,733,"6 de julio de 1997"
24,4,13,286,637,659,1296,"6 de julio de 1997"
24,4,13,287,638,745,1383,"6 de julio de 1997"
24,4,13,288,475,565,1040,"6 de julio de 1997"
24,4,13,289,961,1115,2076,"6 de julio de 1997"
24,4,13,290,336,335,671,"6 de julio de 1997"
24,4,13,291,410,488,898,"6 de julio de 1997"
24,4,13,292,517,599,1116,"6 de julio de 1997"
24,4,13,293,509,587,1096,"6 de julio de 1997"
24,4,13,294,707,818,1525,"6 de julio de 1997"
24,4,13,295,502,605,1107,"6 de julio de 1997"
24,4,13,296,392,427,819,"6 de julio de 1997"
24,4,13,297,423,453,876,"6 de julio de 1997"
24,4,13,298,417,496,913,"6 de julio de 1997"
24,4,13,299,460,496,956,"6 de julio de 1997"
24,4,13,300,583,701,1284,"6 de julio de 1997"
24,4,13,301,542,656,1198,"6 de julio de 1997"
24,4,13,302,259,324,583,"6 de julio de 1997"
24,4,13,303,365,440,805,"6 de julio de 1997"
24,4,13,304,590,646,1236,"6 de julio de 1997"
24,4,13,305,334,369,703,"6 de julio de 1997"
24,4,13,306,181,207,388,"6 de julio de 1997"
24,4,13,307,288,310,598,"6 de julio de 1997"
24,4,13,308,547,615,1162,"6 de julio de 1997"
24,4,13,309,442,527,969,"6 de julio de 1997"
24,4,13,310,498,587,1085,"6 de julio de 1997"
24,4,13,311,393,427,820,"6 de julio de 1997"
24,4,13,312,309,349,658,"6 de julio de 1997"
24,4,13,313,484,550,1034,"6 de julio de 1997"
24,4,13,314,336,389,725,"6 de julio de 1997"
24,4,13,315,181,190,371,"6 de julio de 1997"
24,4,13,316,409,423,832,"6 de julio de 1997"
24,4,13,317,452,509,961,"6 de julio de 1997"
24,4,13,318,266,382,648,"6 de julio de 1997"
24,4,13,319,496,560,1056,"6 de julio de 1997"
24,4,13,320,791,457,1248,"6 de julio de 1997"
24,4,13,321,366,428,794,"6 de julio de 1997"
24,4,13,322,375,430,805,"6 de julio de 1997"
24,4,13,323,267,325,592,"6 de julio de 1997"
24,4,13,324,462,493,955,"6 de julio de 1997"
24,4,13,325,360,455,815,"6 de julio de 1997"
24,4,13,326,551,575,1126,"6 de julio de 1997"
24,4,13,327,288,341,629,"6 de julio de 1997"
24,4,13,328,131,95,226,"6 de julio de 1997"
24,4,13,329,137,115,252,"6 de julio de 1997"
24,4,13,330,94,70,164,"6 de julio de 1997"
24,4,13,331,226,176,402,"6 de julio de 1997"
24,4,13,332,524,480,1004,"6 de julio de 1997"
24,4,13,333,480,340,820,"6 de julio de 1997"
24,4,13,334,89,88,177,"6 de julio de 1997"
24,4,13,335,274,260,534,"6 de julio de 1997"
24,4,13,336,112,108,220,"6 de julio de 1997"
24,4,13,337,143,119,262,"6 de julio de 1997"
24,4,13,338,460,401,861,"6 de julio de 1997"
24,4,13,339,146,125,271,"6 de julio de 1997"
24,4,13,340,149,110,259,"6 de julio de 1997"
24,4,13,341,178,137,315,"6 de julio de 1997"
24,4,13,342,195,176,371,"6 de julio de 1997"
24,4,13,343,152,146,298,"6 de julio de 1997"
24,4,13,344,214,219,433,"6 de julio de 1997"
24,4,13,345,249,219,468,"6 de julio de 1997"
24,4,13,346,213,194,407,"6 de julio de 1997"
24,4,13,347,224,209,433,"6 de julio de 1997"
24,4,13,348,279,276,555,"6 de julio de 1997"
24,4,13,349,276,244,520,"6 de julio de 1997"
24,4,13,350,360,350,710,"6 de julio de 1997"
24,4,13,351,202,219,421,"6 de julio de 1997"
24,4,13,352,389,438,827,"6 de julio de 1997"
24,4,13,353,368,362,730,"6 de julio de 1997"
24,4,13,354,428,373,801,"6 de julio de 1997"
24,4,13,355,211,188,399,"6 de julio de 1997"
24,4,13,356,365,279,644,"6 de julio de 1997"
24,4,13,357,217,193,410,"6 de julio de 1997"
24,4,13,358,303,259,562,"6 de julio de 1997"
24,4,13,359,347,329,676,"6 de julio de 1997"
24,4,13,360,329,266,595,"6 de julio de 1997"
24,4,13,361,360,274,634,"6 de julio de 1997"
24,4,13,362,183,144,327,"6 de julio de 1997"
24,4,13,363,114,109,223,"6 de julio de 1997"
24,4,13,364,472,457,929,"6 de julio de 1997"
24,4,13,365,224,175,399,"6 de julio de 1997"
24,4,13,366,143,130,273,"6 de julio de 1997"
24,4,13,367,408,317,725,"6 de julio de 1997"
24,4,13,368,137,109,246,"6 de julio de 1997"
24,4,13,369,186,155,341,"6 de julio de 1997"
24,4,13,370,224,217,441,"6 de julio de 1997"
24,4,16,405,351,352,703,"6 de julio de 1997"
24,4,16,406,384,415,799,"6 de julio de 1997"
24,4,16,407,458,476,934,"6 de julio de 1997"
24,4,16,408,401,412,813,"6 de julio de 1997"
24,4,16,409,381,423,804,"6 de julio de 1997"
24,4,16,410,309,321,630,"6 de julio de 1997"
24,4,16,411,418,470,888,"6 de julio de 1997"
24,4,16,412,479,495,974,"6 de julio de 1997"
24,4,16,413,259,278,537,"6 de julio de 1997"
24,4,16,414,315,381,696,"6 de julio de 1997"
24,4,16,415,494,572,1066,"6 de julio de 1997"
24,4,16,416,348,404,752,"6 de julio de 1997"
24,4,16,417,292,301,593,"6 de julio de 1997"
24,4,16,418,602,653,1255,"6 de julio de 1997"
24,4,16,419,443,462,905,"6 de julio de 1997"
24,4,16,420,89,69,158,"6 de julio de 1997"
24,4,16,421,417,397,814,"6 de julio de 1997"
24,4,16,422,331,311,642,"6 de julio de 1997"
24,4,16,423,459,480,939,"6 de julio de 1997"
24,4,16,424,554,456,1010,"6 de julio de 1997"
24,4,16,425,542,452,994,"6 de julio de 1997"
24,4,16,426,396,309,705,"6 de julio de 1997"
24,4,16,427,637,517,1154,"6 de julio de 1997"
24,4,16,428,146,131,277,"6 de julio de 1997"
24,4,16,429,210,199,409,"6 de julio de 1997"
24,4,16,430,415,358,773,"6 de julio de 1997"
24,4,16,431,430,396,826,"6 de julio de 1997"
24,4,16,432,55,39,94,"6 de julio de 1997"
24,4,16,433,464,402,866,"6 de julio de 1997"
24,4,16,434,294,242,536,"6 de julio de 1997"
24,4,16,435,129,119,248,"6 de julio de 1997"
24,4,16,436,119,86,205,"6 de julio de 1997"
24,4,26,748,296,313,609,"6 de julio de 1997"
24,4,26,749,162,129,291,"6 de julio de 1997"
24,4,26,750,78,63,141,"6 de julio de 1997"
24,4,26,751,258,233,491,"6 de julio de 1997"
24,4,26,752,409,333,742,"6 de julio de 1997"
24,4,26,753,188,153,341,"6 de julio de 1997"
24,4,26,754,275,240,515,"6 de julio de 1997"
24,4,26,755,118,90,208,"6 de julio de 1997"
24,4,26,756,379,300,679,"6 de julio de 1997"
24,4,31,1160,296,299,595,"6 de julio de 1997"
24,4,31,1161,457,456,913,"6 de julio de 1997"
24,4,31,1162,389,390,779,"6 de julio de 1997"
24,4,31,1163,359,344,703,"6 de julio de 1997"
24,4,31,1164,215,214,429,"6 de julio de 1997"
24,4,31,1165,105,82,187,"6 de julio de 1997"
24,4,31,1166,58,40,98,"6 de julio de 1997"
24,4,31,1167,198,169,367,"6 de julio de 1997"
24,4,31,1168,112,99,211,"6 de julio de 1997"
24,4,31,1169,170,148,318,"6 de julio de 1997"
24,4,31,1170,69,64,133,"6 de julio de 1997"
24,4,31,1171,105,83,188,"6 de julio de 1997"
24,4,31,1172,85,65,150,"6 de julio de 1997"
24,4,31,1173,160,103,263,"6 de julio de 1997"
24,4,31,1174,191,148,339,"6 de julio de 1997"
24,4,31,1175,92,75,167,"6 de julio de 1997"
24,4,31,1176,158,133,291,"6 de julio de 1997"
24,4,31,1177,201,177,378,"6 de julio de 1997"
24,4,31,1178,367,345,712,"6 de julio de 1997"
24,4,39,1428,530,502,1032,"6 de julio de 1997"
24,4,39,1429,409,400,809,"6 de julio de 1997"
24,4,39,1430,142,113,255,"6 de julio de 1997"
24,4,39,1431,149,125,274,"6 de julio de 1997"
24,4,39,1432,327,301,628,"6 de julio de 1997"
24,4,39,1433,204,190,394,"6 de julio de 1997"
24,4,39,1434,103,88,191,"6 de julio de 1997"
24,4,39,1435,157,152,309,"6 de julio de 1997"
24,4,39,1436,55,44,99,"6 de julio de 1997"
24,4,39,1437,132,120,252,"6 de julio de 1997"
24,4,39,1438,231,179,410,"6 de julio de 1997"
24,4,39,1439,295,225,520,"6 de julio de 1997"
24,4,39,1440,138,116,254,"6 de julio de 1997"
24,4,39,1441,127,124,251,"6 de julio de 1997"
24,4,39,1442,124,105,229,"6 de julio de 1997"
24,4,39,1443,165,139,304,"6 de julio de 1997"
24,4,39,1444,193,168,361,"6 de julio de 1997"
24,4,40,1445,467,534,1001,"6 de julio de 1997"
24,4,40,1446,404,418,822,"6 de julio de 1997"
24,4,40,1447,462,472,934,"6 de julio de 1997"
24,4,40,1448,353,403,756,"6 de julio de 1997"
24,4,40,1449,293,350,643,"6 de julio de 1997"
24,4,40,1450,314,324,638,"6 de julio de 1997"
24,4,40,1451,317,317,634,"6 de julio de 1997"
24,4,40,1452,312,339,651,"6 de julio de 1997"
24,4,40,1453,263,312,575,"6 de julio de 1997"
24,4,40,1454,397,384,781,"6 de julio de 1997"
24,4,40,1455,389,452,841,"6 de julio de 1997"
24,4,40,1456,286,247,533,"6 de julio de 1997"
24,4,40,1457,315,250,565,"6 de julio de 1997"
24,4,40,1458,173,125,298,"6 de julio de 1997"
24,4,40,1459,105,96,201,"6 de julio de 1997"
24,4,40,1460,170,113,283,"6 de julio de 1997"
24,4,40,1461,143,99,242,"6 de julio de 1997"
24,4,40,1462,457,420,877,"6 de julio de 1997"
24,4,40,1463,245,198,443,"6 de julio de 1997"
24,4,40,1464,366,355,721,"6 de julio de 1997"
24,4,40,1465,408,346,754,"6 de julio de 1997"
24,4,40,1466,102,93,195,"6 de julio de 1997"
24,4,40,1467,215,223,438,"6 de julio de 1997"
24,4,40,1468,284,261,545,"6 de julio de 1997"
24,4,40,1469,135,127,262,"6 de julio de 1997"
24,4,40,1470,141,122,263,"6 de julio de 1997"
24,4,40,1471,200,191,391,"6 de julio de 1997"
24,4,40,1472,341,334,675,"6 de julio de 1997"
24,4,40,1473,68,55,123,"6 de julio de 1997"
24,4,40,1474,279,254,533,"6 de julio de 1997"
24,4,40,1475,315,257,572,"6 de julio de 1997"
24,4,40,1476,258,213,471,"6 de julio de 1997"
24,4,40,1477,420,370,790,"6 de julio de 1997"
24,4,40,1478,133,82,215,"6 de julio de 1997"
24,4,40,1479,129,120,249,"6 de julio de 1997"
24,4,41,1480,548,538,1086,"6 de julio de 1997"
24,4,41,1481,460,384,844,"6 de julio de 1997"
24,4,41,1482,112,113,225,"6 de julio de 1997"
24,4,41,1483,172,149,321,"6 de julio de 1997"
24,4,41,1484,98,89,187,"6 de julio de 1997"
24,4,41,1485,150,109,259,"6 de julio de 1997"
24,4,41,1486,199,138,337,"6 de julio de 1997"
24,4,41,1487,238,183,421,"6 de julio de 1997"
24,4,41,1488,122,103,225,"6 de julio de 1997"
24,4,41,1489,250,196,446,"6 de julio de 1997"
24,4,41,1490,370,309,679,"6 de julio de 1997"
24,4,41,1491,251,197,448,"6 de julio de 1997"
24,4,41,1492,550,444,994,"6 de julio de 1997"
24,4,41,1493,237,206,443,"6 de julio de 1997"
24,4,41,1494,219,193,412,"6 de julio de 1997"
24,4,41,1495,317,264,581,"6 de julio de 1997"
24,4,42,1496,625,570,1195,"6 de julio de 1997"
24,4,42,1497,544,555,1099,"6 de julio de 1997"
24,4,42,1498,494,552,1046,"6 de julio de 1997"
24,4,42,1499,418,457,875,"6 de julio de 1997"
24,4,42,1500,495,490,985,"6 de julio de 1997"
24,4,42,1501,392,370,762,"6 de julio de 1997"
24,4,42,1502,218,210,428,"6 de julio de 1997"
24,4,42,1503,122,99,221,"6 de julio de 1997"
24,4,42,1504,202,176,378,"6 de julio de 1997"
24,4,42,1505,62,53,115,"6 de julio de 1997"
24,4,42,1506,71,57,128,"6 de julio de 1997"
24,4,57,180,120,109,229,"6 de julio de 1997"
24,4,57,186,379,352,731,"6 de julio de 1997"
24,4,57,187,362,301,663,"6 de julio de 1997"
24,4,57,188,391,351,742,"6 de julio de 1997"
24,4,57,189,203,208,411,"6 de julio de 1997"
24,4,57,190,709,601,1310,"6 de julio de 1997"
24,4,57,191,487,447,934,"6 de julio de 1997"
24,4,57,192,474,508,982,"6 de julio de 1997"
24,4,57,193,434,443,877,"6 de julio de 1997"
24,4,57,194,277,232,509,"6 de julio de 1997"
24,4,57,195,257,220,477,"6 de julio de 1997"
24,4,57,203,105,96,201,"6 de julio de 1997"
24,4,57,204,126,90,216,"6 de julio de 1997"
24,4,57,205,244,203,447,"6 de julio de 1997"
24,4,57,212,335,287,622,"6 de julio de 1997"
24,4,57,213,114,65,179,"6 de julio de 1997"
24,4,57,219,130,158,288,"6 de julio de 1997"
24,5,28,773,510,564,1074,"6 de julio de 1997"
24,5,28,774,847,1048,1895,"6 de julio de 1997"
24,5,28,775,601,687,1288,"6 de julio de 1997"
24,5,28,776,416,471,887,"6 de julio de 1997"
24,5,28,777,428,499,927,"6 de julio de 1997"
24,5,28,778,650,745,1395,"6 de julio de 1997"
24,5,28,779,568,650,1218,"6 de julio de 1997"
24,5,28,780,714,767,1481,"6 de julio de 1997"
24,5,28,781,543,611,1154,"6 de julio de 1997"
24,5,28,782,694,756,1450,"6 de julio de 1997"
24,5,28,783,608,696,1304,"6 de julio de 1997"
24,5,28,784,663,767,1430,"6 de julio de 1997"
24,5,28,785,630,733,1363,"6 de julio de 1997"
24,5,28,786,359,434,793,"6 de julio de 1997"
24,5,28,787,1075,1259,2334,"6 de julio de 1997"
24,5,28,788,328,391,719,"6 de julio de 1997"
24,5,28,789,234,276,510,"6 de julio de 1997"
24,5,28,790,819,999,1818,"6 de julio de 1997"
24,5,28,791,611,713,1324,"6 de julio de 1997"
24,5,28,792,723,858,1581,"6 de julio de 1997"
24,5,28,793,443,577,1020,"6 de julio de 1997"
24,5,28,794,777,825,1602,"6 de julio de 1997"
24,5,28,795,815,914,1729,"6 de julio de 1997"
24,5,28,796,539,628,1167,"6 de julio de 1997"
24,5,28,797,463,503,966,"6 de julio de 1997"
24,5,28,798,519,587,1106,"6 de julio de 1997"
24,5,28,799,284,375,659,"6 de julio de 1997"
24,5,28,800,570,692,1262,"6 de julio de 1997"
24,5,28,801,671,795,1466,"6 de julio de 1997"
24,5,28,802,630,718,1348,"6 de julio de 1997"
24,5,28,803,780,903,1683,"6 de julio de 1997"
24,5,28,804,230,272,502,"6 de julio de 1997"
24,5,28,805,554,666,1220,"6 de julio de 1997"
24,5,28,806,504,619,1123,"6 de julio de 1997"
24,5,28,807,531,676,1207,"6 de julio de 1997"
24,5,28,808,842,910,1752,"6 de julio de 1997"
24,5,28,809,763,851,1614,"6 de julio de 1997"
24,5,28,810,527,582,1109,"6 de julio de 1997"
24,5,28,811,382,467,849,"6 de julio de 1997"
24,5,28,812,521,639,1160,"6 de julio de 1997"
24,5,28,813,392,452,844,"6 de julio de 1997"
24,5,28,814,344,371,715,"6 de julio de 1997"
24,5,28,815,236,275,511,"6 de julio de 1997"
24,5,28,816,499,562,1061,"6 de julio de 1997"
24,5,28,817,415,467,882,"6 de julio de 1997"
24,5,28,818,358,407,765,"6 de julio de 1997"
24,5,28,819,447,521,968,"6 de julio de 1997"
24,5,28,820,377,455,832,"6 de julio de 1997"
24,5,28,821,646,703,1349,"6 de julio de 1997"
24,5,28,822,515,593,1108,"6 de julio de 1997"
24,5,28,823,558,736,1294,"6 de julio de 1997"
24,5,28,824,605,737,1342,"6 de julio de 1997"
24,5,28,825,474,555,1029,"6 de julio de 1997"
24,5,28,826,657,676,1333,"6 de julio de 1997"
24,5,28,827,480,602,1082,"6 de julio de 1997"
24,5,28,828,892,1039,1931,"6 de julio de 1997"
24,5,28,829,790,879,1669,"6 de julio de 1997"
24,5,28,830,665,694,1359,"6 de julio de 1997"
24,5,28,831,583,694,1277,"6 de julio de 1997"
24,5,28,832,519,557,1076,"6 de julio de 1997"
24,5,28,833,883,952,1835,"6 de julio de 1997"
24,5,28,834,771,847,1618,"6 de julio de 1997"
24,5,28,835,540,628,1168,"6 de julio de 1997"
24,5,28,836,306,378,684,"6 de julio de 1997"
24,5,28,837,435,512,947,"6 de julio de 1997"
24,5,28,838,388,415,803,"6 de julio de 1997"
24,5,28,839,455,533,988,"6 de julio de 1997"
24,5,28,840,524,611,1135,"6 de julio de 1997"
24,5,28,841,403,476,879,"6 de julio de 1997"
24,5,28,842,690,937,1627,"6 de julio de 1997"
24,5,28,843,610,717,1327,"6 de julio de 1997"
24,5,28,844,625,703,1328,"6 de julio de 1997"
24,5,28,845,433,509,942,"6 de julio de 1997"
24,5,28,846,458,478,936,"6 de julio de 1997"
24,5,28,847,769,873,1642,"6 de julio de 1997"
24,5,28,848,621,717,1338,"6 de julio de 1997"
24,5,28,849,554,611,1165,"6 de julio de 1997"
24,5,28,850,397,431,828,"6 de julio de 1997"
24,5,28,851,730,886,1616,"6 de julio de 1997"
24,5,28,852,409,503,912,"6 de julio de 1997"
24,5,28,853,265,304,569,"6 de julio de 1997"
24,5,28,854,435,540,975,"6 de julio de 1997"
24,5,28,855,320,398,718,"6 de julio de 1997"
24,5,28,856,476,532,1008,"6 de julio de 1997"
24,5,28,857,664,733,1397,"6 de julio de 1997"
24,5,28,858,327,400,727,"6 de julio de 1997"
24,5,28,859,520,642,1162,"6 de julio de 1997"
24,5,28,860,537,678,1215,"6 de julio de 1997"
24,5,28,861,305,349,654,"6 de julio de 1997"
24,5,28,862,364,451,815,"6 de julio de 1997"
24,5,28,863,678,855,1533,"6 de julio de 1997"
24,5,28,864,330,364,694,"6 de julio de 1997"
24,5,28,865,438,540,978,"6 de julio de 1997"
24,5,28,866,577,684,1261,"6 de julio de 1997"
24,5,28,867,469,545,1014,"6 de julio de 1997"
24,5,28,868,596,769,1365,"6 de julio de 1997"
24,5,28,869,364,422,786,"6 de julio de 1997"
24,5,28,870,607,705,1312,"6 de julio de 1997"
24,5,28,871,552,697,1249,"6 de julio de 1997"
24,5,28,872,398,489,887,"6 de julio de 1997"
24,5,28,873,193,222,415,"6 de julio de 1997"
24,5,28,874,345,431,776,"6 de julio de 1997"
24,5,28,875,318,412,730,"6 de julio de 1997"
24,5,28,876,414,499,913,"6 de julio de 1997"
24,5,28,877,726,842,1568,"6 de julio de 1997"
24,5,28,878,492,608,1100,"6 de julio de 1997"
24,5,28,879,235,268,503,"6 de julio de 1997"
24,5,28,880,319,361,680,"6 de julio de 1997"
24,5,28,881,263,347,610,"6 de julio de 1997"
24,5,28,882,212,246,458,"6 de julio de 1997"
24,5,28,883,484,634,1118,"6 de julio de 1997"
24,5,28,884,438,565,1003,"6 de julio de 1997"
24,5,28,885,594,713,1307,"6 de julio de 1997"
24,5,28,886,580,693,1273,"6 de julio de 1997"
24,5,28,887,380,489,869,"6 de julio de 1997"
24,5,28,888,572,710,1282,"6 de julio de 1997"
24,5,28,889,432,516,948,"6 de julio de 1997"
24,5,28,890,536,740,1276,"6 de julio de 1997"
24,5,28,891,239,273,512,"6 de julio de 1997"
24,5,28,892,113,129,242,"6 de julio de 1997"
24,5,28,893,144,192,336,"6 de julio de 1997"
24,5,28,894,112,111,223,"6 de julio de 1997"
24,5,28,895,265,291,556,"6 de julio de 1997"
24,5,28,896,555,665,1220,"6 de julio de 1997"
24,5,28,897,379,472,851,"6 de julio de 1997"
24,5,28,898,316,363,679,"6 de julio de 1997"
24,5,28,899,257,303,560,"6 de julio de 1997"
24,5,28,900,284,328,612,"6 de julio de 1997"
24,5,28,901,451,506,957,"6 de julio de 1997"
24,5,28,902,298,401,699,"6 de julio de 1997"
24,5,28,903,314,530,844,"6 de julio de 1997"
24,5,28,904,425,561,986,"6 de julio de 1997"
24,5,28,905,240,285,525,"6 de julio de 1997"
24,5,28,906,541,807,1348,"6 de julio de 1997"
24,5,28,907,583,696,1279,"6 de julio de 1997"
24,5,28,908,387,485,872,"6 de julio de 1997"
24,5,28,909,291,457,748,"6 de julio de 1997"
24,5,28,910,590,692,1282,"6 de julio de 1997"
24,5,28,911,309,376,685,"6 de julio de 1997"
24,5,28,912,393,482,875,"6 de julio de 1997"
24,5,28,913,665,746,1411,"6 de julio de 1997"
24,5,28,914,510,609,1119,"6 de julio de 1997"
24,5,28,915,572,687,1259,"6 de julio de 1997"
24,5,28,916,529,676,1205,"6 de julio de 1997"
24,5,28,917,219,295,514,"6 de julio de 1997"
24,5,28,929,191,232,423,"6 de julio de 1997"
24,5,28,930,241,271,512,"6 de julio de 1997"
24,5,28,982,481,553,1034,"6 de julio de 1997"
24,5,28,983,372,426,798,"6 de julio de 1997"
24,5,28,984,305,349,654,"6 de julio de 1997"
24,5,28,985,551,652,1203,"6 de julio de 1997"
24,5,28,1000,660,711,1371,"6 de julio de 1997"
24,5,28,1001,655,738,1393,"6 de julio de 1997"
24,5,28,1002,251,310,561,"6 de julio de 1997"
24,5,28,1003,145,161,306,"6 de julio de 1997"
24,5,28,1022,475,532,1007,"6 de julio de 1997"
24,5,28,1023,749,837,1586,"6 de julio de 1997"
24,5,28,1076,145,149,294,"6 de julio de 1997"
24,5,28,1077,198,153,351,"6 de julio de 1997"
24,5,28,1078,66,79,145,"6 de julio de 1997"
24,5,28,1079,112,99,211,"6 de julio de 1997"
24,5,28,1080,39,32,71,"6 de julio de 1997"
24,5,28,1081,58,69,127,"6 de julio de 1997"
24,5,28,1082,90,87,177,"6 de julio de 1997"
24,5,28,1083,50,84,134,"6 de julio de 1997"
24,5,28,1084,100,161,261,"6 de julio de 1997"
24,5,28,1085,63,72,135,"6 de julio de 1997"
24,5,28,1086,274,298,572,"6 de julio de 1997"
24,5,28,1087,78,92,170,"6 de julio de 1997"
24,5,28,1088,144,172,316,"6 de julio de 1997"
24,5,28,1089,147,159,306,"6 de julio de 1997"
24,5,28,1090,162,160,322,"6 de julio de 1997"
24,5,28,1091,83,116,199,"6 de julio de 1997"
24,5,28,1092,201,260,461,"6 de julio de 1997"
24,5,28,1093,164,159,323,"6 de julio de 1997"
24,5,28,1094,27,34,61,"6 de julio de 1997"
24,5,28,1095,50,79,129,"6 de julio de 1997"
24,5,28,1096,234,374,608,"6 de julio de 1997"
24,5,28,1097,145,186,331,"6 de julio de 1997"
24,5,28,1098,82,95,177,"6 de julio de 1997"
24,5,28,1099,46,64,110,"6 de julio de 1997"
24,5,28,1100,267,254,521,"6 de julio de 1997"
24,5,28,1101,242,229,471,"6 de julio de 1997"
24,5,28,1102,46,53,99,"6 de julio de 1997"
24,5,28,1103,45,75,120,"6 de julio de 1997"
24,5,28,1104,220,223,443,"6 de julio de 1997"
24,5,28,1105,112,125,237,"6 de julio de 1997"
24,5,28,1106,317,336,653,"6 de julio de 1997"
24,6,28,918,250,363,613,"6 de julio de 1997"
24,6,28,919,351,431,782,"6 de julio de 1997"
24,6,28,920,407,531,938,"6 de julio de 1997"
24,6,28,921,731,851,1582,"6 de julio de 1997"
24,6,28,922,581,667,1248,"6 de julio de 1997"
24,6,28,923,113,121,234,"6 de julio de 1997"
24,6,28,924,375,453,828,"6 de julio de 1997"
24,6,28,925,342,432,774,"6 de julio de 1997"
24,6,28,926,555,652,1207,"6 de julio de 1997"
24,6,28,927,387,530,917,"6 de julio de 1997"
24,6,28,928,205,270,475,"6 de julio de 1997"
24,6,28,931,613,838,1451,"6 de julio de 1997"
24,6,28,932,570,698,1268,"6 de julio de 1997"
24,6,28,933,276,309,585,"6 de julio de 1997"
24,6,28,934,786,795,1581,"6 de julio de 1997"
24,6,28,935,497,602,1099,"6 de julio de 1997"
24,6,28,936,667,744,1411,"6 de julio de 1997"
24,6,28,937,507,594,1101,"6 de julio de 1997"
24,6,28,938,442,548,990,"6 de julio de 1997"
24,6,28,939,546,651,1197,"6 de julio de 1997"
24,6,28,940,601,669,1270,"6 de julio de 1997"
24,6,28,941,675,758,1433,"6 de julio de 1997"
24,6,28,942,579,623,1202,"6 de julio de 1997"
24,6,28,943,891,1013,1904,"6 de julio de 1997"
24,6,28,944,975,1098,2073,"6 de julio de 1997"
24,6,28,945,596,661,1257,"6 de julio de 1997"
24,6,28,946,362,441,803,"6 de julio de 1997"
24,6,28,947,526,649,1175,"6 de julio de 1997"
24,6,28,948,490,515,1005,"6 de julio de 1997"
24,6,28,949,336,391,727,"6 de julio de 1997"
24,6,28,950,482,558,1040,"6 de julio de 1997"
24,6,28,951,214,276,490,"6 de julio de 1997"
24,6,28,952,378,415,793,"6 de julio de 1997"
24,6,28,953,513,571,1084,"6 de julio de 1997"
24,6,28,954,401,466,867,"6 de julio de 1997"
24,6,28,955,778,894,1672,"6 de julio de 1997"
24,6,28,956,482,583,1065,"6 de julio de 1997"
24,6,28,957,499,579,1078,"6 de julio de 1997"
24,6,28,958,527,578,1105,"6 de julio de 1997"
24,6,28,959,402,453,855,"6 de julio de 1997"
24,6,28,960,305,359,664,"6 de julio de 1997"
24,6,28,961,946,1047,1993,"6 de julio de 1997"
24,6,28,962,432,537,969,"6 de julio de 1997"
24,6,28,963,531,629,1160,"6 de julio de 1997"
24,6,28,964,476,592,1068,"6 de julio de 1997"
24,6,28,965,1290,1470,2760,"6 de julio de 1997"
24,6,28,966,535,622,1157,"6 de julio de 1997"
24,6,28,967,786,887,1673,"6 de julio de 1997"
24,6,28,968,503,529,1032,"6 de julio de 1997"
24,6,28,969,623,701,1324,"6 de julio de 1997"
24,6,28,970,404,488,892,"6 de julio de 1997"
24,6,28,971,295,347,642,"6 de julio de 1997"
24,6,28,972,1114,1260,2374,"6 de julio de 1997"
24,6,28,973,336,362,698,"6 de julio de 1997"
24,6,28,974,188,205,393,"6 de julio de 1997"
24,6,28,975,72,72,144,"6 de julio de 1997"
24,6,28,976,476,534,1010,"6 de julio de 1997"
24,6,28,977,502,508,1010,"6 de julio de 1997"
24,6,28,978,232,262,494,"6 de julio de 1997"
24,6,28,979,441,492,933,"6 de julio de 1997"
24,6,28,980,329,412,741,"6 de julio de 1997"
24,6,28,981,285,317,602,"6 de julio de 1997"
24,6,28,986,247,349,596,"6 de julio de 1997"
24,6,28,987,367,410,777,"6 de julio de 1997"
24,6,28,988,467,539,1006,"6 de julio de 1997"
24,6,28,989,366,498,864,"6 de julio de 1997"
24,6,28,990,299,386,685,"6 de julio de 1997"
24,6,28,991,248,292,540,"6 de julio de 1997"
24,6,28,992,265,314,579,"6 de julio de 1997"
24,6,28,993,289,382,671,"6 de julio de 1997"
24,6,28,994,553,655,1208,"6 de julio de 1997"
24,6,28,995,364,438,802,"6 de julio de 1997"
24,6,28,996,537,635,1172,"6 de julio de 1997"
24,6,28,997,619,760,1379,"6 de julio de 1997"
24,6,28,998,678,818,1496,"6 de julio de 1997"
24,6,28,999,613,733,1346,"6 de julio de 1997"
24,6,28,1004,483,585,1068,"6 de julio de 1997"
24,6,28,1005,440,519,959,"6 de julio de 1997"
24,6,28,1006,466,521,987,"6 de julio de 1997"
24,6,28,1007,475,574,1049,"6 de julio de 1997"
24,6,28,1008,315,385,700,"6 de julio de 1997"
24,6,28,1009,273,322,595,"6 de julio de 1997"
24,6,28,1010,647,130,777,"6 de julio de 1997"
24,6,28,1011,300,417,717,"6 de julio de 1997"
24,6,28,1012,490,579,1069,"6 de julio de 1997"
24,6,28,1013,446,488,934,"6 de julio de 1997"
24,6,28,1014,462,510,972,"6 de julio de 1997"
24,6,28,1015,458,564,1022,"6 de julio de 1997"
24,6,28,1016,112,178,290,"6 de julio de 1997"
24,6,28,1017,360,473,833,"6 de julio de 1997"
24,6,28,1018,581,696,1277,"6 de julio de 1997"
24,6,28,1019,614,739,1353,"6 de julio de 1997"
24,6,28,1020,570,648,1218,"6 de julio de 1997"
24,6,28,1021,569,664,1233,"6 de julio de 1997"
24,6,28,1024,494,657,1151,"6 de julio de 1997"
24,6,28,1025,454,566,1020,"6 de julio de 1997"
24,6,28,1026,528,597,1125,"6 de julio de 1997"
24,6,28,1027,458,594,1052,"6 de julio de 1997"
24,6,28,1028,636,773,1409,"6 de julio de 1997"
24,6,28,1029,542,670,1212,"6 de julio de 1997"
24,6,28,1030,583,622,1205,"6 de julio de 1997"
24,6,28,1031,717,828,1545,"6 de julio de 1997"
24,6,28,1032,769,826,1595,"6 de julio de 1997"
24,6,28,1033,481,544,1025,"6 de julio de 1997"
24,6,28,1034,595,671,1266,"6 de julio de 1997"
24,6,28,1035,549,648,1197,"6 de julio de 1997"
24,6,28,1036,613,681,1294,"6 de julio de 1997"
24,6,28,1037,542,676,1218,"6 de julio de 1997"
24,6,28,1038,409,559,968,"6 de julio de 1997"
24,6,28,1039,656,699,1355,"6 de julio de 1997"
24,6,28,1040,537,685,1222,"6 de julio de 1997"
24,6,28,1041,558,705,1263,"6 de julio de 1997"
24,6,28,1042,555,669,1224,"6 de julio de 1997"
24,6,28,1043,491,572,1063,"6 de julio de 1997"
24,6,28,1044,539,680,1219,"6 de julio de 1997"
24,6,28,1045,743,822,1565,"6 de julio de 1997"
24,6,28,1046,461,535,996,"6 de julio de 1997"
24,6,28,1047,457,524,981,"6 de julio de 1997"
24,6,28,1048,491,557,1048,"6 de julio de 1997"
24,6,28,1049,693,795,1488,"6 de julio de 1997"
24,6,28,1050,809,919,1728,"6 de julio de 1997"
24,6,28,1051,505,539,1044,"6 de julio de 1997"
24,6,28,1052,370,418,788,"6 de julio de 1997"
24,6,28,1053,708,782,1490,"6 de julio de 1997"
24,6,28,1054,437,500,937,"6 de julio de 1997"
24,6,28,1055,694,719,1413,"6 de julio de 1997"
24,6,28,1056,524,612,1136,"6 de julio de 1997"
24,6,28,1057,610,723,1333,"6 de julio de 1997"
24,6,28,1058,478,515,993,"6 de julio de 1997"
24,6,28,1059,657,794,1451,"6 de julio de 1997"
24,6,28,1060,682,782,1464,"6 de julio de 1997"
24,6,28,1061,695,759,1454,"6 de julio de 1997"
24,6,28,1062,699,850,1549,"6 de julio de 1997"
24,6,28,1063,749,832,1581,"6 de julio de 1997"
24,6,28,1064,500,544,1044,"6 de julio de 1997"
24,6,28,1065,398,460,858,"6 de julio de 1997"
24,6,28,1066,363,446,809,"6 de julio de 1997"
24,6,28,1067,513,581,1094,"6 de julio de 1997"
24,6,28,1068,775,831,1606,"6 de julio de 1997"
24,6,28,1069,729,785,1514,"6 de julio de 1997"
24,6,28,1070,671,766,1437,"6 de julio de 1997"
24,6,28,1071,486,534,1020,"6 de julio de 1997"
24,6,28,1072,746,863,1609,"6 de julio de 1997"
24,6,28,1073,1189,1343,2532,"6 de julio de 1997"
24,6,28,1074,2099,2304,4403,"6 de julio de 1997"
24,6,28,1075,636,693,1329,"6 de julio de 1997"
24,6,28,1107,259,274,533,"6 de julio de 1997"
24,6,28,1108,137,136,273,"6 de julio de 1997"
24,6,28,1109,392,374,766,"6 de julio de 1997"
24,6,28,1110,556,615,1171,"6 de julio de 1997"
24,6,28,1111,270,299,569,"6 de julio de 1997"
24,6,28,1112,196,213,409,"6 de julio de 1997"
24,6,28,1113,590,610,1200,"6 de julio de 1997"
24,6,28,1114,455,471,926,"6 de julio de 1997"
24,6,28,1115,350,379,729,"6 de julio de 1997"
24,6,28,1116,740,817,1557,"6 de julio de 1997"
24,6,28,1117,455,463,918,"6 de julio de 1997"
24,6,28,1118,532,535,1067,"6 de julio de 1997"
24,6,28,1119,166,150,316,"6 de julio de 1997"
24,6,28,1120,227,242,469,"6 de julio de 1997"
24,6,28,1121,345,324,669,"6 de julio de 1997"
24,6,28,1122,58,45,103,"6 de julio de 1997"
24,6,28,1123,300,290,590,"6 de julio de 1997"
24,6,28,1124,307,300,607,"6 de julio de 1997"
24,6,28,1125,542,534,1076,"6 de julio de 1997"
24,6,28,1126,348,336,684,"6 de julio de 1997"
24,6,28,1127,138,153,291,"6 de julio de 1997"
24,7,3,34,551,460,1011,"6 de julio de 1997"
24,7,3,35,246,246,492,"6 de julio de 1997"
24,7,3,36,374,323,697,"6 de julio de 1997"
24,7,3,37,141,126,267,"6 de julio de 1997"
24,7,3,38,267,230,497,"6 de julio de 1997"
24,7,3,39,488,444,932,"6 de julio de 1997"
24,7,3,40,77,60,137,"6 de julio de 1997"
24,7,3,41,479,365,844,"6 de julio de 1997"
24,7,3,42,231,158,389,"6 de julio de 1997"
24,7,3,43,457,427,884,"6 de julio de 1997"
24,7,3,44,535,467,1002,"6 de julio de 1997"
24,7,3,45,402,317,719,"6 de julio de 1997"
24,7,3,46,562,409,971,"6 de julio de 1997"
24,7,3,47,270,212,482,"6 de julio de 1997"
24,7,3,48,512,409,921,"6 de julio de 1997"
24,7,3,49,274,224,498,"6 de julio de 1997"
24,7,3,50,252,231,483,"6 de julio de 1997"
24,7,3,51,422,310,732,"6 de julio de 1997"
24,7,3,52,262,190,452,"6 de julio de 1997"
24,7,3,53,537,496,1033,"6 de julio de 1997"
24,7,3,54,303,224,527,"6 de julio de 1997"
24,7,3,55,269,197,466,"6 de julio de 1997"
24,7,3,56,246,184,430,"6 de julio de 1997"
24,7,3,57,430,384,814,"6 de julio de 1997"
24,7,3,58,247,200,447,"6 de julio de 1997"
24,7,3,59,294,309,603,"6 de julio de 1997"
24,7,12,251,295,314,609,"6 de julio de 1997"
24,7,12,252,480,561,1041,"6 de julio de 1997"
24,7,12,253,434,397,831,"6 de julio de 1997"
24,7,12,254,153,156,309,"6 de julio de 1997"
24,7,12,255,229,209,438,"6 de julio de 1997"
24,7,12,256,324,304,628,"6 de julio de 1997"
24,7,12,257,466,441,907,"6 de julio de 1997"
24,7,12,258,219,206,425,"6 de julio de 1997"
24,7,12,259,506,464,970,"6 de julio de 1997"
24,7,12,260,571,486,1057,"6 de julio de 1997"
24,7,12,261,152,153,305,"6 de julio de 1997"
24,7,12,262,177,190,367,"6 de julio de 1997"
24,7,12,263,223,225,448,"6 de julio de 1997"
24,7,12,264,318,295,613,"6 de julio de 1997"
24,7,12,265,442,377,819,"6 de julio de 1997"
24,7,14,371,460,464,924,"6 de julio de 1997"
24,7,14,372,307,276,583,"6 de julio de 1997"
24,7,14,373,297,266,563,"6 de julio de 1997"
24,7,14,374,278,245,523,"6 de julio de 1997"
24,7,14,375,318,300,618,"6 de julio de 1997"
24,7,14,376,238,228,466,"6 de julio de 1997"
24,7,14,377,331,321,652,"6 de julio de 1997"
24,7,14,378,332,301,633,"6 de julio de 1997"
24,7,14,379,352,329,681,"6 de julio de 1997"
24,7,14,380,175,157,332,"6 de julio de 1997"
24,7,14,381,649,610,1259,"6 de julio de 1997"
24,7,14,382,295,276,571,"6 de julio de 1997"
24,7,14,383,437,433,870,"6 de julio de 1997"
24,7,18,468,143,153,296,"6 de julio de 1997"
24,7,18,469,204,172,376,"6 de julio de 1997"
24,7,18,470,297,318,615,"6 de julio de 1997"
24,7,18,471,206,184,390,"6 de julio de 1997"
24,7,18,472,351,345,696,"6 de julio de 1997"
24,7,18,473,304,275,579,"6 de julio de 1997"
24,7,18,474,497,480,977,"6 de julio de 1997"
24,7,18,475,549,538,1087,"6 de julio de 1997"
24,7,18,476,363,377,740,"6 de julio de 1997"
24,7,18,477,519,559,1078,"6 de julio de 1997"
24,7,29,1128,498,522,1020,"6 de julio de 1997"
24,7,29,1129,467,458,925,"6 de julio de 1997"
24,7,29,1130,274,226,500,"6 de julio de 1997"
24,7,29,1131,341,286,627,"6 de julio de 1997"
24,7,29,1132,187,184,371,"6 de julio de 1997"
24,7,29,1133,82,75,157,"6 de julio de 1997"
24,7,29,1134,304,234,538,"6 de julio de 1997"
24,7,29,1135,87,76,163,"6 de julio de 1997"
24,7,29,1136,286,244,530,"6 de julio de 1997"
24,7,29,1137,121,109,230,"6 de julio de 1997"
24,7,29,1138,53,37,90,"6 de julio de 1997"
24,7,29,1139,157,126,283,"6 de julio de 1997"
24,7,29,1140,475,407,882,"6 de julio de 1997"
24,7,29,1141,599,540,1139,"6 de julio de 1997"
24,7,29,1142,410,410,820,"6 de julio de 1997"
24,7,29,1143,502,440,942,"6 de julio de 1997"
24,7,29,1144,132,91,223,"6 de julio de 1997"
24,7,29,1145,242,213,455,"6 de julio de 1997"
24,7,29,1146,124,118,242,"6 de julio de 1997"
24,7,29,1147,485,396,881,"6 de julio de 1997"
24,7,37,1336,512,601,1113,"6 de julio de 1997"
24,7,37,1337,144,160,304,"6 de julio de 1997"
24,7,37,1338,226,229,455,"6 de julio de 1997"
24,7,37,1339,487,513,1000,"6 de julio de 1997"
24,7,37,1340,253,281,534,"6 de julio de 1997"
24,7,37,1341,427,446,873,"6 de julio de 1997"
24,7,37,1342,399,471,870,"6 de julio de 1997"
24,7,37,1343,492,542,1034,"6 de julio de 1997"
24,7,37,1344,463,486,949,"6 de julio de 1997"
24,7,37,1345,587,594,1181,"6 de julio de 1997"
24,7,37,1346,481,540,1021,"6 de julio de 1997"
24,7,37,1347,650,686,1336,"6 de julio de 1997"
24,7,37,1348,623,663,1286,"6 de julio de 1997"
24,7,37,1365,178,150,328,"6 de julio de 1997"
24,7,37,1367,401,295,696,"6 de julio de 1997"
24,7,37,1368,345,291,636,"6 de julio de 1997"
24,7,37,1369,411,376,787,"6 de julio de 1997"
24,7,37,1370,150,140,290,"6 de julio de 1997"
24,7,37,1371,381,344,725,"6 de julio de 1997"
24,7,37,1372,293,255,548,"6 de julio de 1997"
24,7,37,1373,468,387,855,"6 de julio de 1997"
24,7,37,1374,124,105,229,"6 de julio de 1997"
24,7,37,1375,298,273,571,"6 de julio de 1997"
24,7,37,1376,571,435,1006,"6 de julio de 1997"
24,7,37,1377,313,216,529,"6 de julio de 1997"
24,7,37,1378,362,281,643,"6 de julio de 1997"
24,7,37,1379,91,82,173,"6 de julio de 1997"
24,7,37,1380,443,426,869,"6 de julio de 1997"
24,7,37,1381,227,177,404,"6 de julio de 1997"
24,7,37,1382,391,316,707,"6 de julio de 1997"
24,7,37,1383,442,423,865,"6 de julio de 1997"
24,7,37,1384,257,190,447,"6 de julio de 1997"
24,7,37,1385,509,511,1020,"6 de julio de 1997"
24,7,37,1386,385,403,788,"6 de julio de 1997"
24,7,37,1387,293,263,556,"6 de julio de 1997"
24,7,37,1388,456,422,878,"6 de julio de 1997"
24,7,37,1389,246,187,433,"6 de julio de 1997"
24,7,37,1390,408,359,767,"6 de julio de 1997"
24,7,37,1391,411,400,811,"6 de julio de 1997"
24,7,37,1392,569,456,1025,"6 de julio de 1997"
24,7,37,1393,390,360,750,"6 de julio de 1997"
24,7,37,1394,211,183,394,"6 de julio de 1997"
24,7,37,1395,641,670,1311,"6 de julio de 1997"
24,7,37,1396,368,381,749,"6 de julio de 1997"
24,7,37,1397,262,238,500,"6 de julio de 1997"
24,7,37,1398,547,442,989,"6 de julio de 1997"
24,7,37,1399,287,261,548,"6 de julio de 1997"
24,7,37,1400,222,184,406,"6 de julio de 1997"
24,7,37,1401,310,286,596,"6 de julio de 1997"
24,7,37,1402,296,265,561,"6 de julio de 1997"
24,7,37,1403,135,125,260,"6 de julio de 1997"
24,7,37,1404,329,311,640,"6 de julio de 1997"
24,7,37,1405,236,209,445,"6 de julio de 1997"
24,7,37,1406,229,193,422,"6 de julio de 1997"
24,7,37,1407,268,231,499,"6 de julio de 1997"
24,7,37,1408,219,163,382,"6 de julio de 1997"
24,7,37,1409,524,423,947,"6 de julio de 1997"
24,7,37,1410,499,414,913,"6 de julio de 1997"
24,7,37,1411,415,439,854,"6 de julio de 1997"
24,7,38,1412,242,257,499,"6 de julio de 1997"
24,7,38,1413,119,132,251,"6 de julio de 1997"
24,7,38,1414,308,252,560,"6 de julio de 1997"
24,7,38,1415,167,146,313,"6 de julio de 1997"
24,7,38,1416,101,92,193,"6 de julio de 1997"
24,7,38,1417,386,332,718,"6 de julio de 1997"
24,7,38,1418,453,373,826,"6 de julio de 1997"
24,7,38,1419,151,120,271,"6 de julio de 1997"
24,7,38,1420,86,82,168,"6 de julio de 1997"
24,7,38,1421,218,168,386,"6 de julio de 1997"
24,7,38,1422,274,238,512,"6 de julio de 1997"
24,7,38,1423,299,258,557,"6 de julio de 1997"
24,7,38,1424,262,245,507,"6 de julio de 1997"
24,7,38,1425,355,280,635,"6 de julio de 1997"
24,7,38,1426,207,186,393,"6 de julio de 1997"
24,7,38,1427,503,446,949,"6 de julio de 1997"
24,7,54,1705,532,507,1039,"6 de julio de 1997"
24,7,54,1706,459,505,964,"6 de julio de 1997"
24,7,54,1707,303,339,642,"6 de julio de 1997"
24,7,54,1708,406,461,867,"6 de julio de 1997"
24,7,54,1709,310,301,611,"6 de julio de 1997"
24,7,54,1710,247,218,465,"6 de julio de 1997"
24,7,54,1711,527,492,1019,"6 de julio de 1997"
24,7,54,1712,204,180,384,"6 de julio de 1997"
24,7,54,1713,181,143,324,"6 de julio de 1997"
24,7,54,1714,397,388,785,"6 de julio de 1997"
24,7,54,1715,235,242,477,"6 de julio de 1997"
24,7,54,1716,414,377,791,"6 de julio de 1997"
24,7,54,1717,249,234,483,"6 de julio de 1997"
24,7,54,1718,285,271,556,"6 de julio de 1997"
24,7,54,1719,409,371,780,"6 de julio de 1997"
24,7,54,1720,694,669,1363,"6 de julio de 1997"
24,7,54,1721,345,300,645,"6 de julio de 1997"
24,7,54,1722,417,354,771,"6 de julio de 1997"
24,7,54,1723,460,423,883,"6 de julio de 1997"
24,7,54,1724,386,359,745,"6 de julio de 1997"
24,7,54,1725,520,443,963,"6 de julio de 1997"
24,7,55,1726,436,478,914,"6 de julio de 1997"
24,7,55,1727,398,437,835,"6 de julio de 1997"
24,7,55,1728,249,261,510,"6 de julio de 1997"
24,7,55,1729,207,244,451,"6 de julio de 1997"
24,7,55,1730,430,444,874,"6 de julio de 1997"
24,7,55,1731,398,340,738,"6 de julio de 1997"
24,7,55,1732,387,360,747,"6 de julio de 1997"
24,7,55,1733,163,153,316,"6 de julio de 1997"
24,7,55,1734,152,145,297,"6 de julio de 1997"
24,7,55,1735,277,217,494,"6 de julio de 1997"
24,7,55,1736,82,67,149,"6 de julio de 1997"
24,7,55,1737,202,171,373,"6 de julio de 1997"
24,7,55,1738,143,124,267,"6 de julio de 1997"
24,7,55,1739,416,375,791,"6 de julio de 1997"
24,7,55,1740,237,261,498,"6 de julio de 1997"
24,7,55,1741,294,242,536,"6 de julio de 1997"
24,7,55,1742,142,138,280,"6 de julio de 1997"
24,7,55,1743,178,161,339,"6 de julio de 1997"
24,7,55,1744,187,161,348,"6 de julio de 1997"
24,7,55,1745,87,69,156,"6 de julio de 1997"
24,7,55,1746,107,103,210,"6 de julio de 1997"
24,7,55,1747,338,273,611,"6 de julio de 1997"
24,7,55,1748,148,137,285,"6 de julio de 1997"
24,7,55,1749,364,299,663,"6 de julio de 1997"
24,7,55,1750,262,187,449,"6 de julio de 1997"
24,7,55,1751,340,310,650,"6 de julio de 1997"
24,7,55,1752,173,168,341,"6 de julio de 1997"
24,7,55,1753,317,260,577,"6 de julio de 1997"
24,7,55,1754,199,164,363,"6 de julio de 1997"
24,7,55,1755,307,284,591,"6 de julio de 1997"
24,7,55,1756,149,166,315,"6 de julio de 1997"
24,7,55,1757,129,97,226,"6 de julio de 1997"
24,7,55,1758,185,141,326,"6 de julio de 1997"
24,7,55,1759,268,260,528,"6 de julio de 1997"
24,7,55,1760,333,268,601,"6 de julio de 1997"
24,7,55,1761,169,162,331,"6 de julio de 1997"
24,7,55,1762,386,310,696,"6 de julio de 1997"
24,7,55,1763,270,232,502,"6 de julio de 1997"
24,7,55,1764,104,73,177,"6 de julio de 1997"
24,7,55,1765,217,174,391,"6 de julio de 1997"
24,7,55,1766,240,202,442,"6 de julio de 1997"
24,7,55,1767,342,272,614,"6 de julio de 1997"
24,7,55,1768,157,164,321,"6 de julio de 1997"
24,7,55,1769,375,406,781,"6 de julio de 1997"
24,7,55,1770,183,143,326,"6 de julio de 1997"
24,7,55,1771,181,146,327,"6 de julio de 1997"
24,7,55,1772,301,279,580,"6 de julio de 1997"
24,7,58,1349,392,378,770,"6 de julio de 1997"
24,7,58,1350,313,258,571,"6 de julio de 1997"
24,7,58,1351,394,344,738,"6 de julio de 1997"
24,7,58,1352,290,273,563,"6 de julio de 1997"
24,7,58,1353,470,442,912,"6 de julio de 1997"
24,7,58,1354,51,49,100,"6 de julio de 1997"
24,7,58,1355,487,563,1050,"6 de julio de 1997"
24,7,58,1356,408,420,828,"6 de julio de 1997"
24,7,58,1357,219,191,410,"6 de julio de 1997"
24,7,58,1358,779,679,1458,"6 de julio de 1997"
24,7,58,1359,486,463,949,"6 de julio de 1997"
24,7,58,1360,200,170,370,"6 de julio de 1997"
24,7,58,1361,148,106,254,"6 de julio de 1997"
24,7,58,1362,459,364,823,"6 de julio de 1997"
24,7,58,1363,488,416,904,"6 de julio de 1997"
24,7,58,1364,542,515,1057,"6 de julio de 1997"
24,7,58,1366,294,269,563,"6 de julio de 1997"
25,1,7,1726,280,228,508,"6 de julio de 1997"
25,1,7,1727,387,326,713,"6 de julio de 1997"
25,1,7,1728,148,147,295,"6 de julio de 1997"
25,1,7,1729,270,241,511,"6 de julio de 1997"
25,1,7,1730,261,225,486,"6 de julio de 1997"
25,1,7,1731,176,169,345,"6 de julio de 1997"
25,1,7,1732,81,67,148,"6 de julio de 1997"
25,1,7,1733,349,298,647,"6 de julio de 1997"
25,1,7,1734,139,133,272,"6 de julio de 1997"
25,1,7,1735,365,275,640,"6 de julio de 1997"
25,1,7,1736,56,58,114,"6 de julio de 1997"
25,1,7,1737,52,35,87,"6 de julio de 1997"
25,1,7,1738,40,17,57,"6 de julio de 1997"
25,1,7,1739,52,44,96,"6 de julio de 1997"
25,1,7,1740,84,54,138,"6 de julio de 1997"
25,1,7,1741,73,74,147,"6 de julio de 1997"
25,1,7,1742,95,57,152,"6 de julio de 1997"
25,1,7,1743,117,77,194,"6 de julio de 1997"
25,1,7,1744,92,84,176,"6 de julio de 1997"
25,1,7,1745,268,216,484,"6 de julio de 1997"
25,1,7,1746,151,124,275,"6 de julio de 1997"
25,1,7,1747,53,46,99,"6 de julio de 1997"
25,1,7,1748,57,19,76,"6 de julio de 1997"
25,1,7,1749,128,88,216,"6 de julio de 1997"
25,1,7,1750,146,98,244,"6 de julio de 1997"
25,1,7,1751,85,67,152,"6 de julio de 1997"
25,1,7,1752,100,63,163,"6 de julio de 1997"
25,1,7,1753,59,51,110,"6 de julio de 1997"
25,1,7,1754,132,105,237,"6 de julio de 1997"
25,1,7,1755,196,175,371,"6 de julio de 1997"
25,1,7,1756,96,72,168,"6 de julio de 1997"
25,1,7,1757,67,61,128,"6 de julio de 1997"
25,1,7,1758,154,115,269,"6 de julio de 1997"
25,1,7,1759,124,82,206,"6 de julio de 1997"
25,1,7,1760,70,43,113,"6 de julio de 1997"
25,1,7,1761,100,81,181,"6 de julio de 1997"
25,1,7,1762,77,48,125,"6 de julio de 1997"
25,1,7,1763,78,64,142,"6 de julio de 1997"
25,1,7,1764,197,149,346,"6 de julio de 1997"
25,1,7,1765,61,20,81,"6 de julio de 1997"
25,1,7,1766,85,68,153,"6 de julio de 1997"
25,1,7,1767,65,50,115,"6 de julio de 1997"
25,1,7,1768,148,101,249,"6 de julio de 1997"
25,1,7,1769,250,174,424,"6 de julio de 1997"
25,1,7,1770,172,130,302,"6 de julio de 1997"
25,1,7,1771,159,117,276,"6 de julio de 1997"
25,1,7,1772,176,128,304,"6 de julio de 1997"
25,1,7,1773,146,109,255,"6 de julio de 1997"
25,1,7,1774,140,111,251,"6 de julio de 1997"
25,1,7,1775,180,130,310,"6 de julio de 1997"
25,1,7,1776,126,91,217,"6 de julio de 1997"
25,1,7,1777,73,49,122,"6 de julio de 1997"
25,1,7,1778,161,124,285,"6 de julio de 1997"
25,1,7,1779,113,101,214,"6 de julio de 1997"
25,1,7,1780,88,52,140,"6 de julio de 1997"
25,1,7,1781,50,44,94,"6 de julio de 1997"
25,1,7,1782,185,128,313,"6 de julio de 1997"
25,1,7,1783,97,62,159,"6 de julio de 1997"
25,1,7,1784,235,163,398,"6 de julio de 1997"
25,1,7,1785,94,66,160,"6 de julio de 1997"
25,1,7,1786,137,116,253,"6 de julio de 1997"
25,1,7,1787,228,163,391,"6 de julio de 1997"
25,1,7,1788,214,165,379,"6 de julio de 1997"
25,1,7,1789,106,89,195,"6 de julio de 1997"
25,1,7,1790,134,105,239,"6 de julio de 1997"
25,1,7,1791,108,80,188,"6 de julio de 1997"
25,1,7,1792,141,108,249,"6 de julio de 1997"
25,1,7,1793,173,140,313,"6 de julio de 1997"
25,1,7,1794,109,87,196,"6 de julio de 1997"
25,1,7,1795,58,42,100,"6 de julio de 1997"
25,1,7,1796,128,93,221,"6 de julio de 1997"
25,1,7,1797,206,128,334,"6 de julio de 1997"
25,1,7,1798,90,45,135,"6 de julio de 1997"
25,1,10,1925,180,188,368,"6 de julio de 1997"
25,1,10,1926,151,175,326,"6 de julio de 1997"
25,1,10,1927,177,180,357,"6 de julio de 1997"
25,1,10,1928,185,183,368,"6 de julio de 1997"
25,1,10,1929,185,174,359,"6 de julio de 1997"
25,1,10,1930,221,217,438,"6 de julio de 1997"
25,1,10,1931,138,163,301,"6 de julio de 1997"
25,1,10,1932,147,177,324,"6 de julio de 1997"
25,1,10,1933,185,199,384,"6 de julio de 1997"
25,1,10,1934,210,211,421,"6 de julio de 1997"
25,1,10,1935,155,147,302,"6 de julio de 1997"
25,1,10,1936,143,158,301,"6 de julio de 1997"
25,1,10,1937,172,171,343,"6 de julio de 1997"
25,1,10,1938,312,320,632,"6 de julio de 1997"
25,1,10,1939,188,177,365,"6 de julio de 1997"
25,1,10,1940,189,185,374,"6 de julio de 1997"
25,1,10,1941,269,257,526,"6 de julio de 1997"
25,1,10,1942,202,232,434,"6 de julio de 1997"
25,1,10,1943,80,75,155,"6 de julio de 1997"
25,1,10,1944,185,145,330,"6 de julio de 1997"
25,1,10,1945,91,73,164,"6 de julio de 1997"
25,1,10,1946,65,44,109,"6 de julio de 1997"
25,1,10,1947,57,50,107,"6 de julio de 1997"
25,1,10,1948,164,130,294,"6 de julio de 1997"
25,1,10,1949,110,80,190,"6 de julio de 1997"
25,1,10,1950,51,33,84,"6 de julio de 1997"
25,1,10,1951,100,66,166,"6 de julio de 1997"
25,1,10,1952,97,67,164,"6 de julio de 1997"
25,1,10,1953,72,55,127,"6 de julio de 1997"
25,1,10,1954,70,53,123,"6 de julio de 1997"
25,1,10,1955,145,130,275,"6 de julio de 1997"
25,1,10,1956,91,94,185,"6 de julio de 1997"
25,1,10,1957,251,246,497,"6 de julio de 1997"
25,1,10,1958,104,100,204,"6 de julio de 1997"
25,1,10,1959,83,64,147,"6 de julio de 1997"
25,1,10,1960,215,153,368,"6 de julio de 1997"
25,1,10,1961,160,129,289,"6 de julio de 1997"
25,1,10,1962,198,145,343,"6 de julio de 1997"
25,1,10,1963,96,70,166,"6 de julio de 1997"
25,1,10,1964,53,41,94,"6 de julio de 1997"
25,1,10,1965,185,141,326,"6 de julio de 1997"
25,1,10,1966,115,112,227,"6 de julio de 1997"
25,1,10,1967,109,104,213,"6 de julio de 1997"
25,1,10,1968,40,40,80,"6 de julio de 1997"
25,1,10,1969,169,157,326,"6 de julio de 1997"
25,1,10,1970,183,129,312,"6 de julio de 1997"
25,1,10,1971,165,160,325,"6 de julio de 1997"
25,1,10,1972,149,135,284,"6 de julio de 1997"
25,1,10,1973,110,89,199,"6 de julio de 1997"
25,1,10,1974,106,67,173,"6 de julio de 1997"
25,1,10,1975,55,40,95,"6 de julio de 1997"
25,1,10,1976,106,69,175,"6 de julio de 1997"
25,1,10,1977,168,99,267,"6 de julio de 1997"
25,1,10,1978,121,93,214,"6 de julio de 1997"
25,1,10,1979,70,60,130,"6 de julio de 1997"
25,1,10,1980,99,95,194,"6 de julio de 1997"
25,1,10,1981,199,159,358,"6 de julio de 1997"
25,1,10,1982,118,81,199,"6 de julio de 1997"
25,1,10,1983,66,42,108,"6 de julio de 1997"
25,1,10,1984,56,38,94,"6 de julio de 1997"
25,1,10,1985,97,51,148,"6 de julio de 1997"
25,1,10,1986,120,89,209,"6 de julio de 1997"
25,1,10,1987,57,49,106,"6 de julio de 1997"
25,1,10,1988,192,146,338,"6 de julio de 1997"
25,1,10,1989,111,109,220,"6 de julio de 1997"
25,1,10,1990,122,98,220,"6 de julio de 1997"
25,1,10,1991,227,186,413,"6 de julio de 1997"
25,1,10,1992,102,78,180,"6 de julio de 1997"
25,1,10,1993,136,101,237,"6 de julio de 1997"
25,1,10,1994,157,138,295,"6 de julio de 1997"
25,1,10,1995,73,44,117,"6 de julio de 1997"
25,1,10,1996,138,109,247,"6 de julio de 1997"
25,1,10,1997,176,151,327,"6 de julio de 1997"
25,1,10,1998,202,150,352,"6 de julio de 1997"
25,1,10,1999,65,49,114,"6 de julio de 1997"
25,1,10,2000,101,82,183,"6 de julio de 1997"
25,1,10,2001,134,108,242,"6 de julio de 1997"
25,1,10,2002,126,93,219,"6 de julio de 1997"
25,1,10,2003,87,84,171,"6 de julio de 1997"
25,1,10,2004,176,175,351,"6 de julio de 1997"
25,1,10,2005,209,199,408,"6 de julio de 1997"
25,1,10,2006,254,263,517,"6 de julio de 1997"
25,1,10,2007,218,198,416,"6 de julio de 1997"
25,1,10,2008,154,176,330,"6 de julio de 1997"
25,1,10,2009,214,223,437,"6 de julio de 1997"
25,1,10,2010,265,264,529,"6 de julio de 1997"
25,1,10,2011,160,164,324,"6 de julio de 1997"
25,1,10,2012,284,259,543,"6 de julio de 1997"
25,1,10,2013,200,176,376,"6 de julio de 1997"
25,1,10,2014,215,192,407,"6 de julio de 1997"
25,1,10,2015,171,180,351,"6 de julio de 1997"
25,1,10,2016,135,107,242,"6 de julio de 1997"
25,1,10,2017,186,154,340,"6 de julio de 1997"
25,1,10,2018,64,50,114,"6 de julio de 1997"
25,1,10,2019,202,195,397,"6 de julio de 1997"
25,1,10,2020,89,72,161,"6 de julio de 1997"
25,1,10,2021,202,164,366,"6 de julio de 1997"
25,1,10,2022,61,54,115,"6 de julio de 1997"
25,1,10,2023,158,195,353,"6 de julio de 1997"
25,1,10,2024,154,166,320,"6 de julio de 1997"
25,1,10,2025,127,142,269,"6 de julio de 1997"
25,1,10,2026,134,156,290,"6 de julio de 1997"
25,1,10,2027,78,77,155,"6 de julio de 1997"
25,1,10,2028,149,174,323,"6 de julio de 1997"
25,1,10,2029,157,181,338,"6 de julio de 1997"
25,1,10,2030,150,182,332,"6 de julio de 1997"
25,1,10,2031,188,212,400,"6 de julio de 1997"
25,1,10,2032,300,282,582,"6 de julio de 1997"
25,1,10,2033,109,102,211,"6 de julio de 1997"
25,1,10,2034,163,171,334,"6 de julio de 1997"
25,1,10,2035,125,118,243,"6 de julio de 1997"
25,1,10,2036,73,52,125,"6 de julio de 1997"
25,1,10,2037,74,65,139,"6 de julio de 1997"
25,1,10,2038,135,77,212,"6 de julio de 1997"
25,1,10,2039,309,272,581,"6 de julio de 1997"
25,1,10,2040,96,86,182,"6 de julio de 1997"
25,1,10,2041,115,106,221,"6 de julio de 1997"
25,1,10,2042,92,80,172,"6 de julio de 1997"
25,1,10,2043,238,238,476,"6 de julio de 1997"
25,1,10,2044,227,227,454,"6 de julio de 1997"
25,1,10,2045,121,102,223,"6 de julio de 1997"
25,1,10,2046,133,110,243,"6 de julio de 1997"
25,1,10,2047,246,202,448,"6 de julio de 1997"
25,1,10,2048,235,211,446,"6 de julio de 1997"
25,1,10,2049,189,174,363,"6 de julio de 1997"
25,1,10,2050,260,254,514,"6 de julio de 1997"
25,1,10,2051,75,49,124,"6 de julio de 1997"
25,1,10,2052,34,27,61,"6 de julio de 1997"
25,1,10,2053,64,55,119,"6 de julio de 1997"
25,1,10,2054,112,116,228,"6 de julio de 1997"
25,1,10,2055,217,228,445,"6 de julio de 1997"
25,1,10,2056,151,113,264,"6 de julio de 1997"
25,1,10,2057,107,103,210,"6 de julio de 1997"
25,1,10,2058,161,149,310,"6 de julio de 1997"
25,1,10,2059,139,115,254,"6 de julio de 1997"
25,1,10,2060,198,188,386,"6 de julio de 1997"
25,1,10,2061,270,264,534,"6 de julio de 1997"
25,1,10,2062,231,211,442,"6 de julio de 1997"
25,1,10,2063,236,210,446,"6 de julio de 1997"
25,1,10,2064,212,198,410,"6 de julio de 1997"
25,1,10,2065,166,159,325,"6 de julio de 1997"
25,1,10,2066,280,271,551,"6 de julio de 1997"
25,1,10,2067,299,319,618,"6 de julio de 1997"
25,1,10,2068,305,326,631,"6 de julio de 1997"
25,1,10,2069,166,168,334,"6 de julio de 1997"
25,1,10,2070,186,175,361,"6 de julio de 1997"
25,1,10,2071,112,80,192,"6 de julio de 1997"
25,1,10,2072,177,173,350,"6 de julio de 1997"
25,1,10,2073,235,217,452,"6 de julio de 1997"
25,1,10,2074,226,253,479,"6 de julio de 1997"
25,1,10,2075,206,220,426,"6 de julio de 1997"
25,1,10,2076,185,178,363,"6 de julio de 1997"
25,1,10,2077,202,168,370,"6 de julio de 1997"
25,1,10,2078,165,136,301,"6 de julio de 1997"
25,1,10,2079,133,107,240,"6 de julio de 1997"
25,1,10,2080,111,92,203,"6 de julio de 1997"
25,1,10,2081,100,82,182,"6 de julio de 1997"
25,1,10,2082,246,254,500,"6 de julio de 1997"
25,1,10,2083,149,139,288,"6 de julio de 1997"
25,1,10,2084,112,105,217,"6 de julio de 1997"
25,1,10,2085,179,170,349,"6 de julio de 1997"
25,1,10,2086,222,193,415,"6 de julio de 1997"
25,1,10,2087,155,136,291,"6 de julio de 1997"
25,1,10,2088,200,207,407,"6 de julio de 1997"
25,1,10,2089,191,188,379,"6 de julio de 1997"
25,1,10,2090,197,179,376,"6 de julio de 1997"
25,1,10,2091,148,129,277,"6 de julio de 1997"
25,1,10,2092,216,200,416,"6 de julio de 1997"
25,1,10,2093,164,147,311,"6 de julio de 1997"
25,1,10,2094,166,148,314,"6 de julio de 1997"
25,1,10,2095,392,362,754,"6 de julio de 1997"
25,1,10,2096,372,331,703,"6 de julio de 1997"
25,1,10,2097,258,209,467,"6 de julio de 1997"
25,1,10,2098,251,252,503,"6 de julio de 1997"
25,1,10,2099,462,428,890,"6 de julio de 1997"
25,1,10,2100,276,259,535,"6 de julio de 1997"
25,1,15,3220,290,299,589,"6 de julio de 1997"
25,1,15,3221,222,208,430,"6 de julio de 1997"
25,1,15,3222,323,338,661,"6 de julio de 1997"
25,1,15,3223,115,140,255,"6 de julio de 1997"
25,1,15,3224,364,422,786,"6 de julio de 1997"
25,1,15,3225,127,160,287,"6 de julio de 1997"
25,1,15,3226,210,200,410,"6 de julio de 1997"
25,1,15,3227,188,231,419,"6 de julio de 1997"
25,1,15,3228,214,213,427,"6 de julio de 1997"
25,1,15,3229,154,177,331,"6 de julio de 1997"
25,1,15,3230,89,98,187,"6 de julio de 1997"
25,1,15,3231,72,73,145,"6 de julio de 1997"
25,1,15,3232,62,73,135,"6 de julio de 1997"
25,1,15,3233,198,193,391,"6 de julio de 1997"
25,1,15,3234,150,163,313,"6 de julio de 1997"
25,1,15,3235,207,190,397,"6 de julio de 1997"
25,1,15,3236,90,127,217,"6 de julio de 1997"
25,1,15,3237,329,80,409,"6 de julio de 1997"
25,1,15,3238,179,196,375,"6 de julio de 1997"
25,1,15,3239,151,165,316,"6 de julio de 1997"
25,1,15,3240,101,103,204,"6 de julio de 1997"
25,1,15,3241,182,163,345,"6 de julio de 1997"
25,1,15,3242,149,156,305,"6 de julio de 1997"
25,1,15,3243,72,75,147,"6 de julio de 1997"
25,1,15,3244,81,86,167,"6 de julio de 1997"
25,1,15,3245,142,135,277,"6 de julio de 1997"
25,1,15,3246,125,146,271,"6 de julio de 1997"
25,1,15,3247,176,207,383,"6 de julio de 1997"
25,1,15,3248,115,131,246,"6 de julio de 1997"
25,1,15,3249,120,141,261,"6 de julio de 1997"
25,1,15,3250,137,170,307,"6 de julio de 1997"
25,1,15,3251,56,67,123,"6 de julio de 1997"
25,1,15,3252,103,113,216,"6 de julio de 1997"
25,1,15,3253,122,140,262,"6 de julio de 1997"
25,1,15,3254,100,123,223,"6 de julio de 1997"
25,1,15,3255,87,104,191,"6 de julio de 1997"
25,1,15,3256,84,80,164,"6 de julio de 1997"
25,1,15,3257,106,130,236,"6 de julio de 1997"
25,1,15,3258,163,184,347,"6 de julio de 1997"
25,1,15,3259,93,104,197,"6 de julio de 1997"
25,1,15,3260,65,61,126,"6 de julio de 1997"
25,1,15,3261,42,55,97,"6 de julio de 1997"
25,1,15,3262,73,92,165,"6 de julio de 1997"
25,1,15,3263,84,80,164,"6 de julio de 1997"
25,1,15,3264,53,55,108,"6 de julio de 1997"
25,1,15,3265,94,90,184,"6 de julio de 1997"
25,1,15,3266,39,60,99,"6 de julio de 1997"
25,1,15,3267,67,84,151,"6 de julio de 1997"
25,1,15,3268,163,205,368,"6 de julio de 1997"
25,1,15,3269,121,141,262,"6 de julio de 1997"
25,1,15,3270,87,109,196,"6 de julio de 1997"
25,1,15,3271,110,121,231,"6 de julio de 1997"
25,1,15,3272,185,191,376,"6 de julio de 1997"
25,1,15,3273,287,348,635,"6 de julio de 1997"
25,1,15,3274,210,238,448,"6 de julio de 1997"
25,1,15,3275,383,457,840,"6 de julio de 1997"
25,1,15,3276,213,232,445,"6 de julio de 1997"
25,1,15,3277,194,231,425,"6 de julio de 1997"
25,1,15,3278,145,160,305,"6 de julio de 1997"
25,1,15,3279,176,199,375,"6 de julio de 1997"
25,1,15,3280,178,185,363,"6 de julio de 1997"
25,1,15,3281,209,230,439,"6 de julio de 1997"
25,1,15,3282,141,203,344,"6 de julio de 1997"
25,1,15,3283,173,179,352,"6 de julio de 1997"
25,1,15,3284,282,320,602,"6 de julio de 1997"
25,1,15,3285,235,241,476,"6 de julio de 1997"
25,1,15,3286,169,183,352,"6 de julio de 1997"
25,1,15,3287,98,117,215,"6 de julio de 1997"
25,1,15,3288,147,157,304,"6 de julio de 1997"
25,1,15,3289,77,100,177,"6 de julio de 1997"
25,1,15,3290,90,100,190,"6 de julio de 1997"
25,1,15,3291,100,110,210,"6 de julio de 1997"
25,1,15,3292,97,110,207,"6 de julio de 1997"
25,1,15,3293,104,141,245,"6 de julio de 1997"
25,1,15,3294,116,137,253,"6 de julio de 1997"
25,1,15,3295,121,130,251,"6 de julio de 1997"
25,1,15,3296,88,81,169,"6 de julio de 1997"
25,1,15,3297,116,116,232,"6 de julio de 1997"
25,1,15,3298,153,143,296,"6 de julio de 1997"
25,1,15,3299,120,125,245,"6 de julio de 1997"
25,1,15,3300,112,134,246,"6 de julio de 1997"
25,1,15,3301,116,121,237,"6 de julio de 1997"
25,1,15,3302,125,143,268,"6 de julio de 1997"
25,1,15,3303,92,112,204,"6 de julio de 1997"
25,1,15,3304,219,261,480,"6 de julio de 1997"
25,1,15,3305,151,178,329,"6 de julio de 1997"
25,1,15,3306,227,279,506,"6 de julio de 1997"
25,1,15,3307,191,209,400,"6 de julio de 1997"
25,1,15,3308,166,180,346,"6 de julio de 1997"
25,1,15,3309,168,176,344,"6 de julio de 1997"
25,1,15,3310,128,168,296,"6 de julio de 1997"
25,1,15,3311,143,157,300,"6 de julio de 1997"
25,1,15,3312,113,111,224,"6 de julio de 1997"
25,1,15,3313,147,139,286,"6 de julio de 1997"
25,1,15,3314,140,141,281,"6 de julio de 1997"
25,1,15,3315,149,149,298,"6 de julio de 1997"
25,1,15,3316,167,176,343,"6 de julio de 1997"
25,1,15,3317,129,138,267,"6 de julio de 1997"
25,1,15,3318,138,154,292,"6 de julio de 1997"
25,1,15,3319,134,167,301,"6 de julio de 1997"
25,1,15,3320,281,319,600,"6 de julio de 1997"
25,1,15,3321,167,194,361,"6 de julio de 1997"
25,1,15,3322,160,167,327,"6 de julio de 1997"
25,1,15,3323,167,224,391,"6 de julio de 1997"
25,1,15,3324,65,75,140,"6 de julio de 1997"
25,1,15,3325,92,83,175,"6 de julio de 1997"
25,1,15,3326,53,53,106,"6 de julio de 1997"
25,1,15,3327,136,118,254,"6 de julio de 1997"
25,1,15,3328,125,89,214,"6 de julio de 1997"
25,1,15,3329,124,103,227,"6 de julio de 1997"
25,1,15,3330,99,69,168,"6 de julio de 1997"
25,1,15,3331,88,78,166,"6 de julio de 1997"
25,1,15,3332,100,92,192,"6 de julio de 1997"
25,1,15,3333,83,102,185,"6 de julio de 1997"
25,1,15,3334,102,84,186,"6 de julio de 1997"
25,1,15,3335,68,77,145,"6 de julio de 1997"
25,1,15,3336,204,217,421,"6 de julio de 1997"
25,1,15,3337,227,241,468,"6 de julio de 1997"
25,1,15,3338,104,98,202,"6 de julio de 1997"
25,1,15,3339,99,112,211,"6 de julio de 1997"
25,1,15,3340,124,135,259,"6 de julio de 1997"
25,1,15,3341,129,128,257,"6 de julio de 1997"
25,1,15,3342,108,106,214,"6 de julio de 1997"
25,1,15,3343,101,111,212,"6 de julio de 1997"
25,1,15,3344,76,90,166,"6 de julio de 1997"
25,1,15,3345,110,95,205,"6 de julio de 1997"
25,1,15,3346,99,99,198,"6 de julio de 1997"
25,1,15,3347,86,80,166,"6 de julio de 1997"
25,1,15,3348,112,100,212,"6 de julio de 1997"
25,1,15,3349,146,160,306,"6 de julio de 1997"
25,1,15,3350,255,231,486,"6 de julio de 1997"
25,1,15,3351,87,98,185,"6 de julio de 1997"
25,1,15,3352,171,156,327,"6 de julio de 1997"
25,1,15,3353,151,132,283,"6 de julio de 1997"
25,1,15,3354,123,99,222,"6 de julio de 1997"
25,1,15,3355,174,202,376,"6 de julio de 1997"
25,1,15,3356,147,150,297,"6 de julio de 1997"
25,1,15,3357,151,137,288,"6 de julio de 1997"
25,1,15,3358,209,184,393,"6 de julio de 1997"
25,1,15,3359,104,85,189,"6 de julio de 1997"
25,1,15,3360,146,119,265,"6 de julio de 1997"
25,1,15,3361,72,67,139,"6 de julio de 1997"
25,1,15,3362,125,102,227,"6 de julio de 1997"
25,1,15,3363,93,87,180,"6 de julio de 1997"
25,1,15,3364,59,54,113,"6 de julio de 1997"
25,1,15,3365,79,65,144,"6 de julio de 1997"
25,1,15,3366,89,67,156,"6 de julio de 1997"
25,1,15,3367,106,84,190,"6 de julio de 1997"
25,1,15,3368,72,59,131,"6 de julio de 1997"
25,1,15,3369,44,42,86,"6 de julio de 1997"
25,1,17,3420,200,220,420,"6 de julio de 1997"
25,1,17,3421,149,162,311,"6 de julio de 1997"
25,1,17,3422,199,214,413,"6 de julio de 1997"
25,1,17,3423,299,325,624,"6 de julio de 1997"
25,1,17,3424,123,133,256,"6 de julio de 1997"
25,1,17,3425,160,162,322,"6 de julio de 1997"
25,1,17,3426,49,21,70,"6 de julio de 1997"
25,1,17,3427,38,22,60,"6 de julio de 1997"
25,1,17,3428,29,20,49,"6 de julio de 1997"
25,1,17,3429,36,25,61,"6 de julio de 1997"
25,1,17,3430,93,45,138,"6 de julio de 1997"
25,1,17,3431,146,104,250,"6 de julio de 1997"
25,1,17,3432,152,111,263,"6 de julio de 1997"
25,1,17,3433,181,121,302,"6 de julio de 1997"
25,1,17,3434,69,64,133,"6 de julio de 1997"
25,1,17,3435,166,128,294,"6 de julio de 1997"
25,1,17,3436,265,162,427,"6 de julio de 1997"
25,1,17,3437,83,50,133,"6 de julio de 1997"
25,1,17,3438,65,26,91,"6 de julio de 1997"
25,1,17,3439,169,118,287,"6 de julio de 1997"
25,1,17,3440,38,19,57,"6 de julio de 1997"
25,1,17,3441,56,36,92,"6 de julio de 1997"
25,1,17,3442,94,52,146,"6 de julio de 1997"
25,1,17,3443,166,115,281,"6 de julio de 1997"
25,1,17,3444,113,92,205,"6 de julio de 1997"
25,1,17,3445,89,47,136,"6 de julio de 1997"
25,1,17,3446,196,147,343,"6 de julio de 1997"
25,1,17,3447,146,118,264,"6 de julio de 1997"
25,1,17,3448,67,50,117,"6 de julio de 1997"
25,1,17,3449,61,45,106,"6 de julio de 1997"
25,1,17,3450,124,105,229,"6 de julio de 1997"
25,1,17,3451,292,291,583,"6 de julio de 1997"
25,1,17,3452,200,165,365,"6 de julio de 1997"
25,1,17,3453,75,64,139,"6 de julio de 1997"
25,1,17,3454,68,46,114,"6 de julio de 1997"
25,1,17,3455,161,125,286,"6 de julio de 1997"
25,1,17,3456,147,135,282,"6 de julio de 1997"
25,1,17,3457,38,28,66,"6 de julio de 1997"
25,1,17,3458,56,35,91,"6 de julio de 1997"
25,1,17,3459,132,86,218,"6 de julio de 1997"
25,1,17,3460,35,19,54,"6 de julio de 1997"
25,1,17,3461,202,123,325,"6 de julio de 1997"
25,1,17,3462,48,28,76,"6 de julio de 1997"
25,1,17,3463,28,21,49,"6 de julio de 1997"
25,1,17,3464,113,81,194,"6 de julio de 1997"
25,1,17,3465,85,66,151,"6 de julio de 1997"
25,1,17,3466,102,63,165,"6 de julio de 1997"
25,1,17,3467,84,41,125,"6 de julio de 1997"
25,1,17,3468,113,87,200,"6 de julio de 1997"
25,1,17,3469,262,160,422,"6 de julio de 1997"
25,1,17,3470,229,196,425,"6 de julio de 1997"
25,1,17,3471,238,175,413,"6 de julio de 1997"
25,1,17,3472,99,74,173,"6 de julio de 1997"
25,1,17,3473,174,145,319,"6 de julio de 1997"
25,1,17,3474,158,148,306,"6 de julio de 1997"
25,1,17,3475,95,59,154,"6 de julio de 1997"
25,1,17,3476,149,99,248,"6 de julio de 1997"
25,1,17,3477,39,27,66,"6 de julio de 1997"
25,1,17,3478,272,256,528,"6 de julio de 1997"
25,1,17,3479,98,81,179,"6 de julio de 1997"
25,1,17,3480,237,211,448,"6 de julio de 1997"
25,1,17,3481,266,204,470,"6 de julio de 1997"
25,1,17,3482,217,172,389,"6 de julio de 1997"
25,1,17,3483,177,173,350,"6 de julio de 1997"
25,1,17,3484,180,121,301,"6 de julio de 1997"
25,1,17,3485,97,79,176,"6 de julio de 1997"
25,1,17,3486,135,82,217,"6 de julio de 1997"
25,1,17,3487,81,86,167,"6 de julio de 1997"
25,1,17,3488,186,198,384,"6 de julio de 1997"
25,1,17,3489,138,108,246,"6 de julio de 1997"
25,1,17,3490,175,201,376,"6 de julio de 1997"
25,1,17,3491,174,137,311,"6 de julio de 1997"
25,1,17,3492,79,63,142,"6 de julio de 1997"
25,1,17,3493,129,86,215,"6 de julio de 1997"
25,1,17,3494,95,87,182,"6 de julio de 1997"
25,1,17,3495,49,40,89,"6 de julio de 1997"
25,1,17,3496,100,68,168,"6 de julio de 1997"
25,1,17,3497,115,134,249,"6 de julio de 1997"
25,1,17,3498,70,68,138,"6 de julio de 1997"
25,1,17,3499,92,65,157,"6 de julio de 1997"
25,1,17,3500,48,43,91,"6 de julio de 1997"
25,1,17,3501,206,176,382,"6 de julio de 1997"
25,1,17,3502,190,154,344,"6 de julio de 1997"
25,1,17,3503,163,168,331,"6 de julio de 1997"
25,1,17,3504,64,52,116,"6 de julio de 1997"
25,1,17,3505,54,45,99,"6 de julio de 1997"
25,1,17,3506,109,82,191,"6 de julio de 1997"
25,1,17,3507,49,43,92,"6 de julio de 1997"
25,1,17,3508,262,220,482,"6 de julio de 1997"
25,1,17,3509,80,70,150,"6 de julio de 1997"
25,1,17,3510,153,135,288,"6 de julio de 1997"
25,1,17,3511,200,191,391,"6 de julio de 1997"
25,1,17,3512,127,110,237,"6 de julio de 1997"
25,1,17,3513,52,63,115,"6 de julio de 1997"
25,1,17,3514,46,35,81,"6 de julio de 1997"
25,1,17,3515,243,236,479,"6 de julio de 1997"
25,1,17,3516,125,125,250,"6 de julio de 1997"
25,1,17,3517,113,101,214,"6 de julio de 1997"
25,1,17,3518,297,321,618,"6 de julio de 1997"
25,1,17,3519,231,237,468,"6 de julio de 1997"
25,1,17,3520,206,218,424,"6 de julio de 1997"
25,1,17,3521,174,187,361,"6 de julio de 1997"
25,1,17,3522,90,77,167,"6 de julio de 1997"
25,1,17,3523,103,100,203,"6 de julio de 1997"
25,1,17,3524,159,150,309,"6 de julio de 1997"
25,1,17,3525,215,201,416,"6 de julio de 1997"
25,1,17,3526,173,187,360,"6 de julio de 1997"
25,1,17,3527,219,222,441,"6 de julio de 1997"
25,1,17,3528,149,137,286,"6 de julio de 1997"
25,1,17,3529,98,91,189,"6 de julio de 1997"
25,1,17,3530,86,68,154,"6 de julio de 1997"
25,1,17,3531,33,29,62,"6 de julio de 1997"
25,1,17,3532,188,175,363,"6 de julio de 1997"
25,1,17,3533,102,86,188,"6 de julio de 1997"
25,1,17,3534,163,158,321,"6 de julio de 1997"
25,1,17,3535,82,74,156,"6 de julio de 1997"
25,1,17,3536,149,150,299,"6 de julio de 1997"
25,1,17,3537,116,125,241,"6 de julio de 1997"
25,1,17,3538,128,142,270,"6 de julio de 1997"
25,1,17,3539,115,106,221,"6 de julio de 1997"
25,1,17,3540,148,133,281,"6 de julio de 1997"
25,1,17,3541,114,101,215,"6 de julio de 1997"
25,1,17,3542,92,88,180,"6 de julio de 1997"
25,1,17,3543,104,85,189,"6 de julio de 1997"
25,1,17,3544,123,89,212,"6 de julio de 1997"
25,1,17,3545,90,59,149,"6 de julio de 1997"
25,1,17,3546,168,138,306,"6 de julio de 1997"
25,1,17,3547,72,60,132,"6 de julio de 1997"
25,1,17,3548,79,58,137,"6 de julio de 1997"
25,1,17,3549,137,111,248,"6 de julio de 1997"
25,1,17,3550,99,66,165,"6 de julio de 1997"
25,1,17,3551,136,141,277,"6 de julio de 1997"
25,1,17,3552,160,166,326,"6 de julio de 1997"
25,1,17,3553,111,110,221,"6 de julio de 1997"
25,1,17,3554,130,105,235,"6 de julio de 1997"
25,1,17,3555,71,61,132,"6 de julio de 1997"
25,1,17,3556,92,60,152,"6 de julio de 1997"
25,1,17,3557,136,116,252,"6 de julio de 1997"
25,1,17,3558,111,99,210,"6 de julio de 1997"
25,1,17,3559,190,163,353,"6 de julio de 1997"
25,1,17,3560,100,78,178,"6 de julio de 1997"
25,1,17,3561,66,45,111,"6 de julio de 1997"
25,1,17,3562,154,142,296,"6 de julio de 1997"
25,1,17,3563,101,88,189,"6 de julio de 1997"
25,1,17,3564,153,136,289,"6 de julio de 1997"
25,1,17,3565,269,260,529,"6 de julio de 1997"
25,1,17,3566,211,212,423,"6 de julio de 1997"
25,1,17,3567,97,93,190,"6 de julio de 1997"
25,1,17,3568,157,186,343,"6 de julio de 1997"
25,1,17,3569,121,106,227,"6 de julio de 1997"
25,1,17,3570,131,149,280,"6 de julio de 1997"
25,1,17,3571,170,146,316,"6 de julio de 1997"
25,1,17,3572,318,273,591,"6 de julio de 1997"
25,1,17,3573,90,75,165,"6 de julio de 1997"
25,1,17,3574,50,49,99,"6 de julio de 1997"
25,1,17,3575,110,74,184,"6 de julio de 1997"
25,1,17,3576,223,216,439,"6 de julio de 1997"
25,1,17,3577,227,190,417,"6 de julio de 1997"
25,1,17,3578,208,200,408,"6 de julio de 1997"
25,1,17,3579,184,152,336,"6 de julio de 1997"
25,1,17,3580,197,172,369,"6 de julio de 1997"
25,1,17,3581,81,89,170,"6 de julio de 1997"
25,1,17,3582,200,189,389,"6 de julio de 1997"
25,1,17,3583,157,165,322,"6 de julio de 1997"
25,1,17,3584,257,225,482,"6 de julio de 1997"
25,1,17,3585,85,71,156,"6 de julio de 1997"
25,1,17,3586,136,122,258,"6 de julio de 1997"
25,1,17,3587,272,269,541,"6 de julio de 1997"
25,1,17,3588,116,115,231,"6 de julio de 1997"
25,1,17,3589,125,103,228,"6 de julio de 1997"
25,1,17,3590,342,328,670,"6 de julio de 1997"
25,1,17,3591,211,222,433,"6 de julio de 1997"
25,1,17,3592,167,157,324,"6 de julio de 1997"
25,1,17,3593,198,188,386,"6 de julio de 1997"
25,1,17,3594,234,214,448,"6 de julio de 1997"
25,1,17,3595,215,205,420,"6 de julio de 1997"
25,1,17,3596,81,87,168,"6 de julio de 1997"
25,1,17,3597,72,82,154,"6 de julio de 1997"
25,1,17,3598,136,121,257,"6 de julio de 1997"
25,1,17,3599,107,97,204,"6 de julio de 1997"
25,1,17,3600,145,159,304,"6 de julio de 1997"
25,1,17,3601,93,89,182,"6 de julio de 1997"
25,1,17,3602,60,55,115,"6 de julio de 1997"
25,1,17,3603,156,113,269,"6 de julio de 1997"
25,1,17,3604,64,41,105,"6 de julio de 1997"
25,1,17,3605,163,120,283,"6 de julio de 1997"
25,1,17,3606,98,71,169,"6 de julio de 1997"
25,1,17,3607,195,162,357,"6 de julio de 1997"
25,1,17,3608,222,203,425,"6 de julio de 1997"
25,1,17,3609,178,155,333,"6 de julio de 1997"
25,1,17,3610,269,273,542,"6 de julio de 1997"
25,1,17,3611,211,191,402,"6 de julio de 1997"
25,1,17,3612,98,107,205,"6 de julio de 1997"
25,1,17,3613,133,100,233,"6 de julio de 1997"
25,2,1,1,177,210,387,"6 de julio de 1997"
25,2,1,2,129,160,289,"6 de julio de 1997"
25,2,1,3,177,200,377,"6 de julio de 1997"
25,2,1,4,190,210,400,"6 de julio de 1997"
25,2,1,5,186,217,403,"6 de julio de 1997"
25,2,1,6,127,155,282,"6 de julio de 1997"
25,2,1,7,261,306,567,"6 de julio de 1997"
25,2,1,8,278,327,605,"6 de julio de 1997"
25,2,1,9,155,190,345,"6 de julio de 1997"
25,2,1,10,275,299,574,"6 de julio de 1997"
25,2,1,11,246,268,514,"6 de julio de 1997"
25,2,1,12,168,193,361,"6 de julio de 1997"
25,2,1,13,215,199,414,"6 de julio de 1997"
25,2,1,14,209,205,414,"6 de julio de 1997"
25,2,1,15,176,191,367,"6 de julio de 1997"
25,2,1,16,169,192,361,"6 de julio de 1997"
25,2,1,17,228,226,454,"6 de julio de 1997"
25,2,1,18,120,142,262,"6 de julio de 1997"
25,2,1,19,237,302,539,"6 de julio de 1997"
25,2,1,20,253,314,567,"6 de julio de 1997"
25,2,1,21,94,114,208,"6 de julio de 1997"
25,2,1,22,178,211,389,"6 de julio de 1997"
25,2,1,23,178,193,371,"6 de julio de 1997"
25,2,1,24,233,278,511,"6 de julio de 1997"
25,2,1,25,270,363,633,"6 de julio de 1997"
25,2,1,26,149,176,325,"6 de julio de 1997"
25,2,1,27,153,149,302,"6 de julio de 1997"
25,2,1,28,246,289,535,"6 de julio de 1997"
25,2,1,29,181,222,403,"6 de julio de 1997"
25,2,1,30,196,262,458,"6 de julio de 1997"
25,2,1,31,165,169,334,"6 de julio de 1997"
25,2,1,32,264,301,565,"6 de julio de 1997"
25,2,1,33,155,174,329,"6 de julio de 1997"
25,2,1,34,157,166,323,"6 de julio de 1997"
25,2,1,35,196,194,390,"6 de julio de 1997"
25,2,1,36,145,134,279,"6 de julio de 1997"
25,2,1,37,137,179,316,"6 de julio de 1997"
25,2,1,38,100,117,217,"6 de julio de 1997"
25,2,1,39,210,274,484,"6 de julio de 1997"
25,2,1,40,150,156,306,"6 de julio de 1997"
25,2,1,41,194,227,421,"6 de julio de 1997"
25,2,1,42,287,312,599,"6 de julio de 1997"
25,2,1,43,297,325,622,"6 de julio de 1997"
25,2,1,44,154,167,321,"6 de julio de 1997"
25,2,1,45,276,261,537,"6 de julio de 1997"
25,2,1,46,219,228,447,"6 de julio de 1997"
25,2,1,47,203,188,391,"6 de julio de 1997"
25,2,1,48,293,351,644,"6 de julio de 1997"
25,2,1,49,38,44,82,"6 de julio de 1997"
25,2,1,50,95,86,181,"6 de julio de 1997"
25,2,1,51,134,172,306,"6 de julio de 1997"
25,2,1,52,245,244,489,"6 de julio de 1997"
25,2,1,53,212,250,462,"6 de julio de 1997"
25,2,1,54,179,192,371,"6 de julio de 1997"
25,2,1,55,310,324,634,"6 de julio de 1997"
25,2,1,56,150,166,316,"6 de julio de 1997"
25,2,1,57,183,187,370,"6 de julio de 1997"
25,2,1,58,180,174,354,"6 de julio de 1997"
25,2,1,59,131,151,282,"6 de julio de 1997"
25,2,1,60,138,162,300,"6 de julio de 1997"
25,2,1,61,226,281,507,"6 de julio de 1997"
25,2,1,62,149,143,292,"6 de julio de 1997"
25,2,1,63,386,398,784,"6 de julio de 1997"
25,2,1,64,167,199,366,"6 de julio de 1997"
25,2,1,65,217,237,454,"6 de julio de 1997"
25,2,1,66,168,201,369,"6 de julio de 1997"
25,2,1,67,187,217,404,"6 de julio de 1997"
25,2,1,68,183,220,403,"6 de julio de 1997"
25,2,1,69,448,458,906,"6 de julio de 1997"
25,2,1,70,183,172,355,"6 de julio de 1997"
25,2,1,71,102,112,214,"6 de julio de 1997"
25,2,1,72,161,197,358,"6 de julio de 1997"
25,2,1,73,114,169,283,"6 de julio de 1997"
25,2,1,74,180,189,369,"6 de julio de 1997"
25,2,1,75,186,182,368,"6 de julio de 1997"
25,2,1,76,139,147,286,"6 de julio de 1997"
25,2,1,77,175,196,371,"6 de julio de 1997"
25,2,1,78,129,160,289,"6 de julio de 1997"
25,2,1,79,191,231,422,"6 de julio de 1997"
25,2,1,80,252,311,563,"6 de julio de 1997"
25,2,1,81,399,446,845,"6 de julio de 1997"
25,2,1,82,242,279,521,"6 de julio de 1997"
25,2,1,83,130,145,275,"6 de julio de 1997"
25,2,1,84,440,472,912,"6 de julio de 1997"
25,2,1,85,194,217,411,"6 de julio de 1997"
25,2,1,86,395,452,847,"6 de julio de 1997"
25,2,1,87,505,582,1087,"6 de julio de 1997"
25,2,1,88,443,540,983,"6 de julio de 1997"
25,2,1,89,165,170,335,"6 de julio de 1997"
25,2,1,90,180,206,386,"6 de julio de 1997"
25,2,1,91,238,267,505,"6 de julio de 1997"
25,2,1,92,168,195,363,"6 de julio de 1997"
25,2,1,93,197,229,426,"6 de julio de 1997"
25,2,1,94,161,147,308,"6 de julio de 1997"
25,2,1,95,239,290,529,"6 de julio de 1997"
25,2,1,96,313,355,668,"6 de julio de 1997"
25,2,1,97,273,317,590,"6 de julio de 1997"
25,2,1,98,241,314,555,"6 de julio de 1997"
25,2,1,99,243,273,516,"6 de julio de 1997"
25,2,1,100,199,242,441,"6 de julio de 1997"
25,2,1,101,254,293,547,"6 de julio de 1997"
25,2,1,102,213,199,412,"6 de julio de 1997"
25,2,1,103,120,125,245,"6 de julio de 1997"
25,2,1,104,79,95,174,"6 de julio de 1997"
25,2,1,105,132,150,282,"6 de julio de 1997"
25,2,1,106,156,145,301,"6 de julio de 1997"
25,2,1,107,146,154,300,"6 de julio de 1997"
25,2,1,108,175,168,343,"6 de julio de 1997"
25,2,1,109,87,93,180,"6 de julio de 1997"
25,2,1,110,219,203,422,"6 de julio de 1997"
25,2,1,111,214,285,499,"6 de julio de 1997"
25,2,1,112,140,156,296,"6 de julio de 1997"
25,2,1,113,111,150,261,"6 de julio de 1997"
25,2,1,114,312,337,649,"6 de julio de 1997"
25,2,1,115,352,382,734,"6 de julio de 1997"
25,2,1,116,349,400,749,"6 de julio de 1997"
25,2,1,117,173,198,371,"6 de julio de 1997"
25,2,1,118,159,175,334,"6 de julio de 1997"
25,2,1,119,332,376,708,"6 de julio de 1997"
25,2,1,120,312,335,647,"6 de julio de 1997"
25,2,1,121,271,306,577,"6 de julio de 1997"
25,2,1,122,292,308,600,"6 de julio de 1997"
25,2,1,123,158,163,321,"6 de julio de 1997"
25,2,1,124,222,257,479,"6 de julio de 1997"
25,2,1,125,171,192,363,"6 de julio de 1997"
25,2,1,126,282,304,586,"6 de julio de 1997"
25,2,1,127,169,199,368,"6 de julio de 1997"
25,2,1,128,167,193,360,"6 de julio de 1997"
25,2,1,129,238,263,501,"6 de julio de 1997"
25,2,1,130,202,193,395,"6 de julio de 1997"
25,2,1,131,166,188,354,"6 de julio de 1997"
25,2,1,132,265,270,535,"6 de julio de 1997"
25,2,1,133,316,402,718,"6 de julio de 1997"
25,2,1,134,128,120,248,"6 de julio de 1997"
25,2,1,135,135,171,306,"6 de julio de 1997"
25,2,1,136,223,241,464,"6 de julio de 1997"
25,2,1,137,230,274,504,"6 de julio de 1997"
25,2,1,138,247,265,512,"6 de julio de 1997"
25,2,1,139,248,305,553,"6 de julio de 1997"
25,2,1,140,174,162,336,"6 de julio de 1997"
25,2,1,141,224,261,485,"6 de julio de 1997"
25,2,1,142,213,209,422,"6 de julio de 1997"
25,2,1,143,323,347,670,"6 de julio de 1997"
25,2,1,144,184,196,380,"6 de julio de 1997"
25,2,1,145,145,185,330,"6 de julio de 1997"
25,2,1,146,202,235,437,"6 de julio de 1997"
25,2,1,147,250,284,534,"6 de julio de 1997"
25,2,1,148,198,234,432,"6 de julio de 1997"
25,2,1,149,165,187,352,"6 de julio de 1997"
25,2,1,150,198,236,434,"6 de julio de 1997"
25,2,1,151,191,234,425,"6 de julio de 1997"
25,2,1,152,228,230,458,"6 de julio de 1997"
25,2,1,153,195,222,417,"6 de julio de 1997"
25,2,1,154,253,294,547,"6 de julio de 1997"
25,2,1,155,140,174,314,"6 de julio de 1997"
25,2,1,156,124,161,285,"6 de julio de 1997"
25,2,1,157,346,357,703,"6 de julio de 1997"
25,2,1,158,289,326,615,"6 de julio de 1997"
25,2,1,159,67,77,144,"6 de julio de 1997"
25,2,1,160,173,210,383,"6 de julio de 1997"
25,2,1,161,226,258,484,"6 de julio de 1997"
25,2,1,162,323,412,735,"6 de julio de 1997"
25,2,1,163,155,179,334,"6 de julio de 1997"
25,2,1,164,285,339,624,"6 de julio de 1997"
25,2,1,165,184,250,434,"6 de julio de 1997"
25,2,1,166,257,292,549,"6 de julio de 1997"
25,2,1,167,176,193,369,"6 de julio de 1997"
25,2,1,168,146,171,317,"6 de julio de 1997"
25,2,1,169,272,290,562,"6 de julio de 1997"
25,2,1,170,377,426,803,"6 de julio de 1997"
25,2,1,171,309,367,676,"6 de julio de 1997"
25,2,1,172,105,132,237,"6 de julio de 1997"
25,2,1,173,151,173,324,"6 de julio de 1997"
25,2,1,174,273,349,622,"6 de julio de 1997"
25,2,1,175,170,202,372,"6 de julio de 1997"
25,2,1,176,168,202,370,"6 de julio de 1997"
25,2,1,177,149,169,318,"6 de julio de 1997"
25,2,1,178,129,127,256,"6 de julio de 1997"
25,2,1,179,252,295,547,"6 de julio de 1997"
25,2,1,180,259,265,524,"6 de julio de 1997"
25,2,1,181,204,219,423,"6 de julio de 1997"
25,2,1,182,216,222,438,"6 de julio de 1997"
25,2,1,183,145,202,347,"6 de julio de 1997"
25,2,1,184,157,182,339,"6 de julio de 1997"
25,2,1,185,366,426,792,"6 de julio de 1997"
25,2,1,186,178,172,350,"6 de julio de 1997"
25,2,1,187,177,177,354,"6 de julio de 1997"
25,2,1,188,160,177,337,"6 de julio de 1997"
25,2,1,189,222,257,479,"6 de julio de 1997"
25,2,1,190,149,197,346,"6 de julio de 1997"
25,2,1,191,272,299,571,"6 de julio de 1997"
25,2,1,192,182,232,414,"6 de julio de 1997"
25,2,1,193,211,277,488,"6 de julio de 1997"
25,2,1,194,164,192,356,"6 de julio de 1997"
25,2,1,195,154,218,372,"6 de julio de 1997"
25,2,1,196,314,360,674,"6 de julio de 1997"
25,2,1,197,258,298,556,"6 de julio de 1997"
25,2,1,198,84,103,187,"6 de julio de 1997"
25,2,1,199,499,522,1021,"6 de julio de 1997"
25,2,1,200,200,239,439,"6 de julio de 1997"
25,2,1,201,76,97,173,"6 de julio de 1997"
25,2,1,202,270,294,564,"6 de julio de 1997"
25,2,1,203,155,170,325,"6 de julio de 1997"
25,2,1,204,270,282,552,"6 de julio de 1997"
25,2,1,205,199,208,407,"6 de julio de 1997"
25,2,1,206,315,284,599,"6 de julio de 1997"
25,2,1,207,357,381,738,"6 de julio de 1997"
25,2,1,208,129,153,282,"6 de julio de 1997"
25,2,1,209,365,444,809,"6 de julio de 1997"
25,2,1,210,200,234,434,"6 de julio de 1997"
25,2,1,211,180,218,398,"6 de julio de 1997"
25,2,1,212,208,237,445,"6 de julio de 1997"
25,2,1,213,272,310,582,"6 de julio de 1997"
25,2,1,214,176,181,357,"6 de julio de 1997"
25,2,1,215,227,235,462,"6 de julio de 1997"
25,2,1,216,232,265,497,"6 de julio de 1997"
25,2,1,217,207,216,423,"6 de julio de 1997"
25,2,1,218,284,330,614,"6 de julio de 1997"
25,2,1,219,287,340,627,"6 de julio de 1997"
25,2,1,220,277,302,579,"6 de julio de 1997"
25,2,1,221,231,230,461,"6 de julio de 1997"
25,2,1,222,195,218,413,"6 de julio de 1997"
25,2,1,223,240,298,538,"6 de julio de 1997"
25,2,1,224,304,326,630,"6 de julio de 1997"
25,2,1,225,127,119,246,"6 de julio de 1997"
25,2,1,226,210,253,463,"6 de julio de 1997"
25,2,1,227,131,164,295,"6 de julio de 1997"
25,2,1,228,124,126,250,"6 de julio de 1997"
25,2,1,229,171,189,360,"6 de julio de 1997"
25,2,1,230,138,168,306,"6 de julio de 1997"
25,2,1,231,131,139,270,"6 de julio de 1997"
25,2,1,232,304,357,661,"6 de julio de 1997"
25,2,1,233,235,307,542,"6 de julio de 1997"
25,2,1,234,141,145,286,"6 de julio de 1997"
25,2,1,235,115,147,262,"6 de julio de 1997"
25,2,1,236,301,343,644,"6 de julio de 1997"
25,2,1,237,202,206,408,"6 de julio de 1997"
25,2,1,238,109,118,227,"6 de julio de 1997"
25,2,1,239,132,136,268,"6 de julio de 1997"
25,2,1,240,649,813,1462,"6 de julio de 1997"
25,2,1,241,210,243,453,"6 de julio de 1997"
25,2,1,242,131,127,258,"6 de julio de 1997"
25,2,1,243,168,134,302,"6 de julio de 1997"
25,2,1,244,221,204,425,"6 de julio de 1997"
25,2,1,245,267,276,543,"6 de julio de 1997"
25,2,1,246,168,202,370,"6 de julio de 1997"
25,2,1,247,235,271,506,"6 de julio de 1997"
25,2,1,248,370,370,740,"6 de julio de 1997"
25,2,1,249,240,242,482,"6 de julio de 1997"
25,2,1,250,212,256,468,"6 de julio de 1997"
25,2,1,251,211,237,448,"6 de julio de 1997"
25,2,1,252,311,321,632,"6 de julio de 1997"
25,2,1,253,209,223,432,"6 de julio de 1997"
25,2,1,254,228,201,429,"6 de julio de 1997"
25,2,1,255,213,207,420,"6 de julio de 1997"
25,2,1,256,228,233,461,"6 de julio de 1997"
25,2,1,257,176,173,349,"6 de julio de 1997"
25,2,1,258,272,316,588,"6 de julio de 1997"
25,2,1,259,186,233,419,"6 de julio de 1997"
25,2,1,260,374,378,752,"6 de julio de 1997"
25,2,1,261,266,264,530,"6 de julio de 1997"
25,2,1,262,624,250,874,"6 de julio de 1997"
25,2,1,263,164,154,318,"6 de julio de 1997"
25,2,1,264,125,119,244,"6 de julio de 1997"
25,2,1,265,230,246,476,"6 de julio de 1997"
25,2,1,266,28,22,50,"6 de julio de 1997"
25,2,1,267,162,169,331,"6 de julio de 1997"
25,2,1,268,59,41,100,"6 de julio de 1997"
25,2,1,269,180,181,361,"6 de julio de 1997"
25,2,1,270,206,199,405,"6 de julio de 1997"
25,2,1,271,305,292,597,"6 de julio de 1997"
25,2,1,272,142,129,271,"6 de julio de 1997"
25,2,1,273,321,272,593,"6 de julio de 1997"
25,2,1,274,114,90,204,"6 de julio de 1997"
25,2,1,275,69,61,130,"6 de julio de 1997"
25,2,1,276,158,154,312,"6 de julio de 1997"
25,2,1,277,136,104,240,"6 de julio de 1997"
25,2,1,278,235,295,530,"6 de julio de 1997"
25,2,1,279,270,269,539,"6 de julio de 1997"
25,2,1,280,247,256,503,"6 de julio de 1997"
25,2,1,281,333,292,625,"6 de julio de 1997"
25,2,1,282,352,351,703,"6 de julio de 1997"
25,2,1,283,350,338,688,"6 de julio de 1997"
25,2,1,284,215,220,435,"6 de julio de 1997"
25,2,1,285,243,275,518,"6 de julio de 1997"
25,2,1,286,150,177,327,"6 de julio de 1997"
25,2,1,287,178,194,372,"6 de julio de 1997"
25,2,1,288,150,141,291,"6 de julio de 1997"
25,2,1,289,133,146,279,"6 de julio de 1997"
25,2,1,290,354,336,690,"6 de julio de 1997"
25,2,1,291,228,216,444,"6 de julio de 1997"
25,2,1,292,229,206,435,"6 de julio de 1997"
25,2,1,293,221,245,466,"6 de julio de 1997"
25,2,1,294,261,289,550,"6 de julio de 1997"
25,2,1,295,219,214,433,"6 de julio de 1997"
25,2,1,296,73,64,137,"6 de julio de 1997"
25,2,1,297,360,353,713,"6 de julio de 1997"
25,2,1,298,433,467,900,"6 de julio de 1997"
25,2,1,299,249,233,482,"6 de julio de 1997"
25,2,1,300,127,103,230,"6 de julio de 1997"
25,2,1,301,176,183,359,"6 de julio de 1997"
25,2,1,302,208,209,417,"6 de julio de 1997"
25,2,1,303,195,184,379,"6 de julio de 1997"
25,2,1,304,335,338,673,"6 de julio de 1997"
25,2,1,305,134,151,285,"6 de julio de 1997"
25,2,1,306,238,221,459,"6 de julio de 1997"
25,2,1,307,159,169,328,"6 de julio de 1997"
25,2,1,308,185,173,358,"6 de julio de 1997"
25,2,1,309,137,121,258,"6 de julio de 1997"
25,2,1,310,39,40,79,"6 de julio de 1997"
25,2,1,311,197,184,381,"6 de julio de 1997"
25,2,1,312,362,296,658,"6 de julio de 1997"
25,2,1,313,293,290,583,"6 de julio de 1997"
25,2,1,314,236,237,473,"6 de julio de 1997"
25,2,1,315,240,242,482,"6 de julio de 1997"
25,2,1,316,262,262,524,"6 de julio de 1997"
25,2,1,317,146,170,316,"6 de julio de 1997"
25,2,1,318,213,208,421,"6 de julio de 1997"
25,2,1,319,137,172,309,"6 de julio de 1997"
25,2,1,320,184,211,395,"6 de julio de 1997"
25,2,1,321,305,365,670,"6 de julio de 1997"
25,2,1,322,147,149,296,"6 de julio de 1997"
25,2,1,323,201,199,400,"6 de julio de 1997"
25,2,1,324,229,202,431,"6 de julio de 1997"
25,2,1,325,97,69,166,"6 de julio de 1997"
25,2,1,326,277,270,547,"6 de julio de 1997"
25,2,1,327,178,183,361,"6 de julio de 1997"
25,2,1,328,242,204,446,"6 de julio de 1997"
25,2,1,329,243,262,505,"6 de julio de 1997"
25,2,1,330,161,145,306,"6 de julio de 1997"
25,2,1,331,151,166,317,"6 de julio de 1997"
25,2,1,332,152,149,301,"6 de julio de 1997"
25,2,1,333,147,112,259,"6 de julio de 1997"
25,2,1,334,210,199,409,"6 de julio de 1997"
25,2,1,335,233,201,434,"6 de julio de 1997"
25,2,1,336,306,277,583,"6 de julio de 1997"
25,2,1,337,177,152,329,"6 de julio de 1997"
25,2,1,338,84,69,153,"6 de julio de 1997"
25,2,1,339,234,201,435,"6 de julio de 1997"
25,2,1,340,122,111,233,"6 de julio de 1997"
25,2,1,341,119,123,242,"6 de julio de 1997"
25,2,1,342,267,258,525,"6 de julio de 1997"
25,2,1,343,218,186,404,"6 de julio de 1997"
25,2,1,344,226,193,419,"6 de julio de 1997"
25,2,1,345,250,250,500,"6 de julio de 1997"
25,2,1,346,275,234,509,"6 de julio de 1997"
25,2,1,347,149,135,284,"6 de julio de 1997"
25,2,1,348,115,123,238,"6 de julio de 1997"
25,2,1,349,319,317,636,"6 de julio de 1997"
25,2,1,350,189,193,382,"6 de julio de 1997"
25,2,1,351,221,229,450,"6 de julio de 1997"
25,2,1,352,231,217,448,"6 de julio de 1997"
25,2,1,353,300,310,610,"6 de julio de 1997"
25,2,1,354,306,322,628,"6 de julio de 1997"
25,2,1,355,284,283,567,"6 de julio de 1997"
25,2,1,356,235,183,418,"6 de julio de 1997"
25,2,1,357,165,181,346,"6 de julio de 1997"
25,2,1,358,245,232,477,"6 de julio de 1997"
25,2,1,359,251,219,470,"6 de julio de 1997"
25,2,1,360,361,388,749,"6 de julio de 1997"
25,2,1,361,391,374,765,"6 de julio de 1997"
25,2,1,362,399,371,770,"6 de julio de 1997"
25,2,1,363,511,440,951,"6 de julio de 1997"
25,2,1,364,416,369,785,"6 de julio de 1997"
25,2,1,365,338,337,675,"6 de julio de 1997"
25,2,1,366,258,192,450,"6 de julio de 1997"
25,2,1,367,157,159,316,"6 de julio de 1997"
25,2,1,368,196,198,394,"6 de julio de 1997"
25,2,1,369,176,182,358,"6 de julio de 1997"
25,2,1,370,207,232,439,"6 de julio de 1997"
25,2,1,371,300,312,612,"6 de julio de 1997"
25,2,1,372,75,104,179,"6 de julio de 1997"
25,2,1,373,244,232,476,"6 de julio de 1997"
25,2,1,374,206,198,404,"6 de julio de 1997"
25,2,1,375,125,112,237,"6 de julio de 1997"
25,2,1,376,53,35,88,"6 de julio de 1997"
25,2,1,377,109,94,203,"6 de julio de 1997"
25,2,1,378,185,175,360,"6 de julio de 1997"
25,2,1,379,169,159,328,"6 de julio de 1997"
25,2,1,380,209,196,405,"6 de julio de 1997"
25,2,1,381,170,173,343,"6 de julio de 1997"
25,2,1,382,177,183,360,"6 de julio de 1997"
25,2,1,383,226,207,433,"6 de julio de 1997"
25,2,1,384,101,104,205,"6 de julio de 1997"
25,2,1,385,182,197,379,"6 de julio de 1997"
25,2,1,386,138,151,289,"6 de julio de 1997"
25,2,1,387,124,128,252,"6 de julio de 1997"
25,2,1,388,258,218,476,"6 de julio de 1997"
25,2,1,389,143,132,275,"6 de julio de 1997"
25,2,1,390,339,330,669,"6 de julio de 1997"
25,2,1,391,289,256,545,"6 de julio de 1997"
25,2,1,392,129,111,240,"6 de julio de 1997"
25,2,1,393,233,219,452,"6 de julio de 1997"
25,2,1,394,173,150,323,"6 de julio de 1997"
25,2,1,395,213,222,435,"6 de julio de 1997"
25,2,1,396,276,257,533,"6 de julio de 1997"
25,2,1,397,165,164,329,"6 de julio de 1997"
25,2,1,398,303,299,602,"6 de julio de 1997"
25,2,1,399,328,339,667,"6 de julio de 1997"
25,2,1,400,202,209,411,"6 de julio de 1997"
25,2,1,401,181,186,367,"6 de julio de 1997"
25,2,1,402,190,187,377,"6 de julio de 1997"
25,2,1,403,222,243,465,"6 de julio de 1997"
25,2,1,404,200,227,427,"6 de julio de 1997"
25,2,1,405,132,114,246,"6 de julio de 1997"
25,2,1,406,310,298,608,"6 de julio de 1997"
25,2,1,407,238,231,469,"6 de julio de 1997"
25,2,1,408,291,257,548,"6 de julio de 1997"
25,2,1,409,94,84,178,"6 de julio de 1997"
25,2,1,410,266,222,488,"6 de julio de 1997"
25,2,1,411,573,544,1117,"6 de julio de 1997"
25,2,1,412,234,210,444,"6 de julio de 1997"
25,2,1,413,157,158,315,"6 de julio de 1997"
25,2,1,414,118,127,245,"6 de julio de 1997"
25,2,1,415,209,219,428,"6 de julio de 1997"
25,2,1,416,269,249,518,"6 de julio de 1997"
25,2,1,417,110,106,216,"6 de julio de 1997"
25,2,1,418,194,187,381,"6 de julio de 1997"
25,2,1,419,160,146,306,"6 de julio de 1997"
25,2,1,420,165,155,320,"6 de julio de 1997"
25,2,1,421,169,173,342,"6 de julio de 1997"
25,2,1,422,76,76,152,"6 de julio de 1997"
25,2,1,423,109,111,220,"6 de julio de 1997"
25,2,1,424,90,72,162,"6 de julio de 1997"
25,2,1,425,141,102,243,"6 de julio de 1997"
25,2,1,426,125,103,228,"6 de julio de 1997"
25,2,1,427,41,29,70,"6 de julio de 1997"
25,2,1,428,165,131,296,"6 de julio de 1997"
25,2,1,429,92,93,185,"6 de julio de 1997"
25,2,1,430,199,182,381,"6 de julio de 1997"
25,2,1,431,97,90,187,"6 de julio de 1997"
25,2,1,432,73,68,141,"6 de julio de 1997"
25,2,1,433,124,102,226,"6 de julio de 1997"
25,2,1,434,258,245,503,"6 de julio de 1997"
25,2,1,435,215,198,413,"6 de julio de 1997"
25,2,1,436,97,97,194,"6 de julio de 1997"
25,2,1,437,265,252,517,"6 de julio de 1997"
25,2,1,438,187,140,327,"6 de julio de 1997"
25,2,1,439,266,231,497,"6 de julio de 1997"
25,2,1,440,382,400,782,"6 de julio de 1997"
25,2,1,441,63,67,130,"6 de julio de 1997"
25,2,1,442,286,278,564,"6 de julio de 1997"
25,2,1,443,235,223,458,"6 de julio de 1997"
25,2,1,444,203,211,414,"6 de julio de 1997"
25,2,1,445,109,84,193,"6 de julio de 1997"
25,2,1,446,173,164,337,"6 de julio de 1997"
25,2,1,447,127,111,238,"6 de julio de 1997"
25,2,1,448,261,291,552,"6 de julio de 1997"
25,2,1,449,426,449,875,"6 de julio de 1997"
25,2,1,450,310,267,577,"6 de julio de 1997"
25,2,1,451,212,233,445,"6 de julio de 1997"
25,2,1,452,74,90,164,"6 de julio de 1997"
25,2,1,453,222,188,410,"6 de julio de 1997"
25,2,1,454,198,151,349,"6 de julio de 1997"
25,2,1,455,130,122,252,"6 de julio de 1997"
25,3,2,456,260,236,496,"6 de julio de 1997"
25,3,2,457,172,179,351,"6 de julio de 1997"
25,3,2,458,107,124,231,"6 de julio de 1997"
25,3,2,459,142,151,293,"6 de julio de 1997"
25,3,2,460,97,131,228,"6 de julio de 1997"
25,3,2,461,168,172,340,"6 de julio de 1997"
25,3,2,462,168,163,331,"6 de julio de 1997"
25,3,2,463,129,131,260,"6 de julio de 1997"
25,3,2,464,204,222,426,"6 de julio de 1997"
25,3,2,465,237,207,444,"6 de julio de 1997"
25,3,2,466,64,57,121,"6 de julio de 1997"
25,3,2,467,91,99,190,"6 de julio de 1997"
25,3,2,468,206,219,425,"6 de julio de 1997"
25,3,2,469,49,54,103,"6 de julio de 1997"
25,3,2,470,146,163,309,"6 de julio de 1997"
25,3,2,471,139,147,286,"6 de julio de 1997"
25,3,2,472,142,151,293,"6 de julio de 1997"
25,3,2,473,105,105,210,"6 de julio de 1997"
25,3,2,474,142,160,302,"6 de julio de 1997"
25,3,2,475,128,141,269,"6 de julio de 1997"
25,3,2,476,140,132,272,"6 de julio de 1997"
25,3,2,477,148,142,290,"6 de julio de 1997"
25,3,2,478,129,130,259,"6 de julio de 1997"
25,3,2,479,100,78,178,"6 de julio de 1997"
25,3,2,480,86,108,194,"6 de julio de 1997"
25,3,2,481,62,62,124,"6 de julio de 1997"
25,3,2,482,127,125,252,"6 de julio de 1997"
25,3,2,483,155,142,297,"6 de julio de 1997"
25,3,2,484,127,110,237,"6 de julio de 1997"
25,3,2,485,156,150,306,"6 de julio de 1997"
25,3,2,486,197,187,384,"6 de julio de 1997"
25,3,2,487,252,245,497,"6 de julio de 1997"
25,3,2,488,102,96,198,"6 de julio de 1997"
25,3,2,489,96,84,180,"6 de julio de 1997"
25,3,2,490,129,126,255,"6 de julio de 1997"
25,3,2,491,157,128,285,"6 de julio de 1997"
25,3,2,492,247,224,471,"6 de julio de 1997"
25,3,2,493,48,49,97,"6 de julio de 1997"
25,3,2,494,97,86,183,"6 de julio de 1997"
25,3,2,495,215,181,396,"6 de julio de 1997"
25,3,2,496,86,97,183,"6 de julio de 1997"
25,3,2,497,40,43,83,"6 de julio de 1997"
25,3,2,498,67,45,112,"6 de julio de 1997"
25,3,2,499,122,116,238,"6 de julio de 1997"
25,3,2,500,196,174,370,"6 de julio de 1997"
25,3,2,501,92,96,188,"6 de julio de 1997"
25,3,2,502,191,171,362,"6 de julio de 1997"
25,3,2,503,66,62,128,"6 de julio de 1997"
25,3,2,504,151,160,311,"6 de julio de 1997"
25,3,2,505,73,69,142,"6 de julio de 1997"
25,3,2,506,125,119,244,"6 de julio de 1997"
25,3,2,507,184,211,395,"6 de julio de 1997"
25,3,2,508,71,68,139,"6 de julio de 1997"
25,3,2,509,200,177,377,"6 de julio de 1997"
25,3,2,510,122,109,231,"6 de julio de 1997"
25,3,2,511,110,99,209,"6 de julio de 1997"
25,3,2,512,86,64,150,"6 de julio de 1997"
25,3,2,513,99,99,198,"6 de julio de 1997"
25,3,2,514,91,103,194,"6 de julio de 1997"
25,3,2,515,184,166,350,"6 de julio de 1997"
25,3,2,516,26,19,45,"6 de julio de 1997"
25,3,2,517,155,158,313,"6 de julio de 1997"
25,3,2,518,134,137,271,"6 de julio de 1997"
25,3,2,519,166,142,308,"6 de julio de 1997"
25,3,2,520,198,182,380,"6 de julio de 1997"
25,3,2,521,175,164,339,"6 de julio de 1997"
25,3,2,522,154,143,297,"6 de julio de 1997"
25,3,2,523,96,92,188,"6 de julio de 1997"
25,3,2,524,131,112,243,"6 de julio de 1997"
25,3,2,525,330,314,644,"6 de julio de 1997"
25,3,2,526,288,254,542,"6 de julio de 1997"
25,3,2,527,147,137,284,"6 de julio de 1997"
25,3,2,528,47,43,90,"6 de julio de 1997"
25,3,2,529,76,70,146,"6 de julio de 1997"
25,3,2,530,200,182,382,"6 de julio de 1997"
25,3,2,531,105,71,176,"6 de julio de 1997"
25,3,2,532,199,172,371,"6 de julio de 1997"
25,3,2,533,99,91,190,"6 de julio de 1997"
25,3,2,534,74,78,152,"6 de julio de 1997"
25,3,2,535,106,90,196,"6 de julio de 1997"
25,3,2,536,90,86,176,"6 de julio de 1997"
25,3,2,537,129,123,252,"6 de julio de 1997"
25,3,2,538,108,101,209,"6 de julio de 1997"
25,3,2,539,557,479,1036,"6 de julio de 1997"
25,3,2,540,237,245,482,"6 de julio de 1997"
25,3,2,541,146,167,313,"6 de julio de 1997"
25,3,2,542,217,214,431,"6 de julio de 1997"
25,3,2,543,150,147,297,"6 de julio de 1997"
25,3,2,544,143,145,288,"6 de julio de 1997"
25,3,2,545,78,90,168,"6 de julio de 1997"
25,3,2,546,97,90,187,"6 de julio de 1997"
25,3,2,547,251,252,503,"6 de julio de 1997"
25,3,2,548,120,110,230,"6 de julio de 1997"
25,3,2,549,234,220,454,"6 de julio de 1997"
25,3,2,550,181,177,358,"6 de julio de 1997"
25,3,2,551,135,132,267,"6 de julio de 1997"
25,3,2,552,124,129,253,"6 de julio de 1997"
25,3,2,553,100,96,196,"6 de julio de 1997"
25,3,2,554,107,114,221,"6 de julio de 1997"
25,3,2,555,131,115,246,"6 de julio de 1997"
25,3,2,556,101,103,204,"6 de julio de 1997"
25,3,2,557,129,113,242,"6 de julio de 1997"
25,3,2,558,140,125,265,"6 de julio de 1997"
25,3,2,559,93,88,181,"6 de julio de 1997"
25,3,2,560,90,73,163,"6 de julio de 1997"
25,3,2,561,88,95,183,"6 de julio de 1997"
25,3,2,562,128,132,260,"6 de julio de 1997"
25,3,3,563,219,173,392,"6 de julio de 1997"
25,3,3,564,168,146,314,"6 de julio de 1997"
25,3,3,565,241,224,465,"6 de julio de 1997"
25,3,3,566,142,158,300,"6 de julio de 1997"
25,3,3,567,93,81,174,"6 de julio de 1997"
25,3,3,568,343,281,624,"6 de julio de 1997"
25,3,3,569,180,145,325,"6 de julio de 1997"
25,3,3,570,146,115,261,"6 de julio de 1997"
25,3,3,571,164,103,267,"6 de julio de 1997"
25,3,3,572,348,248,596,"6 de julio de 1997"
25,3,3,573,237,165,402,"6 de julio de 1997"
25,3,3,574,421,330,751,"6 de julio de 1997"
25,3,3,575,350,292,642,"6 de julio de 1997"
25,3,3,576,139,101,240,"6 de julio de 1997"
25,3,3,577,289,234,523,"6 de julio de 1997"
25,3,3,578,50,50,100,"6 de julio de 1997"
25,3,3,579,165,152,317,"6 de julio de 1997"
25,3,3,580,110,90,200,"6 de julio de 1997"
25,3,3,581,53,43,96,"6 de julio de 1997"
25,3,3,582,104,95,199,"6 de julio de 1997"
25,3,3,583,68,55,123,"6 de julio de 1997"
25,3,3,584,95,70,165,"6 de julio de 1997"
25,3,3,585,264,213,477,"6 de julio de 1997"
25,3,3,586,89,65,154,"6 de julio de 1997"
25,3,3,587,173,169,342,"6 de julio de 1997"
25,3,3,588,85,50,135,"6 de julio de 1997"
25,3,3,589,76,63,139,"6 de julio de 1997"
25,3,3,590,235,192,427,"6 de julio de 1997"
25,3,3,591,37,30,67,"6 de julio de 1997"
25,3,3,592,87,80,167,"6 de julio de 1997"
25,3,3,593,208,165,373,"6 de julio de 1997"
25,3,3,594,200,185,385,"6 de julio de 1997"
25,3,3,595,94,75,169,"6 de julio de 1997"
25,3,3,596,86,71,157,"6 de julio de 1997"
25,3,3,597,81,66,147,"6 de julio de 1997"
25,3,3,598,117,85,202,"6 de julio de 1997"
25,3,3,599,63,44,107,"6 de julio de 1997"
25,3,3,600,108,82,190,"6 de julio de 1997"
25,3,3,601,228,174,402,"6 de julio de 1997"
25,3,3,602,44,28,72,"6 de julio de 1997"
25,3,3,603,124,104,228,"6 de julio de 1997"
25,3,3,604,131,122,253,"6 de julio de 1997"
25,3,3,605,109,90,199,"6 de julio de 1997"
25,3,3,606,37,33,70,"6 de julio de 1997"
25,3,3,607,141,112,253,"6 de julio de 1997"
25,3,3,608,65,47,112,"6 de julio de 1997"
25,3,3,609,69,56,125,"6 de julio de 1997"
25,3,3,610,71,60,131,"6 de julio de 1997"
25,3,3,611,51,22,73,"6 de julio de 1997"
25,3,3,612,67,51,118,"6 de julio de 1997"
25,3,3,613,94,75,169,"6 de julio de 1997"
25,3,3,614,124,110,234,"6 de julio de 1997"
25,3,3,615,60,53,113,"6 de julio de 1997"
25,3,3,616,125,110,235,"6 de julio de 1997"
25,3,3,617,152,154,306,"6 de julio de 1997"
25,3,3,618,129,79,208,"6 de julio de 1997"
25,3,3,619,149,83,232,"6 de julio de 1997"
25,3,3,620,142,87,229,"6 de julio de 1997"
25,3,3,621,193,150,343,"6 de julio de 1997"
25,3,3,622,118,84,202,"6 de julio de 1997"
25,3,3,623,80,72,152,"6 de julio de 1997"
25,3,3,624,43,42,85,"6 de julio de 1997"
25,3,3,625,130,111,241,"6 de julio de 1997"
25,3,3,626,38,39,77,"6 de julio de 1997"
25,3,3,627,83,49,132,"6 de julio de 1997"
25,3,3,628,139,113,252,"6 de julio de 1997"
25,3,13,2997,181,171,352,"6 de julio de 1997"
25,3,13,2998,58,59,117,"6 de julio de 1997"
25,3,13,2999,138,135,273,"6 de julio de 1997"
25,3,13,3000,81,98,179,"6 de julio de 1997"
25,3,13,3001,72,90,162,"6 de julio de 1997"
25,3,13,3002,84,85,169,"6 de julio de 1997"
25,3,13,3003,68,82,150,"6 de julio de 1997"
25,3,13,3004,88,110,198,"6 de julio de 1997"
25,3,13,3005,203,243,446,"6 de julio de 1997"
25,3,13,3006,142,149,291,"6 de julio de 1997"
25,3,13,3007,177,203,380,"6 de julio de 1997"
25,3,13,3008,162,150,312,"6 de julio de 1997"
25,3,13,3009,118,141,259,"6 de julio de 1997"
25,3,13,3010,79,63,142,"6 de julio de 1997"
25,3,13,3011,52,34,86,"6 de julio de 1997"
25,3,13,3012,60,51,111,"6 de julio de 1997"
25,3,13,3013,47,28,75,"6 de julio de 1997"
25,3,13,3014,236,183,419,"6 de julio de 1997"
25,3,13,3015,197,163,360,"6 de julio de 1997"
25,3,13,3016,75,57,132,"6 de julio de 1997"
25,3,13,3017,100,80,180,"6 de julio de 1997"
25,3,13,3018,89,52,141,"6 de julio de 1997"
25,3,13,3019,43,27,70,"6 de julio de 1997"
25,3,13,3020,67,46,113,"6 de julio de 1997"
25,3,13,3021,75,48,123,"6 de julio de 1997"
25,3,13,3022,104,82,186,"6 de julio de 1997"
25,3,13,3023,79,70,149,"6 de julio de 1997"
25,3,13,3024,101,68,169,"6 de julio de 1997"
25,3,13,3025,127,95,222,"6 de julio de 1997"
25,3,13,3026,100,107,207,"6 de julio de 1997"
25,3,13,3027,202,179,381,"6 de julio de 1997"
25,3,13,3028,106,80,186,"6 de julio de 1997"
25,3,13,3029,133,118,251,"6 de julio de 1997"
25,3,13,3030,47,37,84,"6 de julio de 1997"
25,3,13,3031,112,90,202,"6 de julio de 1997"
25,3,13,3032,109,62,171,"6 de julio de 1997"
25,3,13,3033,43,24,67,"6 de julio de 1997"
25,3,13,3034,100,62,162,"6 de julio de 1997"
25,3,13,3035,145,116,261,"6 de julio de 1997"
25,3,13,3036,106,67,173,"6 de julio de 1997"
25,3,13,3037,53,45,98,"6 de julio de 1997"
25,3,13,3038,39,19,58,"6 de julio de 1997"
25,3,13,3039,93,57,150,"6 de julio de 1997"
25,3,13,3040,87,73,160,"6 de julio de 1997"
25,3,13,3041,90,74,164,"6 de julio de 1997"
25,3,13,3042,240,205,445,"6 de julio de 1997"
25,3,13,3043,89,84,173,"6 de julio de 1997"
25,3,13,3044,30,21,51,"6 de julio de 1997"
25,3,13,3045,82,45,127,"6 de julio de 1997"
25,3,13,3046,324,218,542,"6 de julio de 1997"
25,3,13,3047,121,103,224,"6 de julio de 1997"
25,3,13,3048,60,57,117,"6 de julio de 1997"
25,3,13,3049,44,31,75,"6 de julio de 1997"
25,3,13,3050,59,44,103,"6 de julio de 1997"
25,3,13,3051,180,124,304,"6 de julio de 1997"
25,3,13,3052,185,213,398,"6 de julio de 1997"
25,3,13,3053,159,162,321,"6 de julio de 1997"
25,3,13,3054,125,111,236,"6 de julio de 1997"
25,3,13,3055,192,165,357,"6 de julio de 1997"
25,3,13,3056,41,43,84,"6 de julio de 1997"
25,3,13,3057,61,56,117,"6 de julio de 1997"
25,3,13,3058,77,79,156,"6 de julio de 1997"
25,3,13,3059,92,78,170,"6 de julio de 1997"
25,3,13,3060,142,107,249,"6 de julio de 1997"
25,3,13,3061,163,102,265,"6 de julio de 1997"
25,3,13,3062,34,16,50,"6 de julio de 1997"
25,3,13,3063,72,56,128,"6 de julio de 1997"
25,3,13,3064,33,39,72,"6 de julio de 1997"
25,3,13,3065,174,149,323,"6 de julio de 1997"
25,3,13,3066,129,118,247,"6 de julio de 1997"
25,3,13,3067,122,115,237,"6 de julio de 1997"
25,3,13,3068,89,78,167,"6 de julio de 1997"
25,3,13,3069,72,62,134,"6 de julio de 1997"
25,3,13,3070,93,90,183,"6 de julio de 1997"
25,3,13,3071,73,66,139,"6 de julio de 1997"
25,3,13,3072,112,117,229,"6 de julio de 1997"
25,3,13,3073,51,71,122,"6 de julio de 1997"
25,3,13,3074,70,65,135,"6 de julio de 1997"
25,3,13,3075,149,121,270,"6 de julio de 1997"
25,3,13,3076,69,68,137,"6 de julio de 1997"
25,3,13,3077,62,40,102,"6 de julio de 1997"
25,3,13,3078,36,42,78,"6 de julio de 1997"
25,3,13,3079,99,88,187,"6 de julio de 1997"
25,3,13,3080,61,52,113,"6 de julio de 1997"
25,3,13,3081,77,64,141,"6 de julio de 1997"
25,3,13,3082,133,69,202,"6 de julio de 1997"
25,3,13,3083,94,93,187,"6 de julio de 1997"
25,3,13,3084,139,110,249,"6 de julio de 1997"
25,3,13,3085,96,64,160,"6 de julio de 1997"
25,3,13,3086,190,150,340,"6 de julio de 1997"
25,3,13,3087,280,240,520,"6 de julio de 1997"
25,3,13,3088,85,62,147,"6 de julio de 1997"
25,3,13,3089,83,76,159,"6 de julio de 1997"
25,3,13,3090,151,145,296,"6 de julio de 1997"
25,3,13,3091,134,102,236,"6 de julio de 1997"
25,3,13,3092,265,223,488,"6 de julio de 1997"
25,3,13,3093,105,74,179,"6 de julio de 1997"
25,3,13,3094,140,79,219,"6 de julio de 1997"
25,3,13,3095,100,79,179,"6 de julio de 1997"
25,3,13,3096,421,400,821,"6 de julio de 1997"
25,3,13,3097,189,185,374,"6 de julio de 1997"
25,3,13,3098,177,185,362,"6 de julio de 1997"
25,3,13,3099,67,64,131,"6 de julio de 1997"
25,3,13,3100,80,106,186,"6 de julio de 1997"
25,3,13,3101,219,202,421,"6 de julio de 1997"
25,3,13,3102,145,167,312,"6 de julio de 1997"
25,3,13,3103,122,103,225,"6 de julio de 1997"
25,3,13,3104,97,106,203,"6 de julio de 1997"
25,3,13,3105,201,204,405,"6 de julio de 1997"
25,3,13,3106,171,162,333,"6 de julio de 1997"
25,3,13,3107,135,113,248,"6 de julio de 1997"
25,3,13,3108,106,100,206,"6 de julio de 1997"
25,3,13,3109,130,108,238,"6 de julio de 1997"
25,3,13,3110,78,56,134,"6 de julio de 1997"
25,3,13,3111,199,208,407,"6 de julio de 1997"
25,3,13,3112,46,37,83,"6 de julio de 1997"
25,3,13,3113,156,132,288,"6 de julio de 1997"
25,3,13,3114,206,206,412,"6 de julio de 1997"
25,3,13,3115,315,301,616,"6 de julio de 1997"
25,3,13,3116,113,92,205,"6 de julio de 1997"
25,3,13,3117,60,44,104,"6 de julio de 1997"
25,3,13,3118,104,80,184,"6 de julio de 1997"
25,3,13,3119,95,74,169,"6 de julio de 1997"
25,3,13,3120,158,122,280,"6 de julio de 1997"
25,3,13,3121,170,140,310,"6 de julio de 1997"
25,3,13,3122,213,195,408,"6 de julio de 1997"
25,3,13,3123,137,124,261,"6 de julio de 1997"
25,3,13,3124,171,156,327,"6 de julio de 1997"
25,3,13,3125,119,103,222,"6 de julio de 1997"
25,3,13,3126,275,253,528,"6 de julio de 1997"
25,3,13,3127,123,101,224,"6 de julio de 1997"
25,3,13,3128,235,223,458,"6 de julio de 1997"
25,3,13,3129,144,131,275,"6 de julio de 1997"
25,3,13,3130,151,114,265,"6 de julio de 1997"
25,3,18,3614,111,135,246,"6 de julio de 1997"
25,3,18,3615,173,189,362,"6 de julio de 1997"
25,3,18,3616,109,118,227,"6 de julio de 1997"
25,3,18,3617,92,100,192,"6 de julio de 1997"
25,3,18,3618,106,94,200,"6 de julio de 1997"
25,3,18,3619,236,227,463,"6 de julio de 1997"
25,3,18,3620,212,216,428,"6 de julio de 1997"
25,3,18,3621,258,276,534,"6 de julio de 1997"
25,3,18,3622,354,353,707,"6 de julio de 1997"
25,3,18,3623,195,211,406,"6 de julio de 1997"
25,3,18,3624,85,105,190,"6 de julio de 1997"
25,3,18,3625,162,184,346,"6 de julio de 1997"
25,3,18,3626,204,224,428,"6 de julio de 1997"
25,3,18,3627,175,202,377,"6 de julio de 1997"
25,3,18,3628,93,124,217,"6 de julio de 1997"
25,3,18,3629,209,189,398,"6 de julio de 1997"
25,3,18,3630,72,60,132,"6 de julio de 1997"
25,3,18,3631,294,322,616,"6 de julio de 1997"
25,3,18,3632,142,138,280,"6 de julio de 1997"
25,3,18,3633,124,138,262,"6 de julio de 1997"
25,3,18,3634,323,347,670,"6 de julio de 1997"
25,3,18,3635,182,203,385,"6 de julio de 1997"
25,3,18,3636,392,444,836,"6 de julio de 1997"
25,3,18,3637,125,122,247,"6 de julio de 1997"
25,3,18,3638,162,146,308,"6 de julio de 1997"
25,3,18,3639,155,166,321,"6 de julio de 1997"
25,3,18,3640,173,177,350,"6 de julio de 1997"
25,3,18,3641,391,409,800,"6 de julio de 1997"
25,3,18,3642,265,246,511,"6 de julio de 1997"
25,3,18,3643,238,246,484,"6 de julio de 1997"
25,3,18,3644,274,260,534,"6 de julio de 1997"
25,3,18,3645,224,266,490,"6 de julio de 1997"
25,3,18,3646,294,281,575,"6 de julio de 1997"
25,3,18,3647,253,305,558,"6 de julio de 1997"
25,3,18,3648,187,164,351,"6 de julio de 1997"
25,3,18,3649,271,225,496,"6 de julio de 1997"
25,3,18,3650,87,64,151,"6 de julio de 1997"
25,3,18,3651,373,347,720,"6 de julio de 1997"
25,3,18,3652,117,88,205,"6 de julio de 1997"
25,3,18,3653,270,247,517,"6 de julio de 1997"
25,3,18,3654,263,274,537,"6 de julio de 1997"
25,3,18,3655,258,210,468,"6 de julio de 1997"
25,3,18,3656,125,103,228,"6 de julio de 1997"
25,3,18,3657,138,111,249,"6 de julio de 1997"
25,3,18,3658,221,210,431,"6 de julio de 1997"
25,3,18,3659,262,249,511,"6 de julio de 1997"
25,3,18,3660,148,105,253,"6 de julio de 1997"
25,3,18,3661,169,146,315,"6 de julio de 1997"
25,3,18,3662,257,239,496,"6 de julio de 1997"
25,3,18,3663,213,221,434,"6 de julio de 1997"
25,3,18,3664,154,170,324,"6 de julio de 1997"
25,3,18,3665,179,186,365,"6 de julio de 1997"
25,3,18,3666,275,269,544,"6 de julio de 1997"
25,3,18,3667,247,249,496,"6 de julio de 1997"
25,3,18,3668,185,170,355,"6 de julio de 1997"
25,3,18,3669,209,222,431,"6 de julio de 1997"
25,3,18,3670,209,200,409,"6 de julio de 1997"
25,3,18,3671,192,197,389,"6 de julio de 1997"
25,3,18,3672,276,261,537,"6 de julio de 1997"
25,3,18,3673,150,150,300,"6 de julio de 1997"
25,3,18,3674,186,187,373,"6 de julio de 1997"
25,3,18,3675,235,202,437,"6 de julio de 1997"
25,3,18,3676,109,114,223,"6 de julio de 1997"
25,3,18,3677,171,147,318,"6 de julio de 1997"
25,3,18,3678,121,120,241,"6 de julio de 1997"
25,3,18,3679,257,226,483,"6 de julio de 1997"
25,3,18,3680,122,96,218,"6 de julio de 1997"
25,3,18,3681,269,234,503,"6 de julio de 1997"
25,3,18,3682,219,171,390,"6 de julio de 1997"
25,3,18,3683,206,186,392,"6 de julio de 1997"
25,3,18,3684,122,125,247,"6 de julio de 1997"
25,3,18,3685,254,258,512,"6 de julio de 1997"
25,3,18,3686,148,148,296,"6 de julio de 1997"
25,3,18,3687,51,49,100,"6 de julio de 1997"
25,3,18,3688,175,157,332,"6 de julio de 1997"
25,3,18,3689,184,153,337,"6 de julio de 1997"
25,3,18,3690,138,134,272,"6 de julio de 1997"
25,3,18,3691,215,204,419,"6 de julio de 1997"
25,3,18,3692,177,180,357,"6 de julio de 1997"
25,3,18,3693,233,245,478,"6 de julio de 1997"
25,3,18,3694,190,211,401,"6 de julio de 1997"
25,3,18,3695,185,212,397,"6 de julio de 1997"
25,3,18,3696,212,214,426,"6 de julio de 1997"
25,3,18,3697,174,160,334,"6 de julio de 1997"
25,3,18,3698,155,167,322,"6 de julio de 1997"
25,3,18,3699,349,303,652,"6 de julio de 1997"
25,3,18,3700,279,275,554,"6 de julio de 1997"
25,3,18,3701,117,106,223,"6 de julio de 1997"
25,3,18,3702,193,208,401,"6 de julio de 1997"
25,3,18,3703,154,141,295,"6 de julio de 1997"
25,3,18,3704,177,164,341,"6 de julio de 1997"
25,3,18,3705,182,169,351,"6 de julio de 1997"
25,3,18,3706,165,136,301,"6 de julio de 1997"
25,3,18,3707,158,157,315,"6 de julio de 1997"
25,3,18,3708,258,235,493,"6 de julio de 1997"
25,3,18,3709,291,240,531,"6 de julio de 1997"
25,3,18,3710,182,157,339,"6 de julio de 1997"
25,3,18,3711,330,274,604,"6 de julio de 1997"
25,3,18,3712,152,139,291,"6 de julio de 1997"
25,3,18,3713,163,118,281,"6 de julio de 1997"
25,3,18,3714,171,173,344,"6 de julio de 1997"
25,3,18,3715,146,160,306,"6 de julio de 1997"
25,3,18,3716,213,203,416,"6 de julio de 1997"
25,3,18,3717,225,197,422,"6 de julio de 1997"
25,3,18,3718,111,131,242,"6 de julio de 1997"
25,3,18,3719,178,134,312,"6 de julio de 1997"
25,3,18,3720,269,238,507,"6 de julio de 1997"
25,3,18,3721,220,246,466,"6 de julio de 1997"
25,3,18,3722,113,141,254,"6 de julio de 1997"
25,3,18,3723,84,79,163,"6 de julio de 1997"
25,3,18,3724,229,248,477,"6 de julio de 1997"
25,3,18,3725,282,263,545,"6 de julio de 1997"
25,3,18,3726,252,258,510,"6 de julio de 1997"
25,3,18,3727,249,269,518,"6 de julio de 1997"
25,3,18,3728,105,84,189,"6 de julio de 1997"
25,3,18,3729,143,131,274,"6 de julio de 1997"
25,3,18,3730,111,103,214,"6 de julio de 1997"
25,3,18,3731,250,235,485,"6 de julio de 1997"
25,3,18,3732,187,156,343,"6 de julio de 1997"
25,3,18,3733,145,142,287,"6 de julio de 1997"
25,3,18,3734,187,176,363,"6 de julio de 1997"
25,3,18,3735,160,138,298,"6 de julio de 1997"
25,3,18,3736,152,159,311,"6 de julio de 1997"
25,3,18,3737,150,160,310,"6 de julio de 1997"
25,3,18,3738,129,119,248,"6 de julio de 1997"
25,3,18,3739,233,199,432,"6 de julio de 1997"
25,3,18,3740,97,102,199,"6 de julio de 1997"
25,3,18,3741,280,268,548,"6 de julio de 1997"
25,3,18,3742,192,163,355,"6 de julio de 1997"
25,3,18,3743,243,214,457,"6 de julio de 1997"
25,3,18,3744,226,193,419,"6 de julio de 1997"
25,3,18,3745,89,73,162,"6 de julio de 1997"
25,3,18,3746,269,258,527,"6 de julio de 1997"
25,3,18,3747,259,236,495,"6 de julio de 1997"
25,3,18,3748,102,77,179,"6 de julio de 1997"
25,3,18,3749,119,102,221,"6 de julio de 1997"
25,3,18,3750,247,231,478,"6 de julio de 1997"
25,3,18,3751,174,121,295,"6 de julio de 1997"
25,3,18,3752,210,193,403,"6 de julio de 1997"
25,3,18,3753,122,113,235,"6 de julio de 1997"
25,3,18,3754,142,115,257,"6 de julio de 1997"
25,3,18,3755,33,42,75,"6 de julio de 1997"
25,3,18,3756,365,347,712,"6 de julio de 1997"
25,3,18,3757,352,358,710,"6 de julio de 1997"
25,3,18,3758,376,373,749,"6 de julio de 1997"
25,3,18,3759,310,282,592,"6 de julio de 1997"
25,3,18,3760,214,218,432,"6 de julio de 1997"
25,3,18,3761,444,458,902,"6 de julio de 1997"
25,3,18,3762,445,448,893,"6 de julio de 1997"
25,3,18,3763,286,255,541,"6 de julio de 1997"
25,3,18,3764,345,330,675,"6 de julio de 1997"
25,3,18,3765,200,180,380,"6 de julio de 1997"
25,3,18,3766,133,152,285,"6 de julio de 1997"
25,3,18,3767,143,151,294,"6 de julio de 1997"
25,3,18,3768,249,211,460,"6 de julio de 1997"
25,3,18,3769,168,112,280,"6 de julio de 1997"
25,3,18,3770,187,152,339,"6 de julio de 1997"
25,3,18,3771,185,168,353,"6 de julio de 1997"
25,3,18,3772,122,85,207,"6 de julio de 1997"
25,3,18,3773,131,118,249,"6 de julio de 1997"
25,3,18,3774,112,91,203,"6 de julio de 1997"
25,3,18,3775,83,56,139,"6 de julio de 1997"
25,3,18,3776,203,180,383,"6 de julio de 1997"
25,3,18,3777,68,64,132,"6 de julio de 1997"
25,3,18,3778,240,212,452,"6 de julio de 1997"
25,3,18,3779,312,259,571,"6 de julio de 1997"
25,3,18,3780,290,240,530,"6 de julio de 1997"
25,3,18,3781,250,218,468,"6 de julio de 1997"
25,3,18,3782,75,54,129,"6 de julio de 1997"
25,3,18,3783,94,79,173,"6 de julio de 1997"
25,3,18,3784,146,119,265,"6 de julio de 1997"
25,3,18,3785,273,238,511,"6 de julio de 1997"
25,3,18,3786,282,259,541,"6 de julio de 1997"
25,3,18,3787,141,150,291,"6 de julio de 1997"
25,3,18,3788,255,229,484,"6 de julio de 1997"
25,3,18,3789,276,254,530,"6 de julio de 1997"
25,4,11,2101,344,374,718,"6 de julio de 1997"
25,4,11,2102,194,229,423,"6 de julio de 1997"
25,4,11,2103,177,187,364,"6 de julio de 1997"
25,4,11,2104,133,151,284,"6 de julio de 1997"
25,4,11,2105,167,206,373,"6 de julio de 1997"
25,4,11,2106,185,208,393,"6 de julio de 1997"
25,4,11,2107,188,216,404,"6 de julio de 1997"
25,4,11,2108,143,178,321,"6 de julio de 1997"
25,4,11,2109,186,198,384,"6 de julio de 1997"
25,4,11,2110,280,317,597,"6 de julio de 1997"
25,4,11,2111,476,546,1022,"6 de julio de 1997"
25,4,11,2112,145,181,326,"6 de julio de 1997"
25,4,11,2113,163,190,353,"6 de julio de 1997"
25,4,11,2114,162,215,377,"6 de julio de 1997"
25,4,11,2115,139,143,282,"6 de julio de 1997"
25,4,11,2116,222,235,457,"6 de julio de 1997"
25,4,11,2117,187,209,396,"6 de julio de 1997"
25,4,11,2118,259,303,562,"6 de julio de 1997"
25,4,11,2119,302,308,610,"6 de julio de 1997"
25,4,11,2120,254,265,519,"6 de julio de 1997"
25,4,11,2121,213,231,444,"6 de julio de 1997"
25,4,11,2122,187,206,393,"6 de julio de 1997"
25,4,11,2123,158,187,345,"6 de julio de 1997"
25,4,11,2124,138,172,310,"6 de julio de 1997"
25,4,11,2125,121,140,261,"6 de julio de 1997"
25,4,11,2126,227,242,469,"6 de julio de 1997"
25,4,11,2127,127,149,276,"6 de julio de 1997"
25,4,11,2128,124,162,286,"6 de julio de 1997"
25,4,11,2129,132,156,288,"6 de julio de 1997"
25,4,11,2130,139,145,284,"6 de julio de 1997"
25,4,11,2131,92,135,227,"6 de julio de 1997"
25,4,11,2132,182,199,381,"6 de julio de 1997"
25,4,11,2133,284,287,571,"6 de julio de 1997"
25,4,11,2134,233,259,492,"6 de julio de 1997"
25,4,11,2135,175,192,367,"6 de julio de 1997"
25,4,11,2136,242,256,498,"6 de julio de 1997"
25,4,11,2137,184,203,387,"6 de julio de 1997"
25,4,11,2138,201,231,432,"6 de julio de 1997"
25,4,11,2139,249,284,533,"6 de julio de 1997"
25,4,11,2140,157,199,356,"6 de julio de 1997"
25,4,11,2141,107,140,247,"6 de julio de 1997"
25,4,11,2142,176,186,362,"6 de julio de 1997"
25,4,11,2143,91,109,200,"6 de julio de 1997"
25,4,11,2144,118,144,262,"6 de julio de 1997"
25,4,11,2145,148,160,308,"6 de julio de 1997"
25,4,11,2146,163,205,368,"6 de julio de 1997"
25,4,11,2147,150,162,312,"6 de julio de 1997"
25,4,11,2148,132,121,253,"6 de julio de 1997"
25,4,11,2149,113,137,250,"6 de julio de 1997"
25,4,11,2150,90,132,222,"6 de julio de 1997"
25,4,11,2151,100,141,241,"6 de julio de 1997"
25,4,11,2152,136,140,276,"6 de julio de 1997"
25,4,11,2153,168,192,360,"6 de julio de 1997"
25,4,11,2154,200,254,454,"6 de julio de 1997"
25,4,11,2155,267,332,599,"6 de julio de 1997"
25,4,11,2156,246,284,530,"6 de julio de 1997"
25,4,11,2157,202,219,421,"6 de julio de 1997"
25,4,11,2158,217,255,472,"6 de julio de 1997"
25,4,11,2159,112,132,244,"6 de julio de 1997"
25,4,11,2160,117,139,256,"6 de julio de 1997"
25,4,11,2161,137,143,280,"6 de julio de 1997"
25,4,11,2162,83,104,187,"6 de julio de 1997"
25,4,11,2163,143,148,291,"6 de julio de 1997"
25,4,11,2164,168,182,350,"6 de julio de 1997"
25,4,11,2165,176,238,414,"6 de julio de 1997"
25,4,11,2166,106,115,221,"6 de julio de 1997"
25,4,11,2167,118,162,280,"6 de julio de 1997"
25,4,11,2168,106,121,227,"6 de julio de 1997"
25,4,11,2169,61,89,150,"6 de julio de 1997"
25,4,11,2170,139,141,280,"6 de julio de 1997"
25,4,11,2171,150,173,323,"6 de julio de 1997"
25,4,11,2172,145,176,321,"6 de julio de 1997"
25,4,11,2173,170,190,360,"6 de julio de 1997"
25,4,11,2174,166,190,356,"6 de julio de 1997"
25,4,11,2175,183,201,384,"6 de julio de 1997"
25,4,11,2176,201,233,434,"6 de julio de 1997"
25,4,11,2177,165,188,353,"6 de julio de 1997"
25,4,11,2178,225,300,525,"6 de julio de 1997"
25,4,11,2179,220,234,454,"6 de julio de 1997"
25,4,11,2180,174,164,338,"6 de julio de 1997"
25,4,11,2181,167,189,356,"6 de julio de 1997"
25,4,11,2182,152,177,329,"6 de julio de 1997"
25,4,11,2183,188,202,390,"6 de julio de 1997"
25,4,11,2184,186,207,393,"6 de julio de 1997"
25,4,11,2185,161,173,334,"6 de julio de 1997"
25,4,11,2186,138,168,306,"6 de julio de 1997"
25,4,11,2187,89,57,146,"6 de julio de 1997"
25,4,11,2188,156,130,286,"6 de julio de 1997"
25,4,11,2189,130,127,257,"6 de julio de 1997"
25,4,11,2190,228,244,472,"6 de julio de 1997"
25,4,11,2191,260,245,505,"6 de julio de 1997"
25,4,11,2192,199,215,414,"6 de julio de 1997"
25,4,11,2193,200,226,426,"6 de julio de 1997"
25,4,11,2194,174,177,351,"6 de julio de 1997"
25,4,11,2195,125,135,260,"6 de julio de 1997"
25,4,11,2196,194,185,379,"6 de julio de 1997"
25,4,11,2197,180,163,343,"6 de julio de 1997"
25,4,11,2198,192,206,398,"6 de julio de 1997"
25,4,11,2199,121,121,242,"6 de julio de 1997"
25,4,11,2200,151,158,309,"6 de julio de 1997"
25,4,11,2201,243,256,499,"6 de julio de 1997"
25,4,11,2202,136,151,287,"6 de julio de 1997"
25,4,11,2203,193,197,390,"6 de julio de 1997"
25,4,11,2204,174,187,361,"6 de julio de 1997"
25,4,11,2205,179,186,365,"6 de julio de 1997"
25,4,11,2206,181,168,349,"6 de julio de 1997"
25,4,11,2207,252,224,476,"6 de julio de 1997"
25,4,11,2208,228,227,455,"6 de julio de 1997"
25,4,11,2209,219,245,464,"6 de julio de 1997"
25,4,11,2210,235,242,477,"6 de julio de 1997"
25,4,11,2211,280,298,578,"6 de julio de 1997"
25,4,11,2212,228,227,455,"6 de julio de 1997"
25,4,11,2213,111,106,217,"6 de julio de 1997"
25,4,11,2214,280,267,547,"6 de julio de 1997"
25,4,11,2215,175,173,348,"6 de julio de 1997"
25,4,11,2216,217,217,434,"6 de julio de 1997"
25,4,11,2217,276,259,535,"6 de julio de 1997"
25,4,11,2218,242,248,490,"6 de julio de 1997"
25,4,11,2219,197,219,416,"6 de julio de 1997"
25,4,11,2220,262,296,558,"6 de julio de 1997"
25,4,11,2221,194,194,388,"6 de julio de 1997"
25,4,11,2222,170,162,332,"6 de julio de 1997"
25,4,11,2223,149,118,267,"6 de julio de 1997"
25,4,11,2224,190,175,365,"6 de julio de 1997"
25,4,11,2225,234,215,449,"6 de julio de 1997"
25,4,11,2226,136,145,281,"6 de julio de 1997"
25,4,11,2227,208,196,404,"6 de julio de 1997"
25,4,11,2228,238,218,456,"6 de julio de 1997"
25,4,11,2229,187,209,396,"6 de julio de 1997"
25,4,11,2230,178,165,343,"6 de julio de 1997"
25,4,11,2231,171,156,327,"6 de julio de 1997"
25,4,11,2232,194,202,396,"6 de julio de 1997"
25,4,11,2233,81,69,150,"6 de julio de 1997"
25,4,11,2234,224,215,439,"6 de julio de 1997"
25,4,11,2235,181,189,370,"6 de julio de 1997"
25,4,11,2236,91,90,181,"6 de julio de 1997"
25,4,11,2237,83,80,163,"6 de julio de 1997"
25,4,11,2238,258,269,527,"6 de julio de 1997"
25,4,11,2239,46,42,88,"6 de julio de 1997"
25,4,11,2240,96,81,177,"6 de julio de 1997"
25,4,11,2241,139,151,290,"6 de julio de 1997"
25,4,11,2242,175,160,335,"6 de julio de 1997"
25,4,11,2243,188,161,349,"6 de julio de 1997"
25,4,11,2244,116,113,229,"6 de julio de 1997"
25,4,11,2245,82,113,195,"6 de julio de 1997"
25,4,11,2246,314,303,617,"6 de julio de 1997"
25,4,11,2247,141,110,251,"6 de julio de 1997"
25,4,11,2248,192,197,389,"6 de julio de 1997"
25,4,11,2249,271,265,536,"6 de julio de 1997"
25,4,11,2250,169,157,326,"6 de julio de 1997"
25,4,11,2251,187,192,379,"6 de julio de 1997"
25,4,11,2252,177,176,353,"6 de julio de 1997"
25,4,11,2253,226,231,457,"6 de julio de 1997"
25,4,11,2254,189,173,362,"6 de julio de 1997"
25,4,11,2255,145,159,304,"6 de julio de 1997"
25,4,11,2256,156,132,288,"6 de julio de 1997"
25,4,11,2257,124,129,253,"6 de julio de 1997"
25,4,11,2258,209,176,385,"6 de julio de 1997"
25,4,11,2259,120,124,244,"6 de julio de 1997"
25,4,11,2260,122,119,241,"6 de julio de 1997"
25,4,11,2261,149,129,278,"6 de julio de 1997"
25,4,11,2262,190,181,371,"6 de julio de 1997"
25,4,11,2263,122,121,243,"6 de julio de 1997"
25,4,11,2264,216,204,420,"6 de julio de 1997"
25,4,11,2265,91,78,169,"6 de julio de 1997"
25,4,11,2266,195,187,382,"6 de julio de 1997"
25,4,11,2267,224,231,455,"6 de julio de 1997"
25,4,11,2268,245,212,457,"6 de julio de 1997"
25,4,11,2269,271,262,533,"6 de julio de 1997"
25,4,11,2270,251,243,494,"6 de julio de 1997"
25,4,11,2271,173,174,347,"6 de julio de 1997"
25,4,11,2272,113,105,218,"6 de julio de 1997"
25,4,11,2273,125,128,253,"6 de julio de 1997"
25,4,11,2274,167,157,324,"6 de julio de 1997"
25,4,11,2275,180,186,366,"6 de julio de 1997"
25,4,11,2276,172,168,340,"6 de julio de 1997"
25,4,11,2277,202,176,378,"6 de julio de 1997"
25,4,11,2278,100,85,185,"6 de julio de 1997"
25,4,11,2279,151,129,280,"6 de julio de 1997"
25,4,11,2280,119,105,224,"6 de julio de 1997"
25,4,11,2281,290,273,563,"6 de julio de 1997"
25,4,11,2282,209,183,392,"6 de julio de 1997"
25,4,11,2283,199,184,383,"6 de julio de 1997"
25,4,11,2284,182,153,335,"6 de julio de 1997"
25,4,11,2285,167,155,322,"6 de julio de 1997"
25,4,11,2286,182,186,368,"6 de julio de 1997"
25,4,11,2287,157,157,314,"6 de julio de 1997"
25,4,11,2288,212,183,395,"6 de julio de 1997"
25,4,11,2289,190,184,374,"6 de julio de 1997"
25,4,11,2290,140,150,290,"6 de julio de 1997"
25,4,11,2291,304,281,585,"6 de julio de 1997"
25,4,11,2292,241,242,483,"6 de julio de 1997"
25,4,11,2293,142,164,306,"6 de julio de 1997"
25,4,11,2294,192,192,384,"6 de julio de 1997"
25,4,11,2295,189,181,370,"6 de julio de 1997"
25,4,11,2296,96,99,195,"6 de julio de 1997"
25,4,11,2297,189,155,344,"6 de julio de 1997"
25,4,11,2298,235,210,445,"6 de julio de 1997"
25,4,11,2299,84,69,153,"6 de julio de 1997"
25,4,11,2300,221,189,410,"6 de julio de 1997"
25,4,11,2301,122,126,248,"6 de julio de 1997"
25,4,11,2302,139,121,260,"6 de julio de 1997"
25,4,11,2303,144,140,284,"6 de julio de 1997"
25,4,11,2304,120,126,246,"6 de julio de 1997"
25,4,11,2305,177,176,353,"6 de julio de 1997"
25,4,11,2306,157,172,329,"6 de julio de 1997"
25,4,11,2307,127,139,266,"6 de julio de 1997"
25,4,11,2308,99,89,188,"6 de julio de 1997"
25,4,11,2309,123,115,238,"6 de julio de 1997"
25,4,11,2310,166,181,347,"6 de julio de 1997"
25,4,11,2311,80,88,168,"6 de julio de 1997"
25,4,11,2312,131,134,265,"6 de julio de 1997"
25,4,11,2313,199,180,379,"6 de julio de 1997"
25,4,11,2314,232,211,443,"6 de julio de 1997"
25,4,11,2315,203,202,405,"6 de julio de 1997"
25,4,11,2316,120,114,234,"6 de julio de 1997"
25,4,11,2317,135,125,260,"6 de julio de 1997"
25,4,11,2318,291,274,565,"6 de julio de 1997"
25,4,11,2319,117,127,244,"6 de julio de 1997"
25,4,11,2320,234,220,454,"6 de julio de 1997"
25,4,11,2321,144,174,318,"6 de julio de 1997"
25,4,11,2322,201,203,404,"6 de julio de 1997"
25,4,11,2323,178,195,373,"6 de julio de 1997"
25,4,11,2324,178,187,365,"6 de julio de 1997"
25,4,11,2325,94,94,188,"6 de julio de 1997"
25,4,11,2326,156,154,310,"6 de julio de 1997"
25,4,11,2327,139,141,280,"6 de julio de 1997"
25,4,11,2328,151,191,342,"6 de julio de 1997"
25,4,11,2329,197,208,405,"6 de julio de 1997"
25,4,11,2330,229,241,470,"6 de julio de 1997"
25,4,11,2331,151,161,312,"6 de julio de 1997"
25,4,11,2332,160,170,330,"6 de julio de 1997"
25,4,11,2333,125,149,274,"6 de julio de 1997"
25,4,11,2334,292,284,576,"6 de julio de 1997"
25,4,11,2335,237,248,485,"6 de julio de 1997"
25,4,11,2336,280,292,572,"6 de julio de 1997"
25,4,11,2337,212,230,442,"6 de julio de 1997"
25,4,11,2338,217,256,473,"6 de julio de 1997"
25,4,11,2339,143,168,311,"6 de julio de 1997"
25,4,11,2340,515,538,1053,"6 de julio de 1997"
25,4,11,2341,284,241,525,"6 de julio de 1997"
25,4,11,2342,114,113,227,"6 de julio de 1997"
25,4,11,2343,253,249,502,"6 de julio de 1997"
25,4,11,2344,311,324,635,"6 de julio de 1997"
25,4,11,2345,80,83,163,"6 de julio de 1997"
25,4,11,2346,278,260,538,"6 de julio de 1997"
25,4,11,2347,292,231,523,"6 de julio de 1997"
25,4,11,2348,505,525,1030,"6 de julio de 1997"
25,4,11,2349,147,125,272,"6 de julio de 1997"
25,4,11,2350,107,111,218,"6 de julio de 1997"
25,4,11,2351,168,146,314,"6 de julio de 1997"
25,4,11,2352,353,337,690,"6 de julio de 1997"
25,4,11,2353,186,175,361,"6 de julio de 1997"
25,4,11,2354,151,129,280,"6 de julio de 1997"
25,4,11,2355,208,204,412,"6 de julio de 1997"
25,4,11,2356,101,89,190,"6 de julio de 1997"
25,4,11,2357,147,143,290,"6 de julio de 1997"
25,4,11,2358,66,59,125,"6 de julio de 1997"
25,4,11,2359,177,159,336,"6 de julio de 1997"
25,4,11,2360,100,80,180,"6 de julio de 1997"
25,4,11,2361,156,150,306,"6 de julio de 1997"
25,4,11,2362,127,115,242,"6 de julio de 1997"
25,4,11,2363,74,60,134,"6 de julio de 1997"
25,4,11,2364,173,180,353,"6 de julio de 1997"
25,4,11,2365,231,227,458,"6 de julio de 1997"
25,4,11,2366,158,152,310,"6 de julio de 1997"
25,4,11,2367,293,253,546,"6 de julio de 1997"
25,4,11,2368,184,174,358,"6 de julio de 1997"
25,4,11,2369,134,122,256,"6 de julio de 1997"
25,4,11,2370,53,51,104,"6 de julio de 1997"
25,4,11,2371,117,123,240,"6 de julio de 1997"
25,4,11,2372,233,222,455,"6 de julio de 1997"
25,4,11,2373,291,278,569,"6 de julio de 1997"
25,4,11,2374,224,221,445,"6 de julio de 1997"
25,4,11,2375,235,233,468,"6 de julio de 1997"
25,4,11,2376,145,150,295,"6 de julio de 1997"
25,4,11,2377,167,154,321,"6 de julio de 1997"
25,4,11,2378,29,20,49,"6 de julio de 1997"
25,4,11,2379,214,214,428,"6 de julio de 1997"
25,4,11,2380,232,199,431,"6 de julio de 1997"
25,4,11,2381,193,183,376,"6 de julio de 1997"
25,4,11,2382,135,139,274,"6 de julio de 1997"
25,4,11,2383,162,140,302,"6 de julio de 1997"
25,4,11,2384,140,128,268,"6 de julio de 1997"
25,4,11,2385,165,145,310,"6 de julio de 1997"
25,4,11,2386,92,84,176,"6 de julio de 1997"
25,4,11,2387,83,74,157,"6 de julio de 1997"
25,4,11,2388,178,171,349,"6 de julio de 1997"
25,4,11,2389,289,280,569,"6 de julio de 1997"
25,4,11,2390,273,235,508,"6 de julio de 1997"
25,4,11,2391,279,223,502,"6 de julio de 1997"
25,4,11,2392,222,219,441,"6 de julio de 1997"
25,4,11,2393,196,180,376,"6 de julio de 1997"
25,4,11,2394,175,183,358,"6 de julio de 1997"
25,4,11,2395,203,181,384,"6 de julio de 1997"
25,4,11,2396,128,107,235,"6 de julio de 1997"
25,4,11,2397,177,186,363,"6 de julio de 1997"
25,4,11,2398,134,123,257,"6 de julio de 1997"
25,4,11,2399,92,94,186,"6 de julio de 1997"
25,4,11,2400,145,142,287,"6 de julio de 1997"
25,4,11,2401,201,203,404,"6 de julio de 1997"
25,4,11,2402,223,195,418,"6 de julio de 1997"
25,4,11,2403,166,151,317,"6 de julio de 1997"
25,4,11,2404,106,66,172,"6 de julio de 1997"
25,4,11,2405,141,114,255,"6 de julio de 1997"
25,4,11,2406,100,84,184,"6 de julio de 1997"
25,4,11,2407,201,179,380,"6 de julio de 1997"
25,4,11,2408,182,183,365,"6 de julio de 1997"
25,4,11,2409,217,255,472,"6 de julio de 1997"
25,4,11,2410,272,266,538,"6 de julio de 1997"
25,4,11,2411,166,160,326,"6 de julio de 1997"
25,4,11,2412,97,98,195,"6 de julio de 1997"
25,4,11,2413,241,200,441,"6 de julio de 1997"
25,4,11,2414,165,159,324,"6 de julio de 1997"
25,4,11,2415,133,140,273,"6 de julio de 1997"
25,4,11,2416,182,175,357,"6 de julio de 1997"
25,4,11,2417,160,138,298,"6 de julio de 1997"
25,4,11,2418,141,96,237,"6 de julio de 1997"
25,4,11,2419,324,323,647,"6 de julio de 1997"
25,4,11,2420,251,258,509,"6 de julio de 1997"
25,4,11,2421,236,241,477,"6 de julio de 1997"
25,4,11,2422,232,218,450,"6 de julio de 1997"
25,4,11,2423,160,166,326,"6 de julio de 1997"
25,4,11,2424,148,160,308,"6 de julio de 1997"
25,4,11,2425,91,89,180,"6 de julio de 1997"
25,4,11,2426,264,241,505,"6 de julio de 1997"
25,4,11,2427,195,186,381,"6 de julio de 1997"
25,4,11,2428,151,141,292,"6 de julio de 1997"
25,4,11,2429,90,106,196,"6 de julio de 1997"
25,4,11,2430,121,155,276,"6 de julio de 1997"
25,4,11,2431,146,155,301,"6 de julio de 1997"
25,4,11,2432,126,117,243,"6 de julio de 1997"
25,4,11,2433,91,99,190,"6 de julio de 1997"
25,4,11,2434,158,176,334,"6 de julio de 1997"
25,4,11,2435,208,226,434,"6 de julio de 1997"
25,4,11,2436,191,175,366,"6 de julio de 1997"
25,4,11,2437,193,177,370,"6 de julio de 1997"
25,4,11,2438,76,80,156,"6 de julio de 1997"
25,4,11,2439,282,300,582,"6 de julio de 1997"
25,4,11,2440,198,203,401,"6 de julio de 1997"
25,4,11,2441,179,170,349,"6 de julio de 1997"
25,4,11,2442,54,62,116,"6 de julio de 1997"
25,4,11,2443,64,54,118,"6 de julio de 1997"
25,4,11,2444,110,99,209,"6 de julio de 1997"
25,4,11,2445,91,92,183,"6 de julio de 1997"
25,4,11,2446,153,157,310,"6 de julio de 1997"
25,4,11,2447,49,45,94,"6 de julio de 1997"
25,4,11,2448,76,52,128,"6 de julio de 1997"
25,4,11,2449,153,152,305,"6 de julio de 1997"
25,4,11,2450,196,195,391,"6 de julio de 1997"
25,4,11,2451,185,179,364,"6 de julio de 1997"
25,4,11,2452,90,94,184,"6 de julio de 1997"
25,4,11,2453,164,179,343,"6 de julio de 1997"
25,4,11,2454,224,220,444,"6 de julio de 1997"
25,4,11,2455,238,192,430,"6 de julio de 1997"
25,4,11,2456,245,228,473,"6 de julio de 1997"
25,4,11,2457,189,167,356,"6 de julio de 1997"
25,4,11,2458,82,44,126,"6 de julio de 1997"
25,4,11,2459,207,178,385,"6 de julio de 1997"
25,4,11,2460,87,84,171,"6 de julio de 1997"
25,4,11,2461,269,240,509,"6 de julio de 1997"
25,4,11,2462,104,87,191,"6 de julio de 1997"
25,4,11,2463,150,160,310,"6 de julio de 1997"
25,4,11,2464,147,130,277,"6 de julio de 1997"
25,4,11,2465,106,94,200,"6 de julio de 1997"
25,4,11,2466,40,46,86,"6 de julio de 1997"
25,4,11,2467,62,60,122,"6 de julio de 1997"
25,4,11,2468,111,127,238,"6 de julio de 1997"
25,4,11,2469,143,132,275,"6 de julio de 1997"
25,4,11,2470,188,203,391,"6 de julio de 1997"
25,4,11,2471,164,176,340,"6 de julio de 1997"
25,4,11,2472,98,99,197,"6 de julio de 1997"
25,4,11,2473,360,349,709,"6 de julio de 1997"
25,4,11,2474,321,317,638,"6 de julio de 1997"
25,4,11,2475,213,210,423,"6 de julio de 1997"
25,4,11,2476,165,144,309,"6 de julio de 1997"
25,4,11,2477,99,101,200,"6 de julio de 1997"
25,4,11,2478,219,186,405,"6 de julio de 1997"
25,4,11,2479,204,183,387,"6 de julio de 1997"
25,4,11,2480,251,253,504,"6 de julio de 1997"
25,4,11,2481,151,132,283,"6 de julio de 1997"
25,4,11,2482,107,93,200,"6 de julio de 1997"
25,4,11,2483,139,124,263,"6 de julio de 1997"
25,4,11,2484,244,225,469,"6 de julio de 1997"
25,4,11,2485,205,203,408,"6 de julio de 1997"
25,4,11,2486,187,176,363,"6 de julio de 1997"
25,4,11,2487,182,150,332,"6 de julio de 1997"
25,4,11,2488,138,153,291,"6 de julio de 1997"
25,4,11,2489,203,194,397,"6 de julio de 1997"
25,4,11,2490,275,281,556,"6 de julio de 1997"
25,4,11,2491,95,88,183,"6 de julio de 1997"
25,4,11,2492,93,78,171,"6 de julio de 1997"
25,4,11,2493,91,73,164,"6 de julio de 1997"
25,4,11,2494,274,218,492,"6 de julio de 1997"
25,4,11,2495,160,142,302,"6 de julio de 1997"
25,4,11,2496,134,125,259,"6 de julio de 1997"
25,4,11,2497,164,161,325,"6 de julio de 1997"
25,4,11,2498,229,190,419,"6 de julio de 1997"
25,4,11,2499,74,62,136,"6 de julio de 1997"
25,4,11,2500,111,119,230,"6 de julio de 1997"
25,4,11,2501,232,202,434,"6 de julio de 1997"
25,4,11,2502,175,168,343,"6 de julio de 1997"
25,4,11,2503,177,138,315,"6 de julio de 1997"
25,4,11,2504,257,235,492,"6 de julio de 1997"
25,4,11,2505,116,142,258,"6 de julio de 1997"
25,4,11,2506,88,122,210,"6 de julio de 1997"
25,4,11,2507,172,168,340,"6 de julio de 1997"
25,4,11,2508,171,185,356,"6 de julio de 1997"
25,4,11,2509,201,201,402,"6 de julio de 1997"
25,4,11,2510,219,164,383,"6 de julio de 1997"
25,4,11,2511,317,301,618,"6 de julio de 1997"
25,4,11,2512,136,138,274,"6 de julio de 1997"
25,4,11,2513,49,48,97,"6 de julio de 1997"
25,4,11,2514,60,38,98,"6 de julio de 1997"
25,4,11,2515,177,171,348,"6 de julio de 1997"
25,4,11,2516,140,109,249,"6 de julio de 1997"
25,4,11,2517,127,125,252,"6 de julio de 1997"
25,4,11,2518,120,127,247,"6 de julio de 1997"
25,4,11,2519,81,94,175,"6 de julio de 1997"
25,4,11,2520,225,206,431,"6 de julio de 1997"
25,4,11,2521,185,152,337,"6 de julio de 1997"
25,4,11,2522,133,128,261,"6 de julio de 1997"
25,4,11,2523,93,69,162,"6 de julio de 1997"
25,4,11,2524,161,133,294,"6 de julio de 1997"
25,4,11,2525,77,72,149,"6 de julio de 1997"
25,4,11,2526,269,234,503,"6 de julio de 1997"
25,4,11,2527,174,165,339,"6 de julio de 1997"
25,4,11,2528,174,169,343,"6 de julio de 1997"
25,4,11,2529,209,145,354,"6 de julio de 1997"
25,4,11,2530,153,124,277,"6 de julio de 1997"
25,4,11,2531,170,157,327,"6 de julio de 1997"
25,4,11,2532,158,157,315,"6 de julio de 1997"
25,4,11,2533,87,72,159,"6 de julio de 1997"
25,4,11,2534,152,142,294,"6 de julio de 1997"
25,4,11,2535,125,118,243,"6 de julio de 1997"
25,4,11,2536,124,120,244,"6 de julio de 1997"
25,4,11,2537,255,221,476,"6 de julio de 1997"
25,4,11,2538,97,87,184,"6 de julio de 1997"
25,4,11,2539,102,80,182,"6 de julio de 1997"
25,5,6,710,226,258,484,"6 de julio de 1997"
25,5,6,711,350,391,741,"6 de julio de 1997"
25,5,6,712,247,272,519,"6 de julio de 1997"
25,5,6,713,316,359,675,"6 de julio de 1997"
25,5,6,714,152,199,351,"6 de julio de 1997"
25,5,6,715,306,319,625,"6 de julio de 1997"
25,5,6,716,212,237,449,"6 de julio de 1997"
25,5,6,717,367,422,789,"6 de julio de 1997"
25,5,6,718,298,365,663,"6 de julio de 1997"
25,5,6,719,220,260,480,"6 de julio de 1997"
25,5,6,720,190,206,396,"6 de julio de 1997"
25,5,6,721,204,207,411,"6 de julio de 1997"
25,5,6,722,188,224,412,"6 de julio de 1997"
25,5,6,723,236,254,490,"6 de julio de 1997"
25,5,6,724,135,178,313,"6 de julio de 1997"
25,5,6,725,602,658,1260,"6 de julio de 1997"
25,5,6,726,391,432,823,"6 de julio de 1997"
25,5,6,727,182,199,381,"6 de julio de 1997"
25,5,6,728,181,197,378,"6 de julio de 1997"
25,5,6,729,187,196,383,"6 de julio de 1997"
25,5,6,730,282,314,596,"6 de julio de 1997"
25,5,6,731,179,179,358,"6 de julio de 1997"
25,5,6,732,125,162,287,"6 de julio de 1997"
25,5,6,733,220,249,469,"6 de julio de 1997"
25,5,6,734,154,208,362,"6 de julio de 1997"
25,5,6,735,154,170,324,"6 de julio de 1997"
25,5,6,736,285,291,576,"6 de julio de 1997"
25,5,6,737,159,187,346,"6 de julio de 1997"
25,5,6,738,156,172,328,"6 de julio de 1997"
25,5,6,739,126,144,270,"6 de julio de 1997"
25,5,6,740,140,197,337,"6 de julio de 1997"
25,5,6,741,214,260,474,"6 de julio de 1997"
25,5,6,742,154,198,352,"6 de julio de 1997"
25,5,6,743,240,292,532,"6 de julio de 1997"
25,5,6,744,125,131,256,"6 de julio de 1997"
25,5,6,745,138,152,290,"6 de julio de 1997"
25,5,6,746,155,182,337,"6 de julio de 1997"
25,5,6,747,100,145,245,"6 de julio de 1997"
25,5,6,748,232,256,488,"6 de julio de 1997"
25,5,6,749,126,160,286,"6 de julio de 1997"
25,5,6,750,185,212,397,"6 de julio de 1997"
25,5,6,751,126,158,284,"6 de julio de 1997"
25,5,6,752,166,218,384,"6 de julio de 1997"
25,5,6,753,221,268,489,"6 de julio de 1997"
25,5,6,754,164,211,375,"6 de julio de 1997"
25,5,6,755,223,301,524,"6 de julio de 1997"
25,5,6,756,167,174,341,"6 de julio de 1997"
25,5,6,757,142,178,320,"6 de julio de 1997"
25,5,6,758,211,230,441,"6 de julio de 1997"
25,5,6,759,166,160,326,"6 de julio de 1997"
25,5,6,760,162,203,365,"6 de julio de 1997"
25,5,6,761,124,146,270,"6 de julio de 1997"
25,5,6,762,117,127,244,"6 de julio de 1997"
25,5,6,763,151,194,345,"6 de julio de 1997"
25,5,6,764,231,273,504,"6 de julio de 1997"
25,5,6,765,188,231,419,"6 de julio de 1997"
25,5,6,766,114,129,243,"6 de julio de 1997"
25,5,6,767,260,297,557,"6 de julio de 1997"
25,5,6,768,117,122,239,"6 de julio de 1997"
25,5,6,769,90,111,201,"6 de julio de 1997"
25,5,6,770,128,152,280,"6 de julio de 1997"
25,5,6,771,172,242,414,"6 de julio de 1997"
25,5,6,772,209,248,457,"6 de julio de 1997"
25,5,6,777,221,267,488,"6 de julio de 1997"
25,5,6,778,166,187,353,"6 de julio de 1997"
25,5,6,779,112,104,216,"6 de julio de 1997"
25,5,6,780,135,168,303,"6 de julio de 1997"
25,5,6,781,107,131,238,"6 de julio de 1997"
25,5,6,869,143,177,320,"6 de julio de 1997"
25,5,6,884,191,234,425,"6 de julio de 1997"
25,5,6,887,392,446,838,"6 de julio de 1997"
25,5,6,888,314,367,681,"6 de julio de 1997"
25,5,6,889,250,288,538,"6 de julio de 1997"
25,5,6,890,189,203,392,"6 de julio de 1997"
25,5,6,891,226,276,502,"6 de julio de 1997"
25,5,6,892,216,251,467,"6 de julio de 1997"
25,5,6,893,171,205,376,"6 de julio de 1997"
25,5,6,894,180,221,401,"6 de julio de 1997"
25,5,6,895,197,239,436,"6 de julio de 1997"
25,5,6,896,142,183,325,"6 de julio de 1997"
25,5,6,897,235,256,491,"6 de julio de 1997"
25,5,6,898,198,241,439,"6 de julio de 1997"
25,5,6,899,264,308,572,"6 de julio de 1997"
25,5,6,900,106,133,239,"6 de julio de 1997"
25,5,6,901,121,191,312,"6 de julio de 1997"
25,5,6,902,123,142,265,"6 de julio de 1997"
25,5,6,903,1058,1279,2337,"6 de julio de 1997"
25,5,6,904,126,152,278,"6 de julio de 1997"
25,5,6,905,166,191,357,"6 de julio de 1997"
25,5,6,906,229,287,516,"6 de julio de 1997"
25,5,6,907,107,137,244,"6 de julio de 1997"
25,5,6,908,80,99,179,"6 de julio de 1997"
25,5,6,909,188,212,400,"6 de julio de 1997"
25,5,6,910,200,206,406,"6 de julio de 1997"
25,5,6,911,102,121,223,"6 de julio de 1997"
25,5,6,912,234,268,502,"6 de julio de 1997"
25,5,6,913,346,402,748,"6 de julio de 1997"
25,5,6,914,217,239,456,"6 de julio de 1997"
25,5,6,915,293,316,609,"6 de julio de 1997"
25,5,6,916,273,275,548,"6 de julio de 1997"
25,5,6,917,227,265,492,"6 de julio de 1997"
25,5,6,918,201,268,469,"6 de julio de 1997"
25,5,6,919,193,200,393,"6 de julio de 1997"
25,5,6,920,187,216,403,"6 de julio de 1997"
25,5,6,921,152,195,347,"6 de julio de 1997"
25,5,6,922,226,247,473,"6 de julio de 1997"
25,5,6,923,120,161,281,"6 de julio de 1997"
25,5,6,924,193,210,403,"6 de julio de 1997"
25,5,6,925,202,199,401,"6 de julio de 1997"
25,5,6,926,210,208,418,"6 de julio de 1997"
25,5,6,927,147,159,306,"6 de julio de 1997"
25,5,6,928,182,178,360,"6 de julio de 1997"
25,5,6,929,120,144,264,"6 de julio de 1997"
25,5,6,930,227,257,484,"6 de julio de 1997"
25,5,6,931,219,253,472,"6 de julio de 1997"
25,5,6,932,237,299,536,"6 de julio de 1997"
25,5,6,933,528,600,1128,"6 de julio de 1997"
25,5,6,934,67,83,150,"6 de julio de 1997"
25,5,6,935,238,269,507,"6 de julio de 1997"
25,5,6,936,205,205,410,"6 de julio de 1997"
25,5,6,937,136,169,305,"6 de julio de 1997"
25,5,6,938,104,98,202,"6 de julio de 1997"
25,5,6,939,182,203,385,"6 de julio de 1997"
25,5,6,940,131,148,279,"6 de julio de 1997"
25,5,6,941,288,176,464,"6 de julio de 1997"
25,5,6,942,101,118,219,"6 de julio de 1997"
25,5,6,943,64,57,121,"6 de julio de 1997"
25,5,6,944,97,78,175,"6 de julio de 1997"
25,5,6,945,103,122,225,"6 de julio de 1997"
25,5,6,946,100,141,241,"6 de julio de 1997"
25,5,6,947,168,156,324,"6 de julio de 1997"
25,5,6,948,147,172,319,"6 de julio de 1997"
25,5,6,949,146,140,286,"6 de julio de 1997"
25,5,6,950,123,144,267,"6 de julio de 1997"
25,5,6,951,171,177,348,"6 de julio de 1997"
25,5,6,952,182,190,372,"6 de julio de 1997"
25,5,6,953,145,166,311,"6 de julio de 1997"
25,5,6,954,153,188,341,"6 de julio de 1997"
25,5,6,955,98,115,213,"6 de julio de 1997"
25,5,6,956,104,118,222,"6 de julio de 1997"
25,5,6,957,97,102,199,"6 de julio de 1997"
25,5,6,958,72,84,156,"6 de julio de 1997"
25,5,6,959,74,88,162,"6 de julio de 1997"
25,5,6,960,93,123,216,"6 de julio de 1997"
25,5,6,961,128,150,278,"6 de julio de 1997"
25,5,6,962,56,80,136,"6 de julio de 1997"
25,5,6,963,74,78,152,"6 de julio de 1997"
25,5,6,964,178,124,302,"6 de julio de 1997"
25,5,6,965,70,93,163,"6 de julio de 1997"
25,5,6,966,141,185,326,"6 de julio de 1997"
25,5,6,967,92,141,233,"6 de julio de 1997"
25,5,6,968,112,113,225,"6 de julio de 1997"
25,5,6,969,59,59,118,"6 de julio de 1997"
25,5,6,970,96,123,219,"6 de julio de 1997"
25,5,6,971,68,101,169,"6 de julio de 1997"
25,5,6,972,112,129,241,"6 de julio de 1997"
25,5,6,973,87,94,181,"6 de julio de 1997"
25,5,6,974,67,86,153,"6 de julio de 1997"
25,5,6,975,142,175,317,"6 de julio de 1997"
25,5,6,976,106,101,207,"6 de julio de 1997"
25,5,6,977,122,127,249,"6 de julio de 1997"
25,5,6,978,146,174,320,"6 de julio de 1997"
25,5,6,979,87,123,210,"6 de julio de 1997"
25,5,6,980,124,157,281,"6 de julio de 1997"
25,5,6,981,82,102,184,"6 de julio de 1997"
25,5,6,982,94,140,234,"6 de julio de 1997"
25,5,6,983,110,140,250,"6 de julio de 1997"
25,5,6,984,108,132,240,"6 de julio de 1997"
25,5,6,985,174,197,371,"6 de julio de 1997"
25,5,6,986,141,172,313,"6 de julio de 1997"
25,5,6,987,120,149,269,"6 de julio de 1997"
25,5,6,988,110,127,237,"6 de julio de 1997"
25,5,6,989,182,243,425,"6 de julio de 1997"
25,5,6,990,192,203,395,"6 de julio de 1997"
25,5,6,991,164,191,355,"6 de julio de 1997"
25,5,6,992,244,218,462,"6 de julio de 1997"
25,5,6,993,262,296,558,"6 de julio de 1997"
25,5,6,994,241,265,506,"6 de julio de 1997"
25,5,6,995,192,209,401,"6 de julio de 1997"
25,5,6,996,200,195,395,"6 de julio de 1997"
25,5,6,997,198,200,398,"6 de julio de 1997"
25,5,6,998,110,115,225,"6 de julio de 1997"
25,5,6,999,208,210,418,"6 de julio de 1997"
25,5,6,1000,510,582,1092,"6 de julio de 1997"
25,5,6,1001,195,201,396,"6 de julio de 1997"
25,5,6,1002,198,237,435,"6 de julio de 1997"
25,5,6,1003,200,225,425,"6 de julio de 1997"
25,5,6,1004,226,274,500,"6 de julio de 1997"
25,5,6,1005,116,135,251,"6 de julio de 1997"
25,5,6,1006,258,253,511,"6 de julio de 1997"
25,5,6,1007,159,198,357,"6 de julio de 1997"
25,5,6,1008,204,250,454,"6 de julio de 1997"
25,5,6,1009,158,206,364,"6 de julio de 1997"
25,5,6,1010,216,262,478,"6 de julio de 1997"
25,5,6,1011,152,176,328,"6 de julio de 1997"
25,5,6,1012,175,219,394,"6 de julio de 1997"
25,5,6,1013,178,170,348,"6 de julio de 1997"
25,5,6,1014,104,113,217,"6 de julio de 1997"
25,5,6,1015,124,159,283,"6 de julio de 1997"
25,5,6,1016,113,140,253,"6 de julio de 1997"
25,5,6,1017,208,256,464,"6 de julio de 1997"
25,5,6,1018,86,96,182,"6 de julio de 1997"
25,5,6,1019,183,218,401,"6 de julio de 1997"
25,5,6,1020,143,172,315,"6 de julio de 1997"
25,5,6,1021,93,96,189,"6 de julio de 1997"
25,5,6,1022,138,139,277,"6 de julio de 1997"
25,5,6,1023,112,135,247,"6 de julio de 1997"
25,5,6,1024,140,184,324,"6 de julio de 1997"
25,5,6,1025,164,204,368,"6 de julio de 1997"
25,5,6,1026,128,166,294,"6 de julio de 1997"
25,5,6,1027,123,158,281,"6 de julio de 1997"
25,5,6,1028,101,116,217,"6 de julio de 1997"
25,5,6,1029,89,97,186,"6 de julio de 1997"
25,5,6,1030,244,279,523,"6 de julio de 1997"
25,5,6,1031,114,117,231,"6 de julio de 1997"
25,5,6,1032,153,191,344,"6 de julio de 1997"
25,5,6,1033,121,119,240,"6 de julio de 1997"
25,5,6,1034,197,200,397,"6 de julio de 1997"
25,5,6,1035,175,198,373,"6 de julio de 1997"
25,5,6,1036,90,115,205,"6 de julio de 1997"
25,5,6,1037,174,207,381,"6 de julio de 1997"
25,5,6,1038,170,191,361,"6 de julio de 1997"
25,5,6,1039,195,227,422,"6 de julio de 1997"
25,5,6,1040,169,204,373,"6 de julio de 1997"
25,5,6,1041,181,234,415,"6 de julio de 1997"
25,5,6,1042,261,297,558,"6 de julio de 1997"
25,5,6,1043,262,323,585,"6 de julio de 1997"
25,5,6,1044,81,113,194,"6 de julio de 1997"
25,5,6,1045,210,248,458,"6 de julio de 1997"
25,5,6,1046,206,255,461,"6 de julio de 1997"
25,5,6,1047,136,139,275,"6 de julio de 1997"
25,5,6,1048,147,173,320,"6 de julio de 1997"
25,5,6,1049,262,332,594,"6 de julio de 1997"
25,5,6,1050,145,179,324,"6 de julio de 1997"
25,5,6,1051,153,170,323,"6 de julio de 1997"
25,5,6,1052,185,216,401,"6 de julio de 1997"
25,5,6,1053,162,205,367,"6 de julio de 1997"
25,5,6,1054,123,126,249,"6 de julio de 1997"
25,5,6,1055,152,173,325,"6 de julio de 1997"
25,5,6,1056,150,187,337,"6 de julio de 1997"
25,5,6,1057,177,181,358,"6 de julio de 1997"
25,5,6,1058,235,272,507,"6 de julio de 1997"
25,5,6,1059,173,188,361,"6 de julio de 1997"
25,5,6,1060,103,145,248,"6 de julio de 1997"
25,5,6,1061,127,161,288,"6 de julio de 1997"
25,5,6,1062,192,212,404,"6 de julio de 1997"
25,5,6,1063,121,129,250,"6 de julio de 1997"
25,5,6,1064,197,213,410,"6 de julio de 1997"
25,5,6,1065,150,151,301,"6 de julio de 1997"
25,5,6,1066,150,184,334,"6 de julio de 1997"
25,5,6,1067,162,153,315,"6 de julio de 1997"
25,5,6,1068,115,124,239,"6 de julio de 1997"
25,5,6,1069,153,184,337,"6 de julio de 1997"
25,5,6,1070,154,170,324,"6 de julio de 1997"
25,5,6,1071,115,137,252,"6 de julio de 1997"
25,5,6,1072,178,170,348,"6 de julio de 1997"
25,5,6,1073,248,253,501,"6 de julio de 1997"
25,5,6,1074,132,172,304,"6 de julio de 1997"
25,5,6,1075,122,178,300,"6 de julio de 1997"
25,5,6,1076,270,333,603,"6 de julio de 1997"
25,5,6,1077,151,189,340,"6 de julio de 1997"
25,5,6,1078,243,300,543,"6 de julio de 1997"
25,5,6,1079,227,265,492,"6 de julio de 1997"
25,5,6,1080,128,130,258,"6 de julio de 1997"
25,5,6,1081,224,276,500,"6 de julio de 1997"
25,5,6,1082,170,189,359,"6 de julio de 1997"
25,5,6,1083,126,187,313,"6 de julio de 1997"
25,5,6,1084,164,208,372,"6 de julio de 1997"
25,5,6,1085,216,239,455,"6 de julio de 1997"
25,5,6,1086,194,212,406,"6 de julio de 1997"
25,5,6,1087,605,776,1381,"6 de julio de 1997"
25,5,6,1088,339,402,741,"6 de julio de 1997"
25,5,6,1089,288,378,666,"6 de julio de 1997"
25,5,6,1090,267,343,610,"6 de julio de 1997"
25,5,6,1091,217,243,460,"6 de julio de 1997"
25,5,6,1092,128,164,292,"6 de julio de 1997"
25,5,6,1093,209,271,480,"6 de julio de 1997"
25,5,6,1094,122,156,278,"6 de julio de 1997"
25,5,6,1095,193,230,423,"6 de julio de 1997"
25,5,6,1096,207,222,429,"6 de julio de 1997"
25,5,6,1097,138,148,286,"6 de julio de 1997"
25,5,6,1098,245,247,492,"6 de julio de 1997"
25,5,6,1099,145,189,334,"6 de julio de 1997"
25,5,6,1100,96,106,202,"6 de julio de 1997"
25,5,6,1101,192,254,446,"6 de julio de 1997"
25,5,6,1102,131,170,301,"6 de julio de 1997"
25,5,6,1103,206,270,476,"6 de julio de 1997"
25,5,6,1104,173,205,378,"6 de julio de 1997"
25,5,6,1105,133,151,284,"6 de julio de 1997"
25,5,6,1106,167,202,369,"6 de julio de 1997"
25,5,6,1107,155,174,329,"6 de julio de 1997"
25,5,6,1108,118,118,236,"6 de julio de 1997"
25,5,6,1109,134,160,294,"6 de julio de 1997"
25,5,6,1110,124,159,283,"6 de julio de 1997"
25,5,6,1111,166,151,317,"6 de julio de 1997"
25,5,6,1112,171,184,355,"6 de julio de 1997"
25,5,6,1113,104,109,213,"6 de julio de 1997"
25,5,6,1114,192,209,401,"6 de julio de 1997"
25,5,6,1115,170,211,381,"6 de julio de 1997"
25,5,6,1116,195,241,436,"6 de julio de 1997"
25,5,6,1117,215,222,437,"6 de julio de 1997"
25,5,6,1118,155,171,326,"6 de julio de 1997"
25,5,6,1119,501,617,1118,"6 de julio de 1997"
25,5,6,1120,192,205,397,"6 de julio de 1997"
25,5,6,1121,203,210,413,"6 de julio de 1997"
25,5,6,1122,103,126,229,"6 de julio de 1997"
25,5,6,1123,189,208,397,"6 de julio de 1997"
25,5,6,1124,139,152,291,"6 de julio de 1997"
25,5,6,1125,127,114,241,"6 de julio de 1997"
25,5,6,1126,155,199,354,"6 de julio de 1997"
25,5,6,1127,96,110,206,"6 de julio de 1997"
25,5,6,1128,135,172,307,"6 de julio de 1997"
25,5,6,1129,229,249,478,"6 de julio de 1997"
25,5,6,1130,202,207,409,"6 de julio de 1997"
25,5,6,1131,115,108,223,"6 de julio de 1997"
25,5,6,1132,171,186,357,"6 de julio de 1997"
25,5,6,1133,130,153,283,"6 de julio de 1997"
25,5,6,1134,172,189,361,"6 de julio de 1997"
25,5,6,1135,149,180,329,"6 de julio de 1997"
25,5,6,1136,156,153,309,"6 de julio de 1997"
25,5,6,1137,152,164,316,"6 de julio de 1997"
25,5,6,1138,191,198,389,"6 de julio de 1997"
25,5,6,1139,135,138,273,"6 de julio de 1997"
25,5,6,1140,167,176,343,"6 de julio de 1997"
25,5,6,1141,149,187,336,"6 de julio de 1997"
25,5,6,1142,188,232,420,"6 de julio de 1997"
25,5,6,1143,173,211,384,"6 de julio de 1997"
25,5,6,1144,183,169,352,"6 de julio de 1997"
25,5,6,1145,251,283,534,"6 de julio de 1997"
25,5,6,1146,185,216,401,"6 de julio de 1997"
25,5,6,1147,132,148,280,"6 de julio de 1997"
25,5,6,1148,98,86,184,"6 de julio de 1997"
25,5,6,1149,172,194,366,"6 de julio de 1997"
25,5,6,1150,226,256,482,"6 de julio de 1997"
25,5,6,1151,402,478,880,"6 de julio de 1997"
25,5,6,1152,222,253,475,"6 de julio de 1997"
25,5,6,1153,203,246,449,"6 de julio de 1997"
25,5,6,1154,177,180,357,"6 de julio de 1997"
25,5,6,1155,186,205,391,"6 de julio de 1997"
25,5,6,1156,347,383,730,"6 de julio de 1997"
25,5,6,1157,164,153,317,"6 de julio de 1997"
25,5,6,1158,165,183,348,"6 de julio de 1997"
25,5,6,1159,179,160,339,"6 de julio de 1997"
25,5,6,1160,176,220,396,"6 de julio de 1997"
25,5,6,1161,113,117,230,"6 de julio de 1997"
25,5,6,1162,192,185,377,"6 de julio de 1997"
25,5,6,1163,159,165,324,"6 de julio de 1997"
25,5,6,1164,191,176,367,"6 de julio de 1997"
25,5,6,1165,152,168,320,"6 de julio de 1997"
25,5,6,1166,147,146,293,"6 de julio de 1997"
25,5,6,1167,133,146,279,"6 de julio de 1997"
25,5,6,1168,124,135,259,"6 de julio de 1997"
25,5,6,1169,234,266,500,"6 de julio de 1997"
25,5,6,1170,155,164,319,"6 de julio de 1997"
25,5,6,1171,198,205,403,"6 de julio de 1997"
25,5,6,1172,213,236,449,"6 de julio de 1997"
25,5,6,1173,104,120,224,"6 de julio de 1997"
25,5,6,1174,161,189,350,"6 de julio de 1997"
25,5,6,1175,146,159,305,"6 de julio de 1997"
25,5,6,1176,152,177,329,"6 de julio de 1997"
25,5,6,1177,105,89,194,"6 de julio de 1997"
25,5,6,1178,200,217,417,"6 de julio de 1997"
25,5,6,1179,183,194,377,"6 de julio de 1997"
25,5,6,1180,115,145,260,"6 de julio de 1997"
25,5,6,1181,175,202,377,"6 de julio de 1997"
25,5,6,1182,262,293,555,"6 de julio de 1997"
25,5,6,1183,127,162,289,"6 de julio de 1997"
25,5,6,1184,190,208,398,"6 de julio de 1997"
25,5,6,1185,307,357,664,"6 de julio de 1997"
25,5,6,1186,226,270,496,"6 de julio de 1997"
25,5,6,1187,156,162,318,"6 de julio de 1997"
25,5,6,1188,408,444,852,"6 de julio de 1997"
25,5,6,1189,548,664,1212,"6 de julio de 1997"
25,5,6,1190,277,307,584,"6 de julio de 1997"
25,5,6,1191,260,321,581,"6 de julio de 1997"
25,5,6,1192,260,295,555,"6 de julio de 1997"
25,5,6,1193,270,342,612,"6 de julio de 1997"
25,5,6,1194,291,312,603,"6 de julio de 1997"
25,5,6,1195,178,213,391,"6 de julio de 1997"
25,5,6,1196,247,312,559,"6 de julio de 1997"
25,5,6,1197,153,201,354,"6 de julio de 1997"
25,5,6,1198,355,421,776,"6 de julio de 1997"
25,5,6,1199,341,423,764,"6 de julio de 1997"
25,5,6,1200,212,262,474,"6 de julio de 1997"
25,5,6,1201,692,784,1476,"6 de julio de 1997"
25,5,6,1202,188,224,412,"6 de julio de 1997"
25,5,6,1203,136,179,315,"6 de julio de 1997"
25,5,6,1204,139,164,303,"6 de julio de 1997"
25,5,6,1205,118,143,261,"6 de julio de 1997"
25,5,6,1206,404,439,843,"6 de julio de 1997"
25,5,6,1207,270,309,579,"6 de julio de 1997"
25,5,6,1208,118,150,268,"6 de julio de 1997"
25,5,6,1209,110,129,239,"6 de julio de 1997"
25,5,6,1210,583,663,1246,"6 de julio de 1997"
25,5,6,1211,129,167,296,"6 de julio de 1997"
25,5,6,1212,146,203,349,"6 de julio de 1997"
25,5,6,1213,128,137,265,"6 de julio de 1997"
25,5,6,1214,95,108,203,"6 de julio de 1997"
25,5,6,1215,109,149,258,"6 de julio de 1997"
25,5,6,1216,191,197,388,"6 de julio de 1997"
25,5,6,1217,173,165,338,"6 de julio de 1997"
25,5,6,1218,227,224,451,"6 de julio de 1997"
25,5,6,1219,146,176,322,"6 de julio de 1997"
25,5,6,1220,346,385,731,"6 de julio de 1997"
25,5,6,1221,39,27,66,"6 de julio de 1997"
25,5,6,1222,227,195,422,"6 de julio de 1997"
25,5,6,1223,192,189,381,"6 de julio de 1997"
25,5,6,1224,149,114,263,"6 de julio de 1997"
25,5,6,1225,82,34,116,"6 de julio de 1997"
25,5,6,1226,96,57,153,"6 de julio de 1997"
25,5,6,1227,151,73,224,"6 de julio de 1997"
25,5,6,1228,109,73,182,"6 de julio de 1997"
25,5,6,1229,66,36,102,"6 de julio de 1997"
25,5,6,1230,122,78,200,"6 de julio de 1997"
25,5,6,1231,134,125,259,"6 de julio de 1997"
25,5,6,1232,63,34,97,"6 de julio de 1997"
25,5,6,1233,90,46,136,"6 de julio de 1997"
25,5,6,1234,78,52,130,"6 de julio de 1997"
25,5,6,1235,257,217,474,"6 de julio de 1997"
25,5,6,1236,94,57,151,"6 de julio de 1997"
25,5,6,1237,131,111,242,"6 de julio de 1997"
25,5,6,1238,63,50,113,"6 de julio de 1997"
25,5,6,1239,249,217,466,"6 de julio de 1997"
25,5,6,1240,111,77,188,"6 de julio de 1997"
25,5,6,1241,197,192,389,"6 de julio de 1997"
25,5,6,1242,94,47,141,"6 de julio de 1997"
25,5,6,1243,78,58,136,"6 de julio de 1997"
25,5,6,1244,370,338,708,"6 de julio de 1997"
25,5,6,1245,277,244,521,"6 de julio de 1997"
25,5,6,1246,137,128,265,"6 de julio de 1997"
25,5,6,1247,198,175,373,"6 de julio de 1997"
25,5,6,1248,321,335,656,"6 de julio de 1997"
25,5,6,1249,182,179,361,"6 de julio de 1997"
25,5,6,1250,209,211,420,"6 de julio de 1997"
25,5,6,1251,138,138,276,"6 de julio de 1997"
25,5,6,1252,194,157,351,"6 de julio de 1997"
25,5,6,1253,143,167,310,"6 de julio de 1997"
25,5,6,1254,394,410,804,"6 de julio de 1997"
25,5,6,1255,284,250,534,"6 de julio de 1997"
25,5,6,1256,71,51,122,"6 de julio de 1997"
25,5,6,1257,157,114,271,"6 de julio de 1997"
25,5,6,1258,74,73,147,"6 de julio de 1997"
25,5,6,1259,65,41,106,"6 de julio de 1997"
25,5,6,1260,223,227,450,"6 de julio de 1997"
25,5,6,1261,330,349,679,"6 de julio de 1997"
25,5,6,1262,295,295,590,"6 de julio de 1997"
25,5,6,1263,64,65,129,"6 de julio de 1997"
25,5,6,1264,139,98,237,"6 de julio de 1997"
25,5,6,1265,176,162,338,"6 de julio de 1997"
25,5,6,1266,145,156,301,"6 de julio de 1997"
25,5,6,1267,99,80,179,"6 de julio de 1997"
25,5,6,1268,101,95,196,"6 de julio de 1997"
25,5,6,1269,323,331,654,"6 de julio de 1997"
25,5,6,1270,196,209,405,"6 de julio de 1997"
25,5,6,1271,303,287,590,"6 de julio de 1997"
25,5,6,1272,297,324,621,"6 de julio de 1997"
25,5,6,1273,268,272,540,"6 de julio de 1997"
25,5,6,1274,140,142,282,"6 de julio de 1997"
25,5,6,1275,385,415,800,"6 de julio de 1997"
25,5,6,1276,123,147,270,"6 de julio de 1997"
25,5,6,1277,162,185,347,"6 de julio de 1997"
25,5,6,1278,115,112,227,"6 de julio de 1997"
25,5,6,1279,200,203,403,"6 de julio de 1997"
25,5,6,1280,125,110,235,"6 de julio de 1997"
25,5,6,1281,196,196,392,"6 de julio de 1997"
25,5,6,1282,202,193,395,"6 de julio de 1997"
25,5,6,1283,142,145,287,"6 de julio de 1997"
25,5,6,1284,185,220,405,"6 de julio de 1997"
25,5,6,1285,143,131,274,"6 de julio de 1997"
25,5,6,1286,176,160,336,"6 de julio de 1997"
25,5,6,1287,231,274,505,"6 de julio de 1997"
25,5,6,1288,363,383,746,"6 de julio de 1997"
25,5,6,1289,208,193,401,"6 de julio de 1997"
25,5,6,1290,97,120,217,"6 de julio de 1997"
25,5,6,1291,185,196,381,"6 de julio de 1997"
25,5,6,1292,222,187,409,"6 de julio de 1997"
25,5,6,1293,102,82,184,"6 de julio de 1997"
25,5,6,1294,102,83,185,"6 de julio de 1997"
25,5,6,1487,80,61,141,"6 de julio de 1997"
25,5,6,1488,144,95,239,"6 de julio de 1997"
25,5,6,1489,89,43,132,"6 de julio de 1997"
25,5,6,1490,81,55,136,"6 de julio de 1997"
25,5,6,1491,72,39,111,"6 de julio de 1997"
25,5,6,1492,148,81,229,"6 de julio de 1997"
25,5,6,1493,160,136,296,"6 de julio de 1997"
25,5,6,1494,156,140,296,"6 de julio de 1997"
25,5,6,1495,110,96,206,"6 de julio de 1997"
25,5,6,1496,86,59,145,"6 de julio de 1997"
25,5,6,1497,157,120,277,"6 de julio de 1997"
25,5,6,1498,118,82,200,"6 de julio de 1997"
25,5,6,1499,44,33,77,"6 de julio de 1997"
25,5,6,1500,166,132,298,"6 de julio de 1997"
25,5,6,1501,95,90,185,"6 de julio de 1997"
25,5,6,1502,88,73,161,"6 de julio de 1997"
25,5,6,1503,239,174,413,"6 de julio de 1997"
25,5,6,1504,144,108,252,"6 de julio de 1997"
25,5,6,1505,163,129,292,"6 de julio de 1997"
25,5,6,1506,140,107,247,"6 de julio de 1997"
25,5,6,1514,76,57,133,"6 de julio de 1997"
25,6,4,629,265,253,518,"6 de julio de 1997"
25,6,4,630,168,155,323,"6 de julio de 1997"
25,6,4,631,252,221,473,"6 de julio de 1997"
25,6,4,632,379,387,766,"6 de julio de 1997"
25,6,4,633,191,200,391,"6 de julio de 1997"
25,6,4,634,164,172,336,"6 de julio de 1997"
25,6,4,635,311,295,606,"6 de julio de 1997"
25,6,4,636,173,187,360,"6 de julio de 1997"
25,6,4,637,481,458,939,"6 de julio de 1997"
25,6,4,638,156,118,274,"6 de julio de 1997"
25,6,4,639,196,112,308,"6 de julio de 1997"
25,6,4,640,89,60,149,"6 de julio de 1997"
25,6,4,641,225,198,423,"6 de julio de 1997"
25,6,4,642,173,167,340,"6 de julio de 1997"
25,6,4,643,185,168,353,"6 de julio de 1997"
25,6,4,644,86,84,170,"6 de julio de 1997"
25,6,4,645,77,71,148,"6 de julio de 1997"
25,6,4,646,229,187,416,"6 de julio de 1997"
25,6,4,647,62,55,117,"6 de julio de 1997"
25,6,4,648,55,40,95,"6 de julio de 1997"
25,6,4,649,141,114,255,"6 de julio de 1997"
25,6,4,650,68,67,135,"6 de julio de 1997"
25,6,4,651,188,152,340,"6 de julio de 1997"
25,6,4,652,150,132,282,"6 de julio de 1997"
25,6,4,653,171,147,318,"6 de julio de 1997"
25,6,4,654,227,214,441,"6 de julio de 1997"
25,6,4,655,236,212,448,"6 de julio de 1997"
25,6,4,656,89,75,164,"6 de julio de 1997"
25,6,4,657,169,137,306,"6 de julio de 1997"
25,6,4,658,145,108,253,"6 de julio de 1997"
25,6,4,659,124,116,240,"6 de julio de 1997"
25,6,4,660,197,176,373,"6 de julio de 1997"
25,6,4,661,247,194,441,"6 de julio de 1997"
25,6,4,662,77,65,142,"6 de julio de 1997"
25,6,4,663,102,70,172,"6 de julio de 1997"
25,6,4,664,173,168,341,"6 de julio de 1997"
25,6,4,665,287,208,495,"6 de julio de 1997"
25,6,4,666,116,95,211,"6 de julio de 1997"
25,6,4,667,165,156,321,"6 de julio de 1997"
25,6,4,668,93,95,188,"6 de julio de 1997"
25,6,4,669,183,188,371,"6 de julio de 1997"
25,6,4,670,259,263,522,"6 de julio de 1997"
25,6,4,671,235,200,435,"6 de julio de 1997"
25,6,4,672,171,154,325,"6 de julio de 1997"
25,6,4,673,172,124,296,"6 de julio de 1997"
25,6,4,674,35,21,56,"6 de julio de 1997"
25,6,5,675,183,190,373,"6 de julio de 1997"
25,6,5,676,168,187,355,"6 de julio de 1997"
25,6,5,677,241,248,489,"6 de julio de 1997"
25,6,5,678,156,154,310,"6 de julio de 1997"
25,6,5,679,230,188,418,"6 de julio de 1997"
25,6,5,680,246,262,508,"6 de julio de 1997"
25,6,5,681,180,153,333,"6 de julio de 1997"
25,6,5,682,232,217,449,"6 de julio de 1997"
25,6,5,683,185,144,329,"6 de julio de 1997"
25,6,5,684,46,21,67,"6 de julio de 1997"
25,6,5,685,61,27,88,"6 de julio de 1997"
25,6,5,686,158,143,301,"6 de julio de 1997"
25,6,5,687,85,59,144,"6 de julio de 1997"
25,6,5,688,43,36,79,"6 de julio de 1997"
25,6,5,689,68,54,122,"6 de julio de 1997"
25,6,5,690,160,102,262,"6 de julio de 1997"
25,6,5,691,139,97,236,"6 de julio de 1997"
25,6,5,692,115,70,185,"6 de julio de 1997"
25,6,5,693,47,43,90,"6 de julio de 1997"
25,6,5,694,170,134,304,"6 de julio de 1997"
25,6,5,695,131,95,226,"6 de julio de 1997"
25,6,5,696,126,91,217,"6 de julio de 1997"
25,6,5,697,98,75,173,"6 de julio de 1997"
25,6,5,698,192,151,343,"6 de julio de 1997"
25,6,5,699,98,65,163,"6 de julio de 1997"
25,6,5,700,133,96,229,"6 de julio de 1997"
25,6,5,701,169,119,288,"6 de julio de 1997"
25,6,5,702,128,99,227,"6 de julio de 1997"
25,6,5,703,207,173,380,"6 de julio de 1997"
25,6,5,704,152,92,244,"6 de julio de 1997"
25,6,5,705,171,138,309,"6 de julio de 1997"
25,6,5,706,69,54,123,"6 de julio de 1997"
25,6,5,707,82,68,150,"6 de julio de 1997"
25,6,5,708,66,57,123,"6 de julio de 1997"
25,6,5,709,171,104,275,"6 de julio de 1997"
25,6,8,1799,201,196,397,"6 de julio de 1997"
25,6,8,1800,176,164,340,"6 de julio de 1997"
25,6,8,1801,216,210,426,"6 de julio de 1997"
25,6,8,1802,262,257,519,"6 de julio de 1997"
25,6,8,1803,127,118,245,"6 de julio de 1997"
25,6,8,1804,246,224,470,"6 de julio de 1997"
25,6,8,1805,269,267,536,"6 de julio de 1997"
25,6,8,1806,167,149,316,"6 de julio de 1997"
25,6,8,1807,152,139,291,"6 de julio de 1997"
25,6,8,1808,103,97,200,"6 de julio de 1997"
25,6,8,1809,71,76,147,"6 de julio de 1997"
25,6,8,1810,80,80,160,"6 de julio de 1997"
25,6,8,1811,221,233,454,"6 de julio de 1997"
25,6,8,1812,95,99,194,"6 de julio de 1997"
25,6,8,1813,216,218,434,"6 de julio de 1997"
25,6,8,1814,183,173,356,"6 de julio de 1997"
25,6,8,1815,62,47,109,"6 de julio de 1997"
25,6,8,1816,49,26,75,"6 de julio de 1997"
25,6,8,1817,78,52,130,"6 de julio de 1997"
25,6,8,1818,63,33,96,"6 de julio de 1997"
25,6,8,1819,40,24,64,"6 de julio de 1997"
25,6,8,1820,107,91,198,"6 de julio de 1997"
25,6,8,1821,79,62,141,"6 de julio de 1997"
25,6,8,1822,239,218,457,"6 de julio de 1997"
25,6,8,1823,169,186,355,"6 de julio de 1997"
25,6,8,1824,145,134,279,"6 de julio de 1997"
25,6,8,1825,124,120,244,"6 de julio de 1997"
25,6,8,1826,91,68,159,"6 de julio de 1997"
25,6,8,1827,109,103,212,"6 de julio de 1997"
25,6,8,1828,96,82,178,"6 de julio de 1997"
25,6,8,1829,175,120,295,"6 de julio de 1997"
25,6,8,1830,159,150,309,"6 de julio de 1997"
25,6,8,1831,78,64,142,"6 de julio de 1997"
25,6,8,1832,65,52,117,"6 de julio de 1997"
25,6,8,1833,126,98,224,"6 de julio de 1997"
25,6,8,1834,173,174,347,"6 de julio de 1997"
25,6,8,1835,246,211,457,"6 de julio de 1997"
25,6,8,1836,180,141,321,"6 de julio de 1997"
25,6,8,1837,269,226,495,"6 de julio de 1997"
25,6,8,1838,158,156,314,"6 de julio de 1997"
25,6,8,1839,178,134,312,"6 de julio de 1997"
25,6,8,1840,163,152,315,"6 de julio de 1997"
25,6,8,1841,130,131,261,"6 de julio de 1997"
25,6,8,1842,137,130,267,"6 de julio de 1997"
25,6,8,1843,161,110,271,"6 de julio de 1997"
25,6,8,1844,65,59,124,"6 de julio de 1997"
25,6,8,1845,121,101,222,"6 de julio de 1997"
25,6,8,1846,212,197,409,"6 de julio de 1997"
25,6,8,1847,345,258,603,"6 de julio de 1997"
25,6,8,1848,32,23,55,"6 de julio de 1997"
25,6,8,1849,109,80,189,"6 de julio de 1997"
25,6,8,1850,195,205,400,"6 de julio de 1997"
25,6,8,1851,211,179,390,"6 de julio de 1997"
25,6,8,1852,52,42,94,"6 de julio de 1997"
25,6,8,1853,80,62,142,"6 de julio de 1997"
25,6,8,1854,196,177,373,"6 de julio de 1997"
25,6,8,1855,145,124,269,"6 de julio de 1997"
25,6,8,1856,187,165,352,"6 de julio de 1997"
25,6,8,1857,202,165,367,"6 de julio de 1997"
25,6,8,1858,164,149,313,"6 de julio de 1997"
25,6,8,1859,261,199,460,"6 de julio de 1997"
25,6,9,1860,70,64,134,"6 de julio de 1997"
25,6,9,1861,293,269,562,"6 de julio de 1997"
25,6,9,1862,169,187,356,"6 de julio de 1997"
25,6,9,1863,190,185,375,"6 de julio de 1997"
25,6,9,1864,311,281,592,"6 de julio de 1997"
25,6,9,1865,184,179,363,"6 de julio de 1997"
25,6,9,1866,214,202,416,"6 de julio de 1997"
25,6,9,1867,218,202,420,"6 de julio de 1997"
25,6,9,1868,290,266,556,"6 de julio de 1997"
25,6,9,1869,219,226,445,"6 de julio de 1997"
25,6,9,1870,130,163,293,"6 de julio de 1997"
25,6,9,1871,235,229,464,"6 de julio de 1997"
25,6,9,1872,201,223,424,"6 de julio de 1997"
25,6,9,1873,181,175,356,"6 de julio de 1997"
25,6,9,1874,208,227,435,"6 de julio de 1997"
25,6,9,1875,187,232,419,"6 de julio de 1997"
25,6,9,1876,371,376,747,"6 de julio de 1997"
25,6,9,1877,148,154,302,"6 de julio de 1997"
25,6,9,1878,159,181,340,"6 de julio de 1997"
25,6,9,1879,159,192,351,"6 de julio de 1997"
25,6,9,1880,193,193,386,"6 de julio de 1997"
25,6,9,1881,132,137,269,"6 de julio de 1997"
25,6,9,1882,209,214,423,"6 de julio de 1997"
25,6,9,1883,379,387,766,"6 de julio de 1997"
25,6,9,1884,360,350,710,"6 de julio de 1997"
25,6,9,1885,349,368,717,"6 de julio de 1997"
25,6,9,1886,261,271,532,"6 de julio de 1997"
25,6,9,1887,120,137,257,"6 de julio de 1997"
25,6,9,1888,101,127,228,"6 de julio de 1997"
25,6,9,1889,163,162,325,"6 de julio de 1997"
25,6,9,1890,250,260,510,"6 de julio de 1997"
25,6,9,1891,335,350,685,"6 de julio de 1997"
25,6,9,1892,278,263,541,"6 de julio de 1997"
25,6,9,1893,353,391,744,"6 de julio de 1997"
25,6,9,1894,331,309,640,"6 de julio de 1997"
25,6,9,1895,150,157,307,"6 de julio de 1997"
25,6,9,1896,106,96,202,"6 de julio de 1997"
25,6,9,1897,89,70,159,"6 de julio de 1997"
25,6,9,1898,24,19,43,"6 de julio de 1997"
25,6,9,1899,29,22,51,"6 de julio de 1997"
25,6,9,1900,38,22,60,"6 de julio de 1997"
25,6,9,1901,331,272,603,"6 de julio de 1997"
25,6,9,1902,320,249,569,"6 de julio de 1997"
25,6,9,1903,377,358,735,"6 de julio de 1997"
25,6,9,1904,517,473,990,"6 de julio de 1997"
25,6,9,1905,85,74,159,"6 de julio de 1997"
25,6,9,1906,377,332,709,"6 de julio de 1997"
25,6,9,1907,131,89,220,"6 de julio de 1997"
25,6,9,1908,280,222,502,"6 de julio de 1997"
25,6,9,1909,293,265,558,"6 de julio de 1997"
25,6,9,1910,276,241,517,"6 de julio de 1997"
25,6,9,1911,249,193,442,"6 de julio de 1997"
25,6,9,1912,250,224,474,"6 de julio de 1997"
25,6,9,1913,488,471,959,"6 de julio de 1997"
25,6,9,1914,146,159,305,"6 de julio de 1997"
25,6,9,1915,154,138,292,"6 de julio de 1997"
25,6,9,1916,164,173,337,"6 de julio de 1997"
25,6,9,1917,224,220,444,"6 de julio de 1997"
25,6,9,1918,168,174,342,"6 de julio de 1997"
25,6,9,1919,242,205,447,"6 de julio de 1997"
25,6,9,1920,143,152,295,"6 de julio de 1997"
25,6,9,1921,162,166,328,"6 de julio de 1997"
25,6,9,1922,185,175,360,"6 de julio de 1997"
25,6,9,1923,165,142,307,"6 de julio de 1997"
25,6,9,1924,183,168,351,"6 de julio de 1997"
25,6,12,2612,215,239,454,"6 de julio de 1997"
25,6,12,2613,176,172,348,"6 de julio de 1997"
25,6,12,2616,415,382,797,"6 de julio de 1997"
25,6,12,2617,214,194,408,"6 de julio de 1997"
25,6,12,2618,403,401,804,"6 de julio de 1997"
25,6,12,2619,183,174,357,"6 de julio de 1997"
25,6,12,2620,142,108,250,"6 de julio de 1997"
25,6,12,2621,179,173,352,"6 de julio de 1997"
25,6,12,2622,186,192,378,"6 de julio de 1997"
25,6,12,2623,217,197,414,"6 de julio de 1997"
25,6,12,2624,96,84,180,"6 de julio de 1997"
25,6,12,2625,147,127,274,"6 de julio de 1997"
25,6,12,2626,138,122,260,"6 de julio de 1997"
25,6,12,2627,252,249,501,"6 de julio de 1997"
25,6,12,2628,195,179,374,"6 de julio de 1997"
25,6,12,2629,147,144,291,"6 de julio de 1997"
25,6,12,2630,152,136,288,"6 de julio de 1997"
25,6,12,2631,185,169,354,"6 de julio de 1997"
25,6,12,2632,120,121,241,"6 de julio de 1997"
25,6,12,2633,113,105,218,"6 de julio de 1997"
25,6,12,2634,90,94,184,"6 de julio de 1997"
25,6,12,2635,65,59,124,"6 de julio de 1997"
25,6,12,2636,351,301,652,"6 de julio de 1997"
25,6,12,2637,160,129,289,"6 de julio de 1997"
25,6,12,2638,264,256,520,"6 de julio de 1997"
25,6,12,2639,131,139,270,"6 de julio de 1997"
25,6,12,2640,308,274,582,"6 de julio de 1997"
25,6,12,2641,241,230,471,"6 de julio de 1997"
25,6,12,2642,75,95,170,"6 de julio de 1997"
25,6,12,2643,144,141,285,"6 de julio de 1997"
25,6,12,2644,293,272,565,"6 de julio de 1997"
25,6,12,2645,144,157,301,"6 de julio de 1997"
25,6,12,2646,115,114,229,"6 de julio de 1997"
25,6,12,2647,288,294,582,"6 de julio de 1997"
25,6,12,2648,282,270,552,"6 de julio de 1997"
25,6,12,2649,112,139,251,"6 de julio de 1997"
25,6,12,2650,49,47,96,"6 de julio de 1997"
25,6,12,2651,163,172,335,"6 de julio de 1997"
25,6,12,2652,162,168,330,"6 de julio de 1997"
25,6,12,2653,173,201,374,"6 de julio de 1997"
25,6,12,2654,186,171,357,"6 de julio de 1997"
25,6,12,2655,248,221,469,"6 de julio de 1997"
25,6,12,2656,202,214,416,"6 de julio de 1997"
25,6,12,2657,177,164,341,"6 de julio de 1997"
25,6,12,2658,39,27,66,"6 de julio de 1997"
25,6,12,2659,29,28,57,"6 de julio de 1997"
25,6,12,2660,105,79,184,"6 de julio de 1997"
25,6,12,2661,198,177,375,"6 de julio de 1997"
25,6,12,2662,274,254,528,"6 de julio de 1997"
25,6,12,2663,191,174,365,"6 de julio de 1997"
25,6,12,2664,177,154,331,"6 de julio de 1997"
25,6,12,2665,209,148,357,"6 de julio de 1997"
25,6,12,2666,246,214,460,"6 de julio de 1997"
25,6,12,2667,353,366,719,"6 de julio de 1997"
25,6,12,2672,1923,2332,4255,"6 de julio de 1997"
25,6,12,2804,342,419,761,"6 de julio de 1997"
25,6,12,2805,211,214,425,"6 de julio de 1997"
25,6,12,2806,166,193,359,"6 de julio de 1997"
25,6,12,2807,226,261,487,"6 de julio de 1997"
25,6,12,2808,808,949,1757,"6 de julio de 1997"
25,6,12,2905,221,200,421,"6 de julio de 1997"
25,6,12,2906,424,454,878,"6 de julio de 1997"
25,6,12,2907,219,238,457,"6 de julio de 1997"
25,6,12,2948,260,294,554,"6 de julio de 1997"
25,6,12,2949,129,159,288,"6 de julio de 1997"
25,6,12,2950,135,167,302,"6 de julio de 1997"
25,6,12,2951,156,181,337,"6 de julio de 1997"
25,6,12,2952,17,8,25,"6 de julio de 1997"
25,6,12,2953,136,109,245,"6 de julio de 1997"
25,6,12,2954,154,106,260,"6 de julio de 1997"
25,6,12,2955,72,47,119,"6 de julio de 1997"
25,6,12,2956,332,273,605,"6 de julio de 1997"
25,6,12,2957,75,42,117,"6 de julio de 1997"
25,6,12,2958,121,101,222,"6 de julio de 1997"
25,6,12,2959,147,118,265,"6 de julio de 1997"
25,6,12,2960,107,99,206,"6 de julio de 1997"
25,6,12,2961,311,308,619,"6 de julio de 1997"
25,6,12,2962,171,166,337,"6 de julio de 1997"
25,6,12,2963,160,148,308,"6 de julio de 1997"
25,6,12,2964,78,59,137,"6 de julio de 1997"
25,6,12,2965,59,50,109,"6 de julio de 1997"
25,6,12,2966,247,187,434,"6 de julio de 1997"
25,6,12,2967,268,212,480,"6 de julio de 1997"
25,6,12,2968,112,88,200,"6 de julio de 1997"
25,6,12,2969,39,31,70,"6 de julio de 1997"
25,6,12,2970,73,40,113,"6 de julio de 1997"
25,6,12,2971,96,72,168,"6 de julio de 1997"
25,6,12,2972,71,45,116,"6 de julio de 1997"
25,6,12,2973,139,117,256,"6 de julio de 1997"
25,6,12,2974,328,274,602,"6 de julio de 1997"
25,6,12,2975,290,250,540,"6 de julio de 1997"
25,6,12,2976,144,120,264,"6 de julio de 1997"
25,6,12,2977,106,92,198,"6 de julio de 1997"
25,6,12,2978,102,101,203,"6 de julio de 1997"
25,6,12,2979,249,192,441,"6 de julio de 1997"
25,6,12,2980,41,35,76,"6 de julio de 1997"
25,6,12,2981,52,38,90,"6 de julio de 1997"
25,6,12,2982,116,107,223,"6 de julio de 1997"
25,6,12,2983,190,181,371,"6 de julio de 1997"
25,6,12,2984,292,283,575,"6 de julio de 1997"
25,6,12,2985,90,89,179,"6 de julio de 1997"
25,6,12,2986,30,21,51,"6 de julio de 1997"
25,6,12,2987,321,316,637,"6 de julio de 1997"
25,6,12,2988,228,272,500,"6 de julio de 1997"
25,6,12,2989,118,100,218,"6 de julio de 1997"
25,6,12,2990,183,150,333,"6 de julio de 1997"
25,6,12,2991,208,205,413,"6 de julio de 1997"
25,6,12,2992,124,131,255,"6 de julio de 1997"
25,6,12,2993,252,224,476,"6 de julio de 1997"
25,6,12,2994,150,120,270,"6 de julio de 1997"
25,6,12,2995,193,149,342,"6 de julio de 1997"
25,6,14,3131,243,266,509,"6 de julio de 1997"
25,6,14,3132,280,274,554,"6 de julio de 1997"
25,6,14,3133,297,296,593,"6 de julio de 1997"
25,6,14,3134,251,250,501,"6 de julio de 1997"
25,6,14,3135,165,163,328,"6 de julio de 1997"
25,6,14,3136,189,180,369,"6 de julio de 1997"
25,6,14,3137,212,229,441,"6 de julio de 1997"
25,6,14,3138,337,321,658,"6 de julio de 1997"
25,6,14,3139,356,340,696,"6 de julio de 1997"
25,6,14,3140,217,228,445,"6 de julio de 1997"
25,6,14,3141,115,130,245,"6 de julio de 1997"
25,6,14,3142,162,204,366,"6 de julio de 1997"
25,6,14,3143,312,274,586,"6 de julio de 1997"
25,6,14,3144,222,232,454,"6 de julio de 1997"
25,6,14,3145,98,115,213,"6 de julio de 1997"
25,6,14,3146,103,108,211,"6 de julio de 1997"
25,6,14,3147,306,257,563,"6 de julio de 1997"
25,6,14,3148,131,125,256,"6 de julio de 1997"
25,6,14,3149,133,137,270,"6 de julio de 1997"
25,6,14,3150,142,144,286,"6 de julio de 1997"
25,6,14,3151,226,156,382,"6 de julio de 1997"
25,6,14,3152,82,56,138,"6 de julio de 1997"
25,6,14,3153,77,26,103,"6 de julio de 1997"
25,6,14,3154,110,85,195,"6 de julio de 1997"
25,6,14,3155,271,228,499,"6 de julio de 1997"
25,6,14,3156,155,98,253,"6 de julio de 1997"
25,6,14,3157,88,70,158,"6 de julio de 1997"
25,6,14,3158,180,100,280,"6 de julio de 1997"
25,6,14,3159,75,47,122,"6 de julio de 1997"
25,6,14,3160,48,24,72,"6 de julio de 1997"
25,6,14,3161,159,123,282,"6 de julio de 1997"
25,6,14,3162,148,115,263,"6 de julio de 1997"
25,6,14,3163,146,131,277,"6 de julio de 1997"
25,6,14,3164,195,175,370,"6 de julio de 1997"
25,6,14,3165,70,46,116,"6 de julio de 1997"
25,6,14,3166,175,148,323,"6 de julio de 1997"
25,6,14,3167,135,102,237,"6 de julio de 1997"
25,6,14,3168,76,81,157,"6 de julio de 1997"
25,6,14,3169,112,97,209,"6 de julio de 1997"
25,6,14,3170,38,28,66,"6 de julio de 1997"
25,6,14,3171,46,23,69,"6 de julio de 1997"
25,6,14,3172,160,141,301,"6 de julio de 1997"
25,6,14,3173,286,234,520,"6 de julio de 1997"
25,6,14,3174,110,82,192,"6 de julio de 1997"
25,6,14,3175,231,174,405,"6 de julio de 1997"
25,6,14,3176,62,48,110,"6 de julio de 1997"
25,6,14,3177,259,216,475,"6 de julio de 1997"
25,6,14,3178,175,186,361,"6 de julio de 1997"
25,6,14,3179,155,131,286,"6 de julio de 1997"
25,6,14,3180,294,208,502,"6 de julio de 1997"
25,6,14,3181,59,48,107,"6 de julio de 1997"
25,6,14,3182,273,193,466,"6 de julio de 1997"
25,6,14,3183,56,38,94,"6 de julio de 1997"
25,6,14,3184,122,96,218,"6 de julio de 1997"
25,6,14,3185,73,44,117,"6 de julio de 1997"
25,6,14,3186,132,114,246,"6 de julio de 1997"
25,6,14,3187,82,76,158,"6 de julio de 1997"
25,6,14,3188,167,119,286,"6 de julio de 1997"
25,6,14,3189,136,122,258,"6 de julio de 1997"
25,6,14,3190,326,260,586,"6 de julio de 1997"
25,6,14,3191,198,168,366,"6 de julio de 1997"
25,6,14,3192,137,103,240,"6 de julio de 1997"
25,6,14,3193,237,169,406,"6 de julio de 1997"
25,6,14,3194,147,111,258,"6 de julio de 1997"
25,6,14,3195,176,136,312,"6 de julio de 1997"
25,6,14,3196,209,174,383,"6 de julio de 1997"
25,6,14,3197,72,46,118,"6 de julio de 1997"
25,6,14,3198,50,43,93,"6 de julio de 1997"
25,6,14,3199,189,140,329,"6 de julio de 1997"
25,6,14,3200,86,65,151,"6 de julio de 1997"
25,6,14,3201,250,243,493,"6 de julio de 1997"
25,6,14,3202,119,110,229,"6 de julio de 1997"
25,6,14,3203,88,72,160,"6 de julio de 1997"
25,6,14,3204,256,183,439,"6 de julio de 1997"
25,6,14,3205,318,305,623,"6 de julio de 1997"
25,6,14,3206,259,180,439,"6 de julio de 1997"
25,6,14,3207,308,237,545,"6 de julio de 1997"
25,6,14,3208,160,119,279,"6 de julio de 1997"
25,6,14,3209,293,242,535,"6 de julio de 1997"
25,6,14,3210,230,213,443,"6 de julio de 1997"
25,6,14,3211,161,149,310,"6 de julio de 1997"
25,6,14,3212,207,171,378,"6 de julio de 1997"
25,6,14,3213,159,141,300,"6 de julio de 1997"
25,6,14,3214,124,113,237,"6 de julio de 1997"
25,6,14,3215,192,203,395,"6 de julio de 1997"
25,6,14,3216,135,101,236,"6 de julio de 1997"
25,6,14,3217,192,195,387,"6 de julio de 1997"
25,6,14,3218,98,95,193,"6 de julio de 1997"
25,6,14,3219,381,337,718,"6 de julio de 1997"
25,6,16,3370,403,380,783,"6 de julio de 1997"
25,6,16,3371,217,159,376,"6 de julio de 1997"
25,6,16,3372,234,235,469,"6 de julio de 1997"
25,6,16,3373,115,106,221,"6 de julio de 1997"
25,6,16,3374,290,271,561,"6 de julio de 1997"
25,6,16,3375,81,42,123,"6 de julio de 1997"
25,6,16,3376,152,104,256,"6 de julio de 1997"
25,6,16,3377,47,20,67,"6 de julio de 1997"
25,6,16,3378,94,48,142,"6 de julio de 1997"
25,6,16,3379,179,120,299,"6 de julio de 1997"
25,6,16,3380,103,56,159,"6 de julio de 1997"
25,6,16,3381,67,45,112,"6 de julio de 1997"
25,6,16,3382,75,56,131,"6 de julio de 1997"
25,6,16,3383,85,63,148,"6 de julio de 1997"
25,6,16,3384,69,57,126,"6 de julio de 1997"
25,6,16,3385,323,220,543,"6 de julio de 1997"
25,6,16,3386,109,70,179,"6 de julio de 1997"
25,6,16,3387,90,62,152,"6 de julio de 1997"
25,6,16,3388,59,31,90,"6 de julio de 1997"
25,6,16,3389,85,63,148,"6 de julio de 1997"
25,6,16,3390,41,31,72,"6 de julio de 1997"
25,6,16,3391,7,6,13,"6 de julio de 1997"
25,6,16,3392,190,183,373,"6 de julio de 1997"
25,6,16,3393,78,81,159,"6 de julio de 1997"
25,6,16,3394,160,132,292,"6 de julio de 1997"
25,6,16,3395,149,102,251,"6 de julio de 1997"
25,6,16,3396,352,248,600,"6 de julio de 1997"
25,6,16,3397,61,40,101,"6 de julio de 1997"
25,6,16,3398,108,92,200,"6 de julio de 1997"
25,6,16,3399,73,68,141,"6 de julio de 1997"
25,6,16,3400,238,184,422,"6 de julio de 1997"
25,6,16,3401,219,175,394,"6 de julio de 1997"
25,6,16,3402,295,242,537,"6 de julio de 1997"
25,6,16,3403,263,238,501,"6 de julio de 1997"
25,6,16,3404,180,159,339,"6 de julio de 1997"
25,6,16,3405,115,101,216,"6 de julio de 1997"
25,6,16,3406,236,171,407,"6 de julio de 1997"
25,6,16,3407,111,71,182,"6 de julio de 1997"
25,6,16,3408,153,109,262,"6 de julio de 1997"
25,6,16,3409,371,302,673,"6 de julio de 1997"
25,6,16,3410,242,209,451,"6 de julio de 1997"
25,6,16,3411,171,132,303,"6 de julio de 1997"
25,6,16,3412,123,97,220,"6 de julio de 1997"
25,6,16,3413,206,179,385,"6 de julio de 1997"
25,6,16,3414,198,164,362,"6 de julio de 1997"
25,6,16,3415,178,136,314,"6 de julio de 1997"
25,6,16,3416,228,208,436,"6 de julio de 1997"
25,6,16,3417,109,78,187,"6 de julio de 1997"
25,6,16,3418,129,75,204,"6 de julio de 1997"
25,6,16,3419,136,102,238,"6 de julio de 1997"
25,7,6,773,150,176,326,"6 de julio de 1997"
25,7,6,774,364,399,763,"6 de julio de 1997"
25,7,6,775,223,258,481,"6 de julio de 1997"
25,7,6,776,226,265,491,"6 de julio de 1997"
25,7,6,782,158,197,355,"6 de julio de 1997"
25,7,6,783,128,156,284,"6 de julio de 1997"
25,7,6,784,157,205,362,"6 de julio de 1997"
25,7,6,785,157,159,316,"6 de julio de 1997"
25,7,6,786,217,260,477,"6 de julio de 1997"
25,7,6,787,130,144,274,"6 de julio de 1997"
25,7,6,788,176,221,397,"6 de julio de 1997"
25,7,6,789,148,173,321,"6 de julio de 1997"
25,7,6,790,126,151,277,"6 de julio de 1997"
25,7,6,791,235,285,520,"6 de julio de 1997"
25,7,6,792,240,288,528,"6 de julio de 1997"
25,7,6,793,286,369,655,"6 de julio de 1997"
25,7,6,794,217,243,460,"6 de julio de 1997"
25,7,6,795,169,216,385,"6 de julio de 1997"
25,7,6,796,239,291,530,"6 de julio de 1997"
25,7,6,797,160,170,330,"6 de julio de 1997"
25,7,6,798,144,175,319,"6 de julio de 1997"
25,7,6,799,203,236,439,"6 de julio de 1997"
25,7,6,800,154,173,327,"6 de julio de 1997"
25,7,6,801,306,342,648,"6 de julio de 1997"
25,7,6,802,218,261,479,"6 de julio de 1997"
25,7,6,803,129,164,293,"6 de julio de 1997"
25,7,6,804,117,145,262,"6 de julio de 1997"
25,7,6,805,215,284,499,"6 de julio de 1997"
25,7,6,806,213,265,478,"6 de julio de 1997"
25,7,6,807,193,189,382,"6 de julio de 1997"
25,7,6,808,75,109,184,"6 de julio de 1997"
25,7,6,809,60,68,128,"6 de julio de 1997"
25,7,6,810,182,219,401,"6 de julio de 1997"
25,7,6,811,73,82,155,"6 de julio de 1997"
25,7,6,812,92,110,202,"6 de julio de 1997"
25,7,6,813,237,187,424,"6 de julio de 1997"
25,7,6,814,89,100,189,"6 de julio de 1997"
25,7,6,815,96,92,188,"6 de julio de 1997"
25,7,6,816,75,109,184,"6 de julio de 1997"
25,7,6,817,142,154,296,"6 de julio de 1997"
25,7,6,818,152,199,351,"6 de julio de 1997"
25,7,6,819,187,214,401,"6 de julio de 1997"
25,7,6,820,197,208,405,"6 de julio de 1997"
25,7,6,821,133,157,290,"6 de julio de 1997"
25,7,6,822,146,197,343,"6 de julio de 1997"
25,7,6,823,182,225,407,"6 de julio de 1997"
25,7,6,824,221,253,474,"6 de julio de 1997"
25,7,6,825,200,209,409,"6 de julio de 1997"
25,7,6,826,233,307,540,"6 de julio de 1997"
25,7,6,827,251,228,479,"6 de julio de 1997"
25,7,6,828,193,189,382,"6 de julio de 1997"
25,7,6,829,207,247,454,"6 de julio de 1997"
25,7,6,830,182,211,393,"6 de julio de 1997"
25,7,6,831,114,154,268,"6 de julio de 1997"
25,7,6,832,204,263,467,"6 de julio de 1997"
25,7,6,833,167,199,366,"6 de julio de 1997"
25,7,6,834,166,226,392,"6 de julio de 1997"
25,7,6,835,271,302,573,"6 de julio de 1997"
25,7,6,836,164,214,378,"6 de julio de 1997"
25,7,6,837,135,161,296,"6 de julio de 1997"
25,7,6,838,149,165,314,"6 de julio de 1997"
25,7,6,839,129,153,282,"6 de julio de 1997"
25,7,6,840,264,280,544,"6 de julio de 1997"
25,7,6,841,175,205,380,"6 de julio de 1997"
25,7,6,842,166,198,364,"6 de julio de 1997"
25,7,6,843,149,186,335,"6 de julio de 1997"
25,7,6,844,184,222,406,"6 de julio de 1997"
25,7,6,845,268,310,578,"6 de julio de 1997"
25,7,6,846,201,248,449,"6 de julio de 1997"
25,7,6,847,131,147,278,"6 de julio de 1997"
25,7,6,848,164,178,342,"6 de julio de 1997"
25,7,6,849,140,158,298,"6 de julio de 1997"
25,7,6,850,218,259,477,"6 de julio de 1997"
25,7,6,851,179,190,369,"6 de julio de 1997"
25,7,6,852,139,137,276,"6 de julio de 1997"
25,7,6,853,137,172,309,"6 de julio de 1997"
25,7,6,854,106,86,192,"6 de julio de 1997"
25,7,6,855,64,73,137,"6 de julio de 1997"
25,7,6,856,90,123,213,"6 de julio de 1997"
25,7,6,857,98,104,202,"6 de julio de 1997"
25,7,6,858,121,137,258,"6 de julio de 1997"
25,7,6,859,221,248,469,"6 de julio de 1997"
25,7,6,860,220,257,477,"6 de julio de 1997"
25,7,6,861,85,92,177,"6 de julio de 1997"
25,7,6,862,128,143,271,"6 de julio de 1997"
25,7,6,863,155,166,321,"6 de julio de 1997"
25,7,6,864,120,145,265,"6 de julio de 1997"
25,7,6,865,151,185,336,"6 de julio de 1997"
25,7,6,866,180,200,380,"6 de julio de 1997"
25,7,6,867,171,209,380,"6 de julio de 1997"
25,7,6,868,143,164,307,"6 de julio de 1997"
25,7,6,870,129,149,278,"6 de julio de 1997"
25,7,6,871,120,139,259,"6 de julio de 1997"
25,7,6,872,177,221,398,"6 de julio de 1997"
25,7,6,873,261,336,597,"6 de julio de 1997"
25,7,6,874,133,156,289,"6 de julio de 1997"
25,7,6,875,183,202,385,"6 de julio de 1997"
25,7,6,876,78,101,179,"6 de julio de 1997"
25,7,6,877,122,137,259,"6 de julio de 1997"
25,7,6,878,116,128,244,"6 de julio de 1997"
25,7,6,879,102,128,230,"6 de julio de 1997"
25,7,6,880,120,142,262,"6 de julio de 1997"
25,7,6,881,189,205,394,"6 de julio de 1997"
25,7,6,882,90,97,187,"6 de julio de 1997"
25,7,6,883,93,131,224,"6 de julio de 1997"
25,7,6,885,456,511,967,"6 de julio de 1997"
25,7,6,886,231,283,514,"6 de julio de 1997"
25,7,6,1295,241,303,544,"6 de julio de 1997"
25,7,6,1296,217,295,512,"6 de julio de 1997"
25,7,6,1297,187,194,381,"6 de julio de 1997"
25,7,6,1298,196,250,446,"6 de julio de 1997"
25,7,6,1299,130,143,273,"6 de julio de 1997"
25,7,6,1300,226,276,502,"6 de julio de 1997"
25,7,6,1301,142,172,314,"6 de julio de 1997"
25,7,6,1302,175,195,370,"6 de julio de 1997"
25,7,6,1303,206,238,444,"6 de julio de 1997"
25,7,6,1304,127,177,304,"6 de julio de 1997"
25,7,6,1305,186,214,400,"6 de julio de 1997"
25,7,6,1306,221,209,430,"6 de julio de 1997"
25,7,6,1307,190,183,373,"6 de julio de 1997"
25,7,6,1308,168,180,348,"6 de julio de 1997"
25,7,6,1309,118,88,206,"6 de julio de 1997"
25,7,6,1310,234,255,489,"6 de julio de 1997"
25,7,6,1311,117,122,239,"6 de julio de 1997"
25,7,6,1312,204,231,435,"6 de julio de 1997"
25,7,6,1313,244,294,538,"6 de julio de 1997"
25,7,6,1314,153,182,335,"6 de julio de 1997"
25,7,6,1315,153,155,308,"6 de julio de 1997"
25,7,6,1316,214,241,455,"6 de julio de 1997"
25,7,6,1317,242,263,505,"6 de julio de 1997"
25,7,6,1318,232,276,508,"6 de julio de 1997"
25,7,6,1319,115,134,249,"6 de julio de 1997"
25,7,6,1320,157,190,347,"6 de julio de 1997"
25,7,6,1321,151,200,351,"6 de julio de 1997"
25,7,6,1322,399,472,871,"6 de julio de 1997"
25,7,6,1323,220,247,467,"6 de julio de 1997"
25,7,6,1324,287,325,612,"6 de julio de 1997"
25,7,6,1325,179,183,362,"6 de julio de 1997"
25,7,6,1326,163,195,358,"6 de julio de 1997"
25,7,6,1327,199,219,418,"6 de julio de 1997"
25,7,6,1328,205,210,415,"6 de julio de 1997"
25,7,6,1329,165,211,376,"6 de julio de 1997"
25,7,6,1330,94,94,188,"6 de julio de 1997"
25,7,6,1331,982,33,1015,"6 de julio de 1997"
25,7,6,1332,109,126,235,"6 de julio de 1997"
25,7,6,1333,354,398,752,"6 de julio de 1997"
25,7,6,1334,195,241,436,"6 de julio de 1997"
25,7,6,1335,289,317,606,"6 de julio de 1997"
25,7,6,1336,187,216,403,"6 de julio de 1997"
25,7,6,1337,181,173,354,"6 de julio de 1997"
25,7,6,1338,237,248,485,"6 de julio de 1997"
25,7,6,1339,143,177,320,"6 de julio de 1997"
25,7,6,1340,250,247,497,"6 de julio de 1997"
25,7,6,1341,195,222,417,"6 de julio de 1997"
25,7,6,1342,192,215,407,"6 de julio de 1997"
25,7,6,1343,275,295,570,"6 de julio de 1997"
25,7,6,1344,168,179,347,"6 de julio de 1997"
25,7,6,1345,175,158,333,"6 de julio de 1997"
25,7,6,1346,316,343,659,"6 de julio de 1997"
25,7,6,1347,174,181,355,"6 de julio de 1997"
25,7,6,1348,126,166,292,"6 de julio de 1997"
25,7,6,1349,151,184,335,"6 de julio de 1997"
25,7,6,1350,322,400,722,"6 de julio de 1997"
25,7,6,1351,249,295,544,"6 de julio de 1997"
25,7,6,1352,240,283,523,"6 de julio de 1997"
25,7,6,1353,225,236,461,"6 de julio de 1997"
25,7,6,1354,186,181,367,"6 de julio de 1997"
25,7,6,1355,257,280,537,"6 de julio de 1997"
25,7,6,1356,223,263,486,"6 de julio de 1997"
25,7,6,1357,300,325,625,"6 de julio de 1997"
25,7,6,1358,176,204,380,"6 de julio de 1997"
25,7,6,1359,200,210,410,"6 de julio de 1997"
25,7,6,1360,267,295,562,"6 de julio de 1997"
25,7,6,1361,164,204,368,"6 de julio de 1997"
25,7,6,1362,151,201,352,"6 de julio de 1997"
25,7,6,1363,178,196,374,"6 de julio de 1997"
25,7,6,1364,169,185,354,"6 de julio de 1997"
25,7,6,1365,167,205,372,"6 de julio de 1997"
25,7,6,1366,109,129,238,"6 de julio de 1997"
25,7,6,1367,174,207,381,"6 de julio de 1997"
25,7,6,1368,217,288,505,"6 de julio de 1997"
25,7,6,1369,181,182,363,"6 de julio de 1997"
25,7,6,1370,167,182,349,"6 de julio de 1997"
25,7,6,1371,238,311,549,"6 de julio de 1997"
25,7,6,1372,216,231,447,"6 de julio de 1997"
25,7,6,1373,189,216,405,"6 de julio de 1997"
25,7,6,1374,164,210,374,"6 de julio de 1997"
25,7,6,1375,186,221,407,"6 de julio de 1997"
25,7,6,1376,285,304,589,"6 de julio de 1997"
25,7,6,1377,314,375,689,"6 de julio de 1997"
25,7,6,1378,186,184,370,"6 de julio de 1997"
25,7,6,1379,244,251,495,"6 de julio de 1997"
25,7,6,1380,229,262,491,"6 de julio de 1997"
25,7,6,1381,95,104,199,"6 de julio de 1997"
25,7,6,1382,202,226,428,"6 de julio de 1997"
25,7,6,1383,201,234,435,"6 de julio de 1997"
25,7,6,1384,201,199,400,"6 de julio de 1997"
25,7,6,1385,131,151,282,"6 de julio de 1997"
25,7,6,1386,138,163,301,"6 de julio de 1997"
25,7,6,1387,194,200,394,"6 de julio de 1997"
25,7,6,1388,156,163,319,"6 de julio de 1997"
25,7,6,1389,213,241,454,"6 de julio de 1997"
25,7,6,1390,233,247,480,"6 de julio de 1997"
25,7,6,1391,227,271,498,"6 de julio de 1997"
25,7,6,1392,326,335,661,"6 de julio de 1997"
25,7,6,1393,230,262,492,"6 de julio de 1997"
25,7,6,1394,249,284,533,"6 de julio de 1997"
25,7,6,1395,177,197,374,"6 de julio de 1997"
25,7,6,1396,196,235,431,"6 de julio de 1997"
25,7,6,1397,134,152,286,"6 de julio de 1997"
25,7,6,1398,181,227,408,"6 de julio de 1997"
25,7,6,1399,144,170,314,"6 de julio de 1997"
25,7,6,1400,119,136,255,"6 de julio de 1997"
25,7,6,1401,127,156,283,"6 de julio de 1997"
25,7,6,1402,154,175,329,"6 de julio de 1997"
25,7,6,1403,204,218,422,"6 de julio de 1997"
25,7,6,1404,173,188,361,"6 de julio de 1997"
25,7,6,1405,308,328,636,"6 de julio de 1997"
25,7,6,1406,176,183,359,"6 de julio de 1997"
25,7,6,1407,210,230,440,"6 de julio de 1997"
25,7,6,1408,252,268,520,"6 de julio de 1997"
25,7,6,1409,162,208,370,"6 de julio de 1997"
25,7,6,1410,96,119,215,"6 de julio de 1997"
25,7,6,1411,277,337,614,"6 de julio de 1997"
25,7,6,1412,132,170,302,"6 de julio de 1997"
25,7,6,1413,156,187,343,"6 de julio de 1997"
25,7,6,1414,133,141,274,"6 de julio de 1997"
25,7,6,1415,173,180,353,"6 de julio de 1997"
25,7,6,1416,223,253,476,"6 de julio de 1997"
25,7,6,1417,242,269,511,"6 de julio de 1997"
25,7,6,1418,153,157,310,"6 de julio de 1997"
25,7,6,1419,235,244,479,"6 de julio de 1997"
25,7,6,1420,264,295,559,"6 de julio de 1997"
25,7,6,1421,289,323,612,"6 de julio de 1997"
25,7,6,1422,179,197,376,"6 de julio de 1997"
25,7,6,1423,163,206,369,"6 de julio de 1997"
25,7,6,1424,156,207,363,"6 de julio de 1997"
25,7,6,1425,160,199,359,"6 de julio de 1997"
25,7,6,1426,182,203,385,"6 de julio de 1997"
25,7,6,1427,209,211,420,"6 de julio de 1997"
25,7,6,1428,162,203,365,"6 de julio de 1997"
25,7,6,1429,232,238,470,"6 de julio de 1997"
25,7,6,1430,196,210,406,"6 de julio de 1997"
25,7,6,1431,197,239,436,"6 de julio de 1997"
25,7,6,1432,172,189,361,"6 de julio de 1997"
25,7,6,1433,163,182,345,"6 de julio de 1997"
25,7,6,1434,192,193,385,"6 de julio de 1997"
25,7,6,1435,251,310,561,"6 de julio de 1997"
25,7,6,1436,297,335,632,"6 de julio de 1997"
25,7,6,1437,87,100,187,"6 de julio de 1997"
25,7,6,1438,154,163,317,"6 de julio de 1997"
25,7,6,1439,202,215,417,"6 de julio de 1997"
25,7,6,1440,205,231,436,"6 de julio de 1997"
25,7,6,1441,181,176,357,"6 de julio de 1997"
25,7,6,1442,200,200,400,"6 de julio de 1997"
25,7,6,1443,112,111,223,"6 de julio de 1997"
25,7,6,1444,97,94,191,"6 de julio de 1997"
25,7,6,1445,110,132,242,"6 de julio de 1997"
25,7,6,1446,117,131,248,"6 de julio de 1997"
25,7,6,1447,177,187,364,"6 de julio de 1997"
25,7,6,1448,186,229,415,"6 de julio de 1997"
25,7,6,1449,221,242,463,"6 de julio de 1997"
25,7,6,1450,181,213,394,"6 de julio de 1997"
25,7,6,1451,110,136,246,"6 de julio de 1997"
25,7,6,1452,127,140,267,"6 de julio de 1997"
25,7,6,1453,195,215,410,"6 de julio de 1997"
25,7,6,1454,189,194,383,"6 de julio de 1997"
25,7,6,1455,121,140,261,"6 de julio de 1997"
25,7,6,1456,146,159,305,"6 de julio de 1997"
25,7,6,1457,173,195,368,"6 de julio de 1997"
25,7,6,1458,269,277,546,"6 de julio de 1997"
25,7,6,1459,208,232,440,"6 de julio de 1997"
25,7,6,1460,179,187,366,"6 de julio de 1997"
25,7,6,1461,172,197,369,"6 de julio de 1997"
25,7,6,1462,239,241,480,"6 de julio de 1997"
25,7,6,1463,169,195,364,"6 de julio de 1997"
25,7,6,1464,222,228,450,"6 de julio de 1997"
25,7,6,1465,177,187,364,"6 de julio de 1997"
25,7,6,1466,247,303,550,"6 de julio de 1997"
25,7,6,1467,189,201,390,"6 de julio de 1997"
25,7,6,1468,172,211,383,"6 de julio de 1997"
25,7,6,1469,218,266,484,"6 de julio de 1997"
25,7,6,1470,201,224,425,"6 de julio de 1997"
25,7,6,1471,228,247,475,"6 de julio de 1997"
25,7,6,1472,225,253,478,"6 de julio de 1997"
25,7,6,1473,200,252,452,"6 de julio de 1997"
25,7,6,1474,139,159,298,"6 de julio de 1997"
25,7,6,1475,163,204,367,"6 de julio de 1997"
25,7,6,1476,144,186,330,"6 de julio de 1997"
25,7,6,1477,310,380,690,"6 de julio de 1997"
25,7,6,1478,340,394,734,"6 de julio de 1997"
25,7,6,1479,204,240,444,"6 de julio de 1997"
25,7,6,1480,173,207,380,"6 de julio de 1997"
25,7,6,1481,164,169,333,"6 de julio de 1997"
25,7,6,1482,172,223,395,"6 de julio de 1997"
25,7,6,1483,170,203,373,"6 de julio de 1997"
25,7,6,1484,240,268,508,"6 de julio de 1997"
25,7,6,1485,170,190,360,"6 de julio de 1997"
25,7,6,1486,151,146,297,"6 de julio de 1997"
25,7,6,1507,350,313,663,"6 de julio de 1997"
25,7,6,1508,379,351,730,"6 de julio de 1997"
25,7,6,1509,430,411,841,"6 de julio de 1997"
25,7,6,1510,214,213,427,"6 de julio de 1997"
25,7,6,1511,379,361,740,"6 de julio de 1997"
25,7,6,1512,95,92,187,"6 de julio de 1997"
25,7,6,1513,97,79,176,"6 de julio de 1997"
25,7,6,1515,47,26,73,"6 de julio de 1997"
25,7,6,1516,186,132,318,"6 de julio de 1997"
25,7,6,1517,66,58,124,"6 de julio de 1997"
25,7,6,1518,128,110,238,"6 de julio de 1997"
25,7,6,1519,43,49,92,"6 de julio de 1997"
25,7,6,1520,95,90,185,"6 de julio de 1997"
25,7,6,1521,242,258,500,"6 de julio de 1997"
25,7,6,1522,72,65,137,"6 de julio de 1997"
25,7,6,1523,52,36,88,"6 de julio de 1997"
25,7,6,1524,61,41,102,"6 de julio de 1997"
25,7,6,1525,62,46,108,"6 de julio de 1997"
25,7,6,1526,87,58,145,"6 de julio de 1997"
25,7,6,1527,113,84,197,"6 de julio de 1997"
25,7,6,1528,177,131,308,"6 de julio de 1997"
25,7,6,1529,33,23,56,"6 de julio de 1997"
25,7,6,1530,38,52,90,"6 de julio de 1997"
25,7,6,1531,69,47,116,"6 de julio de 1997"
25,7,6,1532,120,117,237,"6 de julio de 1997"
25,7,6,1533,118,121,239,"6 de julio de 1997"
25,7,6,1534,189,168,357,"6 de julio de 1997"
25,7,6,1535,175,169,344,"6 de julio de 1997"
25,7,6,1536,38,29,67,"6 de julio de 1997"
25,7,6,1537,129,98,227,"6 de julio de 1997"
25,7,6,1538,75,63,138,"6 de julio de 1997"
25,7,6,1539,48,40,88,"6 de julio de 1997"
25,7,6,1540,165,145,310,"6 de julio de 1997"
25,7,6,1541,115,115,230,"6 de julio de 1997"
25,7,6,1542,85,78,163,"6 de julio de 1997"
25,7,6,1543,146,123,269,"6 de julio de 1997"
25,7,6,1544,210,192,402,"6 de julio de 1997"
25,7,6,1545,158,92,250,"6 de julio de 1997"
25,7,6,1546,82,55,137,"6 de julio de 1997"
25,7,6,1547,124,111,235,"6 de julio de 1997"
25,7,6,1548,200,189,389,"6 de julio de 1997"
25,7,6,1549,129,116,245,"6 de julio de 1997"
25,7,6,1550,168,143,311,"6 de julio de 1997"
25,7,6,1551,128,117,245,"6 de julio de 1997"
25,7,6,1552,176,141,317,"6 de julio de 1997"
25,7,6,1553,229,218,447,"6 de julio de 1997"
25,7,6,1554,146,135,281,"6 de julio de 1997"
25,7,6,1555,255,269,524,"6 de julio de 1997"
25,7,6,1556,311,335,646,"6 de julio de 1997"
25,7,6,1557,344,336,680,"6 de julio de 1997"
25,7,6,1558,259,263,522,"6 de julio de 1997"
25,7,6,1559,170,182,352,"6 de julio de 1997"
25,7,6,1560,142,155,297,"6 de julio de 1997"
25,7,6,1561,170,157,327,"6 de julio de 1997"
25,7,6,1562,169,163,332,"6 de julio de 1997"
25,7,6,1563,253,261,514,"6 de julio de 1997"
25,7,6,1564,155,149,304,"6 de julio de 1997"
25,7,6,1565,87,101,188,"6 de julio de 1997"
25,7,6,1566,154,167,321,"6 de julio de 1997"
25,7,6,1567,94,85,179,"6 de julio de 1997"
25,7,6,1568,192,183,375,"6 de julio de 1997"
25,7,6,1569,88,105,193,"6 de julio de 1997"
25,7,6,1570,268,253,521,"6 de julio de 1997"
25,7,6,1571,134,141,275,"6 de julio de 1997"
25,7,6,1572,70,67,137,"6 de julio de 1997"
25,7,6,1573,76,87,163,"6 de julio de 1997"
25,7,6,1574,311,260,571,"6 de julio de 1997"
25,7,6,1575,235,247,482,"6 de julio de 1997"
25,7,6,1576,242,241,483,"6 de julio de 1997"
25,7,6,1577,234,194,428,"6 de julio de 1997"
25,7,6,1578,118,132,250,"6 de julio de 1997"
25,7,6,1579,135,159,294,"6 de julio de 1997"
25,7,6,1580,327,323,650,"6 de julio de 1997"
25,7,6,1581,105,99,204,"6 de julio de 1997"
25,7,6,1582,271,250,521,"6 de julio de 1997"
25,7,6,1583,244,265,509,"6 de julio de 1997"
25,7,6,1584,124,126,250,"6 de julio de 1997"
25,7,6,1585,149,156,305,"6 de julio de 1997"
25,7,6,1586,168,163,331,"6 de julio de 1997"
25,7,6,1587,126,96,222,"6 de julio de 1997"
25,7,6,1588,119,103,222,"6 de julio de 1997"
25,7,6,1589,119,108,227,"6 de julio de 1997"
25,7,6,1590,211,158,369,"6 de julio de 1997"
25,7,6,1591,267,253,520,"6 de julio de 1997"
25,7,6,1592,157,157,314,"6 de julio de 1997"
25,7,6,1593,109,86,195,"6 de julio de 1997"
25,7,6,1594,83,46,129,"6 de julio de 1997"
25,7,6,1595,79,58,137,"6 de julio de 1997"
25,7,6,1596,279,255,534,"6 de julio de 1997"
25,7,6,1597,340,331,671,"6 de julio de 1997"
25,7,6,1598,214,242,456,"6 de julio de 1997"
25,7,6,1599,90,89,179,"6 de julio de 1997"
25,7,6,1600,66,48,114,"6 de julio de 1997"
25,7,6,1601,28,13,41,"6 de julio de 1997"
25,7,6,1602,57,27,84,"6 de julio de 1997"
25,7,6,1603,195,136,331,"6 de julio de 1997"
25,7,6,1604,129,93,222,"6 de julio de 1997"
25,7,6,1605,167,158,325,"6 de julio de 1997"
25,7,6,1606,140,111,251,"6 de julio de 1997"
25,7,6,1607,172,146,318,"6 de julio de 1997"
25,7,6,1608,112,98,210,"6 de julio de 1997"
25,7,6,1609,187,158,345,"6 de julio de 1997"
25,7,6,1610,97,102,199,"6 de julio de 1997"
25,7,6,1611,93,68,161,"6 de julio de 1997"
25,7,6,1612,130,117,247,"6 de julio de 1997"
25,7,6,1613,136,120,256,"6 de julio de 1997"
25,7,6,1614,260,218,478,"6 de julio de 1997"
25,7,6,1615,183,210,393,"6 de julio de 1997"
25,7,6,1616,172,161,333,"6 de julio de 1997"
25,7,6,1617,169,143,312,"6 de julio de 1997"
25,7,6,1618,96,88,184,"6 de julio de 1997"
25,7,6,1619,243,213,456,"6 de julio de 1997"
25,7,6,1620,212,205,417,"6 de julio de 1997"
25,7,6,1621,299,302,601,"6 de julio de 1997"
25,7,6,1622,180,176,356,"6 de julio de 1997"
25,7,6,1623,201,217,418,"6 de julio de 1997"
25,7,6,1624,148,134,282,"6 de julio de 1997"
25,7,6,1625,250,237,487,"6 de julio de 1997"
25,7,6,1626,198,162,360,"6 de julio de 1997"
25,7,6,1627,130,125,255,"6 de julio de 1997"
25,7,6,1628,118,95,213,"6 de julio de 1997"
25,7,6,1629,172,135,307,"6 de julio de 1997"
25,7,6,1630,219,189,408,"6 de julio de 1997"
25,7,6,1631,228,180,408,"6 de julio de 1997"
25,7,6,1632,131,121,252,"6 de julio de 1997"
25,7,6,1633,228,193,421,"6 de julio de 1997"
25,7,6,1634,105,97,202,"6 de julio de 1997"
25,7,6,1635,267,279,546,"6 de julio de 1997"
25,7,6,1636,317,284,601,"6 de julio de 1997"
25,7,6,1637,177,154,331,"6 de julio de 1997"
25,7,6,1638,275,255,530,"6 de julio de 1997"
25,7,6,1639,108,99,207,"6 de julio de 1997"
25,7,6,1640,200,194,394,"6 de julio de 1997"
25,7,6,1641,207,208,415,"6 de julio de 1997"
25,7,6,1642,184,150,334,"6 de julio de 1997"
25,7,6,1643,116,108,224,"6 de julio de 1997"
25,7,6,1644,124,134,258,"6 de julio de 1997"
25,7,6,1645,286,271,557,"6 de julio de 1997"
25,7,6,1646,331,323,654,"6 de julio de 1997"
25,7,6,1647,72,80,152,"6 de julio de 1997"
25,7,6,1648,201,171,372,"6 de julio de 1997"
25,7,6,1649,221,207,428,"6 de julio de 1997"
25,7,6,1650,244,235,479,"6 de julio de 1997"
25,7,6,1651,93,69,162,"6 de julio de 1997"
25,7,6,1652,290,293,583,"6 de julio de 1997"
25,7,6,1653,178,170,348,"6 de julio de 1997"
25,7,6,1654,352,347,699,"6 de julio de 1997"
25,7,6,1655,211,200,411,"6 de julio de 1997"
25,7,6,1656,128,107,235,"6 de julio de 1997"
25,7,6,1657,200,180,380,"6 de julio de 1997"
25,7,6,1658,216,195,411,"6 de julio de 1997"
25,7,6,1659,143,149,292,"6 de julio de 1997"
25,7,6,1660,172,140,312,"6 de julio de 1997"
25,7,6,1661,278,250,528,"6 de julio de 1997"
25,7,6,1662,247,230,477,"6 de julio de 1997"
25,7,6,1663,296,307,603,"6 de julio de 1997"
25,7,6,1664,160,135,295,"6 de julio de 1997"
25,7,6,1665,67,87,154,"6 de julio de 1997"
25,7,6,1666,245,220,465,"6 de julio de 1997"
25,7,6,1667,94,91,185,"6 de julio de 1997"
25,7,6,1668,226,202,428,"6 de julio de 1997"
25,7,6,1669,252,239,491,"6 de julio de 1997"
25,7,6,1670,79,82,161,"6 de julio de 1997"
25,7,6,1671,219,210,429,"6 de julio de 1997"
25,7,6,1672,239,257,496,"6 de julio de 1997"
25,7,6,1673,174,179,353,"6 de julio de 1997"
25,7,6,1674,169,190,359,"6 de julio de 1997"
25,7,6,1675,214,206,420,"6 de julio de 1997"
25,7,6,1676,194,191,385,"6 de julio de 1997"
25,7,6,1677,131,139,270,"6 de julio de 1997"
25,7,6,1678,135,126,261,"6 de julio de 1997"
25,7,6,1679,259,242,501,"6 de julio de 1997"
25,7,6,1680,123,123,246,"6 de julio de 1997"
25,7,6,1681,121,117,238,"6 de julio de 1997"
25,7,6,1682,148,116,264,"6 de julio de 1997"
25,7,6,1683,262,281,543,"6 de julio de 1997"
25,7,6,1684,193,176,369,"6 de julio de 1997"
25,7,6,1685,142,154,296,"6 de julio de 1997"
25,7,6,1686,164,198,362,"6 de julio de 1997"
25,7,6,1687,200,218,418,"6 de julio de 1997"
25,7,6,1688,136,131,267,"6 de julio de 1997"
25,7,6,1689,153,160,313,"6 de julio de 1997"
25,7,6,1690,227,223,450,"6 de julio de 1997"
25,7,6,1691,188,205,393,"6 de julio de 1997"
25,7,6,1692,175,148,323,"6 de julio de 1997"
25,7,6,1693,210,190,400,"6 de julio de 1997"
25,7,6,1694,93,93,186,"6 de julio de 1997"
25,7,6,1695,194,170,364,"6 de julio de 1997"
25,7,6,1696,209,210,419,"6 de julio de 1997"
25,7,6,1697,292,266,558,"6 de julio de 1997"
25,7,6,1698,210,210,420,"6 de julio de 1997"
25,7,6,1699,148,165,313,"6 de julio de 1997"
25,7,6,1700,159,176,335,"6 de julio de 1997"
25,7,6,1701,80,91,171,"6 de julio de 1997"
25,7,6,1702,108,95,203,"6 de julio de 1997"
25,7,6,1703,321,284,605,"6 de julio de 1997"
25,7,6,1704,413,374,787,"6 de julio de 1997"
25,7,6,1705,41,35,76,"6 de julio de 1997"
25,7,6,1706,227,182,409,"6 de julio de 1997"
25,7,6,1707,194,167,361,"6 de julio de 1997"
25,7,6,1708,241,204,445,"6 de julio de 1997"
25,7,6,1709,215,180,395,"6 de julio de 1997"
25,7,6,1710,180,173,353,"6 de julio de 1997"
25,7,6,1711,263,222,485,"6 de julio de 1997"
25,7,6,1712,184,169,353,"6 de julio de 1997"
25,7,6,1713,331,278,609,"6 de julio de 1997"
25,7,6,1714,214,168,382,"6 de julio de 1997"
25,7,6,1715,439,380,819,"6 de julio de 1997"
25,7,6,1716,66,50,116,"6 de julio de 1997"
25,7,6,1717,50,43,93,"6 de julio de 1997"
25,7,6,1718,79,60,139,"6 de julio de 1997"
25,7,6,1719,428,307,735,"6 de julio de 1997"
25,7,6,1720,199,149,348,"6 de julio de 1997"
25,7,6,1721,383,346,729,"6 de julio de 1997"
25,7,6,1722,50,33,83,"6 de julio de 1997"
25,7,6,1723,48,39,87,"6 de julio de 1997"
25,7,6,1724,251,196,447,"6 de julio de 1997"
25,7,6,1725,260,206,466,"6 de julio de 1997"
25,8,12,2540,136,147,283,"6 de julio de 1997"
25,8,12,2541,169,226,395,"6 de julio de 1997"
25,8,12,2542,161,172,333,"6 de julio de 1997"
25,8,12,2543,229,244,473,"6 de julio de 1997"
25,8,12,2544,212,216,428,"6 de julio de 1997"
25,8,12,2545,240,251,491,"6 de julio de 1997"
25,8,12,2546,790,260,1050,"6 de julio de 1997"
25,8,12,2547,148,163,311,"6 de julio de 1997"
25,8,12,2548,240,242,482,"6 de julio de 1997"
25,8,12,2549,151,158,309,"6 de julio de 1997"
25,8,12,2550,185,228,413,"6 de julio de 1997"
25,8,12,2551,215,277,492,"6 de julio de 1997"
25,8,12,2552,158,184,342,"6 de julio de 1997"
25,8,12,2553,98,120,218,"6 de julio de 1997"
25,8,12,2554,207,257,464,"6 de julio de 1997"
25,8,12,2555,182,210,392,"6 de julio de 1997"
25,8,12,2556,254,279,533,"6 de julio de 1997"
25,8,12,2557,139,152,291,"6 de julio de 1997"
25,8,12,2558,139,153,292,"6 de julio de 1997"
25,8,12,2559,173,184,357,"6 de julio de 1997"
25,8,12,2560,347,307,654,"6 de julio de 1997"
25,8,12,2561,116,136,252,"6 de julio de 1997"
25,8,12,2562,258,264,522,"6 de julio de 1997"
25,8,12,2563,212,264,476,"6 de julio de 1997"
25,8,12,2564,245,293,538,"6 de julio de 1997"
25,8,12,2565,158,169,327,"6 de julio de 1997"
25,8,12,2566,59,87,146,"6 de julio de 1997"
25,8,12,2567,201,236,437,"6 de julio de 1997"
25,8,12,2568,104,148,252,"6 de julio de 1997"
25,8,12,2569,156,175,331,"6 de julio de 1997"
25,8,12,2570,153,173,326,"6 de julio de 1997"
25,8,12,2571,257,257,514,"6 de julio de 1997"
25,8,12,2572,132,130,262,"6 de julio de 1997"
25,8,12,2573,157,174,331,"6 de julio de 1997"
25,8,12,2574,105,146,251,"6 de julio de 1997"
25,8,12,2575,93,117,210,"6 de julio de 1997"
25,8,12,2576,258,210,468,"6 de julio de 1997"
25,8,12,2577,144,168,312,"6 de julio de 1997"
25,8,12,2578,85,108,193,"6 de julio de 1997"
25,8,12,2579,101,128,229,"6 de julio de 1997"
25,8,12,2580,128,108,236,"6 de julio de 1997"
25,8,12,2581,83,94,177,"6 de julio de 1997"
25,8,12,2582,136,199,335,"6 de julio de 1997"
25,8,12,2583,179,227,406,"6 de julio de 1997"
25,8,12,2584,91,155,246,"6 de julio de 1997"
25,8,12,2585,138,167,305,"6 de julio de 1997"
25,8,12,2586,171,210,381,"6 de julio de 1997"
25,8,12,2587,230,244,474,"6 de julio de 1997"
25,8,12,2588,169,216,385,"6 de julio de 1997"
25,8,12,2589,148,161,309,"6 de julio de 1997"
25,8,12,2590,218,218,436,"6 de julio de 1997"
25,8,12,2591,233,221,454,"6 de julio de 1997"
25,8,12,2592,161,168,329,"6 de julio de 1997"
25,8,12,2593,181,177,358,"6 de julio de 1997"
25,8,12,2594,258,275,533,"6 de julio de 1997"
25,8,12,2595,199,236,435,"6 de julio de 1997"
25,8,12,2596,308,308,616,"6 de julio de 1997"
25,8,12,2597,246,280,526,"6 de julio de 1997"
25,8,12,2598,107,123,230,"6 de julio de 1997"
25,8,12,2599,111,130,241,"6 de julio de 1997"
25,8,12,2600,157,144,301,"6 de julio de 1997"
25,8,12,2601,184,181,365,"6 de julio de 1997"
25,8,12,2602,206,226,432,"6 de julio de 1997"
25,8,12,2603,178,166,344,"6 de julio de 1997"
25,8,12,2604,116,116,232,"6 de julio de 1997"
25,8,12,2605,208,230,438,"6 de julio de 1997"
25,8,12,2606,227,199,426,"6 de julio de 1997"
25,8,12,2607,221,240,461,"6 de julio de 1997"
25,8,12,2608,260,232,492,"6 de julio de 1997"
25,8,12,2609,193,182,375,"6 de julio de 1997"
25,8,12,2610,361,345,706,"6 de julio de 1997"
25,8,12,2611,324,336,660,"6 de julio de 1997"
25,8,12,2614,295,298,593,"6 de julio de 1997"
25,8,12,2615,143,153,296,"6 de julio de 1997"
25,8,12,2668,154,178,332,"6 de julio de 1997"
25,8,12,2669,121,122,243,"6 de julio de 1997"
25,8,12,2670,194,227,421,"6 de julio de 1997"
25,8,12,2671,134,156,290,"6 de julio de 1997"
25,8,12,2673,286,296,582,"6 de julio de 1997"
25,8,12,2674,338,379,717,"6 de julio de 1997"
25,8,12,2675,257,266,523,"6 de julio de 1997"
25,8,12,2676,336,365,701,"6 de julio de 1997"
25,8,12,2677,202,207,409,"6 de julio de 1997"
25,8,12,2678,217,228,445,"6 de julio de 1997"
25,8,12,2679,191,185,376,"6 de julio de 1997"
25,8,12,2680,208,239,447,"6 de julio de 1997"
25,8,12,2681,144,164,308,"6 de julio de 1997"
25,8,12,2682,219,254,473,"6 de julio de 1997"
25,8,12,2683,327,393,720,"6 de julio de 1997"
25,8,12,2684,510,591,1101,"6 de julio de 1997"
25,8,12,2685,695,795,1490,"6 de julio de 1997"
25,8,12,2686,437,427,864,"6 de julio de 1997"
25,8,12,2687,321,315,636,"6 de julio de 1997"
25,8,12,2688,490,474,964,"6 de julio de 1997"
25,8,12,2689,352,359,711,"6 de julio de 1997"
25,8,12,2690,160,177,337,"6 de julio de 1997"
25,8,12,2691,346,408,754,"6 de julio de 1997"
25,8,12,2692,179,194,373,"6 de julio de 1997"
25,8,12,2693,188,243,431,"6 de julio de 1997"
25,8,12,2694,743,922,1665,"6 de julio de 1997"
25,8,12,2695,467,506,973,"6 de julio de 1997"
25,8,12,2696,335,360,695,"6 de julio de 1997"
25,8,12,2697,162,180,342,"6 de julio de 1997"
25,8,12,2698,877,1070,1947,"6 de julio de 1997"
25,8,12,2699,184,205,389,"6 de julio de 1997"
25,8,12,2700,277,318,595,"6 de julio de 1997"
25,8,12,2701,195,234,429,"6 de julio de 1997"
25,8,12,2702,355,381,736,"6 de julio de 1997"
25,8,12,2703,313,334,647,"6 de julio de 1997"
25,8,12,2704,303,318,621,"6 de julio de 1997"
25,8,12,2705,212,226,438,"6 de julio de 1997"
25,8,12,2706,248,297,545,"6 de julio de 1997"
25,8,12,2707,267,312,579,"6 de julio de 1997"
25,8,12,2708,488,586,1074,"6 de julio de 1997"
25,8,12,2709,155,184,339,"6 de julio de 1997"
25,8,12,2710,283,338,621,"6 de julio de 1997"
25,8,12,2711,158,178,336,"6 de julio de 1997"
25,8,12,2712,92,106,198,"6 de julio de 1997"
25,8,12,2713,72,74,146,"6 de julio de 1997"
25,8,12,2714,189,234,423,"6 de julio de 1997"
25,8,12,2715,416,451,867,"6 de julio de 1997"
25,8,12,2716,289,315,604,"6 de julio de 1997"
25,8,12,2717,311,357,668,"6 de julio de 1997"
25,8,12,2718,237,279,516,"6 de julio de 1997"
25,8,12,2719,202,225,427,"6 de julio de 1997"
25,8,12,2720,328,319,647,"6 de julio de 1997"
25,8,12,2721,366,383,749,"6 de julio de 1997"
25,8,12,2722,356,404,760,"6 de julio de 1997"
25,8,12,2723,191,221,412,"6 de julio de 1997"
25,8,12,2724,236,222,458,"6 de julio de 1997"
25,8,12,2725,254,260,514,"6 de julio de 1997"
25,8,12,2726,150,154,304,"6 de julio de 1997"
25,8,12,2727,167,197,364,"6 de julio de 1997"
25,8,12,2728,136,167,303,"6 de julio de 1997"
25,8,12,2729,223,244,467,"6 de julio de 1997"
25,8,12,2730,332,382,714,"6 de julio de 1997"
25,8,12,2731,196,221,417,"6 de julio de 1997"
25,8,12,2732,187,231,418,"6 de julio de 1997"
25,8,12,2733,165,182,347,"6 de julio de 1997"
25,8,12,2734,213,211,424,"6 de julio de 1997"
25,8,12,2735,240,261,501,"6 de julio de 1997"
25,8,12,2736,270,283,553,"6 de julio de 1997"
25,8,12,2737,754,778,1532,"6 de julio de 1997"
25,8,12,2738,323,343,666,"6 de julio de 1997"
25,8,12,2739,196,199,395,"6 de julio de 1997"
25,8,12,2740,268,311,579,"6 de julio de 1997"
25,8,12,2741,246,232,478,"6 de julio de 1997"
25,8,12,2742,337,339,676,"6 de julio de 1997"
25,8,12,2743,382,383,765,"6 de julio de 1997"
25,8,12,2744,227,227,454,"6 de julio de 1997"
25,8,12,2745,332,421,753,"6 de julio de 1997"
25,8,12,2746,196,212,408,"6 de julio de 1997"
25,8,12,2747,54,62,116,"6 de julio de 1997"
25,8,12,2748,76,100,176,"6 de julio de 1997"
25,8,12,2749,228,285,513,"6 de julio de 1997"
25,8,12,2750,130,144,274,"6 de julio de 1997"
25,8,12,2751,298,325,623,"6 de julio de 1997"
25,8,12,2752,276,255,531,"6 de julio de 1997"
25,8,12,2753,244,278,522,"6 de julio de 1997"
25,8,12,2754,282,322,604,"6 de julio de 1997"
25,8,12,2755,289,309,598,"6 de julio de 1997"
25,8,12,2756,139,140,279,"6 de julio de 1997"
25,8,12,2757,143,164,307,"6 de julio de 1997"
25,8,12,2758,132,166,298,"6 de julio de 1997"
25,8,12,2759,171,188,359,"6 de julio de 1997"
25,8,12,2760,159,198,357,"6 de julio de 1997"
25,8,12,2761,205,227,432,"6 de julio de 1997"
25,8,12,2762,296,319,615,"6 de julio de 1997"
25,8,12,2763,278,314,592,"6 de julio de 1997"
25,8,12,2764,100,133,233,"6 de julio de 1997"
25,8,12,2765,226,259,485,"6 de julio de 1997"
25,8,12,2766,160,184,344,"6 de julio de 1997"
25,8,12,2767,194,220,414,"6 de julio de 1997"
25,8,12,2768,192,227,419,"6 de julio de 1997"
25,8,12,2769,303,320,623,"6 de julio de 1997"
25,8,12,2770,320,355,675,"6 de julio de 1997"
25,8,12,2771,235,234,469,"6 de julio de 1997"
25,8,12,2772,155,202,357,"6 de julio de 1997"
25,8,12,2773,201,225,426,"6 de julio de 1997"
25,8,12,2774,300,361,661,"6 de julio de 1997"
25,8,12,2775,290,329,619,"6 de julio de 1997"
25,8,12,2776,200,224,424,"6 de julio de 1997"
25,8,12,2777,243,295,538,"6 de julio de 1997"
25,8,12,2778,158,177,335,"6 de julio de 1997"
25,8,12,2779,157,187,344,"6 de julio de 1997"
25,8,12,2780,213,272,485,"6 de julio de 1997"
25,8,12,2781,267,326,593,"6 de julio de 1997"
25,8,12,2782,199,275,474,"6 de julio de 1997"
25,8,12,2783,336,363,699,"6 de julio de 1997"
25,8,12,2784,309,335,644,"6 de julio de 1997"
25,8,12,2785,224,266,490,"6 de julio de 1997"
25,8,12,2786,232,269,501,"6 de julio de 1997"
25,8,12,2787,178,227,405,"6 de julio de 1997"
25,8,12,2788,231,319,550,"6 de julio de 1997"
25,8,12,2789,261,299,560,"6 de julio de 1997"
25,8,12,2790,236,255,491,"6 de julio de 1997"
25,8,12,2791,360,402,762,"6 de julio de 1997"
25,8,12,2792,169,202,371,"6 de julio de 1997"
25,8,12,2793,184,180,364,"6 de julio de 1997"
25,8,12,2794,156,172,328,"6 de julio de 1997"
25,8,12,2795,182,187,369,"6 de julio de 1997"
25,8,12,2796,294,335,629,"6 de julio de 1997"
25,8,12,2797,233,277,510,"6 de julio de 1997"
25,8,12,2798,289,296,585,"6 de julio de 1997"
25,8,12,2799,364,391,755,"6 de julio de 1997"
25,8,12,2800,312,354,666,"6 de julio de 1997"
25,8,12,2801,231,249,480,"6 de julio de 1997"
25,8,12,2802,122,124,246,"6 de julio de 1997"
25,8,12,2803,73,83,156,"6 de julio de 1997"
25,8,12,2809,448,457,905,"6 de julio de 1997"
25,8,12,2810,223,268,491,"6 de julio de 1997"
25,8,12,2811,128,152,280,"6 de julio de 1997"
25,8,12,2812,209,218,427,"6 de julio de 1997"
25,8,12,2813,282,326,608,"6 de julio de 1997"
25,8,12,2814,314,330,644,"6 de julio de 1997"
25,8,12,2815,287,298,585,"6 de julio de 1997"
25,8,12,2816,364,378,742,"6 de julio de 1997"
25,8,12,2817,192,185,377,"6 de julio de 1997"
25,8,12,2818,248,290,538,"6 de julio de 1997"
25,8,12,2819,131,164,295,"6 de julio de 1997"
25,8,12,2820,251,250,501,"6 de julio de 1997"
25,8,12,2821,234,264,498,"6 de julio de 1997"
25,8,12,2822,278,329,607,"6 de julio de 1997"
25,8,12,2823,247,244,491,"6 de julio de 1997"
25,8,12,2824,205,221,426,"6 de julio de 1997"
25,8,12,2825,215,230,445,"6 de julio de 1997"
25,8,12,2826,208,223,431,"6 de julio de 1997"
25,8,12,2827,323,323,646,"6 de julio de 1997"
25,8,12,2828,232,252,484,"6 de julio de 1997"
25,8,12,2829,168,184,352,"6 de julio de 1997"
25,8,12,2830,431,437,868,"6 de julio de 1997"
25,8,12,2831,358,398,756,"6 de julio de 1997"
25,8,12,2832,280,305,585,"6 de julio de 1997"
25,8,12,2833,332,366,698,"6 de julio de 1997"
25,8,12,2834,239,279,518,"6 de julio de 1997"
25,8,12,2835,433,473,906,"6 de julio de 1997"
25,8,12,2836,337,404,741,"6 de julio de 1997"
25,8,12,2837,311,356,667,"6 de julio de 1997"
25,8,12,2838,122,149,271,"6 de julio de 1997"
25,8,12,2839,237,276,513,"6 de julio de 1997"
25,8,12,2840,105,129,234,"6 de julio de 1997"
25,8,12,2841,140,154,294,"6 de julio de 1997"
25,8,12,2842,243,269,512,"6 de julio de 1997"
25,8,12,2843,251,233,484,"6 de julio de 1997"
25,8,12,2844,247,253,500,"6 de julio de 1997"
25,8,12,2845,147,171,318,"6 de julio de 1997"
25,8,12,2846,270,303,573,"6 de julio de 1997"
25,8,12,2847,411,416,827,"6 de julio de 1997"
25,8,12,2848,294,299,593,"6 de julio de 1997"
25,8,12,2849,307,328,635,"6 de julio de 1997"
25,8,12,2850,226,220,446,"6 de julio de 1997"
25,8,12,2851,257,295,552,"6 de julio de 1997"
25,8,12,2852,141,140,281,"6 de julio de 1997"
25,8,12,2853,323,338,661,"6 de julio de 1997"
25,8,12,2854,346,355,701,"6 de julio de 1997"
25,8,12,2855,291,328,619,"6 de julio de 1997"
25,8,12,2856,290,302,592,"6 de julio de 1997"
25,8,12,2857,146,154,300,"6 de julio de 1997"
25,8,12,2858,118,139,257,"6 de julio de 1997"
25,8,12,2859,183,225,408,"6 de julio de 1997"
25,8,12,2860,254,279,533,"6 de julio de 1997"
25,8,12,2861,319,330,649,"6 de julio de 1997"
25,8,12,2862,153,175,328,"6 de julio de 1997"
25,8,12,2863,396,403,799,"6 de julio de 1997"
25,8,12,2864,198,206,404,"6 de julio de 1997"
25,8,12,2865,189,212,401,"6 de julio de 1997"
25,8,12,2866,209,228,437,"6 de julio de 1997"
25,8,12,2867,147,172,319,"6 de julio de 1997"
25,8,12,2868,292,313,605,"6 de julio de 1997"
25,8,12,2869,210,216,426,"6 de julio de 1997"
25,8,12,2870,244,260,504,"6 de julio de 1997"
25,8,12,2871,349,385,734,"6 de julio de 1997"
25,8,12,2872,421,424,845,"6 de julio de 1997"
25,8,12,2873,147,179,326,"6 de julio de 1997"
25,8,12,2874,133,161,294,"6 de julio de 1997"
25,8,12,2875,175,187,362,"6 de julio de 1997"
25,8,12,2876,149,181,330,"6 de julio de 1997"
25,8,12,2877,202,248,450,"6 de julio de 1997"
25,8,12,2878,164,175,339,"6 de julio de 1997"
25,8,12,2879,498,618,1116,"6 de julio de 1997"
25,8,12,2880,199,210,409,"6 de julio de 1997"
25,8,12,2881,201,203,404,"6 de julio de 1997"
25,8,12,2882,171,173,344,"6 de julio de 1997"
25,8,12,2883,159,157,316,"6 de julio de 1997"
25,8,12,2884,95,107,202,"6 de julio de 1997"
25,8,12,2885,290,286,576,"6 de julio de 1997"
25,8,12,2886,189,182,371,"6 de julio de 1997"
25,8,12,2887,210,218,428,"6 de julio de 1997"
25,8,12,2888,241,252,493,"6 de julio de 1997"
25,8,12,2889,900,259,1159,"6 de julio de 1997"
25,8,12,2890,113,114,227,"6 de julio de 1997"
25,8,12,2891,183,200,383,"6 de julio de 1997"
25,8,12,2892,269,290,559,"6 de julio de 1997"
25,8,12,2893,167,206,373,"6 de julio de 1997"
25,8,12,2894,321,341,662,"6 de julio de 1997"
25,8,12,2895,193,222,415,"6 de julio de 1997"
25,8,12,2896,238,260,498,"6 de julio de 1997"
25,8,12,2897,158,179,337,"6 de julio de 1997"
25,8,12,2898,203,225,428,"6 de julio de 1997"
25,8,12,2899,146,180,326,"6 de julio de 1997"
25,8,12,2900,171,177,348,"6 de julio de 1997"
25,8,12,2901,420,473,893,"6 de julio de 1997"
25,8,12,2902,257,250,507,"6 de julio de 1997"
25,8,12,2903,296,312,608,"6 de julio de 1997"
25,8,12,2904,268,257,525,"6 de julio de 1997"
25,8,12,2908,98,95,193,"6 de julio de 1997"
25,8,12,2909,214,264,478,"6 de julio de 1997"
25,8,12,2910,200,213,413,"6 de julio de 1997"
25,8,12,2911,194,198,392,"6 de julio de 1997"
25,8,12,2912,105,117,222,"6 de julio de 1997"
25,8,12,2913,156,178,334,"6 de julio de 1997"
25,8,12,2914,143,139,282,"6 de julio de 1997"
25,8,12,2915,262,272,534,"6 de julio de 1997"
25,8,12,2916,114,142,256,"6 de julio de 1997"
25,8,12,2917,283,308,591,"6 de julio de 1997"
25,8,12,2918,162,160,322,"6 de julio de 1997"
25,8,12,2919,275,309,584,"6 de julio de 1997"
25,8,12,2920,146,175,321,"6 de julio de 1997"
25,8,12,2921,304,338,642,"6 de julio de 1997"
25,8,12,2922,435,499,934,"6 de julio de 1997"
25,8,12,2923,196,205,401,"6 de julio de 1997"
25,8,12,2924,296,317,613,"6 de julio de 1997"
25,8,12,2925,211,246,457,"6 de julio de 1997"
25,8,12,2926,128,130,258,"6 de julio de 1997"
25,8,12,2927,237,242,479,"6 de julio de 1997"
25,8,12,2928,188,210,398,"6 de julio de 1997"
25,8,12,2929,194,202,396,"6 de julio de 1997"
25,8,12,2930,214,247,461,"6 de julio de 1997"
25,8,12,2931,148,181,329,"6 de julio de 1997"
25,8,12,2932,122,146,268,"6 de julio de 1997"
25,8,12,2933,249,303,552,"6 de julio de 1997"
25,8,12,2934,118,139,257,"6 de julio de 1997"
25,8,12,2935,193,244,437,"6 de julio de 1997"
25,8,12,2936,192,204,396,"6 de julio de 1997"
25,8,12,2937,271,318,589,"6 de julio de 1997"
25,8,12,2938,270,307,577,"6 de julio de 1997"
25,8,12,2939,377,376,753,"6 de julio de 1997"
25,8,12,2940,245,236,481,"6 de julio de 1997"
25,8,12,2941,168,170,338,"6 de julio de 1997"
25,8,12,2942,234,249,483,"6 de julio de 1997"
25,8,12,2943,133,133,266,"6 de julio de 1997"
25,8,12,2944,272,279,551,"6 de julio de 1997"
25,8,12,2945,81,95,176,"6 de julio de 1997"
25,8,12,2946,116,156,272,"6 de julio de 1997"
25,8,12,2947,230,214,444,"6 de julio de 1997"
25,8,12,2996,338,364,702,"6 de julio de 1997"
26,1,3,33,565,488,1053,"6 de julio de 1997"
26,1,3,34,462,506,968,"6 de julio de 1997"
26,1,3,35,709,691,1400,"6 de julio de 1997"
26,1,3,36,26,12,38,"6 de julio de 1997"
26,1,3,37,169,122,291,"6 de julio de 1997"
26,1,6,46,247,236,483,"6 de julio de 1997"
26,1,14,66,519,476,995,"6 de julio de 1997"
26,1,14,67,468,411,879,"6 de julio de 1997"
26,1,14,68,445,473,918,"6 de julio de 1997"
26,1,14,69,466,463,929,"6 de julio de 1997"
26,1,31,232,169,156,325,"6 de julio de 1997"
26,1,36,252,345,343,688,"6 de julio de 1997"
26,1,36,253,407,453,860,"6 de julio de 1997"
26,1,36,254,354,350,704,"6 de julio de 1997"
26,1,36,255,531,586,1117,"6 de julio de 1997"
26,1,36,256,479,522,1001,"6 de julio de 1997"
26,1,36,257,246,284,530,"6 de julio de 1997"
26,1,36,258,103,79,182,"6 de julio de 1997"
26,1,36,259,178,159,337,"6 de julio de 1997"
26,1,36,260,220,207,427,"6 de julio de 1997"
26,1,36,261,295,309,604,"6 de julio de 1997"
26,1,36,262,296,241,537,"6 de julio de 1997"
26,1,36,263,433,456,889,"6 de julio de 1997"
26,1,38,265,376,311,687,"6 de julio de 1997"
26,1,38,266,259,223,482,"6 de julio de 1997"
26,1,42,278,449,359,808,"6 de julio de 1997"
26,1,42,279,92,80,172,"6 de julio de 1997"
26,1,42,280,67,48,115,"6 de julio de 1997"
26,1,43,281,147,137,284,"6 de julio de 1997"
26,1,43,282,30,39,69,"6 de julio de 1997"
26,1,43,283,61,39,100,"6 de julio de 1997"
26,1,43,284,68,72,140,"6 de julio de 1997"
26,1,43,285,216,193,409,"6 de julio de 1997"
26,1,46,292,546,583,1129,"6 de julio de 1997"
26,1,46,293,583,537,1120,"6 de julio de 1997"
26,1,46,294,678,680,1358,"6 de julio de 1997"
26,1,46,295,543,567,1110,"6 de julio de 1997"
26,1,46,296,754,816,1570,"6 de julio de 1997"
26,1,46,297,726,664,1390,"6 de julio de 1997"
26,1,46,298,693,705,1398,"6 de julio de 1997"
26,1,46,299,552,619,1171,"6 de julio de 1997"
26,1,46,300,410,394,804,"6 de julio de 1997"
26,1,46,301,373,398,771,"6 de julio de 1997"
26,1,46,302,539,513,1052,"6 de julio de 1997"
26,1,46,303,456,508,964,"6 de julio de 1997"
26,1,46,304,732,729,1461,"6 de julio de 1997"
26,1,46,305,720,738,1458,"6 de julio de 1997"
26,1,46,306,700,727,1427,"6 de julio de 1997"
26,1,46,307,264,282,546,"6 de julio de 1997"
26,1,46,308,730,713,1443,"6 de julio de 1997"
26,1,46,309,467,515,982,"6 de julio de 1997"
26,1,46,310,669,663,1332,"6 de julio de 1997"
26,1,46,311,431,398,829,"6 de julio de 1997"
26,1,46,312,544,562,1106,"6 de julio de 1997"
26,1,46,313,397,393,790,"6 de julio de 1997"
26,1,46,314,647,586,1233,"6 de julio de 1997"
26,1,46,315,365,368,733,"6 de julio de 1997"
26,1,46,316,539,566,1105,"6 de julio de 1997"
26,1,46,317,433,448,881,"6 de julio de 1997"
26,1,46,318,142,83,225,"6 de julio de 1997"
26,1,46,319,803,707,1510,"6 de julio de 1997"
26,1,46,320,517,471,988,"6 de julio de 1997"
26,1,46,321,297,268,565,"6 de julio de 1997"
26,1,46,322,528,470,998,"6 de julio de 1997"
26,1,46,323,417,306,723,"6 de julio de 1997"
26,1,46,324,541,426,967,"6 de julio de 1997"
26,1,46,325,332,216,548,"6 de julio de 1997"
26,1,46,326,359,266,625,"6 de julio de 1997"
26,1,46,327,238,154,392,"6 de julio de 1997"
26,1,46,328,524,389,913,"6 de julio de 1997"
26,1,47,329,894,806,1700,"6 de julio de 1997"
26,1,47,330,424,389,813,"6 de julio de 1997"
26,1,51,620,214,169,383,"6 de julio de 1997"
26,1,51,621,436,405,841,"6 de julio de 1997"
26,1,51,622,199,152,351,"6 de julio de 1997"
26,1,51,623,74,45,119,"6 de julio de 1997"
26,1,51,624,115,68,183,"6 de julio de 1997"
26,1,52,625,488,490,978,"6 de julio de 1997"
26,1,52,626,520,475,995,"6 de julio de 1997"
26,1,52,627,695,594,1289,"6 de julio de 1997"
26,1,52,628,36,23,59,"6 de julio de 1997"
26,1,52,629,600,520,1120,"6 de julio de 1997"
26,1,52,630,135,127,262,"6 de julio de 1997"
26,1,53,631,660,605,1265,"6 de julio de 1997"
26,1,53,632,379,398,777,"6 de julio de 1997"
26,1,53,633,244,255,499,"6 de julio de 1997"
26,1,53,634,312,321,633,"6 de julio de 1997"
26,1,53,635,418,414,832,"6 de julio de 1997"
26,1,53,636,600,657,1257,"6 de julio de 1997"
26,1,53,637,402,444,846,"6 de julio de 1997"
26,1,53,638,438,442,880,"6 de julio de 1997"
26,1,53,639,484,541,1025,"6 de julio de 1997"
26,1,53,640,634,484,1118,"6 de julio de 1997"
26,1,53,641,522,525,1047,"6 de julio de 1997"
26,1,53,642,574,572,1146,"6 de julio de 1997"
26,1,53,643,457,484,941,"6 de julio de 1997"
26,1,53,644,204,224,428,"6 de julio de 1997"
26,1,53,645,493,496,989,"6 de julio de 1997"
26,1,53,646,514,534,1048,"6 de julio de 1997"
26,1,53,647,165,158,323,"6 de julio de 1997"
26,1,53,648,465,417,882,"6 de julio de 1997"
26,1,54,649,220,179,399,"6 de julio de 1997"
26,1,54,650,419,328,747,"6 de julio de 1997"
26,1,54,651,37,26,63,"6 de julio de 1997"
26,1,55,652,401,372,773,"6 de julio de 1997"
26,1,55,653,153,136,289,"6 de julio de 1997"
26,1,55,654,198,194,392,"6 de julio de 1997"
26,1,55,655,265,292,557,"6 de julio de 1997"
26,1,55,656,384,379,763,"6 de julio de 1997"
26,1,55,657,403,429,832,"6 de julio de 1997"
26,1,55,658,366,403,769,"6 de julio de 1997"
26,1,55,659,293,332,625,"6 de julio de 1997"
26,1,55,660,399,428,827,"6 de julio de 1997"
26,1,55,661,613,632,1245,"6 de julio de 1997"
26,1,55,662,346,369,715,"6 de julio de 1997"
26,1,55,663,126,131,257,"6 de julio de 1997"
26,1,55,664,331,337,668,"6 de julio de 1997"
26,1,55,665,337,361,698,"6 de julio de 1997"
26,1,55,666,534,581,1115,"6 de julio de 1997"
26,1,55,667,583,625,1208,"6 de julio de 1997"
26,1,55,668,696,737,1433,"6 de julio de 1997"
26,1,55,669,549,557,1106,"6 de julio de 1997"
26,1,55,670,978,1105,2083,"6 de julio de 1997"
26,1,55,671,189,208,397,"6 de julio de 1997"
26,1,55,672,310,328,638,"6 de julio de 1997"
26,1,55,673,406,388,794,"6 de julio de 1997"
26,1,55,674,324,312,636,"6 de julio de 1997"
26,1,55,675,250,284,534,"6 de julio de 1997"
26,1,55,676,416,436,852,"6 de julio de 1997"
26,1,55,677,534,599,1133,"6 de julio de 1997"
26,1,55,678,475,582,1057,"6 de julio de 1997"
26,1,55,679,389,463,852,"6 de julio de 1997"
26,1,55,680,607,646,1253,"6 de julio de 1997"
26,1,55,681,603,651,1254,"6 de julio de 1997"
26,1,55,682,236,211,447,"6 de julio de 1997"
26,1,55,683,266,298,564,"6 de julio de 1997"
26,1,55,684,400,392,792,"6 de julio de 1997"
26,1,55,685,540,621,1161,"6 de julio de 1997"
26,1,55,686,292,306,598,"6 de julio de 1997"
26,1,55,687,385,395,780,"6 de julio de 1997"
26,1,55,688,361,394,755,"6 de julio de 1997"
26,1,55,689,328,372,700,"6 de julio de 1997"
26,1,55,690,503,532,1035,"6 de julio de 1997"
26,1,55,691,275,278,553,"6 de julio de 1997"
26,1,55,692,364,395,759,"6 de julio de 1997"
26,1,55,693,233,231,464,"6 de julio de 1997"
26,1,55,694,339,330,669,"6 de julio de 1997"
26,1,55,695,303,328,631,"6 de julio de 1997"
26,1,55,696,344,329,673,"6 de julio de 1997"
26,1,55,697,378,419,797,"6 de julio de 1997"
26,1,55,698,347,404,751,"6 de julio de 1997"
26,1,55,699,314,358,672,"6 de julio de 1997"
26,1,55,700,318,375,693,"6 de julio de 1997"
26,1,55,701,742,819,1561,"6 de julio de 1997"
26,1,55,702,250,270,520,"6 de julio de 1997"
26,1,55,703,524,607,1131,"6 de julio de 1997"
26,1,55,704,455,510,965,"6 de julio de 1997"
26,1,55,705,617,662,1279,"6 de julio de 1997"
26,1,55,706,707,781,1488,"6 de julio de 1997"
26,1,55,707,531,566,1097,"6 de julio de 1997"
26,1,55,708,387,414,801,"6 de julio de 1997"
26,1,55,709,465,434,899,"6 de julio de 1997"
26,1,55,710,441,527,968,"6 de julio de 1997"
26,1,55,711,351,397,748,"6 de julio de 1997"
26,1,55,712,254,271,525,"6 de julio de 1997"
26,1,55,713,646,718,1364,"6 de julio de 1997"
26,1,55,714,581,618,1199,"6 de julio de 1997"
26,1,55,715,449,478,927,"6 de julio de 1997"
26,1,55,716,415,414,829,"6 de julio de 1997"
26,1,55,717,330,337,667,"6 de julio de 1997"
26,1,55,718,268,295,563,"6 de julio de 1997"
26,1,55,719,620,507,1127,"6 de julio de 1997"
26,1,55,720,341,354,695,"6 de julio de 1997"
26,1,55,721,528,544,1072,"6 de julio de 1997"
26,1,55,722,543,624,1167,"6 de julio de 1997"
26,1,55,723,412,398,810,"6 de julio de 1997"
26,1,55,724,498,539,1037,"6 de julio de 1997"
26,1,55,725,373,409,782,"6 de julio de 1997"
26,1,55,726,383,402,785,"6 de julio de 1997"
26,1,55,727,470,544,1014,"6 de julio de 1997"
26,1,55,728,319,298,617,"6 de julio de 1997"
26,1,55,729,303,313,616,"6 de julio de 1997"
26,1,55,730,470,504,974,"6 de julio de 1997"
26,1,55,731,476,454,930,"6 de julio de 1997"
26,1,55,732,519,516,1035,"6 de julio de 1997"
26,1,55,733,259,261,520,"6 de julio de 1997"
26,1,55,734,198,200,398,"6 de julio de 1997"
26,1,55,735,158,143,301,"6 de julio de 1997"
26,1,55,736,201,165,366,"6 de julio de 1997"
26,1,55,737,656,601,1257,"6 de julio de 1997"
26,1,55,738,570,508,1078,"6 de julio de 1997"
26,1,55,739,233,213,446,"6 de julio de 1997"
26,1,55,740,684,580,1264,"6 de julio de 1997"
26,1,55,741,876,789,1665,"6 de julio de 1997"
26,1,55,742,601,458,1059,"6 de julio de 1997"
26,1,56,743,228,193,421,"6 de julio de 1997"
26,1,56,744,134,105,239,"6 de julio de 1997"
26,1,56,745,149,116,265,"6 de julio de 1997"
26,1,56,746,859,622,1481,"6 de julio de 1997"
26,1,70,1323,351,340,691,"6 de julio de 1997"
26,1,70,1324,900,708,1608,"6 de julio de 1997"
26,1,70,1325,383,372,755,"6 de julio de 1997"
26,1,70,1326,445,421,866,"6 de julio de 1997"
26,1,70,1327,309,344,653,"6 de julio de 1997"
26,1,70,1328,182,202,384,"6 de julio de 1997"
26,1,70,1329,502,389,891,"6 de julio de 1997"
26,1,70,1330,216,208,424,"6 de julio de 1997"
26,2,1,1,569,493,1062,"6 de julio de 1997"
26,2,1,2,235,209,444,"6 de julio de 1997"
26,2,2,3,606,585,1191,"6 de julio de 1997"
26,2,2,4,295,237,532,"6 de julio de 1997"
26,2,2,5,333,340,673,"6 de julio de 1997"
26,2,2,6,714,722,1436,"6 de julio de 1997"
26,2,2,7,727,661,1388,"6 de julio de 1997"
26,2,2,8,717,751,1468,"6 de julio de 1997"
26,2,2,9,767,793,1560,"6 de julio de 1997"
26,2,2,10,887,893,1780,"6 de julio de 1997"
26,2,2,11,588,641,1229,"6 de julio de 1997"
26,2,2,12,617,621,1238,"6 de julio de 1997"
26,2,2,13,688,632,1320,"6 de julio de 1997"
26,2,2,14,702,729,1431,"6 de julio de 1997"
26,2,2,15,508,534,1042,"6 de julio de 1997"
26,2,2,16,292,335,627,"6 de julio de 1997"
26,2,2,17,166,156,322,"6 de julio de 1997"
26,2,2,18,673,646,1319,"6 de julio de 1997"
26,2,2,19,202,213,415,"6 de julio de 1997"
26,2,2,20,877,838,1715,"6 de julio de 1997"
26,2,2,21,599,594,1193,"6 de julio de 1997"
26,2,2,22,970,963,1933,"6 de julio de 1997"
26,2,2,23,572,500,1072,"6 de julio de 1997"
26,2,2,24,490,448,938,"6 de julio de 1997"
26,2,2,25,1013,995,2008,"6 de julio de 1997"
26,2,2,26,154,167,321,"6 de julio de 1997"
26,2,2,27,56,37,93,"6 de julio de 1997"
26,2,2,28,85,53,138,"6 de julio de 1997"
26,2,2,29,48,33,81,"6 de julio de 1997"
26,2,2,30,138,109,247,"6 de julio de 1997"
26,2,2,31,447,500,947,"6 de julio de 1997"
26,2,2,32,110,113,223,"6 de julio de 1997"
26,2,5,41,268,259,527,"6 de julio de 1997"
26,2,5,42,398,350,748,"6 de julio de 1997"
26,2,5,43,148,142,290,"6 de julio de 1997"
26,2,5,44,160,135,295,"6 de julio de 1997"
26,2,5,45,135,94,229,"6 de julio de 1997"
26,2,7,47,386,336,722,"6 de julio de 1997"
26,2,9,52,392,362,754,"6 de julio de 1997"
26,2,9,53,59,39,98,"6 de julio de 1997"
26,2,10,54,417,392,809,"6 de julio de 1997"
26,2,10,55,150,125,275,"6 de julio de 1997"
26,2,11,56,384,343,727,"6 de julio de 1997"
26,2,11,57,176,175,351,"6 de julio de 1997"
26,2,12,58,408,374,782,"6 de julio de 1997"
26,2,12,59,304,265,569,"6 de julio de 1997"
26,2,12,60,130,112,242,"6 de julio de 1997"
26,2,12,61,66,58,124,"6 de julio de 1997"
26,2,12,62,106,96,202,"6 de julio de 1997"
26,2,12,63,289,246,535,"6 de julio de 1997"
26,2,13,64,263,222,485,"6 de julio de 1997"
26,2,13,65,159,139,298,"6 de julio de 1997"
26,2,15,70,664,648,1312,"6 de julio de 1997"
26,2,15,71,628,621,1249,"6 de julio de 1997"
26,2,15,72,611,698,1309,"6 de julio de 1997"
26,2,15,73,896,803,1699,"6 de julio de 1997"
26,2,15,74,688,704,1392,"6 de julio de 1997"
26,2,15,75,668,622,1290,"6 de julio de 1997"
26,2,15,76,508,544,1052,"6 de julio de 1997"
26,2,15,77,454,475,929,"6 de julio de 1997"
26,2,15,78,557,522,1079,"6 de julio de 1997"
26,2,15,79,363,420,783,"6 de julio de 1997"
26,2,15,80,334,327,661,"6 de julio de 1997"
26,2,15,81,472,466,938,"6 de julio de 1997"
26,2,15,82,704,733,1437,"6 de julio de 1997"
26,2,15,83,523,517,1040,"6 de julio de 1997"
26,2,15,84,708,656,1364,"6 de julio de 1997"
26,2,15,85,340,308,648,"6 de julio de 1997"
26,2,15,86,250,200,450,"6 de julio de 1997"
26,2,15,87,104,89,193,"6 de julio de 1997"
26,2,15,88,240,214,454,"6 de julio de 1997"
26,2,16,89,276,237,513,"6 de julio de 1997"
26,2,16,90,68,38,106,"6 de julio de 1997"
26,2,16,91,45,27,72,"6 de julio de 1997"
26,2,17,92,180,194,374,"6 de julio de 1997"
26,2,17,93,359,377,736,"6 de julio de 1997"
26,2,17,94,469,439,908,"6 de julio de 1997"
26,2,17,95,80,62,142,"6 de julio de 1997"
26,2,17,96,367,315,682,"6 de julio de 1997"
26,2,17,97,319,278,597,"6 de julio de 1997"
26,2,17,98,170,141,311,"6 de julio de 1997"
26,2,17,99,239,218,457,"6 de julio de 1997"
26,2,18,100,333,305,638,"6 de julio de 1997"
26,2,19,101,493,400,893,"6 de julio de 1997"
26,2,19,102,115,87,202,"6 de julio de 1997"
26,2,19,103,396,341,737,"6 de julio de 1997"
26,2,19,104,581,557,1138,"6 de julio de 1997"
26,2,19,105,452,421,873,"6 de julio de 1997"
26,2,20,106,432,382,814,"6 de julio de 1997"
26,2,21,107,308,269,577,"6 de julio de 1997"
26,2,21,108,128,107,235,"6 de julio de 1997"
26,2,22,109,337,328,665,"6 de julio de 1997"
26,2,23,110,330,320,650,"6 de julio de 1997"
26,2,23,111,89,67,156,"6 de julio de 1997"
26,2,24,112,226,251,477,"6 de julio de 1997"
26,2,24,113,768,773,1541,"6 de julio de 1997"
26,2,24,114,323,353,676,"6 de julio de 1997"
26,2,24,115,454,414,868,"6 de julio de 1997"
26,2,24,116,474,443,917,"6 de julio de 1997"
26,2,24,117,113,85,198,"6 de julio de 1997"
26,2,24,118,41,18,59,"6 de julio de 1997"
26,2,24,119,22,17,39,"6 de julio de 1997"
26,2,24,120,30,25,55,"6 de julio de 1997"
26,2,24,121,134,116,250,"6 de julio de 1997"
26,2,24,122,176,190,366,"6 de julio de 1997"
26,2,25,123,404,430,834,"6 de julio de 1997"
26,2,25,124,330,343,673,"6 de julio de 1997"
26,2,25,125,567,544,1111,"6 de julio de 1997"
26,2,25,126,814,829,1643,"6 de julio de 1997"
26,2,25,127,537,575,1112,"6 de julio de 1997"
26,2,25,128,718,693,1411,"6 de julio de 1997"
26,2,25,129,676,725,1401,"6 de julio de 1997"
26,2,25,130,625,624,1249,"6 de julio de 1997"
26,2,25,131,790,821,1611,"6 de julio de 1997"
26,2,25,132,464,496,960,"6 de julio de 1997"
26,2,25,133,592,559,1151,"6 de julio de 1997"
26,2,25,134,188,139,327,"6 de julio de 1997"
26,2,25,135,141,118,259,"6 de julio de 1997"
26,2,25,136,534,474,1008,"6 de julio de 1997"
26,2,25,137,79,48,127,"6 de julio de 1997"
26,2,26,138,601,596,1197,"6 de julio de 1997"
26,2,26,139,288,290,578,"6 de julio de 1997"
26,2,26,140,440,441,881,"6 de julio de 1997"
26,2,26,141,74,58,132,"6 de julio de 1997"
26,2,27,142,306,332,638,"6 de julio de 1997"
26,2,27,143,304,280,584,"6 de julio de 1997"
26,2,27,144,390,374,764,"6 de julio de 1997"
26,2,27,145,349,362,711,"6 de julio de 1997"
26,2,28,146,444,373,817,"6 de julio de 1997"
26,2,28,147,206,178,384,"6 de julio de 1997"
26,2,28,148,38,47,85,"6 de julio de 1997"
26,2,29,149,365,341,706,"6 de julio de 1997"
26,2,29,150,516,359,875,"6 de julio de 1997"
26,2,29,151,526,470,996,"6 de julio de 1997"
26,2,29,152,529,485,1014,"6 de julio de 1997"
26,2,29,153,485,322,807,"6 de julio de 1997"
26,2,29,154,240,237,477,"6 de julio de 1997"
26,2,29,155,329,318,647,"6 de julio de 1997"
26,2,29,156,515,422,937,"6 de julio de 1997"
26,2,29,157,532,463,995,"6 de julio de 1997"
26,2,29,158,547,298,845,"6 de julio de 1997"
26,2,30,159,503,544,1047,"6 de julio de 1997"
26,2,30,160,208,175,383,"6 de julio de 1997"
26,2,30,161,424,421,845,"6 de julio de 1997"
26,2,30,162,750,783,1533,"6 de julio de 1997"
26,2,30,163,690,699,1389,"6 de julio de 1997"
26,2,30,164,422,421,843,"6 de julio de 1997"
26,2,30,165,632,665,1297,"6 de julio de 1997"
26,2,30,166,311,326,637,"6 de julio de 1997"
26,2,30,167,472,462,934,"6 de julio de 1997"
26,2,30,168,361,362,723,"6 de julio de 1997"
26,2,30,169,373,347,720,"6 de julio de 1997"
26,2,30,170,564,544,1108,"6 de julio de 1997"
26,2,30,171,735,769,1504,"6 de julio de 1997"
26,2,30,172,419,441,860,"6 de julio de 1997"
26,2,30,173,397,501,898,"6 de julio de 1997"
26,2,30,174,411,473,884,"6 de julio de 1997"
26,2,30,175,711,691,1402,"6 de julio de 1997"
26,2,30,176,333,369,702,"6 de julio de 1997"
26,2,30,177,355,311,666,"6 de julio de 1997"
26,2,30,178,676,718,1394,"6 de julio de 1997"
26,2,30,179,459,468,927,"6 de julio de 1997"
26,2,30,180,334,316,650,"6 de julio de 1997"
26,2,30,181,292,292,584,"6 de julio de 1997"
26,2,30,182,506,550,1056,"6 de julio de 1997"
26,2,30,183,390,444,834,"6 de julio de 1997"
26,2,30,184,451,484,935,"6 de julio de 1997"
26,2,30,185,492,487,979,"6 de julio de 1997"
26,2,30,186,302,259,561,"6 de julio de 1997"
26,2,30,187,240,203,443,"6 de julio de 1997"
26,2,30,188,856,877,1733,"6 de julio de 1997"
26,2,30,189,477,436,913,"6 de julio de 1997"
26,2,30,190,374,363,737,"6 de julio de 1997"
26,2,30,191,483,477,960,"6 de julio de 1997"
26,2,30,192,696,735,1431,"6 de julio de 1997"
26,2,30,193,330,318,648,"6 de julio de 1997"
26,2,30,194,471,448,919,"6 de julio de 1997"
26,2,30,195,456,536,992,"6 de julio de 1997"
26,2,30,196,574,617,1191,"6 de julio de 1997"
26,2,30,197,323,354,677,"6 de julio de 1997"
26,2,30,198,499,461,960,"6 de julio de 1997"
26,2,30,199,1005,901,1906,"6 de julio de 1997"
26,2,30,200,566,570,1136,"6 de julio de 1997"
26,2,30,201,875,894,1769,"6 de julio de 1997"
26,2,30,202,525,550,1075,"6 de julio de 1997"
26,2,30,203,284,366,650,"6 de julio de 1997"
26,2,30,204,507,532,1039,"6 de julio de 1997"
26,2,30,205,763,696,1459,"6 de julio de 1997"
26,2,30,206,508,473,981,"6 de julio de 1997"
26,2,30,207,645,632,1277,"6 de julio de 1997"
26,2,30,208,617,582,1199,"6 de julio de 1997"
26,2,30,209,510,519,1029,"6 de julio de 1997"
26,2,30,210,915,907,1822,"6 de julio de 1997"
26,2,30,211,924,906,1830,"6 de julio de 1997"
26,2,30,212,446,478,924,"6 de julio de 1997"
26,2,30,213,569,483,1052,"6 de julio de 1997"
26,2,30,214,645,554,1199,"6 de julio de 1997"
26,2,30,215,905,839,1744,"6 de julio de 1997"
26,2,30,216,622,611,1233,"6 de julio de 1997"
26,2,30,217,868,840,1708,"6 de julio de 1997"
26,2,30,218,522,543,1065,"6 de julio de 1997"
26,2,30,219,822,360,1182,"6 de julio de 1997"
26,2,30,220,606,632,1238,"6 de julio de 1997"
26,2,30,221,966,928,1894,"6 de julio de 1997"
26,2,30,222,524,492,1016,"6 de julio de 1997"
26,2,30,223,657,508,1165,"6 de julio de 1997"
26,2,30,224,819,863,1682,"6 de julio de 1997"
26,2,30,225,699,740,1439,"6 de julio de 1997"
26,2,30,226,443,464,907,"6 de julio de 1997"
26,2,30,227,1216,1263,2479,"6 de julio de 1997"
26,2,30,228,181,134,315,"6 de julio de 1997"
26,2,30,229,333,313,646,"6 de julio de 1997"
26,2,30,230,57,38,95,"6 de julio de 1997"
26,2,30,231,798,796,1594,"6 de julio de 1997"
26,2,33,247,171,158,329,"6 de julio de 1997"
26,2,37,264,503,421,924,"6 de julio de 1997"
26,2,41,274,255,262,517,"6 de julio de 1997"
26,2,41,275,218,223,441,"6 de julio de 1997"
26,2,41,276,34,25,59,"6 de julio de 1997"
26,2,41,277,4,4,8,"6 de julio de 1997"
26,2,44,286,246,218,464,"6 de julio de 1997"
26,2,44,287,302,265,567,"6 de julio de 1997"
26,2,44,288,124,97,221,"6 de julio de 1997"
26,2,57,747,613,546,1159,"6 de julio de 1997"
26,2,57,748,511,520,1031,"6 de julio de 1997"
26,2,57,749,348,333,681,"6 de julio de 1997"
26,2,57,750,414,381,795,"6 de julio de 1997"
26,2,57,751,85,61,146,"6 de julio de 1997"
26,2,57,752,139,126,265,"6 de julio de 1997"
26,2,57,753,472,425,897,"6 de julio de 1997"
26,2,57,754,177,176,353,"6 de julio de 1997"
26,2,57,755,135,110,245,"6 de julio de 1997"
26,2,57,756,268,219,487,"6 de julio de 1997"
26,2,57,757,162,109,271,"6 de julio de 1997"
26,2,57,758,73,51,124,"6 de julio de 1997"
26,2,57,759,87,72,159,"6 de julio de 1997"
26,3,49,336,1074,1191,2265,"6 de julio de 1997"
26,3,49,337,1022,1101,2123,"6 de julio de 1997"
26,3,49,338,730,832,1562,"6 de julio de 1997"
26,3,49,339,560,580,1140,"6 de julio de 1997"
26,3,49,340,1002,1055,2057,"6 de julio de 1997"
26,3,49,341,1478,1543,3021,"6 de julio de 1997"
26,3,49,342,976,1022,1998,"6 de julio de 1997"
26,3,49,343,878,963,1841,"6 de julio de 1997"
26,3,49,344,731,803,1534,"6 de julio de 1997"
26,3,49,345,850,910,1760,"6 de julio de 1997"
26,3,49,346,377,406,783,"6 de julio de 1997"
26,3,49,347,701,710,1411,"6 de julio de 1997"
26,3,49,348,491,489,980,"6 de julio de 1997"
26,3,49,349,404,411,815,"6 de julio de 1997"
26,3,49,350,759,850,1609,"6 de julio de 1997"
26,3,49,351,726,778,1504,"6 de julio de 1997"
26,3,49,352,985,1116,2101,"6 de julio de 1997"
26,3,49,353,419,434,853,"6 de julio de 1997"
26,3,49,354,478,511,989,"6 de julio de 1997"
26,3,49,355,494,561,1055,"6 de julio de 1997"
26,3,49,356,470,527,997,"6 de julio de 1997"
26,3,49,357,611,685,1296,"6 de julio de 1997"
26,3,49,358,604,620,1224,"6 de julio de 1997"
26,3,49,359,1045,1136,2181,"6 de julio de 1997"
26,3,49,360,601,643,1244,"6 de julio de 1997"
26,3,49,361,429,425,854,"6 de julio de 1997"
26,3,49,362,648,686,1334,"6 de julio de 1997"
26,3,49,363,293,326,619,"6 de julio de 1997"
26,3,49,364,527,551,1078,"6 de julio de 1997"
26,3,49,365,734,755,1489,"6 de julio de 1997"
26,3,49,366,539,605,1144,"6 de julio de 1997"
26,3,49,367,600,662,1262,"6 de julio de 1997"
26,3,49,368,408,432,840,"6 de julio de 1997"
26,3,49,369,496,535,1031,"6 de julio de 1997"
26,3,49,370,472,510,982,"6 de julio de 1997"
26,3,49,371,422,413,835,"6 de julio de 1997"
26,3,49,372,517,572,1089,"6 de julio de 1997"
26,3,49,373,597,632,1229,"6 de julio de 1997"
26,3,49,374,570,587,1157,"6 de julio de 1997"
26,3,49,375,434,491,925,"6 de julio de 1997"
26,3,49,376,819,862,1681,"6 de julio de 1997"
26,3,49,377,714,769,1483,"6 de julio de 1997"
26,3,49,378,569,607,1176,"6 de julio de 1997"
26,3,49,379,558,542,1100,"6 de julio de 1997"
26,3,49,380,591,586,1177,"6 de julio de 1997"
26,3,49,381,611,629,1240,"6 de julio de 1997"
26,3,49,382,787,854,1641,"6 de julio de 1997"
26,3,49,383,310,358,668,"6 de julio de 1997"
26,3,49,384,398,439,837,"6 de julio de 1997"
26,3,49,385,547,601,1148,"6 de julio de 1997"
26,3,49,386,523,617,1140,"6 de julio de 1997"
26,3,49,387,566,638,1204,"6 de julio de 1997"
26,3,49,388,403,434,837,"6 de julio de 1997"
26,3,49,389,588,588,1176,"6 de julio de 1997"
26,3,49,390,922,953,1875,"6 de julio de 1997"
26,3,49,391,894,70,964,"6 de julio de 1997"
26,3,49,392,686,802,1488,"6 de julio de 1997"
26,3,49,393,605,690,1295,"6 de julio de 1997"
26,3,49,394,877,923,1800,"6 de julio de 1997"
26,3,49,395,503,530,1033,"6 de julio de 1997"
26,3,49,396,628,659,1287,"6 de julio de 1997"
26,3,49,397,555,664,1219,"6 de julio de 1997"
26,3,49,398,708,741,1449,"6 de julio de 1997"
26,3,49,399,420,522,942,"6 de julio de 1997"
26,3,49,400,413,400,813,"6 de julio de 1997"
26,3,49,401,702,719,1421,"6 de julio de 1997"
26,3,49,402,684,718,1402,"6 de julio de 1997"
26,3,49,403,315,329,644,"6 de julio de 1997"
26,3,49,404,517,508,1025,"6 de julio de 1997"
26,3,49,405,490,504,994,"6 de julio de 1997"
26,3,49,406,667,764,1431,"6 de julio de 1997"
26,3,49,407,573,574,1147,"6 de julio de 1997"
26,3,49,408,601,627,1228,"6 de julio de 1997"
26,3,49,409,698,719,1417,"6 de julio de 1997"
26,3,49,410,650,696,1346,"6 de julio de 1997"
26,3,49,411,686,774,1460,"6 de julio de 1997"
26,3,49,412,553,583,1136,"6 de julio de 1997"
26,3,49,413,623,677,1300,"6 de julio de 1997"
26,3,49,417,362,390,752,"6 de julio de 1997"
26,3,49,418,680,762,1442,"6 de julio de 1997"
26,3,49,419,690,840,1530,"6 de julio de 1997"
26,3,49,420,594,648,1242,"6 de julio de 1997"
26,3,49,421,707,747,1454,"6 de julio de 1997"
26,3,49,422,439,459,898,"6 de julio de 1997"
26,3,49,423,595,665,1260,"6 de julio de 1997"
26,3,49,424,735,789,1524,"6 de julio de 1997"
26,3,49,425,553,602,1155,"6 de julio de 1997"
26,3,49,426,484,471,955,"6 de julio de 1997"
26,3,49,427,689,695,1384,"6 de julio de 1997"
26,3,49,428,439,506,945,"6 de julio de 1997"
26,3,49,429,292,302,594,"6 de julio de 1997"
26,3,49,430,666,668,1334,"6 de julio de 1997"
26,3,49,431,738,746,1484,"6 de julio de 1997"
26,3,49,432,327,380,707,"6 de julio de 1997"
26,3,49,433,732,814,1546,"6 de julio de 1997"
26,3,49,434,813,814,1627,"6 de julio de 1997"
26,3,49,435,523,515,1038,"6 de julio de 1997"
26,3,49,436,380,408,788,"6 de julio de 1997"
26,3,49,437,466,524,990,"6 de julio de 1997"
26,3,49,438,694,751,1445,"6 de julio de 1997"
26,3,49,439,724,798,1522,"6 de julio de 1997"
26,3,49,440,515,609,1124,"6 de julio de 1997"
26,3,49,441,446,590,1036,"6 de julio de 1997"
26,3,49,442,678,768,1446,"6 de julio de 1997"
26,3,49,443,615,653,1268,"6 de julio de 1997"
26,3,49,444,627,655,1282,"6 de julio de 1997"
26,3,49,445,370,443,813,"6 de julio de 1997"
26,3,49,446,388,428,816,"6 de julio de 1997"
26,3,49,447,402,447,849,"6 de julio de 1997"
26,3,49,448,809,831,1640,"6 de julio de 1997"
26,3,49,449,728,769,1497,"6 de julio de 1997"
26,3,49,450,517,548,1065,"6 de julio de 1997"
26,3,49,451,628,644,1272,"6 de julio de 1997"
26,3,49,452,786,798,1584,"6 de julio de 1997"
26,3,49,453,412,468,880,"6 de julio de 1997"
26,3,49,454,543,618,1161,"6 de julio de 1997"
26,3,49,455,317,359,676,"6 de julio de 1997"
26,3,49,459,503,603,1106,"6 de julio de 1997"
26,3,49,461,515,559,1074,"6 de julio de 1997"
26,3,49,462,412,473,885,"6 de julio de 1997"
26,3,49,463,845,825,1670,"6 de julio de 1997"
26,3,49,585,539,543,1082,"6 de julio de 1997"
26,3,49,586,448,353,801,"6 de julio de 1997"
26,3,49,587,483,431,914,"6 de julio de 1997"
26,3,49,588,173,126,299,"6 de julio de 1997"
26,3,49,589,919,861,1780,"6 de julio de 1997"
26,3,49,591,236,168,404,"6 de julio de 1997"
26,3,49,592,1022,949,1971,"6 de julio de 1997"
26,3,49,593,351,343,694,"6 de julio de 1997"
26,3,49,596,74,44,118,"6 de julio de 1997"
26,4,4,38,296,259,555,"6 de julio de 1997"
26,4,4,39,129,102,231,"6 de julio de 1997"
26,4,4,40,72,52,124,"6 de julio de 1997"
26,4,8,48,258,207,465,"6 de julio de 1997"
26,4,8,49,77,52,129,"6 de julio de 1997"
26,4,8,50,43,34,77,"6 de julio de 1997"
26,4,8,51,54,50,104,"6 de julio de 1997"
26,4,32,233,353,355,708,"6 de julio de 1997"
26,4,32,234,387,350,737,"6 de julio de 1997"
26,4,32,235,608,560,1168,"6 de julio de 1997"
26,4,32,236,78,63,141,"6 de julio de 1997"
26,4,32,237,77,57,134,"6 de julio de 1997"
26,4,32,238,73,56,129,"6 de julio de 1997"
26,4,32,239,66,65,131,"6 de julio de 1997"
26,4,32,240,159,122,281,"6 de julio de 1997"
26,4,32,241,46,46,92,"6 de julio de 1997"
26,4,32,242,35,25,60,"6 de julio de 1997"
26,4,32,243,86,67,153,"6 de julio de 1997"
26,4,32,244,37,32,69,"6 de julio de 1997"
26,4,32,245,53,39,92,"6 de julio de 1997"
26,4,32,246,102,95,197,"6 de julio de 1997"
26,4,34,248,152,122,274,"6 de julio de 1997"
26,4,35,249,444,395,839,"6 de julio de 1997"
26,4,35,250,52,24,76,"6 de julio de 1997"
26,4,35,251,170,138,308,"6 de julio de 1997"
26,4,39,267,118,90,208,"6 de julio de 1997"
26,4,39,268,131,122,253,"6 de julio de 1997"
26,4,39,269,89,75,164,"6 de julio de 1997"
26,4,39,270,149,127,276,"6 de julio de 1997"
26,4,39,271,50,40,90,"6 de julio de 1997"
26,4,39,272,173,132,305,"6 de julio de 1997"
26,4,40,273,604,487,1091,"6 de julio de 1997"
26,4,45,289,342,297,639,"6 de julio de 1997"
26,4,45,290,145,116,261,"6 de julio de 1997"
26,4,45,291,181,145,326,"6 de julio de 1997"
26,4,48,331,267,182,449,"6 de julio de 1997"
26,4,48,332,218,150,368,"6 de julio de 1997"
26,4,48,333,112,80,192,"6 de julio de 1997"
26,4,48,334,192,131,323,"6 de julio de 1997"
26,4,48,335,161,127,288,"6 de julio de 1997"
26,4,50,619,607,524,1131,"6 de julio de 1997"
26,4,58,760,646,643,1289,"6 de julio de 1997"
26,4,58,761,589,553,1142,"6 de julio de 1997"
26,4,58,762,557,500,1057,"6 de julio de 1997"
26,4,58,763,180,178,358,"6 de julio de 1997"
26,4,58,764,289,309,598,"6 de julio de 1997"
26,4,58,765,695,651,1346,"6 de julio de 1997"
26,4,58,766,681,675,1356,"6 de julio de 1997"
26,4,58,767,631,629,1260,"6 de julio de 1997"
26,4,58,768,547,546,1093,"6 de julio de 1997"
26,4,58,769,466,492,958,"6 de julio de 1997"
26,4,58,770,386,353,739,"6 de julio de 1997"
26,4,58,771,602,553,1155,"6 de julio de 1997"
26,4,58,772,375,333,708,"6 de julio de 1997"
26,4,60,992,356,388,744,"6 de julio de 1997"
26,4,60,993,400,408,808,"6 de julio de 1997"
26,4,60,994,483,533,1016,"6 de julio de 1997"
26,4,60,995,468,482,950,"6 de julio de 1997"
26,4,60,996,537,525,1062,"6 de julio de 1997"
26,4,60,997,317,302,619,"6 de julio de 1997"
26,4,60,998,721,759,1480,"6 de julio de 1997"
26,4,60,999,479,498,977,"6 de julio de 1997"
26,4,60,1000,670,661,1331,"6 de julio de 1997"
26,4,60,1001,581,602,1183,"6 de julio de 1997"
26,4,60,1002,418,433,851,"6 de julio de 1997"
26,4,60,1003,449,468,917,"6 de julio de 1997"
26,4,60,1004,614,620,1234,"6 de julio de 1997"
26,4,60,1005,218,262,480,"6 de julio de 1997"
26,4,60,1006,538,514,1052,"6 de julio de 1997"
26,4,60,1007,496,555,1051,"6 de julio de 1997"
26,4,60,1008,385,428,813,"6 de julio de 1997"
26,4,60,1009,479,530,1009,"6 de julio de 1997"
26,4,60,1010,573,599,1172,"6 de julio de 1997"
26,4,60,1011,545,545,1090,"6 de julio de 1997"
26,4,60,1012,382,380,762,"6 de julio de 1997"
26,4,60,1013,573,577,1150,"6 de julio de 1997"
26,4,60,1014,580,634,1214,"6 de julio de 1997"
26,4,60,1015,738,665,1403,"6 de julio de 1997"
26,4,60,1016,350,289,639,"6 de julio de 1997"
26,4,60,1017,662,664,1326,"6 de julio de 1997"
26,4,60,1018,279,275,554,"6 de julio de 1997"
26,4,60,1019,241,199,440,"6 de julio de 1997"
26,4,60,1020,446,402,848,"6 de julio de 1997"
26,4,60,1021,352,332,684,"6 de julio de 1997"
26,4,61,1022,622,680,1302,"6 de julio de 1997"
26,4,61,1023,691,732,1423,"6 de julio de 1997"
26,4,61,1024,462,517,979,"6 de julio de 1997"
26,4,61,1025,319,318,637,"6 de julio de 1997"
26,4,61,1026,476,483,959,"6 de julio de 1997"
26,4,61,1027,555,574,1129,"6 de julio de 1997"
26,4,61,1028,808,898,1706,"6 de julio de 1997"
26,4,61,1029,674,601,1275,"6 de julio de 1997"
26,4,61,1030,164,185,349,"6 de julio de 1997"
26,4,61,1031,661,410,1071,"6 de julio de 1997"
26,4,61,1032,503,525,1028,"6 de julio de 1997"
26,4,61,1033,115,137,252,"6 de julio de 1997"
26,4,61,1034,649,695,1344,"6 de julio de 1997"
26,4,61,1035,626,609,1235,"6 de julio de 1997"
26,4,61,1036,531,542,1073,"6 de julio de 1997"
26,4,61,1037,437,452,889,"6 de julio de 1997"
26,4,61,1038,501,492,993,"6 de julio de 1997"
26,4,61,1039,612,643,1255,"6 de julio de 1997"
26,4,61,1040,543,568,1111,"6 de julio de 1997"
26,4,61,1041,351,394,745,"6 de julio de 1997"
26,4,61,1042,122,140,262,"6 de julio de 1997"
26,4,61,1043,494,520,1014,"6 de julio de 1997"
26,4,61,1044,584,656,1240,"6 de julio de 1997"
26,4,61,1045,598,607,1205,"6 de julio de 1997"
26,4,61,1046,455,443,898,"6 de julio de 1997"
26,4,61,1047,774,779,1553,"6 de julio de 1997"
26,4,61,1048,779,815,1594,"6 de julio de 1997"
26,4,61,1049,423,450,873,"6 de julio de 1997"
26,4,61,1050,404,394,798,"6 de julio de 1997"
26,4,61,1051,804,802,1606,"6 de julio de 1997"
26,4,61,1052,278,302,580,"6 de julio de 1997"
26,4,61,1053,442,410,852,"6 de julio de 1997"
26,4,61,1054,561,589,1150,"6 de julio de 1997"
26,4,61,1055,344,377,721,"6 de julio de 1997"
26,4,61,1056,646,658,1304,"6 de julio de 1997"
26,4,61,1057,352,352,704,"6 de julio de 1997"
26,4,61,1058,225,225,450,"6 de julio de 1997"
26,4,61,1059,473,533,1006,"6 de julio de 1997"
26,4,61,1060,365,422,787,"6 de julio de 1997"
26,4,61,1061,448,475,923,"6 de julio de 1997"
26,4,61,1062,524,578,1102,"6 de julio de 1997"
26,4,61,1063,306,328,634,"6 de julio de 1997"
26,4,61,1064,596,604,1200,"6 de julio de 1997"
26,4,61,1065,514,486,1000,"6 de julio de 1997"
26,4,61,1066,698,690,1388,"6 de julio de 1997"
26,4,61,1067,619,637,1256,"6 de julio de 1997"
26,4,61,1068,597,623,1220,"6 de julio de 1997"
26,4,61,1069,682,731,1413,"6 de julio de 1997"
26,4,61,1070,577,590,1167,"6 de julio de 1997"
26,4,61,1071,600,617,1217,"6 de julio de 1997"
26,4,61,1072,531,561,1092,"6 de julio de 1997"
26,4,61,1073,603,651,1254,"6 de julio de 1997"
26,4,61,1074,189,197,386,"6 de julio de 1997"
26,4,61,1075,437,507,944,"6 de julio de 1997"
26,4,61,1076,535,629,1164,"6 de julio de 1997"
26,4,61,1077,33,47,80,"6 de julio de 1997"
26,4,61,1078,288,276,564,"6 de julio de 1997"
26,4,61,1079,199,207,406,"6 de julio de 1997"
26,4,61,1080,373,454,827,"6 de julio de 1997"
26,4,61,1081,416,431,847,"6 de julio de 1997"
26,4,61,1082,481,457,938,"6 de julio de 1997"
26,4,61,1083,478,422,900,"6 de julio de 1997"
26,4,61,1084,553,419,972,"6 de julio de 1997"
26,4,61,1085,331,237,568,"6 de julio de 1997"
26,4,61,1086,52,39,91,"6 de julio de 1997"
26,4,61,1087,179,132,311,"6 de julio de 1997"
26,4,61,1088,220,181,401,"6 de julio de 1997"
26,4,61,1089,552,486,1038,"6 de julio de 1997"
26,4,61,1090,558,521,1079,"6 de julio de 1997"
26,4,61,1091,355,336,691,"6 de julio de 1997"
26,4,61,1092,304,282,586,"6 de julio de 1997"
26,4,61,1093,410,417,827,"6 de julio de 1997"
26,4,61,1094,602,630,1232,"6 de julio de 1997"
26,4,61,1095,488,525,1013,"6 de julio de 1997"
26,4,61,1096,397,375,772,"6 de julio de 1997"
26,4,61,1097,645,604,1249,"6 de julio de 1997"
26,4,61,1098,836,779,1615,"6 de julio de 1997"
26,4,61,1099,242,203,445,"6 de julio de 1997"
26,4,61,1100,354,351,705,"6 de julio de 1997"
26,4,66,1306,196,145,341,"6 de julio de 1997"
26,4,68,1310,482,464,946,"6 de julio de 1997"
26,4,68,1311,848,689,1537,"6 de julio de 1997"
26,4,68,1312,43,21,64,"6 de julio de 1997"
26,4,68,1313,94,61,155,"6 de julio de 1997"
26,4,68,1314,380,284,664,"6 de julio de 1997"
26,4,68,1315,157,126,283,"6 de julio de 1997"
26,4,69,1316,407,377,784,"6 de julio de 1997"
26,4,69,1317,371,317,688,"6 de julio de 1997"
26,4,69,1318,168,134,302,"6 de julio de 1997"
26,4,69,1319,286,232,518,"6 de julio de 1997"
26,4,69,1320,232,210,442,"6 de julio de 1997"
26,4,69,1321,96,75,171,"6 de julio de 1997"
26,4,69,1322,104,96,200,"6 de julio de 1997"
26,4,72,1101,144,148,292,"6 de julio de 1997"
26,4,72,1102,477,509,986,"6 de julio de 1997"
26,4,72,1103,378,354,732,"6 de julio de 1997"
26,4,72,1104,361,373,734,"6 de julio de 1997"
26,4,72,1105,526,545,1071,"6 de julio de 1997"
26,4,72,1106,464,406,870,"6 de julio de 1997"
26,4,72,1107,463,441,904,"6 de julio de 1997"
26,4,72,1108,247,199,446,"6 de julio de 1997"
26,5,49,414,786,829,1615,"6 de julio de 1997"
26,5,49,415,628,605,1233,"6 de julio de 1997"
26,5,49,416,506,522,1028,"6 de julio de 1997"
26,5,49,456,677,738,1415,"6 de julio de 1997"
26,5,49,457,355,394,749,"6 de julio de 1997"
26,5,49,458,383,481,864,"6 de julio de 1997"
26,5,49,460,574,637,1211,"6 de julio de 1997"
26,5,49,464,587,591,1178,"6 de julio de 1997"
26,5,49,465,727,728,1455,"6 de julio de 1997"
26,5,49,466,363,427,790,"6 de julio de 1997"
26,5,49,467,471,464,935,"6 de julio de 1997"
26,5,49,468,784,804,1588,"6 de julio de 1997"
26,5,49,469,267,327,594,"6 de julio de 1997"
26,5,49,470,369,406,775,"6 de julio de 1997"
26,5,49,471,779,819,1598,"6 de julio de 1997"
26,5,49,472,648,696,1344,"6 de julio de 1997"
26,5,49,473,551,612,1163,"6 de julio de 1997"
26,5,49,474,733,788,1521,"6 de julio de 1997"
26,5,49,475,565,589,1154,"6 de julio de 1997"
26,5,49,476,470,532,1002,"6 de julio de 1997"
26,5,49,477,530,605,1135,"6 de julio de 1997"
26,5,49,478,418,404,822,"6 de julio de 1997"
26,5,49,479,371,416,787,"6 de julio de 1997"
26,5,49,480,377,372,749,"6 de julio de 1997"
26,5,49,481,335,414,749,"6 de julio de 1997"
26,5,49,482,503,492,995,"6 de julio de 1997"
26,5,49,483,402,457,859,"6 de julio de 1997"
26,5,49,484,873,885,1758,"6 de julio de 1997"
26,5,49,485,465,504,969,"6 de julio de 1997"
26,5,49,486,643,645,1288,"6 de julio de 1997"
26,5,49,487,618,631,1249,"6 de julio de 1997"
26,5,49,488,602,548,1150,"6 de julio de 1997"
26,5,49,489,441,435,876,"6 de julio de 1997"
26,5,49,490,656,688,1344,"6 de julio de 1997"
26,5,49,491,456,454,910,"6 de julio de 1997"
26,5,49,492,509,502,1011,"6 de julio de 1997"
26,5,49,493,361,429,790,"6 de julio de 1997"
26,5,49,494,389,419,808,"6 de julio de 1997"
26,5,49,495,643,610,1253,"6 de julio de 1997"
26,5,49,496,781,794,1575,"6 de julio de 1997"
26,5,49,497,268,259,527,"6 de julio de 1997"
26,5,49,498,537,606,1143,"6 de julio de 1997"
26,5,49,499,413,461,874,"6 de julio de 1997"
26,5,49,500,331,353,684,"6 de julio de 1997"
26,5,49,501,677,773,1450,"6 de julio de 1997"
26,5,49,502,368,403,771,"6 de julio de 1997"
26,5,49,503,398,436,834,"6 de julio de 1997"
26,5,49,504,537,602,1139,"6 de julio de 1997"
26,5,49,505,700,813,1513,"6 de julio de 1997"
26,5,49,506,568,678,1246,"6 de julio de 1997"
26,5,49,507,361,334,695,"6 de julio de 1997"
26,5,49,508,603,673,1276,"6 de julio de 1997"
26,5,49,509,796,793,1589,"6 de julio de 1997"
26,5,49,510,534,559,1093,"6 de julio de 1997"
26,5,49,511,460,502,962,"6 de julio de 1997"
26,5,49,512,919,952,1871,"6 de julio de 1997"
26,5,49,513,467,454,921,"6 de julio de 1997"
26,5,49,514,623,623,1246,"6 de julio de 1997"
26,5,49,515,206,199,405,"6 de julio de 1997"
26,5,49,516,236,252,488,"6 de julio de 1997"
26,5,49,517,533,592,1125,"6 de julio de 1997"
26,5,49,518,350,386,736,"6 de julio de 1997"
26,5,49,519,397,501,898,"6 de julio de 1997"
26,5,49,520,492,509,1001,"6 de julio de 1997"
26,5,49,521,418,480,898,"6 de julio de 1997"
26,5,49,522,538,616,1154,"6 de julio de 1997"
26,5,49,523,305,319,624,"6 de julio de 1997"
26,5,49,524,720,772,1492,"6 de julio de 1997"
26,5,49,525,521,567,1088,"6 de julio de 1997"
26,5,49,526,279,303,582,"6 de julio de 1997"
26,5,49,527,529,561,1090,"6 de julio de 1997"
26,5,49,528,554,563,1117,"6 de julio de 1997"
26,5,49,529,568,554,1122,"6 de julio de 1997"
26,5,49,530,429,433,862,"6 de julio de 1997"
26,5,49,531,451,500,951,"6 de julio de 1997"
26,5,49,532,761,782,1543,"6 de julio de 1997"
26,5,49,533,429,441,870,"6 de julio de 1997"
26,5,49,534,421,419,840,"6 de julio de 1997"
26,5,49,535,373,397,770,"6 de julio de 1997"
26,5,49,536,491,497,988,"6 de julio de 1997"
26,5,49,537,621,652,1273,"6 de julio de 1997"
26,5,49,538,627,649,1276,"6 de julio de 1997"
26,5,49,539,463,535,998,"6 de julio de 1997"
26,5,49,540,316,361,677,"6 de julio de 1997"
26,5,49,541,659,673,1332,"6 de julio de 1997"
26,5,49,542,444,475,919,"6 de julio de 1997"
26,5,49,543,317,314,631,"6 de julio de 1997"
26,5,49,544,603,680,1283,"6 de julio de 1997"
26,5,49,545,658,727,1385,"6 de julio de 1997"
26,5,49,546,402,459,861,"6 de julio de 1997"
26,5,49,547,430,417,847,"6 de julio de 1997"
26,5,49,548,492,522,1014,"6 de julio de 1997"
26,5,49,549,462,520,982,"6 de julio de 1997"
26,5,49,550,339,413,752,"6 de julio de 1997"
26,5,49,551,454,487,941,"6 de julio de 1997"
26,5,49,552,458,486,944,"6 de julio de 1997"
26,5,49,553,423,451,874,"6 de julio de 1997"
26,5,49,554,380,409,789,"6 de julio de 1997"
26,5,49,555,624,660,1284,"6 de julio de 1997"
26,5,49,556,675,677,1352,"6 de julio de 1997"
26,5,49,557,391,438,829,"6 de julio de 1997"
26,5,49,558,837,821,1658,"6 de julio de 1997"
26,5,49,559,622,683,1305,"6 de julio de 1997"
26,5,49,560,526,530,1056,"6 de julio de 1997"
26,5,49,561,465,435,900,"6 de julio de 1997"
26,5,49,562,381,393,774,"6 de julio de 1997"
26,5,49,563,542,535,1077,"6 de julio de 1997"
26,5,49,564,645,669,1314,"6 de julio de 1997"
26,5,49,565,805,792,1597,"6 de julio de 1997"
26,5,49,566,460,513,973,"6 de julio de 1997"
26,5,49,567,613,604,1217,"6 de julio de 1997"
26,5,49,568,605,654,1259,"6 de julio de 1997"
26,5,49,569,858,854,1712,"6 de julio de 1997"
26,5,49,570,496,496,992,"6 de julio de 1997"
26,5,49,571,609,573,1182,"6 de julio de 1997"
26,5,49,572,410,420,830,"6 de julio de 1997"
26,5,49,573,448,448,896,"6 de julio de 1997"
26,5,49,574,392,442,834,"6 de julio de 1997"
26,5,49,575,413,505,918,"6 de julio de 1997"
26,5,49,576,325,415,740,"6 de julio de 1997"
26,5,49,577,340,329,669,"6 de julio de 1997"
26,5,49,578,307,354,661,"6 de julio de 1997"
26,5,49,579,453,507,960,"6 de julio de 1997"
26,5,49,580,531,608,1139,"6 de julio de 1997"
26,5,49,581,532,548,1080,"6 de julio de 1997"
26,5,49,582,483,581,1064,"6 de julio de 1997"
26,5,49,583,2259,2632,4891,"6 de julio de 1997"
26,5,49,584,519,508,1027,"6 de julio de 1997"
26,5,49,590,806,768,1574,"6 de julio de 1997"
26,5,49,594,65,51,116,"6 de julio de 1997"
26,5,49,595,132,126,258,"6 de julio de 1997"
26,5,49,597,261,156,417,"6 de julio de 1997"
26,5,49,598,1068,942,2010,"6 de julio de 1997"
26,5,49,599,180,138,318,"6 de julio de 1997"
26,5,49,600,271,253,524,"6 de julio de 1997"
26,5,49,601,1614,1516,3130,"6 de julio de 1997"
26,5,49,602,742,656,1398,"6 de julio de 1997"
26,5,49,603,1009,909,1918,"6 de julio de 1997"
26,5,49,604,850,531,1381,"6 de julio de 1997"
26,5,49,605,908,924,1832,"6 de julio de 1997"
26,5,49,606,478,356,834,"6 de julio de 1997"
26,5,49,607,21,12,33,"6 de julio de 1997"
26,5,49,608,316,229,545,"6 de julio de 1997"
26,5,49,609,250,190,440,"6 de julio de 1997"
26,5,49,610,277,182,459,"6 de julio de 1997"
26,5,49,611,241,196,437,"6 de julio de 1997"
26,5,49,612,144,100,244,"6 de julio de 1997"
26,5,49,613,80,62,142,"6 de julio de 1997"
26,5,49,614,145,101,246,"6 de julio de 1997"
26,5,49,615,357,222,579,"6 de julio de 1997"
26,5,49,616,99,78,177,"6 de julio de 1997"
26,5,49,617,35,29,64,"6 de julio de 1997"
26,5,49,618,108,101,209,"6 de julio de 1997"
26,6,59,773,551,566,1117,"6 de julio de 1997"
26,6,59,774,239,264,503,"6 de julio de 1997"
26,6,59,775,140,149,289,"6 de julio de 1997"
26,6,59,776,540,575,1115,"6 de julio de 1997"
26,6,59,777,519,533,1052,"6 de julio de 1997"
26,6,59,778,446,499,945,"6 de julio de 1997"
26,6,59,779,512,527,1039,"6 de julio de 1997"
26,6,59,780,570,622,1192,"6 de julio de 1997"
26,6,59,781,351,378,729,"6 de julio de 1997"
26,6,59,782,366,409,775,"6 de julio de 1997"
26,6,59,783,561,632,1193,"6 de julio de 1997"
26,6,59,784,519,563,1082,"6 de julio de 1997"
26,6,59,785,457,452,909,"6 de julio de 1997"
26,6,59,786,866,905,1771,"6 de julio de 1997"
26,6,59,787,460,463,923,"6 de julio de 1997"
26,6,59,788,477,543,1020,"6 de julio de 1997"
26,6,59,789,712,724,1436,"6 de julio de 1997"
26,6,59,790,578,654,1232,"6 de julio de 1997"
26,6,59,791,376,388,764,"6 de julio de 1997"
26,6,59,792,565,642,1207,"6 de julio de 1997"
26,6,59,793,557,637,1194,"6 de julio de 1997"
26,6,59,794,427,422,849,"6 de julio de 1997"
26,6,59,795,747,820,1567,"6 de julio de 1997"
26,6,59,796,693,687,1380,"6 de julio de 1997"
26,6,59,797,383,423,806,"6 de julio de 1997"
26,6,59,798,237,256,493,"6 de julio de 1997"
26,6,59,799,367,394,761,"6 de julio de 1997"
26,6,59,800,464,501,965,"6 de julio de 1997"
26,6,59,801,320,316,636,"6 de julio de 1997"
26,6,59,802,427,525,952,"6 de julio de 1997"
26,6,59,803,485,551,1036,"6 de julio de 1997"
26,6,59,804,488,541,1029,"6 de julio de 1997"
26,6,59,805,344,379,723,"6 de julio de 1997"
26,6,59,806,393,431,824,"6 de julio de 1997"
26,6,59,807,501,577,1078,"6 de julio de 1997"
26,6,59,808,587,613,1200,"6 de julio de 1997"
26,6,59,809,527,554,1081,"6 de julio de 1997"
26,6,59,810,538,613,1151,"6 de julio de 1997"
26,6,59,811,529,609,1138,"6 de julio de 1997"
26,6,59,812,635,712,1347,"6 de julio de 1997"
26,6,59,813,420,490,910,"6 de julio de 1997"
26,6,59,814,811,866,1677,"6 de julio de 1997"
26,6,59,815,417,447,864,"6 de julio de 1997"
26,6,59,816,437,491,928,"6 de julio de 1997"
26,6,59,817,346,397,743,"6 de julio de 1997"
26,6,59,818,210,238,448,"6 de julio de 1997"
26,6,59,819,176,166,342,"6 de julio de 1997"
26,6,59,820,541,549,1090,"6 de julio de 1997"
26,6,59,821,132,148,280,"6 de julio de 1997"
26,6,59,822,603,732,1335,"6 de julio de 1997"
26,6,59,823,356,382,738,"6 de julio de 1997"
26,6,59,824,343,391,734,"6 de julio de 1997"
26,6,59,825,246,242,488,"6 de julio de 1997"
26,6,59,826,404,419,823,"6 de julio de 1997"
26,6,59,827,388,442,830,"6 de julio de 1997"
26,6,59,828,322,341,663,"6 de julio de 1997"
26,6,59,829,142,166,308,"6 de julio de 1997"
26,6,59,830,688,732,1420,"6 de julio de 1997"
26,6,59,831,218,224,442,"6 de julio de 1997"
26,6,59,832,442,455,897,"6 de julio de 1997"
26,6,59,833,548,605,1153,"6 de julio de 1997"
26,6,59,834,275,333,608,"6 de julio de 1997"
26,6,59,835,262,312,574,"6 de julio de 1997"
26,6,59,836,273,281,554,"6 de julio de 1997"
26,6,59,837,569,580,1149,"6 de julio de 1997"
26,6,59,838,455,485,940,"6 de julio de 1997"
26,6,59,839,310,329,639,"6 de julio de 1997"
26,6,59,840,225,249,474,"6 de julio de 1997"
26,6,59,841,338,403,741,"6 de julio de 1997"
26,6,59,842,461,525,986,"6 de julio de 1997"
26,6,59,843,306,327,633,"6 de julio de 1997"
26,6,59,844,401,457,858,"6 de julio de 1997"
26,6,59,845,373,433,806,"6 de julio de 1997"
26,6,59,846,478,595,1073,"6 de julio de 1997"
26,6,59,847,288,333,621,"6 de julio de 1997"
26,6,59,848,313,383,696,"6 de julio de 1997"
26,6,59,849,665,781,1446,"6 de julio de 1997"
26,6,59,850,309,330,639,"6 de julio de 1997"
26,6,59,851,344,438,782,"6 de julio de 1997"
26,6,59,852,317,368,685,"6 de julio de 1997"
26,6,59,853,399,509,908,"6 de julio de 1997"
26,6,59,854,333,396,729,"6 de julio de 1997"
26,6,59,855,500,591,1091,"6 de julio de 1997"
26,6,59,856,597,666,1263,"6 de julio de 1997"
26,6,59,857,520,570,1090,"6 de julio de 1997"
26,6,59,858,292,299,591,"6 de julio de 1997"
26,6,59,859,437,479,916,"6 de julio de 1997"
26,6,59,860,398,464,862,"6 de julio de 1997"
26,6,59,861,576,614,1190,"6 de julio de 1997"
26,6,59,862,500,542,1042,"6 de julio de 1997"
26,6,59,863,524,546,1070,"6 de julio de 1997"
26,6,59,864,491,529,1020,"6 de julio de 1997"
26,6,59,865,511,575,1086,"6 de julio de 1997"
26,6,59,866,477,532,1009,"6 de julio de 1997"
26,6,59,867,666,740,1406,"6 de julio de 1997"
26,6,59,868,403,427,830,"6 de julio de 1997"
26,6,59,869,392,430,822,"6 de julio de 1997"
26,6,59,870,385,404,789,"6 de julio de 1997"
26,6,59,871,598,613,1211,"6 de julio de 1997"
26,6,59,872,431,485,916,"6 de julio de 1997"
26,6,59,873,471,494,965,"6 de julio de 1997"
26,6,59,874,333,395,728,"6 de julio de 1997"
26,6,59,875,636,723,1359,"6 de julio de 1997"
26,6,59,876,245,259,504,"6 de julio de 1997"
26,6,59,877,237,268,505,"6 de julio de 1997"
26,6,59,878,416,457,873,"6 de julio de 1997"
26,6,59,879,433,457,890,"6 de julio de 1997"
26,6,59,880,522,568,1090,"6 de julio de 1997"
26,6,59,881,520,539,1059,"6 de julio de 1997"
26,6,59,882,425,517,942,"6 de julio de 1997"
26,6,59,883,441,493,934,"6 de julio de 1997"
26,6,59,884,364,375,739,"6 de julio de 1997"
26,6,59,885,621,670,1291,"6 de julio de 1997"
26,6,59,886,482,562,1044,"6 de julio de 1997"
26,6,59,887,364,404,768,"6 de julio de 1997"
26,6,59,888,783,757,1540,"6 de julio de 1997"
26,6,59,889,546,522,1068,"6 de julio de 1997"
26,6,59,890,706,699,1405,"6 de julio de 1997"
26,6,59,891,407,430,837,"6 de julio de 1997"
26,6,59,892,373,393,766,"6 de julio de 1997"
26,6,59,893,458,487,945,"6 de julio de 1997"
26,6,59,894,318,376,694,"6 de julio de 1997"
26,6,59,895,271,329,600,"6 de julio de 1997"
26,6,59,896,388,438,826,"6 de julio de 1997"
26,6,59,897,427,498,925,"6 de julio de 1997"
26,6,59,898,398,487,885,"6 de julio de 1997"
26,6,59,899,395,441,836,"6 de julio de 1997"
26,6,59,900,388,409,797,"6 de julio de 1997"
26,6,59,901,569,618,1187,"6 de julio de 1997"
26,6,59,902,407,445,852,"6 de julio de 1997"
26,6,59,903,350,389,739,"6 de julio de 1997"
26,6,59,904,320,350,670,"6 de julio de 1997"
26,6,59,905,362,407,769,"6 de julio de 1997"
26,6,59,906,593,618,1211,"6 de julio de 1997"
26,6,59,907,666,753,1419,"6 de julio de 1997"
26,6,59,908,485,581,1066,"6 de julio de 1997"
26,6,59,909,481,527,1008,"6 de julio de 1997"
26,6,59,910,399,448,847,"6 de julio de 1997"
26,6,59,911,544,553,1097,"6 de julio de 1997"
26,6,59,912,523,556,1079,"6 de julio de 1997"
26,6,59,913,411,488,899,"6 de julio de 1997"
26,6,59,914,394,398,792,"6 de julio de 1997"
26,6,59,915,360,410,770,"6 de julio de 1997"
26,6,59,916,594,694,1288,"6 de julio de 1997"
26,6,59,917,298,368,666,"6 de julio de 1997"
26,6,59,918,360,388,748,"6 de julio de 1997"
26,6,59,919,539,629,1168,"6 de julio de 1997"
26,6,59,920,456,476,932,"6 de julio de 1997"
26,6,59,921,550,606,1156,"6 de julio de 1997"
26,6,59,922,426,500,926,"6 de julio de 1997"
26,6,59,923,310,359,669,"6 de julio de 1997"
26,6,59,924,352,424,776,"6 de julio de 1997"
26,6,59,925,374,442,816,"6 de julio de 1997"
26,6,59,926,391,430,821,"6 de julio de 1997"
26,6,59,927,418,432,850,"6 de julio de 1997"
26,6,59,928,423,475,898,"6 de julio de 1997"
26,6,59,929,427,515,942,"6 de julio de 1997"
26,6,59,930,445,554,999,"6 de julio de 1997"
26,6,59,931,361,406,767,"6 de julio de 1997"
26,6,59,932,402,485,887,"6 de julio de 1997"
26,6,59,933,157,91,248,"6 de julio de 1997"
26,6,59,934,191,153,344,"6 de julio de 1997"
26,6,59,935,323,279,602,"6 de julio de 1997"
26,6,59,936,587,637,1224,"6 de julio de 1997"
26,6,59,937,681,698,1379,"6 de julio de 1997"
26,6,59,938,335,313,648,"6 de julio de 1997"
26,6,59,939,592,627,1219,"6 de julio de 1997"
26,6,59,940,768,797,1565,"6 de julio de 1997"
26,6,59,941,351,362,713,"6 de julio de 1997"
26,6,59,942,579,557,1136,"6 de julio de 1997"
26,6,59,943,699,812,1511,"6 de julio de 1997"
26,6,59,944,419,396,815,"6 de julio de 1997"
26,6,59,945,487,545,1032,"6 de julio de 1997"
26,6,59,946,508,552,1060,"6 de julio de 1997"
26,6,59,947,759,778,1537,"6 de julio de 1997"
26,6,59,948,626,572,1198,"6 de julio de 1997"
26,6,59,949,869,964,1833,"6 de julio de 1997"
26,6,59,950,457,545,1002,"6 de julio de 1997"
26,6,59,951,1516,1236,2752,"6 de julio de 1997"
26,6,59,952,297,284,581,"6 de julio de 1997"
26,6,59,953,185,198,383,"6 de julio de 1997"
26,6,59,954,372,350,722,"6 de julio de 1997"
26,6,59,955,240,192,432,"6 de julio de 1997"
26,6,59,956,432,435,867,"6 de julio de 1997"
26,6,59,957,427,458,885,"6 de julio de 1997"
26,6,59,958,500,498,998,"6 de julio de 1997"
26,6,59,959,478,500,978,"6 de julio de 1997"
26,6,59,960,422,401,823,"6 de julio de 1997"
26,6,59,961,427,467,894,"6 de julio de 1997"
26,6,59,962,283,281,564,"6 de julio de 1997"
26,6,59,963,165,148,313,"6 de julio de 1997"
26,6,59,964,666,660,1326,"6 de julio de 1997"
26,6,59,965,396,371,767,"6 de julio de 1997"
26,6,59,966,975,875,1850,"6 de julio de 1997"
26,6,59,967,416,420,836,"6 de julio de 1997"
26,6,59,968,504,489,993,"6 de julio de 1997"
26,6,59,969,461,464,925,"6 de julio de 1997"
26,6,59,970,422,448,870,"6 de julio de 1997"
26,6,59,971,613,565,1178,"6 de julio de 1997"
26,6,59,972,400,362,762,"6 de julio de 1997"
26,6,59,973,564,601,1165,"6 de julio de 1997"
26,6,59,974,525,496,1021,"6 de julio de 1997"
26,6,59,975,605,633,1238,"6 de julio de 1997"
26,6,59,976,655,648,1303,"6 de julio de 1997"
26,6,59,977,688,695,1383,"6 de julio de 1997"
26,6,59,978,640,673,1313,"6 de julio de 1997"
26,6,59,979,472,492,964,"6 de julio de 1997"
26,6,59,980,571,531,1102,"6 de julio de 1997"
26,6,59,981,370,365,735,"6 de julio de 1997"
26,6,59,982,245,263,508,"6 de julio de 1997"
26,6,59,983,642,561,1203,"6 de julio de 1997"
26,6,59,984,278,228,506,"6 de julio de 1997"
26,6,59,985,282,278,560,"6 de julio de 1997"
26,6,59,986,460,445,905,"6 de julio de 1997"
26,6,59,987,467,469,936,"6 de julio de 1997"
26,6,59,988,144,116,260,"6 de julio de 1997"
26,6,59,989,253,239,492,"6 de julio de 1997"
26,6,59,990,189,139,328,"6 de julio de 1997"
26,6,59,991,920,937,1857,"6 de julio de 1997"
26,7,62,1109,926,925,1851,"6 de julio de 1997"
26,7,62,1110,563,557,1120,"6 de julio de 1997"
26,7,62,1111,487,506,993,"6 de julio de 1997"
26,7,62,1112,483,472,955,"6 de julio de 1997"
26,7,62,1113,339,241,580,"6 de julio de 1997"
26,7,62,1114,102,69,171,"6 de julio de 1997"
26,7,62,1115,344,312,656,"6 de julio de 1997"
26,7,62,1116,150,96,246,"6 de julio de 1997"
26,7,62,1117,147,127,274,"6 de julio de 1997"
26,7,62,1118,242,184,426,"6 de julio de 1997"
26,7,62,1119,60,33,93,"6 de julio de 1997"
26,7,62,1120,129,79,208,"6 de julio de 1997"
26,7,62,1121,168,121,289,"6 de julio de 1997"
26,7,62,1122,256,202,458,"6 de julio de 1997"
26,7,62,1123,263,213,476,"6 de julio de 1997"
26,7,62,1124,518,411,929,"6 de julio de 1997"
26,7,62,1125,262,206,468,"6 de julio de 1997"
26,7,62,1126,70,38,108,"6 de julio de 1997"
26,7,62,1127,72,47,119,"6 de julio de 1997"
26,7,62,1128,138,94,232,"6 de julio de 1997"
26,7,62,1129,66,41,107,"6 de julio de 1997"
26,7,62,1130,482,389,871,"6 de julio de 1997"
26,7,62,1131,338,258,596,"6 de julio de 1997"
26,7,62,1132,181,114,295,"6 de julio de 1997"
26,7,62,1133,320,245,565,"6 de julio de 1997"
26,7,62,1134,278,201,479,"6 de julio de 1997"
26,7,62,1135,280,192,472,"6 de julio de 1997"
26,7,62,1136,137,136,273,"6 de julio de 1997"
26,7,62,1137,294,223,517,"6 de julio de 1997"
26,7,63,1138,485,487,972,"6 de julio de 1997"
26,7,63,1139,410,433,843,"6 de julio de 1997"
26,7,63,1140,645,621,1266,"6 de julio de 1997"
26,7,63,1141,433,442,875,"6 de julio de 1997"
26,7,63,1143,179,162,341,"6 de julio de 1997"
26,7,63,1144,95,76,171,"6 de julio de 1997"
26,7,63,1145,535,425,960,"6 de julio de 1997"
26,7,63,1153,298,253,551,"6 de julio de 1997"
26,7,63,1154,96,94,190,"6 de julio de 1997"
26,7,63,1158,571,538,1109,"6 de julio de 1997"
26,7,63,1159,575,464,1039,"6 de julio de 1997"
26,7,63,1160,365,341,706,"6 de julio de 1997"
26,7,63,1161,364,293,657,"6 de julio de 1997"
26,7,63,1162,381,325,706,"6 de julio de 1997"
26,7,63,1163,446,408,854,"6 de julio de 1997"
26,7,63,1164,205,167,372,"6 de julio de 1997"
26,7,63,1165,506,518,1024,"6 de julio de 1997"
26,7,63,1166,462,421,883,"6 de julio de 1997"
26,7,63,1167,421,416,837,"6 de julio de 1997"
26,7,63,1168,671,672,1343,"6 de julio de 1997"
26,7,63,1169,208,209,417,"6 de julio de 1997"
26,7,63,1170,567,603,1170,"6 de julio de 1997"
26,7,63,1171,444,470,914,"6 de julio de 1997"
26,7,63,1172,292,304,596,"6 de julio de 1997"
26,7,63,1173,241,242,483,"6 de julio de 1997"
26,7,63,1174,771,760,1531,"6 de julio de 1997"
26,7,63,1175,208,176,384,"6 de julio de 1997"
26,7,63,1176,371,341,712,"6 de julio de 1997"
26,7,63,1177,157,149,306,"6 de julio de 1997"
26,7,63,1178,783,790,1573,"6 de julio de 1997"
26,7,63,1179,287,240,527,"6 de julio de 1997"
26,7,63,1180,339,301,640,"6 de julio de 1997"
26,7,63,1181,716,656,1372,"6 de julio de 1997"
26,7,63,1182,508,437,945,"6 de julio de 1997"
26,7,63,1183,655,614,1269,"6 de julio de 1997"
26,7,63,1184,812,703,1515,"6 de julio de 1997"
26,7,63,1185,364,318,682,"6 de julio de 1997"
26,7,63,1186,465,457,922,"6 de julio de 1997"
26,7,63,1187,437,573,1010,"6 de julio de 1997"
26,7,63,1188,439,507,946,"6 de julio de 1997"
26,7,64,1189,519,517,1036,"6 de julio de 1997"
26,7,64,1190,790,849,1639,"6 de julio de 1997"
26,7,64,1191,536,543,1079,"6 de julio de 1997"
26,7,64,1192,678,701,1379,"6 de julio de 1997"
26,7,64,1193,551,576,1127,"6 de julio de 1997"
26,7,64,1194,526,583,1109,"6 de julio de 1997"
26,7,64,1195,657,740,1397,"6 de julio de 1997"
26,7,64,1196,254,269,523,"6 de julio de 1997"
26,7,64,1197,695,688,1383,"6 de julio de 1997"
26,7,64,1198,436,440,876,"6 de julio de 1997"
26,7,64,1199,767,892,1659,"6 de julio de 1997"
26,7,64,1200,258,280,538,"6 de julio de 1997"
26,7,64,1201,685,692,1377,"6 de julio de 1997"
26,7,64,1202,493,501,994,"6 de julio de 1997"
26,7,64,1203,777,840,1617,"6 de julio de 1997"
26,7,64,1204,371,328,699,"6 de julio de 1997"
26,7,64,1205,528,516,1044,"6 de julio de 1997"
26,7,64,1206,384,381,765,"6 de julio de 1997"
26,7,64,1207,451,431,882,"6 de julio de 1997"
26,7,64,1208,477,409,886,"6 de julio de 1997"
26,7,64,1209,648,568,1216,"6 de julio de 1997"
26,7,64,1210,466,427,893,"6 de julio de 1997"
26,7,64,1211,698,700,1398,"6 de julio de 1997"
26,7,64,1212,733,736,1469,"6 de julio de 1997"
26,7,64,1213,807,770,1577,"6 de julio de 1997"
26,7,64,1214,223,182,405,"6 de julio de 1997"
26,7,64,1215,722,670,1392,"6 de julio de 1997"
26,7,64,1216,742,746,1488,"6 de julio de 1997"
26,7,64,1217,795,716,1511,"6 de julio de 1997"
26,7,64,1218,843,815,1658,"6 de julio de 1997"
26,7,64,1219,359,332,691,"6 de julio de 1997"
26,7,64,1220,592,559,1151,"6 de julio de 1997"
26,7,64,1221,541,502,1043,"6 de julio de 1997"
26,7,64,1222,392,294,686,"6 de julio de 1997"
26,7,64,1223,194,173,367,"6 de julio de 1997"
26,7,64,1224,458,477,935,"6 de julio de 1997"
26,7,64,1225,578,533,1111,"6 de julio de 1997"
26,7,64,1226,617,606,1223,"6 de julio de 1997"
26,7,64,1227,200,168,368,"6 de julio de 1997"
26,7,64,1228,714,635,1349,"6 de julio de 1997"
26,7,64,1229,410,443,853,"6 de julio de 1997"
26,7,65,1230,677,670,1347,"6 de julio de 1997"
26,7,65,1231,390,442,832,"6 de julio de 1997"
26,7,65,1232,717,725,1442,"6 de julio de 1997"
26,7,65,1233,439,518,957,"6 de julio de 1997"
26,7,65,1234,687,649,1336,"6 de julio de 1997"
26,7,65,1235,467,513,980,"6 de julio de 1997"
26,7,65,1236,694,789,1483,"6 de julio de 1997"
26,7,65,1237,474,531,1005,"6 de julio de 1997"
26,7,65,1238,461,493,954,"6 de julio de 1997"
26,7,65,1239,841,892,1733,"6 de julio de 1997"
26,7,65,1240,142,157,299,"6 de julio de 1997"
26,7,65,1241,228,216,444,"6 de julio de 1997"
26,7,65,1242,279,293,572,"6 de julio de 1997"
26,7,65,1243,638,713,1351,"6 de julio de 1997"
26,7,65,1244,680,745,1425,"6 de julio de 1997"
26,7,65,1245,472,496,968,"6 de julio de 1997"
26,7,65,1246,644,711,1355,"6 de julio de 1997"
26,7,65,1247,745,806,1551,"6 de julio de 1997"
26,7,65,1248,313,318,631,"6 de julio de 1997"
26,7,65,1249,596,663,1259,"6 de julio de 1997"
26,7,65,1250,521,547,1068,"6 de julio de 1997"
26,7,65,1251,638,699,1337,"6 de julio de 1997"
26,7,65,1252,1020,1070,2090,"6 de julio de 1997"
26,7,65,1253,757,795,1552,"6 de julio de 1997"
26,7,65,1254,669,685,1354,"6 de julio de 1997"
26,7,65,1255,423,507,930,"6 de julio de 1997"
26,7,65,1256,573,575,1148,"6 de julio de 1997"
26,7,65,1257,745,843,1588,"6 de julio de 1997"
26,7,65,1258,596,607,1203,"6 de julio de 1997"
26,7,65,1259,535,564,1099,"6 de julio de 1997"
26,7,65,1260,993,1074,2067,"6 de julio de 1997"
26,7,65,1261,534,591,1125,"6 de julio de 1997"
26,7,65,1262,373,424,797,"6 de julio de 1997"
26,7,65,1263,1007,1018,2025,"6 de julio de 1997"
26,7,65,1264,727,786,1513,"6 de julio de 1997"
26,7,65,1265,766,859,1625,"6 de julio de 1997"
26,7,65,1266,535,656,1191,"6 de julio de 1997"
26,7,65,1267,535,560,1095,"6 de julio de 1997"
26,7,65,1268,671,657,1328,"6 de julio de 1997"
26,7,65,1269,649,744,1393,"6 de julio de 1997"
26,7,65,1270,649,604,1253,"6 de julio de 1997"
26,7,65,1271,465,394,859,"6 de julio de 1997"
26,7,65,1272,300,238,538,"6 de julio de 1997"
26,7,65,1273,250,207,457,"6 de julio de 1997"
26,7,65,1274,152,119,271,"6 de julio de 1997"
26,7,65,1275,345,302,647,"6 de julio de 1997"
26,7,65,1276,508,425,933,"6 de julio de 1997"
26,7,65,1277,527,532,1059,"6 de julio de 1997"
26,7,65,1278,773,721,1494,"6 de julio de 1997"
26,7,65,1279,463,486,949,"6 de julio de 1997"
26,7,65,1280,533,427,960,"6 de julio de 1997"
26,7,65,1281,274,226,500,"6 de julio de 1997"
26,7,65,1282,493,449,942,"6 de julio de 1997"
26,7,65,1283,405,390,795,"6 de julio de 1997"
26,7,65,1284,635,584,1219,"6 de julio de 1997"
26,7,65,1285,289,299,588,"6 de julio de 1997"
26,7,65,1286,581,483,1064,"6 de julio de 1997"
26,7,65,1287,441,378,819,"6 de julio de 1997"
26,7,65,1288,499,493,992,"6 de julio de 1997"
26,7,65,1289,748,736,1484,"6 de julio de 1997"
26,7,65,1290,639,608,1247,"6 de julio de 1997"
26,7,65,1291,996,930,1926,"6 de julio de 1997"
26,7,65,1292,626,605,1231,"6 de julio de 1997"
26,7,65,1293,598,574,1172,"6 de julio de 1997"
26,7,65,1294,434,372,806,"6 de julio de 1997"
26,7,65,1295,445,405,850,"6 de julio de 1997"
26,7,65,1296,400,375,775,"6 de julio de 1997"
26,7,65,1297,717,662,1379,"6 de julio de 1997"
26,7,65,1298,446,346,792,"6 de julio de 1997"
26,7,65,1299,191,186,377,"6 de julio de 1997"
26,7,65,1300,779,692,1471,"6 de julio de 1997"
26,7,65,1301,232,212,444,"6 de julio de 1997"
26,7,65,1302,382,431,813,"6 de julio de 1997"
26,7,65,1303,531,585,1116,"6 de julio de 1997"
26,7,65,1304,474,521,995,"6 de julio de 1997"
26,7,65,1305,360,392,752,"6 de julio de 1997"
26,7,67,1307,494,415,909,"6 de julio de 1997"
26,7,67,1308,381,289,670,"6 de julio de 1997"
26,7,67,1309,222,174,396,"6 de julio de 1997"
26,7,71,1142,364,394,758,"6 de julio de 1997"
26,7,71,1146,396,396,792,"6 de julio de 1997"
26,7,71,1147,541,540,1081,"6 de julio de 1997"
26,7,71,1148,548,575,1123,"6 de julio de 1997"
26,7,71,1149,480,520,1000,"6 de julio de 1997"
26,7,71,1150,698,708,1406,"6 de julio de 1997"
26,7,71,1151,520,559,1079,"6 de julio de 1997"
26,7,71,1152,444,471,915,"6 de julio de 1997"
26,7,71,1155,386,357,743,"6 de julio de 1997"
26,7,71,1156,501,512,1013,"6 de julio de 1997"
26,7,71,1157,167,146,313,"6 de julio de 1997"
26,7,71,1331,228,228,456,"6 de julio de 1997"
27,1,1,1,503,502,1005,"6 de julio de 1997"
27,1,1,2,437,443,880,"6 de julio de 1997"
27,1,1,3,449,477,926,"6 de julio de 1997"
27,1,1,4,462,484,946,"6 de julio de 1997"
27,1,1,5,499,554,1053,"6 de julio de 1997"
27,1,1,6,304,354,658,"6 de julio de 1997"
27,1,1,7,463,424,887,"6 de julio de 1997"
27,1,1,8,326,230,556,"6 de julio de 1997"
27,1,1,9,473,358,831,"6 de julio de 1997"
27,1,1,10,86,62,148,"6 de julio de 1997"
27,1,1,11,166,143,309,"6 de julio de 1997"
27,1,1,12,230,174,404,"6 de julio de 1997"
27,1,1,13,389,361,750,"6 de julio de 1997"
27,1,1,14,296,335,631,"6 de julio de 1997"
27,1,1,15,398,381,779,"6 de julio de 1997"
27,1,1,16,311,345,656,"6 de julio de 1997"
27,1,1,17,362,344,706,"6 de julio de 1997"
27,1,1,18,461,347,808,"6 de julio de 1997"
27,1,1,19,99,67,166,"6 de julio de 1997"
27,1,1,20,271,242,513,"6 de julio de 1997"
27,1,1,21,117,92,209,"6 de julio de 1997"
27,1,1,22,338,282,620,"6 de julio de 1997"
27,1,1,23,401,309,710,"6 de julio de 1997"
27,1,1,24,643,531,1174,"6 de julio de 1997"
27,1,1,25,279,224,503,"6 de julio de 1997"
27,1,1,26,30,28,58,"6 de julio de 1997"
27,1,1,27,306,253,559,"6 de julio de 1997"
27,1,1,28,302,321,623,"6 de julio de 1997"
27,1,1,29,225,179,404,"6 de julio de 1997"
27,1,1,30,337,245,582,"6 de julio de 1997"
27,1,1,31,86,63,149,"6 de julio de 1997"
27,1,1,32,106,65,171,"6 de julio de 1997"
27,1,1,33,173,134,307,"6 de julio de 1997"
27,1,1,34,160,136,296,"6 de julio de 1997"
27,1,1,35,512,477,989,"6 de julio de 1997"
27,1,1,36,258,242,500,"6 de julio de 1997"
27,1,1,37,515,430,945,"6 de julio de 1997"
27,1,1,38,345,259,604,"6 de julio de 1997"
27,1,1,39,349,302,651,"6 de julio de 1997"
27,1,1,40,339,281,620,"6 de julio de 1997"
27,1,1,41,342,306,648,"6 de julio de 1997"
27,1,1,42,507,425,932,"6 de julio de 1997"
27,1,1,43,458,454,912,"6 de julio de 1997"
27,1,1,44,477,407,884,"6 de julio de 1997"
27,1,1,45,412,317,729,"6 de julio de 1997"
27,1,3,168,406,374,780,"6 de julio de 1997"
27,1,3,169,482,467,949,"6 de julio de 1997"
27,1,3,170,393,408,801,"6 de julio de 1997"
27,1,3,171,517,522,1039,"6 de julio de 1997"
27,1,3,172,287,328,615,"6 de julio de 1997"
27,1,3,173,317,338,655,"6 de julio de 1997"
27,1,3,174,343,361,704,"6 de julio de 1997"
27,1,3,175,406,429,835,"6 de julio de 1997"
27,1,3,176,466,471,937,"6 de julio de 1997"
27,1,3,177,543,546,1089,"6 de julio de 1997"
27,1,3,178,394,389,783,"6 de julio de 1997"
27,1,3,179,799,443,1242,"6 de julio de 1997"
27,1,3,180,429,438,867,"6 de julio de 1997"
27,1,3,181,279,249,528,"6 de julio de 1997"
27,1,3,182,166,158,324,"6 de julio de 1997"
27,1,3,183,270,223,493,"6 de julio de 1997"
27,1,3,184,318,275,593,"6 de julio de 1997"
27,1,3,185,115,101,216,"6 de julio de 1997"
27,1,3,186,204,182,386,"6 de julio de 1997"
27,1,3,187,92,84,176,"6 de julio de 1997"
27,1,3,188,63,54,117,"6 de julio de 1997"
27,1,3,189,435,389,824,"6 de julio de 1997"
27,1,3,190,292,256,548,"6 de julio de 1997"
27,1,3,191,163,137,300,"6 de julio de 1997"
27,1,3,192,620,541,1161,"6 de julio de 1997"
27,1,3,193,158,100,258,"6 de julio de 1997"
27,1,3,194,158,114,272,"6 de julio de 1997"
27,1,3,195,180,165,345,"6 de julio de 1997"
27,1,3,196,670,660,1330,"6 de julio de 1997"
27,1,3,197,355,314,669,"6 de julio de 1997"
27,1,3,198,325,286,611,"6 de julio de 1997"
27,1,3,199,203,205,408,"6 de julio de 1997"
27,1,3,200,481,393,874,"6 de julio de 1997"
27,1,3,201,473,408,881,"6 de julio de 1997"
27,1,3,202,525,434,959,"6 de julio de 1997"
27,1,3,203,499,462,961,"6 de julio de 1997"
27,1,3,204,626,573,1199,"6 de julio de 1997"
27,1,3,205,405,386,791,"6 de julio de 1997"
27,1,3,206,476,452,928,"6 de julio de 1997"
27,1,3,207,588,540,1128,"6 de julio de 1997"
27,1,3,208,363,360,723,"6 de julio de 1997"
27,1,3,209,563,543,1106,"6 de julio de 1997"
27,1,3,210,569,528,1097,"6 de julio de 1997"
27,1,3,211,531,481,1012,"6 de julio de 1997"
27,1,3,212,366,343,709,"6 de julio de 1997"
27,1,3,213,428,417,845,"6 de julio de 1997"
27,1,3,214,424,390,814,"6 de julio de 1997"
27,1,3,215,65,54,119,"6 de julio de 1997"
27,1,3,216,420,372,792,"6 de julio de 1997"
27,1,3,217,236,190,426,"6 de julio de 1997"
27,1,3,218,77,58,135,"6 de julio de 1997"
27,1,3,219,109,82,191,"6 de julio de 1997"
27,1,3,220,306,241,547,"6 de julio de 1997"
27,1,3,221,188,139,327,"6 de julio de 1997"
27,1,3,222,473,442,915,"6 de julio de 1997"
27,1,3,223,612,563,1175,"6 de julio de 1997"
27,1,3,224,460,404,864,"6 de julio de 1997"
27,1,3,225,217,199,416,"6 de julio de 1997"
27,1,3,226,130,85,215,"6 de julio de 1997"
27,1,3,227,384,316,700,"6 de julio de 1997"
27,1,3,228,312,268,580,"6 de julio de 1997"
27,1,3,229,38,30,68,"6 de julio de 1997"
27,1,3,230,45,31,76,"6 de julio de 1997"
27,1,3,231,124,105,229,"6 de julio de 1997"
27,1,7,668,513,524,1037,"6 de julio de 1997"
27,1,7,669,497,501,998,"6 de julio de 1997"
27,1,7,670,415,464,879,"6 de julio de 1997"
27,1,7,671,532,547,1079,"6 de julio de 1997"
27,1,7,672,493,552,1045,"6 de julio de 1997"
27,1,7,673,519,532,1051,"6 de julio de 1997"
27,1,7,674,675,638,1313,"6 de julio de 1997"
27,1,7,675,332,395,727,"6 de julio de 1997"
27,1,7,676,514,532,1046,"6 de julio de 1997"
27,1,7,677,641,710,1351,"6 de julio de 1997"
27,1,7,678,939,843,1782,"6 de julio de 1997"
27,1,7,679,289,241,530,"6 de julio de 1997"
27,1,7,680,102,94,196,"6 de julio de 1997"
27,1,7,681,257,214,471,"6 de julio de 1997"
27,1,7,682,293,242,535,"6 de julio de 1997"
27,1,7,683,454,471,925,"6 de julio de 1997"
27,1,11,846,427,442,869,"6 de julio de 1997"
27,1,11,847,393,386,779,"6 de julio de 1997"
27,1,11,848,415,411,826,"6 de julio de 1997"
27,1,11,849,375,382,757,"6 de julio de 1997"
27,1,11,850,159,124,283,"6 de julio de 1997"
27,1,11,851,251,232,483,"6 de julio de 1997"
27,1,11,852,209,162,371,"6 de julio de 1997"
27,1,11,853,153,143,296,"6 de julio de 1997"
27,1,11,854,74,68,142,"6 de julio de 1997"
27,1,11,855,113,114,227,"6 de julio de 1997"
27,1,11,856,127,110,237,"6 de julio de 1997"
27,1,11,857,176,141,317,"6 de julio de 1997"
27,1,11,858,359,330,689,"6 de julio de 1997"
27,1,11,859,356,257,613,"6 de julio de 1997"
27,1,11,860,232,200,432,"6 de julio de 1997"
27,1,11,861,411,357,768,"6 de julio de 1997"
27,1,11,862,213,166,379,"6 de julio de 1997"
27,1,11,863,438,380,818,"6 de julio de 1997"
27,1,11,864,113,80,193,"6 de julio de 1997"
27,1,11,865,246,238,484,"6 de julio de 1997"
27,1,11,866,166,148,314,"6 de julio de 1997"
27,1,11,867,155,131,286,"6 de julio de 1997"
27,1,11,868,384,321,705,"6 de julio de 1997"
27,1,11,869,349,309,658,"6 de julio de 1997"
27,1,11,870,349,279,628,"6 de julio de 1997"
27,1,11,871,226,196,422,"6 de julio de 1997"
27,1,14,991,474,482,956,"6 de julio de 1997"
27,1,14,992,331,342,673,"6 de julio de 1997"
27,1,14,993,422,402,824,"6 de julio de 1997"
27,1,14,994,464,482,946,"6 de julio de 1997"
27,1,14,995,429,435,864,"6 de julio de 1997"
27,1,14,996,382,365,747,"6 de julio de 1997"
27,1,14,997,440,443,883,"6 de julio de 1997"
27,1,14,998,382,409,791,"6 de julio de 1997"
27,1,14,999,433,468,901,"6 de julio de 1997"
27,1,14,1000,452,526,978,"6 de julio de 1997"
27,1,14,1001,423,458,881,"6 de julio de 1997"
27,1,14,1002,323,352,675,"6 de julio de 1997"
27,1,14,1003,406,403,809,"6 de julio de 1997"
27,1,14,1004,431,488,919,"6 de julio de 1997"
27,1,14,1005,443,418,861,"6 de julio de 1997"
27,1,14,1006,312,281,593,"6 de julio de 1997"
27,1,14,1007,435,395,830,"6 de julio de 1997"
27,1,14,1008,364,365,729,"6 de julio de 1997"
27,1,14,1009,276,253,529,"6 de julio de 1997"
27,1,14,1010,259,239,498,"6 de julio de 1997"
27,1,14,1011,402,367,769,"6 de julio de 1997"
27,1,14,1012,503,505,1008,"6 de julio de 1997"
27,1,14,1013,455,409,864,"6 de julio de 1997"
27,1,14,1014,633,607,1240,"6 de julio de 1997"
27,1,14,1015,284,284,568,"6 de julio de 1997"
27,1,14,1016,517,542,1059,"6 de julio de 1997"
27,1,14,1017,385,396,781,"6 de julio de 1997"
27,1,14,1018,444,415,859,"6 de julio de 1997"
27,1,14,1019,428,355,783,"6 de julio de 1997"
27,1,14,1020,327,322,649,"6 de julio de 1997"
27,1,14,1021,513,473,986,"6 de julio de 1997"
27,1,14,1022,820,743,1563,"6 de julio de 1997"
27,1,14,1023,553,493,1046,"6 de julio de 1997"
27,1,14,1024,391,378,769,"6 de julio de 1997"
27,1,14,1025,422,409,831,"6 de julio de 1997"
27,1,14,1026,307,280,587,"6 de julio de 1997"
27,1,14,1027,650,642,1292,"6 de julio de 1997"
27,1,14,1028,495,465,960,"6 de julio de 1997"
27,1,14,1029,491,436,927,"6 de julio de 1997"
27,1,14,1030,333,334,667,"6 de julio de 1997"
27,1,14,1031,220,182,402,"6 de julio de 1997"
27,1,14,1032,494,514,1008,"6 de julio de 1997"
27,1,14,1033,495,459,954,"6 de julio de 1997"
27,1,14,1034,373,344,717,"6 de julio de 1997"
27,1,14,1035,430,432,862,"6 de julio de 1997"
27,1,17,1089,253,236,489,"6 de julio de 1997"
27,1,17,1090,447,509,956,"6 de julio de 1997"
27,1,17,1091,346,403,749,"6 de julio de 1997"
27,1,17,1092,365,412,777,"6 de julio de 1997"
27,1,17,1093,334,387,721,"6 de julio de 1997"
27,1,17,1094,409,481,890,"6 de julio de 1997"
27,1,17,1095,197,226,423,"6 de julio de 1997"
27,1,17,1096,563,593,1156,"6 de julio de 1997"
27,1,17,1097,508,550,1058,"6 de julio de 1997"
27,1,17,1098,395,482,877,"6 de julio de 1997"
27,1,17,1099,456,556,1012,"6 de julio de 1997"
27,1,17,1100,415,421,836,"6 de julio de 1997"
27,1,17,1101,499,524,1023,"6 de julio de 1997"
27,1,17,1102,429,453,882,"6 de julio de 1997"
27,1,17,1103,395,423,818,"6 de julio de 1997"
27,1,17,1104,664,690,1354,"6 de julio de 1997"
27,1,17,1105,438,506,944,"6 de julio de 1997"
27,1,17,1106,207,240,447,"6 de julio de 1997"
27,1,17,1107,343,332,675,"6 de julio de 1997"
27,1,17,1108,412,329,741,"6 de julio de 1997"
27,1,17,1109,253,233,486,"6 de julio de 1997"
27,1,17,1110,140,120,260,"6 de julio de 1997"
27,1,17,1111,357,305,662,"6 de julio de 1997"
27,1,17,1112,177,151,328,"6 de julio de 1997"
27,1,17,1113,395,355,750,"6 de julio de 1997"
27,1,17,1114,414,390,804,"6 de julio de 1997"
27,1,17,1115,239,216,455,"6 de julio de 1997"
27,1,17,1116,283,240,523,"6 de julio de 1997"
27,1,17,1117,276,247,523,"6 de julio de 1997"
27,1,17,1118,414,361,775,"6 de julio de 1997"
27,1,17,1119,367,324,691,"6 de julio de 1997"
27,1,17,1120,81,66,147,"6 de julio de 1997"
27,1,17,1121,480,528,1008,"6 de julio de 1997"
27,1,17,1122,326,283,609,"6 de julio de 1997"
27,1,17,1123,283,223,506,"6 de julio de 1997"
27,1,17,1124,83,68,151,"6 de julio de 1997"
27,1,17,1125,262,200,462,"6 de julio de 1997"
27,1,17,1126,234,182,416,"6 de julio de 1997"
27,1,17,1127,359,340,699,"6 de julio de 1997"
27,1,17,1128,412,376,788,"6 de julio de 1997"
27,1,17,1129,98,74,172,"6 de julio de 1997"
27,1,17,1130,417,356,773,"6 de julio de 1997"
27,1,17,1131,242,216,458,"6 de julio de 1997"
27,1,17,1132,132,106,238,"6 de julio de 1997"
27,1,17,1133,697,17,714,"6 de julio de 1997"
27,2,2,46,502,541,1043,"6 de julio de 1997"
27,2,2,47,666,630,1296,"6 de julio de 1997"
27,2,2,48,383,388,771,"6 de julio de 1997"
27,2,2,49,276,287,563,"6 de julio de 1997"
27,2,2,50,547,547,1094,"6 de julio de 1997"
27,2,2,51,445,428,873,"6 de julio de 1997"
27,2,2,52,401,415,816,"6 de julio de 1997"
27,2,2,53,504,487,991,"6 de julio de 1997"
27,2,2,54,505,480,985,"6 de julio de 1997"
27,2,2,55,473,468,941,"6 de julio de 1997"
27,2,2,56,434,457,891,"6 de julio de 1997"
27,2,2,57,396,370,766,"6 de julio de 1997"
27,2,2,58,402,448,850,"6 de julio de 1997"
27,2,2,59,437,463,900,"6 de julio de 1997"
27,2,2,60,417,451,868,"6 de julio de 1997"
27,2,2,61,390,396,786,"6 de julio de 1997"
27,2,2,62,406,441,847,"6 de julio de 1997"
27,2,2,63,456,461,917,"6 de julio de 1997"
27,2,2,64,524,582,1106,"6 de julio de 1997"
27,2,2,65,506,568,1074,"6 de julio de 1997"
27,2,2,66,419,434,853,"6 de julio de 1997"
27,2,2,67,334,378,712,"6 de julio de 1997"
27,2,2,68,372,384,756,"6 de julio de 1997"
27,2,2,69,268,340,608,"6 de julio de 1997"
27,2,2,70,415,438,853,"6 de julio de 1997"
27,2,2,71,417,430,847,"6 de julio de 1997"
27,2,2,72,488,533,1021,"6 de julio de 1997"
27,2,2,73,438,468,906,"6 de julio de 1997"
27,2,2,74,404,415,819,"6 de julio de 1997"
27,2,2,75,517,608,1125,"6 de julio de 1997"
27,2,2,76,334,356,690,"6 de julio de 1997"
27,2,2,77,421,492,913,"6 de julio de 1997"
27,2,2,78,472,521,993,"6 de julio de 1997"
27,2,2,79,448,501,949,"6 de julio de 1997"
27,2,2,80,371,359,730,"6 de julio de 1997"
27,2,2,81,624,608,1232,"6 de julio de 1997"
27,2,2,82,464,500,964,"6 de julio de 1997"
27,2,2,83,486,501,987,"6 de julio de 1997"
27,2,2,84,474,483,957,"6 de julio de 1997"
27,2,2,85,513,502,1015,"6 de julio de 1997"
27,2,2,86,663,747,1410,"6 de julio de 1997"
27,2,2,87,562,559,1121,"6 de julio de 1997"
27,2,2,88,506,564,1070,"6 de julio de 1997"
27,2,2,89,612,562,1174,"6 de julio de 1997"
27,2,2,90,372,315,687,"6 de julio de 1997"
27,2,2,91,401,342,743,"6 de julio de 1997"
27,2,2,92,643,590,1233,"6 de julio de 1997"
27,2,2,93,606,607,1213,"6 de julio de 1997"
27,2,2,94,506,480,986,"6 de julio de 1997"
27,2,2,95,521,499,1020,"6 de julio de 1997"
27,2,2,96,211,189,400,"6 de julio de 1997"
27,2,2,97,293,253,546,"6 de julio de 1997"
27,2,2,98,437,379,816,"6 de julio de 1997"
27,2,2,99,398,363,761,"6 de julio de 1997"
27,2,2,100,553,558,1111,"6 de julio de 1997"
27,2,2,101,406,376,782,"6 de julio de 1997"
27,2,2,102,344,298,642,"6 de julio de 1997"
27,2,2,103,378,341,719,"6 de julio de 1997"
27,2,2,104,285,256,541,"6 de julio de 1997"
27,2,2,105,515,461,976,"6 de julio de 1997"
27,2,2,106,389,329,718,"6 de julio de 1997"
27,2,2,107,499,492,991,"6 de julio de 1997"
27,2,2,108,230,204,434,"6 de julio de 1997"
27,2,2,109,368,333,701,"6 de julio de 1997"
27,2,2,110,709,643,1352,"6 de julio de 1997"
27,2,2,111,169,165,334,"6 de julio de 1997"
27,2,2,112,406,404,810,"6 de julio de 1997"
27,2,2,113,332,341,673,"6 de julio de 1997"
27,2,2,114,409,387,796,"6 de julio de 1997"
27,2,2,115,283,321,604,"6 de julio de 1997"
27,2,2,116,366,336,702,"6 de julio de 1997"
27,2,2,117,148,162,310,"6 de julio de 1997"
27,2,2,118,315,286,601,"6 de julio de 1997"
27,2,2,119,477,372,849,"6 de julio de 1997"
27,2,2,120,485,464,949,"6 de julio de 1997"
27,2,2,121,588,534,1122,"6 de julio de 1997"
27,2,2,122,588,492,1080,"6 de julio de 1997"
27,2,2,123,396,397,793,"6 de julio de 1997"
27,2,2,124,273,263,536,"6 de julio de 1997"
27,2,2,125,500,503,1003,"6 de julio de 1997"
27,2,2,126,303,269,572,"6 de julio de 1997"
27,2,2,127,375,359,734,"6 de julio de 1997"
27,2,2,128,333,289,622,"6 de julio de 1997"
27,2,2,129,498,440,938,"6 de julio de 1997"
27,2,2,130,593,567,1160,"6 de julio de 1997"
27,2,2,131,497,454,951,"6 de julio de 1997"
27,2,2,132,491,462,953,"6 de julio de 1997"
27,2,2,133,486,459,945,"6 de julio de 1997"
27,2,2,134,621,555,1176,"6 de julio de 1997"
27,2,2,135,162,149,311,"6 de julio de 1997"
27,2,2,136,292,261,553,"6 de julio de 1997"
27,2,2,137,554,589,1143,"6 de julio de 1997"
27,2,2,138,526,524,1050,"6 de julio de 1997"
27,2,2,139,369,370,739,"6 de julio de 1997"
27,2,2,140,279,293,572,"6 de julio de 1997"
27,2,2,141,371,351,722,"6 de julio de 1997"
27,2,2,142,372,357,729,"6 de julio de 1997"
27,2,2,143,511,489,1000,"6 de julio de 1997"
27,2,2,144,624,585,1209,"6 de julio de 1997"
27,2,2,145,480,436,916,"6 de julio de 1997"
27,2,2,146,633,590,1223,"6 de julio de 1997"
27,2,2,147,445,436,881,"6 de julio de 1997"
27,2,2,148,673,663,1336,"6 de julio de 1997"
27,2,2,149,461,456,917,"6 de julio de 1997"
27,2,2,150,305,337,642,"6 de julio de 1997"
27,2,2,151,406,403,809,"6 de julio de 1997"
27,2,2,152,737,717,1454,"6 de julio de 1997"
27,2,2,153,190,124,314,"6 de julio de 1997"
27,2,2,154,582,530,1112,"6 de julio de 1997"
27,2,2,155,686,675,1361,"6 de julio de 1997"
27,2,2,156,435,405,840,"6 de julio de 1997"
27,2,2,157,607,553,1160,"6 de julio de 1997"
27,2,2,158,407,363,770,"6 de julio de 1997"
27,2,2,159,375,376,751,"6 de julio de 1997"
27,2,2,160,579,500,1079,"6 de julio de 1997"
27,2,2,161,209,216,425,"6 de julio de 1997"
27,2,2,162,430,374,804,"6 de julio de 1997"
27,2,2,163,612,598,1210,"6 de julio de 1997"
27,2,2,164,398,373,771,"6 de julio de 1997"
27,2,2,165,580,494,1074,"6 de julio de 1997"
27,2,2,166,385,379,764,"6 de julio de 1997"
27,2,2,167,307,167,474,"6 de julio de 1997"
27,2,8,684,447,509,956,"6 de julio de 1997"
27,2,8,685,392,397,789,"6 de julio de 1997"
27,2,8,686,479,518,997,"6 de julio de 1997"
27,2,8,687,509,529,1038,"6 de julio de 1997"
27,2,8,688,437,446,883,"6 de julio de 1997"
27,2,8,689,384,392,776,"6 de julio de 1997"
27,2,8,690,324,355,679,"6 de julio de 1997"
27,2,8,691,385,405,790,"6 de julio de 1997"
27,2,8,692,484,512,996,"6 de julio de 1997"
27,2,8,693,475,518,993,"6 de julio de 1997"
27,2,8,694,682,682,1364,"6 de julio de 1997"
27,2,8,695,584,543,1127,"6 de julio de 1997"
27,2,8,696,463,542,1005,"6 de julio de 1997"
27,2,8,697,525,535,1060,"6 de julio de 1997"
27,2,8,698,367,344,711,"6 de julio de 1997"
27,2,8,699,709,639,1348,"6 de julio de 1997"
27,2,8,700,510,519,1029,"6 de julio de 1997"
27,2,8,701,386,390,776,"6 de julio de 1997"
27,2,8,702,361,340,701,"6 de julio de 1997"
27,2,8,703,641,626,1267,"6 de julio de 1997"
27,2,8,704,543,510,1053,"6 de julio de 1997"
27,2,8,705,330,299,629,"6 de julio de 1997"
27,2,8,706,568,509,1077,"6 de julio de 1997"
27,2,8,707,584,490,1074,"6 de julio de 1997"
27,2,8,708,613,556,1169,"6 de julio de 1997"
27,2,8,709,204,181,385,"6 de julio de 1997"
27,2,8,710,528,482,1010,"6 de julio de 1997"
27,2,8,711,521,492,1013,"6 de julio de 1997"
27,2,8,712,545,465,1010,"6 de julio de 1997"
27,2,8,713,468,376,844,"6 de julio de 1997"
27,2,8,714,599,532,1131,"6 de julio de 1997"
27,2,8,715,52,43,95,"6 de julio de 1997"
27,2,8,716,505,441,946,"6 de julio de 1997"
27,2,8,717,286,256,542,"6 de julio de 1997"
27,2,8,718,471,467,938,"6 de julio de 1997"
27,2,8,719,441,442,883,"6 de julio de 1997"
27,2,8,720,388,331,719,"6 de julio de 1997"
27,2,8,721,381,376,757,"6 de julio de 1997"
27,2,8,722,681,666,1347,"6 de julio de 1997"
27,2,8,723,605,548,1153,"6 de julio de 1997"
27,2,8,724,479,435,914,"6 de julio de 1997"
27,2,8,725,540,499,1039,"6 de julio de 1997"
27,2,8,726,494,450,944,"6 de julio de 1997"
27,2,8,727,706,651,1357,"6 de julio de 1997"
27,2,8,728,485,464,949,"6 de julio de 1997"
27,2,8,729,855,788,1643,"6 de julio de 1997"
27,2,8,730,446,390,836,"6 de julio de 1997"
27,2,8,731,526,527,1053,"6 de julio de 1997"
27,2,8,732,255,224,479,"6 de julio de 1997"
27,2,8,733,667,534,1201,"6 de julio de 1997"
27,2,8,734,95,72,167,"6 de julio de 1997"
27,2,8,735,461,377,838,"6 de julio de 1997"
27,2,8,736,405,338,743,"6 de julio de 1997"
27,2,8,737,212,179,391,"6 de julio de 1997"
27,2,8,738,586,575,1161,"6 de julio de 1997"
27,2,8,739,212,186,398,"6 de julio de 1997"
27,2,8,740,51,42,93,"6 de julio de 1997"
27,2,8,741,591,538,1129,"6 de julio de 1997"
27,2,8,742,478,366,844,"6 de julio de 1997"
27,2,8,743,640,551,1191,"6 de julio de 1997"
27,2,8,744,476,446,922,"6 de julio de 1997"
27,2,8,745,160,142,302,"6 de julio de 1997"
27,2,8,746,401,371,772,"6 de julio de 1997"
27,2,8,747,596,522,1118,"6 de julio de 1997"
27,2,8,748,547,475,1022,"6 de julio de 1997"
27,2,8,749,285,226,511,"6 de julio de 1997"
27,2,8,750,214,164,378,"6 de julio de 1997"
27,2,8,751,159,126,285,"6 de julio de 1997"
27,2,8,752,251,207,458,"6 de julio de 1997"
27,2,8,753,190,137,327,"6 de julio de 1997"
27,2,8,754,220,178,398,"6 de julio de 1997"
27,2,8,755,153,114,267,"6 de julio de 1997"
27,2,8,756,376,294,670,"6 de julio de 1997"
27,2,8,757,530,478,1008,"6 de julio de 1997"
27,2,8,758,268,225,493,"6 de julio de 1997"
27,2,8,759,469,400,869,"6 de julio de 1997"
27,2,8,760,395,320,715,"6 de julio de 1997"
27,2,8,761,96,92,188,"6 de julio de 1997"
27,2,8,762,225,161,386,"6 de julio de 1997"
27,2,8,763,420,369,789,"6 de julio de 1997"
27,2,8,764,300,222,522,"6 de julio de 1997"
27,2,8,765,450,433,883,"6 de julio de 1997"
27,2,8,766,358,339,697,"6 de julio de 1997"
27,2,8,767,399,369,768,"6 de julio de 1997"
27,2,8,768,347,332,679,"6 de julio de 1997"
27,2,8,769,293,237,530,"6 de julio de 1997"
27,2,8,770,435,418,853,"6 de julio de 1997"
27,2,8,771,309,276,585,"6 de julio de 1997"
27,2,8,772,160,126,286,"6 de julio de 1997"
27,2,8,773,402,336,738,"6 de julio de 1997"
27,2,8,774,336,280,616,"6 de julio de 1997"
27,2,8,775,182,153,335,"6 de julio de 1997"
27,2,8,776,283,224,507,"6 de julio de 1997"
27,2,8,777,361,314,675,"6 de julio de 1997"
27,2,8,778,331,271,602,"6 de julio de 1997"
27,2,8,779,363,313,676,"6 de julio de 1997"
27,2,8,780,312,272,584,"6 de julio de 1997"
27,3,5,512,462,507,969,"6 de julio de 1997"
27,3,5,513,430,445,875,"6 de julio de 1997"
27,3,5,514,282,305,587,"6 de julio de 1997"
27,3,5,515,560,604,1164,"6 de julio de 1997"
27,3,5,516,529,574,1103,"6 de julio de 1997"
27,3,5,517,441,440,881,"6 de julio de 1997"
27,3,5,518,242,290,532,"6 de julio de 1997"
27,3,5,519,376,377,753,"6 de julio de 1997"
27,3,5,520,296,352,648,"6 de julio de 1997"
27,3,5,521,312,334,646,"6 de julio de 1997"
27,3,5,522,343,313,656,"6 de julio de 1997"
27,3,5,523,413,427,840,"6 de julio de 1997"
27,3,5,524,328,356,684,"6 de julio de 1997"
27,3,5,525,340,342,682,"6 de julio de 1997"
27,3,5,526,285,317,602,"6 de julio de 1997"
27,3,5,527,349,402,751,"6 de julio de 1997"
27,3,5,528,619,661,1280,"6 de julio de 1997"
27,3,5,529,409,419,828,"6 de julio de 1997"
27,3,5,530,371,401,772,"6 de julio de 1997"
27,3,5,531,326,349,675,"6 de julio de 1997"
27,3,5,532,314,332,646,"6 de julio de 1997"
27,3,5,533,492,493,985,"6 de julio de 1997"
27,3,5,534,441,494,935,"6 de julio de 1997"
27,3,5,535,372,398,770,"6 de julio de 1997"
27,3,5,536,495,454,949,"6 de julio de 1997"
27,3,5,537,386,372,758,"6 de julio de 1997"
27,3,5,538,736,713,1449,"6 de julio de 1997"
27,3,5,539,260,248,508,"6 de julio de 1997"
27,3,5,540,346,308,654,"6 de julio de 1997"
27,3,5,541,271,259,530,"6 de julio de 1997"
27,3,5,542,529,489,1018,"6 de julio de 1997"
27,3,5,543,442,357,799,"6 de julio de 1997"
27,3,5,544,316,287,603,"6 de julio de 1997"
27,3,5,545,546,522,1068,"6 de julio de 1997"
27,3,5,546,413,357,770,"6 de julio de 1997"
27,3,5,547,314,290,604,"6 de julio de 1997"
27,3,5,548,441,417,858,"6 de julio de 1997"
27,3,5,549,335,342,677,"6 de julio de 1997"
27,3,5,550,503,500,1003,"6 de julio de 1997"
27,3,5,551,420,378,798,"6 de julio de 1997"
27,3,5,552,463,452,915,"6 de julio de 1997"
27,3,5,553,404,400,804,"6 de julio de 1997"
27,3,5,554,512,485,997,"6 de julio de 1997"
27,3,5,555,929,906,1835,"6 de julio de 1997"
27,3,5,556,393,382,775,"6 de julio de 1997"
27,3,5,557,462,408,870,"6 de julio de 1997"
27,3,5,558,489,496,985,"6 de julio de 1997"
27,3,5,559,417,398,815,"6 de julio de 1997"
27,3,5,560,533,525,1058,"6 de julio de 1997"
27,3,5,561,437,410,847,"6 de julio de 1997"
27,3,5,562,449,441,890,"6 de julio de 1997"
27,3,5,563,434,440,874,"6 de julio de 1997"
27,3,5,564,406,403,809,"6 de julio de 1997"
27,3,5,565,448,437,885,"6 de julio de 1997"
27,3,5,566,308,301,609,"6 de julio de 1997"
27,3,5,567,362,376,738,"6 de julio de 1997"
27,3,5,568,635,625,1260,"6 de julio de 1997"
27,3,5,569,389,363,752,"6 de julio de 1997"
27,3,5,570,619,513,1132,"6 de julio de 1997"
27,3,5,571,433,386,819,"6 de julio de 1997"
27,3,5,572,518,487,1005,"6 de julio de 1997"
27,3,5,573,511,494,1005,"6 de julio de 1997"
27,3,5,574,585,559,1144,"6 de julio de 1997"
27,3,5,575,579,539,1118,"6 de julio de 1997"
27,3,5,576,612,573,1185,"6 de julio de 1997"
27,3,5,577,472,436,908,"6 de julio de 1997"
27,3,5,578,433,379,812,"6 de julio de 1997"
27,3,5,579,370,365,735,"6 de julio de 1997"
27,3,5,580,273,237,510,"6 de julio de 1997"
27,3,5,581,492,463,955,"6 de julio de 1997"
27,3,5,582,389,431,820,"6 de julio de 1997"
27,3,5,583,514,485,999,"6 de julio de 1997"
27,3,5,584,425,411,836,"6 de julio de 1997"
27,3,5,585,441,468,909,"6 de julio de 1997"
27,3,5,586,466,468,934,"6 de julio de 1997"
27,3,5,587,706,688,1394,"6 de julio de 1997"
27,3,5,588,436,383,819,"6 de julio de 1997"
27,3,5,589,405,342,747,"6 de julio de 1997"
27,3,5,590,681,644,1325,"6 de julio de 1997"
27,3,5,591,659,637,1296,"6 de julio de 1997"
27,3,5,592,562,513,1075,"6 de julio de 1997"
27,3,5,593,436,428,864,"6 de julio de 1997"
27,3,5,594,452,398,850,"6 de julio de 1997"
27,3,5,595,381,398,779,"6 de julio de 1997"
27,3,5,596,404,371,775,"6 de julio de 1997"
27,3,5,597,300,277,577,"6 de julio de 1997"
27,3,5,598,501,500,1001,"6 de julio de 1997"
27,3,5,599,274,247,521,"6 de julio de 1997"
27,3,5,600,513,492,1005,"6 de julio de 1997"
27,3,5,601,579,527,1106,"6 de julio de 1997"
27,3,5,602,478,427,905,"6 de julio de 1997"
27,3,5,603,453,411,864,"6 de julio de 1997"
27,3,5,604,507,442,949,"6 de julio de 1997"
27,3,5,605,238,211,449,"6 de julio de 1997"
27,3,5,606,597,536,1133,"6 de julio de 1997"
27,3,5,607,516,472,988,"6 de julio de 1997"
27,3,5,608,553,536,1089,"6 de julio de 1997"
27,3,6,609,463,454,917,"6 de julio de 1997"
27,3,6,610,509,552,1061,"6 de julio de 1997"
27,3,6,611,519,513,1032,"6 de julio de 1997"
27,3,6,612,471,493,964,"6 de julio de 1997"
27,3,6,613,544,570,1114,"6 de julio de 1997"
27,3,6,614,501,490,991,"6 de julio de 1997"
27,3,6,615,511,508,1019,"6 de julio de 1997"
27,3,6,616,416,431,847,"6 de julio de 1997"
27,3,6,617,568,587,1155,"6 de julio de 1997"
27,3,6,618,484,436,920,"6 de julio de 1997"
27,3,6,619,430,374,804,"6 de julio de 1997"
27,3,6,620,621,599,1220,"6 de julio de 1997"
27,3,6,621,489,478,967,"6 de julio de 1997"
27,3,6,622,300,252,552,"6 de julio de 1997"
27,3,6,623,328,300,628,"6 de julio de 1997"
27,3,6,624,442,416,858,"6 de julio de 1997"
27,3,6,625,429,433,862,"6 de julio de 1997"
27,3,6,626,324,310,634,"6 de julio de 1997"
27,3,6,627,316,327,643,"6 de julio de 1997"
27,3,6,628,465,474,939,"6 de julio de 1997"
27,3,6,629,416,386,802,"6 de julio de 1997"
27,3,6,630,429,404,833,"6 de julio de 1997"
27,3,6,631,542,514,1056,"6 de julio de 1997"
27,3,6,632,295,280,575,"6 de julio de 1997"
27,3,6,633,413,390,803,"6 de julio de 1997"
27,3,6,634,570,539,1109,"6 de julio de 1997"
27,3,6,635,564,537,1101,"6 de julio de 1997"
27,3,6,636,528,474,1002,"6 de julio de 1997"
27,3,6,637,361,369,730,"6 de julio de 1997"
27,3,6,638,589,503,1092,"6 de julio de 1997"
27,3,6,639,445,419,864,"6 de julio de 1997"
27,3,6,640,332,307,639,"6 de julio de 1997"
27,3,6,641,780,712,1492,"6 de julio de 1997"
27,3,6,642,796,790,1586,"6 de julio de 1997"
27,3,6,643,377,382,759,"6 de julio de 1997"
27,3,6,644,340,357,697,"6 de julio de 1997"
27,3,6,645,694,701,1395,"6 de julio de 1997"
27,3,6,646,357,347,704,"6 de julio de 1997"
27,3,6,647,503,466,969,"6 de julio de 1997"
27,3,6,648,428,408,836,"6 de julio de 1997"
27,3,6,649,412,399,811,"6 de julio de 1997"
27,3,6,650,369,356,725,"6 de julio de 1997"
27,3,6,651,424,414,838,"6 de julio de 1997"
27,3,6,652,461,413,874,"6 de julio de 1997"
27,3,6,653,467,419,886,"6 de julio de 1997"
27,3,6,654,637,579,1216,"6 de julio de 1997"
27,3,6,655,380,352,732,"6 de julio de 1997"
27,3,6,656,646,608,1254,"6 de julio de 1997"
27,3,6,657,264,292,556,"6 de julio de 1997"
27,3,6,658,413,387,800,"6 de julio de 1997"
27,3,6,659,590,466,1056,"6 de julio de 1997"
27,3,6,660,208,204,412,"6 de julio de 1997"
27,3,6,661,335,285,620,"6 de julio de 1997"
27,3,6,662,399,383,782,"6 de julio de 1997"
27,3,6,663,1013,937,1950,"6 de julio de 1997"
27,3,6,664,299,245,544,"6 de julio de 1997"
27,3,6,665,543,530,1073,"6 de julio de 1997"
27,3,6,666,313,270,583,"6 de julio de 1997"
27,3,6,667,324,264,588,"6 de julio de 1997"
27,3,10,809,410,396,806,"6 de julio de 1997"
27,3,10,810,705,681,1386,"6 de julio de 1997"
27,3,10,811,522,593,1115,"6 de julio de 1997"
27,3,10,812,423,453,876,"6 de julio de 1997"
27,3,10,813,539,528,1067,"6 de julio de 1997"
27,3,10,814,417,439,856,"6 de julio de 1997"
27,3,10,815,456,438,894,"6 de julio de 1997"
27,3,10,816,457,472,929,"6 de julio de 1997"
27,3,10,817,389,422,811,"6 de julio de 1997"
27,3,10,818,247,248,495,"6 de julio de 1997"
27,3,10,819,396,376,772,"6 de julio de 1997"
27,3,10,820,217,231,448,"6 de julio de 1997"
27,3,10,821,571,525,1096,"6 de julio de 1997"
27,3,10,822,507,485,992,"6 de julio de 1997"
27,3,10,823,734,637,1371,"6 de julio de 1997"
27,3,10,824,371,343,714,"6 de julio de 1997"
27,3,10,825,596,625,1221,"6 de julio de 1997"
27,3,10,826,593,541,1134,"6 de julio de 1997"
27,3,10,827,758,678,1436,"6 de julio de 1997"
27,3,10,828,385,362,747,"6 de julio de 1997"
27,3,10,829,958,910,1868,"6 de julio de 1997"
27,3,10,830,62,76,138,"6 de julio de 1997"
27,3,10,831,343,326,669,"6 de julio de 1997"
27,3,10,832,620,582,1202,"6 de julio de 1997"
27,3,10,833,380,391,771,"6 de julio de 1997"
27,3,10,834,479,498,977,"6 de julio de 1997"
27,3,10,835,264,266,530,"6 de julio de 1997"
27,3,10,836,557,507,1064,"6 de julio de 1997"
27,3,10,837,140,115,255,"6 de julio de 1997"
27,3,10,838,587,589,1176,"6 de julio de 1997"
27,3,10,839,617,570,1187,"6 de julio de 1997"
27,3,10,840,460,467,927,"6 de julio de 1997"
27,3,10,841,579,534,1113,"6 de julio de 1997"
27,3,10,842,678,583,1261,"6 de julio de 1997"
27,3,10,843,339,313,652,"6 de julio de 1997"
27,3,10,844,372,354,726,"6 de julio de 1997"
27,3,10,845,509,472,981,"6 de julio de 1997"
27,4,4,232,755,777,1532,"6 de julio de 1997"
27,4,4,233,310,361,671,"6 de julio de 1997"
27,4,4,234,1009,1039,2048,"6 de julio de 1997"
27,4,4,235,363,421,784,"6 de julio de 1997"
27,4,4,236,356,402,758,"6 de julio de 1997"
27,4,4,237,501,605,1106,"6 de julio de 1997"
27,4,4,238,710,728,1438,"6 de julio de 1997"
27,4,4,239,288,335,623,"6 de julio de 1997"
27,4,4,240,339,380,719,"6 de julio de 1997"
27,4,4,241,540,556,1096,"6 de julio de 1997"
27,4,4,242,846,904,1750,"6 de julio de 1997"
27,4,4,243,438,511,949,"6 de julio de 1997"
27,4,4,244,397,422,819,"6 de julio de 1997"
27,4,4,245,577,702,1279,"6 de julio de 1997"
27,4,4,246,493,480,973,"6 de julio de 1997"
27,4,4,247,398,437,835,"6 de julio de 1997"
27,4,4,248,594,643,1237,"6 de julio de 1997"
27,4,4,249,499,557,1056,"6 de julio de 1997"
27,4,4,250,510,612,1122,"6 de julio de 1997"
27,4,4,251,710,765,1475,"6 de julio de 1997"
27,4,4,252,446,469,915,"6 de julio de 1997"
27,4,4,253,628,703,1331,"6 de julio de 1997"
27,4,4,254,434,425,859,"6 de julio de 1997"
27,4,4,255,495,546,1041,"6 de julio de 1997"
27,4,4,256,536,633,1169,"6 de julio de 1997"
27,4,4,257,398,505,903,"6 de julio de 1997"
27,4,4,258,358,416,774,"6 de julio de 1997"
27,4,4,259,475,540,1015,"6 de julio de 1997"
27,4,4,260,608,585,1193,"6 de julio de 1997"
27,4,4,261,541,640,1181,"6 de julio de 1997"
27,4,4,262,547,582,1129,"6 de julio de 1997"
27,4,4,263,304,340,644,"6 de julio de 1997"
27,4,4,264,470,527,997,"6 de julio de 1997"
27,4,4,265,368,455,823,"6 de julio de 1997"
27,4,4,266,361,382,743,"6 de julio de 1997"
27,4,4,267,742,768,1510,"6 de julio de 1997"
27,4,4,269,484,491,975,"6 de julio de 1997"
27,4,4,270,468,504,972,"6 de julio de 1997"
27,4,4,271,366,357,723,"6 de julio de 1997"
27,4,4,272,401,356,757,"6 de julio de 1997"
27,4,4,277,467,542,1009,"6 de julio de 1997"
27,4,4,278,379,459,838,"6 de julio de 1997"
27,4,4,279,236,271,507,"6 de julio de 1997"
27,4,4,280,520,507,1027,"6 de julio de 1997"
27,4,4,281,467,495,962,"6 de julio de 1997"
27,4,4,282,468,468,936,"6 de julio de 1997"
27,4,4,283,535,519,1054,"6 de julio de 1997"
27,4,4,284,475,442,917,"6 de julio de 1997"
27,4,4,285,296,355,651,"6 de julio de 1997"
27,4,4,286,484,535,1019,"6 de julio de 1997"
27,4,4,287,353,398,751,"6 de julio de 1997"
27,4,4,288,399,535,934,"6 de julio de 1997"
27,4,4,289,350,401,751,"6 de julio de 1997"
27,4,4,290,518,519,1037,"6 de julio de 1997"
27,4,4,291,453,463,916,"6 de julio de 1997"
27,4,4,292,480,506,986,"6 de julio de 1997"
27,4,4,293,303,342,645,"6 de julio de 1997"
27,4,4,294,361,434,795,"6 de julio de 1997"
27,4,4,295,327,361,688,"6 de julio de 1997"
27,4,4,296,434,454,888,"6 de julio de 1997"
27,4,4,297,380,475,855,"6 de julio de 1997"
27,4,4,298,135,189,324,"6 de julio de 1997"
27,4,4,299,422,511,933,"6 de julio de 1997"
27,4,4,307,492,589,1081,"6 de julio de 1997"
27,4,4,309,419,495,914,"6 de julio de 1997"
27,4,4,310,422,520,942,"6 de julio de 1997"
27,4,4,319,407,480,887,"6 de julio de 1997"
27,4,4,321,397,498,895,"6 de julio de 1997"
27,4,4,322,347,395,742,"6 de julio de 1997"
27,4,4,323,496,559,1055,"6 de julio de 1997"
27,4,4,333,348,434,782,"6 de julio de 1997"
27,4,4,359,531,555,1086,"6 de julio de 1997"
27,4,4,360,560,575,1135,"6 de julio de 1997"
27,4,4,361,594,595,1189,"6 de julio de 1997"
27,4,4,382,590,669,1259,"6 de julio de 1997"
27,4,4,383,607,696,1303,"6 de julio de 1997"
27,4,4,384,451,454,905,"6 de julio de 1997"
27,4,4,405,612,678,1290,"6 de julio de 1997"
27,4,4,419,154,132,286,"6 de julio de 1997"
27,4,4,420,361,334,695,"6 de julio de 1997"
27,4,4,421,729,631,1360,"6 de julio de 1997"
27,4,4,422,803,740,1543,"6 de julio de 1997"
27,4,4,423,710,656,1366,"6 de julio de 1997"
27,4,4,424,47,37,84,"6 de julio de 1997"
27,4,4,425,483,428,911,"6 de julio de 1997"
27,4,4,426,538,478,1016,"6 de julio de 1997"
27,4,4,427,550,517,1067,"6 de julio de 1997"
27,4,4,428,501,558,1059,"6 de julio de 1997"
27,4,4,429,552,566,1118,"6 de julio de 1997"
27,4,4,430,497,498,995,"6 de julio de 1997"
27,4,4,431,556,519,1075,"6 de julio de 1997"
27,4,4,432,485,425,910,"6 de julio de 1997"
27,4,4,433,630,583,1213,"6 de julio de 1997"
27,4,4,434,315,383,698,"6 de julio de 1997"
27,4,4,435,840,1000,1840,"6 de julio de 1997"
27,4,4,436,470,399,869,"6 de julio de 1997"
27,4,4,437,352,298,650,"6 de julio de 1997"
27,4,4,438,513,519,1032,"6 de julio de 1997"
27,4,4,439,169,153,322,"6 de julio de 1997"
27,4,4,440,939,984,1923,"6 de julio de 1997"
27,4,4,441,566,477,1043,"6 de julio de 1997"
27,4,4,442,188,168,356,"6 de julio de 1997"
27,4,4,443,607,620,1227,"6 de julio de 1997"
27,4,4,444,166,139,305,"6 de julio de 1997"
27,4,4,445,383,373,756,"6 de julio de 1997"
27,4,4,446,721,775,1496,"6 de julio de 1997"
27,4,4,447,351,301,652,"6 de julio de 1997"
27,4,4,448,335,277,612,"6 de julio de 1997"
27,4,4,449,35,31,66,"6 de julio de 1997"
27,4,4,450,525,461,986,"6 de julio de 1997"
27,4,4,451,312,257,569,"6 de julio de 1997"
27,4,4,454,308,259,567,"6 de julio de 1997"
27,4,4,455,302,300,602,"6 de julio de 1997"
27,4,4,456,381,310,691,"6 de julio de 1997"
27,4,4,457,442,430,872,"6 de julio de 1997"
27,4,4,466,328,328,656,"6 de julio de 1997"
27,4,4,471,231,244,475,"6 de julio de 1997"
27,4,4,472,396,379,775,"6 de julio de 1997"
27,4,4,473,215,157,372,"6 de julio de 1997"
27,4,4,474,560,553,1113,"6 de julio de 1997"
27,4,4,478,417,387,804,"6 de julio de 1997"
27,4,4,489,438,398,836,"6 de julio de 1997"
27,4,4,493,309,287,596,"6 de julio de 1997"
27,4,13,954,278,331,609,"6 de julio de 1997"
27,4,13,955,402,407,809,"6 de julio de 1997"
27,4,13,956,515,505,1020,"6 de julio de 1997"
27,4,13,957,378,420,798,"6 de julio de 1997"
27,4,13,958,531,560,1091,"6 de julio de 1997"
27,4,13,959,387,376,763,"6 de julio de 1997"
27,4,13,960,642,568,1210,"6 de julio de 1997"
27,4,13,961,124,117,241,"6 de julio de 1997"
27,4,13,962,595,590,1185,"6 de julio de 1997"
27,4,13,963,511,507,1018,"6 de julio de 1997"
27,4,13,964,621,604,1225,"6 de julio de 1997"
27,4,13,965,693,591,1284,"6 de julio de 1997"
27,4,13,966,195,168,363,"6 de julio de 1997"
27,4,13,967,511,486,997,"6 de julio de 1997"
27,4,13,968,427,378,805,"6 de julio de 1997"
27,4,13,969,539,521,1060,"6 de julio de 1997"
27,4,13,970,431,390,821,"6 de julio de 1997"
27,4,13,971,733,724,1457,"6 de julio de 1997"
27,4,13,972,590,528,1118,"6 de julio de 1997"
27,4,13,973,195,182,377,"6 de julio de 1997"
27,4,13,974,764,669,1433,"6 de julio de 1997"
27,4,13,975,259,278,537,"6 de julio de 1997"
27,4,13,976,474,464,938,"6 de julio de 1997"
27,4,13,977,339,319,658,"6 de julio de 1997"
27,4,13,978,339,349,688,"6 de julio de 1997"
27,4,13,979,445,425,870,"6 de julio de 1997"
27,4,13,980,576,617,1193,"6 de julio de 1997"
27,4,13,981,265,244,509,"6 de julio de 1997"
27,4,13,982,855,799,1654,"6 de julio de 1997"
27,4,13,983,385,385,770,"6 de julio de 1997"
27,4,13,984,406,390,796,"6 de julio de 1997"
27,4,13,985,505,517,1022,"6 de julio de 1997"
27,4,13,986,1353,1650,3003,"6 de julio de 1997"
27,4,13,987,447,479,926,"6 de julio de 1997"
27,4,13,988,374,374,748,"6 de julio de 1997"
27,4,13,989,347,418,765,"6 de julio de 1997"
27,4,13,990,434,459,893,"6 de julio de 1997"
27,5,9,781,574,565,1139,"6 de julio de 1997"
27,5,9,782,415,428,843,"6 de julio de 1997"
27,5,9,783,451,471,922,"6 de julio de 1997"
27,5,9,784,146,163,309,"6 de julio de 1997"
27,5,9,785,350,323,673,"6 de julio de 1997"
27,5,9,786,485,424,909,"6 de julio de 1997"
27,5,9,787,219,183,402,"6 de julio de 1997"
27,5,9,788,302,287,589,"6 de julio de 1997"
27,5,9,789,481,492,973,"6 de julio de 1997"
27,5,9,790,83,72,155,"6 de julio de 1997"
27,5,9,791,136,143,279,"6 de julio de 1997"
27,5,9,792,497,502,999,"6 de julio de 1997"
27,5,9,793,361,336,697,"6 de julio de 1997"
27,5,9,794,456,416,872,"6 de julio de 1997"
27,5,9,795,406,411,817,"6 de julio de 1997"
27,5,9,796,218,202,420,"6 de julio de 1997"
27,5,9,797,61,59,120,"6 de julio de 1997"
27,5,9,798,468,413,881,"6 de julio de 1997"
27,5,9,799,293,240,533,"6 de julio de 1997"
27,5,9,800,500,451,951,"6 de julio de 1997"
27,5,9,801,405,341,746,"6 de julio de 1997"
27,5,9,802,313,296,609,"6 de julio de 1997"
27,5,9,803,400,324,724,"6 de julio de 1997"
27,5,9,804,332,323,655,"6 de julio de 1997"
27,5,9,805,108,99,207,"6 de julio de 1997"
27,5,9,806,328,331,659,"6 de julio de 1997"
27,5,9,807,248,220,468,"6 de julio de 1997"
27,5,9,808,431,356,787,"6 de julio de 1997"
27,5,12,872,733,753,1486,"6 de julio de 1997"
27,5,12,873,482,510,992,"6 de julio de 1997"
27,5,12,874,522,549,1071,"6 de julio de 1997"
27,5,12,875,502,594,1096,"6 de julio de 1997"
27,5,12,876,500,540,1040,"6 de julio de 1997"
27,5,12,877,556,539,1095,"6 de julio de 1997"
27,5,12,878,642,688,1330,"6 de julio de 1997"
27,5,12,879,556,545,1101,"6 de julio de 1997"
27,5,12,880,596,635,1231,"6 de julio de 1997"
27,5,12,881,790,844,1634,"6 de julio de 1997"
27,5,12,882,638,679,1317,"6 de julio de 1997"
27,5,12,883,456,462,918,"6 de julio de 1997"
27,5,12,884,522,482,1004,"6 de julio de 1997"
27,5,12,885,921,850,1771,"6 de julio de 1997"
27,5,12,886,463,388,851,"6 de julio de 1997"
27,5,12,887,198,153,351,"6 de julio de 1997"
27,5,12,888,94,92,186,"6 de julio de 1997"
27,5,12,889,436,438,874,"6 de julio de 1997"
27,5,12,890,716,681,1397,"6 de julio de 1997"
27,5,12,891,211,202,413,"6 de julio de 1997"
27,5,12,892,633,551,1184,"6 de julio de 1997"
27,5,12,893,462,448,910,"6 de julio de 1997"
27,5,12,894,202,184,386,"6 de julio de 1997"
27,5,12,895,528,519,1047,"6 de julio de 1997"
27,5,12,896,345,351,696,"6 de julio de 1997"
27,5,12,897,585,515,1100,"6 de julio de 1997"
27,5,12,898,474,480,954,"6 de julio de 1997"
27,5,12,899,266,251,517,"6 de julio de 1997"
27,5,12,900,495,462,957,"6 de julio de 1997"
27,5,12,901,496,460,956,"6 de julio de 1997"
27,5,12,902,403,383,786,"6 de julio de 1997"
27,5,12,903,522,541,1063,"6 de julio de 1997"
27,5,12,904,136,105,241,"6 de julio de 1997"
27,5,12,905,409,409,818,"6 de julio de 1997"
27,5,12,906,255,275,530,"6 de julio de 1997"
27,5,12,907,319,321,640,"6 de julio de 1997"
27,5,12,908,250,240,490,"6 de julio de 1997"
27,5,12,909,289,254,543,"6 de julio de 1997"
27,5,12,910,353,321,674,"6 de julio de 1997"
27,5,12,911,440,445,885,"6 de julio de 1997"
27,5,12,912,437,474,911,"6 de julio de 1997"
27,5,12,913,536,529,1065,"6 de julio de 1997"
27,5,12,914,476,482,958,"6 de julio de 1997"
27,5,12,915,537,564,1101,"6 de julio de 1997"
27,5,12,916,373,348,721,"6 de julio de 1997"
27,5,12,917,380,367,747,"6 de julio de 1997"
27,5,12,918,402,397,799,"6 de julio de 1997"
27,5,12,919,402,355,757,"6 de julio de 1997"
27,5,12,920,123,121,244,"6 de julio de 1997"
27,5,12,921,68,48,116,"6 de julio de 1997"
27,5,12,922,600,566,1166,"6 de julio de 1997"
27,5,12,923,627,577,1204,"6 de julio de 1997"
27,5,12,924,594,570,1164,"6 de julio de 1997"
27,5,12,925,504,426,930,"6 de julio de 1997"
27,5,12,926,134,109,243,"6 de julio de 1997"
27,5,12,927,256,243,499,"6 de julio de 1997"
27,5,12,928,490,432,922,"6 de julio de 1997"
27,5,12,929,489,431,920,"6 de julio de 1997"
27,5,12,930,398,416,814,"6 de julio de 1997"
27,5,12,931,434,484,918,"6 de julio de 1997"
27,5,12,932,221,193,414,"6 de julio de 1997"
27,5,12,933,437,442,879,"6 de julio de 1997"
27,5,12,934,763,777,1540,"6 de julio de 1997"
27,5,12,935,536,499,1035,"6 de julio de 1997"
27,5,12,936,160,164,324,"6 de julio de 1997"
27,5,12,937,224,177,401,"6 de julio de 1997"
27,5,12,938,494,472,966,"6 de julio de 1997"
27,5,12,939,614,558,1172,"6 de julio de 1997"
27,5,12,940,244,234,478,"6 de julio de 1997"
27,5,12,941,189,172,361,"6 de julio de 1997"
27,5,12,942,421,378,799,"6 de julio de 1997"
27,5,12,943,509,472,981,"6 de julio de 1997"
27,5,12,944,361,323,684,"6 de julio de 1997"
27,5,12,945,727,623,1350,"6 de julio de 1997"
27,5,12,946,447,367,814,"6 de julio de 1997"
27,5,12,947,643,533,1176,"6 de julio de 1997"
27,5,12,948,437,390,827,"6 de julio de 1997"
27,5,12,949,297,262,559,"6 de julio de 1997"
27,5,12,950,315,254,569,"6 de julio de 1997"
27,5,12,951,325,301,626,"6 de julio de 1997"
27,5,12,952,372,336,708,"6 de julio de 1997"
27,5,12,953,315,244,559,"6 de julio de 1997"
27,5,15,1036,425,412,837,"6 de julio de 1997"
27,5,15,1037,387,378,765,"6 de julio de 1997"
27,5,15,1038,632,607,1239,"6 de julio de 1997"
27,5,15,1039,463,492,955,"6 de julio de 1997"
27,5,15,1040,439,437,876,"6 de julio de 1997"
27,5,15,1041,216,180,396,"6 de julio de 1997"
27,5,15,1042,429,380,809,"6 de julio de 1997"
27,5,15,1043,125,96,221,"6 de julio de 1997"
27,5,15,1044,583,496,1079,"6 de julio de 1997"
27,5,15,1045,191,186,377,"6 de julio de 1997"
27,5,15,1046,251,214,465,"6 de julio de 1997"
27,5,15,1047,106,103,209,"6 de julio de 1997"
27,5,15,1048,83,62,145,"6 de julio de 1997"
27,5,15,1049,521,374,895,"6 de julio de 1997"
27,5,15,1050,600,513,1113,"6 de julio de 1997"
27,5,15,1051,627,560,1187,"6 de julio de 1997"
27,5,15,1052,494,429,923,"6 de julio de 1997"
27,5,15,1053,641,565,1206,"6 de julio de 1997"
27,5,15,1054,319,257,576,"6 de julio de 1997"
27,5,15,1055,449,383,832,"6 de julio de 1997"
27,5,15,1056,530,410,940,"6 de julio de 1997"
27,5,15,1057,232,226,458,"6 de julio de 1997"
27,5,15,1058,293,236,529,"6 de julio de 1997"
27,5,15,1059,226,195,421,"6 de julio de 1997"
27,5,15,1060,483,435,918,"6 de julio de 1997"
27,5,15,1061,473,410,883,"6 de julio de 1997"
27,5,15,1062,255,219,474,"6 de julio de 1997"
27,5,16,1063,634,614,1248,"6 de julio de 1997"
27,5,16,1064,633,677,1310,"6 de julio de 1997"
27,5,16,1065,451,449,900,"6 de julio de 1997"
27,5,16,1066,577,590,1167,"6 de julio de 1997"
27,5,16,1067,554,474,1028,"6 de julio de 1997"
27,5,16,1068,704,717,1421,"6 de julio de 1997"
27,5,16,1069,508,525,1033,"6 de julio de 1997"
27,5,16,1070,607,583,1190,"6 de julio de 1997"
27,5,16,1071,548,597,1145,"6 de julio de 1997"
27,5,16,1072,726,684,1410,"6 de julio de 1997"
27,5,16,1073,629,639,1268,"6 de julio de 1997"
27,5,16,1074,542,567,1109,"6 de julio de 1997"
27,5,16,1075,255,202,457,"6 de julio de 1997"
27,5,16,1076,268,222,490,"6 de julio de 1997"
27,5,16,1077,397,330,727,"6 de julio de 1997"
27,5,16,1078,335,295,630,"6 de julio de 1997"
27,5,16,1079,493,341,834,"6 de julio de 1997"
27,5,16,1080,333,237,570,"6 de julio de 1997"
27,5,16,1081,510,405,915,"6 de julio de 1997"
27,5,16,1082,913,813,1726,"6 de julio de 1997"
27,5,16,1083,593,549,1142,"6 de julio de 1997"
27,5,16,1084,181,123,304,"6 de julio de 1997"
27,5,16,1085,144,113,257,"6 de julio de 1997"
27,5,16,1086,232,211,443,"6 de julio de 1997"
27,5,16,1087,186,157,343,"6 de julio de 1997"
27,5,16,1088,650,536,1186,"6 de julio de 1997"
27,6,4,268,291,340,631,"6 de julio de 1997"
27,6,4,273,713,792,1505,"6 de julio de 1997"
27,6,4,274,491,532,1023,"6 de julio de 1997"
27,6,4,275,436,518,954,"6 de julio de 1997"
27,6,4,276,344,410,754,"6 de julio de 1997"
27,6,4,300,405,401,806,"6 de julio de 1997"
27,6,4,301,317,347,664,"6 de julio de 1997"
27,6,4,302,433,452,885,"6 de julio de 1997"
27,6,4,303,454,468,922,"6 de julio de 1997"
27,6,4,304,521,586,1107,"6 de julio de 1997"
27,6,4,305,436,546,982,"6 de julio de 1997"
27,6,4,306,368,441,809,"6 de julio de 1997"
27,6,4,308,316,338,654,"6 de julio de 1997"
27,6,4,311,357,386,743,"6 de julio de 1997"
27,6,4,312,429,501,930,"6 de julio de 1997"
27,6,4,313,331,350,681,"6 de julio de 1997"
27,6,4,314,893,992,1885,"6 de julio de 1997"
27,6,4,315,491,536,1027,"6 de julio de 1997"
27,6,4,316,465,469,934,"6 de julio de 1997"
27,6,4,317,341,402,743,"6 de julio de 1997"
27,6,4,318,186,251,437,"6 de julio de 1997"
27,6,4,320,562,559,1121,"6 de julio de 1997"
27,6,4,324,439,526,965,"6 de julio de 1997"
27,6,4,325,410,432,842,"6 de julio de 1997"
27,6,4,326,419,453,872,"6 de julio de 1997"
27,6,4,327,496,547,1043,"6 de julio de 1997"
27,6,4,328,522,595,1117,"6 de julio de 1997"
27,6,4,329,420,483,903,"6 de julio de 1997"
27,6,4,330,413,467,880,"6 de julio de 1997"
27,6,4,331,239,303,542,"6 de julio de 1997"
27,6,4,332,496,545,1041,"6 de julio de 1997"
27,6,4,334,514,547,1061,"6 de julio de 1997"
27,6,4,335,408,462,870,"6 de julio de 1997"
27,6,4,336,319,337,656,"6 de julio de 1997"
27,6,4,337,464,549,1013,"6 de julio de 1997"
27,6,4,338,358,420,778,"6 de julio de 1997"
27,6,4,339,220,238,458,"6 de julio de 1997"
27,6,4,340,453,550,1003,"6 de julio de 1997"
27,6,4,341,353,376,729,"6 de julio de 1997"
27,6,4,342,419,490,909,"6 de julio de 1997"
27,6,4,343,462,491,953,"6 de julio de 1997"
27,6,4,344,604,645,1249,"6 de julio de 1997"
27,6,4,345,447,503,950,"6 de julio de 1997"
27,6,4,346,478,501,979,"6 de julio de 1997"
27,6,4,347,374,423,797,"6 de julio de 1997"
27,6,4,348,432,526,958,"6 de julio de 1997"
27,6,4,349,364,438,802,"6 de julio de 1997"
27,6,4,350,487,563,1050,"6 de julio de 1997"
27,6,4,351,353,373,726,"6 de julio de 1997"
27,6,4,352,340,404,744,"6 de julio de 1997"
27,6,4,353,443,477,920,"6 de julio de 1997"
27,6,4,354,450,519,969,"6 de julio de 1997"
27,6,4,355,423,436,859,"6 de julio de 1997"
27,6,4,356,652,710,1362,"6 de julio de 1997"
27,6,4,357,520,522,1042,"6 de julio de 1997"
27,6,4,358,414,443,857,"6 de julio de 1997"
27,6,4,362,361,369,730,"6 de julio de 1997"
27,6,4,363,377,442,819,"6 de julio de 1997"
27,6,4,364,371,406,777,"6 de julio de 1997"
27,6,4,365,342,414,756,"6 de julio de 1997"
27,6,4,366,375,481,856,"6 de julio de 1997"
27,6,4,367,463,524,987,"6 de julio de 1997"
27,6,4,368,482,588,1070,"6 de julio de 1997"
27,6,4,369,524,594,1118,"6 de julio de 1997"
27,6,4,370,366,393,759,"6 de julio de 1997"
27,6,4,371,441,491,932,"6 de julio de 1997"
27,6,4,372,1380,1432,2812,"6 de julio de 1997"
27,6,4,373,507,549,1056,"6 de julio de 1997"
27,6,4,374,470,505,975,"6 de julio de 1997"
27,6,4,375,472,510,982,"6 de julio de 1997"
27,6,4,376,350,404,754,"6 de julio de 1997"
27,6,4,377,363,449,812,"6 de julio de 1997"
27,6,4,378,274,328,602,"6 de julio de 1997"
27,6,4,379,490,516,1006,"6 de julio de 1997"
27,6,4,380,335,385,720,"6 de julio de 1997"
27,6,4,381,371,412,783,"6 de julio de 1997"
27,6,4,385,373,381,754,"6 de julio de 1997"
27,6,4,386,389,430,819,"6 de julio de 1997"
27,6,4,387,470,524,994,"6 de julio de 1997"
27,6,4,388,468,508,976,"6 de julio de 1997"
27,6,4,389,324,413,737,"6 de julio de 1997"
27,6,4,390,309,367,676,"6 de julio de 1997"
27,6,4,391,569,661,1230,"6 de julio de 1997"
27,6,4,392,463,491,954,"6 de julio de 1997"
27,6,4,393,625,662,1287,"6 de julio de 1997"
27,6,4,394,434,515,949,"6 de julio de 1997"
27,6,4,395,499,556,1055,"6 de julio de 1997"
27,6,4,396,327,375,702,"6 de julio de 1997"
27,6,4,397,581,615,1196,"6 de julio de 1997"
27,6,4,398,295,307,602,"6 de julio de 1997"
27,6,4,399,547,637,1184,"6 de julio de 1997"
27,6,4,400,533,623,1156,"6 de julio de 1997"
27,6,4,401,970,1114,2084,"6 de julio de 1997"
27,6,4,402,415,515,930,"6 de julio de 1997"
27,6,4,403,442,497,939,"6 de julio de 1997"
27,6,4,404,636,691,1327,"6 de julio de 1997"
27,6,4,406,454,468,922,"6 de julio de 1997"
27,6,4,407,458,481,939,"6 de julio de 1997"
27,6,4,408,532,570,1102,"6 de julio de 1997"
27,6,4,409,484,563,1047,"6 de julio de 1997"
27,6,4,410,329,326,655,"6 de julio de 1997"
27,6,4,411,556,595,1151,"6 de julio de 1997"
27,6,4,412,494,563,1057,"6 de julio de 1997"
27,6,4,413,463,502,965,"6 de julio de 1997"
27,6,4,414,463,529,992,"6 de julio de 1997"
27,6,4,415,966,1062,2028,"6 de julio de 1997"
27,6,4,416,503,550,1053,"6 de julio de 1997"
27,6,4,417,345,417,762,"6 de julio de 1997"
27,6,4,418,391,433,824,"6 de julio de 1997"
27,6,4,452,458,403,861,"6 de julio de 1997"
27,6,4,453,450,446,896,"6 de julio de 1997"
27,6,4,458,581,571,1152,"6 de julio de 1997"
27,6,4,459,59,46,105,"6 de julio de 1997"
27,6,4,460,605,547,1152,"6 de julio de 1997"
27,6,4,461,333,300,633,"6 de julio de 1997"
27,6,4,462,557,544,1101,"6 de julio de 1997"
27,6,4,463,677,645,1322,"6 de julio de 1997"
27,6,4,464,588,568,1156,"6 de julio de 1997"
27,6,4,465,473,459,932,"6 de julio de 1997"
27,6,4,467,827,783,1610,"6 de julio de 1997"
27,6,4,468,433,454,887,"6 de julio de 1997"
27,6,4,469,565,519,1084,"6 de julio de 1997"
27,6,4,470,536,575,1111,"6 de julio de 1997"
27,6,4,475,416,407,823,"6 de julio de 1997"
27,6,4,476,424,389,813,"6 de julio de 1997"
27,6,4,477,597,541,1138,"6 de julio de 1997"
27,6,4,479,346,320,666,"6 de julio de 1997"
27,6,4,480,929,891,1820,"6 de julio de 1997"
27,6,4,481,647,587,1234,"6 de julio de 1997"
27,6,4,482,419,413,832,"6 de julio de 1997"
27,6,4,483,288,314,602,"6 de julio de 1997"
27,6,4,484,589,583,1172,"6 de julio de 1997"
27,6,4,485,575,603,1178,"6 de julio de 1997"
27,6,4,486,455,437,892,"6 de julio de 1997"
27,6,4,487,226,246,472,"6 de julio de 1997"
27,6,4,488,231,264,495,"6 de julio de 1997"
27,6,4,490,469,408,877,"6 de julio de 1997"
27,6,4,491,536,484,1020,"6 de julio de 1997"
27,6,4,492,312,283,595,"6 de julio de 1997"
27,6,4,494,518,467,985,"6 de julio de 1997"
27,6,4,495,609,553,1162,"6 de julio de 1997"
27,6,4,496,261,225,486,"6 de julio de 1997"
27,6,4,497,685,632,1317,"6 de julio de 1997"
27,6,4,498,629,567,1196,"6 de julio de 1997"
27,6,4,499,142,152,294,"6 de julio de 1997"
27,6,4,500,695,734,1429,"6 de julio de 1997"
27,6,4,501,614,615,1229,"6 de julio de 1997"
27,6,4,502,860,811,1671,"6 de julio de 1997"
27,6,4,503,639,622,1261,"6 de julio de 1997"
27,6,4,504,519,441,960,"6 de julio de 1997"
27,6,4,505,409,400,809,"6 de julio de 1997"
27,6,4,506,279,289,568,"6 de julio de 1997"
27,6,4,507,355,308,663,"6 de julio de 1997"
27,6,4,508,517,512,1029,"6 de julio de 1997"
27,6,4,509,160,138,298,"6 de julio de 1997"
27,6,4,510,140,123,263,"6 de julio de 1997"
27,6,4,511,386,67,453,"6 de julio de 1997"
28,1,7,125,351,379,730,"6 de julio de 1997"
28,1,7,126,464,488,952,"6 de julio de 1997"
28,1,7,127,541,563,1104,"6 de julio de 1997"
28,1,7,128,323,344,667,"6 de julio de 1997"
28,1,7,129,321,342,663,"6 de julio de 1997"
28,1,7,130,291,318,609,"6 de julio de 1997"
28,1,7,131,467,504,971,"6 de julio de 1997"
28,1,7,132,315,319,634,"6 de julio de 1997"
28,1,7,133,278,287,565,"6 de julio de 1997"
28,1,7,134,268,268,536,"6 de julio de 1997"
28,1,7,135,173,155,328,"6 de julio de 1997"
28,1,7,136,102,103,205,"6 de julio de 1997"
28,1,7,137,287,315,602,"6 de julio de 1997"
28,1,7,138,178,183,361,"6 de julio de 1997"
28,1,7,139,215,207,422,"6 de julio de 1997"
28,1,7,140,76,51,127,"6 de julio de 1997"
28,1,7,141,72,58,130,"6 de julio de 1997"
28,1,7,142,246,191,437,"6 de julio de 1997"
28,1,14,327,434,424,858,"6 de julio de 1997"
28,1,14,328,364,343,707,"6 de julio de 1997"
28,1,14,329,307,288,595,"6 de julio de 1997"
28,1,14,330,52,34,86,"6 de julio de 1997"
28,1,14,331,6,4,10,"6 de julio de 1997"
28,1,15,332,397,447,844,"6 de julio de 1997"
28,1,15,333,519,557,1076,"6 de julio de 1997"
28,1,15,334,470,440,910,"6 de julio de 1997"
28,1,15,335,517,548,1065,"6 de julio de 1997"
28,1,15,336,510,527,1037,"6 de julio de 1997"
28,1,15,337,441,539,980,"6 de julio de 1997"
28,1,15,338,462,462,924,"6 de julio de 1997"
28,1,15,339,517,491,1008,"6 de julio de 1997"
28,1,15,340,450,499,949,"6 de julio de 1997"
28,1,15,341,108,95,203,"6 de julio de 1997"
28,1,15,342,310,299,609,"6 de julio de 1997"
28,1,15,343,194,170,364,"6 de julio de 1997"
28,1,15,344,345,363,708,"6 de julio de 1997"
28,1,15,345,310,271,581,"6 de julio de 1997"
28,1,24,716,280,302,582,"6 de julio de 1997"
28,1,24,717,402,413,815,"6 de julio de 1997"
28,1,24,718,266,266,532,"6 de julio de 1997"
28,1,24,719,324,341,665,"6 de julio de 1997"
28,1,24,720,332,355,687,"6 de julio de 1997"
28,1,24,721,301,284,585,"6 de julio de 1997"
28,1,25,722,293,328,621,"6 de julio de 1997"
28,1,25,723,465,525,990,"6 de julio de 1997"
28,1,25,724,318,336,654,"6 de julio de 1997"
28,1,25,725,421,416,837,"6 de julio de 1997"
28,1,25,726,361,299,660,"6 de julio de 1997"
28,1,25,727,415,458,873,"6 de julio de 1997"
28,1,25,728,446,451,897,"6 de julio de 1997"
28,1,25,729,255,275,530,"6 de julio de 1997"
28,1,25,730,383,430,813,"6 de julio de 1997"
28,1,25,731,269,269,538,"6 de julio de 1997"
28,1,25,732,283,326,609,"6 de julio de 1997"
28,1,25,733,524,535,1059,"6 de julio de 1997"
28,1,25,734,369,394,763,"6 de julio de 1997"
28,1,25,735,445,478,923,"6 de julio de 1997"
28,1,25,736,305,302,607,"6 de julio de 1997"
28,1,25,737,106,98,204,"6 de julio de 1997"
28,1,25,738,220,245,465,"6 de julio de 1997"
28,1,25,739,383,391,774,"6 de julio de 1997"
28,1,25,740,167,177,344,"6 de julio de 1997"
28,1,25,741,36,31,67,"6 de julio de 1997"
28,1,25,742,70,46,116,"6 de julio de 1997"
28,1,25,743,175,152,327,"6 de julio de 1997"
28,1,25,744,199,159,358,"6 de julio de 1997"
28,1,27,749,486,481,967,"6 de julio de 1997"
28,1,27,750,569,591,1160,"6 de julio de 1997"
28,1,27,751,144,170,314,"6 de julio de 1997"
28,1,27,752,442,472,914,"6 de julio de 1997"
28,1,27,753,280,287,567,"6 de julio de 1997"
28,1,27,754,916,921,1837,"6 de julio de 1997"
28,1,27,755,502,507,1009,"6 de julio de 1997"
28,1,27,756,881,950,1831,"6 de julio de 1997"
28,1,27,757,561,647,1208,"6 de julio de 1997"
28,1,27,758,568,710,1278,"6 de julio de 1997"
28,1,27,759,704,772,1476,"6 de julio de 1997"
28,1,27,760,536,632,1168,"6 de julio de 1997"
28,1,27,761,615,639,1254,"6 de julio de 1997"
28,1,27,762,597,593,1190,"6 de julio de 1997"
28,1,27,763,486,531,1017,"6 de julio de 1997"
28,1,27,764,386,401,787,"6 de julio de 1997"
28,1,27,765,567,589,1156,"6 de julio de 1997"
28,1,27,766,565,567,1132,"6 de julio de 1997"
28,1,27,767,477,550,1027,"6 de julio de 1997"
28,1,27,768,295,312,607,"6 de julio de 1997"
28,1,27,769,339,429,768,"6 de julio de 1997"
28,1,27,770,480,483,963,"6 de julio de 1997"
28,1,27,771,263,253,516,"6 de julio de 1997"
28,1,27,772,287,268,555,"6 de julio de 1997"
28,1,27,773,284,310,594,"6 de julio de 1997"
28,1,27,774,525,579,1104,"6 de julio de 1997"
28,1,27,775,575,571,1146,"6 de julio de 1997"
28,1,27,776,353,346,699,"6 de julio de 1997"
28,1,27,777,264,277,541,"6 de julio de 1997"
28,1,27,778,562,582,1144,"6 de julio de 1997"
28,1,27,779,554,579,1133,"6 de julio de 1997"
28,1,27,780,697,744,1441,"6 de julio de 1997"
28,1,27,781,529,543,1072,"6 de julio de 1997"
28,1,27,782,585,610,1195,"6 de julio de 1997"
28,1,27,783,436,505,941,"6 de julio de 1997"
28,1,27,784,665,750,1415,"6 de julio de 1997"
28,1,27,785,644,76,720,"6 de julio de 1997"
28,1,27,786,270,329,599,"6 de julio de 1997"
28,1,27,787,354,348,702,"6 de julio de 1997"
28,1,27,788,556,540,1096,"6 de julio de 1997"
28,1,27,789,344,309,653,"6 de julio de 1997"
28,1,27,790,288,351,639,"6 de julio de 1997"
28,1,27,791,516,596,1112,"6 de julio de 1997"
28,1,27,792,414,422,836,"6 de julio de 1997"
28,1,27,793,337,340,677,"6 de julio de 1997"
28,1,27,794,376,388,764,"6 de julio de 1997"
28,1,27,795,257,292,549,"6 de julio de 1997"
28,1,27,796,469,535,1004,"6 de julio de 1997"
28,1,27,797,384,416,800,"6 de julio de 1997"
28,1,27,798,558,631,1189,"6 de julio de 1997"
28,1,27,799,409,437,846,"6 de julio de 1997"
28,1,27,800,386,401,787,"6 de julio de 1997"
28,1,27,801,294,303,597,"6 de julio de 1997"
28,1,27,802,323,352,675,"6 de julio de 1997"
28,1,27,803,394,383,777,"6 de julio de 1997"
28,1,27,804,262,296,558,"6 de julio de 1997"
28,1,27,805,290,356,646,"6 de julio de 1997"
28,1,27,806,386,432,818,"6 de julio de 1997"
28,1,27,807,512,571,1083,"6 de julio de 1997"
28,1,27,808,567,653,1220,"6 de julio de 1997"
28,1,27,809,595,565,1160,"6 de julio de 1997"
28,1,27,810,803,813,1616,"6 de julio de 1997"
28,1,27,811,760,814,1574,"6 de julio de 1997"
28,1,27,812,589,570,1159,"6 de julio de 1997"
28,1,27,813,1045,1103,2148,"6 de julio de 1997"
28,1,27,814,1058,1118,2176,"6 de julio de 1997"
28,1,27,815,1830,1799,3629,"6 de julio de 1997"
28,1,27,816,1239,1286,2525,"6 de julio de 1997"
28,1,27,817,725,784,1509,"6 de julio de 1997"
28,1,27,818,380,382,762,"6 de julio de 1997"
28,1,27,819,525,548,1073,"6 de julio de 1997"
28,1,27,820,565,615,1180,"6 de julio de 1997"
28,1,27,821,343,344,687,"6 de julio de 1997"
28,1,27,822,301,357,658,"6 de julio de 1997"
28,1,27,823,579,615,1194,"6 de julio de 1997"
28,1,27,824,522,634,1156,"6 de julio de 1997"
28,1,27,825,548,623,1171,"6 de julio de 1997"
28,1,27,826,540,601,1141,"6 de julio de 1997"
28,1,27,827,689,704,1393,"6 de julio de 1997"
28,1,27,828,648,722,1370,"6 de julio de 1997"
28,1,27,829,495,566,1061,"6 de julio de 1997"
28,1,27,830,368,458,826,"6 de julio de 1997"
28,1,27,831,204,239,443,"6 de julio de 1997"
28,1,27,832,455,479,934,"6 de julio de 1997"
28,1,27,833,271,294,565,"6 de julio de 1997"
28,1,27,834,282,340,622,"6 de julio de 1997"
28,1,27,835,442,487,929,"6 de julio de 1997"
28,1,27,836,377,427,804,"6 de julio de 1997"
28,1,27,837,564,658,1222,"6 de julio de 1997"
28,1,27,838,405,427,832,"6 de julio de 1997"
28,1,27,839,640,623,1263,"6 de julio de 1997"
28,1,27,840,459,473,932,"6 de julio de 1997"
28,1,27,841,478,501,979,"6 de julio de 1997"
28,1,27,842,448,484,932,"6 de julio de 1997"
28,1,27,843,366,404,770,"6 de julio de 1997"
28,1,27,844,547,567,1114,"6 de julio de 1997"
28,1,27,845,431,528,959,"6 de julio de 1997"
28,1,27,846,313,362,675,"6 de julio de 1997"
28,1,27,847,554,566,1120,"6 de julio de 1997"
28,1,27,848,610,650,1260,"6 de julio de 1997"
28,1,27,849,384,467,851,"6 de julio de 1997"
28,1,27,850,375,371,746,"6 de julio de 1997"
28,1,27,851,107,134,241,"6 de julio de 1997"
28,1,27,852,482,509,991,"6 de julio de 1997"
28,1,27,853,484,567,1051,"6 de julio de 1997"
28,1,27,854,691,804,1495,"6 de julio de 1997"
28,1,27,855,401,437,838,"6 de julio de 1997"
28,1,27,856,394,430,824,"6 de julio de 1997"
28,1,27,857,430,523,953,"6 de julio de 1997"
28,1,27,858,282,304,586,"6 de julio de 1997"
28,1,27,859,742,765,1507,"6 de julio de 1997"
28,1,27,860,647,773,1420,"6 de julio de 1997"
28,1,27,861,359,391,750,"6 de julio de 1997"
28,1,27,862,454,459,913,"6 de julio de 1997"
28,1,27,863,586,584,1170,"6 de julio de 1997"
28,1,27,864,422,437,859,"6 de julio de 1997"
28,1,27,865,601,625,1226,"6 de julio de 1997"
28,1,27,866,950,991,1941,"6 de julio de 1997"
28,1,27,867,586,629,1215,"6 de julio de 1997"
28,1,27,868,677,730,1407,"6 de julio de 1997"
28,1,27,869,542,602,1144,"6 de julio de 1997"
28,1,27,870,441,505,946,"6 de julio de 1997"
28,1,27,871,548,597,1145,"6 de julio de 1997"
28,1,27,872,572,590,1162,"6 de julio de 1997"
28,1,27,873,782,813,1595,"6 de julio de 1997"
28,1,27,874,510,528,1038,"6 de julio de 1997"
28,1,27,875,522,476,998,"6 de julio de 1997"
28,1,27,876,543,599,1142,"6 de julio de 1997"
28,1,27,877,544,557,1101,"6 de julio de 1997"
28,1,27,878,540,537,1077,"6 de julio de 1997"
28,1,27,879,689,698,1387,"6 de julio de 1997"
28,1,27,880,294,347,641,"6 de julio de 1997"
28,1,27,881,522,533,1055,"6 de julio de 1997"
28,1,27,882,380,383,763,"6 de julio de 1997"
28,1,27,883,473,529,1002,"6 de julio de 1997"
28,1,27,884,433,492,925,"6 de julio de 1997"
28,1,27,885,533,589,1122,"6 de julio de 1997"
28,1,27,886,578,645,1223,"6 de julio de 1997"
28,1,27,887,559,599,1158,"6 de julio de 1997"
28,1,27,888,564,654,1218,"6 de julio de 1997"
28,1,27,889,541,545,1086,"6 de julio de 1997"
28,1,27,890,846,978,1824,"6 de julio de 1997"
28,1,27,891,703,759,1462,"6 de julio de 1997"
28,1,27,892,436,491,927,"6 de julio de 1997"
28,1,27,893,353,403,756,"6 de julio de 1997"
28,1,27,894,610,646,1256,"6 de julio de 1997"
28,1,27,895,477,528,1005,"6 de julio de 1997"
28,1,27,896,405,453,858,"6 de julio de 1997"
28,1,27,897,275,277,552,"6 de julio de 1997"
28,1,27,898,678,733,1411,"6 de julio de 1997"
28,1,27,899,294,330,624,"6 de julio de 1997"
28,1,27,900,377,375,752,"6 de julio de 1997"
28,1,27,901,183,183,366,"6 de julio de 1997"
28,1,27,902,149,134,283,"6 de julio de 1997"
28,1,27,903,132,101,233,"6 de julio de 1997"
28,1,27,904,151,121,272,"6 de julio de 1997"
28,2,32,935,456,475,931,"6 de julio de 1997"
28,2,32,936,393,464,857,"6 de julio de 1997"
28,2,32,937,467,479,946,"6 de julio de 1997"
28,2,32,938,282,310,592,"6 de julio de 1997"
28,2,32,939,365,417,782,"6 de julio de 1997"
28,2,32,940,400,471,871,"6 de julio de 1997"
28,2,32,941,656,677,1333,"6 de julio de 1997"
28,2,32,942,322,360,682,"6 de julio de 1997"
28,2,32,943,571,619,1190,"6 de julio de 1997"
28,2,32,944,505,529,1034,"6 de julio de 1997"
28,2,32,945,557,599,1156,"6 de julio de 1997"
28,2,32,946,606,688,1294,"6 de julio de 1997"
28,2,32,947,578,662,1240,"6 de julio de 1997"
28,2,32,948,550,655,1205,"6 de julio de 1997"
28,2,32,949,419,467,886,"6 de julio de 1997"
28,2,32,950,497,526,1023,"6 de julio de 1997"
28,2,32,951,572,659,1231,"6 de julio de 1997"
28,2,32,952,652,681,1333,"6 de julio de 1997"
28,2,32,953,655,607,1262,"6 de julio de 1997"
28,2,32,954,312,328,640,"6 de julio de 1997"
28,2,32,955,502,518,1020,"6 de julio de 1997"
28,2,32,956,448,522,970,"6 de julio de 1997"
28,2,32,957,671,671,1342,"6 de julio de 1997"
28,2,32,958,410,419,829,"6 de julio de 1997"
28,2,32,959,479,496,975,"6 de julio de 1997"
28,2,32,960,523,578,1101,"6 de julio de 1997"
28,2,32,961,382,453,835,"6 de julio de 1997"
28,2,32,962,326,386,712,"6 de julio de 1997"
28,2,32,963,485,617,1102,"6 de julio de 1997"
28,2,32,964,662,672,1334,"6 de julio de 1997"
28,2,32,965,622,677,1299,"6 de julio de 1997"
28,2,32,966,700,745,1445,"6 de julio de 1997"
28,2,32,967,576,652,1228,"6 de julio de 1997"
28,2,32,968,401,434,835,"6 de julio de 1997"
28,2,32,969,275,343,618,"6 de julio de 1997"
28,2,32,970,569,627,1196,"6 de julio de 1997"
28,2,32,971,510,488,998,"6 de julio de 1997"
28,2,32,972,445,454,899,"6 de julio de 1997"
28,2,32,973,669,737,1406,"6 de julio de 1997"
28,2,32,974,471,488,959,"6 de julio de 1997"
28,2,32,975,554,540,1094,"6 de julio de 1997"
28,2,32,976,317,305,622,"6 de julio de 1997"
28,2,32,977,457,480,937,"6 de julio de 1997"
28,2,32,978,597,691,1288,"6 de julio de 1997"
28,2,32,979,456,515,971,"6 de julio de 1997"
28,2,32,980,541,583,1124,"6 de julio de 1997"
28,2,32,981,284,298,582,"6 de julio de 1997"
28,2,32,982,415,508,923,"6 de julio de 1997"
28,2,32,983,420,468,888,"6 de julio de 1997"
28,2,32,984,401,468,869,"6 de julio de 1997"
28,2,32,985,575,630,1205,"6 de julio de 1997"
28,2,32,986,122,128,250,"6 de julio de 1997"
28,2,32,987,336,392,728,"6 de julio de 1997"
28,2,32,988,410,436,846,"6 de julio de 1997"
28,2,32,989,369,422,791,"6 de julio de 1997"
28,2,32,990,563,556,1119,"6 de julio de 1997"
28,2,32,991,584,600,1184,"6 de julio de 1997"
28,2,32,992,152,126,278,"6 de julio de 1997"
28,2,32,993,245,192,437,"6 de julio de 1997"
28,2,32,994,55,44,99,"6 de julio de 1997"
28,2,32,995,489,522,1011,"6 de julio de 1997"
28,2,32,996,650,662,1312,"6 de julio de 1997"
28,2,32,997,604,630,1234,"6 de julio de 1997"
28,2,32,998,562,613,1175,"6 de julio de 1997"
28,2,32,999,573,601,1174,"6 de julio de 1997"
28,2,32,1000,617,717,1334,"6 de julio de 1997"
28,2,32,1001,487,539,1026,"6 de julio de 1997"
28,2,32,1002,390,413,803,"6 de julio de 1997"
28,2,32,1003,480,559,1039,"6 de julio de 1997"
28,2,32,1004,329,361,690,"6 de julio de 1997"
28,2,32,1005,423,520,943,"6 de julio de 1997"
28,2,32,1006,303,340,643,"6 de julio de 1997"
28,2,32,1007,540,642,1182,"6 de julio de 1997"
28,2,32,1008,393,452,845,"6 de julio de 1997"
28,2,32,1009,363,401,764,"6 de julio de 1997"
28,2,32,1010,303,367,670,"6 de julio de 1997"
28,2,32,1011,501,622,1123,"6 de julio de 1997"
28,2,32,1012,377,431,808,"6 de julio de 1997"
28,2,32,1013,557,637,1194,"6 de julio de 1997"
28,2,32,1014,462,534,996,"6 de julio de 1997"
28,2,32,1015,546,626,1172,"6 de julio de 1997"
28,2,32,1016,546,581,1127,"6 de julio de 1997"
28,2,32,1017,487,552,1039,"6 de julio de 1997"
28,2,32,1018,379,410,789,"6 de julio de 1997"
28,2,32,1019,300,308,608,"6 de julio de 1997"
28,2,32,1020,477,510,987,"6 de julio de 1997"
28,2,32,1021,285,349,634,"6 de julio de 1997"
28,2,32,1022,998,1187,2185,"6 de julio de 1997"
28,2,32,1023,989,1178,2167,"6 de julio de 1997"
28,2,32,1024,596,665,1261,"6 de julio de 1997"
28,2,32,1025,523,616,1139,"6 de julio de 1997"
28,2,32,1026,768,866,1634,"6 de julio de 1997"
28,2,32,1027,565,615,1180,"6 de julio de 1997"
28,2,32,1028,406,474,880,"6 de julio de 1997"
28,2,32,1029,463,529,992,"6 de julio de 1997"
28,2,32,1030,432,532,964,"6 de julio de 1997"
28,2,32,1031,453,551,1004,"6 de julio de 1997"
28,2,32,1032,324,403,727,"6 de julio de 1997"
28,2,32,1033,373,421,794,"6 de julio de 1997"
28,2,32,1034,313,369,682,"6 de julio de 1997"
28,2,32,1035,473,511,984,"6 de julio de 1997"
28,2,32,1036,481,511,992,"6 de julio de 1997"
28,2,32,1037,617,678,1295,"6 de julio de 1997"
28,2,32,1038,586,660,1246,"6 de julio de 1997"
28,2,32,1039,489,550,1039,"6 de julio de 1997"
28,2,32,1040,680,743,1423,"6 de julio de 1997"
28,2,32,1041,504,572,1076,"6 de julio de 1997"
28,2,32,1042,557,590,1147,"6 de julio de 1997"
28,2,32,1043,590,672,1262,"6 de julio de 1997"
28,2,32,1044,392,434,826,"6 de julio de 1997"
28,2,32,1045,478,579,1057,"6 de julio de 1997"
28,2,32,1046,514,647,1161,"6 de julio de 1997"
28,2,32,1047,547,589,1136,"6 de julio de 1997"
28,2,32,1048,533,584,1117,"6 de julio de 1997"
28,2,32,1049,499,495,994,"6 de julio de 1997"
28,2,32,1050,485,554,1039,"6 de julio de 1997"
28,2,32,1051,433,460,893,"6 de julio de 1997"
28,2,32,1052,547,609,1156,"6 de julio de 1997"
28,2,32,1053,444,533,977,"6 de julio de 1997"
28,2,32,1054,282,323,605,"6 de julio de 1997"
28,2,32,1055,420,472,892,"6 de julio de 1997"
28,2,32,1056,783,943,1726,"6 de julio de 1997"
28,2,32,1057,730,751,1481,"6 de julio de 1997"
28,2,32,1058,638,688,1326,"6 de julio de 1997"
28,2,32,1059,382,430,812,"6 de julio de 1997"
28,2,32,1060,499,544,1043,"6 de julio de 1997"
28,2,32,1061,517,594,1111,"6 de julio de 1997"
28,2,32,1062,647,634,1281,"6 de julio de 1997"
28,2,32,1063,504,604,1108,"6 de julio de 1997"
28,2,32,1064,521,579,1100,"6 de julio de 1997"
28,2,32,1065,334,372,706,"6 de julio de 1997"
28,2,32,1066,769,877,1646,"6 de julio de 1997"
28,2,32,1067,332,331,663,"6 de julio de 1997"
28,2,32,1068,474,491,965,"6 de julio de 1997"
28,2,32,1069,533,556,1089,"6 de julio de 1997"
28,2,32,1070,521,545,1066,"6 de julio de 1997"
28,2,32,1071,482,483,965,"6 de julio de 1997"
28,2,32,1072,257,251,508,"6 de julio de 1997"
28,2,32,1073,1127,1315,2442,"6 de julio de 1997"
28,2,32,1074,641,732,1373,"6 de julio de 1997"
28,2,32,1075,627,664,1291,"6 de julio de 1997"
28,2,32,1076,568,595,1163,"6 de julio de 1997"
28,2,32,1077,399,431,830,"6 de julio de 1997"
28,2,32,1078,627,646,1273,"6 de julio de 1997"
28,2,32,1079,495,522,1017,"6 de julio de 1997"
28,2,32,1080,591,667,1258,"6 de julio de 1997"
28,2,32,1081,510,587,1097,"6 de julio de 1997"
28,2,32,1082,456,532,988,"6 de julio de 1997"
28,2,32,1083,394,430,824,"6 de julio de 1997"
28,2,32,1084,632,635,1267,"6 de julio de 1997"
28,2,32,1085,671,745,1416,"6 de julio de 1997"
28,2,32,1086,558,607,1165,"6 de julio de 1997"
28,2,32,1087,613,739,1352,"6 de julio de 1997"
28,2,32,1088,623,635,1258,"6 de julio de 1997"
28,2,32,1089,728,766,1494,"6 de julio de 1997"
28,2,32,1090,679,790,1469,"6 de julio de 1997"
28,2,32,1091,491,529,1020,"6 de julio de 1997"
28,2,32,1092,243,267,510,"6 de julio de 1997"
28,2,32,1093,531,52,583,"6 de julio de 1997"
28,2,32,1094,1004,1093,2097,"6 de julio de 1997"
28,2,32,1095,758,787,1545,"6 de julio de 1997"
28,2,32,1096,673,733,1406,"6 de julio de 1997"
28,2,32,1097,638,692,1330,"6 de julio de 1997"
28,2,32,1098,550,619,1169,"6 de julio de 1997"
28,2,32,1099,565,608,1173,"6 de julio de 1997"
28,2,32,1100,560,590,1150,"6 de julio de 1997"
28,2,32,1101,337,393,730,"6 de julio de 1997"
28,2,32,1102,559,622,1181,"6 de julio de 1997"
28,2,32,1103,609,723,1332,"6 de julio de 1997"
28,2,32,1104,538,618,1156,"6 de julio de 1997"
28,2,32,1105,579,654,1233,"6 de julio de 1997"
28,2,32,1106,503,540,1043,"6 de julio de 1997"
28,2,32,1107,381,436,817,"6 de julio de 1997"
28,2,32,1108,539,594,1133,"6 de julio de 1997"
28,2,32,1109,786,812,1598,"6 de julio de 1997"
28,2,32,1110,433,428,861,"6 de julio de 1997"
28,2,32,1111,221,223,444,"6 de julio de 1997"
28,2,32,1112,491,528,1019,"6 de julio de 1997"
28,2,32,1113,376,386,762,"6 de julio de 1997"
28,2,32,1114,459,557,1016,"6 de julio de 1997"
28,2,32,1115,486,577,1063,"6 de julio de 1997"
28,2,32,1116,592,722,1314,"6 de julio de 1997"
28,2,32,1117,492,598,1090,"6 de julio de 1997"
28,2,32,1118,573,586,1159,"6 de julio de 1997"
28,2,32,1119,680,768,1448,"6 de julio de 1997"
28,2,32,1120,489,542,1031,"6 de julio de 1997"
28,2,32,1121,381,457,838,"6 de julio de 1997"
28,2,32,1122,575,574,1149,"6 de julio de 1997"
28,2,32,1123,347,395,742,"6 de julio de 1997"
28,2,32,1124,443,416,859,"6 de julio de 1997"
28,2,32,1125,147,139,286,"6 de julio de 1997"
28,2,32,1126,71,63,134,"6 de julio de 1997"
28,2,32,1127,290,170,460,"6 de julio de 1997"
28,2,32,1128,76,46,122,"6 de julio de 1997"
28,2,32,1129,98,74,172,"6 de julio de 1997"
28,2,32,1130,351,230,581,"6 de julio de 1997"
28,2,32,1131,223,127,350,"6 de julio de 1997"
28,2,32,1132,119,82,201,"6 de julio de 1997"
28,2,32,1133,150,89,239,"6 de julio de 1997"
28,2,32,1134,287,186,473,"6 de julio de 1997"
28,2,32,1135,313,274,587,"6 de julio de 1997"
28,2,32,1136,383,346,729,"6 de julio de 1997"
28,2,32,1137,325,297,622,"6 de julio de 1997"
28,2,32,1138,41,29,70,"6 de julio de 1997"
28,3,1,1,281,262,543,"6 de julio de 1997"
28,3,1,2,489,479,968,"6 de julio de 1997"
28,3,1,3,302,293,595,"6 de julio de 1997"
28,3,1,4,315,326,641,"6 de julio de 1997"
28,3,1,5,315,319,634,"6 de julio de 1997"
28,3,1,6,227,209,436,"6 de julio de 1997"
28,3,1,7,30,16,46,"6 de julio de 1997"
28,3,1,8,430,392,822,"6 de julio de 1997"
28,3,1,9,406,364,770,"6 de julio de 1997"
28,3,1,10,575,514,1089,"6 de julio de 1997"
28,3,1,11,281,236,517,"6 de julio de 1997"
28,3,1,12,310,225,535,"6 de julio de 1997"
28,3,5,108,277,272,549,"6 de julio de 1997"
28,3,5,109,305,255,560,"6 de julio de 1997"
28,3,5,110,328,270,598,"6 de julio de 1997"
28,3,5,111,114,106,220,"6 de julio de 1997"
28,3,5,112,214,213,427,"6 de julio de 1997"
28,3,5,113,89,77,166,"6 de julio de 1997"
28,3,5,114,399,351,750,"6 de julio de 1997"
28,3,5,115,93,73,166,"6 de julio de 1997"
28,3,10,259,184,167,351,"6 de julio de 1997"
28,3,10,260,59,53,112,"6 de julio de 1997"
28,3,10,261,77,52,129,"6 de julio de 1997"
28,3,10,262,84,91,175,"6 de julio de 1997"
28,3,10,263,37,20,57,"6 de julio de 1997"
28,3,10,264,160,137,297,"6 de julio de 1997"
28,3,10,265,204,165,369,"6 de julio de 1997"
28,3,18,381,549,497,1046,"6 de julio de 1997"
28,3,18,382,410,435,845,"6 de julio de 1997"
28,3,18,383,242,232,474,"6 de julio de 1997"
28,3,18,384,429,393,822,"6 de julio de 1997"
28,3,18,385,379,375,754,"6 de julio de 1997"
28,3,18,386,204,159,363,"6 de julio de 1997"
28,3,18,387,191,147,338,"6 de julio de 1997"
28,3,18,388,394,332,726,"6 de julio de 1997"
28,3,23,710,363,283,646,"6 de julio de 1997"
28,3,23,711,258,250,508,"6 de julio de 1997"
28,3,23,712,505,453,958,"6 de julio de 1997"
28,3,23,713,318,296,614,"6 de julio de 1997"
28,3,23,714,261,203,464,"6 de julio de 1997"
28,3,23,715,132,110,242,"6 de julio de 1997"
28,3,30,922,488,460,948,"6 de julio de 1997"
28,3,30,923,426,400,826,"6 de julio de 1997"
28,3,30,924,574,514,1088,"6 de julio de 1997"
28,3,30,925,393,418,811,"6 de julio de 1997"
28,3,30,926,703,660,1363,"6 de julio de 1997"
28,3,30,927,397,393,790,"6 de julio de 1997"
28,3,30,928,573,492,1065,"6 de julio de 1997"
28,3,30,929,380,317,697,"6 de julio de 1997"
28,3,30,930,509,452,961,"6 de julio de 1997"
28,3,33,1139,244,250,494,"6 de julio de 1997"
28,3,33,1140,322,330,652,"6 de julio de 1997"
28,3,33,1141,372,391,763,"6 de julio de 1997"
28,3,33,1142,297,341,638,"6 de julio de 1997"
28,3,33,1143,288,323,611,"6 de julio de 1997"
28,3,33,1144,349,424,773,"6 de julio de 1997"
28,3,33,1145,645,625,1270,"6 de julio de 1997"
28,3,33,1146,372,402,774,"6 de julio de 1997"
28,3,33,1147,544,576,1120,"6 de julio de 1997"
28,3,33,1148,645,696,1341,"6 de julio de 1997"
28,3,33,1149,579,661,1240,"6 de julio de 1997"
28,3,33,1150,456,481,937,"6 de julio de 1997"
28,3,33,1151,535,637,1172,"6 de julio de 1997"
28,3,33,1152,635,645,1280,"6 de julio de 1997"
28,3,33,1153,351,391,742,"6 de julio de 1997"
28,3,33,1154,426,495,921,"6 de julio de 1997"
28,3,33,1155,498,575,1073,"6 de julio de 1997"
28,3,33,1156,522,580,1102,"6 de julio de 1997"
28,3,33,1157,624,690,1314,"6 de julio de 1997"
28,3,33,1158,639,653,1292,"6 de julio de 1997"
28,3,33,1159,681,775,1456,"6 de julio de 1997"
28,3,33,1160,161,134,295,"6 de julio de 1997"
28,3,33,1161,380,436,816,"6 de julio de 1997"
28,3,33,1162,396,411,807,"6 de julio de 1997"
28,3,33,1163,489,548,1037,"6 de julio de 1997"
28,3,33,1164,526,631,1157,"6 de julio de 1997"
28,3,33,1165,290,318,608,"6 de julio de 1997"
28,3,33,1166,474,518,992,"6 de julio de 1997"
28,3,33,1167,355,348,703,"6 de julio de 1997"
28,3,33,1168,412,456,868,"6 de julio de 1997"
28,3,33,1169,583,650,1233,"6 de julio de 1997"
28,3,33,1170,529,616,1145,"6 de julio de 1997"
28,3,33,1171,608,672,1280,"6 de julio de 1997"
28,3,33,1172,604,637,1241,"6 de julio de 1997"
28,3,33,1173,396,447,843,"6 de julio de 1997"
28,3,33,1174,709,832,1541,"6 de julio de 1997"
28,3,33,1175,349,412,761,"6 de julio de 1997"
28,3,33,1176,414,434,848,"6 de julio de 1997"
28,3,33,1177,454,493,947,"6 de julio de 1997"
28,3,33,1178,605,609,1214,"6 de julio de 1997"
28,3,33,1179,174,221,395,"6 de julio de 1997"
28,3,33,1180,295,345,640,"6 de julio de 1997"
28,3,33,1181,330,375,705,"6 de julio de 1997"
28,3,33,1182,297,323,620,"6 de julio de 1997"
28,3,33,1183,320,380,700,"6 de julio de 1997"
28,3,33,1184,477,526,1003,"6 de julio de 1997"
28,3,33,1185,382,424,806,"6 de julio de 1997"
28,3,33,1186,208,260,468,"6 de julio de 1997"
28,3,33,1187,177,187,364,"6 de julio de 1997"
28,3,33,1188,123,118,241,"6 de julio de 1997"
28,3,33,1189,316,306,622,"6 de julio de 1997"
28,3,33,1190,247,261,508,"6 de julio de 1997"
28,3,33,1191,468,500,968,"6 de julio de 1997"
28,3,33,1192,590,620,1210,"6 de julio de 1997"
28,3,33,1193,578,620,1198,"6 de julio de 1997"
28,3,33,1194,535,560,1095,"6 de julio de 1997"
28,3,33,1195,457,455,912,"6 de julio de 1997"
28,3,33,1196,494,481,975,"6 de julio de 1997"
28,3,33,1197,388,316,704,"6 de julio de 1997"
28,3,33,1198,172,115,287,"6 de julio de 1997"
28,3,33,1199,143,136,279,"6 de julio de 1997"
28,3,33,1200,454,396,850,"6 de julio de 1997"
28,3,33,1201,172,140,312,"6 de julio de 1997"
28,3,33,1202,141,117,258,"6 de julio de 1997"
28,3,33,1203,266,242,508,"6 de julio de 1997"
28,3,33,1204,363,356,719,"6 de julio de 1997"
28,3,33,1205,308,365,673,"6 de julio de 1997"
28,3,33,1206,493,449,942,"6 de julio de 1997"
28,3,33,1207,240,245,485,"6 de julio de 1997"
28,3,33,1208,149,149,298,"6 de julio de 1997"
28,3,33,1209,464,384,848,"6 de julio de 1997"
28,3,33,1210,259,240,499,"6 de julio de 1997"
28,3,34,1211,188,198,386,"6 de julio de 1997"
28,3,34,1212,202,209,411,"6 de julio de 1997"
28,3,34,1213,79,54,133,"6 de julio de 1997"
28,3,34,1214,174,142,316,"6 de julio de 1997"
28,3,34,1215,213,192,405,"6 de julio de 1997"
28,3,34,1216,256,214,470,"6 de julio de 1997"
28,3,34,1217,237,172,409,"6 de julio de 1997"
28,3,34,1218,218,161,379,"6 de julio de 1997"
28,3,34,1219,271,177,448,"6 de julio de 1997"
28,3,34,1220,370,283,653,"6 de julio de 1997"
28,3,34,1221,513,437,950,"6 de julio de 1997"
28,3,34,1222,524,463,987,"6 de julio de 1997"
28,3,35,1223,318,305,623,"6 de julio de 1997"
28,3,35,1224,143,136,279,"6 de julio de 1997"
28,3,35,1225,487,521,1008,"6 de julio de 1997"
28,3,35,1226,545,514,1059,"6 de julio de 1997"
28,3,35,1227,272,291,563,"6 de julio de 1997"
28,3,35,1228,117,116,233,"6 de julio de 1997"
28,3,35,1229,311,312,623,"6 de julio de 1997"
28,3,35,1230,351,348,699,"6 de julio de 1997"
28,3,35,1231,276,305,581,"6 de julio de 1997"
28,3,35,1232,613,634,1247,"6 de julio de 1997"
28,3,35,1233,389,421,810,"6 de julio de 1997"
28,3,35,1234,335,370,705,"6 de julio de 1997"
28,3,35,1235,429,447,876,"6 de julio de 1997"
28,3,35,1236,374,407,781,"6 de julio de 1997"
28,3,35,1237,565,569,1134,"6 de julio de 1997"
28,3,35,1238,600,654,1254,"6 de julio de 1997"
28,3,35,1239,208,220,428,"6 de julio de 1997"
28,3,35,1240,107,118,225,"6 de julio de 1997"
28,3,35,1241,122,135,257,"6 de julio de 1997"
28,3,35,1242,244,240,484,"6 de julio de 1997"
28,3,35,1243,235,238,473,"6 de julio de 1997"
28,3,35,1244,290,244,534,"6 de julio de 1997"
28,3,35,1245,115,126,241,"6 de julio de 1997"
28,3,35,1246,367,344,711,"6 de julio de 1997"
28,3,35,1247,329,334,663,"6 de julio de 1997"
28,3,35,1248,320,238,558,"6 de julio de 1997"
28,3,35,1249,429,383,812,"6 de julio de 1997"
28,3,35,1250,182,169,351,"6 de julio de 1997"
28,3,35,1251,221,206,427,"6 de julio de 1997"
28,3,35,1252,402,386,788,"6 de julio de 1997"
28,3,35,1253,283,252,535,"6 de julio de 1997"
28,3,35,1254,524,503,1027,"6 de julio de 1997"
28,3,35,1255,273,205,478,"6 de julio de 1997"
28,3,35,1256,326,280,606,"6 de julio de 1997"
28,3,35,1257,261,180,441,"6 de julio de 1997"
28,3,35,1258,355,291,646,"6 de julio de 1997"
28,3,35,1259,484,454,938,"6 de julio de 1997"
28,3,35,1260,415,376,791,"6 de julio de 1997"
28,3,35,1261,264,206,470,"6 de julio de 1997"
28,3,35,1262,341,282,623,"6 de julio de 1997"
28,3,35,1263,478,469,947,"6 de julio de 1997"
28,3,35,1264,338,361,699,"6 de julio de 1997"
28,3,35,1265,327,312,639,"6 de julio de 1997"
28,3,35,1266,46,36,82,"6 de julio de 1997"
28,3,35,1267,62,51,113,"6 de julio de 1997"
28,3,35,1268,371,307,678,"6 de julio de 1997"
28,3,35,1269,202,155,357,"6 de julio de 1997"
28,3,35,1270,111,93,204,"6 de julio de 1997"
28,3,35,1271,287,216,503,"6 de julio de 1997"
28,3,35,1272,344,259,603,"6 de julio de 1997"
28,3,35,1273,32,25,57,"6 de julio de 1997"
28,3,35,1274,115,100,215,"6 de julio de 1997"
28,3,35,1275,114,79,193,"6 de julio de 1997"
28,3,35,1276,191,131,322,"6 de julio de 1997"
28,3,35,1277,420,317,737,"6 de julio de 1997"
28,3,36,1278,213,173,386,"6 de julio de 1997"
28,3,36,1279,122,101,223,"6 de julio de 1997"
28,3,37,1280,547,502,1049,"6 de julio de 1997"
28,3,37,1281,368,414,782,"6 de julio de 1997"
28,3,37,1282,395,367,762,"6 de julio de 1997"
28,3,37,1283,453,417,870,"6 de julio de 1997"
28,3,37,1284,305,320,625,"6 de julio de 1997"
28,3,37,1285,346,272,618,"6 de julio de 1997"
28,3,37,1286,330,251,581,"6 de julio de 1997"
28,3,37,1287,288,228,516,"6 de julio de 1997"
28,3,37,1288,286,214,500,"6 de julio de 1997"
28,3,37,1289,153,100,253,"6 de julio de 1997"
28,3,37,1290,340,277,617,"6 de julio de 1997"
28,3,37,1291,216,166,382,"6 de julio de 1997"
28,3,37,1292,122,103,225,"6 de julio de 1997"
28,3,37,1293,138,91,229,"6 de julio de 1997"
28,3,37,1294,630,425,1055,"6 de julio de 1997"
28,3,37,1295,133,95,228,"6 de julio de 1997"
28,3,37,1296,168,123,291,"6 de julio de 1997"
28,3,37,1297,100,49,149,"6 de julio de 1997"
28,3,37,1298,306,206,512,"6 de julio de 1997"
28,3,37,1299,386,322,708,"6 de julio de 1997"
28,3,37,1300,114,81,195,"6 de julio de 1997"
28,3,37,1301,267,174,441,"6 de julio de 1997"
28,3,37,1302,375,325,700,"6 de julio de 1997"
28,3,37,1303,275,219,494,"6 de julio de 1997"
28,3,40,1516,287,294,581,"6 de julio de 1997"
28,3,40,1517,360,382,742,"6 de julio de 1997"
28,3,40,1518,308,358,666,"6 de julio de 1997"
28,3,40,1519,324,327,651,"6 de julio de 1997"
28,3,40,1520,684,797,1481,"6 de julio de 1997"
28,3,40,1521,265,253,518,"6 de julio de 1997"
28,3,40,1522,437,508,945,"6 de julio de 1997"
28,3,40,1523,470,579,1049,"6 de julio de 1997"
28,3,40,1524,542,626,1168,"6 de julio de 1997"
28,3,40,1525,348,394,742,"6 de julio de 1997"
28,3,40,1526,374,424,798,"6 de julio de 1997"
28,3,40,1527,494,516,1010,"6 de julio de 1997"
28,3,40,1528,221,228,449,"6 de julio de 1997"
28,3,40,1529,337,367,704,"6 de julio de 1997"
28,3,40,1530,498,550,1048,"6 de julio de 1997"
28,3,40,1531,495,576,1071,"6 de julio de 1997"
28,3,40,1532,410,502,912,"6 de julio de 1997"
28,3,40,1533,368,413,781,"6 de julio de 1997"
28,3,40,1534,430,476,906,"6 de julio de 1997"
28,3,40,1535,210,240,450,"6 de julio de 1997"
28,3,40,1536,470,524,994,"6 de julio de 1997"
28,3,40,1537,381,417,798,"6 de julio de 1997"
28,3,40,1538,251,277,528,"6 de julio de 1997"
28,3,40,1539,136,147,283,"6 de julio de 1997"
28,3,40,1540,455,502,957,"6 de julio de 1997"
28,3,40,1541,360,426,786,"6 de julio de 1997"
28,3,40,1542,237,263,500,"6 de julio de 1997"
28,3,40,1543,281,370,651,"6 de julio de 1997"
28,3,40,1544,130,114,244,"6 de julio de 1997"
28,3,40,1545,336,316,652,"6 de julio de 1997"
28,3,40,1546,320,361,681,"6 de julio de 1997"
28,3,40,1547,172,170,342,"6 de julio de 1997"
28,3,40,1548,450,369,819,"6 de julio de 1997"
28,3,40,1549,195,124,319,"6 de julio de 1997"
28,3,40,1550,500,492,992,"6 de julio de 1997"
28,3,40,1551,709,749,1458,"6 de julio de 1997"
28,3,40,1552,342,332,674,"6 de julio de 1997"
28,3,40,1553,158,145,303,"6 de julio de 1997"
28,3,40,1554,204,188,392,"6 de julio de 1997"
28,3,40,1555,497,532,1029,"6 de julio de 1997"
28,3,40,1556,431,487,918,"6 de julio de 1997"
28,3,40,1557,163,194,357,"6 de julio de 1997"
28,3,40,1558,131,144,275,"6 de julio de 1997"
28,3,40,1559,173,132,305,"6 de julio de 1997"
28,3,40,1560,284,222,506,"6 de julio de 1997"
28,3,40,1561,137,81,218,"6 de julio de 1997"
28,4,22,498,375,379,754,"6 de julio de 1997"
28,4,22,499,480,475,955,"6 de julio de 1997"
28,4,22,500,538,518,1056,"6 de julio de 1997"
28,4,22,501,324,390,714,"6 de julio de 1997"
28,4,22,502,647,680,1327,"6 de julio de 1997"
28,4,22,503,565,612,1177,"6 de julio de 1997"
28,4,22,504,343,368,711,"6 de julio de 1997"
28,4,22,505,377,417,794,"6 de julio de 1997"
28,4,22,506,599,663,1262,"6 de julio de 1997"
28,4,22,507,592,690,1282,"6 de julio de 1997"
28,4,22,508,257,277,534,"6 de julio de 1997"
28,4,22,509,294,311,605,"6 de julio de 1997"
28,4,22,510,508,504,1012,"6 de julio de 1997"
28,4,22,511,523,688,1211,"6 de julio de 1997"
28,4,22,512,484,531,1015,"6 de julio de 1997"
28,4,22,513,499,509,1008,"6 de julio de 1997"
28,4,22,514,545,602,1147,"6 de julio de 1997"
28,4,22,515,662,677,1339,"6 de julio de 1997"
28,4,22,516,715,794,1509,"6 de julio de 1997"
28,4,22,517,486,446,932,"6 de julio de 1997"
28,4,22,518,546,643,1189,"6 de julio de 1997"
28,4,22,519,373,456,829,"6 de julio de 1997"
28,4,22,520,428,483,911,"6 de julio de 1997"
28,4,22,521,357,382,739,"6 de julio de 1997"
28,4,22,522,485,528,1013,"6 de julio de 1997"
28,4,22,523,521,506,1027,"6 de julio de 1997"
28,4,22,524,319,389,708,"6 de julio de 1997"
28,4,22,525,314,394,708,"6 de julio de 1997"
28,4,22,526,388,424,812,"6 de julio de 1997"
28,4,22,527,499,533,1032,"6 de julio de 1997"
28,4,22,528,420,424,844,"6 de julio de 1997"
28,4,22,529,506,471,977,"6 de julio de 1997"
28,4,22,530,301,340,641,"6 de julio de 1997"
28,4,22,531,346,372,718,"6 de julio de 1997"
28,4,22,532,401,471,872,"6 de julio de 1997"
28,4,22,533,425,489,914,"6 de julio de 1997"
28,4,22,534,577,621,1198,"6 de julio de 1997"
28,4,22,535,851,991,1842,"6 de julio de 1997"
28,4,22,536,489,598,1087,"6 de julio de 1997"
28,4,22,537,485,545,1030,"6 de julio de 1997"
28,4,22,538,539,632,1171,"6 de julio de 1997"
28,4,22,539,694,823,1517,"6 de julio de 1997"
28,4,22,540,691,727,1418,"6 de julio de 1997"
28,4,22,541,542,593,1135,"6 de julio de 1997"
28,4,22,542,567,614,1181,"6 de julio de 1997"
28,4,22,543,1123,1275,2398,"6 de julio de 1997"
28,4,22,544,540,549,1089,"6 de julio de 1997"
28,4,22,545,661,691,1352,"6 de julio de 1997"
28,4,22,546,415,451,866,"6 de julio de 1997"
28,4,22,547,457,452,909,"6 de julio de 1997"
28,4,22,548,551,648,1199,"6 de julio de 1997"
28,4,22,549,477,558,1035,"6 de julio de 1997"
28,4,22,550,423,468,891,"6 de julio de 1997"
28,4,22,551,355,371,726,"6 de julio de 1997"
28,4,22,552,1161,1349,2510,"6 de julio de 1997"
28,4,22,553,564,626,1190,"6 de julio de 1997"
28,4,22,554,443,516,959,"6 de julio de 1997"
28,4,22,555,482,558,1040,"6 de julio de 1997"
28,4,22,556,449,489,938,"6 de julio de 1997"
28,4,22,557,635,686,1321,"6 de julio de 1997"
28,4,22,558,639,722,1361,"6 de julio de 1997"
28,4,22,559,404,494,898,"6 de julio de 1997"
28,4,22,560,304,363,667,"6 de julio de 1997"
28,4,22,561,344,364,708,"6 de julio de 1997"
28,4,22,562,370,331,701,"6 de julio de 1997"
28,4,22,563,224,247,471,"6 de julio de 1997"
28,4,22,564,317,364,681,"6 de julio de 1997"
28,4,22,565,505,559,1064,"6 de julio de 1997"
28,4,22,566,444,465,909,"6 de julio de 1997"
28,4,22,567,386,477,863,"6 de julio de 1997"
28,4,22,568,517,538,1055,"6 de julio de 1997"
28,4,22,569,424,490,914,"6 de julio de 1997"
28,4,22,570,406,444,850,"6 de julio de 1997"
28,4,22,571,335,377,712,"6 de julio de 1997"
28,4,22,572,527,615,1142,"6 de julio de 1997"
28,4,22,573,343,382,725,"6 de julio de 1997"
28,4,22,574,268,260,528,"6 de julio de 1997"
28,4,22,575,520,519,1039,"6 de julio de 1997"
28,4,22,576,309,354,663,"6 de julio de 1997"
28,4,22,577,440,465,905,"6 de julio de 1997"
28,4,22,578,430,506,936,"6 de julio de 1997"
28,4,22,579,408,433,841,"6 de julio de 1997"
28,4,22,580,365,433,798,"6 de julio de 1997"
28,4,22,581,597,679,1276,"6 de julio de 1997"
28,4,22,582,243,308,551,"6 de julio de 1997"
28,4,22,583,403,449,852,"6 de julio de 1997"
28,4,22,584,444,504,948,"6 de julio de 1997"
28,4,22,585,403,498,901,"6 de julio de 1997"
28,4,22,586,297,365,662,"6 de julio de 1997"
28,4,22,587,369,453,822,"6 de julio de 1997"
28,4,22,588,418,521,939,"6 de julio de 1997"
28,4,22,589,661,742,1403,"6 de julio de 1997"
28,4,22,590,675,831,1506,"6 de julio de 1997"
28,4,22,591,413,422,835,"6 de julio de 1997"
28,4,22,592,481,561,1042,"6 de julio de 1997"
28,4,22,593,422,518,940,"6 de julio de 1997"
28,4,22,594,651,697,1348,"6 de julio de 1997"
28,4,22,595,244,271,515,"6 de julio de 1997"
28,4,22,596,506,604,1110,"6 de julio de 1997"
28,4,22,597,386,463,849,"6 de julio de 1997"
28,4,22,598,535,577,1112,"6 de julio de 1997"
28,4,22,599,350,376,726,"6 de julio de 1997"
28,4,22,600,435,486,921,"6 de julio de 1997"
28,4,22,601,657,816,1473,"6 de julio de 1997"
28,4,22,602,533,630,1163,"6 de julio de 1997"
28,4,22,603,581,658,1239,"6 de julio de 1997"
28,4,22,604,458,501,959,"6 de julio de 1997"
28,4,22,605,648,696,1344,"6 de julio de 1997"
28,4,22,606,564,637,1201,"6 de julio de 1997"
28,4,22,607,573,667,1240,"6 de julio de 1997"
28,4,22,608,458,546,1004,"6 de julio de 1997"
28,4,22,609,321,345,666,"6 de julio de 1997"
28,4,22,610,621,666,1287,"6 de julio de 1997"
28,4,22,611,467,528,995,"6 de julio de 1997"
28,4,22,612,359,397,756,"6 de julio de 1997"
28,4,22,613,383,391,774,"6 de julio de 1997"
28,4,22,614,578,701,1279,"6 de julio de 1997"
28,4,22,615,470,511,981,"6 de julio de 1997"
28,4,22,616,800,869,1669,"6 de julio de 1997"
28,4,22,617,503,579,1082,"6 de julio de 1997"
28,4,22,618,566,640,1206,"6 de julio de 1997"
28,4,22,619,480,480,960,"6 de julio de 1997"
28,4,22,620,1456,1639,3095,"6 de julio de 1997"
28,4,22,621,499,565,1064,"6 de julio de 1997"
28,4,22,622,337,357,694,"6 de julio de 1997"
28,4,22,623,533,585,1118,"6 de julio de 1997"
28,4,22,624,522,570,1092,"6 de julio de 1997"
28,4,22,625,646,640,1286,"6 de julio de 1997"
28,4,22,626,681,871,1552,"6 de julio de 1997"
28,4,22,627,665,753,1418,"6 de julio de 1997"
28,4,22,628,745,766,1511,"6 de julio de 1997"
28,4,22,629,588,669,1257,"6 de julio de 1997"
28,4,22,630,489,520,1009,"6 de julio de 1997"
28,4,22,631,478,515,993,"6 de julio de 1997"
28,4,22,632,380,431,811,"6 de julio de 1997"
28,4,22,633,659,711,1370,"6 de julio de 1997"
28,4,22,634,562,656,1218,"6 de julio de 1997"
28,4,22,635,511,557,1068,"6 de julio de 1997"
28,4,22,636,378,428,806,"6 de julio de 1997"
28,4,22,637,526,568,1094,"6 de julio de 1997"
28,4,22,638,453,520,973,"6 de julio de 1997"
28,4,22,639,1463,1593,3056,"6 de julio de 1997"
28,4,22,640,1017,986,2003,"6 de julio de 1997"
28,4,22,641,508,599,1107,"6 de julio de 1997"
28,4,22,642,494,574,1068,"6 de julio de 1997"
28,4,22,643,592,592,1184,"6 de julio de 1997"
28,4,22,644,457,517,974,"6 de julio de 1997"
28,4,22,645,396,391,787,"6 de julio de 1997"
28,4,22,646,409,467,876,"6 de julio de 1997"
28,4,22,647,719,747,1466,"6 de julio de 1997"
28,4,22,648,202,207,409,"6 de julio de 1997"
28,4,22,649,428,450,878,"6 de julio de 1997"
28,4,22,650,588,686,1274,"6 de julio de 1997"
28,4,22,651,802,932,1734,"6 de julio de 1997"
28,4,22,652,494,549,1043,"6 de julio de 1997"
28,4,22,653,945,986,1931,"6 de julio de 1997"
28,4,22,654,765,826,1591,"6 de julio de 1997"
28,4,22,655,522,627,1149,"6 de julio de 1997"
28,4,22,656,543,618,1161,"6 de julio de 1997"
28,4,22,657,525,565,1090,"6 de julio de 1997"
28,4,22,658,444,513,957,"6 de julio de 1997"
28,4,22,659,567,689,1256,"6 de julio de 1997"
28,4,22,660,490,601,1091,"6 de julio de 1997"
28,4,22,661,542,592,1134,"6 de julio de 1997"
28,4,22,662,663,760,1423,"6 de julio de 1997"
28,4,22,663,500,565,1065,"6 de julio de 1997"
28,4,22,664,526,586,1112,"6 de julio de 1997"
28,4,22,665,419,514,933,"6 de julio de 1997"
28,4,22,666,557,651,1208,"6 de julio de 1997"
28,4,22,667,483,608,1091,"6 de julio de 1997"
28,4,22,668,543,594,1137,"6 de julio de 1997"
28,4,22,669,552,539,1091,"6 de julio de 1997"
28,4,22,670,844,873,1717,"6 de julio de 1997"
28,4,22,671,643,643,1286,"6 de julio de 1997"
28,4,22,672,495,482,977,"6 de julio de 1997"
28,4,22,673,434,543,977,"6 de julio de 1997"
28,4,22,674,379,434,813,"6 de julio de 1997"
28,4,22,675,380,417,797,"6 de julio de 1997"
28,4,22,676,565,546,1111,"6 de julio de 1997"
28,4,22,677,581,585,1166,"6 de julio de 1997"
28,4,22,678,402,390,792,"6 de julio de 1997"
28,4,22,679,285,288,573,"6 de julio de 1997"
28,4,22,680,292,284,576,"6 de julio de 1997"
28,4,22,681,246,222,468,"6 de julio de 1997"
28,4,22,682,400,397,797,"6 de julio de 1997"
28,4,22,683,504,507,1011,"6 de julio de 1997"
28,4,22,684,454,416,870,"6 de julio de 1997"
28,4,22,685,550,560,1110,"6 de julio de 1997"
28,4,22,686,557,549,1106,"6 de julio de 1997"
28,4,22,687,630,646,1276,"6 de julio de 1997"
28,4,22,688,410,396,806,"6 de julio de 1997"
28,4,22,689,241,255,496,"6 de julio de 1997"
28,4,22,690,450,449,899,"6 de julio de 1997"
28,4,22,691,267,292,559,"6 de julio de 1997"
28,4,22,692,342,235,577,"6 de julio de 1997"
28,4,22,693,476,426,902,"6 de julio de 1997"
28,4,22,694,438,378,816,"6 de julio de 1997"
28,4,22,695,380,415,795,"6 de julio de 1997"
28,4,22,696,307,277,584,"6 de julio de 1997"
28,4,22,697,432,383,815,"6 de julio de 1997"
28,4,22,698,598,556,1154,"6 de julio de 1997"
28,4,22,699,656,643,1299,"6 de julio de 1997"
28,4,22,700,88,1,89,"6 de julio de 1997"
28,4,22,701,294,270,564,"6 de julio de 1997"
28,4,22,702,230,225,455,"6 de julio de 1997"
28,4,22,703,386,335,721,"6 de julio de 1997"
28,4,22,704,147,88,235,"6 de julio de 1997"
28,4,22,705,253,217,470,"6 de julio de 1997"
28,4,22,706,326,267,593,"6 de julio de 1997"
28,4,22,707,103,84,187,"6 de julio de 1997"
28,4,22,708,137,126,263,"6 de julio de 1997"
28,4,22,709,629,388,1017,"6 de julio de 1997"
28,5,6,116,276,243,519,"6 de julio de 1997"
28,5,6,117,270,234,504,"6 de julio de 1997"
28,5,6,118,347,298,645,"6 de julio de 1997"
28,5,6,119,124,95,219,"6 de julio de 1997"
28,5,6,120,151,110,261,"6 de julio de 1997"
28,5,6,121,359,315,674,"6 de julio de 1997"
28,5,6,122,208,191,399,"6 de julio de 1997"
28,5,6,123,166,127,293,"6 de julio de 1997"
28,5,6,124,344,318,662,"6 de julio de 1997"
28,5,8,143,356,273,629,"6 de julio de 1997"
28,5,8,144,153,122,275,"6 de julio de 1997"
28,5,8,145,146,74,220,"6 de julio de 1997"
28,5,8,146,77,63,140,"6 de julio de 1997"
28,5,8,147,274,229,503,"6 de julio de 1997"
28,5,8,148,184,139,323,"6 de julio de 1997"
28,5,8,149,226,165,391,"6 de julio de 1997"
28,5,8,150,80,53,133,"6 de julio de 1997"
28,5,13,311,316,275,591,"6 de julio de 1997"
28,5,13,312,291,264,555,"6 de julio de 1997"
28,5,13,313,282,222,504,"6 de julio de 1997"
28,5,13,314,304,307,611,"6 de julio de 1997"
28,5,13,315,251,224,475,"6 de julio de 1997"
28,5,13,316,537,480,1017,"6 de julio de 1997"
28,5,13,317,521,439,960,"6 de julio de 1997"
28,5,13,318,319,280,599,"6 de julio de 1997"
28,5,13,319,266,238,504,"6 de julio de 1997"
28,5,13,320,281,239,520,"6 de julio de 1997"
28,5,13,321,303,256,559,"6 de julio de 1997"
28,5,13,322,215,206,421,"6 de julio de 1997"
28,5,13,323,97,60,157,"6 de julio de 1997"
28,5,13,324,324,271,595,"6 de julio de 1997"
28,5,13,325,234,168,402,"6 de julio de 1997"
28,5,13,326,109,86,195,"6 de julio de 1997"
28,5,16,346,581,577,1158,"6 de julio de 1997"
28,5,16,347,415,395,810,"6 de julio de 1997"
28,5,16,348,418,415,833,"6 de julio de 1997"
28,5,16,349,462,401,863,"6 de julio de 1997"
28,5,16,350,346,277,623,"6 de julio de 1997"
28,5,16,351,183,145,328,"6 de julio de 1997"
28,5,16,352,113,75,188,"6 de julio de 1997"
28,5,16,353,422,296,718,"6 de julio de 1997"
28,5,16,354,500,412,912,"6 de julio de 1997"
28,5,16,355,392,332,724,"6 de julio de 1997"
28,5,16,356,406,336,742,"6 de julio de 1997"
28,5,16,357,213,189,402,"6 de julio de 1997"
28,5,16,358,340,280,620,"6 de julio de 1997"
28,5,16,359,509,427,936,"6 de julio de 1997"
28,5,16,360,458,362,820,"6 de julio de 1997"
28,5,16,361,25,25,50,"6 de julio de 1997"
28,5,16,362,119,86,205,"6 de julio de 1997"
28,5,16,363,414,387,801,"6 de julio de 1997"
28,5,16,364,547,510,1057,"6 de julio de 1997"
28,5,16,365,359,356,715,"6 de julio de 1997"
28,5,16,366,386,353,739,"6 de julio de 1997"
28,5,16,367,444,424,868,"6 de julio de 1997"
28,5,17,368,446,418,864,"6 de julio de 1997"
28,5,17,369,560,626,1186,"6 de julio de 1997"
28,5,17,370,408,451,859,"6 de julio de 1997"
28,5,17,371,222,151,373,"6 de julio de 1997"
28,5,17,372,489,407,896,"6 de julio de 1997"
28,5,17,373,179,136,315,"6 de julio de 1997"
28,5,17,374,134,106,240,"6 de julio de 1997"
28,5,17,375,424,370,794,"6 de julio de 1997"
28,5,17,376,377,304,681,"6 de julio de 1997"
28,5,17,377,422,393,815,"6 de julio de 1997"
28,5,17,378,254,190,444,"6 de julio de 1997"
28,5,17,379,31,22,53,"6 de julio de 1997"
28,5,17,380,90,59,149,"6 de julio de 1997"
28,5,20,408,263,205,468,"6 de julio de 1997"
28,5,20,409,218,200,418,"6 de julio de 1997"
28,5,20,410,346,280,626,"6 de julio de 1997"
28,5,20,411,228,207,435,"6 de julio de 1997"
28,5,26,745,429,382,811,"6 de julio de 1997"
28,5,26,746,182,168,350,"6 de julio de 1997"
28,5,26,747,349,292,641,"6 de julio de 1997"
28,5,26,748,92,58,150,"6 de julio de 1997"
28,5,31,931,100,96,196,"6 de julio de 1997"
28,5,31,932,109,126,235,"6 de julio de 1997"
28,5,31,933,94,93,187,"6 de julio de 1997"
28,5,31,934,245,199,444,"6 de julio de 1997"
28,5,41,1562,343,389,732,"6 de julio de 1997"
28,5,41,1563,403,489,892,"6 de julio de 1997"
28,5,41,1564,381,423,804,"6 de julio de 1997"
28,5,41,1565,476,496,972,"6 de julio de 1997"
28,5,41,1566,547,628,1175,"6 de julio de 1997"
28,5,41,1567,358,362,720,"6 de julio de 1997"
28,5,41,1568,303,333,636,"6 de julio de 1997"
28,5,41,1569,681,837,1518,"6 de julio de 1997"
28,5,41,1570,471,552,1023,"6 de julio de 1997"
28,5,41,1571,469,510,979,"6 de julio de 1997"
28,5,41,1572,474,521,995,"6 de julio de 1997"
28,5,41,1573,856,913,1769,"6 de julio de 1997"
28,5,41,1574,366,388,754,"6 de julio de 1997"
28,5,41,1575,489,556,1045,"6 de julio de 1997"
28,5,41,1576,367,431,798,"6 de julio de 1997"
28,5,41,1577,1157,1379,2536,"6 de julio de 1997"
28,5,41,1578,449,7,456,"6 de julio de 1997"
28,5,41,1579,537,578,1115,"6 de julio de 1997"
28,5,41,1580,562,639,1201,"6 de julio de 1997"
28,5,41,1581,493,568,1061,"6 de julio de 1997"
28,5,41,1582,538,617,1155,"6 de julio de 1997"
28,5,41,1583,494,563,1057,"6 de julio de 1997"
28,5,41,1584,326,385,711,"6 de julio de 1997"
28,5,41,1585,394,480,874,"6 de julio de 1997"
28,5,41,1586,448,473,921,"6 de julio de 1997"
28,5,41,1587,494,589,1083,"6 de julio de 1997"
28,5,41,1588,773,908,1681,"6 de julio de 1997"
28,5,41,1589,299,310,609,"6 de julio de 1997"
28,5,41,1590,366,369,735,"6 de julio de 1997"
28,5,41,1591,454,536,990,"6 de julio de 1997"
28,5,41,1592,614,636,1250,"6 de julio de 1997"
28,5,41,1593,504,562,1066,"6 de julio de 1997"
28,5,41,1594,558,588,1146,"6 de julio de 1997"
28,5,41,1595,384,463,847,"6 de julio de 1997"
28,5,41,1596,290,376,666,"6 de julio de 1997"
28,5,41,1597,392,479,871,"6 de julio de 1997"
28,5,41,1598,304,356,660,"6 de julio de 1997"
28,5,41,1599,288,369,657,"6 de julio de 1997"
28,5,41,1600,670,719,1389,"6 de julio de 1997"
28,5,41,1601,554,677,1231,"6 de julio de 1997"
28,5,41,1602,619,691,1310,"6 de julio de 1997"
28,5,41,1603,615,689,1304,"6 de julio de 1997"
28,5,41,1604,368,431,799,"6 de julio de 1997"
28,5,41,1605,332,380,712,"6 de julio de 1997"
28,5,41,1606,622,706,1328,"6 de julio de 1997"
28,5,41,1607,992,1086,2078,"6 de julio de 1997"
28,5,41,1608,442,507,949,"6 de julio de 1997"
28,5,41,1609,427,480,907,"6 de julio de 1997"
28,5,41,1610,433,421,854,"6 de julio de 1997"
28,5,41,1611,474,519,993,"6 de julio de 1997"
28,5,41,1612,451,491,942,"6 de julio de 1997"
28,5,41,1613,429,479,908,"6 de julio de 1997"
28,5,41,1614,491,603,1094,"6 de julio de 1997"
28,5,41,1615,502,604,1106,"6 de julio de 1997"
28,5,41,1616,470,587,1057,"6 de julio de 1997"
28,5,41,1617,447,491,938,"6 de julio de 1997"
28,5,41,1618,478,537,1015,"6 de julio de 1997"
28,5,41,1619,526,591,1117,"6 de julio de 1997"
28,5,41,1620,606,678,1284,"6 de julio de 1997"
28,5,41,1621,226,274,500,"6 de julio de 1997"
28,5,41,1622,446,518,964,"6 de julio de 1997"
28,5,41,1623,357,463,820,"6 de julio de 1997"
28,5,41,1624,392,506,898,"6 de julio de 1997"
28,5,41,1625,580,686,1266,"6 de julio de 1997"
28,5,41,1626,424,515,939,"6 de julio de 1997"
28,5,41,1627,406,503,909,"6 de julio de 1997"
28,5,41,1628,411,458,869,"6 de julio de 1997"
28,5,41,1629,449,587,1036,"6 de julio de 1997"
28,5,41,1630,213,273,486,"6 de julio de 1997"
28,5,41,1631,446,521,967,"6 de julio de 1997"
28,5,41,1632,526,577,1103,"6 de julio de 1997"
28,5,41,1633,508,557,1065,"6 de julio de 1997"
28,5,41,1634,513,572,1085,"6 de julio de 1997"
28,5,41,1635,435,502,937,"6 de julio de 1997"
28,5,41,1636,937,1106,2043,"6 de julio de 1997"
28,5,41,1637,556,606,1162,"6 de julio de 1997"
28,5,41,1638,406,467,873,"6 de julio de 1997"
28,5,41,1639,497,534,1031,"6 de julio de 1997"
28,5,41,1640,491,516,1007,"6 de julio de 1997"
28,5,41,1641,454,520,974,"6 de julio de 1997"
28,5,41,1642,292,399,691,"6 de julio de 1997"
28,5,41,1643,323,380,703,"6 de julio de 1997"
28,5,41,1644,282,317,599,"6 de julio de 1997"
28,5,41,1645,364,473,837,"6 de julio de 1997"
28,5,41,1646,614,675,1289,"6 de julio de 1997"
28,5,41,1647,513,553,1066,"6 de julio de 1997"
28,5,41,1648,333,357,690,"6 de julio de 1997"
28,5,41,1649,404,416,820,"6 de julio de 1997"
28,5,41,1650,629,744,1373,"6 de julio de 1997"
28,5,41,1651,619,686,1305,"6 de julio de 1997"
28,5,41,1652,492,632,1124,"6 de julio de 1997"
28,5,41,1653,359,398,757,"6 de julio de 1997"
28,5,41,1654,137,165,302,"6 de julio de 1997"
28,5,41,1655,515,574,1089,"6 de julio de 1997"
28,5,41,1656,357,443,800,"6 de julio de 1997"
28,5,41,1657,388,435,823,"6 de julio de 1997"
28,5,41,1658,388,425,813,"6 de julio de 1997"
28,5,41,1659,260,276,536,"6 de julio de 1997"
28,5,41,1660,379,426,805,"6 de julio de 1997"
28,5,41,1661,228,275,503,"6 de julio de 1997"
28,5,41,1662,543,661,1204,"6 de julio de 1997"
28,5,41,1663,458,506,964,"6 de julio de 1997"
28,5,41,1664,447,437,884,"6 de julio de 1997"
28,5,41,1665,398,465,863,"6 de julio de 1997"
28,5,41,1666,525,555,1080,"6 de julio de 1997"
28,5,41,1667,784,885,1669,"6 de julio de 1997"
28,5,41,1668,542,570,1112,"6 de julio de 1997"
28,5,41,1669,591,658,1249,"6 de julio de 1997"
28,5,41,1670,471,533,1004,"6 de julio de 1997"
28,5,41,1671,634,677,1311,"6 de julio de 1997"
28,5,41,1672,393,441,834,"6 de julio de 1997"
28,5,41,1673,409,473,882,"6 de julio de 1997"
28,5,41,1674,391,463,854,"6 de julio de 1997"
28,5,41,1675,537,569,1106,"6 de julio de 1997"
28,5,41,1676,432,511,943,"6 de julio de 1997"
28,5,41,1677,375,422,797,"6 de julio de 1997"
28,5,41,1678,334,366,700,"6 de julio de 1997"
28,5,41,1679,422,472,894,"6 de julio de 1997"
28,5,41,1680,427,489,916,"6 de julio de 1997"
28,5,41,1681,487,559,1046,"6 de julio de 1997"
28,5,41,1682,440,485,925,"6 de julio de 1997"
28,5,41,1683,710,776,1486,"6 de julio de 1997"
28,5,41,1684,350,356,706,"6 de julio de 1997"
28,5,41,1685,131,134,265,"6 de julio de 1997"
28,5,41,1686,443,503,946,"6 de julio de 1997"
28,5,41,1687,529,588,1117,"6 de julio de 1997"
28,5,41,1688,490,541,1031,"6 de julio de 1997"
28,5,41,1689,468,511,979,"6 de julio de 1997"
28,5,41,1690,462,483,945,"6 de julio de 1997"
28,5,41,1691,386,419,805,"6 de julio de 1997"
28,5,41,1692,260,269,529,"6 de julio de 1997"
28,5,41,1693,525,611,1136,"6 de julio de 1997"
28,5,41,1694,787,810,1597,"6 de julio de 1997"
28,5,41,1695,276,287,563,"6 de julio de 1997"
28,5,41,1696,500,504,1004,"6 de julio de 1997"
28,5,41,1697,441,419,860,"6 de julio de 1997"
28,5,41,1698,529,589,1118,"6 de julio de 1997"
28,5,41,1699,330,375,705,"6 de julio de 1997"
28,5,41,1700,258,282,540,"6 de julio de 1997"
28,5,41,1701,497,399,896,"6 de julio de 1997"
28,5,41,1702,289,261,550,"6 de julio de 1997"
28,5,41,1703,362,294,656,"6 de julio de 1997"
28,5,41,1704,371,299,670,"6 de julio de 1997"
28,5,41,1705,428,423,851,"6 de julio de 1997"
28,5,41,1706,385,366,751,"6 de julio de 1997"
28,5,41,1707,318,296,614,"6 de julio de 1997"
28,5,41,1708,396,353,749,"6 de julio de 1997"
28,5,41,1709,328,271,599,"6 de julio de 1997"
28,5,41,1710,319,276,595,"6 de julio de 1997"
28,5,41,1711,68,33,101,"6 de julio de 1997"
28,5,42,1712,493,404,897,"6 de julio de 1997"
28,5,42,1713,428,408,836,"6 de julio de 1997"
28,5,42,1714,274,233,507,"6 de julio de 1997"
28,5,42,1715,298,247,545,"6 de julio de 1997"
28,5,42,1716,399,325,724,"6 de julio de 1997"
28,5,42,1717,305,233,538,"6 de julio de 1997"
28,5,42,1718,338,253,591,"6 de julio de 1997"
28,6,4,101,521,599,1120,"6 de julio de 1997"
28,6,4,102,534,538,1072,"6 de julio de 1997"
28,6,4,103,496,404,900,"6 de julio de 1997"
28,6,4,104,309,271,580,"6 de julio de 1997"
28,6,4,105,218,170,388,"6 de julio de 1997"
28,6,4,106,538,512,1050,"6 de julio de 1997"
28,6,4,107,177,130,307,"6 de julio de 1997"
28,6,11,266,607,532,1139,"6 de julio de 1997"
28,6,11,267,83,44,127,"6 de julio de 1997"
28,6,11,268,580,481,1061,"6 de julio de 1997"
28,6,11,269,329,283,612,"6 de julio de 1997"
28,6,11,270,397,383,780,"6 de julio de 1997"
28,6,11,271,426,462,888,"6 de julio de 1997"
28,6,11,272,458,453,911,"6 de julio de 1997"
28,6,12,273,131,108,239,"6 de julio de 1997"
28,6,12,274,166,174,340,"6 de julio de 1997"
28,6,12,275,368,384,752,"6 de julio de 1997"
28,6,12,276,378,389,767,"6 de julio de 1997"
28,6,12,277,434,457,891,"6 de julio de 1997"
28,6,12,278,301,320,621,"6 de julio de 1997"
28,6,12,279,376,384,760,"6 de julio de 1997"
28,6,12,280,501,575,1076,"6 de julio de 1997"
28,6,12,281,345,419,764,"6 de julio de 1997"
28,6,12,282,234,196,430,"6 de julio de 1997"
28,6,12,283,184,117,301,"6 de julio de 1997"
28,6,12,284,145,113,258,"6 de julio de 1997"
28,6,12,285,199,172,371,"6 de julio de 1997"
28,6,12,286,319,251,570,"6 de julio de 1997"
28,6,12,287,456,391,847,"6 de julio de 1997"
28,6,12,288,498,505,1003,"6 de julio de 1997"
28,6,12,289,331,326,657,"6 de julio de 1997"
28,6,12,290,319,335,654,"6 de julio de 1997"
28,6,12,291,312,346,658,"6 de julio de 1997"
28,6,12,292,371,415,786,"6 de julio de 1997"
28,6,12,293,400,384,784,"6 de julio de 1997"
28,6,12,294,509,485,994,"6 de julio de 1997"
28,6,12,295,367,409,776,"6 de julio de 1997"
28,6,12,296,311,332,643,"6 de julio de 1997"
28,6,12,297,253,231,484,"6 de julio de 1997"
28,6,12,298,365,365,730,"6 de julio de 1997"
28,6,12,299,248,178,426,"6 de julio de 1997"
28,6,12,300,319,292,611,"6 de julio de 1997"
28,6,12,301,361,326,687,"6 de julio de 1997"
28,6,12,302,349,360,709,"6 de julio de 1997"
28,6,12,303,287,213,500,"6 de julio de 1997"
28,6,12,304,119,98,217,"6 de julio de 1997"
28,6,12,305,151,118,269,"6 de julio de 1997"
28,6,12,306,466,364,830,"6 de julio de 1997"
28,6,12,307,38,37,75,"6 de julio de 1997"
28,6,12,308,116,90,206,"6 de julio de 1997"
28,6,12,309,519,429,948,"6 de julio de 1997"
28,6,12,310,447,468,915,"6 de julio de 1997"
28,6,19,389,429,395,824,"6 de julio de 1997"
28,6,19,390,411,449,860,"6 de julio de 1997"
28,6,19,391,545,535,1080,"6 de julio de 1997"
28,6,19,392,98,48,146,"6 de julio de 1997"
28,6,19,393,277,235,512,"6 de julio de 1997"
28,6,19,394,397,309,706,"6 de julio de 1997"
28,6,19,395,282,259,541,"6 de julio de 1997"
28,6,19,396,422,371,793,"6 de julio de 1997"
28,6,19,397,471,413,884,"6 de julio de 1997"
28,6,19,398,242,206,448,"6 de julio de 1997"
28,6,19,399,263,188,451,"6 de julio de 1997"
28,6,19,400,390,294,684,"6 de julio de 1997"
28,6,19,401,359,310,669,"6 de julio de 1997"
28,6,19,402,330,254,584,"6 de julio de 1997"
28,6,19,403,189,114,303,"6 de julio de 1997"
28,6,19,404,442,374,816,"6 de julio de 1997"
28,6,19,405,346,289,635,"6 de julio de 1997"
28,6,19,406,191,181,372,"6 de julio de 1997"
28,6,19,407,303,263,566,"6 de julio de 1997"
28,6,21,412,385,339,724,"6 de julio de 1997"
28,6,21,413,274,300,574,"6 de julio de 1997"
28,6,21,414,175,188,363,"6 de julio de 1997"
28,6,21,415,379,448,827,"6 de julio de 1997"
28,6,21,416,601,688,1289,"6 de julio de 1997"
28,6,21,417,575,628,1203,"6 de julio de 1997"
28,6,21,418,297,360,657,"6 de julio de 1997"
28,6,21,419,317,337,654,"6 de julio de 1997"
28,6,21,420,650,727,1377,"6 de julio de 1997"
28,6,21,421,531,635,1166,"6 de julio de 1997"
28,6,21,422,629,680,1309,"6 de julio de 1997"
28,6,21,423,420,454,874,"6 de julio de 1997"
28,6,21,424,558,649,1207,"6 de julio de 1997"
28,6,21,425,348,366,714,"6 de julio de 1997"
28,6,21,426,541,591,1132,"6 de julio de 1997"
28,6,21,427,399,354,753,"6 de julio de 1997"
28,6,21,428,495,562,1057,"6 de julio de 1997"
28,6,21,429,409,419,828,"6 de julio de 1997"
28,6,21,430,476,514,990,"6 de julio de 1997"
28,6,21,431,521,550,1071,"6 de julio de 1997"
28,6,21,432,616,672,1288,"6 de julio de 1997"
28,6,21,433,426,483,909,"6 de julio de 1997"
28,6,21,434,204,283,487,"6 de julio de 1997"
28,6,21,435,458,508,966,"6 de julio de 1997"
28,6,21,436,529,568,1097,"6 de julio de 1997"
28,6,21,437,547,594,1141,"6 de julio de 1997"
28,6,21,438,308,318,626,"6 de julio de 1997"
28,6,21,439,557,587,1144,"6 de julio de 1997"
28,6,21,440,501,553,1054,"6 de julio de 1997"
28,6,21,441,430,523,953,"6 de julio de 1997"
28,6,21,442,395,431,826,"6 de julio de 1997"
28,6,21,443,437,519,956,"6 de julio de 1997"
28,6,21,444,276,292,568,"6 de julio de 1997"
28,6,21,445,578,593,1171,"6 de julio de 1997"
28,6,21,446,359,401,760,"6 de julio de 1997"
28,6,21,447,391,440,831,"6 de julio de 1997"
28,6,21,448,701,788,1489,"6 de julio de 1997"
28,6,21,449,567,569,1136,"6 de julio de 1997"
28,6,21,450,557,610,1167,"6 de julio de 1997"
28,6,21,451,560,663,1223,"6 de julio de 1997"
28,6,21,452,517,599,1116,"6 de julio de 1997"
28,6,21,453,358,408,766,"6 de julio de 1997"
28,6,21,454,217,215,432,"6 de julio de 1997"
28,6,21,455,631,702,1333,"6 de julio de 1997"
28,6,21,456,486,548,1034,"6 de julio de 1997"
28,6,21,457,488,565,1053,"6 de julio de 1997"
28,6,21,458,649,712,1361,"6 de julio de 1997"
28,6,21,459,347,385,732,"6 de julio de 1997"
28,6,21,460,457,487,944,"6 de julio de 1997"
28,6,21,461,616,657,1273,"6 de julio de 1997"
28,6,21,462,464,519,983,"6 de julio de 1997"
28,6,21,463,164,164,328,"6 de julio de 1997"
28,6,21,464,286,334,620,"6 de julio de 1997"
28,6,21,465,334,323,657,"6 de julio de 1997"
28,6,21,466,412,460,872,"6 de julio de 1997"
28,6,21,467,277,236,513,"6 de julio de 1997"
28,6,21,468,570,569,1139,"6 de julio de 1997"
28,6,21,469,578,562,1140,"6 de julio de 1997"
28,6,21,470,319,283,602,"6 de julio de 1997"
28,6,21,471,632,575,1207,"6 de julio de 1997"
28,6,21,472,358,305,663,"6 de julio de 1997"
28,6,21,473,241,252,493,"6 de julio de 1997"
28,6,21,474,220,213,433,"6 de julio de 1997"
28,6,21,475,285,243,528,"6 de julio de 1997"
28,6,21,476,349,339,688,"6 de julio de 1997"
28,6,21,477,289,267,556,"6 de julio de 1997"
28,6,21,478,506,508,1014,"6 de julio de 1997"
28,6,21,479,322,304,626,"6 de julio de 1997"
28,6,21,480,346,367,713,"6 de julio de 1997"
28,6,21,481,125,102,227,"6 de julio de 1997"
28,6,21,482,338,327,665,"6 de julio de 1997"
28,6,21,483,556,473,1029,"6 de julio de 1997"
28,6,21,484,287,246,533,"6 de julio de 1997"
28,6,21,485,332,321,653,"6 de julio de 1997"
28,6,21,486,72,72,144,"6 de julio de 1997"
28,6,21,487,252,285,537,"6 de julio de 1997"
28,6,21,488,345,324,669,"6 de julio de 1997"
28,6,21,489,303,314,617,"6 de julio de 1997"
28,6,21,490,320,306,626,"6 de julio de 1997"
28,6,21,491,319,265,584,"6 de julio de 1997"
28,6,21,492,318,267,585,"6 de julio de 1997"
28,6,21,493,278,240,518,"6 de julio de 1997"
28,6,21,494,200,176,376,"6 de julio de 1997"
28,6,21,495,228,179,407,"6 de julio de 1997"
28,6,21,496,455,424,879,"6 de julio de 1997"
28,6,21,497,228,187,415,"6 de julio de 1997"
28,6,28,905,457,365,822,"6 de julio de 1997"
28,6,28,906,361,354,715,"6 de julio de 1997"
28,6,28,907,162,128,290,"6 de julio de 1997"
28,6,29,908,526,442,968,"6 de julio de 1997"
28,6,29,909,456,485,941,"6 de julio de 1997"
28,6,29,910,627,593,1220,"6 de julio de 1997"
28,6,29,911,222,205,427,"6 de julio de 1997"
28,6,29,912,86,80,166,"6 de julio de 1997"
28,6,29,913,103,64,167,"6 de julio de 1997"
28,6,29,914,477,377,854,"6 de julio de 1997"
28,6,29,915,216,192,408,"6 de julio de 1997"
28,6,29,916,224,185,409,"6 de julio de 1997"
28,6,29,917,188,162,350,"6 de julio de 1997"
28,6,29,918,312,283,595,"6 de julio de 1997"
28,6,29,919,166,126,292,"6 de julio de 1997"
28,6,29,920,242,195,437,"6 de julio de 1997"
28,6,29,921,431,360,791,"6 de julio de 1997"
28,6,39,1497,313,317,630,"6 de julio de 1997"
28,6,39,1498,525,533,1058,"6 de julio de 1997"
28,6,39,1499,648,745,1393,"6 de julio de 1997"
28,6,39,1500,397,418,815,"6 de julio de 1997"
28,6,39,1501,471,489,960,"6 de julio de 1997"
28,6,39,1502,335,304,639,"6 de julio de 1997"
28,6,39,1503,229,229,458,"6 de julio de 1997"
28,6,39,1504,523,436,959,"6 de julio de 1997"
28,6,39,1505,263,231,494,"6 de julio de 1997"
28,6,39,1506,416,315,731,"6 de julio de 1997"
28,6,39,1507,232,250,482,"6 de julio de 1997"
28,6,39,1508,353,307,660,"6 de julio de 1997"
28,6,39,1509,384,345,729,"6 de julio de 1997"
28,6,39,1510,338,355,693,"6 de julio de 1997"
28,6,39,1511,492,439,931,"6 de julio de 1997"
28,6,39,1512,403,338,741,"6 de julio de 1997"
28,6,39,1513,210,191,401,"6 de julio de 1997"
28,6,39,1514,423,367,790,"6 de julio de 1997"
28,6,39,1515,383,284,667,"6 de julio de 1997"
28,6,43,1719,530,624,1154,"6 de julio de 1997"
28,6,43,1720,365,403,768,"6 de julio de 1997"
28,6,43,1721,467,518,985,"6 de julio de 1997"
28,6,43,1722,441,448,889,"6 de julio de 1997"
28,6,43,1723,331,400,731,"6 de julio de 1997"
28,6,43,1724,460,470,930,"6 de julio de 1997"
28,6,43,1725,254,195,449,"6 de julio de 1997"
28,6,43,1726,194,127,321,"6 de julio de 1997"
28,6,43,1727,87,63,150,"6 de julio de 1997"
28,6,43,1728,209,180,389,"6 de julio de 1997"
28,6,43,1729,395,354,749,"6 de julio de 1997"
28,6,43,1730,441,408,849,"6 de julio de 1997"
28,6,43,1731,185,187,372,"6 de julio de 1997"
28,6,43,1732,328,268,596,"6 de julio de 1997"
28,6,43,1733,145,160,305,"6 de julio de 1997"
28,6,43,1734,166,155,321,"6 de julio de 1997"
28,6,43,1735,361,366,727,"6 de julio de 1997"
28,6,43,1736,333,338,671,"6 de julio de 1997"
28,6,43,1737,696,615,1311,"6 de julio de 1997"
28,6,43,1738,388,374,762,"6 de julio de 1997"
28,6,43,1739,170,164,334,"6 de julio de 1997"
28,7,2,13,537,529,1066,"6 de julio de 1997"
28,7,2,14,562,565,1127,"6 de julio de 1997"
28,7,2,15,430,435,865,"6 de julio de 1997"
28,7,2,16,411,450,861,"6 de julio de 1997"
28,7,2,17,363,417,780,"6 de julio de 1997"
28,7,2,18,547,512,1059,"6 de julio de 1997"
28,7,2,19,663,698,1361,"6 de julio de 1997"
28,7,2,20,269,199,468,"6 de julio de 1997"
28,7,2,21,215,154,369,"6 de julio de 1997"
28,7,2,22,189,147,336,"6 de julio de 1997"
28,7,2,23,448,366,814,"6 de julio de 1997"
28,7,2,24,339,243,582,"6 de julio de 1997"
28,7,2,25,328,209,537,"6 de julio de 1997"
28,7,2,26,170,120,290,"6 de julio de 1997"
28,7,2,27,460,327,787,"6 de julio de 1997"
28,7,2,28,266,213,479,"6 de julio de 1997"
28,7,2,29,142,114,256,"6 de julio de 1997"
28,7,2,30,575,449,1024,"6 de julio de 1997"
28,7,2,31,255,181,436,"6 de julio de 1997"
28,7,2,32,290,195,485,"6 de julio de 1997"
28,7,2,33,513,396,909,"6 de julio de 1997"
28,7,3,34,456,464,920,"6 de julio de 1997"
28,7,3,35,216,196,412,"6 de julio de 1997"
28,7,3,36,344,335,679,"6 de julio de 1997"
28,7,3,37,176,191,367,"6 de julio de 1997"
28,7,3,38,287,268,555,"6 de julio de 1997"
28,7,3,39,416,426,842,"6 de julio de 1997"
28,7,3,40,659,647,1306,"6 de julio de 1997"
28,7,3,41,677,645,1322,"6 de julio de 1997"
28,7,3,42,361,363,724,"6 de julio de 1997"
28,7,3,43,522,527,1049,"6 de julio de 1997"
28,7,3,44,336,369,705,"6 de julio de 1997"
28,7,3,45,219,214,433,"6 de julio de 1997"
28,7,3,46,503,490,993,"6 de julio de 1997"
28,7,3,47,97,107,204,"6 de julio de 1997"
28,7,3,48,913,974,1887,"6 de julio de 1997"
28,7,3,49,358,384,742,"6 de julio de 1997"
28,7,3,50,518,523,1041,"6 de julio de 1997"
28,7,3,51,825,835,1660,"6 de julio de 1997"
28,7,3,52,681,691,1372,"6 de julio de 1997"
28,7,3,53,500,506,1006,"6 de julio de 1997"
28,7,3,54,404,456,860,"6 de julio de 1997"
28,7,3,55,367,285,652,"6 de julio de 1997"
28,7,3,56,317,273,590,"6 de julio de 1997"
28,7,3,57,579,577,1156,"6 de julio de 1997"
28,7,3,58,381,414,795,"6 de julio de 1997"
28,7,3,59,382,409,791,"6 de julio de 1997"
28,7,3,60,485,437,922,"6 de julio de 1997"
28,7,3,61,655,554,1209,"6 de julio de 1997"
28,7,3,62,708,672,1380,"6 de julio de 1997"
28,7,3,63,564,571,1135,"6 de julio de 1997"
28,7,3,64,611,574,1185,"6 de julio de 1997"
28,7,3,65,248,244,492,"6 de julio de 1997"
28,7,3,66,233,168,401,"6 de julio de 1997"
28,7,3,67,531,494,1025,"6 de julio de 1997"
28,7,3,68,460,437,897,"6 de julio de 1997"
28,7,3,69,746,738,1484,"6 de julio de 1997"
28,7,3,70,467,428,895,"6 de julio de 1997"
28,7,3,71,770,843,1613,"6 de julio de 1997"
28,7,3,72,517,599,1116,"6 de julio de 1997"
28,7,3,73,345,403,748,"6 de julio de 1997"
28,7,3,74,276,289,565,"6 de julio de 1997"
28,7,3,75,212,272,484,"6 de julio de 1997"
28,7,3,76,389,390,779,"6 de julio de 1997"
28,7,3,77,452,515,967,"6 de julio de 1997"
28,7,3,78,372,355,727,"6 de julio de 1997"
28,7,3,79,321,350,671,"6 de julio de 1997"
28,7,3,80,391,360,751,"6 de julio de 1997"
28,7,3,81,363,385,748,"6 de julio de 1997"
28,7,3,82,233,260,493,"6 de julio de 1997"
28,7,3,83,275,291,566,"6 de julio de 1997"
28,7,3,84,499,521,1020,"6 de julio de 1997"
28,7,3,85,496,526,1022,"6 de julio de 1997"
28,7,3,86,445,492,937,"6 de julio de 1997"
28,7,3,87,284,321,605,"6 de julio de 1997"
28,7,3,88,279,319,598,"6 de julio de 1997"
28,7,3,89,494,531,1025,"6 de julio de 1997"
28,7,3,90,475,517,992,"6 de julio de 1997"
28,7,3,91,553,569,1122,"6 de julio de 1997"
28,7,3,92,630,712,1342,"6 de julio de 1997"
28,7,3,93,706,717,1423,"6 de julio de 1997"
28,7,3,94,431,478,909,"6 de julio de 1997"
28,7,3,95,578,623,1201,"6 de julio de 1997"
28,7,3,96,329,374,703,"6 de julio de 1997"
28,7,3,97,536,590,1126,"6 de julio de 1997"
28,7,3,98,500,524,1024,"6 de julio de 1997"
28,7,3,99,471,446,917,"6 de julio de 1997"
28,7,3,100,131,113,244,"6 de julio de 1997"
28,7,9,151,556,589,1145,"6 de julio de 1997"
28,7,9,152,369,403,772,"6 de julio de 1997"
28,7,9,153,394,429,823,"6 de julio de 1997"
28,7,9,154,556,604,1160,"6 de julio de 1997"
28,7,9,155,457,500,957,"6 de julio de 1997"
28,7,9,156,497,573,1070,"6 de julio de 1997"
28,7,9,157,788,865,1653,"6 de julio de 1997"
28,7,9,158,503,507,1010,"6 de julio de 1997"
28,7,9,159,851,1015,1866,"6 de julio de 1997"
28,7,9,160,493,565,1058,"6 de julio de 1997"
28,7,9,161,346,371,717,"6 de julio de 1997"
28,7,9,162,575,602,1177,"6 de julio de 1997"
28,7,9,163,184,178,362,"6 de julio de 1997"
28,7,9,164,326,368,694,"6 de julio de 1997"
28,7,9,165,449,475,924,"6 de julio de 1997"
28,7,9,166,627,666,1293,"6 de julio de 1997"
28,7,9,167,518,570,1088,"6 de julio de 1997"
28,7,9,168,565,621,1186,"6 de julio de 1997"
28,7,9,169,509,577,1086,"6 de julio de 1997"
28,7,9,170,463,532,995,"6 de julio de 1997"
28,7,9,171,476,558,1034,"6 de julio de 1997"
28,7,9,172,536,663,1199,"6 de julio de 1997"
28,7,9,173,569,616,1185,"6 de julio de 1997"
28,7,9,174,239,235,474,"6 de julio de 1997"
28,7,9,175,409,395,804,"6 de julio de 1997"
28,7,9,176,210,67,277,"6 de julio de 1997"
28,7,9,177,625,587,1212,"6 de julio de 1997"
28,7,9,178,552,562,1114,"6 de julio de 1997"
28,7,9,179,537,580,1117,"6 de julio de 1997"
28,7,9,180,434,592,1026,"6 de julio de 1997"
28,7,9,181,419,457,876,"6 de julio de 1997"
28,7,9,182,401,433,834,"6 de julio de 1997"
28,7,9,183,387,477,864,"6 de julio de 1997"
28,7,9,184,561,672,1233,"6 de julio de 1997"
28,7,9,185,465,564,1029,"6 de julio de 1997"
28,7,9,186,489,613,1102,"6 de julio de 1997"
28,7,9,187,590,644,1234,"6 de julio de 1997"
28,7,9,188,545,663,1208,"6 de julio de 1997"
28,7,9,189,711,912,1623,"6 de julio de 1997"
28,7,9,190,648,655,1303,"6 de julio de 1997"
28,7,9,191,543,596,1139,"6 de julio de 1997"
28,7,9,192,610,582,1192,"6 de julio de 1997"
28,7,9,193,642,640,1282,"6 de julio de 1997"
28,7,9,194,653,692,1345,"6 de julio de 1997"
28,7,9,195,368,408,776,"6 de julio de 1997"
28,7,9,196,422,495,917,"6 de julio de 1997"
28,7,9,197,552,681,1233,"6 de julio de 1997"
28,7,9,198,613,686,1299,"6 de julio de 1997"
28,7,9,199,447,588,1035,"6 de julio de 1997"
28,7,9,200,490,622,1112,"6 de julio de 1997"
28,7,9,201,405,447,852,"6 de julio de 1997"
28,7,9,202,435,504,939,"6 de julio de 1997"
28,7,9,203,406,441,847,"6 de julio de 1997"
28,7,9,204,618,599,1217,"6 de julio de 1997"
28,7,9,205,594,574,1168,"6 de julio de 1997"
28,7,9,206,711,712,1423,"6 de julio de 1997"
28,7,9,207,484,469,953,"6 de julio de 1997"
28,7,9,208,642,687,1329,"6 de julio de 1997"
28,7,9,209,512,575,1087,"6 de julio de 1997"
28,7,9,210,530,573,1103,"6 de julio de 1997"
28,7,9,211,650,734,1384,"6 de julio de 1997"
28,7,9,212,626,698,1324,"6 de julio de 1997"
28,7,9,213,415,535,950,"6 de julio de 1997"
28,7,9,214,514,627,1141,"6 de julio de 1997"
28,7,9,215,544,637,1181,"6 de julio de 1997"
28,7,9,216,472,503,975,"6 de julio de 1997"
28,7,9,217,389,438,827,"6 de julio de 1997"
28,7,9,218,505,604,1109,"6 de julio de 1997"
28,7,9,219,473,590,1063,"6 de julio de 1997"
28,7,9,220,577,614,1191,"6 de julio de 1997"
28,7,9,221,532,569,1101,"6 de julio de 1997"
28,7,9,222,543,572,1115,"6 de julio de 1997"
28,7,9,223,484,584,1068,"6 de julio de 1997"
28,7,9,224,586,713,1299,"6 de julio de 1997"
28,7,9,225,436,514,950,"6 de julio de 1997"
28,7,9,226,434,519,953,"6 de julio de 1997"
28,7,9,227,550,637,1187,"6 de julio de 1997"
28,7,9,228,509,621,1130,"6 de julio de 1997"
28,7,9,229,523,567,1090,"6 de julio de 1997"
28,7,9,230,529,650,1179,"6 de julio de 1997"
28,7,9,231,477,608,1085,"6 de julio de 1997"
28,7,9,232,580,734,1314,"6 de julio de 1997"
28,7,9,233,591,627,1218,"6 de julio de 1997"
28,7,9,234,404,478,882,"6 de julio de 1997"
28,7,9,235,323,409,732,"6 de julio de 1997"
28,7,9,236,242,270,512,"6 de julio de 1997"
28,7,9,237,391,454,845,"6 de julio de 1997"
28,7,9,238,568,656,1224,"6 de julio de 1997"
28,7,9,239,468,498,966,"6 de julio de 1997"
28,7,9,240,517,543,1060,"6 de julio de 1997"
28,7,9,241,491,572,1063,"6 de julio de 1997"
28,7,9,242,632,792,1424,"6 de julio de 1997"
28,7,9,243,361,448,809,"6 de julio de 1997"
28,7,9,244,582,668,1250,"6 de julio de 1997"
28,7,9,245,432,479,911,"6 de julio de 1997"
28,7,9,246,496,570,1066,"6 de julio de 1997"
28,7,9,247,475,509,984,"6 de julio de 1997"
28,7,9,248,368,387,755,"6 de julio de 1997"
28,7,9,249,349,430,779,"6 de julio de 1997"
28,7,9,250,506,594,1100,"6 de julio de 1997"
28,7,9,251,382,425,807,"6 de julio de 1997"
28,7,9,252,312,395,707,"6 de julio de 1997"
28,7,9,253,572,641,1213,"6 de julio de 1997"
28,7,9,254,399,453,852,"6 de julio de 1997"
28,7,9,255,382,409,791,"6 de julio de 1997"
28,7,9,256,479,566,1045,"6 de julio de 1997"
28,7,9,257,396,505,901,"6 de julio de 1997"
28,7,9,258,374,442,816,"6 de julio de 1997"
28,8,38,1304,535,538,1073,"6 de julio de 1997"
28,8,38,1305,574,585,1159,"6 de julio de 1997"
28,8,38,1306,425,451,876,"6 de julio de 1997"
28,8,38,1307,554,590,1144,"6 de julio de 1997"
28,8,38,1308,438,468,906,"6 de julio de 1997"
28,8,38,1309,385,396,781,"6 de julio de 1997"
28,8,38,1310,578,631,1209,"6 de julio de 1997"
28,8,38,1311,330,357,687,"6 de julio de 1997"
28,8,38,1312,400,422,822,"6 de julio de 1997"
28,8,38,1313,514,540,1054,"6 de julio de 1997"
28,8,38,1314,712,781,1493,"6 de julio de 1997"
28,8,38,1315,485,477,962,"6 de julio de 1997"
28,8,38,1316,463,488,951,"6 de julio de 1997"
28,8,38,1317,491,520,1011,"6 de julio de 1997"
28,8,38,1318,659,730,1389,"6 de julio de 1997"
28,8,38,1319,584,607,1191,"6 de julio de 1997"
28,8,38,1320,531,598,1129,"6 de julio de 1997"
28,8,38,1321,395,434,829,"6 de julio de 1997"
28,8,38,1322,403,475,878,"6 de julio de 1997"
28,8,38,1323,534,597,1131,"6 de julio de 1997"
28,8,38,1324,366,412,778,"6 de julio de 1997"
28,8,38,1325,449,511,960,"6 de julio de 1997"
28,8,38,1326,569,647,1216,"6 de julio de 1997"
28,8,38,1327,653,729,1382,"6 de julio de 1997"
28,8,38,1328,633,646,1279,"6 de julio de 1997"
28,8,38,1329,636,749,1385,"6 de julio de 1997"
28,8,38,1330,671,713,1384,"6 de julio de 1997"
28,8,38,1331,624,660,1284,"6 de julio de 1997"
28,8,38,1332,565,608,1173,"6 de julio de 1997"
28,8,38,1333,715,808,1523,"6 de julio de 1997"
28,8,38,1334,764,806,1570,"6 de julio de 1997"
28,8,38,1335,489,515,1004,"6 de julio de 1997"
28,8,38,1336,622,688,1310,"6 de julio de 1997"
28,8,38,1337,500,510,1010,"6 de julio de 1997"
28,8,38,1338,423,448,871,"6 de julio de 1997"
28,8,38,1339,479,531,1010,"6 de julio de 1997"
28,8,38,1340,664,691,1355,"6 de julio de 1997"
28,8,38,1341,457,546,1003,"6 de julio de 1997"
28,8,38,1342,461,510,971,"6 de julio de 1997"
28,8,38,1343,313,360,673,"6 de julio de 1997"
28,8,38,1344,615,639,1254,"6 de julio de 1997"
28,8,38,1345,574,584,1158,"6 de julio de 1997"
28,8,38,1346,461,537,998,"6 de julio de 1997"
28,8,38,1347,798,926,1724,"6 de julio de 1997"
28,8,38,1348,512,612,1124,"6 de julio de 1997"
28,8,38,1349,340,435,775,"6 de julio de 1997"
28,8,38,1350,657,755,1412,"6 de julio de 1997"
28,8,38,1351,643,701,1344,"6 de julio de 1997"
28,8,38,1352,563,610,1173,"6 de julio de 1997"
28,8,38,1353,438,490,928,"6 de julio de 1997"
28,8,38,1354,578,586,1164,"6 de julio de 1997"
28,8,38,1355,462,454,916,"6 de julio de 1997"
28,8,38,1356,503,589,1092,"6 de julio de 1997"
28,8,38,1357,374,3,377,"6 de julio de 1997"
28,8,38,1358,560,596,1156,"6 de julio de 1997"
28,8,38,1359,445,551,996,"6 de julio de 1997"
28,8,38,1360,521,596,1117,"6 de julio de 1997"
28,8,38,1361,372,435,807,"6 de julio de 1997"
28,8,38,1362,691,818,1509,"6 de julio de 1997"
28,8,38,1363,461,548,1009,"6 de julio de 1997"
28,8,38,1364,444,539,983,"6 de julio de 1997"
28,8,38,1365,590,633,1223,"6 de julio de 1997"
28,8,38,1366,427,476,903,"6 de julio de 1997"
28,8,38,1367,593,723,1316,"6 de julio de 1997"
28,8,38,1368,569,623,1192,"6 de julio de 1997"
28,8,38,1369,450,515,965,"6 de julio de 1997"
28,8,38,1370,419,488,907,"6 de julio de 1997"
28,8,38,1371,535,627,1162,"6 de julio de 1997"
28,8,38,1372,475,571,1046,"6 de julio de 1997"
28,8,38,1373,237,246,483,"6 de julio de 1997"
28,8,38,1374,414,442,856,"6 de julio de 1997"
28,8,38,1375,404,407,811,"6 de julio de 1997"
28,8,38,1376,474,543,1017,"6 de julio de 1997"
28,8,38,1377,712,798,1510,"6 de julio de 1997"
28,8,38,1378,602,622,1224,"6 de julio de 1997"
28,8,38,1379,529,614,1143,"6 de julio de 1997"
28,8,38,1380,637,703,1340,"6 de julio de 1997"
28,8,38,1381,294,317,611,"6 de julio de 1997"
28,8,38,1382,398,477,875,"6 de julio de 1997"
28,8,38,1383,441,519,960,"6 de julio de 1997"
28,8,38,1384,422,472,894,"6 de julio de 1997"
28,8,38,1385,539,626,1165,"6 de julio de 1997"
28,8,38,1386,578,669,1247,"6 de julio de 1997"
28,8,38,1387,721,866,1587,"6 de julio de 1997"
28,8,38,1388,423,508,931,"6 de julio de 1997"
28,8,38,1389,431,545,976,"6 de julio de 1997"
28,8,38,1390,297,381,678,"6 de julio de 1997"
28,8,38,1391,464,574,1038,"6 de julio de 1997"
28,8,38,1392,696,837,1533,"6 de julio de 1997"
28,8,38,1393,697,839,1536,"6 de julio de 1997"
28,8,38,1394,260,358,618,"6 de julio de 1997"
28,8,38,1395,325,424,749,"6 de julio de 1997"
28,8,38,1396,427,571,998,"6 de julio de 1997"
28,8,38,1397,516,660,1176,"6 de julio de 1997"
28,8,38,1398,397,526,923,"6 de julio de 1997"
28,8,38,1399,316,417,733,"6 de julio de 1997"
28,8,38,1400,495,654,1149,"6 de julio de 1997"
28,8,38,1401,611,633,1244,"6 de julio de 1997"
28,8,38,1402,539,676,1215,"6 de julio de 1997"
28,8,38,1403,464,574,1038,"6 de julio de 1997"
28,8,38,1404,355,427,782,"6 de julio de 1997"
28,8,38,1405,354,433,787,"6 de julio de 1997"
28,8,38,1406,362,448,810,"6 de julio de 1997"
28,8,38,1407,330,363,693,"6 de julio de 1997"
28,8,38,1408,508,625,1133,"6 de julio de 1997"
28,8,38,1409,508,632,1140,"6 de julio de 1997"
28,8,38,1410,548,634,1182,"6 de julio de 1997"
28,8,38,1411,343,409,752,"6 de julio de 1997"
28,8,38,1412,308,364,672,"6 de julio de 1997"
28,8,38,1413,559,585,1144,"6 de julio de 1997"
28,8,38,1414,528,603,1131,"6 de julio de 1997"
28,8,38,1415,453,542,995,"6 de julio de 1997"
28,8,38,1416,566,704,1270,"6 de julio de 1997"
28,8,38,1417,590,698,1288,"6 de julio de 1997"
28,8,38,1418,495,550,1045,"6 de julio de 1997"
28,8,38,1419,591,697,1288,"6 de julio de 1997"
28,8,38,1420,512,680,1192,"6 de julio de 1997"
28,8,38,1421,519,650,1169,"6 de julio de 1997"
28,8,38,1422,345,448,793,"6 de julio de 1997"
28,8,38,1423,359,467,826,"6 de julio de 1997"
28,8,38,1424,511,569,1080,"6 de julio de 1997"
28,8,38,1425,296,354,650,"6 de julio de 1997"
28,8,38,1426,507,601,1108,"6 de julio de 1997"
28,8,38,1427,557,577,1134,"6 de julio de 1997"
28,8,38,1428,547,541,1088,"6 de julio de 1997"
28,8,38,1429,406,539,945,"6 de julio de 1997"
28,8,38,1430,292,346,638,"6 de julio de 1997"
28,8,38,1431,254,337,591,"6 de julio de 1997"
28,8,38,1432,578,658,1236,"6 de julio de 1997"
28,8,38,1433,310,348,658,"6 de julio de 1997"
28,8,38,1434,312,400,712,"6 de julio de 1997"
28,8,38,1435,358,409,767,"6 de julio de 1997"
28,8,38,1436,364,372,736,"6 de julio de 1997"
28,8,38,1437,463,506,969,"6 de julio de 1997"
28,8,38,1438,390,407,797,"6 de julio de 1997"
28,8,38,1439,403,446,849,"6 de julio de 1997"
28,8,38,1440,405,498,903,"6 de julio de 1997"
28,8,38,1441,638,719,1357,"6 de julio de 1997"
28,8,38,1442,818,793,1611,"6 de julio de 1997"
28,8,38,1443,495,538,1033,"6 de julio de 1997"
28,8,38,1444,500,583,1083,"6 de julio de 1997"
28,8,38,1445,369,407,776,"6 de julio de 1997"
28,8,38,1446,446,469,915,"6 de julio de 1997"
28,8,38,1447,451,475,926,"6 de julio de 1997"
28,8,38,1448,297,386,683,"6 de julio de 1997"
28,8,38,1449,617,721,1338,"6 de julio de 1997"
28,8,38,1450,550,545,1095,"6 de julio de 1997"
28,8,38,1451,575,638,1213,"6 de julio de 1997"
28,8,38,1452,595,589,1184,"6 de julio de 1997"
28,8,38,1453,582,631,1213,"6 de julio de 1997"
28,8,38,1454,420,427,847,"6 de julio de 1997"
28,8,38,1455,338,409,747,"6 de julio de 1997"
28,8,38,1456,444,541,985,"6 de julio de 1997"
28,8,38,1457,418,475,893,"6 de julio de 1997"
28,8,38,1458,483,546,1029,"6 de julio de 1997"
28,8,38,1459,402,445,847,"6 de julio de 1997"
28,8,38,1460,460,496,956,"6 de julio de 1997"
28,8,38,1461,452,512,964,"6 de julio de 1997"
28,8,38,1462,490,539,1029,"6 de julio de 1997"
28,8,38,1463,599,644,1243,"6 de julio de 1997"
28,8,38,1464,474,568,1042,"6 de julio de 1997"
28,8,38,1465,507,565,1072,"6 de julio de 1997"
28,8,38,1466,541,608,1149,"6 de julio de 1997"
28,8,38,1467,366,384,750,"6 de julio de 1997"
28,8,38,1468,318,326,644,"6 de julio de 1997"
28,8,38,1469,284,340,624,"6 de julio de 1997"
28,8,38,1470,291,300,591,"6 de julio de 1997"
28,8,38,1471,553,596,1149,"6 de julio de 1997"
28,8,38,1472,293,369,662,"6 de julio de 1997"
28,8,38,1473,495,536,1031,"6 de julio de 1997"
28,8,38,1474,399,425,824,"6 de julio de 1997"
28,8,38,1475,401,428,829,"6 de julio de 1997"
28,8,38,1476,781,226,1007,"6 de julio de 1997"
28,8,38,1477,566,591,1157,"6 de julio de 1997"
28,8,38,1478,335,368,703,"6 de julio de 1997"
28,8,38,1479,527,599,1126,"6 de julio de 1997"
28,8,38,1480,376,399,775,"6 de julio de 1997"
28,8,38,1481,395,490,885,"6 de julio de 1997"
28,8,38,1482,376,431,807,"6 de julio de 1997"
28,8,38,1483,416,440,856,"6 de julio de 1997"
28,8,38,1484,338,311,649,"6 de julio de 1997"
28,8,38,1485,241,230,471,"6 de julio de 1997"
28,8,38,1486,332,370,702,"6 de julio de 1997"
28,8,38,1487,467,491,958,"6 de julio de 1997"
28,8,38,1488,561,644,1205,"6 de julio de 1997"
28,8,38,1489,348,353,701,"6 de julio de 1997"
28,8,38,1490,270,249,519,"6 de julio de 1997"
28,8,38,1491,191,177,368,"6 de julio de 1997"
28,8,38,1492,254,307,561,"6 de julio de 1997"
28,8,38,1493,247,290,537,"6 de julio de 1997"
28,8,38,1494,266,281,547,"6 de julio de 1997"
28,8,38,1495,297,311,608,"6 de julio de 1997"
28,8,38,1496,364,345,709,"6 de julio de 1997"
29,1,3,12,574,651,1225,"6 de julio de 1997"
29,1,3,13,572,687,1259,"6 de julio de 1997"
29,1,3,14,598,673,1271,"6 de julio de 1997"
29,1,3,15,460,543,1003,"6 de julio de 1997"
29,1,3,16,448,506,954,"6 de julio de 1997"
29,1,3,17,631,783,1414,"6 de julio de 1997"
29,1,3,18,594,654,1248,"6 de julio de 1997"
29,1,3,19,524,631,1155,"6 de julio de 1997"
29,1,3,20,223,287,510,"6 de julio de 1997"
29,1,3,21,140,159,299,"6 de julio de 1997"
29,1,3,22,637,813,1450,"6 de julio de 1997"
29,1,3,23,341,391,732,"6 de julio de 1997"
29,1,3,24,429,501,930,"6 de julio de 1997"
29,1,3,25,583,655,1238,"6 de julio de 1997"
29,1,3,26,505,606,1111,"6 de julio de 1997"
29,1,3,27,733,824,1557,"6 de julio de 1997"
29,1,3,28,758,905,1663,"6 de julio de 1997"
29,1,3,29,726,859,1585,"6 de julio de 1997"
29,1,3,30,581,694,1275,"6 de julio de 1997"
29,1,3,31,699,768,1467,"6 de julio de 1997"
29,1,3,32,641,738,1379,"6 de julio de 1997"
29,1,3,33,530,590,1120,"6 de julio de 1997"
29,1,3,34,572,640,1212,"6 de julio de 1997"
29,1,3,35,417,483,900,"6 de julio de 1997"
29,1,3,36,574,663,1237,"6 de julio de 1997"
29,1,3,37,477,538,1015,"6 de julio de 1997"
29,1,3,38,266,246,512,"6 de julio de 1997"
29,1,3,39,243,242,485,"6 de julio de 1997"
29,1,3,40,728,729,1457,"6 de julio de 1997"
29,1,3,41,723,711,1434,"6 de julio de 1997"
29,1,3,42,108,119,227,"6 de julio de 1997"
29,1,3,43,468,478,946,"6 de julio de 1997"
29,1,3,44,384,408,792,"6 de julio de 1997"
29,1,3,45,66,70,136,"6 de julio de 1997"
29,1,3,46,316,362,678,"6 de julio de 1997"
29,1,3,47,247,292,539,"6 de julio de 1997"
29,1,3,48,201,192,393,"6 de julio de 1997"
29,1,4,49,210,236,446,"6 de julio de 1997"
29,1,4,50,103,87,190,"6 de julio de 1997"
29,1,4,51,88,87,175,"6 de julio de 1997"
29,1,4,52,28,25,53,"6 de julio de 1997"
29,1,4,53,359,337,696,"6 de julio de 1997"
29,1,4,54,106,121,227,"6 de julio de 1997"
29,1,4,55,89,80,169,"6 de julio de 1997"
29,1,4,56,288,320,608,"6 de julio de 1997"
29,1,4,57,89,103,192,"6 de julio de 1997"
29,1,4,58,7,14,21,"6 de julio de 1997"
29,1,5,59,330,342,672,"6 de julio de 1997"
29,1,5,60,199,192,391,"6 de julio de 1997"
29,1,5,61,208,183,391,"6 de julio de 1997"
29,1,5,62,105,100,205,"6 de julio de 1997"
29,1,5,63,95,99,194,"6 de julio de 1997"
29,1,5,64,96,73,169,"6 de julio de 1997"
29,1,5,65,80,83,163,"6 de julio de 1997"
29,1,5,66,138,131,269,"6 de julio de 1997"
29,1,5,67,73,68,141,"6 de julio de 1997"
29,1,5,68,531,514,1045,"6 de julio de 1997"
29,1,5,69,253,258,511,"6 de julio de 1997"
29,1,5,70,184,166,350,"6 de julio de 1997"
29,1,5,71,263,233,496,"6 de julio de 1997"
29,1,5,72,182,176,358,"6 de julio de 1997"
29,1,5,73,70,54,124,"6 de julio de 1997"
29,1,5,74,276,262,538,"6 de julio de 1997"
29,1,5,75,90,80,170,"6 de julio de 1997"
29,1,5,76,83,67,150,"6 de julio de 1997"
29,1,5,77,364,388,752,"6 de julio de 1997"
29,1,7,100,718,740,1458,"6 de julio de 1997"
29,1,7,101,664,729,1393,"6 de julio de 1997"
29,1,7,102,698,723,1421,"6 de julio de 1997"
29,1,7,103,330,315,645,"6 de julio de 1997"
29,1,7,104,346,377,723,"6 de julio de 1997"
29,1,7,105,105,95,200,"6 de julio de 1997"
29,1,7,106,52,48,100,"6 de julio de 1997"
29,1,8,107,652,716,1368,"6 de julio de 1997"
29,1,8,108,413,434,847,"6 de julio de 1997"
29,1,8,109,561,593,1154,"6 de julio de 1997"
29,1,8,110,393,376,769,"6 de julio de 1997"
29,1,8,111,67,55,122,"6 de julio de 1997"
29,1,8,112,34,34,68,"6 de julio de 1997"
29,1,8,113,73,79,152,"6 de julio de 1997"
29,1,8,114,190,168,358,"6 de julio de 1997"
29,1,8,115,108,92,200,"6 de julio de 1997"
29,1,8,116,92,85,177,"6 de julio de 1997"
29,1,9,117,376,405,781,"6 de julio de 1997"
29,1,9,118,307,310,617,"6 de julio de 1997"
29,1,9,119,128,127,255,"6 de julio de 1997"
29,1,9,120,57,62,119,"6 de julio de 1997"
29,1,9,121,293,297,590,"6 de julio de 1997"
29,1,13,178,828,928,1756,"6 de julio de 1997"
29,1,13,179,771,913,1684,"6 de julio de 1997"
29,1,13,180,563,579,1142,"6 de julio de 1997"
29,1,13,181,815,932,1747,"6 de julio de 1997"
29,1,13,182,442,515,957,"6 de julio de 1997"
29,1,13,183,345,425,770,"6 de julio de 1997"
29,1,13,184,272,283,555,"6 de julio de 1997"
29,1,13,185,526,587,1113,"6 de julio de 1997"
29,1,13,186,571,709,1280,"6 de julio de 1997"
29,1,13,187,787,919,1706,"6 de julio de 1997"
29,1,13,188,575,600,1175,"6 de julio de 1997"
29,1,13,189,705,802,1507,"6 de julio de 1997"
29,1,13,190,430,473,903,"6 de julio de 1997"
29,1,13,191,429,502,931,"6 de julio de 1997"
29,1,13,192,608,649,1257,"6 de julio de 1997"
29,1,13,193,191,192,383,"6 de julio de 1997"
29,1,13,194,611,732,1343,"6 de julio de 1997"
29,1,13,195,373,389,762,"6 de julio de 1997"
29,1,13,196,305,279,584,"6 de julio de 1997"
29,1,13,197,64,61,125,"6 de julio de 1997"
29,1,13,198,137,121,258,"6 de julio de 1997"
29,1,13,199,143,166,309,"6 de julio de 1997"
29,1,13,200,401,403,804,"6 de julio de 1997"
29,1,13,201,773,769,1542,"6 de julio de 1997"
29,1,13,202,138,145,283,"6 de julio de 1997"
29,1,13,203,600,595,1195,"6 de julio de 1997"
29,1,13,204,364,364,728,"6 de julio de 1997"
29,1,13,205,60,59,119,"6 de julio de 1997"
29,1,13,206,209,180,389,"6 de julio de 1997"
29,1,13,207,199,206,405,"6 de julio de 1997"
29,1,13,208,203,193,396,"6 de julio de 1997"
29,1,13,209,181,225,406,"6 de julio de 1997"
29,1,13,210,52,43,95,"6 de julio de 1997"
29,1,13,211,263,254,517,"6 de julio de 1997"
29,1,13,212,120,113,233,"6 de julio de 1997"
29,1,13,213,675,698,1373,"6 de julio de 1997"
29,1,13,214,470,528,998,"6 de julio de 1997"
29,1,13,215,60,60,120,"6 de julio de 1997"
29,1,13,216,193,209,402,"6 de julio de 1997"
29,1,13,217,154,170,324,"6 de julio de 1997"
29,1,13,218,147,151,298,"6 de julio de 1997"
29,1,13,219,222,237,459,"6 de julio de 1997"
29,1,16,259,473,523,996,"6 de julio de 1997"
29,1,16,260,425,454,879,"6 de julio de 1997"
29,1,16,261,518,559,1077,"6 de julio de 1997"
29,1,16,262,281,294,575,"6 de julio de 1997"
29,1,30,398,580,560,1140,"6 de julio de 1997"
29,1,30,399,404,408,812,"6 de julio de 1997"
29,1,30,403,362,324,686,"6 de julio de 1997"
29,1,30,404,668,623,1291,"6 de julio de 1997"
29,1,30,405,60,58,118,"6 de julio de 1997"
29,1,30,406,129,117,246,"6 de julio de 1997"
29,1,30,407,190,177,367,"6 de julio de 1997"
29,1,30,408,324,301,625,"6 de julio de 1997"
29,1,31,409,252,266,518,"6 de julio de 1997"
29,1,31,410,351,375,726,"6 de julio de 1997"
29,1,31,411,491,510,1001,"6 de julio de 1997"
29,1,31,412,460,510,970,"6 de julio de 1997"
29,1,31,413,343,367,710,"6 de julio de 1997"
29,1,31,414,345,425,770,"6 de julio de 1997"
29,1,31,415,351,438,789,"6 de julio de 1997"
29,1,31,416,328,297,625,"6 de julio de 1997"
29,1,31,417,77,74,151,"6 de julio de 1997"
29,1,31,418,83,68,151,"6 de julio de 1997"
29,1,31,419,159,127,286,"6 de julio de 1997"
29,1,31,420,501,520,1021,"6 de julio de 1997"
29,1,31,421,491,537,1028,"6 de julio de 1997"
29,1,31,422,615,629,1244,"6 de julio de 1997"
29,1,31,423,66,59,125,"6 de julio de 1997"
29,1,34,470,245,305,550,"6 de julio de 1997"
29,1,34,471,317,314,631,"6 de julio de 1997"
29,1,34,472,251,296,547,"6 de julio de 1997"
29,1,34,473,218,278,496,"6 de julio de 1997"
29,1,34,474,276,302,578,"6 de julio de 1997"
29,1,34,475,492,573,1065,"6 de julio de 1997"
29,1,34,476,424,442,866,"6 de julio de 1997"
29,1,34,477,422,499,921,"6 de julio de 1997"
29,1,34,478,98,114,212,"6 de julio de 1997"
29,1,34,479,96,73,169,"6 de julio de 1997"
29,1,34,480,91,77,168,"6 de julio de 1997"
29,1,34,481,639,721,1360,"6 de julio de 1997"
29,1,34,482,455,434,889,"6 de julio de 1997"
29,1,34,483,32,29,61,"6 de julio de 1997"
29,1,34,484,375,374,749,"6 de julio de 1997"
29,1,34,485,210,196,406,"6 de julio de 1997"
29,1,34,486,191,189,380,"6 de julio de 1997"
29,1,34,487,262,30,292,"6 de julio de 1997"
29,1,34,488,357,333,690,"6 de julio de 1997"
29,1,34,489,42,38,80,"6 de julio de 1997"
29,1,34,490,74,57,131,"6 de julio de 1997"
29,1,34,491,754,753,1507,"6 de julio de 1997"
29,1,34,492,72,74,146,"6 de julio de 1997"
29,1,34,493,147,157,304,"6 de julio de 1997"
29,1,34,494,226,220,446,"6 de julio de 1997"
29,1,34,495,247,241,488,"6 de julio de 1997"
29,1,34,496,169,187,356,"6 de julio de 1997"
29,1,34,497,160,137,297,"6 de julio de 1997"
29,1,34,498,94,74,168,"6 de julio de 1997"
29,1,34,499,209,211,420,"6 de julio de 1997"
29,1,34,500,152,151,303,"6 de julio de 1997"
29,1,34,501,441,424,865,"6 de julio de 1997"
29,1,34,502,86,90,176,"6 de julio de 1997"
29,1,34,503,38,31,69,"6 de julio de 1997"
29,1,34,504,62,50,112,"6 de julio de 1997"
29,1,35,505,699,696,1395,"6 de julio de 1997"
29,1,35,506,335,361,696,"6 de julio de 1997"
29,1,35,507,184,193,377,"6 de julio de 1997"
29,1,37,520,517,549,1066,"6 de julio de 1997"
29,1,37,521,398,391,789,"6 de julio de 1997"
29,1,37,522,474,519,993,"6 de julio de 1997"
29,1,37,523,524,633,1157,"6 de julio de 1997"
29,1,37,524,142,158,300,"6 de julio de 1997"
29,1,37,525,245,259,504,"6 de julio de 1997"
29,1,37,526,13,11,24,"6 de julio de 1997"
29,1,38,527,586,610,1196,"6 de julio de 1997"
29,1,38,528,536,590,1126,"6 de julio de 1997"
29,1,38,529,414,446,860,"6 de julio de 1997"
29,1,38,530,300,315,615,"6 de julio de 1997"
29,1,38,536,171,172,343,"6 de julio de 1997"
29,1,38,537,93,98,191,"6 de julio de 1997"
29,1,39,538,539,509,1048,"6 de julio de 1997"
29,1,39,539,636,639,1275,"6 de julio de 1997"
29,1,39,540,845,836,1681,"6 de julio de 1997"
29,1,39,541,694,721,1415,"6 de julio de 1997"
29,1,39,542,632,663,1295,"6 de julio de 1997"
29,1,39,543,591,620,1211,"6 de julio de 1997"
29,1,39,544,168,168,336,"6 de julio de 1997"
29,1,39,545,58,62,120,"6 de julio de 1997"
29,1,39,546,181,175,356,"6 de julio de 1997"
29,1,43,575,568,597,1165,"6 de julio de 1997"
29,1,43,576,436,480,916,"6 de julio de 1997"
29,1,43,577,194,200,394,"6 de julio de 1997"
29,1,43,578,276,271,547,"6 de julio de 1997"
29,1,43,579,313,341,654,"6 de julio de 1997"
29,1,43,580,183,202,385,"6 de julio de 1997"
29,1,43,581,561,591,1152,"6 de julio de 1997"
29,1,43,582,597,568,1165,"6 de julio de 1997"
29,1,43,583,327,374,701,"6 de julio de 1997"
29,1,43,584,203,202,405,"6 de julio de 1997"
29,1,43,585,667,685,1352,"6 de julio de 1997"
29,1,50,531,275,296,571,"6 de julio de 1997"
29,1,50,532,208,222,430,"6 de julio de 1997"
29,1,50,533,215,212,427,"6 de julio de 1997"
29,1,50,534,342,347,689,"6 de julio de 1997"
29,1,50,535,167,185,352,"6 de julio de 1997"
29,1,54,400,37,23,60,"6 de julio de 1997"
29,1,54,401,59,37,96,"6 de julio de 1997"
29,1,54,607,554,567,1121,"6 de julio de 1997"
29,1,54,608,163,149,312,"6 de julio de 1997"
29,1,55,402,72,55,127,"6 de julio de 1997"
29,1,55,606,492,473,965,"6 de julio de 1997"
29,2,1,1,234,260,494,"6 de julio de 1997"
29,2,1,2,787,839,1626,"6 de julio de 1997"
29,2,1,3,864,865,1729,"6 de julio de 1997"
29,2,1,4,145,146,291,"6 de julio de 1997"
29,2,2,5,616,649,1265,"6 de julio de 1997"
29,2,2,6,317,343,660,"6 de julio de 1997"
29,2,2,7,109,156,265,"6 de julio de 1997"
29,2,2,8,661,804,1465,"6 de julio de 1997"
29,2,2,9,543,586,1129,"6 de julio de 1997"
29,2,2,10,601,696,1297,"6 de julio de 1997"
29,2,2,11,206,251,457,"6 de julio de 1997"
29,2,6,78,783,885,1668,"6 de julio de 1997"
29,2,6,79,735,854,1589,"6 de julio de 1997"
29,2,6,80,602,675,1277,"6 de julio de 1997"
29,2,6,81,564,621,1185,"6 de julio de 1997"
29,2,6,82,390,451,841,"6 de julio de 1997"
29,2,6,83,817,908,1725,"6 de julio de 1997"
29,2,6,84,357,403,760,"6 de julio de 1997"
29,2,6,85,677,763,1440,"6 de julio de 1997"
29,2,6,86,478,513,991,"6 de julio de 1997"
29,2,6,87,397,422,819,"6 de julio de 1997"
29,2,6,88,569,642,1211,"6 de julio de 1997"
29,2,6,89,562,616,1178,"6 de julio de 1997"
29,2,6,90,375,435,810,"6 de julio de 1997"
29,2,6,91,211,222,433,"6 de julio de 1997"
29,2,6,92,515,510,1025,"6 de julio de 1997"
29,2,6,93,416,394,810,"6 de julio de 1997"
29,2,6,94,312,342,654,"6 de julio de 1997"
29,2,6,95,125,114,239,"6 de julio de 1997"
29,2,6,96,145,160,305,"6 de julio de 1997"
29,2,6,97,236,225,461,"6 de julio de 1997"
29,2,6,98,492,500,992,"6 de julio de 1997"
29,2,6,99,29,27,56,"6 de julio de 1997"
29,2,11,161,509,516,1025,"6 de julio de 1997"
29,2,11,162,305,306,611,"6 de julio de 1997"
29,2,11,163,129,122,251,"6 de julio de 1997"
29,2,11,164,54,55,109,"6 de julio de 1997"
29,2,12,165,567,579,1146,"6 de julio de 1997"
29,2,12,166,32,23,55,"6 de julio de 1997"
29,2,12,167,114,100,214,"6 de julio de 1997"
29,2,12,168,207,194,401,"6 de julio de 1997"
29,2,12,169,72,64,136,"6 de julio de 1997"
29,2,12,170,293,230,523,"6 de julio de 1997"
29,2,12,171,94,88,182,"6 de julio de 1997"
29,2,12,172,105,75,180,"6 de julio de 1997"
29,2,12,173,99,74,173,"6 de julio de 1997"
29,2,12,174,62,57,119,"6 de julio de 1997"
29,2,12,175,158,157,315,"6 de julio de 1997"
29,2,12,176,159,168,327,"6 de julio de 1997"
29,2,12,177,105,99,204,"6 de julio de 1997"
29,2,14,220,575,584,1159,"6 de julio de 1997"
29,2,14,221,648,698,1346,"6 de julio de 1997"
29,2,14,222,296,262,558,"6 de julio de 1997"
29,2,14,223,121,118,239,"6 de julio de 1997"
29,2,14,224,197,191,388,"6 de julio de 1997"
29,2,14,225,93,86,179,"6 de julio de 1997"
29,2,14,226,152,152,304,"6 de julio de 1997"
29,2,14,227,177,180,357,"6 de julio de 1997"
29,2,14,228,868,897,1765,"6 de julio de 1997"
29,2,14,229,44,42,86,"6 de julio de 1997"
29,2,14,230,210,232,442,"6 de julio de 1997"
29,2,14,231,103,89,192,"6 de julio de 1997"
29,2,15,232,433,472,905,"6 de julio de 1997"
29,2,15,233,539,579,1118,"6 de julio de 1997"
29,2,15,234,423,451,874,"6 de julio de 1997"
29,2,15,235,60,52,112,"6 de julio de 1997"
29,2,15,236,91,99,190,"6 de julio de 1997"
29,2,15,237,136,132,268,"6 de julio de 1997"
29,2,15,238,94,118,212,"6 de julio de 1997"
29,2,15,239,169,161,330,"6 de julio de 1997"
29,2,15,240,251,213,464,"6 de julio de 1997"
29,2,15,241,512,487,999,"6 de julio de 1997"
29,2,15,242,422,408,830,"6 de julio de 1997"
29,2,15,243,106,98,204,"6 de julio de 1997"
29,2,15,244,161,172,333,"6 de julio de 1997"
29,2,15,245,684,704,1388,"6 de julio de 1997"
29,2,15,246,200,191,391,"6 de julio de 1997"
29,2,15,247,488,553,1041,"6 de julio de 1997"
29,2,15,248,358,383,741,"6 de julio de 1997"
29,2,15,249,151,174,325,"6 de julio de 1997"
29,2,15,250,281,299,580,"6 de julio de 1997"
29,2,15,251,826,877,1703,"6 de julio de 1997"
29,2,15,252,459,512,971,"6 de julio de 1997"
29,2,15,253,501,586,1087,"6 de julio de 1997"
29,2,15,256,435,523,958,"6 de julio de 1997"
29,2,15,257,261,311,572,"6 de julio de 1997"
29,2,15,258,161,167,328,"6 de julio de 1997"
29,2,18,267,496,515,1011,"6 de julio de 1997"
29,2,18,268,595,571,1166,"6 de julio de 1997"
29,2,18,269,552,510,1062,"6 de julio de 1997"
29,2,18,270,251,265,516,"6 de julio de 1997"
29,2,18,271,523,573,1096,"6 de julio de 1997"
29,2,18,272,871,828,1699,"6 de julio de 1997"
29,2,18,273,598,590,1188,"6 de julio de 1997"
29,2,18,274,333,314,647,"6 de julio de 1997"
29,2,18,275,407,401,808,"6 de julio de 1997"
29,2,18,276,438,437,875,"6 de julio de 1997"
29,2,18,277,99,106,205,"6 de julio de 1997"
29,2,18,278,134,132,266,"6 de julio de 1997"
29,2,18,279,532,465,997,"6 de julio de 1997"
29,2,18,280,116,136,252,"6 de julio de 1997"
29,2,18,281,549,440,989,"6 de julio de 1997"
29,2,18,282,111,93,204,"6 de julio de 1997"
29,2,18,283,377,378,755,"6 de julio de 1997"
29,2,20,292,381,411,792,"6 de julio de 1997"
29,2,20,293,424,421,845,"6 de julio de 1997"
29,2,20,294,427,403,830,"6 de julio de 1997"
29,2,20,297,445,445,890,"6 de julio de 1997"
29,2,20,298,223,235,458,"6 de julio de 1997"
29,2,21,299,707,725,1432,"6 de julio de 1997"
29,2,21,300,522,541,1063,"6 de julio de 1997"
29,2,21,301,783,892,1675,"6 de julio de 1997"
29,2,21,302,791,768,1559,"6 de julio de 1997"
29,2,21,303,347,466,813,"6 de julio de 1997"
29,2,21,304,352,320,672,"6 de julio de 1997"
29,2,21,305,103,110,213,"6 de julio de 1997"
29,2,21,306,22,31,53,"6 de julio de 1997"
29,2,21,307,155,152,307,"6 de julio de 1997"
29,2,21,308,355,323,678,"6 de julio de 1997"
29,2,24,332,672,51,723,"6 de julio de 1997"
29,2,24,333,93,95,188,"6 de julio de 1997"
29,2,24,334,382,428,810,"6 de julio de 1997"
29,2,24,335,239,286,525,"6 de julio de 1997"
29,2,24,336,642,781,1423,"6 de julio de 1997"
29,2,24,337,635,751,1386,"6 de julio de 1997"
29,2,24,338,618,625,1243,"6 de julio de 1997"
29,2,24,339,334,349,683,"6 de julio de 1997"
29,2,24,340,292,295,587,"6 de julio de 1997"
29,2,24,341,48,44,92,"6 de julio de 1997"
29,2,24,342,499,529,1028,"6 de julio de 1997"
29,2,24,343,175,216,391,"6 de julio de 1997"
29,2,24,344,180,195,375,"6 de julio de 1997"
29,2,24,345,425,497,922,"6 de julio de 1997"
29,2,24,346,545,610,1155,"6 de julio de 1997"
29,2,24,347,468,515,983,"6 de julio de 1997"
29,2,26,365,232,241,473,"6 de julio de 1997"
29,2,26,366,565,582,1147,"6 de julio de 1997"
29,2,26,367,705,788,1493,"6 de julio de 1997"
29,2,26,368,523,568,1091,"6 de julio de 1997"
29,2,26,369,468,520,988,"6 de julio de 1997"
29,2,26,370,194,183,377,"6 de julio de 1997"
29,2,26,371,656,691,1347,"6 de julio de 1997"
29,2,33,435,450,463,913,"6 de julio de 1997"
29,2,33,436,411,441,852,"6 de julio de 1997"
29,2,33,437,278,350,628,"6 de julio de 1997"
29,2,33,438,435,492,927,"6 de julio de 1997"
29,2,33,439,471,516,987,"6 de julio de 1997"
29,2,33,440,403,506,909,"6 de julio de 1997"
29,2,33,441,553,674,1227,"6 de julio de 1997"
29,2,33,442,468,526,994,"6 de julio de 1997"
29,2,33,443,350,399,749,"6 de julio de 1997"
29,2,33,444,753,946,1699,"6 de julio de 1997"
29,2,33,445,472,539,1011,"6 de julio de 1997"
29,2,33,446,402,478,880,"6 de julio de 1997"
29,2,33,447,415,492,907,"6 de julio de 1997"
29,2,33,448,573,630,1203,"6 de julio de 1997"
29,2,33,449,518,658,1176,"6 de julio de 1997"
29,2,33,450,389,456,845,"6 de julio de 1997"
29,2,33,451,590,711,1301,"6 de julio de 1997"
29,2,33,452,387,506,893,"6 de julio de 1997"
29,2,33,453,830,947,1777,"6 de julio de 1997"
29,2,33,454,350,396,746,"6 de julio de 1997"
29,2,33,455,291,358,649,"6 de julio de 1997"
29,2,33,456,518,587,1105,"6 de julio de 1997"
29,2,33,457,448,585,1033,"6 de julio de 1997"
29,2,33,458,720,780,1500,"6 de julio de 1997"
29,2,33,459,470,584,1054,"6 de julio de 1997"
29,2,33,460,518,594,1112,"6 de julio de 1997"
29,2,33,461,617,736,1353,"6 de julio de 1997"
29,2,33,462,280,312,592,"6 de julio de 1997"
29,2,33,463,492,600,1092,"6 de julio de 1997"
29,2,33,464,657,790,1447,"6 de julio de 1997"
29,2,33,465,685,796,1481,"6 de julio de 1997"
29,2,33,466,841,894,1735,"6 de julio de 1997"
29,2,33,467,354,412,766,"6 de julio de 1997"
29,2,33,468,532,549,1081,"6 de julio de 1997"
29,2,33,469,407,439,846,"6 de julio de 1997"
29,2,36,508,209,246,455,"6 de julio de 1997"
29,2,36,509,279,313,592,"6 de julio de 1997"
29,2,36,510,271,269,540,"6 de julio de 1997"
29,2,36,511,222,263,485,"6 de julio de 1997"
29,2,36,512,350,404,754,"6 de julio de 1997"
29,2,36,513,618,682,1300,"6 de julio de 1997"
29,2,36,514,395,477,872,"6 de julio de 1997"
29,2,36,515,495,587,1082,"6 de julio de 1997"
29,2,36,516,543,612,1155,"6 de julio de 1997"
29,2,36,517,286,315,601,"6 de julio de 1997"
29,2,36,518,322,364,686,"6 de julio de 1997"
29,2,36,519,223,277,500,"6 de julio de 1997"
29,2,40,547,255,277,532,"6 de julio de 1997"
29,2,40,548,567,619,1186,"6 de julio de 1997"
29,2,40,549,386,402,788,"6 de julio de 1997"
29,2,40,550,290,294,584,"6 de julio de 1997"
29,2,40,555,212,222,434,"6 de julio de 1997"
29,2,40,556,216,216,432,"6 de julio de 1997"
29,2,40,557,176,207,383,"6 de julio de 1997"
29,2,57,551,473,488,961,"6 de julio de 1997"
29,2,57,552,260,273,533,"6 de julio de 1997"
29,2,57,553,72,69,141,"6 de julio de 1997"
29,2,57,554,45,46,91,"6 de julio de 1997"
29,2,58,254,743,770,1513,"6 de julio de 1997"
29,2,58,255,777,765,1542,"6 de julio de 1997"
29,2,60,295,699,733,1432,"6 de julio de 1997"
29,2,60,296,502,524,1026,"6 de julio de 1997"
29,3,10,122,475,490,965,"6 de julio de 1997"
29,3,10,123,448,548,996,"6 de julio de 1997"
29,3,10,124,514,502,1016,"6 de julio de 1997"
29,3,10,125,524,509,1033,"6 de julio de 1997"
29,3,10,126,458,447,905,"6 de julio de 1997"
29,3,10,127,685,770,1455,"6 de julio de 1997"
29,3,10,128,445,531,976,"6 de julio de 1997"
29,3,10,129,469,521,990,"6 de julio de 1997"
29,3,10,130,412,452,864,"6 de julio de 1997"
29,3,10,131,539,602,1141,"6 de julio de 1997"
29,3,10,132,424,526,950,"6 de julio de 1997"
29,3,10,133,403,450,853,"6 de julio de 1997"
29,3,10,134,377,413,790,"6 de julio de 1997"
29,3,10,135,375,489,864,"6 de julio de 1997"
29,3,10,136,155,190,345,"6 de julio de 1997"
29,3,10,137,539,601,1140,"6 de julio de 1997"
29,3,10,138,472,591,1063,"6 de julio de 1997"
29,3,10,139,1005,1040,2045,"6 de julio de 1997"
29,3,10,140,371,434,805,"6 de julio de 1997"
29,3,10,141,973,1013,1986,"6 de julio de 1997"
29,3,10,142,376,391,767,"6 de julio de 1997"
29,3,10,143,498,567,1065,"6 de julio de 1997"
29,3,10,144,432,479,911,"6 de julio de 1997"
29,3,10,145,462,442,904,"6 de julio de 1997"
29,3,10,146,499,503,1002,"6 de julio de 1997"
29,3,10,147,414,403,817,"6 de julio de 1997"
29,3,10,148,342,371,713,"6 de julio de 1997"
29,3,10,149,774,823,1597,"6 de julio de 1997"
29,3,10,156,393,421,814,"6 de julio de 1997"
29,3,10,157,270,291,561,"6 de julio de 1997"
29,3,17,263,509,507,1016,"6 de julio de 1997"
29,3,17,264,451,423,874,"6 de julio de 1997"
29,3,17,265,430,416,846,"6 de julio de 1997"
29,3,17,266,529,518,1047,"6 de julio de 1997"
29,3,19,284,362,424,786,"6 de julio de 1997"
29,3,19,285,504,548,1052,"6 de julio de 1997"
29,3,19,286,697,776,1473,"6 de julio de 1997"
29,3,19,287,433,472,905,"6 de julio de 1997"
29,3,19,288,469,451,920,"6 de julio de 1997"
29,3,19,289,447,507,954,"6 de julio de 1997"
29,3,19,290,528,551,1079,"6 de julio de 1997"
29,3,19,291,99,96,195,"6 de julio de 1997"
29,3,22,309,310,356,666,"6 de julio de 1997"
29,3,22,310,337,322,659,"6 de julio de 1997"
29,3,22,311,224,231,455,"6 de julio de 1997"
29,3,22,312,150,119,269,"6 de julio de 1997"
29,3,23,318,296,343,639,"6 de julio de 1997"
29,3,23,319,777,885,1662,"6 de julio de 1997"
29,3,23,320,183,193,376,"6 de julio de 1997"
29,3,23,321,198,212,410,"6 de julio de 1997"
29,3,23,322,323,329,652,"6 de julio de 1997"
29,3,23,323,525,598,1123,"6 de julio de 1997"
29,3,23,324,179,195,374,"6 de julio de 1997"
29,3,23,325,408,461,869,"6 de julio de 1997"
29,3,23,326,650,654,1304,"6 de julio de 1997"
29,3,23,327,520,519,1039,"6 de julio de 1997"
29,3,23,328,303,273,576,"6 de julio de 1997"
29,3,23,329,425,469,894,"6 de julio de 1997"
29,3,23,330,346,350,696,"6 de julio de 1997"
29,3,23,331,262,289,551,"6 de julio de 1997"
29,3,25,348,867,934,1801,"6 de julio de 1997"
29,3,25,349,799,796,1595,"6 de julio de 1997"
29,3,25,350,1012,988,2000,"6 de julio de 1997"
29,3,25,351,724,732,1456,"6 de julio de 1997"
29,3,25,352,607,606,1213,"6 de julio de 1997"
29,3,25,353,721,739,1460,"6 de julio de 1997"
29,3,25,354,977,960,1937,"6 de julio de 1997"
29,3,25,355,732,752,1484,"6 de julio de 1997"
29,3,25,356,891,900,1791,"6 de julio de 1997"
29,3,25,357,813,856,1669,"6 de julio de 1997"
29,3,25,358,716,763,1479,"6 de julio de 1997"
29,3,25,359,506,534,1040,"6 de julio de 1997"
29,3,25,360,564,614,1178,"6 de julio de 1997"
29,3,25,361,728,785,1513,"6 de julio de 1997"
29,3,25,362,739,758,1497,"6 de julio de 1997"
29,3,25,363,555,612,1167,"6 de julio de 1997"
29,3,25,364,506,558,1064,"6 de julio de 1997"
29,3,27,372,446,535,981,"6 de julio de 1997"
29,3,27,373,399,462,861,"6 de julio de 1997"
29,3,27,374,291,323,614,"6 de julio de 1997"
29,3,27,375,599,662,1261,"6 de julio de 1997"
29,3,27,376,380,431,811,"6 de julio de 1997"
29,3,27,377,619,639,1258,"6 de julio de 1997"
29,3,28,378,453,520,973,"6 de julio de 1997"
29,3,28,379,490,532,1022,"6 de julio de 1997"
29,3,28,380,842,877,1719,"6 de julio de 1997"
29,3,28,381,498,507,1005,"6 de julio de 1997"
29,3,28,382,370,421,791,"6 de julio de 1997"
29,3,28,383,368,421,789,"6 de julio de 1997"
29,3,28,384,379,421,800,"6 de julio de 1997"
29,3,28,385,77,68,145,"6 de julio de 1997"
29,3,28,386,573,655,1228,"6 de julio de 1997"
29,3,29,387,487,559,1046,"6 de julio de 1997"
29,3,29,388,395,435,830,"6 de julio de 1997"
29,3,29,389,80,76,156,"6 de julio de 1997"
29,3,29,390,252,277,529,"6 de julio de 1997"
29,3,29,393,197,201,398,"6 de julio de 1997"
29,3,29,394,485,533,1018,"6 de julio de 1997"
29,3,29,397,507,545,1052,"6 de julio de 1997"
29,3,32,424,373,330,703,"6 de julio de 1997"
29,3,32,425,427,422,849,"6 de julio de 1997"
29,3,32,426,492,464,956,"6 de julio de 1997"
29,3,32,427,586,600,1186,"6 de julio de 1997"
29,3,32,428,446,466,912,"6 de julio de 1997"
29,3,32,431,330,335,665,"6 de julio de 1997"
29,3,32,434,185,194,379,"6 de julio de 1997"
29,3,41,558,707,768,1475,"6 de julio de 1997"
29,3,41,559,618,659,1277,"6 de julio de 1997"
29,3,41,560,640,677,1317,"6 de julio de 1997"
29,3,41,561,718,791,1509,"6 de julio de 1997"
29,3,41,562,543,561,1104,"6 de julio de 1997"
29,3,41,563,491,616,1107,"6 de julio de 1997"
29,3,41,564,547,562,1109,"6 de julio de 1997"
29,3,41,565,290,295,585,"6 de julio de 1997"
29,3,41,566,330,349,679,"6 de julio de 1997"
29,3,41,567,300,318,618,"6 de julio de 1997"
29,3,41,568,221,208,429,"6 de julio de 1997"
29,3,41,569,119,122,241,"6 de julio de 1997"
29,3,42,570,772,846,1618,"6 de julio de 1997"
29,3,42,571,542,614,1156,"6 de julio de 1997"
29,3,42,572,429,473,902,"6 de julio de 1997"
29,3,42,573,626,686,1312,"6 de julio de 1997"
29,3,42,574,504,575,1079,"6 de julio de 1997"
29,3,44,588,355,384,739,"6 de julio de 1997"
29,3,44,589,497,535,1032,"6 de julio de 1997"
29,3,44,590,740,841,1581,"6 de julio de 1997"
29,3,44,591,901,968,1869,"6 de julio de 1997"
29,3,44,592,672,770,1442,"6 de julio de 1997"
29,3,44,593,774,913,1687,"6 de julio de 1997"
29,3,44,594,447,495,942,"6 de julio de 1997"
29,3,44,595,657,690,1347,"6 de julio de 1997"
29,3,44,596,419,498,917,"6 de julio de 1997"
29,3,44,597,550,592,1142,"6 de julio de 1997"
29,3,44,598,546,622,1168,"6 de julio de 1997"
29,3,44,599,595,634,1229,"6 de julio de 1997"
29,3,44,600,671,759,1430,"6 de julio de 1997"
29,3,44,601,709,778,1487,"6 de julio de 1997"
29,3,45,316,418,497,915,"6 de julio de 1997"
29,3,45,317,537,615,1152,"6 de julio de 1997"
29,3,46,313,454,540,994,"6 de julio de 1997"
29,3,46,314,376,416,792,"6 de julio de 1997"
29,3,46,315,317,318,635,"6 de julio de 1997"
29,3,47,395,707,765,1472,"6 de julio de 1997"
29,3,47,396,677,686,1363,"6 de julio de 1997"
29,3,48,602,419,501,920,"6 de julio de 1997"
29,3,48,603,246,280,526,"6 de julio de 1997"
29,3,48,604,748,850,1598,"6 de julio de 1997"
29,3,48,605,260,311,571,"6 de julio de 1997"
29,3,49,391,456,479,935,"6 de julio de 1997"
29,3,49,392,302,329,631,"6 de julio de 1997"
29,3,51,158,787,913,1700,"6 de julio de 1997"
29,3,51,159,604,632,1236,"6 de julio de 1997"
29,3,51,160,673,756,1429,"6 de julio de 1997"
29,3,52,150,249,261,510,"6 de julio de 1997"
29,3,52,151,836,921,1757,"6 de julio de 1997"
29,3,52,152,509,574,1083,"6 de julio de 1997"
29,3,52,153,303,358,661,"6 de julio de 1997"
29,3,52,154,411,452,863,"6 de julio de 1997"
29,3,52,155,361,424,785,"6 de julio de 1997"
29,3,53,429,595,612,1207,"6 de julio de 1997"
29,3,53,430,608,610,1218,"6 de julio de 1997"
29,3,56,432,363,422,785,"6 de julio de 1997"
29,3,56,433,432,561,993,"6 de julio de 1997"
29,3,59,586,481,543,1024,"6 de julio de 1997"
29,3,59,587,478,535,1013,"6 de julio de 1997"
30,1,57,1320,480,472,952,"6 de julio de 1997"
30,1,57,1321,315,305,620,"6 de julio de 1997"
30,1,57,1322,372,326,698,"6 de julio de 1997"
30,1,57,1323,308,301,609,"6 de julio de 1997"
30,1,57,1324,444,366,810,"6 de julio de 1997"
30,1,57,1325,274,251,525,"6 de julio de 1997"
30,1,57,1326,281,303,584,"6 de julio de 1997"
30,1,57,1327,358,382,740,"6 de julio de 1997"
30,1,57,1328,443,407,850,"6 de julio de 1997"
30,1,58,1329,501,468,969,"6 de julio de 1997"
30,1,58,1330,150,104,254,"6 de julio de 1997"
30,1,58,1331,250,212,462,"6 de julio de 1997"
30,1,58,1332,190,165,355,"6 de julio de 1997"
30,1,58,1333,209,216,425,"6 de julio de 1997"
30,1,58,1334,292,245,537,"6 de julio de 1997"
30,1,122,2776,750,738,1488,"6 de julio de 1997"
30,1,122,2777,573,582,1155,"6 de julio de 1997"
30,1,122,2778,298,190,488,"6 de julio de 1997"
30,1,122,2779,237,201,438,"6 de julio de 1997"
30,1,122,2780,141,102,243,"6 de julio de 1997"
30,1,122,2781,421,407,828,"6 de julio de 1997"
30,1,122,2782,145,131,276,"6 de julio de 1997"
30,1,122,2783,129,110,239,"6 de julio de 1997"
30,1,122,2784,200,163,363,"6 de julio de 1997"
30,1,122,2785,290,217,507,"6 de julio de 1997"
30,1,122,2786,279,220,499,"6 de julio de 1997"
30,1,122,2787,182,155,337,"6 de julio de 1997"
30,1,122,2788,361,313,674,"6 de julio de 1997"
30,1,122,2789,197,156,353,"6 de julio de 1997"
30,1,122,2790,477,411,888,"6 de julio de 1997"
30,1,122,2791,212,183,395,"6 de julio de 1997"
30,1,122,2792,243,241,484,"6 de julio de 1997"
30,1,122,2793,282,229,511,"6 de julio de 1997"
30,1,122,2794,316,224,540,"6 de julio de 1997"
30,1,122,2795,273,220,493,"6 de julio de 1997"
30,1,122,2796,111,71,182,"6 de julio de 1997"
30,1,122,2797,232,187,419,"6 de julio de 1997"
30,1,122,2798,354,259,613,"6 de julio de 1997"
30,1,122,2799,176,124,300,"6 de julio de 1997"
30,1,122,2800,188,131,319,"6 de julio de 1997"
30,1,122,2801,288,254,542,"6 de julio de 1997"
30,1,122,2802,414,302,716,"6 de julio de 1997"
30,1,122,2803,132,116,248,"6 de julio de 1997"
30,1,122,2804,228,193,421,"6 de julio de 1997"
30,1,124,2814,359,353,712,"6 de julio de 1997"
30,1,124,2815,467,524,991,"6 de julio de 1997"
30,1,124,2816,452,476,928,"6 de julio de 1997"
30,1,124,2817,458,509,967,"6 de julio de 1997"
30,1,124,2818,381,449,830,"6 de julio de 1997"
30,1,124,2819,499,522,1021,"6 de julio de 1997"
30,1,124,2820,516,591,1107,"6 de julio de 1997"
30,1,124,2821,337,385,722,"6 de julio de 1997"
30,1,124,2822,405,451,856,"6 de julio de 1997"
30,1,124,2823,458,516,974,"6 de julio de 1997"
30,1,124,2824,477,563,1040,"6 de julio de 1997"
30,1,124,2825,319,336,655,"6 de julio de 1997"
30,1,124,2826,306,279,585,"6 de julio de 1997"
30,1,124,2827,349,364,713,"6 de julio de 1997"
30,1,124,2828,294,322,616,"6 de julio de 1997"
30,1,124,2829,351,404,755,"6 de julio de 1997"
30,1,124,2830,556,615,1171,"6 de julio de 1997"
30,1,124,2831,479,468,947,"6 de julio de 1997"
30,1,124,2832,417,421,838,"6 de julio de 1997"
30,1,124,2833,521,577,1098,"6 de julio de 1997"
30,1,124,2834,402,400,802,"6 de julio de 1997"
30,1,124,2835,379,398,777,"6 de julio de 1997"
30,1,124,2836,420,510,930,"6 de julio de 1997"
30,1,124,2837,463,466,929,"6 de julio de 1997"
30,1,124,2838,433,340,773,"6 de julio de 1997"
30,1,124,2839,402,361,763,"6 de julio de 1997"
30,1,124,2840,583,489,1072,"6 de julio de 1997"
30,1,124,2841,275,231,506,"6 de julio de 1997"
30,1,124,2842,87,68,155,"6 de julio de 1997"
30,1,124,2843,122,99,221,"6 de julio de 1997"
30,1,124,2844,56,59,115,"6 de julio de 1997"
30,1,124,2845,369,342,711,"6 de julio de 1997"
30,1,124,2846,75,57,132,"6 de julio de 1997"
30,1,124,2847,94,86,180,"6 de julio de 1997"
30,1,124,2848,232,206,438,"6 de julio de 1997"
30,1,124,2849,150,114,264,"6 de julio de 1997"
30,1,124,2850,215,173,388,"6 de julio de 1997"
30,1,124,2851,131,114,245,"6 de julio de 1997"
30,1,124,2852,164,154,318,"6 de julio de 1997"
30,1,124,2853,152,152,304,"6 de julio de 1997"
30,1,124,2854,245,283,528,"6 de julio de 1997"
30,1,124,2855,282,308,590,"6 de julio de 1997"
30,1,124,2856,78,90,168,"6 de julio de 1997"
30,1,124,2857,92,75,167,"6 de julio de 1997"
30,1,124,2858,237,256,493,"6 de julio de 1997"
30,1,124,2859,567,573,1140,"6 de julio de 1997"
30,1,124,2860,496,500,996,"6 de julio de 1997"
30,1,124,2861,463,511,974,"6 de julio de 1997"
30,1,124,2862,515,522,1037,"6 de julio de 1997"
30,1,124,2863,395,431,826,"6 de julio de 1997"
30,1,124,2864,286,273,559,"6 de julio de 1997"
30,1,124,2865,455,455,910,"6 de julio de 1997"
30,1,124,2866,174,121,295,"6 de julio de 1997"
30,1,124,2867,237,199,436,"6 de julio de 1997"
30,1,124,2868,406,363,769,"6 de julio de 1997"
30,1,124,2869,523,542,1065,"6 de julio de 1997"
30,1,124,2870,340,364,704,"6 de julio de 1997"
30,1,124,2871,443,454,897,"6 de julio de 1997"
30,1,124,2872,198,133,331,"6 de julio de 1997"
30,1,124,2873,541,444,985,"6 de julio de 1997"
30,1,124,2874,143,117,260,"6 de julio de 1997"
30,1,124,2875,360,325,685,"6 de julio de 1997"
30,1,124,2876,511,434,945,"6 de julio de 1997"
30,1,124,2877,359,316,675,"6 de julio de 1997"
30,1,124,2878,195,140,335,"6 de julio de 1997"
30,1,124,2879,308,258,566,"6 de julio de 1997"
30,1,124,2880,225,194,419,"6 de julio de 1997"
30,1,124,2881,217,171,388,"6 de julio de 1997"
30,1,124,2882,295,303,598,"6 de julio de 1997"
30,1,124,2883,331,280,611,"6 de julio de 1997"
30,1,124,2884,555,495,1050,"6 de julio de 1997"
30,1,124,2885,555,443,998,"6 de julio de 1997"
30,1,124,2886,186,154,340,"6 de julio de 1997"
30,1,124,2887,126,99,225,"6 de julio de 1997"
30,1,124,2888,357,270,627,"6 de julio de 1997"
30,1,124,2889,315,266,581,"6 de julio de 1997"
30,1,124,2890,65,51,116,"6 de julio de 1997"
30,1,124,2891,235,170,405,"6 de julio de 1997"
30,1,124,2892,86,73,159,"6 de julio de 1997"
30,1,124,2893,592,530,1122,"6 de julio de 1997"
30,1,124,2894,152,134,286,"6 de julio de 1997"
30,1,124,2895,332,276,608,"6 de julio de 1997"
30,1,124,2896,189,157,346,"6 de julio de 1997"
30,1,124,2897,391,330,721,"6 de julio de 1997"
30,1,130,3067,627,631,1258,"6 de julio de 1997"
30,1,130,3068,482,459,941,"6 de julio de 1997"
30,1,130,3069,473,481,954,"6 de julio de 1997"
30,1,130,3070,596,576,1172,"6 de julio de 1997"
30,1,130,3071,467,437,904,"6 de julio de 1997"
30,1,130,3072,255,248,503,"6 de julio de 1997"
30,1,130,3073,137,90,227,"6 de julio de 1997"
30,1,130,3074,503,382,885,"6 de julio de 1997"
30,1,130,3075,106,107,213,"6 de julio de 1997"
30,1,130,3076,503,477,980,"6 de julio de 1997"
30,1,130,3077,112,108,220,"6 de julio de 1997"
30,1,130,3078,121,100,221,"6 de julio de 1997"
30,1,130,3079,290,271,561,"6 de julio de 1997"
30,1,130,3080,181,131,312,"6 de julio de 1997"
30,1,133,3219,357,385,742,"6 de julio de 1997"
30,1,133,3220,306,310,616,"6 de julio de 1997"
30,1,133,3221,445,449,894,"6 de julio de 1997"
30,1,133,3222,309,336,645,"6 de julio de 1997"
30,1,133,3223,460,470,930,"6 de julio de 1997"
30,1,133,3224,381,414,795,"6 de julio de 1997"
30,1,133,3225,333,345,678,"6 de julio de 1997"
30,1,133,3226,225,242,467,"6 de julio de 1997"
30,1,133,3227,338,376,714,"6 de julio de 1997"
30,1,133,3228,281,342,623,"6 de julio de 1997"
30,1,133,3229,436,479,915,"6 de julio de 1997"
30,1,133,3230,499,552,1051,"6 de julio de 1997"
30,1,133,3231,312,355,667,"6 de julio de 1997"
30,1,133,3232,463,537,1000,"6 de julio de 1997"
30,1,133,3233,1035,693,1728,"6 de julio de 1997"
30,1,133,3234,320,246,566,"6 de julio de 1997"
30,1,133,3235,401,407,808,"6 de julio de 1997"
30,1,133,3236,397,353,750,"6 de julio de 1997"
30,1,133,3237,363,375,738,"6 de julio de 1997"
30,1,133,3238,336,323,659,"6 de julio de 1997"
30,1,133,3239,396,415,811,"6 de julio de 1997"
30,1,133,3240,437,497,934,"6 de julio de 1997"
30,1,133,3241,322,337,659,"6 de julio de 1997"
30,1,133,3242,259,279,538,"6 de julio de 1997"
30,1,133,3243,353,369,722,"6 de julio de 1997"
30,1,133,3244,287,305,592,"6 de julio de 1997"
30,1,133,3245,516,574,1090,"6 de julio de 1997"
30,1,133,3246,348,337,685,"6 de julio de 1997"
30,1,133,3247,370,418,788,"6 de julio de 1997"
30,1,133,3248,385,393,778,"6 de julio de 1997"
30,1,133,3249,339,334,673,"6 de julio de 1997"
30,1,133,3250,139,137,276,"6 de julio de 1997"
30,1,133,3251,217,223,440,"6 de julio de 1997"
30,1,133,3252,356,357,713,"6 de julio de 1997"
30,1,133,3253,456,494,950,"6 de julio de 1997"
30,1,133,3254,180,157,337,"6 de julio de 1997"
30,1,133,3255,255,195,450,"6 de julio de 1997"
30,1,133,3256,196,153,349,"6 de julio de 1997"
30,1,133,3257,215,175,390,"6 de julio de 1997"
30,1,133,3258,68,64,132,"6 de julio de 1997"
30,1,153,3572,364,382,746,"6 de julio de 1997"
30,1,153,3573,417,443,860,"6 de julio de 1997"
30,1,153,3574,150,105,255,"6 de julio de 1997"
30,1,153,3575,135,100,235,"6 de julio de 1997"
30,1,153,3576,424,388,812,"6 de julio de 1997"
30,1,153,3577,147,124,271,"6 de julio de 1997"
30,1,153,3578,278,220,498,"6 de julio de 1997"
30,1,153,3579,168,120,288,"6 de julio de 1997"
30,1,153,3580,296,272,568,"6 de julio de 1997"
30,1,153,3581,421,375,796,"6 de julio de 1997"
30,1,153,3582,107,77,184,"6 de julio de 1997"
30,1,153,3583,150,117,267,"6 de julio de 1997"
30,1,153,3584,142,101,243,"6 de julio de 1997"
30,1,153,3585,319,277,596,"6 de julio de 1997"
30,1,153,3586,360,313,673,"6 de julio de 1997"
30,1,153,3587,155,138,293,"6 de julio de 1997"
30,1,153,3588,214,167,381,"6 de julio de 1997"
30,1,153,3589,292,216,508,"6 de julio de 1997"
30,1,153,3590,156,115,271,"6 de julio de 1997"
30,1,160,3706,299,334,633,"6 de julio de 1997"
30,1,160,3707,461,442,903,"6 de julio de 1997"
30,1,160,3708,431,408,839,"6 de julio de 1997"
30,1,160,3709,152,129,281,"6 de julio de 1997"
30,1,160,3710,491,500,991,"6 de julio de 1997"
30,1,160,3711,696,748,1444,"6 de julio de 1997"
30,1,160,3712,637,619,1256,"6 de julio de 1997"
30,1,160,3713,544,474,1018,"6 de julio de 1997"
30,1,160,3714,514,527,1041,"6 de julio de 1997"
30,1,160,3715,339,284,623,"6 de julio de 1997"
30,1,160,3716,124,122,246,"6 de julio de 1997"
30,1,160,3717,246,193,439,"6 de julio de 1997"
30,1,160,3718,496,408,904,"6 de julio de 1997"
30,1,160,3719,416,364,780,"6 de julio de 1997"
30,1,160,3720,192,135,327,"6 de julio de 1997"
30,1,160,3721,243,183,426,"6 de julio de 1997"
30,1,160,3722,173,130,303,"6 de julio de 1997"
30,1,160,3723,357,315,672,"6 de julio de 1997"
30,1,160,3724,286,278,564,"6 de julio de 1997"
30,1,160,3725,468,347,815,"6 de julio de 1997"
30,1,160,3726,273,206,479,"6 de julio de 1997"
30,1,160,3727,354,300,654,"6 de julio de 1997"
30,1,160,3728,138,112,250,"6 de julio de 1997"
30,1,160,3729,530,451,981,"6 de julio de 1997"
30,1,160,3730,346,285,631,"6 de julio de 1997"
30,1,160,3731,260,224,484,"6 de julio de 1997"
30,1,160,3732,375,267,642,"6 de julio de 1997"
30,1,160,3733,124,100,224,"6 de julio de 1997"
30,1,160,3734,248,220,468,"6 de julio de 1997"
30,1,160,3735,231,201,432,"6 de julio de 1997"
30,1,207,4696,364,386,750,"6 de julio de 1997"
30,1,207,4697,456,445,901,"6 de julio de 1997"
30,1,207,4698,507,492,999,"6 de julio de 1997"
30,1,207,4699,530,572,1102,"6 de julio de 1997"
30,1,207,4700,544,517,1061,"6 de julio de 1997"
30,1,207,4701,395,389,784,"6 de julio de 1997"
30,1,207,4702,386,325,711,"6 de julio de 1997"
30,1,207,4703,391,320,711,"6 de julio de 1997"
30,1,207,4704,150,127,277,"6 de julio de 1997"
30,1,207,4705,215,180,395,"6 de julio de 1997"
30,1,207,4706,181,180,361,"6 de julio de 1997"
30,1,207,4707,405,375,780,"6 de julio de 1997"
30,1,207,4708,409,391,800,"6 de julio de 1997"
30,1,207,4709,277,255,532,"6 de julio de 1997"
30,1,207,4710,395,402,797,"6 de julio de 1997"
30,1,207,4711,335,301,636,"6 de julio de 1997"
30,2,28,482,473,495,968,"6 de julio de 1997"
30,2,28,483,305,335,640,"6 de julio de 1997"
30,2,28,484,380,410,790,"6 de julio de 1997"
30,2,28,485,322,308,630,"6 de julio de 1997"
30,2,28,486,308,333,641,"6 de julio de 1997"
30,2,28,487,326,336,662,"6 de julio de 1997"
30,2,28,488,383,399,782,"6 de julio de 1997"
30,2,28,489,336,367,703,"6 de julio de 1997"
30,2,28,490,464,461,925,"6 de julio de 1997"
30,2,28,491,352,422,774,"6 de julio de 1997"
30,2,60,1343,429,453,882,"6 de julio de 1997"
30,2,60,1344,538,675,1213,"6 de julio de 1997"
30,2,60,1345,356,417,773,"6 de julio de 1997"
30,2,60,1346,394,403,797,"6 de julio de 1997"
30,2,60,1347,529,479,1008,"6 de julio de 1997"
30,2,60,1348,265,209,474,"6 de julio de 1997"
30,2,60,1349,123,118,241,"6 de julio de 1997"
30,2,60,1350,260,237,497,"6 de julio de 1997"
30,2,60,1351,506,448,954,"6 de julio de 1997"
30,2,60,1352,561,539,1100,"6 de julio de 1997"
30,2,60,1353,399,397,796,"6 de julio de 1997"
30,2,60,1354,158,133,291,"6 de julio de 1997"
30,2,60,1355,288,228,516,"6 de julio de 1997"
30,2,60,1356,179,195,374,"6 de julio de 1997"
30,2,60,1357,231,269,500,"6 de julio de 1997"
30,2,60,1358,365,377,742,"6 de julio de 1997"
30,2,60,1359,472,441,913,"6 de julio de 1997"
30,2,60,1360,537,493,1030,"6 de julio de 1997"
30,2,60,1361,414,444,858,"6 de julio de 1997"
30,2,60,1362,360,380,740,"6 de julio de 1997"
30,2,60,1363,250,275,525,"6 de julio de 1997"
30,2,60,1364,125,138,263,"6 de julio de 1997"
30,2,60,1365,409,443,852,"6 de julio de 1997"
30,2,60,1366,447,415,862,"6 de julio de 1997"
30,2,60,1367,176,198,374,"6 de julio de 1997"
30,2,60,1368,341,292,633,"6 de julio de 1997"
30,2,60,1369,479,486,965,"6 de julio de 1997"
30,2,60,1370,223,265,488,"6 de julio de 1997"
30,2,60,1371,428,403,831,"6 de julio de 1997"
30,2,60,1372,275,233,508,"6 de julio de 1997"
30,2,60,1373,291,259,550,"6 de julio de 1997"
30,2,60,1374,299,309,608,"6 de julio de 1997"
30,2,60,1375,353,349,702,"6 de julio de 1997"
30,2,60,1376,452,490,942,"6 de julio de 1997"
30,2,60,1377,301,350,651,"6 de julio de 1997"
30,2,60,1378,396,403,799,"6 de julio de 1997"
30,2,60,1379,106,86,192,"6 de julio de 1997"
30,2,60,1380,315,299,614,"6 de julio de 1997"
30,2,60,1381,211,190,401,"6 de julio de 1997"
30,2,60,1382,188,208,396,"6 de julio de 1997"
30,2,60,1383,266,270,536,"6 de julio de 1997"
30,2,60,1384,170,195,365,"6 de julio de 1997"
30,2,60,1385,470,475,945,"6 de julio de 1997"
30,2,60,1386,133,149,282,"6 de julio de 1997"
30,2,60,1387,144,141,285,"6 de julio de 1997"
30,2,60,1388,242,278,520,"6 de julio de 1997"
30,2,60,1389,241,262,503,"6 de julio de 1997"
30,2,65,1463,339,375,714,"6 de julio de 1997"
30,2,65,1464,249,297,546,"6 de julio de 1997"
30,2,65,1465,222,202,424,"6 de julio de 1997"
30,2,65,1466,227,169,396,"6 de julio de 1997"
30,2,65,1467,574,492,1066,"6 de julio de 1997"
30,2,65,1468,493,463,956,"6 de julio de 1997"
30,2,65,1469,350,339,689,"6 de julio de 1997"
30,2,65,1470,450,384,834,"6 de julio de 1997"
30,2,65,1471,461,454,915,"6 de julio de 1997"
30,2,65,1472,600,544,1144,"6 de julio de 1997"
30,2,74,1623,436,512,948,"6 de julio de 1997"
30,2,74,1624,403,464,867,"6 de julio de 1997"
30,2,74,1625,349,416,765,"6 de julio de 1997"
30,2,74,1626,228,224,452,"6 de julio de 1997"
30,2,74,1627,196,191,387,"6 de julio de 1997"
30,2,74,1628,192,198,390,"6 de julio de 1997"
30,2,74,1629,71,55,126,"6 de julio de 1997"
30,2,74,1630,246,223,469,"6 de julio de 1997"
30,2,74,1631,83,61,144,"6 de julio de 1997"
30,2,74,1632,72,83,155,"6 de julio de 1997"
30,2,74,1633,245,209,454,"6 de julio de 1997"
30,2,74,1634,189,208,397,"6 de julio de 1997"
30,2,74,1635,166,150,316,"6 de julio de 1997"
30,2,74,1636,382,388,770,"6 de julio de 1997"
30,2,74,1637,365,359,724,"6 de julio de 1997"
30,2,74,1638,430,362,792,"6 de julio de 1997"
30,2,74,1639,153,101,254,"6 de julio de 1997"
30,2,74,1640,242,205,447,"6 de julio de 1997"
30,2,78,1688,213,217,430,"6 de julio de 1997"
30,2,78,1689,391,403,794,"6 de julio de 1997"
30,2,78,1690,103,102,205,"6 de julio de 1997"
30,2,78,1691,227,282,509,"6 de julio de 1997"
30,2,78,1692,188,213,401,"6 de julio de 1997"
30,2,78,1693,300,334,634,"6 de julio de 1997"
30,2,78,1694,325,355,680,"6 de julio de 1997"
30,2,78,1695,304,285,589,"6 de julio de 1997"
30,2,78,1696,210,193,403,"6 de julio de 1997"
30,2,78,1697,293,250,543,"6 de julio de 1997"
30,2,78,1698,59,33,92,"6 de julio de 1997"
30,2,78,1699,123,123,246,"6 de julio de 1997"
30,2,78,1700,210,203,413,"6 de julio de 1997"
30,2,80,1718,502,546,1048,"6 de julio de 1997"
30,2,80,1719,478,467,945,"6 de julio de 1997"
30,2,80,1720,516,522,1038,"6 de julio de 1997"
30,2,80,1721,289,262,551,"6 de julio de 1997"
30,2,80,1722,223,212,435,"6 de julio de 1997"
30,2,80,1723,371,373,744,"6 de julio de 1997"
30,2,80,1724,539,521,1060,"6 de julio de 1997"
30,2,80,1725,492,455,947,"6 de julio de 1997"
30,2,156,3609,277,308,585,"6 de julio de 1997"
30,2,156,3610,231,256,487,"6 de julio de 1997"
30,2,156,3611,617,721,1338,"6 de julio de 1997"
30,2,156,3612,388,442,830,"6 de julio de 1997"
30,2,156,3613,364,407,771,"6 de julio de 1997"
30,2,156,3614,609,704,1313,"6 de julio de 1997"
30,2,156,3615,572,669,1241,"6 de julio de 1997"
30,2,156,3616,251,327,578,"6 de julio de 1997"
30,2,156,3617,147,186,333,"6 de julio de 1997"
30,2,156,3618,621,714,1335,"6 de julio de 1997"
30,2,156,3619,626,714,1340,"6 de julio de 1997"
30,2,156,3620,447,542,989,"6 de julio de 1997"
30,2,156,3621,544,626,1170,"6 de julio de 1997"
30,2,156,3622,359,441,800,"6 de julio de 1997"
30,2,156,3623,299,343,642,"6 de julio de 1997"
30,2,156,3624,349,385,734,"6 de julio de 1997"
30,2,156,3625,349,284,633,"6 de julio de 1997"
30,2,156,3626,201,158,359,"6 de julio de 1997"
30,2,156,3627,145,99,244,"6 de julio de 1997"
30,2,156,3628,371,331,702,"6 de julio de 1997"
30,2,156,3629,471,445,916,"6 de julio de 1997"
30,2,156,3630,272,303,575,"6 de julio de 1997"
30,2,156,3631,473,413,886,"6 de julio de 1997"
30,2,156,3632,370,311,681,"6 de julio de 1997"
30,2,156,3633,542,500,1042,"6 de julio de 1997"
30,2,156,3634,408,381,789,"6 de julio de 1997"
30,2,156,3635,501,467,968,"6 de julio de 1997"
30,2,156,3636,689,646,1335,"6 de julio de 1997"
30,2,156,3637,479,506,985,"6 de julio de 1997"
30,2,156,3638,387,302,689,"6 de julio de 1997"
30,2,156,3639,458,441,899,"6 de julio de 1997"
30,2,156,3640,505,452,957,"6 de julio de 1997"
30,2,156,3641,423,384,807,"6 de julio de 1997"
30,2,156,3642,271,252,523,"6 de julio de 1997"
30,2,156,3643,451,443,894,"6 de julio de 1997"
30,2,156,3644,131,117,248,"6 de julio de 1997"
30,2,156,3645,427,379,806,"6 de julio de 1997"
30,2,156,3646,262,222,484,"6 de julio de 1997"
30,2,156,3647,369,347,716,"6 de julio de 1997"
30,2,156,3648,475,420,895,"6 de julio de 1997"
30,2,156,3649,222,196,418,"6 de julio de 1997"
30,2,156,3650,400,371,771,"6 de julio de 1997"
30,2,156,3651,362,364,726,"6 de julio de 1997"
30,2,156,3652,301,290,591,"6 de julio de 1997"
30,2,156,3653,256,258,514,"6 de julio de 1997"
30,2,156,3654,414,363,777,"6 de julio de 1997"
30,2,156,3655,383,355,738,"6 de julio de 1997"
30,2,156,3656,215,201,416,"6 de julio de 1997"
30,2,156,3657,446,394,840,"6 de julio de 1997"
30,2,156,3658,191,164,355,"6 de julio de 1997"
30,2,156,3659,293,276,569,"6 de julio de 1997"
30,2,156,3660,495,438,933,"6 de julio de 1997"
30,2,156,3661,602,535,1137,"6 de julio de 1997"
30,2,156,3662,131,107,238,"6 de julio de 1997"
30,2,156,3663,697,631,1328,"6 de julio de 1997"
30,2,156,3664,602,627,1229,"6 de julio de 1997"
30,2,156,3665,334,338,672,"6 de julio de 1997"
30,2,156,3666,321,301,622,"6 de julio de 1997"
30,2,156,3667,485,461,946,"6 de julio de 1997"
30,2,156,3668,298,308,606,"6 de julio de 1997"
30,2,169,3799,595,555,1150,"6 de julio de 1997"
30,2,169,3800,580,496,1076,"6 de julio de 1997"
30,2,169,3801,357,284,641,"6 de julio de 1997"
30,2,169,3802,92,67,159,"6 de julio de 1997"
30,2,169,3803,482,452,934,"6 de julio de 1997"
30,2,198,4551,420,439,859,"6 de julio de 1997"
30,2,198,4552,392,347,739,"6 de julio de 1997"
30,2,198,4553,413,406,819,"6 de julio de 1997"
30,2,198,4554,191,165,356,"6 de julio de 1997"
30,2,198,4555,204,173,377,"6 de julio de 1997"
30,2,198,4556,268,255,523,"6 de julio de 1997"
30,2,202,4598,315,316,631,"6 de julio de 1997"
30,2,202,4599,297,331,628,"6 de julio de 1997"
30,2,202,4600,237,203,440,"6 de julio de 1997"
30,2,202,4601,363,388,751,"6 de julio de 1997"
30,2,202,4602,239,236,475,"6 de julio de 1997"
30,2,202,4603,450,444,894,"6 de julio de 1997"
30,2,202,4604,368,351,719,"6 de julio de 1997"
30,2,202,4605,544,484,1028,"6 de julio de 1997"
30,3,15,320,392,441,833,"6 de julio de 1997"
30,3,15,321,507,609,1116,"6 de julio de 1997"
30,3,15,322,455,535,990,"6 de julio de 1997"
30,3,15,323,443,491,934,"6 de julio de 1997"
30,3,15,324,347,406,753,"6 de julio de 1997"
30,3,15,325,547,627,1174,"6 de julio de 1997"
30,3,15,326,304,351,655,"6 de julio de 1997"
30,3,15,327,318,372,690,"6 de julio de 1997"
30,3,15,328,681,805,1486,"6 de julio de 1997"
30,3,15,329,582,696,1278,"6 de julio de 1997"
30,3,15,330,602,705,1307,"6 de julio de 1997"
30,3,15,331,366,420,786,"6 de julio de 1997"
30,3,15,332,362,380,742,"6 de julio de 1997"
30,3,15,333,319,345,664,"6 de julio de 1997"
30,3,15,334,364,354,718,"6 de julio de 1997"
30,3,15,335,312,303,615,"6 de julio de 1997"
30,3,15,336,359,342,701,"6 de julio de 1997"
30,3,15,337,266,228,494,"6 de julio de 1997"
30,3,15,338,410,478,888,"6 de julio de 1997"
30,3,35,656,483,547,1030,"6 de julio de 1997"
30,3,35,657,487,540,1027,"6 de julio de 1997"
30,3,35,658,361,405,766,"6 de julio de 1997"
30,3,35,659,697,660,1357,"6 de julio de 1997"
30,3,35,660,311,341,652,"6 de julio de 1997"
30,3,35,661,665,655,1320,"6 de julio de 1997"
30,3,35,662,228,230,458,"6 de julio de 1997"
30,3,35,663,518,518,1036,"6 de julio de 1997"
30,3,35,664,162,167,329,"6 de julio de 1997"
30,3,35,665,287,293,580,"6 de julio de 1997"
30,3,35,666,631,622,1253,"6 de julio de 1997"
30,3,35,667,734,751,1485,"6 de julio de 1997"
30,3,35,668,379,405,784,"6 de julio de 1997"
30,3,35,669,573,576,1149,"6 de julio de 1997"
30,3,35,670,216,204,420,"6 de julio de 1997"
30,3,62,1403,289,297,586,"6 de julio de 1997"
30,3,62,1404,333,344,677,"6 de julio de 1997"
30,3,62,1405,290,319,609,"6 de julio de 1997"
30,3,62,1406,382,361,743,"6 de julio de 1997"
30,3,62,1407,185,181,366,"6 de julio de 1997"
30,3,62,1408,419,460,879,"6 de julio de 1997"
30,3,62,1409,343,345,688,"6 de julio de 1997"
30,3,62,1410,279,270,549,"6 de julio de 1997"
30,3,62,1411,408,380,788,"6 de julio de 1997"
30,3,62,1412,714,794,1508,"6 de julio de 1997"
30,3,151,3543,496,504,1000,"6 de julio de 1997"
30,3,151,3544,502,511,1013,"6 de julio de 1997"
30,3,151,3545,260,277,537,"6 de julio de 1997"
30,3,151,3546,390,363,753,"6 de julio de 1997"
30,3,151,3547,179,133,312,"6 de julio de 1997"
30,3,151,3548,349,321,670,"6 de julio de 1997"
30,3,151,3549,554,492,1046,"6 de julio de 1997"
30,3,151,3550,521,491,1012,"6 de julio de 1997"
30,3,152,3551,555,548,1103,"6 de julio de 1997"
30,3,152,3552,431,507,938,"6 de julio de 1997"
30,3,152,3553,452,482,934,"6 de julio de 1997"
30,3,152,3554,319,360,679,"6 de julio de 1997"
30,3,152,3555,196,142,338,"6 de julio de 1997"
30,3,152,3556,307,296,603,"6 de julio de 1997"
30,3,152,3557,447,358,805,"6 de julio de 1997"
30,3,152,3558,498,421,919,"6 de julio de 1997"
30,3,152,3559,292,258,550,"6 de julio de 1997"
30,3,152,3560,435,382,817,"6 de julio de 1997"
30,3,152,3561,433,376,809,"6 de julio de 1997"
30,3,152,3562,145,119,264,"6 de julio de 1997"
30,3,152,3563,458,412,870,"6 de julio de 1997"
30,3,152,3564,460,445,905,"6 de julio de 1997"
30,3,152,3565,228,200,428,"6 de julio de 1997"
30,3,152,3566,568,432,1000,"6 de julio de 1997"
30,3,152,3567,473,405,878,"6 de julio de 1997"
30,3,152,3568,793,786,1579,"6 de julio de 1997"
30,3,152,3569,333,305,638,"6 de julio de 1997"
30,3,152,3570,283,255,538,"6 de julio de 1997"
30,3,152,3571,128,112,240,"6 de julio de 1997"
30,3,155,3598,518,532,1050,"6 de julio de 1997"
30,3,155,3599,657,574,1231,"6 de julio de 1997"
30,3,155,3600,338,293,631,"6 de julio de 1997"
30,3,155,3601,312,263,575,"6 de julio de 1997"
30,3,155,3602,198,174,372,"6 de julio de 1997"
30,3,155,3603,591,522,1113,"6 de julio de 1997"
30,3,155,3604,510,479,989,"6 de julio de 1997"
30,3,155,3605,155,139,294,"6 de julio de 1997"
30,3,155,3606,250,232,482,"6 de julio de 1997"
30,3,155,3607,250,254,504,"6 de julio de 1997"
30,3,155,3608,304,348,652,"6 de julio de 1997"
30,3,188,4096,123,132,255,"6 de julio de 1997"
30,3,188,4097,707,754,1461,"6 de julio de 1997"
30,3,188,4098,145,154,299,"6 de julio de 1997"
30,3,188,4099,487,620,1107,"6 de julio de 1997"
30,3,188,4100,854,1014,1868,"6 de julio de 1997"
30,3,188,4101,716,855,1571,"6 de julio de 1997"
30,3,188,4102,505,572,1077,"6 de julio de 1997"
30,3,188,4103,715,784,1499,"6 de julio de 1997"
30,3,188,4104,722,839,1561,"6 de julio de 1997"
30,3,188,4105,595,640,1235,"6 de julio de 1997"
30,3,188,4106,450,529,979,"6 de julio de 1997"
30,3,188,4107,585,693,1278,"6 de julio de 1997"
30,3,188,4108,390,442,832,"6 de julio de 1997"
30,3,188,4109,339,432,771,"6 de julio de 1997"
30,3,188,4110,306,375,681,"6 de julio de 1997"
30,3,188,4111,337,406,743,"6 de julio de 1997"
30,3,188,4112,351,373,724,"6 de julio de 1997"
30,3,188,4113,433,554,987,"6 de julio de 1997"
30,3,188,4114,514,593,1107,"6 de julio de 1997"
30,3,188,4115,525,573,1098,"6 de julio de 1997"
30,3,188,4116,487,579,1066,"6 de julio de 1997"
30,3,188,4117,519,622,1141,"6 de julio de 1997"
30,3,188,4118,696,767,1463,"6 de julio de 1997"
30,3,188,4119,560,458,1018,"6 de julio de 1997"
30,3,188,4120,359,412,771,"6 de julio de 1997"
30,3,188,4121,363,432,795,"6 de julio de 1997"
30,3,188,4122,447,561,1008,"6 de julio de 1997"
30,3,188,4123,368,446,814,"6 de julio de 1997"
30,3,188,4124,279,342,621,"6 de julio de 1997"
30,3,188,4125,663,775,1438,"6 de julio de 1997"
30,3,188,4126,457,517,974,"6 de julio de 1997"
30,3,188,4127,407,496,903,"6 de julio de 1997"
30,3,188,4128,454,547,1001,"6 de julio de 1997"
30,3,188,4129,478,598,1076,"6 de julio de 1997"
30,3,188,4130,782,904,1686,"6 de julio de 1997"
30,3,188,4131,183,191,374,"6 de julio de 1997"
30,3,188,4132,533,631,1164,"6 de julio de 1997"
30,3,188,4133,505,524,1029,"6 de julio de 1997"
30,3,188,4134,274,287,561,"6 de julio de 1997"
30,3,188,4135,761,885,1646,"6 de julio de 1997"
30,3,188,4136,420,512,932,"6 de julio de 1997"
30,3,188,4137,435,502,937,"6 de julio de 1997"
30,3,188,4138,419,495,914,"6 de julio de 1997"
30,3,188,4139,397,471,868,"6 de julio de 1997"
30,3,188,4140,571,635,1206,"6 de julio de 1997"
30,3,188,4141,713,826,1539,"6 de julio de 1997"
30,3,188,4142,829,748,1577,"6 de julio de 1997"
30,3,188,4143,785,630,1415,"6 de julio de 1997"
30,3,188,4144,623,725,1348,"6 de julio de 1997"
30,3,188,4145,385,436,821,"6 de julio de 1997"
30,3,188,4146,498,604,1102,"6 de julio de 1997"
30,3,188,4147,330,309,639,"6 de julio de 1997"
30,3,188,4148,644,637,1281,"6 de julio de 1997"
30,3,188,4149,505,518,1023,"6 de julio de 1997"
30,3,188,4150,322,289,611,"6 de julio de 1997"
30,3,188,4151,127,104,231,"6 de julio de 1997"
30,3,188,4152,175,156,331,"6 de julio de 1997"
30,3,188,4153,542,581,1123,"6 de julio de 1997"
30,3,188,4154,732,691,1423,"6 de julio de 1997"
30,3,188,4155,764,933,1697,"6 de julio de 1997"
30,3,188,4156,636,640,1276,"6 de julio de 1997"
30,3,188,4157,464,489,953,"6 de julio de 1997"
30,3,188,4158,373,382,755,"6 de julio de 1997"
30,3,188,4159,806,870,1676,"6 de julio de 1997"
30,3,188,4160,538,504,1042,"6 de julio de 1997"
30,3,188,4161,673,685,1358,"6 de julio de 1997"
30,3,188,4162,227,195,422,"6 de julio de 1997"
30,3,188,4163,390,355,745,"6 de julio de 1997"
30,3,188,4164,506,461,967,"6 de julio de 1997"
30,3,188,4165,664,570,1234,"6 de julio de 1997"
30,3,188,4166,385,344,729,"6 de julio de 1997"
30,3,188,4167,499,528,1027,"6 de julio de 1997"
30,3,188,4168,536,445,981,"6 de julio de 1997"
30,3,188,4169,395,333,728,"6 de julio de 1997"
30,3,188,4170,403,371,774,"6 de julio de 1997"
30,4,8,109,501,559,1060,"6 de julio de 1997"
30,4,8,110,549,577,1126,"6 de julio de 1997"
30,4,8,111,495,581,1076,"6 de julio de 1997"
30,4,8,112,621,730,1351,"6 de julio de 1997"
30,4,8,113,327,383,710,"6 de julio de 1997"
30,4,8,114,682,803,1485,"6 de julio de 1997"
30,4,8,115,482,528,1010,"6 de julio de 1997"
30,4,8,116,575,569,1144,"6 de julio de 1997"
30,4,8,117,434,511,945,"6 de julio de 1997"
30,4,8,118,279,303,582,"6 de julio de 1997"
30,4,8,119,315,338,653,"6 de julio de 1997"
30,4,8,120,527,576,1103,"6 de julio de 1997"
30,4,8,121,600,599,1199,"6 de julio de 1997"
30,4,8,122,176,164,340,"6 de julio de 1997"
30,4,8,123,391,393,784,"6 de julio de 1997"
30,4,8,124,183,179,362,"6 de julio de 1997"
30,4,8,125,278,285,563,"6 de julio de 1997"
30,4,8,126,257,225,482,"6 de julio de 1997"
30,4,8,127,93,82,175,"6 de julio de 1997"
30,4,8,128,393,370,763,"6 de julio de 1997"
30,4,8,129,687,671,1358,"6 de julio de 1997"
30,4,8,130,727,688,1415,"6 de julio de 1997"
30,4,8,131,391,416,807,"6 de julio de 1997"
30,4,8,132,372,419,791,"6 de julio de 1997"
30,4,8,133,401,379,780,"6 de julio de 1997"
30,4,8,134,174,145,319,"6 de julio de 1997"
30,4,8,135,530,461,991,"6 de julio de 1997"
30,4,8,136,675,656,1331,"6 de julio de 1997"
30,4,8,137,390,347,737,"6 de julio de 1997"
30,4,8,138,217,194,411,"6 de julio de 1997"
30,4,8,139,377,322,699,"6 de julio de 1997"
30,4,8,140,590,570,1160,"6 de julio de 1997"
30,4,8,141,398,337,735,"6 de julio de 1997"
30,4,8,142,382,346,728,"6 de julio de 1997"
30,4,8,143,274,313,587,"6 de julio de 1997"
30,4,8,144,182,160,342,"6 de julio de 1997"
30,4,8,145,490,406,896,"6 de julio de 1997"
30,4,8,146,655,598,1253,"6 de julio de 1997"
30,4,8,147,577,572,1149,"6 de julio de 1997"
30,4,8,148,366,345,711,"6 de julio de 1997"
30,4,8,149,372,345,717,"6 de julio de 1997"
30,4,8,150,446,429,875,"6 de julio de 1997"
30,4,8,151,334,337,671,"6 de julio de 1997"
30,4,8,152,624,646,1270,"6 de julio de 1997"
30,4,8,153,525,486,1011,"6 de julio de 1997"
30,4,8,154,265,290,555,"6 de julio de 1997"
30,4,8,155,495,531,1026,"6 de julio de 1997"
30,4,8,156,374,325,699,"6 de julio de 1997"
30,4,8,157,555,494,1049,"6 de julio de 1997"
30,4,8,158,371,345,716,"6 de julio de 1997"
30,4,8,159,316,305,621,"6 de julio de 1997"
30,4,8,160,604,542,1146,"6 de julio de 1997"
30,4,8,161,243,273,516,"6 de julio de 1997"
30,4,8,162,748,738,1486,"6 de julio de 1997"
30,4,8,163,563,552,1115,"6 de julio de 1997"
30,4,8,164,523,486,1009,"6 de julio de 1997"
30,4,8,165,375,324,699,"6 de julio de 1997"
30,4,8,166,224,195,419,"6 de julio de 1997"
30,4,8,167,436,418,854,"6 de julio de 1997"
30,4,8,168,616,568,1184,"6 de julio de 1997"
30,4,8,169,407,370,777,"6 de julio de 1997"
30,4,8,170,329,254,583,"6 de julio de 1997"
30,4,8,171,691,647,1338,"6 de julio de 1997"
30,4,8,172,282,244,526,"6 de julio de 1997"
30,4,8,173,433,386,819,"6 de julio de 1997"
30,4,8,174,288,307,595,"6 de julio de 1997"
30,4,8,175,465,407,872,"6 de julio de 1997"
30,4,8,176,327,281,608,"6 de julio de 1997"
30,4,8,177,176,171,347,"6 de julio de 1997"
30,4,33,617,595,589,1184,"6 de julio de 1997"
30,4,33,618,381,384,765,"6 de julio de 1997"
30,4,33,619,328,320,648,"6 de julio de 1997"
30,4,33,620,330,276,606,"6 de julio de 1997"
30,4,33,621,500,445,945,"6 de julio de 1997"
30,4,33,622,198,184,382,"6 de julio de 1997"
30,4,33,623,271,231,502,"6 de julio de 1997"
30,4,33,624,504,433,937,"6 de julio de 1997"
30,4,33,625,580,492,1072,"6 de julio de 1997"
30,4,33,626,233,194,427,"6 de julio de 1997"
30,4,33,627,165,154,319,"6 de julio de 1997"
30,4,33,628,270,224,494,"6 de julio de 1997"
30,4,33,629,412,388,800,"6 de julio de 1997"
30,4,33,630,471,464,935,"6 de julio de 1997"
30,4,33,631,341,282,623,"6 de julio de 1997"
30,4,36,671,384,453,837,"6 de julio de 1997"
30,4,36,672,554,662,1216,"6 de julio de 1997"
30,4,36,673,367,433,800,"6 de julio de 1997"
30,4,36,674,321,384,705,"6 de julio de 1997"
30,4,36,675,345,427,772,"6 de julio de 1997"
30,4,36,676,278,358,636,"6 de julio de 1997"
30,4,36,677,193,257,450,"6 de julio de 1997"
30,4,36,678,356,395,751,"6 de julio de 1997"
30,4,36,679,309,391,700,"6 de julio de 1997"
30,4,36,680,596,734,1330,"6 de julio de 1997"
30,4,36,681,296,371,667,"6 de julio de 1997"
30,4,36,682,367,438,805,"6 de julio de 1997"
30,4,36,683,147,170,317,"6 de julio de 1997"
30,4,36,684,223,268,491,"6 de julio de 1997"
30,4,36,685,291,399,690,"6 de julio de 1997"
30,4,36,686,208,279,487,"6 de julio de 1997"
30,4,36,687,275,350,625,"6 de julio de 1997"
30,4,36,688,455,494,949,"6 de julio de 1997"
30,4,36,689,427,542,969,"6 de julio de 1997"
30,4,36,690,295,374,669,"6 de julio de 1997"
30,4,36,691,137,144,281,"6 de julio de 1997"
30,4,36,692,269,259,528,"6 de julio de 1997"
30,4,36,693,203,198,401,"6 de julio de 1997"
30,4,36,694,733,404,1137,"6 de julio de 1997"
30,4,37,695,369,374,743,"6 de julio de 1997"
30,4,37,696,281,316,597,"6 de julio de 1997"
30,4,37,697,487,510,997,"6 de julio de 1997"
30,4,37,698,230,263,493,"6 de julio de 1997"
30,4,37,699,231,248,479,"6 de julio de 1997"
30,4,37,700,490,455,945,"6 de julio de 1997"
30,4,37,701,320,299,619,"6 de julio de 1997"
30,4,37,702,178,179,357,"6 de julio de 1997"
30,4,37,703,330,340,670,"6 de julio de 1997"
30,4,82,1731,506,449,955,"6 de julio de 1997"
30,4,82,1732,492,522,1014,"6 de julio de 1997"
30,4,82,1733,385,425,810,"6 de julio de 1997"
30,4,82,1734,325,299,624,"6 de julio de 1997"
30,4,82,1735,383,390,773,"6 de julio de 1997"
30,4,82,1736,396,449,845,"6 de julio de 1997"
30,4,82,1737,322,302,624,"6 de julio de 1997"
30,4,82,1738,579,527,1106,"6 de julio de 1997"
30,4,82,1739,433,387,820,"6 de julio de 1997"
30,4,82,1740,358,338,696,"6 de julio de 1997"
30,4,82,1741,276,281,557,"6 de julio de 1997"
30,4,82,1742,546,645,1191,"6 de julio de 1997"
30,4,82,1743,301,321,622,"6 de julio de 1997"
30,4,82,1744,472,457,929,"6 de julio de 1997"
30,4,82,1745,306,293,599,"6 de julio de 1997"
30,4,82,1746,536,476,1012,"6 de julio de 1997"
30,4,82,1747,274,274,548,"6 de julio de 1997"
30,4,82,1748,423,419,842,"6 de julio de 1997"
30,4,82,1749,399,336,735,"6 de julio de 1997"
30,4,82,1750,389,382,771,"6 de julio de 1997"
30,4,82,1751,254,244,498,"6 de julio de 1997"
30,4,82,1752,77,54,131,"6 de julio de 1997"
30,4,82,1753,407,394,801,"6 de julio de 1997"
30,4,82,1754,376,362,738,"6 de julio de 1997"
30,4,82,1755,206,193,399,"6 de julio de 1997"
30,4,82,1756,147,110,257,"6 de julio de 1997"
30,4,82,1757,305,335,640,"6 de julio de 1997"
30,4,82,1758,249,280,529,"6 de julio de 1997"
30,4,82,1759,182,201,383,"6 de julio de 1997"
30,4,82,1760,317,325,642,"6 de julio de 1997"
30,4,82,1761,223,193,416,"6 de julio de 1997"
30,4,82,1762,240,228,468,"6 de julio de 1997"
30,4,82,1763,452,350,802,"6 de julio de 1997"
30,4,154,3591,178,181,359,"6 de julio de 1997"
30,4,154,3592,364,348,712,"6 de julio de 1997"
30,4,154,3593,68,69,137,"6 de julio de 1997"
30,4,154,3594,123,131,254,"6 de julio de 1997"
30,4,154,3595,343,374,717,"6 de julio de 1997"
30,4,154,3596,444,512,956,"6 de julio de 1997"
30,4,154,3597,254,252,506,"6 de julio de 1997"
30,4,166,3763,722,770,1492,"6 de julio de 1997"
30,4,166,3764,608,638,1246,"6 de julio de 1997"
30,4,166,3765,542,520,1062,"6 de julio de 1997"
30,4,166,3766,408,451,859,"6 de julio de 1997"
30,4,166,3767,211,209,420,"6 de julio de 1997"
30,4,166,3768,171,174,345,"6 de julio de 1997"
30,4,166,3769,246,259,505,"6 de julio de 1997"
30,4,166,3770,416,425,841,"6 de julio de 1997"
30,4,166,3771,235,247,482,"6 de julio de 1997"
30,4,179,4001,566,490,1056,"6 de julio de 1997"
30,4,179,4002,110,115,225,"6 de julio de 1997"
30,4,179,4003,535,524,1059,"6 de julio de 1997"
30,4,179,4004,285,252,537,"6 de julio de 1997"
30,4,179,4005,396,363,759,"6 de julio de 1997"
30,4,179,4006,226,171,397,"6 de julio de 1997"
30,4,179,4007,123,123,246,"6 de julio de 1997"
30,4,179,4008,141,97,238,"6 de julio de 1997"
30,4,179,4009,289,228,517,"6 de julio de 1997"
30,5,42,932,519,588,1107,"6 de julio de 1997"
30,5,42,933,952,1210,2162,"6 de julio de 1997"
30,5,42,934,455,587,1042,"6 de julio de 1997"
30,5,42,935,547,612,1159,"6 de julio de 1997"
30,5,42,936,475,581,1056,"6 de julio de 1997"
30,5,42,937,652,762,1414,"6 de julio de 1997"
30,5,42,938,712,799,1511,"6 de julio de 1997"
30,5,42,939,441,526,967,"6 de julio de 1997"
30,5,42,940,699,812,1511,"6 de julio de 1997"
30,5,42,941,448,501,949,"6 de julio de 1997"
30,5,42,942,281,314,595,"6 de julio de 1997"
30,5,42,943,714,782,1496,"6 de julio de 1997"
30,5,42,944,437,524,961,"6 de julio de 1997"
30,5,42,945,284,293,577,"6 de julio de 1997"
30,5,42,946,670,559,1229,"6 de julio de 1997"
30,5,42,947,203,202,405,"6 de julio de 1997"
30,5,42,948,214,232,446,"6 de julio de 1997"
30,5,42,949,210,206,416,"6 de julio de 1997"
30,5,42,950,101,93,194,"6 de julio de 1997"
30,5,42,951,73,71,144,"6 de julio de 1997"
30,5,42,952,516,523,1039,"6 de julio de 1997"
30,5,42,953,83,82,165,"6 de julio de 1997"
30,5,42,954,118,104,222,"6 de julio de 1997"
30,5,42,955,463,503,966,"6 de julio de 1997"
30,5,42,956,80,89,169,"6 de julio de 1997"
30,5,42,957,88,84,172,"6 de julio de 1997"
30,5,42,958,190,172,362,"6 de julio de 1997"
30,5,42,959,190,177,367,"6 de julio de 1997"
30,5,42,960,168,157,325,"6 de julio de 1997"
30,5,132,3109,583,735,1318,"6 de julio de 1997"
30,5,132,3110,424,525,949,"6 de julio de 1997"
30,5,132,3111,594,771,1365,"6 de julio de 1997"
30,5,132,3112,423,467,890,"6 de julio de 1997"
30,5,132,3113,559,632,1191,"6 de julio de 1997"
30,5,132,3114,650,760,1410,"6 de julio de 1997"
30,5,132,3115,679,839,1518,"6 de julio de 1997"
30,5,132,3116,400,477,877,"6 de julio de 1997"
30,5,132,3117,279,344,623,"6 de julio de 1997"
30,5,132,3118,445,516,961,"6 de julio de 1997"
30,5,132,3119,599,674,1273,"6 de julio de 1997"
30,5,132,3120,503,562,1065,"6 de julio de 1997"
30,5,132,3121,367,405,772,"6 de julio de 1997"
30,5,132,3122,357,417,774,"6 de julio de 1997"
30,5,132,3123,385,504,889,"6 de julio de 1997"
30,5,132,3124,679,707,1386,"6 de julio de 1997"
30,5,132,3125,635,785,1420,"6 de julio de 1997"
30,5,132,3126,275,353,628,"6 de julio de 1997"
30,5,132,3127,365,447,812,"6 de julio de 1997"
30,5,132,3128,346,397,743,"6 de julio de 1997"
30,5,132,3129,555,703,1258,"6 de julio de 1997"
30,5,132,3130,635,733,1368,"6 de julio de 1997"
30,5,132,3131,636,766,1402,"6 de julio de 1997"
30,5,132,3132,684,772,1456,"6 de julio de 1997"
30,5,132,3133,396,485,881,"6 de julio de 1997"
30,5,132,3134,344,417,761,"6 de julio de 1997"
30,5,132,3135,424,556,980,"6 de julio de 1997"
30,5,132,3136,453,531,984,"6 de julio de 1997"
30,5,132,3137,586,695,1281,"6 de julio de 1997"
30,5,132,3138,342,388,730,"6 de julio de 1997"
30,5,132,3139,551,663,1214,"6 de julio de 1997"
30,5,132,3140,602,704,1306,"6 de julio de 1997"
30,5,132,3141,323,435,758,"6 de julio de 1997"
30,5,132,3142,412,507,919,"6 de julio de 1997"
30,5,132,3143,302,378,680,"6 de julio de 1997"
30,5,132,3144,699,777,1476,"6 de julio de 1997"
30,5,132,3145,637,732,1369,"6 de julio de 1997"
30,5,132,3146,550,631,1181,"6 de julio de 1997"
30,5,132,3147,435,485,920,"6 de julio de 1997"
30,5,132,3148,335,430,765,"6 de julio de 1997"
30,5,132,3149,499,575,1074,"6 de julio de 1997"
30,5,132,3150,522,617,1139,"6 de julio de 1997"
30,5,132,3151,620,702,1322,"6 de julio de 1997"
30,5,132,3152,515,639,1154,"6 de julio de 1997"
30,5,132,3153,576,652,1228,"6 de julio de 1997"
30,5,132,3154,381,470,851,"6 de julio de 1997"
30,5,132,3155,456,531,987,"6 de julio de 1997"
30,5,132,3156,612,701,1313,"6 de julio de 1997"
30,5,132,3157,600,648,1248,"6 de julio de 1997"
30,5,132,3158,360,397,757,"6 de julio de 1997"
30,5,132,3159,708,811,1519,"6 de julio de 1997"
30,5,132,3160,468,561,1029,"6 de julio de 1997"
30,5,132,3161,419,549,968,"6 de julio de 1997"
30,5,132,3162,252,352,604,"6 de julio de 1997"
30,5,132,3163,307,371,678,"6 de julio de 1997"
30,5,132,3164,454,553,1007,"6 de julio de 1997"
30,5,132,3165,551,657,1208,"6 de julio de 1997"
30,5,132,3166,614,672,1286,"6 de julio de 1997"
30,5,132,3167,282,325,607,"6 de julio de 1997"
30,5,132,3168,556,653,1209,"6 de julio de 1997"
30,5,132,3169,617,713,1330,"6 de julio de 1997"
30,5,132,3170,700,797,1497,"6 de julio de 1997"
30,5,132,3171,629,735,1364,"6 de julio de 1997"
30,5,132,3172,618,708,1326,"6 de julio de 1997"
30,5,132,3173,377,433,810,"6 de julio de 1997"
30,5,132,3174,318,380,698,"6 de julio de 1997"
30,5,132,3175,576,681,1257,"6 de julio de 1997"
30,5,132,3176,462,598,1060,"6 de julio de 1997"
30,5,132,3177,399,397,796,"6 de julio de 1997"
30,5,132,3178,216,263,479,"6 de julio de 1997"
30,5,132,3179,337,399,736,"6 de julio de 1997"
30,5,132,3180,422,527,949,"6 de julio de 1997"
30,5,132,3181,319,377,696,"6 de julio de 1997"
30,5,132,3182,399,441,840,"6 de julio de 1997"
30,5,132,3183,391,436,827,"6 de julio de 1997"
30,5,132,3184,405,480,885,"6 de julio de 1997"
30,5,132,3185,246,280,526,"6 de julio de 1997"
30,5,132,3186,533,596,1129,"6 de julio de 1997"
30,5,132,3187,736,851,1587,"6 de julio de 1997"
30,5,132,3188,830,955,1785,"6 de julio de 1997"
30,5,132,3189,597,700,1297,"6 de julio de 1997"
30,5,132,3190,554,680,1234,"6 de julio de 1997"
30,5,132,3191,663,765,1428,"6 de julio de 1997"
30,5,132,3192,376,459,835,"6 de julio de 1997"
30,5,132,3193,378,419,797,"6 de julio de 1997"
30,5,132,3194,445,514,959,"6 de julio de 1997"
30,5,132,3195,301,352,653,"6 de julio de 1997"
30,5,132,3196,467,523,990,"6 de julio de 1997"
30,5,132,3197,531,565,1096,"6 de julio de 1997"
30,5,132,3198,669,805,1474,"6 de julio de 1997"
30,5,132,3199,500,537,1037,"6 de julio de 1997"
30,5,132,3200,632,741,1373,"6 de julio de 1997"
30,5,132,3201,385,454,839,"6 de julio de 1997"
30,5,132,3202,401,490,891,"6 de julio de 1997"
30,5,132,3203,572,659,1231,"6 de julio de 1997"
30,5,132,3204,631,743,1374,"6 de julio de 1997"
30,5,132,3205,457,522,979,"6 de julio de 1997"
30,5,132,3206,220,254,474,"6 de julio de 1997"
30,5,132,3207,705,861,1566,"6 de julio de 1997"
30,5,132,3208,544,595,1139,"6 de julio de 1997"
30,5,132,3209,318,354,672,"6 de julio de 1997"
30,5,132,3210,544,591,1135,"6 de julio de 1997"
30,5,132,3211,305,336,641,"6 de julio de 1997"
30,5,132,3212,624,799,1423,"6 de julio de 1997"
30,5,132,3213,595,629,1224,"6 de julio de 1997"
30,5,132,3214,432,546,978,"6 de julio de 1997"
30,5,132,3215,665,772,1437,"6 de julio de 1997"
30,5,132,3216,739,843,1582,"6 de julio de 1997"
30,5,132,3217,508,563,1071,"6 de julio de 1997"
30,5,132,3218,293,306,599,"6 de julio de 1997"
30,5,174,3926,521,600,1121,"6 de julio de 1997"
30,5,174,3927,346,368,714,"6 de julio de 1997"
30,5,174,3928,575,637,1212,"6 de julio de 1997"
30,5,174,3929,509,563,1072,"6 de julio de 1997"
30,5,174,3930,695,761,1456,"6 de julio de 1997"
30,5,174,3931,608,665,1273,"6 de julio de 1997"
30,5,174,3932,385,440,825,"6 de julio de 1997"
30,5,174,3933,388,376,764,"6 de julio de 1997"
30,5,174,3934,358,295,653,"6 de julio de 1997"
30,5,174,3935,511,491,1002,"6 de julio de 1997"
30,5,174,3936,303,301,604,"6 de julio de 1997"
30,5,174,3937,367,350,717,"6 de julio de 1997"
30,5,174,3938,501,472,973,"6 de julio de 1997"
30,5,174,3939,425,428,853,"6 de julio de 1997"
30,5,174,3940,462,453,915,"6 de julio de 1997"
30,5,174,3941,547,482,1029,"6 de julio de 1997"
30,5,174,3942,516,443,959,"6 de julio de 1997"
30,5,174,3943,413,436,849,"6 de julio de 1997"
30,5,174,3944,517,480,997,"6 de julio de 1997"
30,5,174,3945,521,494,1015,"6 de julio de 1997"
30,5,174,3946,555,507,1062,"6 de julio de 1997"
30,5,174,3947,219,194,413,"6 de julio de 1997"
30,5,174,3948,569,563,1132,"6 de julio de 1997"
30,5,174,3949,791,806,1597,"6 de julio de 1997"
30,5,174,3950,496,505,1001,"6 de julio de 1997"
30,5,174,3951,523,519,1042,"6 de julio de 1997"
30,5,174,3952,424,454,878,"6 de julio de 1997"
30,5,174,3953,278,272,550,"6 de julio de 1997"
30,5,174,3954,834,871,1705,"6 de julio de 1997"
30,5,174,3955,215,184,399,"6 de julio de 1997"
30,5,174,3956,304,308,612,"6 de julio de 1997"
30,5,174,3957,386,354,740,"6 de julio de 1997"
30,5,174,3958,399,424,823,"6 de julio de 1997"
30,5,174,3959,458,478,936,"6 de julio de 1997"
30,5,174,3960,369,419,788,"6 de julio de 1997"
30,5,174,3961,411,454,865,"6 de julio de 1997"
30,5,174,3962,457,498,955,"6 de julio de 1997"
30,5,174,3963,409,436,845,"6 de julio de 1997"
30,5,174,3964,552,587,1139,"6 de julio de 1997"
30,5,174,3965,480,550,1030,"6 de julio de 1997"
30,5,174,3966,421,485,906,"6 de julio de 1997"
30,5,174,3967,518,591,1109,"6 de julio de 1997"
30,5,174,3968,374,423,797,"6 de julio de 1997"
30,5,174,3969,476,520,996,"6 de julio de 1997"
30,5,174,3970,266,300,566,"6 de julio de 1997"
30,5,174,3971,626,651,1277,"6 de julio de 1997"
30,5,174,3972,577,610,1187,"6 de julio de 1997"
30,5,174,3973,739,769,1508,"6 de julio de 1997"
30,5,174,3974,416,438,854,"6 de julio de 1997"
30,6,39,709,595,568,1163,"6 de julio de 1997"
30,6,39,710,470,444,914,"6 de julio de 1997"
30,6,39,711,447,393,840,"6 de julio de 1997"
30,6,52,1266,546,566,1112,"6 de julio de 1997"
30,6,52,1267,663,634,1297,"6 de julio de 1997"
30,6,52,1268,240,246,486,"6 de julio de 1997"
30,6,52,1269,295,328,623,"6 de julio de 1997"
30,6,52,1270,247,239,486,"6 de julio de 1997"
30,6,52,1271,334,320,654,"6 de julio de 1997"
30,6,52,1272,666,645,1311,"6 de julio de 1997"
30,6,52,1273,485,456,941,"6 de julio de 1997"
30,6,52,1274,409,363,772,"6 de julio de 1997"
30,6,53,1275,548,632,1180,"6 de julio de 1997"
30,6,53,1276,504,563,1067,"6 de julio de 1997"
30,6,53,1277,523,514,1037,"6 de julio de 1997"
30,6,53,1278,354,369,723,"6 de julio de 1997"
30,6,53,1279,207,193,400,"6 de julio de 1997"
30,6,53,1280,452,389,841,"6 de julio de 1997"
30,6,53,1281,304,301,605,"6 de julio de 1997"
30,6,53,1282,475,512,987,"6 de julio de 1997"
30,6,53,1283,533,550,1083,"6 de julio de 1997"
30,6,53,1284,432,484,916,"6 de julio de 1997"
30,6,53,1285,577,590,1167,"6 de julio de 1997"
30,6,66,1473,586,566,1152,"6 de julio de 1997"
30,6,66,1474,327,337,664,"6 de julio de 1997"
30,6,68,1510,467,499,966,"6 de julio de 1997"
30,6,68,1511,299,324,623,"6 de julio de 1997"
30,6,68,1512,310,306,616,"6 de julio de 1997"
30,6,68,1513,372,338,710,"6 de julio de 1997"
30,6,68,1514,638,599,1237,"6 de julio de 1997"
30,6,68,1515,378,334,712,"6 de julio de 1997"
30,6,68,1516,440,408,848,"6 de julio de 1997"
30,6,68,1517,653,659,1312,"6 de julio de 1997"
30,6,68,1518,640,669,1309,"6 de julio de 1997"
30,6,68,1519,545,582,1127,"6 de julio de 1997"
30,6,68,1520,100,71,171,"6 de julio de 1997"
30,6,68,1521,315,297,612,"6 de julio de 1997"
30,6,68,1522,452,468,920,"6 de julio de 1997"
30,6,68,1523,553,517,1070,"6 de julio de 1997"
30,6,69,1524,456,482,938,"6 de julio de 1997"
30,6,69,1525,430,419,849,"6 de julio de 1997"
30,6,69,1526,432,471,903,"6 de julio de 1997"
30,6,69,1527,443,490,933,"6 de julio de 1997"
30,6,69,1528,322,298,620,"6 de julio de 1997"
30,6,104,2374,483,495,978,"6 de julio de 1997"
30,6,104,2375,509,520,1029,"6 de julio de 1997"
30,6,104,2376,453,455,908,"6 de julio de 1997"
30,6,104,2377,244,265,509,"6 de julio de 1997"
30,6,104,2378,442,385,827,"6 de julio de 1997"
30,6,125,2898,550,645,1195,"6 de julio de 1997"
30,6,125,2899,535,618,1153,"6 de julio de 1997"
30,6,125,2900,349,419,768,"6 de julio de 1997"
30,6,125,2901,482,587,1069,"6 de julio de 1997"
30,6,125,2902,304,316,620,"6 de julio de 1997"
30,6,125,2903,349,407,756,"6 de julio de 1997"
30,6,125,2904,452,531,983,"6 de julio de 1997"
30,6,125,2905,614,759,1373,"6 de julio de 1997"
30,6,125,2906,635,734,1369,"6 de julio de 1997"
30,6,125,2907,600,703,1303,"6 de julio de 1997"
30,6,125,2908,473,553,1026,"6 de julio de 1997"
30,6,125,2909,270,324,594,"6 de julio de 1997"
30,6,125,2910,710,806,1516,"6 de julio de 1997"
30,6,125,2911,614,744,1358,"6 de julio de 1997"
30,6,125,2912,733,857,1590,"6 de julio de 1997"
30,6,125,2913,628,703,1331,"6 de julio de 1997"
30,6,125,2914,658,760,1418,"6 de julio de 1997"
30,6,125,2915,665,781,1446,"6 de julio de 1997"
30,6,125,2916,687,835,1522,"6 de julio de 1997"
30,6,125,2917,691,848,1539,"6 de julio de 1997"
30,6,125,2918,366,461,827,"6 de julio de 1997"
30,6,125,2919,407,509,916,"6 de julio de 1997"
30,6,125,2920,743,831,1574,"6 de julio de 1997"
30,6,125,2921,624,763,1387,"6 de julio de 1997"
30,6,125,2922,283,343,626,"6 de julio de 1997"
30,6,125,2923,544,655,1199,"6 de julio de 1997"
30,6,125,2924,447,520,967,"6 de julio de 1997"
30,6,125,2925,429,510,939,"6 de julio de 1997"
30,6,125,2926,503,551,1054,"6 de julio de 1997"
30,6,125,2927,485,496,981,"6 de julio de 1997"
30,6,125,2928,482,515,997,"6 de julio de 1997"
30,6,125,2929,766,823,1589,"6 de julio de 1997"
30,6,125,2930,648,641,1289,"6 de julio de 1997"
30,6,125,2931,216,208,424,"6 de julio de 1997"
30,6,125,2932,374,411,785,"6 de julio de 1997"
30,6,125,2933,340,424,764,"6 de julio de 1997"
30,6,125,2934,431,407,838,"6 de julio de 1997"
30,6,125,2935,432,496,928,"6 de julio de 1997"
30,6,125,2936,870,942,1812,"6 de julio de 1997"
30,6,125,2937,173,230,403,"6 de julio de 1997"
30,6,125,2938,434,451,885,"6 de julio de 1997"
30,6,125,2939,314,303,617,"6 de julio de 1997"
30,6,125,2940,327,319,646,"6 de julio de 1997"
30,6,125,2941,158,164,322,"6 de julio de 1997"
30,6,125,2942,391,407,798,"6 de julio de 1997"
30,6,125,2943,422,491,913,"6 de julio de 1997"
30,6,125,2944,101,113,214,"6 de julio de 1997"
30,6,125,2945,540,536,1076,"6 de julio de 1997"
30,6,125,2946,460,497,957,"6 de julio de 1997"
30,6,125,2947,438,426,864,"6 de julio de 1997"
30,6,125,2948,387,416,803,"6 de julio de 1997"
30,6,125,2949,447,429,876,"6 de julio de 1997"
30,6,125,2950,457,496,953,"6 de julio de 1997"
30,6,125,2951,227,230,457,"6 de julio de 1997"
30,6,125,2952,453,453,906,"6 de julio de 1997"
30,6,125,2953,291,315,606,"6 de julio de 1997"
30,6,125,2954,372,343,715,"6 de julio de 1997"
30,6,125,2955,346,377,723,"6 de julio de 1997"
30,6,125,2956,865,936,1801,"6 de julio de 1997"
30,6,125,2957,678,658,1336,"6 de julio de 1997"
30,6,125,2958,353,321,674,"6 de julio de 1997"
30,6,125,2959,492,478,970,"6 de julio de 1997"
30,6,125,2960,398,438,836,"6 de julio de 1997"
30,6,125,2961,293,315,608,"6 de julio de 1997"
30,6,125,2962,295,277,572,"6 de julio de 1997"
30,6,125,2963,240,207,447,"6 de julio de 1997"
30,6,125,2964,526,519,1045,"6 de julio de 1997"
30,6,125,2965,486,442,928,"6 de julio de 1997"
30,6,125,2966,384,434,818,"6 de julio de 1997"
30,6,125,2967,507,577,1084,"6 de julio de 1997"
30,6,125,2968,377,435,812,"6 de julio de 1997"
30,6,125,2969,384,381,765,"6 de julio de 1997"
30,6,125,2970,351,341,692,"6 de julio de 1997"
30,6,125,2971,661,660,1321,"6 de julio de 1997"
30,6,125,2972,464,428,892,"6 de julio de 1997"
30,6,125,2973,224,176,400,"6 de julio de 1997"
30,6,125,2974,319,293,612,"6 de julio de 1997"
30,6,125,2975,251,242,493,"6 de julio de 1997"
30,6,125,2976,427,376,803,"6 de julio de 1997"
30,6,125,2977,389,368,757,"6 de julio de 1997"
30,6,125,2978,317,319,636,"6 de julio de 1997"
30,6,125,2979,442,440,882,"6 de julio de 1997"
30,6,125,2980,485,430,915,"6 de julio de 1997"
30,6,125,2981,208,184,392,"6 de julio de 1997"
30,6,125,2982,611,529,1140,"6 de julio de 1997"
30,6,125,2983,448,394,842,"6 de julio de 1997"
30,6,125,2984,361,380,741,"6 de julio de 1997"
30,6,125,2985,539,558,1097,"6 de julio de 1997"
30,6,125,2986,517,489,1006,"6 de julio de 1997"
30,6,125,2987,529,471,1000,"6 de julio de 1997"
30,6,125,2988,605,499,1104,"6 de julio de 1997"
30,6,125,2989,555,467,1022,"6 de julio de 1997"
30,6,203,4606,461,438,899,"6 de julio de 1997"
30,6,203,4607,329,332,661,"6 de julio de 1997"
30,6,203,4608,420,370,790,"6 de julio de 1997"
30,6,203,4609,541,502,1043,"6 de julio de 1997"
30,6,203,4610,171,177,348,"6 de julio de 1997"
30,6,203,4611,413,375,788,"6 de julio de 1997"
30,6,203,4612,162,162,324,"6 de julio de 1997"
30,6,203,4613,580,576,1156,"6 de julio de 1997"
30,7,24,425,244,267,511,"6 de julio de 1997"
30,7,24,426,247,268,515,"6 de julio de 1997"
30,7,24,427,631,562,1193,"6 de julio de 1997"
30,7,24,428,506,549,1055,"6 de julio de 1997"
30,7,24,429,393,355,748,"6 de julio de 1997"
30,7,24,430,248,182,430,"6 de julio de 1997"
30,7,24,431,308,255,563,"6 de julio de 1997"
30,7,24,432,464,351,815,"6 de julio de 1997"
30,7,24,433,634,524,1158,"6 de julio de 1997"
30,7,24,434,642,503,1145,"6 de julio de 1997"
30,7,24,435,430,419,849,"6 de julio de 1997"
30,7,24,436,343,282,625,"6 de julio de 1997"
30,7,24,437,481,410,891,"6 de julio de 1997"
30,7,24,438,370,295,665,"6 de julio de 1997"
30,7,24,439,244,236,480,"6 de julio de 1997"
30,7,24,440,382,331,713,"6 de julio de 1997"
30,7,24,441,254,222,476,"6 de julio de 1997"
30,7,24,442,315,268,583,"6 de julio de 1997"
30,7,24,443,291,252,543,"6 de julio de 1997"
30,7,24,444,218,199,417,"6 de julio de 1997"
30,7,24,445,355,301,656,"6 de julio de 1997"
30,7,24,446,329,320,649,"6 de julio de 1997"
30,7,24,447,250,301,551,"6 de julio de 1997"
30,7,24,448,291,235,526,"6 de julio de 1997"
30,7,24,449,223,186,409,"6 de julio de 1997"
30,7,24,450,715,585,1300,"6 de julio de 1997"
30,7,24,451,385,307,692,"6 de julio de 1997"
30,7,24,452,469,382,851,"6 de julio de 1997"
30,7,24,453,183,144,327,"6 de julio de 1997"
30,7,24,454,252,206,458,"6 de julio de 1997"
30,7,24,455,507,491,998,"6 de julio de 1997"
30,7,24,456,111,109,220,"6 de julio de 1997"
30,7,24,457,388,299,687,"6 de julio de 1997"
30,7,24,458,162,138,300,"6 de julio de 1997"
30,7,71,1556,474,544,1018,"6 de julio de 1997"
30,7,71,1557,356,403,759,"6 de julio de 1997"
30,7,71,1558,296,355,651,"6 de julio de 1997"
30,7,71,1559,287,358,645,"6 de julio de 1997"
30,7,71,1560,259,331,590,"6 de julio de 1997"
30,7,71,1561,347,453,800,"6 de julio de 1997"
30,7,71,1562,457,496,953,"6 de julio de 1997"
30,7,71,1563,399,471,870,"6 de julio de 1997"
30,7,71,1564,589,719,1308,"6 de julio de 1997"
30,7,71,1565,691,786,1477,"6 de julio de 1997"
30,7,71,1566,298,387,685,"6 de julio de 1997"
30,7,71,1567,334,268,602,"6 de julio de 1997"
30,7,71,1568,159,155,314,"6 de julio de 1997"
30,7,71,1569,341,310,651,"6 de julio de 1997"
30,7,71,1570,421,388,809,"6 de julio de 1997"
30,7,71,1571,280,259,539,"6 de julio de 1997"
30,7,71,1572,267,216,483,"6 de julio de 1997"
30,7,71,1573,601,564,1165,"6 de julio de 1997"
30,7,71,1574,377,383,760,"6 de julio de 1997"
30,7,71,1575,436,462,898,"6 de julio de 1997"
30,7,71,1576,221,235,456,"6 de julio de 1997"
30,7,71,1577,364,363,727,"6 de julio de 1997"
30,7,71,1578,297,304,601,"6 de julio de 1997"
30,7,103,2281,515,545,1060,"6 de julio de 1997"
30,7,103,2282,283,289,572,"6 de julio de 1997"
30,7,103,2283,394,440,834,"6 de julio de 1997"
30,7,103,2284,554,573,1127,"6 de julio de 1997"
30,7,103,2285,547,673,1220,"6 de julio de 1997"
30,7,103,2286,1159,1216,2375,"6 de julio de 1997"
30,7,103,2287,378,412,790,"6 de julio de 1997"
30,7,103,2288,430,471,901,"6 de julio de 1997"
30,7,103,2289,321,343,664,"6 de julio de 1997"
30,7,103,2290,547,580,1127,"6 de julio de 1997"
30,7,103,2291,334,412,746,"6 de julio de 1997"
30,7,103,2292,394,449,843,"6 de julio de 1997"
30,7,103,2293,1084,736,1820,"6 de julio de 1997"
30,7,103,2294,307,333,640,"6 de julio de 1997"
30,7,103,2295,283,306,589,"6 de julio de 1997"
30,7,103,2296,519,535,1054,"6 de julio de 1997"
30,7,103,2297,571,710,1281,"6 de julio de 1997"
30,7,103,2298,547,678,1225,"6 de julio de 1997"
30,7,103,2299,301,344,645,"6 de julio de 1997"
30,7,103,2300,442,482,924,"6 de julio de 1997"
30,7,103,2301,460,460,920,"6 de julio de 1997"
30,7,103,2302,343,387,730,"6 de julio de 1997"
30,7,103,2303,346,426,772,"6 de julio de 1997"
30,7,103,2304,437,485,922,"6 de julio de 1997"
30,7,103,2305,559,699,1258,"6 de julio de 1997"
30,7,103,2306,292,373,665,"6 de julio de 1997"
30,7,103,2307,424,502,926,"6 de julio de 1997"
30,7,103,2308,558,683,1241,"6 de julio de 1997"
30,7,103,2309,431,496,927,"6 de julio de 1997"
30,7,103,2310,429,527,956,"6 de julio de 1997"
30,7,103,2311,497,656,1153,"6 de julio de 1997"
30,7,103,2312,445,497,942,"6 de julio de 1997"
30,7,103,2313,343,386,729,"6 de julio de 1997"
30,7,103,2314,354,370,724,"6 de julio de 1997"
30,7,103,2315,375,443,818,"6 de julio de 1997"
30,7,103,2316,702,791,1493,"6 de julio de 1997"
30,7,103,2317,140,111,251,"6 de julio de 1997"
30,7,103,2318,68,66,134,"6 de julio de 1997"
30,7,103,2319,272,267,539,"6 de julio de 1997"
30,7,103,2320,51,44,95,"6 de julio de 1997"
30,7,103,2321,175,151,326,"6 de julio de 1997"
30,7,103,2322,86,76,162,"6 de julio de 1997"
30,7,103,2323,176,158,334,"6 de julio de 1997"
30,7,103,2324,25,23,48,"6 de julio de 1997"
30,7,103,2325,261,223,484,"6 de julio de 1997"
30,7,103,2326,434,374,808,"6 de julio de 1997"
30,7,103,2327,299,245,544,"6 de julio de 1997"
30,7,103,2328,50,48,98,"6 de julio de 1997"
30,7,103,2329,182,154,336,"6 de julio de 1997"
30,7,103,2330,29,24,53,"6 de julio de 1997"
30,7,103,2331,346,318,664,"6 de julio de 1997"
30,7,103,2332,402,389,791,"6 de julio de 1997"
30,7,103,2333,115,104,219,"6 de julio de 1997"
30,7,103,2334,236,220,456,"6 de julio de 1997"
30,7,103,2335,164,133,297,"6 de julio de 1997"
30,7,103,2336,225,221,446,"6 de julio de 1997"
30,7,103,2337,158,131,289,"6 de julio de 1997"
30,7,103,2338,345,360,705,"6 de julio de 1997"
30,7,103,2339,700,700,1400,"6 de julio de 1997"
30,7,103,2340,462,472,934,"6 de julio de 1997"
30,7,103,2341,682,740,1422,"6 de julio de 1997"
30,7,103,2342,415,477,892,"6 de julio de 1997"
30,7,103,2343,484,521,1005,"6 de julio de 1997"
30,7,103,2344,379,436,815,"6 de julio de 1997"
30,7,103,2345,160,159,319,"6 de julio de 1997"
30,7,103,2346,73,71,144,"6 de julio de 1997"
30,7,103,2347,596,549,1145,"6 de julio de 1997"
30,7,103,2348,368,326,694,"6 de julio de 1997"
30,7,103,2349,349,357,706,"6 de julio de 1997"
30,7,103,2350,42,50,92,"6 de julio de 1997"
30,7,103,2351,254,259,513,"6 de julio de 1997"
30,7,103,2352,399,459,858,"6 de julio de 1997"
30,7,103,2353,348,323,671,"6 de julio de 1997"
30,7,103,2354,389,415,804,"6 de julio de 1997"
30,7,103,2355,313,306,619,"6 de julio de 1997"
30,7,103,2356,421,436,857,"6 de julio de 1997"
30,7,103,2357,384,436,820,"6 de julio de 1997"
30,7,103,2358,464,498,962,"6 de julio de 1997"
30,7,103,2359,540,513,1053,"6 de julio de 1997"
30,7,103,2360,662,705,1367,"6 de julio de 1997"
30,7,103,2361,194,172,366,"6 de julio de 1997"
30,7,103,2362,106,77,183,"6 de julio de 1997"
30,7,103,2363,482,474,956,"6 de julio de 1997"
30,7,103,2364,243,224,467,"6 de julio de 1997"
30,7,103,2365,194,183,377,"6 de julio de 1997"
30,7,103,2366,234,258,492,"6 de julio de 1997"
30,7,103,2367,396,397,793,"6 de julio de 1997"
30,7,103,2368,262,250,512,"6 de julio de 1997"
30,7,103,2369,139,127,266,"6 de julio de 1997"
30,7,103,2370,119,104,223,"6 de julio de 1997"
30,7,103,2371,170,158,328,"6 de julio de 1997"
30,7,103,2372,231,179,410,"6 de julio de 1997"
30,7,103,2373,158,122,280,"6 de julio de 1997"
30,7,115,2610,398,406,804,"6 de julio de 1997"
30,7,115,2611,382,444,826,"6 de julio de 1997"
30,7,115,2612,239,250,489,"6 de julio de 1997"
30,7,115,2613,407,362,769,"6 de julio de 1997"
30,7,115,2614,395,403,798,"6 de julio de 1997"
30,7,115,2615,64,61,125,"6 de julio de 1997"
30,7,115,2616,121,105,226,"6 de julio de 1997"
30,7,115,2617,428,343,771,"6 de julio de 1997"
30,7,115,2618,288,221,509,"6 de julio de 1997"
30,7,115,2619,194,162,356,"6 de julio de 1997"
30,7,115,2620,292,291,583,"6 de julio de 1997"
30,7,158,3673,100,107,207,"6 de julio de 1997"
30,7,158,3674,339,368,707,"6 de julio de 1997"
30,7,158,3675,666,701,1367,"6 de julio de 1997"
30,7,158,3676,233,202,435,"6 de julio de 1997"
30,7,158,3677,485,476,961,"6 de julio de 1997"
30,7,158,3678,40,46,86,"6 de julio de 1997"
30,7,158,3679,43,29,72,"6 de julio de 1997"
30,7,158,3680,268,255,523,"6 de julio de 1997"
30,7,158,3681,176,190,366,"6 de julio de 1997"
30,7,158,3682,195,185,380,"6 de julio de 1997"
30,7,158,3683,554,441,995,"6 de julio de 1997"
30,7,158,3684,131,124,255,"6 de julio de 1997"
30,7,158,3685,28,29,57,"6 de julio de 1997"
30,7,158,3686,292,314,606,"6 de julio de 1997"
30,7,158,3687,277,305,582,"6 de julio de 1997"
30,7,158,3688,812,758,1570,"6 de julio de 1997"
30,7,158,3689,33,28,61,"6 de julio de 1997"
30,7,158,3690,471,452,923,"6 de julio de 1997"
30,7,158,3691,252,217,469,"6 de julio de 1997"
30,7,158,3692,431,364,795,"6 de julio de 1997"
30,7,158,3693,177,136,313,"6 de julio de 1997"
30,7,158,3694,360,290,650,"6 de julio de 1997"
30,7,158,3695,229,260,489,"6 de julio de 1997"
30,7,158,3696,200,232,432,"6 de julio de 1997"
30,7,158,3697,30,30,60,"6 de julio de 1997"
30,7,158,3698,682,737,1419,"6 de julio de 1997"
30,7,182,4042,500,534,1034,"6 de julio de 1997"
30,7,182,4043,622,630,1252,"6 de julio de 1997"
30,7,182,4044,293,302,595,"6 de julio de 1997"
30,7,182,4045,587,664,1251,"6 de julio de 1997"
30,7,182,4046,472,502,974,"6 de julio de 1997"
30,7,182,4047,442,514,956,"6 de julio de 1997"
30,7,182,4048,438,542,980,"6 de julio de 1997"
30,7,182,4049,302,344,646,"6 de julio de 1997"
30,7,182,4050,428,464,892,"6 de julio de 1997"
30,7,182,4051,567,575,1142,"6 de julio de 1997"
30,7,182,4052,534,580,1114,"6 de julio de 1997"
30,7,182,4053,411,442,853,"6 de julio de 1997"
30,7,182,4054,463,539,1002,"6 de julio de 1997"
30,7,182,4055,605,674,1279,"6 de julio de 1997"
30,7,182,4056,649,729,1378,"6 de julio de 1997"
30,7,182,4057,457,498,955,"6 de julio de 1997"
30,7,182,4058,59,54,113,"6 de julio de 1997"
30,7,182,4059,133,98,231,"6 de julio de 1997"
30,7,182,4060,234,221,455,"6 de julio de 1997"
30,7,182,4061,456,476,932,"6 de julio de 1997"
30,7,182,4062,670,711,1381,"6 de julio de 1997"
30,7,182,4063,733,712,1445,"6 de julio de 1997"
30,7,182,4064,619,623,1242,"6 de julio de 1997"
30,7,182,4065,136,86,222,"6 de julio de 1997"
30,7,182,4066,587,557,1144,"6 de julio de 1997"
30,7,182,4067,341,347,688,"6 de julio de 1997"
30,7,182,4068,56,51,107,"6 de julio de 1997"
30,7,182,4069,281,219,500,"6 de julio de 1997"
30,7,182,4070,128,132,260,"6 de julio de 1997"
30,7,182,4071,511,515,1026,"6 de julio de 1997"
30,7,182,4072,125,126,251,"6 de julio de 1997"
30,7,182,4073,480,427,907,"6 de julio de 1997"
30,7,191,4196,462,465,927,"6 de julio de 1997"
30,7,191,4197,562,614,1176,"6 de julio de 1997"
30,7,191,4198,372,327,699,"6 de julio de 1997"
30,7,191,4199,589,607,1196,"6 de julio de 1997"
30,7,191,4200,210,209,419,"6 de julio de 1997"
30,7,191,4201,217,184,401,"6 de julio de 1997"
30,7,191,4202,376,375,751,"6 de julio de 1997"
30,7,191,4203,120,89,209,"6 de julio de 1997"
30,7,191,4204,129,116,245,"6 de julio de 1997"
30,7,191,4205,200,179,379,"6 de julio de 1997"
30,7,191,4206,131,105,236,"6 de julio de 1997"
30,7,191,4207,170,148,318,"6 de julio de 1997"
30,7,191,4208,365,357,722,"6 de julio de 1997"
30,7,191,4209,376,393,769,"6 de julio de 1997"
30,7,191,4210,204,232,436,"6 de julio de 1997"
30,7,191,4211,440,437,877,"6 de julio de 1997"
30,7,191,4212,409,377,786,"6 de julio de 1997"
30,7,191,4213,81,63,144,"6 de julio de 1997"
30,7,191,4214,182,169,351,"6 de julio de 1997"
30,7,191,4215,150,105,255,"6 de julio de 1997"
30,7,191,4216,149,116,265,"6 de julio de 1997"
30,8,2,5,383,427,810,"6 de julio de 1997"
30,8,2,6,417,426,843,"6 de julio de 1997"
30,8,4,47,500,481,981,"6 de julio de 1997"
30,8,4,48,441,466,907,"6 de julio de 1997"
30,8,4,49,504,476,980,"6 de julio de 1997"
30,8,4,50,416,372,788,"6 de julio de 1997"
30,8,4,51,635,588,1223,"6 de julio de 1997"
30,8,4,52,792,790,1582,"6 de julio de 1997"
30,8,4,53,454,415,869,"6 de julio de 1997"
30,8,4,54,152,112,264,"6 de julio de 1997"
30,8,4,55,327,280,607,"6 de julio de 1997"
30,8,4,56,263,242,505,"6 de julio de 1997"
30,8,4,57,367,349,716,"6 de julio de 1997"
30,8,4,58,178,176,354,"6 de julio de 1997"
30,8,4,59,179,207,386,"6 de julio de 1997"
30,8,4,60,358,370,728,"6 de julio de 1997"
30,8,4,61,438,455,893,"6 de julio de 1997"
30,8,4,62,275,245,520,"6 de julio de 1997"
30,8,4,63,402,390,792,"6 de julio de 1997"
30,8,4,64,119,98,217,"6 de julio de 1997"
30,8,4,65,288,258,546,"6 de julio de 1997"
30,8,4,66,290,240,530,"6 de julio de 1997"
30,8,4,67,349,319,668,"6 de julio de 1997"
30,8,4,68,419,372,791,"6 de julio de 1997"
30,8,4,69,507,452,959,"6 de julio de 1997"
30,8,4,70,430,347,777,"6 de julio de 1997"
30,8,4,71,340,315,655,"6 de julio de 1997"
30,8,4,72,283,250,533,"6 de julio de 1997"
30,8,4,73,222,243,465,"6 de julio de 1997"
30,8,4,74,352,363,715,"6 de julio de 1997"
30,8,4,75,350,358,708,"6 de julio de 1997"
30,8,4,76,599,596,1195,"6 de julio de 1997"
30,8,4,77,356,308,664,"6 de julio de 1997"
30,8,4,78,149,146,295,"6 de julio de 1997"
30,8,4,79,221,146,367,"6 de julio de 1997"
30,8,4,80,108,92,200,"6 de julio de 1997"
30,8,4,81,157,132,289,"6 de julio de 1997"
30,8,4,82,57,53,110,"6 de julio de 1997"
30,8,4,83,322,316,638,"6 de julio de 1997"
30,8,4,84,519,489,1008,"6 de julio de 1997"
30,8,10,183,358,326,684,"6 de julio de 1997"
30,8,10,184,470,432,902,"6 de julio de 1997"
30,8,10,185,237,246,483,"6 de julio de 1997"
30,8,10,186,472,426,898,"6 de julio de 1997"
30,8,10,187,270,205,475,"6 de julio de 1997"
30,8,10,188,127,101,228,"6 de julio de 1997"
30,8,10,189,76,76,152,"6 de julio de 1997"
30,8,10,190,142,103,245,"6 de julio de 1997"
30,8,10,191,171,163,334,"6 de julio de 1997"
30,8,10,192,295,295,590,"6 de julio de 1997"
30,8,10,193,151,150,301,"6 de julio de 1997"
30,8,10,194,152,131,283,"6 de julio de 1997"
30,8,10,195,24,5,29,"6 de julio de 1997"
30,8,10,196,8,0,8,"6 de julio de 1997"
30,8,10,197,481,481,962,"6 de julio de 1997"
30,8,10,198,240,244,484,"6 de julio de 1997"
30,8,10,199,140,121,261,"6 de julio de 1997"
30,8,10,200,253,219,472,"6 de julio de 1997"
30,8,10,201,162,153,315,"6 de julio de 1997"
30,8,10,202,463,379,842,"6 de julio de 1997"
30,8,10,203,116,93,209,"6 de julio de 1997"
30,8,10,204,212,171,383,"6 de julio de 1997"
30,8,10,205,66,60,126,"6 de julio de 1997"
30,8,10,206,346,294,640,"6 de julio de 1997"
30,8,10,207,271,186,457,"6 de julio de 1997"
30,8,10,208,239,203,442,"6 de julio de 1997"
30,8,10,209,258,190,448,"6 de julio de 1997"
30,8,10,210,226,196,422,"6 de julio de 1997"
30,8,10,211,363,344,707,"6 de julio de 1997"
30,8,10,212,316,311,627,"6 de julio de 1997"
30,8,10,213,171,173,344,"6 de julio de 1997"
30,8,10,214,199,171,370,"6 de julio de 1997"
30,8,10,215,497,445,942,"6 de julio de 1997"
30,8,10,216,433,303,736,"6 de julio de 1997"
30,8,10,217,341,288,629,"6 de julio de 1997"
30,8,38,704,461,494,955,"6 de julio de 1997"
30,8,38,705,590,631,1221,"6 de julio de 1997"
30,8,38,706,230,197,427,"6 de julio de 1997"
30,8,38,707,227,223,450,"6 de julio de 1997"
30,8,38,708,149,132,281,"6 de julio de 1997"
30,8,44,963,485,506,991,"6 de julio de 1997"
30,8,44,964,430,417,847,"6 de julio de 1997"
30,8,44,965,272,211,483,"6 de julio de 1997"
30,8,44,966,41,26,67,"6 de julio de 1997"
30,8,44,967,209,168,377,"6 de julio de 1997"
30,8,44,968,131,117,248,"6 de julio de 1997"
30,8,44,969,296,256,552,"6 de julio de 1997"
30,8,59,1335,593,524,1117,"6 de julio de 1997"
30,8,59,1336,548,580,1128,"6 de julio de 1997"
30,8,59,1337,421,315,736,"6 de julio de 1997"
30,8,59,1338,288,221,509,"6 de julio de 1997"
30,8,59,1339,276,235,511,"6 de julio de 1997"
30,8,59,1340,440,398,838,"6 de julio de 1997"
30,8,59,1341,180,179,359,"6 de julio de 1997"
30,8,59,1342,390,353,743,"6 de julio de 1997"
30,8,94,2170,456,553,1009,"6 de julio de 1997"
30,8,94,2171,394,420,814,"6 de julio de 1997"
30,8,94,2172,307,296,603,"6 de julio de 1997"
30,8,94,2173,176,179,355,"6 de julio de 1997"
30,8,94,2174,546,593,1139,"6 de julio de 1997"
30,8,94,2175,496,544,1040,"6 de julio de 1997"
30,8,94,2176,569,561,1130,"6 de julio de 1997"
30,8,94,2177,232,212,444,"6 de julio de 1997"
30,8,94,2178,340,316,656,"6 de julio de 1997"
30,8,96,2201,468,513,981,"6 de julio de 1997"
30,8,96,2202,446,444,890,"6 de julio de 1997"
30,8,96,2203,293,211,504,"6 de julio de 1997"
30,8,96,2204,282,242,524,"6 de julio de 1997"
30,8,96,2205,207,185,392,"6 de julio de 1997"
30,8,96,2206,435,283,718,"6 de julio de 1997"
30,8,96,2207,201,153,354,"6 de julio de 1997"
30,8,96,2208,238,205,443,"6 de julio de 1997"
30,8,96,2209,442,347,789,"6 de julio de 1997"
30,8,96,2210,229,199,428,"6 de julio de 1997"
30,8,96,2211,198,160,358,"6 de julio de 1997"
30,8,96,2212,214,242,456,"6 de julio de 1997"
30,8,96,2213,314,258,572,"6 de julio de 1997"
30,8,96,2214,175,128,303,"6 de julio de 1997"
30,8,96,2215,250,220,470,"6 de julio de 1997"
30,8,96,2216,237,199,436,"6 de julio de 1997"
30,8,96,2217,221,203,424,"6 de julio de 1997"
30,8,96,2218,156,120,276,"6 de julio de 1997"
30,8,97,2219,182,252,434,"6 de julio de 1997"
30,8,97,2220,264,301,565,"6 de julio de 1997"
30,8,107,2415,286,335,621,"6 de julio de 1997"
30,8,107,2416,436,491,927,"6 de julio de 1997"
30,8,107,2417,225,202,427,"6 de julio de 1997"
30,8,110,2526,451,480,931,"6 de julio de 1997"
30,8,110,2527,374,426,800,"6 de julio de 1997"
30,8,110,2528,548,607,1155,"6 de julio de 1997"
30,8,110,2529,469,569,1038,"6 de julio de 1997"
30,8,110,2530,481,447,928,"6 de julio de 1997"
30,8,110,2531,476,562,1038,"6 de julio de 1997"
30,8,110,2532,402,457,859,"6 de julio de 1997"
30,8,110,2533,376,476,852,"6 de julio de 1997"
30,8,110,2534,331,346,677,"6 de julio de 1997"
30,8,110,2535,620,715,1335,"6 de julio de 1997"
30,8,110,2536,708,762,1470,"6 de julio de 1997"
30,8,110,2537,237,263,500,"6 de julio de 1997"
30,8,110,2538,624,648,1272,"6 de julio de 1997"
30,8,110,2539,216,258,474,"6 de julio de 1997"
30,8,110,2540,347,297,644,"6 de julio de 1997"
30,8,110,2541,307,283,590,"6 de julio de 1997"
30,8,110,2542,384,359,743,"6 de julio de 1997"
30,8,110,2543,433,412,845,"6 de julio de 1997"
30,8,110,2544,236,243,479,"6 de julio de 1997"
30,8,110,2545,643,575,1218,"6 de julio de 1997"
30,8,110,2546,432,397,829,"6 de julio de 1997"
30,8,110,2547,411,408,819,"6 de julio de 1997"
30,8,110,2548,311,309,620,"6 de julio de 1997"
30,8,110,2549,437,380,817,"6 de julio de 1997"
30,8,110,2550,267,258,525,"6 de julio de 1997"
30,8,110,2551,251,260,511,"6 de julio de 1997"
30,8,110,2552,196,157,353,"6 de julio de 1997"
30,8,110,2553,229,192,421,"6 de julio de 1997"
30,8,110,2554,270,220,490,"6 de julio de 1997"
30,8,110,2555,483,407,890,"6 de julio de 1997"
30,8,110,2556,199,169,368,"6 de julio de 1997"
30,8,110,2557,316,319,635,"6 de julio de 1997"
30,8,110,2558,365,315,680,"6 de julio de 1997"
30,8,110,2559,319,320,639,"6 de julio de 1997"
30,8,110,2560,82,71,153,"6 de julio de 1997"
30,8,110,2561,290,259,549,"6 de julio de 1997"
30,8,110,2562,169,128,297,"6 de julio de 1997"
30,8,110,2563,409,386,795,"6 de julio de 1997"
30,8,110,2564,263,242,505,"6 de julio de 1997"
30,8,110,2565,288,279,567,"6 de julio de 1997"
30,8,110,2566,333,279,612,"6 de julio de 1997"
30,8,110,2567,253,255,508,"6 de julio de 1997"
30,8,110,2568,303,275,578,"6 de julio de 1997"
30,8,110,2569,328,316,644,"6 de julio de 1997"
30,8,110,2570,280,286,566,"6 de julio de 1997"
30,8,110,2571,380,372,752,"6 de julio de 1997"
30,8,110,2572,142,124,266,"6 de julio de 1997"
30,8,110,2573,356,349,705,"6 de julio de 1997"
30,8,110,2574,138,132,270,"6 de julio de 1997"
30,8,110,2575,308,295,603,"6 de julio de 1997"
30,8,110,2576,322,315,637,"6 de julio de 1997"
30,8,110,2577,304,260,564,"6 de julio de 1997"
30,8,113,2594,470,516,986,"6 de julio de 1997"
30,8,113,2595,413,430,843,"6 de julio de 1997"
30,8,113,2596,479,503,982,"6 de julio de 1997"
30,8,113,2597,402,451,853,"6 de julio de 1997"
30,8,113,2598,363,388,751,"6 de julio de 1997"
30,8,113,2599,295,306,601,"6 de julio de 1997"
30,8,113,2600,131,134,265,"6 de julio de 1997"
30,8,113,2601,405,409,814,"6 de julio de 1997"
30,8,113,2602,275,223,498,"6 de julio de 1997"
30,8,113,2603,571,562,1133,"6 de julio de 1997"
30,8,113,2604,339,304,643,"6 de julio de 1997"
30,8,113,2605,474,422,896,"6 de julio de 1997"
30,8,113,2606,270,268,538,"6 de julio de 1997"
30,8,162,3739,377,408,785,"6 de julio de 1997"
30,8,162,3740,331,323,654,"6 de julio de 1997"
30,8,162,3741,120,84,204,"6 de julio de 1997"
30,8,162,3742,430,387,817,"6 de julio de 1997"
30,8,162,3743,96,98,194,"6 de julio de 1997"
30,8,162,3744,27,31,58,"6 de julio de 1997"
30,8,165,3757,784,680,1464,"6 de julio de 1997"
30,8,165,3758,187,130,317,"6 de julio de 1997"
30,8,165,3759,481,374,855,"6 de julio de 1997"
30,8,165,3760,264,229,493,"6 de julio de 1997"
30,8,165,3761,546,501,1047,"6 de julio de 1997"
30,8,165,3762,271,228,499,"6 de julio de 1997"
30,8,186,4083,291,338,629,"6 de julio de 1997"
30,8,186,4084,475,436,911,"6 de julio de 1997"
30,8,186,4085,275,262,537,"6 de julio de 1997"
30,8,197,4541,560,551,1111,"6 de julio de 1997"
30,8,197,4542,252,274,526,"6 de julio de 1997"
30,8,197,4543,339,381,720,"6 de julio de 1997"
30,8,197,4544,230,208,438,"6 de julio de 1997"
30,8,197,4545,340,319,659,"6 de julio de 1997"
30,8,197,4546,543,537,1080,"6 de julio de 1997"
30,8,197,4547,455,399,854,"6 de julio de 1997"
30,8,197,4548,139,83,222,"6 de julio de 1997"
30,8,197,4549,248,210,458,"6 de julio de 1997"
30,8,197,4550,481,413,894,"6 de julio de 1997"
30,9,1,1,633,573,1206,"6 de julio de 1997"
30,9,1,2,427,399,826,"6 de julio de 1997"
30,9,1,3,560,476,1036,"6 de julio de 1997"
30,9,1,4,305,174,479,"6 de julio de 1997"
30,9,11,218,577,672,1249,"6 de julio de 1997"
30,9,11,219,679,809,1488,"6 de julio de 1997"
30,9,11,220,539,758,1297,"6 de julio de 1997"
30,9,11,221,628,748,1376,"6 de julio de 1997"
30,9,11,222,595,760,1355,"6 de julio de 1997"
30,9,11,223,447,558,1005,"6 de julio de 1997"
30,9,11,224,377,313,690,"6 de julio de 1997"
30,9,11,225,150,94,244,"6 de julio de 1997"
30,9,11,226,215,175,390,"6 de julio de 1997"
30,9,11,227,273,232,505,"6 de julio de 1997"
30,9,11,228,519,441,960,"6 de julio de 1997"
30,9,11,229,610,512,1122,"6 de julio de 1997"
30,9,11,230,279,225,504,"6 de julio de 1997"
30,9,11,231,251,233,484,"6 de julio de 1997"
30,9,11,232,97,83,180,"6 de julio de 1997"
30,9,11,233,308,282,590,"6 de julio de 1997"
30,9,11,234,283,263,546,"6 de julio de 1997"
30,9,11,235,286,297,583,"6 de julio de 1997"
30,9,11,236,546,570,1116,"6 de julio de 1997"
30,9,11,237,475,473,948,"6 de julio de 1997"
30,9,11,238,551,536,1087,"6 de julio de 1997"
30,9,11,239,368,420,788,"6 de julio de 1997"
30,9,11,240,370,359,729,"6 de julio de 1997"
30,9,11,241,230,230,460,"6 de julio de 1997"
30,9,11,242,542,538,1080,"6 de julio de 1997"
30,9,11,243,322,327,649,"6 de julio de 1997"
30,9,11,244,460,520,980,"6 de julio de 1997"
30,9,11,245,410,469,879,"6 de julio de 1997"
30,9,11,246,138,154,292,"6 de julio de 1997"
30,9,26,465,622,610,1232,"6 de julio de 1997"
30,9,26,466,632,638,1270,"6 de julio de 1997"
30,9,26,467,827,832,1659,"6 de julio de 1997"
30,9,26,468,456,436,892,"6 de julio de 1997"
30,9,26,469,589,540,1129,"6 de julio de 1997"
30,9,26,470,580,526,1106,"6 de julio de 1997"
30,9,26,471,623,595,1218,"6 de julio de 1997"
30,9,26,472,463,478,941,"6 de julio de 1997"
30,9,27,473,409,451,860,"6 de julio de 1997"
30,9,27,474,410,426,836,"6 de julio de 1997"
30,9,27,475,305,324,629,"6 de julio de 1997"
30,9,27,476,548,654,1202,"6 de julio de 1997"
30,9,27,477,477,584,1061,"6 de julio de 1997"
30,9,27,478,515,578,1093,"6 de julio de 1997"
30,9,27,479,453,524,977,"6 de julio de 1997"
30,9,27,480,368,427,795,"6 de julio de 1997"
30,9,27,481,542,560,1102,"6 de julio de 1997"
30,9,48,1153,371,381,752,"6 de julio de 1997"
30,9,48,1154,298,324,622,"6 de julio de 1997"
30,9,48,1155,385,388,773,"6 de julio de 1997"
30,9,48,1156,523,433,956,"6 de julio de 1997"
30,9,48,1157,469,398,867,"6 de julio de 1997"
30,9,48,1158,628,568,1196,"6 de julio de 1997"
30,9,48,1159,365,313,678,"6 de julio de 1997"
30,9,48,1160,413,358,771,"6 de julio de 1997"
30,9,48,1161,343,327,670,"6 de julio de 1997"
30,9,81,1726,441,400,841,"6 de julio de 1997"
30,9,81,1727,455,456,911,"6 de julio de 1997"
30,9,81,1728,498,425,923,"6 de julio de 1997"
30,9,81,1729,463,428,891,"6 de julio de 1997"
30,9,81,1730,487,417,904,"6 de julio de 1997"
30,9,88,1830,789,848,1637,"6 de julio de 1997"
30,9,88,1831,618,579,1197,"6 de julio de 1997"
30,9,88,1832,576,616,1192,"6 de julio de 1997"
30,9,88,1833,296,266,562,"6 de julio de 1997"
30,9,88,1834,179,175,354,"6 de julio de 1997"
30,9,88,1835,232,206,438,"6 de julio de 1997"
30,9,88,1836,84,77,161,"6 de julio de 1997"
30,9,88,1837,210,183,393,"6 de julio de 1997"
30,9,88,1838,514,535,1049,"6 de julio de 1997"
30,9,88,1839,372,349,721,"6 de julio de 1997"
30,9,88,1840,533,554,1087,"6 de julio de 1997"
30,9,88,1841,289,279,568,"6 de julio de 1997"
30,9,88,1842,189,219,408,"6 de julio de 1997"
30,9,88,1843,366,418,784,"6 de julio de 1997"
30,9,88,1844,367,362,729,"6 de julio de 1997"
30,9,88,1845,651,589,1240,"6 de julio de 1997"
30,9,88,1846,569,598,1167,"6 de julio de 1997"
30,9,88,1847,100,116,216,"6 de julio de 1997"
30,9,108,2418,375,324,699,"6 de julio de 1997"
30,9,108,2419,298,232,530,"6 de julio de 1997"
30,9,129,3036,298,331,629,"6 de julio de 1997"
30,9,129,3037,467,578,1045,"6 de julio de 1997"
30,9,129,3038,451,518,969,"6 de julio de 1997"
30,9,129,3039,809,941,1750,"6 de julio de 1997"
30,9,129,3040,643,821,1464,"6 de julio de 1997"
30,9,129,3041,609,742,1351,"6 de julio de 1997"
30,9,129,3042,383,439,822,"6 de julio de 1997"
30,9,129,3043,831,907,1738,"6 de julio de 1997"
30,9,129,3044,603,769,1372,"6 de julio de 1997"
30,9,129,3045,643,742,1385,"6 de julio de 1997"
30,9,129,3046,615,752,1367,"6 de julio de 1997"
30,9,129,3047,560,614,1174,"6 de julio de 1997"
30,9,129,3048,103,92,195,"6 de julio de 1997"
30,9,129,3049,326,347,673,"6 de julio de 1997"
30,9,129,3050,122,129,251,"6 de julio de 1997"
30,9,129,3051,626,641,1267,"6 de julio de 1997"
30,9,129,3052,478,431,909,"6 de julio de 1997"
30,9,129,3053,212,214,426,"6 de julio de 1997"
30,9,129,3054,167,179,346,"6 de julio de 1997"
30,9,129,3055,77,70,147,"6 de julio de 1997"
30,9,129,3056,206,207,413,"6 de julio de 1997"
30,9,129,3057,334,357,691,"6 de julio de 1997"
30,9,129,3058,655,615,1270,"6 de julio de 1997"
30,9,129,3059,119,128,247,"6 de julio de 1997"
30,9,129,3060,193,179,372,"6 de julio de 1997"
30,9,129,3061,456,460,916,"6 de julio de 1997"
30,9,129,3062,368,334,702,"6 de julio de 1997"
30,9,129,3063,193,199,392,"6 de julio de 1997"
30,9,129,3064,101,105,206,"6 de julio de 1997"
30,9,129,3065,328,256,584,"6 de julio de 1997"
30,9,129,3066,297,362,659,"6 de julio de 1997"
30,9,136,3283,483,467,950,"6 de julio de 1997"
30,9,136,3284,502,491,993,"6 de julio de 1997"
30,9,136,3285,396,410,806,"6 de julio de 1997"
30,9,137,3286,712,728,1440,"6 de julio de 1997"
30,9,137,3287,678,716,1394,"6 de julio de 1997"
30,9,137,3288,521,573,1094,"6 de julio de 1997"
30,9,137,3289,463,528,991,"6 de julio de 1997"
30,9,137,3290,218,204,422,"6 de julio de 1997"
30,9,137,3291,254,214,468,"6 de julio de 1997"
30,9,137,3292,399,376,775,"6 de julio de 1997"
30,9,137,3293,269,217,486,"6 de julio de 1997"
30,9,157,3669,257,270,527,"6 de julio de 1997"
30,9,157,3670,393,252,645,"6 de julio de 1997"
30,9,157,3671,336,298,634,"6 de julio de 1997"
30,9,157,3672,185,158,343,"6 de julio de 1997"
30,9,163,3745,625,652,1277,"6 de julio de 1997"
30,9,163,3746,319,353,672,"6 de julio de 1997"
30,9,163,3747,454,502,956,"6 de julio de 1997"
30,9,163,3748,480,539,1019,"6 de julio de 1997"
30,9,163,3749,488,526,1014,"6 de julio de 1997"
30,9,163,3750,324,326,650,"6 de julio de 1997"
30,9,163,3751,324,317,641,"6 de julio de 1997"
30,9,163,3752,526,452,978,"6 de julio de 1997"
30,9,163,3753,475,408,883,"6 de julio de 1997"
30,9,176,3979,380,367,747,"6 de julio de 1997"
30,9,176,3980,324,253,577,"6 de julio de 1997"
30,9,176,3981,379,330,709,"6 de julio de 1997"
30,9,176,3982,389,367,756,"6 de julio de 1997"
30,9,176,3983,168,149,317,"6 de julio de 1997"
30,9,176,3984,417,402,819,"6 de julio de 1997"
30,9,181,4037,333,364,697,"6 de julio de 1997"
30,9,181,4038,388,344,732,"6 de julio de 1997"
30,9,181,4039,706,850,1556,"6 de julio de 1997"
30,9,181,4040,424,342,766,"6 de julio de 1997"
30,9,181,4041,156,150,306,"6 de julio de 1997"
30,9,193,4501,357,408,765,"6 de julio de 1997"
30,9,193,4502,444,423,867,"6 de julio de 1997"
30,9,193,4503,136,141,277,"6 de julio de 1997"
30,9,193,4504,462,461,923,"6 de julio de 1997"
30,9,193,4505,446,412,858,"6 de julio de 1997"
30,10,89,1848,550,657,1207,"6 de julio de 1997"
30,10,89,1849,644,726,1370,"6 de julio de 1997"
30,10,89,1850,764,916,1680,"6 de julio de 1997"
30,10,89,1851,586,627,1213,"6 de julio de 1997"
30,10,89,1852,566,580,1146,"6 de julio de 1997"
30,10,89,1853,373,450,823,"6 de julio de 1997"
30,10,89,1854,372,447,819,"6 de julio de 1997"
30,10,89,1855,421,491,912,"6 de julio de 1997"
30,10,89,1856,451,497,948,"6 de julio de 1997"
30,10,89,1857,391,441,832,"6 de julio de 1997"
30,10,89,1858,404,465,869,"6 de julio de 1997"
30,10,89,1859,349,398,747,"6 de julio de 1997"
30,10,89,1860,389,414,803,"6 de julio de 1997"
30,10,89,1861,314,358,672,"6 de julio de 1997"
30,10,89,1862,329,353,682,"6 de julio de 1997"
30,10,89,1863,378,394,772,"6 de julio de 1997"
30,10,89,1864,233,221,454,"6 de julio de 1997"
30,10,89,1865,397,464,861,"6 de julio de 1997"
30,10,89,1866,361,410,771,"6 de julio de 1997"
30,10,89,1867,393,444,837,"6 de julio de 1997"
30,10,89,1868,342,364,706,"6 de julio de 1997"
30,10,89,1869,421,494,915,"6 de julio de 1997"
30,10,89,1870,400,496,896,"6 de julio de 1997"
30,10,89,1871,298,386,684,"6 de julio de 1997"
30,10,89,1872,377,436,813,"6 de julio de 1997"
30,10,89,1873,221,243,464,"6 de julio de 1997"
30,10,89,1874,584,610,1194,"6 de julio de 1997"
30,10,89,1875,839,899,1738,"6 de julio de 1997"
30,10,89,1876,309,345,654,"6 de julio de 1997"
30,10,89,1877,433,482,915,"6 de julio de 1997"
30,10,89,1878,345,407,752,"6 de julio de 1997"
30,10,89,1879,641,812,1453,"6 de julio de 1997"
30,10,89,1880,443,482,925,"6 de julio de 1997"
30,10,89,1881,424,492,916,"6 de julio de 1997"
30,10,89,1882,604,733,1337,"6 de julio de 1997"
30,10,89,1883,410,462,872,"6 de julio de 1997"
30,10,89,1884,487,550,1037,"6 de julio de 1997"
30,10,89,1885,511,567,1078,"6 de julio de 1997"
30,10,89,1886,433,487,920,"6 de julio de 1997"
30,10,89,1887,452,508,960,"6 de julio de 1997"
30,10,89,1888,376,439,815,"6 de julio de 1997"
30,10,89,1889,479,546,1025,"6 de julio de 1997"
30,10,89,1890,443,541,984,"6 de julio de 1997"
30,10,89,1891,339,441,780,"6 de julio de 1997"
30,10,89,1892,332,429,761,"6 de julio de 1997"
30,10,89,1893,350,394,744,"6 de julio de 1997"
30,10,89,1894,321,386,707,"6 de julio de 1997"
30,10,89,1895,568,654,1222,"6 de julio de 1997"
30,10,89,1896,402,402,804,"6 de julio de 1997"
30,10,89,1897,344,291,635,"6 de julio de 1997"
30,10,89,1898,385,485,870,"6 de julio de 1997"
30,10,89,1899,469,629,1098,"6 de julio de 1997"
30,10,89,1900,375,490,865,"6 de julio de 1997"
30,10,89,1901,558,647,1205,"6 de julio de 1997"
30,10,89,1902,410,470,880,"6 de julio de 1997"
30,10,89,1903,540,616,1156,"6 de julio de 1997"
30,10,89,1904,353,367,720,"6 de julio de 1997"
30,10,89,1905,870,1017,1887,"6 de julio de 1997"
30,10,89,1906,446,574,1020,"6 de julio de 1997"
30,10,89,1907,594,718,1312,"6 de julio de 1997"
30,10,89,1908,733,775,1508,"6 de julio de 1997"
30,10,89,1909,270,324,594,"6 de julio de 1997"
30,10,89,1910,469,541,1010,"6 de julio de 1997"
30,10,89,1911,434,516,950,"6 de julio de 1997"
30,10,89,1912,480,539,1019,"6 de julio de 1997"
30,10,89,1913,425,560,985,"6 de julio de 1997"
30,10,89,1914,481,592,1073,"6 de julio de 1997"
30,10,89,1915,396,446,842,"6 de julio de 1997"
30,10,89,1916,521,614,1135,"6 de julio de 1997"
30,10,89,1917,439,526,965,"6 de julio de 1997"
30,10,89,1918,428,469,897,"6 de julio de 1997"
30,10,89,1919,272,330,602,"6 de julio de 1997"
30,10,89,1920,346,431,777,"6 de julio de 1997"
30,10,89,1921,404,440,844,"6 de julio de 1997"
30,10,89,1922,395,401,796,"6 de julio de 1997"
30,10,89,1923,468,477,945,"6 de julio de 1997"
30,10,89,1924,376,438,814,"6 de julio de 1997"
30,10,89,1925,470,542,1012,"6 de julio de 1997"
30,10,89,1926,402,538,940,"6 de julio de 1997"
30,10,89,1927,374,439,813,"6 de julio de 1997"
30,10,89,1928,446,508,954,"6 de julio de 1997"
30,10,89,1929,313,413,726,"6 de julio de 1997"
30,10,89,1930,282,347,629,"6 de julio de 1997"
30,10,89,1931,295,330,625,"6 de julio de 1997"
30,10,89,1932,351,498,849,"6 de julio de 1997"
30,10,89,1933,408,535,943,"6 de julio de 1997"
30,10,89,1934,323,411,734,"6 de julio de 1997"
30,10,89,1935,266,330,596,"6 de julio de 1997"
30,10,89,1936,341,507,848,"6 de julio de 1997"
30,10,89,1937,536,668,1204,"6 de julio de 1997"
30,10,89,1938,479,638,1117,"6 de julio de 1997"
30,10,89,1939,431,505,936,"6 de julio de 1997"
30,10,89,1940,498,571,1069,"6 de julio de 1997"
30,10,89,1941,288,366,654,"6 de julio de 1997"
30,10,89,1942,374,489,863,"6 de julio de 1997"
30,10,89,1943,312,409,721,"6 de julio de 1997"
30,10,89,1944,511,592,1103,"6 de julio de 1997"
30,10,89,1945,229,310,539,"6 de julio de 1997"
30,10,89,1946,327,446,773,"6 de julio de 1997"
30,10,89,1947,354,455,809,"6 de julio de 1997"
30,10,89,1948,419,484,903,"6 de julio de 1997"
30,10,89,1949,372,433,805,"6 de julio de 1997"
30,10,89,1950,278,352,630,"6 de julio de 1997"
30,10,89,1951,845,1034,1879,"6 de julio de 1997"
30,10,89,1952,267,361,628,"6 de julio de 1997"
30,10,89,1953,364,470,834,"6 de julio de 1997"
30,10,89,1954,233,330,563,"6 de julio de 1997"
30,10,89,1955,433,565,998,"6 de julio de 1997"
30,10,89,1956,525,663,1188,"6 de julio de 1997"
30,10,89,1957,433,492,925,"6 de julio de 1997"
30,10,89,1958,442,491,933,"6 de julio de 1997"
30,10,89,1959,419,506,925,"6 de julio de 1997"
30,10,89,1960,428,499,927,"6 de julio de 1997"
30,10,89,1961,364,414,778,"6 de julio de 1997"
30,10,89,1962,411,486,897,"6 de julio de 1997"
30,10,89,1963,250,327,577,"6 de julio de 1997"
30,10,89,1964,346,451,797,"6 de julio de 1997"
30,10,89,1965,347,433,780,"6 de julio de 1997"
30,10,89,1966,413,551,964,"6 de julio de 1997"
30,10,89,1967,317,390,707,"6 de julio de 1997"
30,10,89,1968,452,527,979,"6 de julio de 1997"
30,10,89,1969,318,391,709,"6 de julio de 1997"
30,10,89,1970,685,779,1464,"6 de julio de 1997"
30,10,89,1971,479,622,1101,"6 de julio de 1997"
30,10,89,1972,616,713,1329,"6 de julio de 1997"
30,10,89,1973,574,676,1250,"6 de julio de 1997"
30,10,89,1974,363,386,749,"6 de julio de 1997"
30,10,89,1975,304,405,709,"6 de julio de 1997"
30,10,89,1976,387,503,890,"6 de julio de 1997"
30,10,89,1977,281,350,631,"6 de julio de 1997"
30,10,89,1978,308,482,790,"6 de julio de 1997"
30,10,89,1979,276,400,676,"6 de julio de 1997"
30,10,89,1980,236,331,567,"6 de julio de 1997"
30,10,89,1981,290,359,649,"6 de julio de 1997"
30,10,89,1982,289,363,652,"6 de julio de 1997"
30,10,89,1983,367,427,794,"6 de julio de 1997"
30,10,89,1984,352,436,788,"6 de julio de 1997"
30,10,89,1985,454,496,950,"6 de julio de 1997"
30,10,89,1986,301,347,648,"6 de julio de 1997"
30,10,89,1987,321,348,669,"6 de julio de 1997"
30,10,89,1988,328,391,719,"6 de julio de 1997"
30,10,89,1989,312,481,793,"6 de julio de 1997"
30,10,89,1990,275,364,639,"6 de julio de 1997"
30,10,89,1991,299,373,672,"6 de julio de 1997"
30,10,89,1992,325,385,710,"6 de julio de 1997"
30,10,89,1993,328,416,744,"6 de julio de 1997"
30,10,89,1994,470,607,1077,"6 de julio de 1997"
30,10,89,1995,309,431,740,"6 de julio de 1997"
30,10,89,1996,415,539,954,"6 de julio de 1997"
30,10,89,1997,301,401,702,"6 de julio de 1997"
30,10,89,1998,301,348,649,"6 de julio de 1997"
30,10,89,1999,431,500,931,"6 de julio de 1997"
30,10,89,2000,381,515,896,"6 de julio de 1997"
30,10,89,2001,346,431,777,"6 de julio de 1997"
30,10,89,2002,364,430,794,"6 de julio de 1997"
30,10,89,2003,509,642,1151,"6 de julio de 1997"
30,10,89,2004,602,791,1393,"6 de julio de 1997"
30,10,89,2005,783,980,1763,"6 de julio de 1997"
30,10,89,2006,337,417,754,"6 de julio de 1997"
30,10,89,2007,348,462,810,"6 de julio de 1997"
30,10,89,2008,346,422,768,"6 de julio de 1997"
30,10,89,2009,248,358,606,"6 de julio de 1997"
30,10,89,2010,309,412,721,"6 de julio de 1997"
30,10,89,2011,298,416,714,"6 de julio de 1997"
30,10,89,2012,343,469,812,"6 de julio de 1997"
30,10,89,2013,353,382,735,"6 de julio de 1997"
30,10,89,2014,446,510,956,"6 de julio de 1997"
30,10,89,2015,481,566,1047,"6 de julio de 1997"
30,10,89,2016,417,517,934,"6 de julio de 1997"
30,10,89,2017,444,592,1036,"6 de julio de 1997"
30,10,89,2018,288,363,651,"6 de julio de 1997"
30,10,89,2019,429,619,1048,"6 de julio de 1997"
30,10,89,2020,457,680,1137,"6 de julio de 1997"
30,10,89,2021,452,569,1021,"6 de julio de 1997"
30,10,89,2022,211,275,486,"6 de julio de 1997"
30,10,89,2023,359,442,801,"6 de julio de 1997"
30,10,89,2024,465,577,1042,"6 de julio de 1997"
30,10,89,2025,522,627,1149,"6 de julio de 1997"
30,10,89,2026,459,538,997,"6 de julio de 1997"
30,10,89,2027,469,583,1052,"6 de julio de 1997"
30,10,89,2028,434,481,915,"6 de julio de 1997"
30,10,89,2029,442,546,988,"6 de julio de 1997"
30,10,89,2030,375,475,850,"6 de julio de 1997"
30,10,89,2031,414,540,954,"6 de julio de 1997"
30,10,89,2032,253,375,628,"6 de julio de 1997"
30,10,89,2033,178,295,473,"6 de julio de 1997"
30,10,89,2034,407,529,936,"6 de julio de 1997"
30,10,89,2035,412,531,943,"6 de julio de 1997"
30,10,89,2036,447,579,1026,"6 de julio de 1997"
30,10,89,2037,236,263,499,"6 de julio de 1997"
30,10,89,2038,486,603,1089,"6 de julio de 1997"
30,10,89,2039,280,339,619,"6 de julio de 1997"
30,10,89,2040,407,454,861,"6 de julio de 1997"
30,10,89,2041,350,392,742,"6 de julio de 1997"
30,10,89,2042,372,465,837,"6 de julio de 1997"
30,10,89,2043,299,346,645,"6 de julio de 1997"
30,10,89,2044,329,366,695,"6 de julio de 1997"
30,10,89,2045,276,411,687,"6 de julio de 1997"
30,10,89,2046,283,406,689,"6 de julio de 1997"
30,10,89,2047,218,331,549,"6 de julio de 1997"
30,10,89,2048,390,558,948,"6 de julio de 1997"
30,10,89,2049,377,529,906,"6 de julio de 1997"
30,10,89,2050,356,478,834,"6 de julio de 1997"
30,10,89,2051,305,386,691,"6 de julio de 1997"
30,10,89,2052,399,467,866,"6 de julio de 1997"
30,10,89,2053,313,345,658,"6 de julio de 1997"
30,10,89,2054,527,577,1104,"6 de julio de 1997"
30,10,89,2055,485,558,1043,"6 de julio de 1997"
30,10,89,2056,351,430,781,"6 de julio de 1997"
30,10,89,2057,198,253,451,"6 de julio de 1997"
30,10,89,2058,242,334,576,"6 de julio de 1997"
30,10,89,2059,424,545,969,"6 de julio de 1997"
30,10,89,2060,304,408,712,"6 de julio de 1997"
30,10,89,2061,390,495,885,"6 de julio de 1997"
30,10,89,2062,278,387,665,"6 de julio de 1997"
30,10,89,2063,303,384,687,"6 de julio de 1997"
30,10,89,2064,466,515,981,"6 de julio de 1997"
30,10,89,2065,380,452,832,"6 de julio de 1997"
30,10,89,2066,353,533,886,"6 de julio de 1997"
30,10,89,2067,371,491,862,"6 de julio de 1997"
30,10,89,2068,390,439,829,"6 de julio de 1997"
30,10,89,2069,212,294,506,"6 de julio de 1997"
30,10,89,2070,829,1049,1878,"6 de julio de 1997"
30,10,89,2071,145,232,377,"6 de julio de 1997"
30,10,89,2072,368,404,772,"6 de julio de 1997"
30,10,89,2073,258,350,608,"6 de julio de 1997"
30,10,89,2074,73,87,160,"6 de julio de 1997"
30,10,89,2075,431,501,932,"6 de julio de 1997"
30,10,89,2076,355,446,801,"6 de julio de 1997"
30,10,89,2077,323,433,756,"6 de julio de 1997"
30,10,89,2078,181,227,408,"6 de julio de 1997"
30,10,89,2079,236,267,503,"6 de julio de 1997"
30,10,89,2080,302,375,677,"6 de julio de 1997"
30,10,89,2081,508,550,1058,"6 de julio de 1997"
30,10,89,2082,478,535,1013,"6 de julio de 1997"
30,10,89,2083,426,523,949,"6 de julio de 1997"
30,10,89,2084,322,376,698,"6 de julio de 1997"
30,10,89,2085,471,527,998,"6 de julio de 1997"
30,10,89,2086,1157,1464,2621,"6 de julio de 1997"
30,10,89,2087,354,373,727,"6 de julio de 1997"
30,10,89,2088,338,379,717,"6 de julio de 1997"
30,10,89,2089,416,418,834,"6 de julio de 1997"
30,10,89,2090,151,189,340,"6 de julio de 1997"
30,10,89,2091,144,187,331,"6 de julio de 1997"
30,10,89,2092,597,568,1165,"6 de julio de 1997"
30,10,89,2093,340,315,655,"6 de julio de 1997"
30,10,89,2094,230,211,441,"6 de julio de 1997"
30,10,89,2095,524,513,1037,"6 de julio de 1997"
30,10,89,2096,519,506,1025,"6 de julio de 1997"
30,10,89,2097,154,137,291,"6 de julio de 1997"
30,10,89,2098,87,82,169,"6 de julio de 1997"
30,10,89,2099,163,202,365,"6 de julio de 1997"
30,10,89,2100,291,362,653,"6 de julio de 1997"
30,11,17,363,359,389,748,"6 de julio de 1997"
30,11,17,364,295,303,598,"6 de julio de 1997"
30,11,17,365,428,441,869,"6 de julio de 1997"
30,11,17,366,278,314,592,"6 de julio de 1997"
30,11,17,367,513,528,1041,"6 de julio de 1997"
30,11,17,368,514,557,1071,"6 de julio de 1997"
30,11,17,369,420,442,862,"6 de julio de 1997"
30,11,17,370,251,265,516,"6 de julio de 1997"
30,11,17,371,327,380,707,"6 de julio de 1997"
30,11,17,372,223,281,504,"6 de julio de 1997"
30,11,17,373,363,350,713,"6 de julio de 1997"
30,11,17,374,488,546,1034,"6 de julio de 1997"
30,11,17,375,621,662,1283,"6 de julio de 1997"
30,11,17,376,513,548,1061,"6 de julio de 1997"
30,11,17,377,440,454,894,"6 de julio de 1997"
30,11,17,378,278,302,580,"6 de julio de 1997"
30,11,17,379,361,366,727,"6 de julio de 1997"
30,11,17,380,243,236,479,"6 de julio de 1997"
30,11,17,381,365,326,691,"6 de julio de 1997"
30,11,17,382,195,203,398,"6 de julio de 1997"
30,11,17,383,230,228,458,"6 de julio de 1997"
30,11,18,384,292,316,608,"6 de julio de 1997"
30,11,18,385,442,406,848,"6 de julio de 1997"
30,11,18,386,282,255,537,"6 de julio de 1997"
30,11,18,387,187,157,344,"6 de julio de 1997"
30,11,18,388,79,58,137,"6 de julio de 1997"
30,11,25,459,532,468,1000,"6 de julio de 1997"
30,11,25,460,718,642,1360,"6 de julio de 1997"
30,11,25,461,391,375,766,"6 de julio de 1997"
30,11,25,462,399,331,730,"6 de julio de 1997"
30,11,25,463,492,410,902,"6 de julio de 1997"
30,11,25,464,703,558,1261,"6 de julio de 1997"
30,11,40,712,408,374,782,"6 de julio de 1997"
30,11,40,713,340,357,697,"6 de julio de 1997"
30,11,40,714,374,384,758,"6 de julio de 1997"
30,11,40,715,527,597,1124,"6 de julio de 1997"
30,11,40,716,539,604,1143,"6 de julio de 1997"
30,11,40,717,400,449,849,"6 de julio de 1997"
30,11,40,718,244,274,518,"6 de julio de 1997"
30,11,40,719,444,456,900,"6 de julio de 1997"
30,11,40,720,535,585,1120,"6 de julio de 1997"
30,11,40,721,432,519,951,"6 de julio de 1997"
30,11,40,722,259,339,598,"6 de julio de 1997"
30,11,40,723,431,532,963,"6 de julio de 1997"
30,11,40,724,382,514,896,"6 de julio de 1997"
30,11,40,725,381,467,848,"6 de julio de 1997"
30,11,40,726,341,421,762,"6 de julio de 1997"
30,11,40,727,370,489,859,"6 de julio de 1997"
30,11,40,728,483,587,1070,"6 de julio de 1997"
30,11,40,729,564,666,1230,"6 de julio de 1997"
30,11,40,730,339,364,703,"6 de julio de 1997"
30,11,40,731,487,573,1060,"6 de julio de 1997"
30,11,40,732,392,436,828,"6 de julio de 1997"
30,11,40,733,308,350,658,"6 de julio de 1997"
30,11,40,734,382,468,850,"6 de julio de 1997"
30,11,40,735,352,424,776,"6 de julio de 1997"
30,11,40,736,376,426,802,"6 de julio de 1997"
30,11,40,737,247,290,537,"6 de julio de 1997"
30,11,40,738,245,269,514,"6 de julio de 1997"
30,11,40,739,331,352,683,"6 de julio de 1997"
30,11,40,740,399,428,827,"6 de julio de 1997"
30,11,40,741,344,398,742,"6 de julio de 1997"
30,11,40,742,489,510,999,"6 de julio de 1997"
30,11,40,743,108,62,170,"6 de julio de 1997"
30,11,40,744,508,451,959,"6 de julio de 1997"
30,11,40,745,427,448,875,"6 de julio de 1997"
30,11,40,746,512,544,1056,"6 de julio de 1997"
30,11,40,747,363,343,706,"6 de julio de 1997"
30,11,40,748,287,280,567,"6 de julio de 1997"
30,11,40,749,539,572,1111,"6 de julio de 1997"
30,11,40,750,464,387,851,"6 de julio de 1997"
30,11,40,751,498,517,1015,"6 de julio de 1997"
30,11,40,752,301,309,610,"6 de julio de 1997"
30,11,40,753,434,448,882,"6 de julio de 1997"
30,11,40,754,480,509,989,"6 de julio de 1997"
30,11,40,755,420,444,864,"6 de julio de 1997"
30,11,40,756,306,347,653,"6 de julio de 1997"
30,11,40,757,425,449,874,"6 de julio de 1997"
30,11,40,758,415,452,867,"6 de julio de 1997"
30,11,40,759,424,421,845,"6 de julio de 1997"
30,11,40,760,342,359,701,"6 de julio de 1997"
30,11,40,761,298,308,606,"6 de julio de 1997"
30,11,40,762,182,165,347,"6 de julio de 1997"
30,11,67,1475,229,222,451,"6 de julio de 1997"
30,11,67,1476,335,283,618,"6 de julio de 1997"
30,11,67,1477,382,318,700,"6 de julio de 1997"
30,11,67,1478,280,233,513,"6 de julio de 1997"
30,11,67,1479,417,412,829,"6 de julio de 1997"
30,11,67,1480,744,341,1085,"6 de julio de 1997"
30,11,67,1481,392,364,756,"6 de julio de 1997"
30,11,67,1482,373,350,723,"6 de julio de 1997"
30,11,67,1483,321,320,641,"6 de julio de 1997"
30,11,67,1484,341,367,708,"6 de julio de 1997"
30,11,67,1485,537,543,1080,"6 de julio de 1997"
30,11,67,1486,100,110,210,"6 de julio de 1997"
30,11,67,1487,763,753,1516,"6 de julio de 1997"
30,11,67,1488,517,441,958,"6 de julio de 1997"
30,11,67,1489,72,53,125,"6 de julio de 1997"
30,11,67,1490,197,199,396,"6 de julio de 1997"
30,11,67,1491,406,377,783,"6 de julio de 1997"
30,11,67,1492,84,81,165,"6 de julio de 1997"
30,11,67,1493,299,332,631,"6 de julio de 1997"
30,11,67,1494,227,222,449,"6 de julio de 1997"
30,11,67,1495,562,523,1085,"6 de julio de 1997"
30,11,67,1496,275,254,529,"6 de julio de 1997"
30,11,67,1497,336,324,660,"6 de julio de 1997"
30,11,67,1498,342,328,670,"6 de julio de 1997"
30,11,67,1499,281,252,533,"6 de julio de 1997"
30,11,67,1500,200,176,376,"6 de julio de 1997"
30,11,67,1501,131,104,235,"6 de julio de 1997"
30,11,67,1502,231,261,492,"6 de julio de 1997"
30,11,67,1503,358,360,718,"6 de julio de 1997"
30,11,67,1504,431,403,834,"6 de julio de 1997"
30,11,67,1505,292,269,561,"6 de julio de 1997"
30,11,67,1506,449,455,904,"6 de julio de 1997"
30,11,67,1507,324,318,642,"6 de julio de 1997"
30,11,67,1508,520,556,1076,"6 de julio de 1997"
30,11,67,1509,515,500,1015,"6 de julio de 1997"
30,11,90,2101,418,396,814,"6 de julio de 1997"
30,11,90,2102,403,365,768,"6 de julio de 1997"
30,11,90,2103,48,32,80,"6 de julio de 1997"
30,11,90,2104,516,395,911,"6 de julio de 1997"
30,11,127,3004,344,357,701,"6 de julio de 1997"
30,11,127,3005,326,313,639,"6 de julio de 1997"
30,11,127,3006,413,401,814,"6 de julio de 1997"
30,11,127,3007,363,392,755,"6 de julio de 1997"
30,11,127,3008,398,410,808,"6 de julio de 1997"
30,11,127,3009,438,410,848,"6 de julio de 1997"
30,11,127,3010,304,259,563,"6 de julio de 1997"
30,11,127,3011,750,685,1435,"6 de julio de 1997"
30,11,127,3012,548,534,1082,"6 de julio de 1997"
30,11,127,3013,179,162,341,"6 de julio de 1997"
30,11,127,3014,423,376,799,"6 de julio de 1997"
30,11,127,3015,763,777,1540,"6 de julio de 1997"
30,11,127,3016,568,557,1125,"6 de julio de 1997"
30,11,127,3017,125,115,240,"6 de julio de 1997"
30,11,127,3018,491,416,907,"6 de julio de 1997"
30,11,127,3019,278,281,559,"6 de julio de 1997"
30,11,127,3020,293,276,569,"6 de julio de 1997"
30,11,127,3021,374,317,691,"6 de julio de 1997"
30,11,127,3022,601,541,1142,"6 de julio de 1997"
30,11,127,3023,369,291,660,"6 de julio de 1997"
30,11,127,3024,461,481,942,"6 de julio de 1997"
30,11,127,3025,315,335,650,"6 de julio de 1997"
30,11,127,3026,300,306,606,"6 de julio de 1997"
30,11,127,3027,409,365,774,"6 de julio de 1997"
30,11,134,3259,450,435,885,"6 de julio de 1997"
30,11,134,3260,94,90,184,"6 de julio de 1997"
30,11,134,3261,600,710,1310,"6 de julio de 1997"
30,11,134,3262,283,322,605,"6 de julio de 1997"
30,11,134,3263,428,462,890,"6 de julio de 1997"
30,11,134,3264,508,501,1009,"6 de julio de 1997"
30,11,134,3265,290,288,578,"6 de julio de 1997"
30,11,134,3266,282,301,583,"6 de julio de 1997"
30,11,134,3267,575,581,1156,"6 de julio de 1997"
30,11,134,3268,225,210,435,"6 de julio de 1997"
30,11,134,3269,408,354,762,"6 de julio de 1997"
30,11,134,3270,314,211,525,"6 de julio de 1997"
30,11,134,3271,235,229,464,"6 de julio de 1997"
30,11,134,3272,456,380,836,"6 de julio de 1997"
30,11,134,3273,425,351,776,"6 de julio de 1997"
30,11,190,4173,692,761,1453,"6 de julio de 1997"
30,11,190,4174,585,658,1243,"6 de julio de 1997"
30,11,190,4175,504,516,1020,"6 de julio de 1997"
30,11,190,4176,418,406,824,"6 de julio de 1997"
30,11,190,4177,414,477,891,"6 de julio de 1997"
30,11,190,4178,404,398,802,"6 de julio de 1997"
30,11,190,4179,358,352,710,"6 de julio de 1997"
30,11,190,4180,223,226,449,"6 de julio de 1997"
30,11,190,4181,397,435,832,"6 de julio de 1997"
30,11,190,4182,248,229,477,"6 de julio de 1997"
30,11,190,4183,353,387,740,"6 de julio de 1997"
30,11,190,4184,297,296,593,"6 de julio de 1997"
30,11,190,4185,416,449,865,"6 de julio de 1997"
30,11,190,4186,412,437,849,"6 de julio de 1997"
30,11,190,4187,217,210,427,"6 de julio de 1997"
30,11,190,4188,379,396,775,"6 de julio de 1997"
30,11,190,4189,397,446,843,"6 de julio de 1997"
30,11,190,4190,498,512,1010,"6 de julio de 1997"
30,11,190,4191,489,525,1014,"6 de julio de 1997"
30,11,190,4192,331,356,687,"6 de julio de 1997"
30,11,190,4193,586,563,1149,"6 de julio de 1997"
30,11,190,4194,221,232,453,"6 de julio de 1997"
30,11,190,4195,433,416,849,"6 de julio de 1997"
30,11,194,4506,325,300,625,"6 de julio de 1997"
30,11,194,4507,630,637,1267,"6 de julio de 1997"
30,11,194,4508,561,586,1147,"6 de julio de 1997"
30,11,194,4509,452,503,955,"6 de julio de 1997"
30,11,194,4510,414,443,857,"6 de julio de 1997"
30,11,194,4511,410,428,838,"6 de julio de 1997"
30,11,194,4512,525,583,1108,"6 de julio de 1997"
30,11,194,4513,285,258,543,"6 de julio de 1997"
30,11,194,4514,446,440,886,"6 de julio de 1997"
30,11,194,4515,183,147,330,"6 de julio de 1997"
30,11,194,4516,502,370,872,"6 de julio de 1997"
30,11,194,4517,188,150,338,"6 de julio de 1997"
30,11,194,4518,306,266,572,"6 de julio de 1997"
30,11,194,4519,338,362,700,"6 de julio de 1997"
30,11,194,4520,237,268,505,"6 de julio de 1997"
30,11,194,4521,408,426,834,"6 de julio de 1997"
30,11,194,4522,281,288,569,"6 de julio de 1997"
30,11,194,4523,381,419,800,"6 de julio de 1997"
30,11,194,4524,319,310,629,"6 de julio de 1997"
30,12,192,4217,539,626,1165,"6 de julio de 1997"
30,12,192,4218,386,441,827,"6 de julio de 1997"
30,12,192,4219,418,390,808,"6 de julio de 1997"
30,12,192,4220,360,412,772,"6 de julio de 1997"
30,12,192,4221,448,497,945,"6 de julio de 1997"
30,12,192,4222,350,355,705,"6 de julio de 1997"
30,12,192,4223,325,377,702,"6 de julio de 1997"
30,12,192,4224,326,369,695,"6 de julio de 1997"
30,12,192,4225,520,576,1096,"6 de julio de 1997"
30,12,192,4226,447,495,942,"6 de julio de 1997"
30,12,192,4227,477,550,1027,"6 de julio de 1997"
30,12,192,4228,745,833,1578,"6 de julio de 1997"
30,12,192,4229,930,1136,2066,"6 de julio de 1997"
30,12,192,4230,2092,2504,4596,"6 de julio de 1997"
30,12,192,4231,1095,1292,2387,"6 de julio de 1997"
30,12,192,4232,363,451,814,"6 de julio de 1997"
30,12,192,4233,365,448,813,"6 de julio de 1997"
30,12,192,4234,301,385,686,"6 de julio de 1997"
30,12,192,4235,314,393,707,"6 de julio de 1997"
30,12,192,4236,530,574,1104,"6 de julio de 1997"
30,12,192,4237,458,503,961,"6 de julio de 1997"
30,12,192,4238,534,558,1092,"6 de julio de 1997"
30,12,192,4239,417,464,881,"6 de julio de 1997"
30,12,192,4240,480,518,998,"6 de julio de 1997"
30,12,192,4241,288,352,640,"6 de julio de 1997"
30,12,192,4242,345,482,827,"6 de julio de 1997"
30,12,192,4243,363,452,815,"6 de julio de 1997"
30,12,192,4244,421,515,936,"6 de julio de 1997"
30,12,192,4245,322,386,708,"6 de julio de 1997"
30,12,192,4246,308,347,655,"6 de julio de 1997"
30,12,192,4247,267,289,556,"6 de julio de 1997"
30,12,192,4248,564,653,1217,"6 de julio de 1997"
30,12,192,4249,371,426,797,"6 de julio de 1997"
30,12,192,4250,274,335,609,"6 de julio de 1997"
30,12,192,4251,295,329,624,"6 de julio de 1997"
30,12,192,4252,340,411,751,"6 de julio de 1997"
30,12,192,4253,361,419,780,"6 de julio de 1997"
30,12,192,4254,659,735,1394,"6 de julio de 1997"
30,12,192,4255,440,513,953,"6 de julio de 1997"
30,12,192,4256,237,281,518,"6 de julio de 1997"
30,12,192,4257,251,267,518,"6 de julio de 1997"
30,12,192,4258,383,426,809,"6 de julio de 1997"
30,12,192,4259,398,466,864,"6 de julio de 1997"
30,12,192,4260,1084,1343,2427,"6 de julio de 1997"
30,12,192,4261,280,382,662,"6 de julio de 1997"
30,12,192,4262,1093,1350,2443,"6 de julio de 1997"
30,12,192,4263,406,518,924,"6 de julio de 1997"
30,12,192,4264,715,791,1506,"6 de julio de 1997"
30,12,192,4265,450,455,905,"6 de julio de 1997"
30,12,192,4266,745,777,1522,"6 de julio de 1997"
30,12,192,4267,738,835,1573,"6 de julio de 1997"
30,12,192,4268,518,615,1133,"6 de julio de 1997"
30,12,192,4269,325,359,684,"6 de julio de 1997"
30,12,192,4270,547,651,1198,"6 de julio de 1997"
30,12,192,4271,355,374,729,"6 de julio de 1997"
30,12,192,4272,536,453,989,"6 de julio de 1997"
30,12,192,4273,201,208,409,"6 de julio de 1997"
30,12,192,4274,381,495,876,"6 de julio de 1997"
30,12,192,4275,455,538,993,"6 de julio de 1997"
30,12,192,4276,570,659,1229,"6 de julio de 1997"
30,12,192,4277,566,618,1184,"6 de julio de 1997"
30,12,192,4278,514,589,1103,"6 de julio de 1997"
30,12,192,4279,619,726,1345,"6 de julio de 1997"
30,12,192,4280,750,853,1603,"6 de julio de 1997"
30,12,192,4281,375,466,841,"6 de julio de 1997"
30,12,192,4282,433,516,949,"6 de julio de 1997"
30,12,192,4283,596,675,1271,"6 de julio de 1997"
30,12,192,4284,640,701,1341,"6 de julio de 1997"
30,12,192,4285,413,477,890,"6 de julio de 1997"
30,12,192,4286,392,447,839,"6 de julio de 1997"
30,12,192,4287,347,459,806,"6 de julio de 1997"
30,12,192,4288,486,536,1022,"6 de julio de 1997"
30,12,192,4289,298,350,648,"6 de julio de 1997"
30,12,192,4290,323,420,743,"6 de julio de 1997"
30,12,192,4291,294,327,621,"6 de julio de 1997"
30,12,192,4292,431,466,897,"6 de julio de 1997"
30,12,192,4293,277,306,583,"6 de julio de 1997"
30,12,192,4294,265,317,582,"6 de julio de 1997"
30,12,192,4295,282,362,644,"6 de julio de 1997"
30,12,192,4296,252,304,556,"6 de julio de 1997"
30,12,192,4297,345,415,760,"6 de julio de 1997"
30,12,192,4298,298,347,645,"6 de julio de 1997"
30,12,192,4299,214,247,461,"6 de julio de 1997"
30,12,192,4300,361,427,788,"6 de julio de 1997"
30,12,192,4301,260,335,595,"6 de julio de 1997"
30,12,192,4302,311,381,692,"6 de julio de 1997"
30,12,192,4303,258,314,572,"6 de julio de 1997"
30,12,192,4304,588,663,1251,"6 de julio de 1997"
30,12,192,4305,587,646,1233,"6 de julio de 1997"
30,12,192,4306,540,605,1145,"6 de julio de 1997"
30,12,192,4307,617,742,1359,"6 de julio de 1997"
30,12,192,4308,544,586,1130,"6 de julio de 1997"
30,12,192,4309,495,542,1037,"6 de julio de 1997"
30,12,192,4310,523,558,1081,"6 de julio de 1997"
30,12,192,4311,666,664,1330,"6 de julio de 1997"
30,12,192,4312,550,535,1085,"6 de julio de 1997"
30,12,192,4313,289,353,642,"6 de julio de 1997"
30,12,192,4314,284,315,599,"6 de julio de 1997"
30,12,192,4315,324,392,716,"6 de julio de 1997"
30,12,192,4316,333,385,718,"6 de julio de 1997"
30,12,192,4317,444,523,967,"6 de julio de 1997"
30,12,192,4318,377,403,780,"6 de julio de 1997"
30,12,192,4319,304,342,646,"6 de julio de 1997"
30,12,192,4320,255,296,551,"6 de julio de 1997"
30,12,192,4321,369,411,780,"6 de julio de 1997"
30,12,192,4322,422,590,1012,"6 de julio de 1997"
30,12,192,4323,442,555,997,"6 de julio de 1997"
30,12,192,4324,465,574,1039,"6 de julio de 1997"
30,12,192,4325,438,501,939,"6 de julio de 1997"
30,12,192,4326,263,381,644,"6 de julio de 1997"
30,12,192,4327,301,422,723,"6 de julio de 1997"
30,12,192,4328,312,385,697,"6 de julio de 1997"
30,12,192,4329,458,484,942,"6 de julio de 1997"
30,12,192,4330,314,363,677,"6 de julio de 1997"
30,12,192,4331,367,411,778,"6 de julio de 1997"
30,12,192,4332,449,535,984,"6 de julio de 1997"
30,12,192,4333,354,428,782,"6 de julio de 1997"
30,12,192,4334,364,437,801,"6 de julio de 1997"
30,12,192,4335,368,406,774,"6 de julio de 1997"
30,12,192,4336,664,686,1350,"6 de julio de 1997"
30,12,192,4337,665,762,1427,"6 de julio de 1997"
30,12,192,4338,472,527,999,"6 de julio de 1997"
30,12,192,4339,581,649,1230,"6 de julio de 1997"
30,12,192,4340,507,590,1097,"6 de julio de 1997"
30,12,192,4341,631,724,1355,"6 de julio de 1997"
30,12,192,4342,406,471,877,"6 de julio de 1997"
30,12,192,4343,558,616,1174,"6 de julio de 1997"
30,12,192,4344,670,682,1352,"6 de julio de 1997"
30,12,192,4345,589,603,1192,"6 de julio de 1997"
30,12,192,4346,548,610,1158,"6 de julio de 1997"
30,12,192,4347,452,547,999,"6 de julio de 1997"
30,12,192,4348,432,540,972,"6 de julio de 1997"
30,12,192,4349,454,511,965,"6 de julio de 1997"
30,12,192,4350,347,463,810,"6 de julio de 1997"
30,12,192,4351,355,516,871,"6 de julio de 1997"
30,12,192,4352,349,484,833,"6 de julio de 1997"
30,12,192,4353,438,524,962,"6 de julio de 1997"
30,12,192,4354,578,734,1312,"6 de julio de 1997"
30,12,192,4355,397,472,869,"6 de julio de 1997"
30,12,192,4356,390,467,857,"6 de julio de 1997"
30,12,192,4357,273,334,607,"6 de julio de 1997"
30,12,192,4358,268,323,591,"6 de julio de 1997"
30,12,192,4359,341,426,767,"6 de julio de 1997"
30,12,192,4360,631,638,1269,"6 de julio de 1997"
30,12,192,4361,462,518,980,"6 de julio de 1997"
30,12,192,4362,624,672,1296,"6 de julio de 1997"
30,12,192,4363,457,521,978,"6 de julio de 1997"
30,12,192,4364,411,486,897,"6 de julio de 1997"
30,12,192,4365,469,508,977,"6 de julio de 1997"
30,12,192,4366,692,750,1442,"6 de julio de 1997"
30,12,192,4367,596,625,1221,"6 de julio de 1997"
30,12,192,4368,415,448,863,"6 de julio de 1997"
30,12,192,4369,504,476,980,"6 de julio de 1997"
30,12,192,4370,375,388,763,"6 de julio de 1997"
30,12,192,4371,451,516,967,"6 de julio de 1997"
30,12,192,4372,531,633,1164,"6 de julio de 1997"
30,12,192,4373,463,559,1022,"6 de julio de 1997"
30,12,192,4374,561,677,1238,"6 de julio de 1997"
30,12,192,4375,260,331,591,"6 de julio de 1997"
30,12,192,4376,419,498,917,"6 de julio de 1997"
30,12,192,4377,293,408,701,"6 de julio de 1997"
30,12,192,4378,251,328,579,"6 de julio de 1997"
30,12,192,4379,507,499,1006,"6 de julio de 1997"
30,12,192,4380,384,390,774,"6 de julio de 1997"
30,12,192,4381,285,294,579,"6 de julio de 1997"
30,12,192,4382,2557,2873,5430,"6 de julio de 1997"
30,12,192,4383,454,513,967,"6 de julio de 1997"
30,12,192,4384,1355,1570,2925,"6 de julio de 1997"
30,12,192,4385,340,367,707,"6 de julio de 1997"
30,12,192,4386,291,433,724,"6 de julio de 1997"
30,12,192,4387,452,517,969,"6 de julio de 1997"
30,12,192,4388,369,366,735,"6 de julio de 1997"
30,12,192,4389,346,416,762,"6 de julio de 1997"
30,12,192,4390,552,739,1291,"6 de julio de 1997"
30,12,192,4391,421,485,906,"6 de julio de 1997"
30,12,192,4392,360,421,781,"6 de julio de 1997"
30,12,192,4393,434,510,944,"6 de julio de 1997"
30,12,192,4394,433,508,941,"6 de julio de 1997"
30,12,192,4395,288,382,670,"6 de julio de 1997"
30,12,192,4396,333,439,772,"6 de julio de 1997"
30,12,192,4397,197,269,466,"6 de julio de 1997"
30,12,192,4398,309,415,724,"6 de julio de 1997"
30,12,192,4399,272,386,658,"6 de julio de 1997"
30,12,192,4400,163,232,395,"6 de julio de 1997"
30,12,192,4401,380,551,931,"6 de julio de 1997"
30,12,192,4402,459,580,1039,"6 de julio de 1997"
30,12,192,4403,338,458,796,"6 de julio de 1997"
30,12,192,4404,213,275,488,"6 de julio de 1997"
30,12,192,4405,334,484,818,"6 de julio de 1997"
30,12,192,4406,309,391,700,"6 de julio de 1997"
30,12,192,4407,222,310,532,"6 de julio de 1997"
30,12,192,4408,381,455,836,"6 de julio de 1997"
30,12,192,4409,347,402,749,"6 de julio de 1997"
30,12,192,4410,428,487,915,"6 de julio de 1997"
30,12,192,4411,484,555,1039,"6 de julio de 1997"
30,12,192,4412,519,628,1147,"6 de julio de 1997"
30,12,192,4413,482,516,998,"6 de julio de 1997"
30,12,192,4414,608,690,1298,"6 de julio de 1997"
30,12,192,4415,364,409,773,"6 de julio de 1997"
30,12,192,4416,440,533,973,"6 de julio de 1997"
30,12,192,4417,390,482,872,"6 de julio de 1997"
30,12,192,4418,262,300,562,"6 de julio de 1997"
30,12,192,4419,296,301,597,"6 de julio de 1997"
30,12,192,4420,571,774,1345,"6 de julio de 1997"
30,12,192,4421,894,1124,2018,"6 de julio de 1997"
30,12,192,4422,265,293,558,"6 de julio de 1997"
30,12,192,4423,450,495,945,"6 de julio de 1997"
30,12,192,4424,416,457,873,"6 de julio de 1997"
30,12,192,4425,398,550,948,"6 de julio de 1997"
30,12,192,4426,305,385,690,"6 de julio de 1997"
30,12,192,4427,337,482,819,"6 de julio de 1997"
30,12,192,4428,293,410,703,"6 de julio de 1997"
30,12,192,4429,293,399,692,"6 de julio de 1997"
30,12,192,4430,310,388,698,"6 de julio de 1997"
30,12,192,4431,349,478,827,"6 de julio de 1997"
30,12,192,4432,290,422,712,"6 de julio de 1997"
30,12,192,4433,341,478,819,"6 de julio de 1997"
30,12,192,4434,408,504,912,"6 de julio de 1997"
30,12,192,4435,295,459,754,"6 de julio de 1997"
30,12,192,4436,397,552,949,"6 de julio de 1997"
30,12,192,4437,403,534,937,"6 de julio de 1997"
30,12,192,4438,279,353,632,"6 de julio de 1997"
30,12,192,4439,284,375,659,"6 de julio de 1997"
30,12,192,4440,430,568,998,"6 de julio de 1997"
30,12,192,4441,464,491,955,"6 de julio de 1997"
30,12,192,4442,368,433,801,"6 de julio de 1997"
30,12,192,4443,290,358,648,"6 de julio de 1997"
30,12,192,4444,438,525,963,"6 de julio de 1997"
30,12,192,4445,346,443,789,"6 de julio de 1997"
30,12,192,4446,401,398,799,"6 de julio de 1997"
30,12,192,4447,336,390,726,"6 de julio de 1997"
30,12,192,4448,337,384,721,"6 de julio de 1997"
30,12,192,4449,338,360,698,"6 de julio de 1997"
30,12,192,4450,376,405,781,"6 de julio de 1997"
30,12,192,4451,305,318,623,"6 de julio de 1997"
30,12,192,4452,744,817,1561,"6 de julio de 1997"
30,12,192,4453,400,433,833,"6 de julio de 1997"
30,12,192,4454,436,500,936,"6 de julio de 1997"
30,12,192,4455,241,244,485,"6 de julio de 1997"
30,12,192,4456,211,290,501,"6 de julio de 1997"
30,12,192,4457,412,454,866,"6 de julio de 1997"
30,12,192,4458,367,479,846,"6 de julio de 1997"
30,12,192,4459,300,329,629,"6 de julio de 1997"
30,12,192,4460,347,371,718,"6 de julio de 1997"
30,12,192,4461,384,433,817,"6 de julio de 1997"
30,12,192,4462,478,520,998,"6 de julio de 1997"
30,12,192,4463,363,446,809,"6 de julio de 1997"
30,12,192,4464,341,413,754,"6 de julio de 1997"
30,12,192,4465,235,291,526,"6 de julio de 1997"
30,12,192,4466,399,451,850,"6 de julio de 1997"
30,12,192,4467,315,397,712,"6 de julio de 1997"
30,12,192,4468,522,695,1217,"6 de julio de 1997"
30,12,192,4469,384,380,764,"6 de julio de 1997"
30,12,192,4470,427,446,873,"6 de julio de 1997"
30,12,192,4471,634,778,1412,"6 de julio de 1997"
30,12,192,4472,363,341,704,"6 de julio de 1997"
30,12,192,4473,297,286,583,"6 de julio de 1997"
30,12,192,4474,1135,1325,2460,"6 de julio de 1997"
30,12,192,4475,752,992,1744,"6 de julio de 1997"
30,12,192,4476,679,777,1456,"6 de julio de 1997"
30,12,192,4477,439,453,892,"6 de julio de 1997"
30,12,192,4478,241,222,463,"6 de julio de 1997"
30,12,192,4479,287,296,583,"6 de julio de 1997"
30,12,192,4480,278,279,557,"6 de julio de 1997"
30,12,192,4481,356,331,687,"6 de julio de 1997"
30,12,192,4482,359,339,698,"6 de julio de 1997"
30,12,192,4483,216,222,438,"6 de julio de 1997"
30,12,192,4484,346,355,701,"6 de julio de 1997"
30,12,192,4485,563,561,1124,"6 de julio de 1997"
30,12,192,4486,236,257,493,"6 de julio de 1997"
30,12,192,4487,290,314,604,"6 de julio de 1997"
30,12,192,4488,486,525,1011,"6 de julio de 1997"
30,12,192,4489,317,303,620,"6 de julio de 1997"
30,12,192,4490,462,504,966,"6 de julio de 1997"
30,12,192,4491,436,420,856,"6 de julio de 1997"
30,12,192,4492,246,294,540,"6 de julio de 1997"
30,12,192,4493,308,295,603,"6 de julio de 1997"
30,12,192,4494,546,580,1126,"6 de julio de 1997"
30,12,192,4495,740,904,1644,"6 de julio de 1997"
30,12,192,4496,342,340,682,"6 de julio de 1997"
30,12,192,4497,1133,1092,2225,"6 de julio de 1997"
30,12,192,4498,252,238,490,"6 de julio de 1997"
30,12,192,4499,293,286,579,"6 de julio de 1997"
30,12,192,4500,446,494,940,"6 de julio de 1997"
30,13,7,106,725,724,1449,"6 de julio de 1997"
30,13,7,107,733,641,1374,"6 de julio de 1997"
30,13,7,108,418,352,770,"6 de julio de 1997"
30,13,9,178,576,601,1177,"6 de julio de 1997"
30,13,9,179,394,354,748,"6 de julio de 1997"
30,13,9,180,469,501,970,"6 de julio de 1997"
30,13,9,181,315,301,616,"6 de julio de 1997"
30,13,9,182,425,352,777,"6 de julio de 1997"
30,13,30,588,543,534,1077,"6 de julio de 1997"
30,13,30,589,391,350,741,"6 de julio de 1997"
30,13,30,590,576,499,1075,"6 de julio de 1997"
30,13,30,591,537,502,1039,"6 de julio de 1997"
30,13,30,592,456,421,877,"6 de julio de 1997"
30,13,45,970,451,381,832,"6 de julio de 1997"
30,13,45,971,375,323,698,"6 de julio de 1997"
30,13,45,972,376,333,709,"6 de julio de 1997"
30,13,45,973,784,727,1511,"6 de julio de 1997"
30,13,45,974,328,254,582,"6 de julio de 1997"
30,13,45,975,240,163,403,"6 de julio de 1997"
30,13,45,976,756,556,1312,"6 de julio de 1997"
30,13,45,977,389,289,678,"6 de julio de 1997"
30,13,45,978,309,239,548,"6 de julio de 1997"
30,13,45,979,600,495,1095,"6 de julio de 1997"
30,13,49,1162,382,388,770,"6 de julio de 1997"
30,13,49,1163,461,526,987,"6 de julio de 1997"
30,13,49,1164,403,458,861,"6 de julio de 1997"
30,13,49,1165,497,521,1018,"6 de julio de 1997"
30,13,49,1166,385,418,803,"6 de julio de 1997"
30,13,49,1167,430,486,916,"6 de julio de 1997"
30,13,49,1168,452,465,917,"6 de julio de 1997"
30,13,49,1169,583,612,1195,"6 de julio de 1997"
30,13,49,1170,380,358,738,"6 de julio de 1997"
30,13,49,1171,327,343,670,"6 de julio de 1997"
30,13,49,1172,425,439,864,"6 de julio de 1997"
30,13,49,1173,324,276,600,"6 de julio de 1997"
30,13,49,1174,538,427,965,"6 de julio de 1997"
30,13,49,1175,397,343,740,"6 de julio de 1997"
30,13,49,1176,513,480,993,"6 de julio de 1997"
30,13,49,1177,551,513,1064,"6 de julio de 1997"
30,13,49,1178,398,345,743,"6 de julio de 1997"
30,13,49,1179,481,439,920,"6 de julio de 1997"
30,13,49,1180,311,261,572,"6 de julio de 1997"
30,13,49,1181,398,401,799,"6 de julio de 1997"
30,13,49,1182,491,482,973,"6 de julio de 1997"
30,13,49,1183,288,306,594,"6 de julio de 1997"
30,13,51,1252,691,627,1318,"6 de julio de 1997"
30,13,51,1253,264,194,458,"6 de julio de 1997"
30,13,51,1254,353,253,606,"6 de julio de 1997"
30,13,51,1255,326,289,615,"6 de julio de 1997"
30,13,51,1256,370,331,701,"6 de julio de 1997"
30,13,51,1257,383,332,715,"6 de julio de 1997"
30,13,51,1258,496,527,1023,"6 de julio de 1997"
30,13,51,1259,915,749,1664,"6 de julio de 1997"
30,13,51,1260,350,303,653,"6 de julio de 1997"
30,13,51,1261,337,302,639,"6 de julio de 1997"
30,13,51,1262,303,282,585,"6 de julio de 1997"
30,13,51,1263,302,268,570,"6 de julio de 1997"
30,13,51,1264,287,262,549,"6 de julio de 1997"
30,13,51,1265,551,551,1102,"6 de julio de 1997"
30,13,64,1456,537,494,1031,"6 de julio de 1997"
30,13,64,1457,674,693,1367,"6 de julio de 1997"
30,13,64,1458,746,793,1539,"6 de julio de 1997"
30,13,64,1459,816,698,1514,"6 de julio de 1997"
30,13,64,1460,327,297,624,"6 de julio de 1997"
30,13,64,1461,442,413,855,"6 de julio de 1997"
30,13,64,1462,551,494,1045,"6 de julio de 1997"
30,13,73,1597,363,376,739,"6 de julio de 1997"
30,13,73,1598,384,437,821,"6 de julio de 1997"
30,13,73,1599,560,622,1182,"6 de julio de 1997"
30,13,73,1600,533,633,1166,"6 de julio de 1997"
30,13,73,1601,498,646,1144,"6 de julio de 1997"
30,13,73,1602,266,302,568,"6 de julio de 1997"
30,13,73,1603,377,462,839,"6 de julio de 1997"
30,13,73,1604,690,764,1454,"6 de julio de 1997"
30,13,73,1605,512,612,1124,"6 de julio de 1997"
30,13,73,1606,660,728,1388,"6 de julio de 1997"
30,13,73,1607,459,506,965,"6 de julio de 1997"
30,13,73,1608,473,579,1052,"6 de julio de 1997"
30,13,73,1609,445,482,927,"6 de julio de 1997"
30,13,73,1610,442,500,942,"6 de julio de 1997"
30,13,73,1611,399,400,799,"6 de julio de 1997"
30,13,73,1612,136,129,265,"6 de julio de 1997"
30,13,73,1613,341,328,669,"6 de julio de 1997"
30,13,73,1614,499,441,940,"6 de julio de 1997"
30,13,73,1615,406,350,756,"6 de julio de 1997"
30,13,73,1616,551,529,1080,"6 de julio de 1997"
30,13,73,1617,235,271,506,"6 de julio de 1997"
30,13,73,1618,180,165,345,"6 de julio de 1997"
30,13,73,1619,546,518,1064,"6 de julio de 1997"
30,13,73,1620,506,457,963,"6 de julio de 1997"
30,13,73,1621,321,277,598,"6 de julio de 1997"
30,13,73,1622,492,455,947,"6 de julio de 1997"
30,13,83,1764,741,780,1521,"6 de julio de 1997"
30,13,83,1765,279,296,575,"6 de julio de 1997"
30,13,83,1766,243,278,521,"6 de julio de 1997"
30,13,83,1767,496,474,970,"6 de julio de 1997"
30,13,83,1768,496,464,960,"6 de julio de 1997"
30,13,83,1769,574,515,1089,"6 de julio de 1997"
30,13,83,1770,318,323,641,"6 de julio de 1997"
30,13,83,1771,499,464,963,"6 de julio de 1997"
30,13,83,1772,286,253,539,"6 de julio de 1997"
30,13,83,1773,449,416,865,"6 de julio de 1997"
30,13,83,1774,416,339,755,"6 de julio de 1997"
30,13,126,2990,387,383,770,"6 de julio de 1997"
30,13,126,2991,652,666,1318,"6 de julio de 1997"
30,13,126,2992,524,525,1049,"6 de julio de 1997"
30,13,126,2993,455,454,909,"6 de julio de 1997"
30,13,126,2994,707,732,1439,"6 de julio de 1997"
30,13,126,2995,658,622,1280,"6 de julio de 1997"
30,13,126,2996,543,491,1034,"6 de julio de 1997"
30,13,126,2997,524,478,1002,"6 de julio de 1997"
30,13,126,2998,401,344,745,"6 de julio de 1997"
30,13,126,2999,573,471,1044,"6 de julio de 1997"
30,13,126,3000,444,376,820,"6 de julio de 1997"
30,13,126,3001,376,329,705,"6 de julio de 1997"
30,13,126,3002,462,386,848,"6 de julio de 1997"
30,13,126,3003,643,557,1200,"6 de julio de 1997"
30,13,147,3502,331,329,660,"6 de julio de 1997"
30,13,147,3503,381,373,754,"6 de julio de 1997"
30,13,149,3513,429,455,884,"6 de julio de 1997"
30,13,149,3514,503,503,1006,"6 de julio de 1997"
30,13,149,3515,411,457,868,"6 de julio de 1997"
30,13,149,3516,531,526,1057,"6 de julio de 1997"
30,13,149,3517,363,445,808,"6 de julio de 1997"
30,13,149,3518,436,480,916,"6 de julio de 1997"
30,13,149,3519,431,446,877,"6 de julio de 1997"
30,13,149,3520,377,370,747,"6 de julio de 1997"
30,13,149,3521,387,381,768,"6 de julio de 1997"
30,13,149,3522,560,448,1008,"6 de julio de 1997"
30,13,149,3523,458,419,877,"6 de julio de 1997"
30,13,149,3524,495,441,936,"6 de julio de 1997"
30,13,149,3525,603,480,1083,"6 de julio de 1997"
30,13,149,3526,503,406,909,"6 de julio de 1997"
30,13,149,3527,386,354,740,"6 de julio de 1997"
30,13,149,3528,905,689,1594,"6 de julio de 1997"
30,13,149,3529,626,536,1162,"6 de julio de 1997"
30,13,161,3736,694,637,1331,"6 de julio de 1997"
30,13,161,3737,274,206,480,"6 de julio de 1997"
30,13,161,3738,556,514,1070,"6 de julio de 1997"
30,13,164,3754,714,586,1300,"6 de julio de 1997"
30,13,164,3755,673,581,1254,"6 de julio de 1997"
30,13,164,3756,707,505,1212,"6 de julio de 1997"
30,13,178,3999,463,435,898,"6 de julio de 1997"
30,13,178,4000,514,484,998,"6 de julio de 1997"
30,13,185,4079,414,431,845,"6 de julio de 1997"
30,13,185,4080,453,509,962,"6 de julio de 1997"
30,13,185,4081,317,317,634,"6 de julio de 1997"
30,13,185,4082,536,512,1048,"6 de julio de 1997"
30,13,187,4086,621,560,1181,"6 de julio de 1997"
30,13,187,4087,521,526,1047,"6 de julio de 1997"
30,13,187,4088,594,439,1033,"6 de julio de 1997"
30,13,187,4089,269,249,518,"6 de julio de 1997"
30,13,187,4090,216,188,404,"6 de julio de 1997"
30,13,187,4091,373,308,681,"6 de julio de 1997"
30,13,187,4092,310,298,608,"6 de julio de 1997"
30,13,187,4093,480,485,965,"6 de julio de 1997"
30,13,187,4094,202,190,392,"6 de julio de 1997"
30,13,187,4095,476,411,887,"6 de julio de 1997"
30,13,200,4561,378,343,721,"6 de julio de 1997"
30,13,200,4562,149,137,286,"6 de julio de 1997"
30,13,200,4563,351,322,673,"6 de julio de 1997"
30,13,200,4564,326,252,578,"6 de julio de 1997"
30,13,200,4565,685,552,1237,"6 de julio de 1997"
30,13,200,4566,478,434,912,"6 de julio de 1997"
30,13,200,4567,500,450,950,"6 de julio de 1997"
30,13,200,4568,303,261,564,"6 de julio de 1997"
30,13,200,4569,394,363,757,"6 de julio de 1997"
30,14,12,247,442,435,877,"6 de julio de 1997"
30,14,12,248,321,318,639,"6 de julio de 1997"
30,14,12,249,174,214,388,"6 de julio de 1997"
30,14,12,250,254,299,553,"6 de julio de 1997"
30,14,12,251,183,179,362,"6 de julio de 1997"
30,14,12,252,463,476,939,"6 de julio de 1997"
30,14,12,253,266,300,566,"6 de julio de 1997"
30,14,12,254,373,424,797,"6 de julio de 1997"
30,14,12,255,686,805,1491,"6 de julio de 1997"
30,14,12,256,408,462,870,"6 de julio de 1997"
30,14,12,257,505,536,1041,"6 de julio de 1997"
30,14,12,258,345,418,763,"6 de julio de 1997"
30,14,12,259,497,523,1020,"6 de julio de 1997"
30,14,12,260,621,703,1324,"6 de julio de 1997"
30,14,12,261,442,492,934,"6 de julio de 1997"
30,14,12,262,340,381,721,"6 de julio de 1997"
30,14,12,263,368,458,826,"6 de julio de 1997"
30,14,12,264,321,403,724,"6 de julio de 1997"
30,14,12,265,478,594,1072,"6 de julio de 1997"
30,14,12,266,162,157,319,"6 de julio de 1997"
30,14,12,267,239,285,524,"6 de julio de 1997"
30,14,12,268,315,389,704,"6 de julio de 1997"
30,14,12,269,152,108,260,"6 de julio de 1997"
30,14,12,270,298,328,626,"6 de julio de 1997"
30,14,12,271,873,365,1238,"6 de julio de 1997"
30,14,12,272,677,708,1385,"6 de julio de 1997"
30,14,12,273,234,237,471,"6 de julio de 1997"
30,14,12,274,311,299,610,"6 de julio de 1997"
30,14,12,275,205,226,431,"6 de julio de 1997"
30,14,12,276,508,492,1000,"6 de julio de 1997"
30,14,12,277,189,218,407,"6 de julio de 1997"
30,14,12,278,313,293,606,"6 de julio de 1997"
30,14,12,279,417,349,766,"6 de julio de 1997"
30,14,12,280,557,531,1088,"6 de julio de 1997"
30,14,12,281,272,221,493,"6 de julio de 1997"
30,14,12,282,548,530,1078,"6 de julio de 1997"
30,14,12,283,460,428,888,"6 de julio de 1997"
30,14,12,284,551,481,1032,"6 de julio de 1997"
30,14,12,285,144,135,279,"6 de julio de 1997"
30,14,12,286,157,126,283,"6 de julio de 1997"
30,14,29,492,432,531,963,"6 de julio de 1997"
30,14,29,493,418,557,975,"6 de julio de 1997"
30,14,29,494,448,573,1021,"6 de julio de 1997"
30,14,29,495,357,532,889,"6 de julio de 1997"
30,14,29,496,373,473,846,"6 de julio de 1997"
30,14,29,497,302,366,668,"6 de julio de 1997"
30,14,29,498,247,314,561,"6 de julio de 1997"
30,14,29,499,325,462,787,"6 de julio de 1997"
30,14,29,500,460,554,1014,"6 de julio de 1997"
30,14,29,501,329,360,689,"6 de julio de 1997"
30,14,29,502,339,473,812,"6 de julio de 1997"
30,14,29,503,316,409,725,"6 de julio de 1997"
30,14,29,504,399,459,858,"6 de julio de 1997"
30,14,29,505,399,469,868,"6 de julio de 1997"
30,14,29,506,722,865,1587,"6 de julio de 1997"
30,14,29,507,611,680,1291,"6 de julio de 1997"
30,14,29,508,711,798,1509,"6 de julio de 1997"
30,14,29,509,569,708,1277,"6 de julio de 1997"
30,14,29,510,536,624,1160,"6 de julio de 1997"
30,14,29,511,426,537,963,"6 de julio de 1997"
30,14,29,512,400,494,894,"6 de julio de 1997"
30,14,29,513,367,433,800,"6 de julio de 1997"
30,14,29,514,436,466,902,"6 de julio de 1997"
30,14,29,515,438,507,945,"6 de julio de 1997"
30,14,29,516,657,788,1445,"6 de julio de 1997"
30,14,29,517,610,668,1278,"6 de julio de 1997"
30,14,29,518,477,518,995,"6 de julio de 1997"
30,14,29,519,539,586,1125,"6 de julio de 1997"
30,14,29,520,571,660,1231,"6 de julio de 1997"
30,14,29,521,516,568,1084,"6 de julio de 1997"
30,14,29,522,684,781,1465,"6 de julio de 1997"
30,14,29,523,635,733,1368,"6 de julio de 1997"
30,14,29,524,585,656,1241,"6 de julio de 1997"
30,14,29,525,419,458,877,"6 de julio de 1997"
30,14,29,526,507,554,1061,"6 de julio de 1997"
30,14,29,527,342,448,790,"6 de julio de 1997"
30,14,29,528,218,235,453,"6 de julio de 1997"
30,14,29,529,730,829,1559,"6 de julio de 1997"
30,14,29,530,632,734,1366,"6 de julio de 1997"
30,14,29,531,352,443,795,"6 de julio de 1997"
30,14,29,532,366,426,792,"6 de julio de 1997"
30,14,29,533,464,523,987,"6 de julio de 1997"
30,14,29,534,422,521,943,"6 de julio de 1997"
30,14,29,535,347,401,748,"6 de julio de 1997"
30,14,29,536,522,583,1105,"6 de julio de 1997"
30,14,29,537,509,547,1056,"6 de julio de 1997"
30,14,29,538,289,345,634,"6 de julio de 1997"
30,14,29,539,247,280,527,"6 de julio de 1997"
30,14,29,540,314,391,705,"6 de julio de 1997"
30,14,29,541,528,566,1094,"6 de julio de 1997"
30,14,29,542,229,217,446,"6 de julio de 1997"
30,14,29,543,498,547,1045,"6 de julio de 1997"
30,14,29,544,426,527,953,"6 de julio de 1997"
30,14,29,545,310,388,698,"6 de julio de 1997"
30,14,29,546,402,154,556,"6 de julio de 1997"
30,14,29,547,228,256,484,"6 de julio de 1997"
30,14,29,548,376,437,813,"6 de julio de 1997"
30,14,29,549,349,430,779,"6 de julio de 1997"
30,14,29,550,398,446,844,"6 de julio de 1997"
30,14,29,551,344,388,732,"6 de julio de 1997"
30,14,29,552,392,448,840,"6 de julio de 1997"
30,14,29,553,258,283,541,"6 de julio de 1997"
30,14,29,554,381,432,813,"6 de julio de 1997"
30,14,29,555,299,340,639,"6 de julio de 1997"
30,14,29,556,383,449,832,"6 de julio de 1997"
30,14,29,557,366,452,818,"6 de julio de 1997"
30,14,29,558,351,386,737,"6 de julio de 1997"
30,14,29,559,434,506,940,"6 de julio de 1997"
30,14,29,560,439,475,914,"6 de julio de 1997"
30,14,29,561,447,536,983,"6 de julio de 1997"
30,14,29,562,431,552,983,"6 de julio de 1997"
30,14,29,563,336,387,723,"6 de julio de 1997"
30,14,29,564,434,496,930,"6 de julio de 1997"
30,14,29,565,462,501,963,"6 de julio de 1997"
30,14,29,566,289,339,628,"6 de julio de 1997"
30,14,29,567,440,536,976,"6 de julio de 1997"
30,14,29,568,505,565,1070,"6 de julio de 1997"
30,14,29,569,376,416,792,"6 de julio de 1997"
30,14,29,570,869,1108,1977,"6 de julio de 1997"
30,14,29,571,514,628,1142,"6 de julio de 1997"
30,14,29,572,262,304,566,"6 de julio de 1997"
30,14,29,573,518,623,1141,"6 de julio de 1997"
30,14,29,574,362,393,755,"6 de julio de 1997"
30,14,29,575,267,293,560,"6 de julio de 1997"
30,14,29,576,434,492,926,"6 de julio de 1997"
30,14,29,577,521,677,1198,"6 de julio de 1997"
30,14,29,578,291,347,638,"6 de julio de 1997"
30,14,29,579,272,364,636,"6 de julio de 1997"
30,14,29,580,340,377,717,"6 de julio de 1997"
30,14,29,581,713,781,1494,"6 de julio de 1997"
30,14,29,582,310,361,671,"6 de julio de 1997"
30,14,29,583,275,312,587,"6 de julio de 1997"
30,14,29,584,407,471,878,"6 de julio de 1997"
30,14,29,585,543,621,1164,"6 de julio de 1997"
30,14,29,586,567,598,1165,"6 de julio de 1997"
30,14,29,587,463,538,1001,"6 de julio de 1997"
30,14,77,1672,309,381,690,"6 de julio de 1997"
30,14,77,1673,298,411,709,"6 de julio de 1997"
30,14,77,1674,423,527,950,"6 de julio de 1997"
30,14,77,1675,387,389,776,"6 de julio de 1997"
30,14,77,1676,279,296,575,"6 de julio de 1997"
30,14,77,1677,391,367,758,"6 de julio de 1997"
30,14,77,1678,326,266,592,"6 de julio de 1997"
30,14,77,1679,235,219,454,"6 de julio de 1997"
30,14,77,1680,535,486,1021,"6 de julio de 1997"
30,14,77,1681,292,275,567,"6 de julio de 1997"
30,14,77,1682,325,290,615,"6 de julio de 1997"
30,14,77,1683,104,77,181,"6 de julio de 1997"
30,14,77,1684,559,528,1087,"6 de julio de 1997"
30,14,77,1685,522,490,1012,"6 de julio de 1997"
30,14,77,1686,386,391,777,"6 de julio de 1997"
30,14,77,1687,46,49,95,"6 de julio de 1997"
30,14,92,2138,529,532,1061,"6 de julio de 1997"
30,14,92,2139,273,341,614,"6 de julio de 1997"
30,14,92,2140,489,521,1010,"6 de julio de 1997"
30,14,92,2141,209,180,389,"6 de julio de 1997"
30,14,92,2142,524,445,969,"6 de julio de 1997"
30,14,92,2143,131,111,242,"6 de julio de 1997"
30,14,92,2144,446,452,898,"6 de julio de 1997"
30,14,92,2145,337,315,652,"6 de julio de 1997"
30,14,101,2249,425,476,901,"6 de julio de 1997"
30,14,101,2250,371,401,772,"6 de julio de 1997"
30,14,101,2251,307,347,654,"6 de julio de 1997"
30,14,101,2252,265,289,554,"6 de julio de 1997"
30,14,101,2253,470,411,881,"6 de julio de 1997"
30,14,101,2254,536,471,1007,"6 de julio de 1997"
30,14,101,2255,414,370,784,"6 de julio de 1997"
30,14,101,2256,306,308,614,"6 de julio de 1997"
30,14,101,2257,471,439,910,"6 de julio de 1997"
30,14,101,2258,481,464,945,"6 de julio de 1997"
30,14,101,2259,356,344,700,"6 de julio de 1997"
30,14,101,2260,235,236,471,"6 de julio de 1997"
30,14,101,2261,321,304,625,"6 de julio de 1997"
30,14,101,2262,481,445,926,"6 de julio de 1997"
30,14,101,2263,501,430,931,"6 de julio de 1997"
30,14,101,2264,661,594,1255,"6 de julio de 1997"
30,14,106,2390,544,583,1127,"6 de julio de 1997"
30,14,106,2391,510,458,968,"6 de julio de 1997"
30,14,106,2392,371,434,805,"6 de julio de 1997"
30,14,106,2393,360,390,750,"6 de julio de 1997"
30,14,106,2394,408,468,876,"6 de julio de 1997"
30,14,106,2395,183,208,391,"6 de julio de 1997"
30,14,106,2396,421,482,903,"6 de julio de 1997"
30,14,106,2397,596,644,1240,"6 de julio de 1997"
30,14,106,2398,381,415,796,"6 de julio de 1997"
30,14,106,2399,331,427,758,"6 de julio de 1997"
30,14,106,2400,293,308,601,"6 de julio de 1997"
30,14,106,2401,437,428,865,"6 de julio de 1997"
30,14,106,2402,423,400,823,"6 de julio de 1997"
30,14,106,2403,482,448,930,"6 de julio de 1997"
30,14,106,2404,342,375,717,"6 de julio de 1997"
30,14,106,2405,548,586,1134,"6 de julio de 1997"
30,14,106,2406,343,358,701,"6 de julio de 1997"
30,14,106,2407,352,346,698,"6 de julio de 1997"
30,14,106,2408,336,306,642,"6 de julio de 1997"
30,14,106,2409,570,607,1177,"6 de julio de 1997"
30,14,106,2410,325,341,666,"6 de julio de 1997"
30,14,106,2411,696,646,1342,"6 de julio de 1997"
30,14,106,2412,140,119,259,"6 de julio de 1997"
30,14,106,2413,194,199,393,"6 de julio de 1997"
30,14,106,2414,224,195,419,"6 de julio de 1997"
30,14,180,4010,544,578,1122,"6 de julio de 1997"
30,14,180,4011,445,476,921,"6 de julio de 1997"
30,14,180,4012,617,565,1182,"6 de julio de 1997"
30,14,180,4013,355,363,718,"6 de julio de 1997"
30,14,180,4014,521,515,1036,"6 de julio de 1997"
30,14,180,4015,331,283,614,"6 de julio de 1997"
30,14,180,4016,456,371,827,"6 de julio de 1997"
30,14,180,4017,422,391,813,"6 de julio de 1997"
30,14,180,4018,313,340,653,"6 de julio de 1997"
30,14,180,4019,288,330,618,"6 de julio de 1997"
30,14,180,4020,394,436,830,"6 de julio de 1997"
30,14,180,4021,367,357,724,"6 de julio de 1997"
30,14,180,4022,385,435,820,"6 de julio de 1997"
30,14,180,4023,324,344,668,"6 de julio de 1997"
30,14,180,4024,280,281,561,"6 de julio de 1997"
30,14,180,4025,511,518,1029,"6 de julio de 1997"
30,14,180,4026,613,558,1171,"6 de julio de 1997"
30,14,180,4027,397,363,760,"6 de julio de 1997"
30,14,180,4028,210,190,400,"6 de julio de 1997"
30,14,180,4029,309,275,584,"6 de julio de 1997"
30,14,180,4030,413,313,726,"6 de julio de 1997"
30,14,180,4031,269,231,500,"6 de julio de 1997"
30,14,180,4032,415,385,800,"6 de julio de 1997"
30,14,180,4033,567,569,1136,"6 de julio de 1997"
30,14,180,4034,557,549,1106,"6 de julio de 1997"
30,14,180,4035,620,583,1203,"6 de julio de 1997"
30,14,180,4036,570,548,1118,"6 de julio de 1997"
30,15,19,389,395,409,804,"6 de julio de 1997"
30,15,23,414,228,215,443,"6 de julio de 1997"
30,15,23,415,418,448,866,"6 de julio de 1997"
30,15,23,416,337,317,654,"6 de julio de 1997"
30,15,23,417,473,473,946,"6 de julio de 1997"
30,15,23,418,375,392,767,"6 de julio de 1997"
30,15,23,419,346,271,617,"6 de julio de 1997"
30,15,23,420,416,390,806,"6 de julio de 1997"
30,15,23,421,361,364,725,"6 de julio de 1997"
30,15,23,422,241,219,460,"6 de julio de 1997"
30,15,23,423,573,521,1094,"6 de julio de 1997"
30,15,23,424,311,302,613,"6 de julio de 1997"
30,15,76,1668,264,292,556,"6 de julio de 1997"
30,15,76,1669,369,402,771,"6 de julio de 1997"
30,15,76,1670,398,410,808,"6 de julio de 1997"
30,15,76,1671,399,424,823,"6 de julio de 1997"
30,15,85,1784,484,431,915,"6 de julio de 1997"
30,15,85,1785,281,274,555,"6 de julio de 1997"
30,15,85,1786,197,222,419,"6 de julio de 1997"
30,15,85,1787,272,240,512,"6 de julio de 1997"
30,15,85,1788,354,327,681,"6 de julio de 1997"
30,15,85,1789,745,851,1596,"6 de julio de 1997"
30,15,85,1790,132,141,273,"6 de julio de 1997"
30,15,87,1798,448,494,942,"6 de julio de 1997"
30,15,87,1799,573,601,1174,"6 de julio de 1997"
30,15,87,1800,407,419,826,"6 de julio de 1997"
30,15,87,1801,147,113,260,"6 de julio de 1997"
30,15,87,1802,386,375,761,"6 de julio de 1997"
30,15,87,1803,450,510,960,"6 de julio de 1997"
30,15,87,1804,505,488,993,"6 de julio de 1997"
30,15,87,1805,230,233,463,"6 de julio de 1997"
30,15,87,1806,492,515,1007,"6 de julio de 1997"
30,15,87,1807,513,539,1052,"6 de julio de 1997"
30,15,87,1808,676,680,1356,"6 de julio de 1997"
30,15,87,1809,740,772,1512,"6 de julio de 1997"
30,15,87,1810,874,963,1837,"6 de julio de 1997"
30,15,87,1811,310,345,655,"6 de julio de 1997"
30,15,87,1812,596,617,1213,"6 de julio de 1997"
30,15,87,1813,289,325,614,"6 de julio de 1997"
30,15,87,1814,354,393,747,"6 de julio de 1997"
30,15,87,1815,366,426,792,"6 de julio de 1997"
30,15,87,1816,316,325,641,"6 de julio de 1997"
30,15,87,1817,367,374,741,"6 de julio de 1997"
30,15,87,1818,391,448,839,"6 de julio de 1997"
30,15,87,1819,115,138,253,"6 de julio de 1997"
30,15,87,1820,177,178,355,"6 de julio de 1997"
30,15,87,1821,227,211,438,"6 de julio de 1997"
30,15,87,1822,569,552,1121,"6 de julio de 1997"
30,15,87,1823,518,525,1043,"6 de julio de 1997"
30,15,87,1824,605,543,1148,"6 de julio de 1997"
30,15,87,1825,229,228,457,"6 de julio de 1997"
30,15,87,1826,44,45,89,"6 de julio de 1997"
30,15,87,1827,184,179,363,"6 de julio de 1997"
30,15,87,1828,675,635,1310,"6 de julio de 1997"
30,15,87,1829,339,346,685,"6 de julio de 1997"
30,15,100,2240,482,521,1003,"6 de julio de 1997"
30,15,100,2241,491,572,1063,"6 de julio de 1997"
30,15,100,2242,548,556,1104,"6 de julio de 1997"
30,15,100,2243,542,583,1125,"6 de julio de 1997"
30,15,100,2244,544,592,1136,"6 de julio de 1997"
30,15,100,2245,374,370,744,"6 de julio de 1997"
30,15,100,2246,261,260,521,"6 de julio de 1997"
30,15,100,2247,79,56,135,"6 de julio de 1997"
30,15,100,2248,45,42,87,"6 de julio de 1997"
30,15,102,2265,609,614,1223,"6 de julio de 1997"
30,15,102,2266,313,295,608,"6 de julio de 1997"
30,15,102,2267,252,208,460,"6 de julio de 1997"
30,15,102,2268,401,363,764,"6 de julio de 1997"
30,15,102,2269,216,217,433,"6 de julio de 1997"
30,15,102,2270,465,475,940,"6 de julio de 1997"
30,15,102,2271,251,208,459,"6 de julio de 1997"
30,15,102,2272,321,287,608,"6 de julio de 1997"
30,15,102,2273,326,311,637,"6 de julio de 1997"
30,15,102,2274,223,284,507,"6 de julio de 1997"
30,15,102,2275,242,290,532,"6 de julio de 1997"
30,15,102,2276,277,348,625,"6 de julio de 1997"
30,15,102,2277,375,468,843,"6 de julio de 1997"
30,15,102,2278,328,400,728,"6 de julio de 1997"
30,15,102,2279,360,459,819,"6 de julio de 1997"
30,15,102,2280,865,970,1835,"6 de julio de 1997"
30,15,116,2621,596,650,1246,"6 de julio de 1997"
30,15,116,2622,498,525,1023,"6 de julio de 1997"
30,15,116,2623,394,453,847,"6 de julio de 1997"
30,15,116,2624,662,732,1394,"6 de julio de 1997"
30,15,116,2625,880,1001,1881,"6 de julio de 1997"
30,15,116,2626,635,699,1334,"6 de julio de 1997"
30,15,116,2627,519,571,1090,"6 de julio de 1997"
30,15,116,2628,482,603,1085,"6 de julio de 1997"
30,15,116,2629,606,661,1267,"6 de julio de 1997"
30,15,116,2630,514,614,1128,"6 de julio de 1997"
30,15,116,2631,403,561,964,"6 de julio de 1997"
30,15,116,2632,526,571,1097,"6 de julio de 1997"
30,15,116,2633,844,884,1728,"6 de julio de 1997"
30,15,116,2634,737,782,1519,"6 de julio de 1997"
30,15,116,2635,643,673,1316,"6 de julio de 1997"
30,15,116,2636,654,734,1388,"6 de julio de 1997"
30,15,116,2637,384,375,759,"6 de julio de 1997"
30,15,116,2638,611,506,1117,"6 de julio de 1997"
30,15,116,2639,279,261,540,"6 de julio de 1997"
30,15,119,2666,641,738,1379,"6 de julio de 1997"
30,15,119,2667,350,398,748,"6 de julio de 1997"
30,15,119,2668,348,361,709,"6 de julio de 1997"
30,15,119,2669,121,130,251,"6 de julio de 1997"
30,15,119,2670,445,535,980,"6 de julio de 1997"
30,15,119,2671,300,335,635,"6 de julio de 1997"
30,15,119,2672,362,423,785,"6 de julio de 1997"
30,15,119,2673,343,404,747,"6 de julio de 1997"
30,15,119,2674,340,385,725,"6 de julio de 1997"
30,15,119,2675,449,486,935,"6 de julio de 1997"
30,15,119,2676,370,466,836,"6 de julio de 1997"
30,15,119,2677,431,526,957,"6 de julio de 1997"
30,15,119,2678,486,572,1058,"6 de julio de 1997"
30,15,119,2679,611,691,1302,"6 de julio de 1997"
30,15,119,2680,452,487,939,"6 de julio de 1997"
30,15,119,2681,366,425,791,"6 de julio de 1997"
30,15,119,2682,148,183,331,"6 de julio de 1997"
30,15,119,2683,354,397,751,"6 de julio de 1997"
30,15,119,2684,531,591,1122,"6 de julio de 1997"
30,15,119,2685,800,947,1747,"6 de julio de 1997"
30,15,119,2686,666,715,1381,"6 de julio de 1997"
30,15,119,2687,292,340,632,"6 de julio de 1997"
30,15,119,2688,349,403,752,"6 de julio de 1997"
30,15,119,2689,373,466,839,"6 de julio de 1997"
30,15,119,2690,350,371,721,"6 de julio de 1997"
30,15,119,2691,335,360,695,"6 de julio de 1997"
30,15,119,2692,288,303,591,"6 de julio de 1997"
30,15,119,2693,435,508,943,"6 de julio de 1997"
30,15,119,2694,287,335,622,"6 de julio de 1997"
30,15,119,2695,379,426,805,"6 de julio de 1997"
30,15,119,2696,249,267,516,"6 de julio de 1997"
30,15,119,2697,232,272,504,"6 de julio de 1997"
30,15,119,2698,395,450,845,"6 de julio de 1997"
30,15,119,2699,371,403,774,"6 de julio de 1997"
30,15,119,2700,248,269,517,"6 de julio de 1997"
30,15,119,2701,375,409,784,"6 de julio de 1997"
30,15,119,2702,460,554,1014,"6 de julio de 1997"
30,15,119,2703,218,248,466,"6 de julio de 1997"
30,15,119,2704,452,531,983,"6 de julio de 1997"
30,15,119,2705,382,446,828,"6 de julio de 1997"
30,15,119,2706,174,227,401,"6 de julio de 1997"
30,15,119,2707,238,287,525,"6 de julio de 1997"
30,15,119,2708,532,637,1169,"6 de julio de 1997"
30,15,119,2709,234,266,500,"6 de julio de 1997"
30,15,119,2710,199,241,440,"6 de julio de 1997"
30,15,119,2711,414,468,882,"6 de julio de 1997"
30,15,119,2712,388,491,879,"6 de julio de 1997"
30,15,119,2713,391,476,867,"6 de julio de 1997"
30,15,119,2714,240,289,529,"6 de julio de 1997"
30,15,119,2715,239,393,632,"6 de julio de 1997"
30,15,119,2716,757,935,1692,"6 de julio de 1997"
30,15,119,2717,379,387,766,"6 de julio de 1997"
30,15,119,2718,651,685,1336,"6 de julio de 1997"
30,15,119,2719,604,654,1258,"6 de julio de 1997"
30,15,119,2720,222,228,450,"6 de julio de 1997"
30,15,119,2721,524,641,1165,"6 de julio de 1997"
30,15,119,2722,384,420,804,"6 de julio de 1997"
30,15,119,2723,286,336,622,"6 de julio de 1997"
30,15,119,2724,546,576,1122,"6 de julio de 1997"
30,15,119,2725,446,506,952,"6 de julio de 1997"
30,15,119,2726,486,633,1119,"6 de julio de 1997"
30,15,119,2727,178,224,402,"6 de julio de 1997"
30,15,119,2728,295,406,701,"6 de julio de 1997"
30,15,119,2729,470,539,1009,"6 de julio de 1997"
30,15,119,2730,331,405,736,"6 de julio de 1997"
30,15,119,2731,309,336,645,"6 de julio de 1997"
30,15,119,2732,355,426,781,"6 de julio de 1997"
30,15,119,2733,299,371,670,"6 de julio de 1997"
30,15,119,2734,124,154,278,"6 de julio de 1997"
30,15,119,2735,281,396,677,"6 de julio de 1997"
30,15,119,2736,274,348,622,"6 de julio de 1997"
30,15,119,2737,201,222,423,"6 de julio de 1997"
30,15,119,2738,324,409,733,"6 de julio de 1997"
30,15,119,2739,323,432,755,"6 de julio de 1997"
30,15,119,2740,337,429,766,"6 de julio de 1997"
30,15,119,2741,245,280,525,"6 de julio de 1997"
30,15,119,2742,635,683,1318,"6 de julio de 1997"
30,15,119,2743,498,560,1058,"6 de julio de 1997"
30,15,119,2744,183,214,397,"6 de julio de 1997"
30,15,119,2745,389,444,833,"6 de julio de 1997"
30,15,119,2746,316,390,706,"6 de julio de 1997"
30,15,119,2747,669,779,1448,"6 de julio de 1997"
30,15,119,2748,393,436,829,"6 de julio de 1997"
30,15,119,2749,273,326,599,"6 de julio de 1997"
30,15,119,2750,231,307,538,"6 de julio de 1997"
30,15,119,2751,371,444,815,"6 de julio de 1997"
30,15,119,2752,500,538,1038,"6 de julio de 1997"
30,15,119,2753,390,450,840,"6 de julio de 1997"
30,15,119,2754,390,426,816,"6 de julio de 1997"
30,15,119,2755,299,349,648,"6 de julio de 1997"
30,15,119,2756,347,408,755,"6 de julio de 1997"
30,15,119,2757,502,557,1059,"6 de julio de 1997"
30,15,119,2758,562,617,1179,"6 de julio de 1997"
30,15,119,2759,186,205,391,"6 de julio de 1997"
30,15,119,2760,565,610,1175,"6 de julio de 1997"
30,15,119,2761,524,554,1078,"6 de julio de 1997"
30,15,119,2762,434,513,947,"6 de julio de 1997"
30,15,119,2763,509,564,1073,"6 de julio de 1997"
30,15,128,3028,601,569,1170,"6 de julio de 1997"
30,15,128,3029,255,215,470,"6 de julio de 1997"
30,15,128,3030,211,185,396,"6 de julio de 1997"
30,15,128,3031,329,307,636,"6 de julio de 1997"
30,15,128,3032,487,474,961,"6 de julio de 1997"
30,15,128,3033,697,572,1269,"6 de julio de 1997"
30,15,128,3034,376,343,719,"6 de julio de 1997"
30,15,128,3035,350,331,681,"6 de julio de 1997"
30,15,135,3274,456,456,912,"6 de julio de 1997"
30,15,135,3275,390,356,746,"6 de julio de 1997"
30,15,135,3276,161,139,300,"6 de julio de 1997"
30,15,135,3277,599,612,1211,"6 de julio de 1997"
30,15,135,3278,79,84,163,"6 de julio de 1997"
30,15,135,3279,432,439,871,"6 de julio de 1997"
30,15,135,3280,506,478,984,"6 de julio de 1997"
30,15,135,3281,289,296,585,"6 de julio de 1997"
30,15,135,3282,178,137,315,"6 de julio de 1997"
30,15,139,3297,618,673,1291,"6 de julio de 1997"
30,15,139,3298,637,698,1335,"6 de julio de 1997"
30,15,139,3299,787,935,1722,"6 de julio de 1997"
30,15,139,3300,294,342,636,"6 de julio de 1997"
30,15,139,3301,574,670,1244,"6 de julio de 1997"
30,15,139,3302,644,707,1351,"6 de julio de 1997"
30,15,139,3303,557,651,1208,"6 de julio de 1997"
30,15,139,3304,702,778,1480,"6 de julio de 1997"
30,15,139,3305,589,691,1280,"6 de julio de 1997"
30,15,139,3306,340,377,717,"6 de julio de 1997"
30,15,139,3307,372,407,779,"6 de julio de 1997"
30,15,139,3308,447,480,927,"6 de julio de 1997"
30,15,139,3309,393,460,853,"6 de julio de 1997"
30,15,139,3310,451,511,962,"6 de julio de 1997"
30,15,139,3311,422,508,930,"6 de julio de 1997"
30,15,139,3312,665,747,1412,"6 de julio de 1997"
30,15,139,3313,526,573,1099,"6 de julio de 1997"
30,15,139,3314,502,555,1057,"6 de julio de 1997"
30,15,139,3315,195,217,412,"6 de julio de 1997"
30,15,139,3316,541,606,1147,"6 de julio de 1997"
30,15,139,3317,648,772,1420,"6 de julio de 1997"
30,15,139,3318,469,551,1020,"6 de julio de 1997"
30,15,139,3319,370,438,808,"6 de julio de 1997"
30,15,139,3320,439,473,912,"6 de julio de 1997"
30,15,184,4077,668,708,1376,"6 de julio de 1997"
30,15,184,4078,184,196,380,"6 de julio de 1997"
30,16,14,294,347,356,703,"6 de julio de 1997"
30,16,14,295,647,739,1386,"6 de julio de 1997"
30,16,14,296,513,541,1054,"6 de julio de 1997"
30,16,14,297,472,520,992,"6 de julio de 1997"
30,16,14,298,330,290,620,"6 de julio de 1997"
30,16,14,299,261,235,496,"6 de julio de 1997"
30,16,14,300,344,339,683,"6 de julio de 1997"
30,16,14,301,522,513,1035,"6 de julio de 1997"
30,16,14,302,86,87,173,"6 de julio de 1997"
30,16,14,303,325,380,705,"6 de julio de 1997"
30,16,14,304,345,401,746,"6 de julio de 1997"
30,16,14,305,771,811,1582,"6 de julio de 1997"
30,16,14,306,561,628,1189,"6 de julio de 1997"
30,16,14,307,678,694,1372,"6 de julio de 1997"
30,16,14,308,347,472,819,"6 de julio de 1997"
30,16,14,309,421,441,862,"6 de julio de 1997"
30,16,14,310,751,813,1564,"6 de julio de 1997"
30,16,14,311,218,216,434,"6 de julio de 1997"
30,16,14,312,366,386,752,"6 de julio de 1997"
30,16,14,313,278,301,579,"6 de julio de 1997"
30,16,14,314,180,206,386,"6 de julio de 1997"
30,16,14,315,465,513,978,"6 de julio de 1997"
30,16,14,316,268,237,505,"6 de julio de 1997"
30,16,14,317,381,395,776,"6 de julio de 1997"
30,16,14,318,563,640,1203,"6 de julio de 1997"
30,16,14,319,123,141,264,"6 de julio de 1997"
30,16,22,398,346,336,682,"6 de julio de 1997"
30,16,22,399,618,626,1244,"6 de julio de 1997"
30,16,22,400,389,345,734,"6 de julio de 1997"
30,16,22,401,277,245,522,"6 de julio de 1997"
30,16,22,402,189,177,366,"6 de julio de 1997"
30,16,22,403,305,236,541,"6 de julio de 1997"
30,16,22,404,140,108,248,"6 de julio de 1997"
30,16,22,405,740,806,1546,"6 de julio de 1997"
30,16,22,406,449,531,980,"6 de julio de 1997"
30,16,22,407,484,501,985,"6 de julio de 1997"
30,16,22,408,780,821,1601,"6 de julio de 1997"
30,16,22,409,694,790,1484,"6 de julio de 1997"
30,16,22,410,534,594,1128,"6 de julio de 1997"
30,16,22,411,533,589,1122,"6 de julio de 1997"
30,16,22,412,266,296,562,"6 de julio de 1997"
30,16,22,413,229,216,445,"6 de julio de 1997"
30,16,32,609,441,411,852,"6 de julio de 1997"
30,16,32,610,688,627,1315,"6 de julio de 1997"
30,16,32,611,316,292,608,"6 de julio de 1997"
30,16,32,612,358,352,710,"6 de julio de 1997"
30,16,32,613,429,366,795,"6 de julio de 1997"
30,16,32,614,625,603,1228,"6 de julio de 1997"
30,16,32,615,526,488,1014,"6 de julio de 1997"
30,16,32,616,421,389,810,"6 de julio de 1997"
30,16,46,980,839,899,1738,"6 de julio de 1997"
30,16,46,981,603,663,1266,"6 de julio de 1997"
30,16,46,982,657,701,1358,"6 de julio de 1997"
30,16,46,983,469,506,975,"6 de julio de 1997"
30,16,46,984,569,649,1218,"6 de julio de 1997"
30,16,46,985,493,536,1029,"6 de julio de 1997"
30,16,46,986,613,678,1291,"6 de julio de 1997"
30,16,46,987,399,447,846,"6 de julio de 1997"
30,16,46,988,422,532,954,"6 de julio de 1997"
30,16,46,989,383,406,789,"6 de julio de 1997"
30,16,46,990,560,624,1184,"6 de julio de 1997"
30,16,46,991,375,520,895,"6 de julio de 1997"
30,16,46,992,460,504,964,"6 de julio de 1997"
30,16,46,993,234,286,520,"6 de julio de 1997"
30,16,46,994,363,391,754,"6 de julio de 1997"
30,16,46,995,394,433,827,"6 de julio de 1997"
30,16,46,996,445,497,942,"6 de julio de 1997"
30,16,46,997,397,509,906,"6 de julio de 1997"
30,16,46,998,451,502,953,"6 de julio de 1997"
30,16,46,999,326,370,696,"6 de julio de 1997"
30,16,46,1000,333,440,773,"6 de julio de 1997"
30,16,46,1001,573,660,1233,"6 de julio de 1997"
30,16,46,1002,469,523,992,"6 de julio de 1997"
30,16,46,1003,323,386,709,"6 de julio de 1997"
30,16,46,1004,240,296,536,"6 de julio de 1997"
30,16,46,1005,235,288,523,"6 de julio de 1997"
30,16,46,1006,319,356,675,"6 de julio de 1997"
30,16,46,1007,348,353,701,"6 de julio de 1997"
30,16,46,1008,477,547,1024,"6 de julio de 1997"
30,16,46,1009,322,350,672,"6 de julio de 1997"
30,16,46,1010,481,533,1014,"6 de julio de 1997"
30,16,46,1011,448,548,996,"6 de julio de 1997"
30,16,46,1012,293,300,593,"6 de julio de 1997"
30,16,46,1013,325,410,735,"6 de julio de 1997"
30,16,46,1014,488,554,1042,"6 de julio de 1997"
30,16,46,1015,252,328,580,"6 de julio de 1997"
30,16,46,1016,314,386,700,"6 de julio de 1997"
30,16,46,1017,374,440,814,"6 de julio de 1997"
30,16,46,1018,265,295,560,"6 de julio de 1997"
30,16,46,1019,488,598,1086,"6 de julio de 1997"
30,16,46,1020,237,315,552,"6 de julio de 1997"
30,16,46,1021,347,488,835,"6 de julio de 1997"
30,16,46,1022,423,553,976,"6 de julio de 1997"
30,16,46,1023,280,375,655,"6 de julio de 1997"
30,16,46,1024,238,355,593,"6 de julio de 1997"
30,16,46,1025,286,355,641,"6 de julio de 1997"
30,16,46,1026,351,405,756,"6 de julio de 1997"
30,16,46,1027,409,459,868,"6 de julio de 1997"
30,16,46,1028,462,566,1028,"6 de julio de 1997"
30,16,46,1029,510,613,1123,"6 de julio de 1997"
30,16,46,1030,760,885,1645,"6 de julio de 1997"
30,16,46,1031,519,586,1105,"6 de julio de 1997"
30,16,46,1032,534,572,1106,"6 de julio de 1997"
30,16,46,1033,591,630,1221,"6 de julio de 1997"
30,16,46,1034,587,685,1272,"6 de julio de 1997"
30,16,46,1035,418,494,912,"6 de julio de 1997"
30,16,46,1036,384,438,822,"6 de julio de 1997"
30,16,46,1037,362,395,757,"6 de julio de 1997"
30,16,46,1038,441,550,991,"6 de julio de 1997"
30,16,46,1039,380,453,833,"6 de julio de 1997"
30,16,46,1040,316,392,708,"6 de julio de 1997"
30,16,46,1041,376,409,785,"6 de julio de 1997"
30,16,46,1042,294,354,648,"6 de julio de 1997"
30,16,46,1043,473,550,1023,"6 de julio de 1997"
30,16,46,1044,207,274,481,"6 de julio de 1997"
30,16,46,1045,411,504,915,"6 de julio de 1997"
30,16,46,1046,244,292,536,"6 de julio de 1997"
30,16,46,1047,373,427,800,"6 de julio de 1997"
30,16,46,1048,426,465,891,"6 de julio de 1997"
30,16,46,1049,411,474,885,"6 de julio de 1997"
30,16,46,1050,583,676,1259,"6 de julio de 1997"
30,16,46,1051,491,597,1088,"6 de julio de 1997"
30,16,46,1052,221,309,530,"6 de julio de 1997"
30,16,46,1053,244,359,603,"6 de julio de 1997"
30,16,46,1054,424,563,987,"6 de julio de 1997"
30,16,46,1055,493,591,1084,"6 de julio de 1997"
30,16,46,1056,553,590,1143,"6 de julio de 1997"
30,16,46,1057,265,308,573,"6 de julio de 1997"
30,16,46,1058,350,389,739,"6 de julio de 1997"
30,16,46,1059,795,908,1703,"6 de julio de 1997"
30,16,46,1060,418,437,855,"6 de julio de 1997"
30,16,46,1061,349,435,784,"6 de julio de 1997"
30,16,46,1062,929,1066,1995,"6 de julio de 1997"
30,16,46,1063,361,408,769,"6 de julio de 1997"
30,16,46,1064,264,350,614,"6 de julio de 1997"
30,16,46,1065,432,476,908,"6 de julio de 1997"
30,16,46,1066,458,541,999,"6 de julio de 1997"
30,16,46,1067,287,357,644,"6 de julio de 1997"
30,16,46,1068,495,596,1091,"6 de julio de 1997"
30,16,46,1069,327,380,707,"6 de julio de 1997"
30,16,46,1070,243,310,553,"6 de julio de 1997"
30,16,46,1071,359,420,779,"6 de julio de 1997"
30,16,46,1072,609,739,1348,"6 de julio de 1997"
30,16,46,1073,431,525,956,"6 de julio de 1997"
30,16,46,1074,418,501,919,"6 de julio de 1997"
30,16,46,1075,409,368,777,"6 de julio de 1997"
30,16,46,1076,454,407,861,"6 de julio de 1997"
30,16,46,1077,382,341,723,"6 de julio de 1997"
30,16,46,1078,220,237,457,"6 de julio de 1997"
30,16,46,1079,517,514,1031,"6 de julio de 1997"
30,16,46,1080,329,255,584,"6 de julio de 1997"
30,16,46,1081,408,426,834,"6 de julio de 1997"
30,16,46,1082,311,329,640,"6 de julio de 1997"
30,16,46,1083,317,405,722,"6 de julio de 1997"
30,16,46,1084,683,706,1389,"6 de julio de 1997"
30,16,46,1085,407,397,804,"6 de julio de 1997"
30,16,46,1086,296,290,586,"6 de julio de 1997"
30,16,46,1087,429,454,883,"6 de julio de 1997"
30,16,46,1088,207,215,422,"6 de julio de 1997"
30,16,46,1089,1376,1775,3151,"6 de julio de 1997"
30,16,46,1090,269,297,566,"6 de julio de 1997"
30,16,46,1091,1206,1458,2664,"6 de julio de 1997"
30,16,46,1092,409,507,916,"6 de julio de 1997"
30,16,46,1093,430,444,874,"6 de julio de 1997"
30,16,55,1293,515,626,1141,"6 de julio de 1997"
30,16,55,1294,531,686,1217,"6 de julio de 1997"
30,16,55,1295,452,517,969,"6 de julio de 1997"
30,16,55,1296,311,352,663,"6 de julio de 1997"
30,16,55,1297,587,658,1245,"6 de julio de 1997"
30,16,55,1298,375,458,833,"6 de julio de 1997"
30,16,55,1299,456,557,1013,"6 de julio de 1997"
30,16,55,1300,448,473,921,"6 de julio de 1997"
30,16,55,1301,219,211,430,"6 de julio de 1997"
30,16,55,1302,608,719,1327,"6 de julio de 1997"
30,16,55,1303,302,295,597,"6 de julio de 1997"
30,16,55,1304,174,193,367,"6 de julio de 1997"
30,16,55,1305,435,484,919,"6 de julio de 1997"
30,16,55,1306,613,648,1261,"6 de julio de 1997"
30,16,55,1307,444,445,889,"6 de julio de 1997"
30,16,55,1308,48,53,101,"6 de julio de 1997"
30,16,55,1309,187,180,367,"6 de julio de 1997"
30,16,70,1529,363,409,772,"6 de julio de 1997"
30,16,70,1530,802,862,1664,"6 de julio de 1997"
30,16,70,1531,490,557,1047,"6 de julio de 1997"
30,16,70,1532,512,633,1145,"6 de julio de 1997"
30,16,70,1533,299,346,645,"6 de julio de 1997"
30,16,70,1534,453,571,1024,"6 de julio de 1997"
30,16,70,1535,395,445,840,"6 de julio de 1997"
30,16,70,1536,534,573,1107,"6 de julio de 1997"
30,16,70,1537,489,623,1112,"6 de julio de 1997"
30,16,70,1538,392,419,811,"6 de julio de 1997"
30,16,70,1539,474,473,947,"6 de julio de 1997"
30,16,70,1540,260,280,540,"6 de julio de 1997"
30,16,70,1541,521,590,1111,"6 de julio de 1997"
30,16,70,1542,745,835,1580,"6 de julio de 1997"
30,16,70,1543,530,575,1105,"6 de julio de 1997"
30,16,70,1544,456,485,941,"6 de julio de 1997"
30,16,70,1545,670,792,1462,"6 de julio de 1997"
30,16,70,1546,657,660,1317,"6 de julio de 1997"
30,16,70,1547,576,645,1221,"6 de julio de 1997"
30,16,70,1548,599,646,1245,"6 de julio de 1997"
30,16,70,1549,418,489,907,"6 de julio de 1997"
30,16,70,1550,444,537,981,"6 de julio de 1997"
30,16,70,1551,354,431,785,"6 de julio de 1997"
30,16,70,1552,531,626,1157,"6 de julio de 1997"
30,16,70,1553,406,426,832,"6 de julio de 1997"
30,16,70,1554,212,209,421,"6 de julio de 1997"
30,16,70,1555,258,266,524,"6 de julio de 1997"
30,16,114,2607,558,623,1181,"6 de julio de 1997"
30,16,114,2608,265,236,501,"6 de julio de 1997"
30,16,114,2609,191,179,370,"6 de julio de 1997"
30,16,196,4527,273,350,623,"6 de julio de 1997"
30,16,196,4528,334,415,749,"6 de julio de 1997"
30,16,196,4529,347,424,771,"6 de julio de 1997"
30,16,196,4530,393,424,817,"6 de julio de 1997"
30,16,196,4531,326,410,736,"6 de julio de 1997"
30,16,196,4532,365,409,774,"6 de julio de 1997"
30,16,196,4533,375,400,775,"6 de julio de 1997"
30,16,196,4534,268,319,587,"6 de julio de 1997"
30,16,196,4535,156,170,326,"6 de julio de 1997"
30,16,196,4536,193,227,420,"6 de julio de 1997"
30,16,196,4537,578,657,1235,"6 de julio de 1997"
30,16,196,4538,471,513,984,"6 de julio de 1997"
30,16,196,4539,731,734,1465,"6 de julio de 1997"
30,16,196,4540,298,329,627,"6 de julio de 1997"
30,17,5,85,461,491,952,"6 de julio de 1997"
30,17,5,86,387,383,770,"6 de julio de 1997"
30,17,5,87,101,76,177,"6 de julio de 1997"
30,17,5,88,124,99,223,"6 de julio de 1997"
30,17,5,89,158,122,280,"6 de julio de 1997"
30,17,5,90,138,155,293,"6 de julio de 1997"
30,17,5,91,266,215,481,"6 de julio de 1997"
30,17,13,287,473,544,1017,"6 de julio de 1997"
30,17,13,288,306,254,560,"6 de julio de 1997"
30,17,13,289,350,306,656,"6 de julio de 1997"
30,17,13,290,371,363,734,"6 de julio de 1997"
30,17,13,291,360,397,757,"6 de julio de 1997"
30,17,13,292,171,162,333,"6 de julio de 1997"
30,17,13,293,308,296,604,"6 de julio de 1997"
30,17,47,1094,381,390,771,"6 de julio de 1997"
30,17,47,1095,472,522,994,"6 de julio de 1997"
30,17,47,1096,416,436,852,"6 de julio de 1997"
30,17,47,1097,384,386,770,"6 de julio de 1997"
30,17,47,1098,295,345,640,"6 de julio de 1997"
30,17,47,1099,417,489,906,"6 de julio de 1997"
30,17,47,1100,465,512,977,"6 de julio de 1997"
30,17,47,1101,351,379,730,"6 de julio de 1997"
30,17,47,1102,385,470,855,"6 de julio de 1997"
30,17,47,1103,414,507,921,"6 de julio de 1997"
30,17,47,1104,366,431,797,"6 de julio de 1997"
30,17,47,1105,304,388,692,"6 de julio de 1997"
30,17,47,1106,432,544,976,"6 de julio de 1997"
30,17,47,1107,541,617,1158,"6 de julio de 1997"
30,17,47,1108,438,530,968,"6 de julio de 1997"
30,17,47,1109,325,368,693,"6 de julio de 1997"
30,17,47,1110,370,463,833,"6 de julio de 1997"
30,17,47,1111,510,566,1076,"6 de julio de 1997"
30,17,47,1112,381,439,820,"6 de julio de 1997"
30,17,47,1113,415,451,866,"6 de julio de 1997"
30,17,47,1114,451,471,922,"6 de julio de 1997"
30,17,47,1115,551,606,1157,"6 de julio de 1997"
30,17,47,1116,452,385,837,"6 de julio de 1997"
30,17,47,1117,399,346,745,"6 de julio de 1997"
30,17,47,1133,551,560,1111,"6 de julio de 1997"
30,17,47,1134,683,592,1275,"6 de julio de 1997"
30,17,47,1135,159,128,287,"6 de julio de 1997"
30,17,47,1136,111,112,223,"6 de julio de 1997"
30,17,47,1137,580,542,1122,"6 de julio de 1997"
30,17,47,1138,349,327,676,"6 de julio de 1997"
30,17,47,1139,333,319,652,"6 de julio de 1997"
30,17,47,1140,604,632,1236,"6 de julio de 1997"
30,17,47,1141,458,458,916,"6 de julio de 1997"
30,17,47,1142,430,437,867,"6 de julio de 1997"
30,17,47,1146,388,326,714,"6 de julio de 1997"
30,17,47,1147,455,461,916,"6 de julio de 1997"
30,17,47,1148,532,623,1155,"6 de julio de 1997"
30,17,47,1149,343,364,707,"6 de julio de 1997"
30,17,47,1150,463,471,934,"6 de julio de 1997"
30,17,47,1151,474,474,948,"6 de julio de 1997"
30,17,47,1152,246,225,471,"6 de julio de 1997"
30,17,56,1310,386,431,817,"6 de julio de 1997"
30,17,56,1311,444,491,935,"6 de julio de 1997"
30,17,56,1312,313,318,631,"6 de julio de 1997"
30,17,56,1313,376,360,736,"6 de julio de 1997"
30,17,56,1314,302,257,559,"6 de julio de 1997"
30,17,56,1315,207,188,395,"6 de julio de 1997"
30,17,56,1316,561,575,1136,"6 de julio de 1997"
30,17,56,1317,572,464,1036,"6 de julio de 1997"
30,17,56,1318,383,345,728,"6 de julio de 1997"
30,17,56,1319,374,316,690,"6 de julio de 1997"
30,17,86,1791,590,608,1198,"6 de julio de 1997"
30,17,86,1792,143,126,269,"6 de julio de 1997"
30,17,86,1793,210,177,387,"6 de julio de 1997"
30,17,86,1794,366,312,678,"6 de julio de 1997"
30,17,86,1795,172,143,315,"6 de julio de 1997"
30,17,86,1796,291,264,555,"6 de julio de 1997"
30,17,86,1797,259,255,514,"6 de julio de 1997"
30,17,120,2764,310,321,631,"6 de julio de 1997"
30,17,120,2765,402,437,839,"6 de julio de 1997"
30,17,120,2766,424,411,835,"6 de julio de 1997"
30,17,120,2767,433,454,887,"6 de julio de 1997"
30,17,120,2768,79,71,150,"6 de julio de 1997"
30,17,120,2769,134,85,219,"6 de julio de 1997"
30,17,173,3859,473,498,971,"6 de julio de 1997"
30,17,173,3860,229,250,479,"6 de julio de 1997"
30,17,173,3861,343,388,731,"6 de julio de 1997"
30,17,173,3862,519,648,1167,"6 de julio de 1997"
30,17,173,3863,614,712,1326,"6 de julio de 1997"
30,17,173,3864,314,389,703,"6 de julio de 1997"
30,17,173,3865,332,338,670,"6 de julio de 1997"
30,17,173,3866,330,349,679,"6 de julio de 1997"
30,17,173,3867,599,710,1309,"6 de julio de 1997"
30,17,173,3868,508,626,1134,"6 de julio de 1997"
30,17,173,3869,508,586,1094,"6 de julio de 1997"
30,17,173,3870,272,303,575,"6 de julio de 1997"
30,17,173,3871,612,715,1327,"6 de julio de 1997"
30,17,173,3872,446,538,984,"6 de julio de 1997"
30,17,173,3873,288,358,646,"6 de julio de 1997"
30,17,173,3874,261,253,514,"6 de julio de 1997"
30,17,173,3875,580,684,1264,"6 de julio de 1997"
30,17,173,3876,358,389,747,"6 de julio de 1997"
30,17,173,3877,397,505,902,"6 de julio de 1997"
30,17,173,3878,575,695,1270,"6 de julio de 1997"
30,17,173,3879,482,590,1072,"6 de julio de 1997"
30,17,173,3880,470,556,1026,"6 de julio de 1997"
30,17,173,3881,414,454,868,"6 de julio de 1997"
30,17,173,3882,588,643,1231,"6 de julio de 1997"
30,17,173,3883,633,751,1384,"6 de julio de 1997"
30,17,173,3884,254,333,587,"6 de julio de 1997"
30,17,173,3885,338,360,698,"6 de julio de 1997"
30,17,173,3886,622,685,1307,"6 de julio de 1997"
30,17,173,3887,402,450,852,"6 de julio de 1997"
30,17,173,3888,325,309,634,"6 de julio de 1997"
30,17,173,3889,253,241,494,"6 de julio de 1997"
30,17,173,3890,595,583,1178,"6 de julio de 1997"
30,17,173,3891,424,404,828,"6 de julio de 1997"
30,17,173,3892,468,425,893,"6 de julio de 1997"
30,17,173,3893,347,305,652,"6 de julio de 1997"
30,17,173,3894,354,314,668,"6 de julio de 1997"
30,17,173,3895,213,183,396,"6 de julio de 1997"
30,17,173,3896,727,711,1438,"6 de julio de 1997"
30,17,173,3897,427,413,840,"6 de julio de 1997"
30,17,173,3898,354,337,691,"6 de julio de 1997"
30,17,173,3899,527,522,1049,"6 de julio de 1997"
30,17,173,3900,509,520,1029,"6 de julio de 1997"
30,17,173,3901,269,220,489,"6 de julio de 1997"
30,17,173,3902,198,162,360,"6 de julio de 1997"
30,17,173,3903,267,262,529,"6 de julio de 1997"
30,17,173,3904,163,151,314,"6 de julio de 1997"
30,17,173,3905,403,374,777,"6 de julio de 1997"
30,17,173,3906,453,469,922,"6 de julio de 1997"
30,17,173,3907,537,421,958,"6 de julio de 1997"
30,17,173,3908,623,535,1158,"6 de julio de 1997"
30,17,173,3909,383,357,740,"6 de julio de 1997"
30,17,173,3910,290,252,542,"6 de julio de 1997"
30,17,173,3911,412,356,768,"6 de julio de 1997"
30,17,173,3912,88,83,171,"6 de julio de 1997"
30,17,173,3913,314,289,603,"6 de julio de 1997"
30,17,173,3914,343,328,671,"6 de julio de 1997"
30,17,173,3915,158,147,305,"6 de julio de 1997"
30,17,173,3916,138,98,236,"6 de julio de 1997"
30,17,173,3917,432,452,884,"6 de julio de 1997"
30,17,173,3918,316,291,607,"6 de julio de 1997"
30,17,173,3919,595,491,1086,"6 de julio de 1997"
30,17,173,3920,265,237,502,"6 de julio de 1997"
30,17,173,3921,291,261,552,"6 de julio de 1997"
30,17,173,3922,490,405,895,"6 de julio de 1997"
30,17,173,3923,539,527,1066,"6 de julio de 1997"
30,17,173,3924,129,147,276,"6 de julio de 1997"
30,17,173,3925,111,107,218,"6 de julio de 1997"
30,17,175,3975,470,426,896,"6 de julio de 1997"
30,17,175,3976,506,483,989,"6 de julio de 1997"
30,17,175,3977,321,343,664,"6 de julio de 1997"
30,17,175,3978,187,142,329,"6 de julio de 1997"
30,17,177,3985,470,478,948,"6 de julio de 1997"
30,17,177,3986,318,440,758,"6 de julio de 1997"
30,17,177,3987,338,423,761,"6 de julio de 1997"
30,17,177,3988,481,532,1013,"6 de julio de 1997"
30,17,177,3989,652,664,1316,"6 de julio de 1997"
30,17,177,3990,306,333,639,"6 de julio de 1997"
30,17,177,3991,312,380,692,"6 de julio de 1997"
30,17,177,3992,67,42,109,"6 de julio de 1997"
30,17,177,3993,140,115,255,"6 de julio de 1997"
30,17,177,3994,543,476,1019,"6 de julio de 1997"
30,17,177,3995,391,313,704,"6 de julio de 1997"
30,17,177,3996,388,318,706,"6 de julio de 1997"
30,17,177,3997,243,194,437,"6 de julio de 1997"
30,17,177,3998,217,180,397,"6 de julio de 1997"
30,17,189,4171,376,392,768,"6 de julio de 1997"
30,17,189,4172,402,395,797,"6 de julio de 1997"
30,17,204,4614,665,620,1285,"6 de julio de 1997"
30,17,204,4615,641,658,1299,"6 de julio de 1997"
30,17,204,4616,491,470,961,"6 de julio de 1997"
30,17,204,4617,330,366,696,"6 de julio de 1997"
30,17,204,4618,625,722,1347,"6 de julio de 1997"
30,17,204,4619,558,562,1120,"6 de julio de 1997"
30,17,204,4620,318,384,702,"6 de julio de 1997"
30,17,204,4621,344,350,694,"6 de julio de 1997"
30,17,204,4622,619,726,1345,"6 de julio de 1997"
30,17,204,4623,350,377,727,"6 de julio de 1997"
30,17,204,4624,535,551,1086,"6 de julio de 1997"
30,17,204,4625,291,302,593,"6 de julio de 1997"
30,17,204,4626,419,381,800,"6 de julio de 1997"
30,17,204,4627,366,297,663,"6 de julio de 1997"
30,17,204,4628,355,337,692,"6 de julio de 1997"
30,17,204,4629,117,102,219,"6 de julio de 1997"
30,17,204,4630,258,272,530,"6 de julio de 1997"
30,17,204,4631,317,301,618,"6 de julio de 1997"
30,17,204,4632,304,307,611,"6 de julio de 1997"
30,17,204,4633,288,323,611,"6 de julio de 1997"
30,17,204,4634,524,507,1031,"6 de julio de 1997"
30,17,204,4635,368,322,690,"6 de julio de 1997"
30,17,204,4636,165,133,298,"6 de julio de 1997"
30,17,204,4637,368,353,721,"6 de julio de 1997"
30,17,204,4638,288,279,567,"6 de julio de 1997"
30,17,204,4639,669,676,1345,"6 de julio de 1997"
30,17,204,4640,489,445,934,"6 de julio de 1997"
30,17,204,4641,372,319,691,"6 de julio de 1997"
30,17,204,4642,388,413,801,"6 de julio de 1997"
30,17,204,4643,335,423,758,"6 de julio de 1997"
30,17,204,4644,410,446,856,"6 de julio de 1997"
30,17,204,4645,105,97,202,"6 de julio de 1997"
30,17,204,4646,471,396,867,"6 de julio de 1997"
30,17,208,1118,265,281,546,"6 de julio de 1997"
30,17,208,1119,241,198,439,"6 de julio de 1997"
30,17,208,1120,528,628,1156,"6 de julio de 1997"
30,17,208,1121,300,349,649,"6 de julio de 1997"
30,17,208,1122,331,399,730,"6 de julio de 1997"
30,17,208,1123,225,262,487,"6 de julio de 1997"
30,17,208,1124,202,220,422,"6 de julio de 1997"
30,17,208,1125,272,325,597,"6 de julio de 1997"
30,17,208,1126,475,561,1036,"6 de julio de 1997"
30,17,208,1127,505,587,1092,"6 de julio de 1997"
30,17,208,1128,454,549,1003,"6 de julio de 1997"
30,17,208,1129,263,300,563,"6 de julio de 1997"
30,17,208,1130,434,482,916,"6 de julio de 1997"
30,17,208,1131,408,490,898,"6 de julio de 1997"
30,17,208,1132,491,521,1012,"6 de julio de 1997"
30,17,208,1143,263,262,525,"6 de julio de 1997"
30,17,208,1144,74,65,139,"6 de julio de 1997"
30,17,208,1145,233,215,448,"6 de julio de 1997"
30,17,208,4712,15,19,34,"6 de julio de 1997"
30,17,208,4713,70,67,137,"6 de julio de 1997"
30,18,6,92,691,698,1389,"6 de julio de 1997"
30,18,6,93,329,321,650,"6 de julio de 1997"
30,18,6,94,326,295,621,"6 de julio de 1997"
30,18,6,95,322,343,665,"6 de julio de 1997"
30,18,6,96,172,133,305,"6 de julio de 1997"
30,18,6,97,252,260,512,"6 de julio de 1997"
30,18,6,98,260,268,528,"6 de julio de 1997"
30,18,6,99,311,323,634,"6 de julio de 1997"
30,18,6,100,196,196,392,"6 de julio de 1997"
30,18,6,101,261,283,544,"6 de julio de 1997"
30,18,6,102,86,78,164,"6 de julio de 1997"
30,18,6,103,182,128,310,"6 de julio de 1997"
30,18,6,104,345,309,654,"6 de julio de 1997"
30,18,6,105,299,304,603,"6 de julio de 1997"
30,18,20,390,444,489,933,"6 de julio de 1997"
30,18,20,391,318,345,663,"6 de julio de 1997"
30,18,20,392,233,301,534,"6 de julio de 1997"
30,18,21,393,487,497,984,"6 de julio de 1997"
30,18,21,394,241,244,485,"6 de julio de 1997"
30,18,21,395,299,311,610,"6 de julio de 1997"
30,18,21,396,242,248,490,"6 de julio de 1997"
30,18,21,397,461,481,942,"6 de julio de 1997"
30,18,31,593,631,689,1320,"6 de julio de 1997"
30,18,31,594,517,551,1068,"6 de julio de 1997"
30,18,31,595,492,587,1079,"6 de julio de 1997"
30,18,31,596,388,424,812,"6 de julio de 1997"
30,18,31,597,447,517,964,"6 de julio de 1997"
30,18,31,598,411,481,892,"6 de julio de 1997"
30,18,31,599,611,698,1309,"6 de julio de 1997"
30,18,31,600,622,670,1292,"6 de julio de 1997"
30,18,31,601,724,823,1547,"6 de julio de 1997"
30,18,31,602,784,889,1673,"6 de julio de 1997"
30,18,31,603,554,684,1238,"6 de julio de 1997"
30,18,31,604,668,799,1467,"6 de julio de 1997"
30,18,31,605,587,722,1309,"6 de julio de 1997"
30,18,31,606,374,397,771,"6 de julio de 1997"
30,18,31,607,349,233,582,"6 de julio de 1997"
30,18,31,608,528,349,877,"6 de julio de 1997"
30,18,43,961,305,334,639,"6 de julio de 1997"
30,18,43,962,184,170,354,"6 de julio de 1997"
30,18,54,1286,522,582,1104,"6 de julio de 1997"
30,18,54,1287,417,419,836,"6 de julio de 1997"
30,18,54,1288,494,466,960,"6 de julio de 1997"
30,18,54,1289,325,319,644,"6 de julio de 1997"
30,18,54,1290,469,521,990,"6 de julio de 1997"
30,18,54,1291,652,693,1345,"6 de julio de 1997"
30,18,54,1292,235,244,479,"6 de julio de 1997"
30,18,99,2237,386,378,764,"6 de julio de 1997"
30,18,99,2238,67,66,133,"6 de julio de 1997"
30,18,99,2239,70,73,143,"6 de julio de 1997"
30,18,111,2578,390,364,754,"6 de julio de 1997"
30,18,111,2579,485,443,928,"6 de julio de 1997"
30,18,111,2580,351,306,657,"6 de julio de 1997"
30,18,111,2581,387,326,713,"6 de julio de 1997"
30,18,111,2582,482,401,883,"6 de julio de 1997"
30,18,118,2650,458,467,925,"6 de julio de 1997"
30,18,118,2651,516,591,1107,"6 de julio de 1997"
30,18,118,2652,319,394,713,"6 de julio de 1997"
30,18,118,2653,224,206,430,"6 de julio de 1997"
30,18,118,2654,191,173,364,"6 de julio de 1997"
30,18,118,2655,371,328,699,"6 de julio de 1997"
30,18,118,2656,428,421,849,"6 de julio de 1997"
30,18,118,2657,315,292,607,"6 de julio de 1997"
30,18,118,2658,382,411,793,"6 de julio de 1997"
30,18,118,2659,152,137,289,"6 de julio de 1997"
30,18,118,2660,488,489,977,"6 de julio de 1997"
30,18,118,2661,528,481,1009,"6 de julio de 1997"
30,18,118,2662,508,532,1040,"6 de julio de 1997"
30,18,118,2663,416,374,790,"6 de julio de 1997"
30,18,118,2664,555,556,1111,"6 de julio de 1997"
30,18,118,2665,293,263,556,"6 de julio de 1997"
30,18,138,3294,474,449,923,"6 de julio de 1997"
30,18,138,3295,212,190,402,"6 de julio de 1997"
30,18,138,3296,304,262,566,"6 de julio de 1997"
30,18,141,3326,366,366,732,"6 de julio de 1997"
30,18,141,3327,94,83,177,"6 de julio de 1997"
30,18,148,3504,489,465,954,"6 de julio de 1997"
30,18,148,3505,347,341,688,"6 de julio de 1997"
30,18,148,3506,320,296,616,"6 de julio de 1997"
30,18,148,3507,351,287,638,"6 de julio de 1997"
30,18,148,3508,687,780,1467,"6 de julio de 1997"
30,18,148,3509,116,131,247,"6 de julio de 1997"
30,18,148,3510,402,391,793,"6 de julio de 1997"
30,18,148,3511,395,322,717,"6 de julio de 1997"
30,18,148,3512,170,178,348,"6 de julio de 1997"
30,18,159,3699,523,499,1022,"6 de julio de 1997"
30,18,159,3700,601,622,1223,"6 de julio de 1997"
30,18,159,3701,562,604,1166,"6 de julio de 1997"
30,18,159,3702,299,278,577,"6 de julio de 1997"
30,18,159,3703,371,370,741,"6 de julio de 1997"
30,18,159,3704,367,367,734,"6 de julio de 1997"
30,18,159,3705,788,745,1533,"6 de julio de 1997"
30,18,167,3772,472,474,946,"6 de julio de 1997"
30,18,167,3773,610,593,1203,"6 de julio de 1997"
30,18,167,3774,105,78,183,"6 de julio de 1997"
30,18,167,3775,128,117,245,"6 de julio de 1997"
30,18,167,3776,318,282,600,"6 de julio de 1997"
30,18,167,3777,449,440,889,"6 de julio de 1997"
30,18,167,3778,306,257,563,"6 de julio de 1997"
30,18,167,3779,210,185,395,"6 de julio de 1997"
30,18,170,3804,429,423,852,"6 de julio de 1997"
30,18,170,3805,492,448,940,"6 de julio de 1997"
30,18,170,3806,111,85,196,"6 de julio de 1997"
30,18,170,3807,130,102,232,"6 de julio de 1997"
30,18,172,3824,505,502,1007,"6 de julio de 1997"
30,18,172,3825,535,620,1155,"6 de julio de 1997"
30,18,172,3826,491,502,993,"6 de julio de 1997"
30,18,172,3827,353,317,670,"6 de julio de 1997"
30,18,172,3828,461,376,837,"6 de julio de 1997"
30,18,172,3829,366,320,686,"6 de julio de 1997"
30,18,172,3830,382,335,717,"6 de julio de 1997"
30,18,172,3831,467,482,949,"6 de julio de 1997"
30,18,172,3832,455,475,930,"6 de julio de 1997"
30,18,172,3833,597,619,1216,"6 de julio de 1997"
30,18,172,3834,615,511,1126,"6 de julio de 1997"
30,18,172,3835,66,51,117,"6 de julio de 1997"
30,18,172,3836,534,527,1061,"6 de julio de 1997"
30,18,172,3837,626,603,1229,"6 de julio de 1997"
30,18,172,3838,129,123,252,"6 de julio de 1997"
30,18,172,3839,656,565,1221,"6 de julio de 1997"
30,18,172,3840,270,245,515,"6 de julio de 1997"
30,18,172,3841,178,135,313,"6 de julio de 1997"
30,18,172,3842,125,99,224,"6 de julio de 1997"
30,18,172,3843,638,655,1293,"6 de julio de 1997"
30,18,172,3844,410,360,770,"6 de julio de 1997"
30,18,172,3845,602,515,1117,"6 de julio de 1997"
30,18,172,3846,259,253,512,"6 de julio de 1997"
30,18,172,3847,375,398,773,"6 de julio de 1997"
30,18,172,3848,146,150,296,"6 de julio de 1997"
30,18,172,3849,649,651,1300,"6 de julio de 1997"
30,18,172,3850,309,274,583,"6 de julio de 1997"
30,18,172,3851,331,324,655,"6 de julio de 1997"
30,18,172,3852,475,436,911,"6 de julio de 1997"
30,18,172,3853,307,314,621,"6 de julio de 1997"
30,18,172,3854,253,261,514,"6 de julio de 1997"
30,18,172,3855,562,568,1130,"6 de julio de 1997"
30,18,172,3856,293,284,577,"6 de julio de 1997"
30,18,172,3857,423,353,776,"6 de julio de 1997"
30,18,172,3858,175,138,313,"6 de julio de 1997"
30,18,183,4074,702,724,1426,"6 de julio de 1997"
30,18,183,4075,314,323,637,"6 de julio de 1997"
30,18,183,4076,238,217,455,"6 de julio de 1997"
30,18,195,4525,794,737,1531,"6 de julio de 1997"
30,18,195,4526,183,137,320,"6 de julio de 1997"
30,18,201,4570,498,544,1042,"6 de julio de 1997"
30,18,201,4571,765,867,1632,"6 de julio de 1997"
30,18,201,4572,305,384,689,"6 de julio de 1997"
30,18,201,4573,311,304,615,"6 de julio de 1997"
30,18,201,4574,427,402,829,"6 de julio de 1997"
30,18,201,4575,176,143,319,"6 de julio de 1997"
30,18,201,4576,335,286,621,"6 de julio de 1997"
30,18,201,4577,573,508,1081,"6 de julio de 1997"
30,18,201,4578,368,327,695,"6 de julio de 1997"
30,18,201,4579,105,88,193,"6 de julio de 1997"
30,18,201,4580,250,201,451,"6 de julio de 1997"
30,18,201,4581,420,414,834,"6 de julio de 1997"
30,18,201,4582,444,422,866,"6 de julio de 1997"
30,18,201,4583,382,309,691,"6 de julio de 1997"
30,18,201,4584,175,157,332,"6 de julio de 1997"
30,18,201,4585,377,310,687,"6 de julio de 1997"
30,18,201,4586,300,259,559,"6 de julio de 1997"
30,18,201,4587,244,217,461,"6 de julio de 1997"
30,18,201,4588,288,293,581,"6 de julio de 1997"
30,18,201,4589,192,156,348,"6 de julio de 1997"
30,18,201,4590,452,414,866,"6 de julio de 1997"
30,18,201,4591,211,168,379,"6 de julio de 1997"
30,18,201,4592,279,228,507,"6 de julio de 1997"
30,18,201,4593,540,474,1014,"6 de julio de 1997"
30,18,201,4594,426,309,735,"6 de julio de 1997"
30,18,201,4595,121,104,225,"6 de julio de 1997"
30,18,201,4596,466,388,854,"6 de julio de 1997"
30,18,201,4597,291,237,528,"6 de julio de 1997"
30,19,16,339,612,674,1286,"6 de julio de 1997"
30,19,16,340,536,644,1180,"6 de julio de 1997"
30,19,16,341,417,458,875,"6 de julio de 1997"
30,19,16,342,517,574,1091,"6 de julio de 1997"
30,19,16,343,449,467,916,"6 de julio de 1997"
30,19,16,344,466,530,996,"6 de julio de 1997"
30,19,16,345,430,456,886,"6 de julio de 1997"
30,19,16,346,450,527,977,"6 de julio de 1997"
30,19,16,347,150,118,268,"6 de julio de 1997"
30,19,16,348,394,366,760,"6 de julio de 1997"
30,19,16,349,836,760,1596,"6 de julio de 1997"
30,19,16,350,492,469,961,"6 de julio de 1997"
30,19,16,351,329,351,680,"6 de julio de 1997"
30,19,16,352,457,456,913,"6 de julio de 1997"
30,19,16,353,612,634,1246,"6 de julio de 1997"
30,19,16,354,772,758,1530,"6 de julio de 1997"
30,19,16,355,314,340,654,"6 de julio de 1997"
30,19,16,356,571,502,1073,"6 de julio de 1997"
30,19,16,357,356,338,694,"6 de julio de 1997"
30,19,16,358,454,433,887,"6 de julio de 1997"
30,19,16,359,151,152,303,"6 de julio de 1997"
30,19,16,360,533,566,1099,"6 de julio de 1997"
30,19,16,361,264,266,530,"6 de julio de 1997"
30,19,16,362,428,399,827,"6 de julio de 1997"
30,19,34,632,298,329,627,"6 de julio de 1997"
30,19,34,633,792,851,1643,"6 de julio de 1997"
30,19,34,634,534,557,1091,"6 de julio de 1997"
30,19,34,635,542,562,1104,"6 de julio de 1997"
30,19,34,636,594,637,1231,"6 de julio de 1997"
30,19,34,637,372,411,783,"6 de julio de 1997"
30,19,34,638,714,708,1422,"6 de julio de 1997"
30,19,34,639,435,423,858,"6 de julio de 1997"
30,19,34,640,530,567,1097,"6 de julio de 1997"
30,19,34,641,539,522,1061,"6 de julio de 1997"
30,19,34,642,459,504,963,"6 de julio de 1997"
30,19,34,643,494,648,1142,"6 de julio de 1997"
30,19,34,644,411,335,746,"6 de julio de 1997"
30,19,34,645,500,365,865,"6 de julio de 1997"
30,19,34,646,271,257,528,"6 de julio de 1997"
30,19,34,647,742,672,1414,"6 de julio de 1997"
30,19,34,648,215,225,440,"6 de julio de 1997"
30,19,34,649,348,288,636,"6 de julio de 1997"
30,19,34,650,337,274,611,"6 de julio de 1997"
30,19,34,651,355,310,665,"6 de julio de 1997"
30,19,34,652,504,451,955,"6 de julio de 1997"
30,19,34,653,501,447,948,"6 de julio de 1997"
30,19,34,654,654,572,1226,"6 de julio de 1997"
30,19,34,655,512,406,918,"6 de julio de 1997"
30,19,79,1701,369,415,784,"6 de julio de 1997"
30,19,79,1702,652,666,1318,"6 de julio de 1997"
30,19,79,1703,776,879,1655,"6 de julio de 1997"
30,19,79,1704,706,789,1495,"6 de julio de 1997"
30,19,79,1705,630,683,1313,"6 de julio de 1997"
30,19,79,1706,626,697,1323,"6 de julio de 1997"
30,19,79,1707,623,722,1345,"6 de julio de 1997"
30,19,79,1708,500,592,1092,"6 de julio de 1997"
30,19,79,1709,673,714,1387,"6 de julio de 1997"
30,19,79,1710,693,737,1430,"6 de julio de 1997"
30,19,79,1711,583,504,1087,"6 de julio de 1997"
30,19,79,1712,530,440,970,"6 de julio de 1997"
30,19,79,1713,613,526,1139,"6 de julio de 1997"
30,19,79,1714,584,514,1098,"6 de julio de 1997"
30,19,79,1715,613,532,1145,"6 de julio de 1997"
30,19,79,1716,313,267,580,"6 de julio de 1997"
30,19,79,1717,637,546,1183,"6 de julio de 1997"
30,19,98,2221,459,507,966,"6 de julio de 1997"
30,19,98,2222,557,665,1222,"6 de julio de 1997"
30,19,98,2223,216,260,476,"6 de julio de 1997"
30,19,98,2224,622,675,1297,"6 de julio de 1997"
30,19,98,2225,239,259,498,"6 de julio de 1997"
30,19,98,2226,403,453,856,"6 de julio de 1997"
30,19,98,2227,400,490,890,"6 de julio de 1997"
30,19,98,2228,349,450,799,"6 de julio de 1997"
30,19,98,2229,376,428,804,"6 de julio de 1997"
30,19,98,2230,371,452,823,"6 de julio de 1997"
30,19,98,2231,397,434,831,"6 de julio de 1997"
30,19,98,2232,375,438,813,"6 de julio de 1997"
30,19,98,2233,386,425,811,"6 de julio de 1997"
30,19,98,2234,730,822,1552,"6 de julio de 1997"
30,19,98,2235,473,564,1037,"6 de julio de 1997"
30,19,98,2236,356,364,720,"6 de julio de 1997"
30,19,140,3321,313,333,646,"6 de julio de 1997"
30,19,140,3322,493,548,1041,"6 de julio de 1997"
30,19,140,3323,440,428,868,"6 de julio de 1997"
30,19,140,3324,517,550,1067,"6 de julio de 1997"
30,19,140,3325,241,240,481,"6 de julio de 1997"
30,19,142,3328,234,295,529,"6 de julio de 1997"
30,19,142,3329,795,819,1614,"6 de julio de 1997"
30,19,142,3330,522,583,1105,"6 de julio de 1997"
30,19,142,3331,363,382,745,"6 de julio de 1997"
30,19,142,3332,462,502,964,"6 de julio de 1997"
30,19,142,3333,530,608,1138,"6 de julio de 1997"
30,19,142,3334,436,522,958,"6 de julio de 1997"
30,19,142,3335,423,502,925,"6 de julio de 1997"
30,19,142,3336,553,657,1210,"6 de julio de 1997"
30,19,142,3337,338,428,766,"6 de julio de 1997"
30,19,142,3338,473,561,1034,"6 de julio de 1997"
30,19,142,3339,569,652,1221,"6 de julio de 1997"
30,19,142,3340,473,495,968,"6 de julio de 1997"
30,19,142,3341,464,531,995,"6 de julio de 1997"
30,19,142,3342,382,439,821,"6 de julio de 1997"
30,19,142,3343,402,421,823,"6 de julio de 1997"
30,19,142,3344,493,550,1043,"6 de julio de 1997"
30,19,142,3345,532,594,1126,"6 de julio de 1997"
30,19,142,3346,424,543,967,"6 de julio de 1997"
30,19,142,3347,510,592,1102,"6 de julio de 1997"
30,19,142,3348,440,534,974,"6 de julio de 1997"
30,19,142,3349,590,709,1299,"6 de julio de 1997"
30,19,142,3350,692,779,1471,"6 de julio de 1997"
30,19,142,3351,889,652,1541,"6 de julio de 1997"
30,19,142,3352,483,567,1050,"6 de julio de 1997"
30,19,142,3353,391,462,853,"6 de julio de 1997"
30,19,142,3354,446,498,944,"6 de julio de 1997"
30,19,142,3355,670,778,1448,"6 de julio de 1997"
30,19,142,3356,234,255,489,"6 de julio de 1997"
30,19,142,3357,383,426,809,"6 de julio de 1997"
30,19,142,3358,288,272,560,"6 de julio de 1997"
30,19,142,3359,394,334,728,"6 de julio de 1997"
30,19,142,3360,383,276,659,"6 de julio de 1997"
30,19,142,3361,323,322,645,"6 de julio de 1997"
30,19,142,3362,584,561,1145,"6 de julio de 1997"
30,19,142,3363,291,227,518,"6 de julio de 1997"
30,19,142,3364,229,206,435,"6 de julio de 1997"
30,19,142,3365,825,730,1555,"6 de julio de 1997"
30,19,142,3366,575,527,1102,"6 de julio de 1997"
30,19,142,3367,733,656,1389,"6 de julio de 1997"
30,19,142,3368,770,780,1550,"6 de julio de 1997"
30,19,142,3369,340,298,638,"6 de julio de 1997"
30,19,142,3370,295,299,594,"6 de julio de 1997"
30,19,142,3371,504,548,1052,"6 de julio de 1997"
30,19,142,3372,523,538,1061,"6 de julio de 1997"
30,19,142,3373,478,530,1008,"6 de julio de 1997"
30,19,142,3374,507,541,1048,"6 de julio de 1997"
30,19,142,3375,590,608,1198,"6 de julio de 1997"
30,19,142,3376,732,641,1373,"6 de julio de 1997"
30,19,142,3377,320,325,645,"6 de julio de 1997"
30,19,142,3378,607,701,1308,"6 de julio de 1997"
30,19,142,3379,528,572,1100,"6 de julio de 1997"
30,19,142,3380,379,386,765,"6 de julio de 1997"
30,19,142,3381,444,497,941,"6 de julio de 1997"
30,19,142,3382,312,319,631,"6 de julio de 1997"
30,19,142,3383,473,504,977,"6 de julio de 1997"
30,19,142,3384,421,412,833,"6 de julio de 1997"
30,19,142,3385,526,490,1016,"6 de julio de 1997"
30,19,142,3386,290,306,596,"6 de julio de 1997"
30,19,142,3387,378,408,786,"6 de julio de 1997"
30,19,142,3388,375,365,740,"6 de julio de 1997"
30,19,142,3389,556,562,1118,"6 de julio de 1997"
30,19,142,3390,445,426,871,"6 de julio de 1997"
30,19,142,3391,264,240,504,"6 de julio de 1997"
30,19,142,3392,539,562,1101,"6 de julio de 1997"
30,19,142,3393,192,203,395,"6 de julio de 1997"
30,19,142,3394,569,548,1117,"6 de julio de 1997"
30,19,142,3395,226,223,449,"6 de julio de 1997"
30,19,142,3396,508,555,1063,"6 de julio de 1997"
30,19,142,3397,632,630,1262,"6 de julio de 1997"
30,19,142,3398,724,662,1386,"6 de julio de 1997"
30,19,142,3399,665,610,1275,"6 de julio de 1997"
30,19,142,3400,294,249,543,"6 de julio de 1997"
30,19,142,3401,356,328,684,"6 de julio de 1997"
30,19,142,3402,577,499,1076,"6 de julio de 1997"
30,19,142,3403,656,561,1217,"6 de julio de 1997"
30,19,142,3404,626,564,1190,"6 de julio de 1997"
30,19,142,3405,226,197,423,"6 de julio de 1997"
30,19,142,3406,598,558,1156,"6 de julio de 1997"
30,19,142,3407,386,368,754,"6 de julio de 1997"
30,19,142,3408,213,199,412,"6 de julio de 1997"
30,19,144,3437,622,672,1294,"6 de julio de 1997"
30,19,144,3438,475,471,946,"6 de julio de 1997"
30,19,144,3439,299,327,626,"6 de julio de 1997"
30,19,144,3440,378,402,780,"6 de julio de 1997"
30,19,144,3441,420,442,862,"6 de julio de 1997"
30,19,144,3442,363,426,789,"6 de julio de 1997"
30,19,144,3443,398,415,813,"6 de julio de 1997"
30,19,144,3444,299,344,643,"6 de julio de 1997"
30,19,144,3445,502,546,1048,"6 de julio de 1997"
30,19,144,3446,511,505,1016,"6 de julio de 1997"
30,19,144,3447,324,305,629,"6 de julio de 1997"
30,19,144,3448,291,296,587,"6 de julio de 1997"
30,19,144,3449,171,163,334,"6 de julio de 1997"
30,19,144,3450,301,264,565,"6 de julio de 1997"
30,19,144,3451,269,233,502,"6 de julio de 1997"
30,19,144,3452,392,335,727,"6 de julio de 1997"
30,19,144,3453,609,612,1221,"6 de julio de 1997"
30,19,144,3454,388,411,799,"6 de julio de 1997"
30,19,144,3455,424,414,838,"6 de julio de 1997"
30,19,144,3456,489,508,997,"6 de julio de 1997"
30,19,144,3457,268,256,524,"6 de julio de 1997"
30,19,144,3458,410,408,818,"6 de julio de 1997"
30,19,144,3459,397,337,734,"6 de julio de 1997"
30,19,144,3460,426,465,891,"6 de julio de 1997"
30,19,144,3461,446,428,874,"6 de julio de 1997"
30,19,144,3462,218,232,450,"6 de julio de 1997"
30,19,144,3463,537,526,1063,"6 de julio de 1997"
30,19,144,3464,266,251,517,"6 de julio de 1997"
30,19,144,3465,447,454,901,"6 de julio de 1997"
30,19,144,3466,493,541,1034,"6 de julio de 1997"
30,19,144,3467,510,524,1034,"6 de julio de 1997"
30,19,144,3468,580,592,1172,"6 de julio de 1997"
30,19,144,3469,162,130,292,"6 de julio de 1997"
30,19,144,3470,409,436,845,"6 de julio de 1997"
30,19,144,3471,576,515,1091,"6 de julio de 1997"
30,19,144,3472,508,578,1086,"6 de julio de 1997"
30,19,144,3473,234,240,474,"6 de julio de 1997"
30,19,144,3474,435,406,841,"6 de julio de 1997"
30,20,3,7,707,824,1531,"6 de julio de 1997"
30,20,3,8,330,325,655,"6 de julio de 1997"
30,20,3,9,569,636,1205,"6 de julio de 1997"
30,20,3,10,373,363,736,"6 de julio de 1997"
30,20,3,11,604,640,1244,"6 de julio de 1997"
30,20,3,12,387,379,766,"6 de julio de 1997"
30,20,3,13,597,634,1231,"6 de julio de 1997"
30,20,3,14,508,510,1018,"6 de julio de 1997"
30,20,3,15,687,743,1430,"6 de julio de 1997"
30,20,3,16,611,681,1292,"6 de julio de 1997"
30,20,3,17,401,460,861,"6 de julio de 1997"
30,20,3,18,585,625,1210,"6 de julio de 1997"
30,20,3,19,634,696,1330,"6 de julio de 1997"
30,20,3,20,428,465,893,"6 de julio de 1997"
30,20,3,21,459,475,934,"6 de julio de 1997"
30,20,3,22,487,514,1001,"6 de julio de 1997"
30,20,3,23,818,878,1696,"6 de julio de 1997"
30,20,3,24,786,859,1645,"6 de julio de 1997"
30,20,3,25,727,832,1559,"6 de julio de 1997"
30,20,3,26,574,596,1170,"6 de julio de 1997"
30,20,3,27,703,769,1472,"6 de julio de 1997"
30,20,3,28,666,656,1322,"6 de julio de 1997"
30,20,3,29,618,655,1273,"6 de julio de 1997"
30,20,3,30,682,697,1379,"6 de julio de 1997"
30,20,3,31,505,478,983,"6 de julio de 1997"
30,20,3,32,616,581,1197,"6 de julio de 1997"
30,20,3,33,465,443,908,"6 de julio de 1997"
30,20,3,34,702,711,1413,"6 de julio de 1997"
30,20,3,35,463,416,879,"6 de julio de 1997"
30,20,3,36,703,634,1337,"6 de julio de 1997"
30,20,3,37,674,659,1333,"6 de julio de 1997"
30,20,3,38,542,508,1050,"6 de julio de 1997"
30,20,3,39,637,525,1162,"6 de julio de 1997"
30,20,3,40,319,296,615,"6 de julio de 1997"
30,20,3,41,385,353,738,"6 de julio de 1997"
30,20,3,42,620,487,1107,"6 de julio de 1997"
30,20,3,43,678,569,1247,"6 de julio de 1997"
30,20,3,44,542,480,1022,"6 de julio de 1997"
30,20,3,45,802,714,1516,"6 de julio de 1997"
30,20,3,46,403,326,729,"6 de julio de 1997"
30,20,75,1641,573,576,1149,"6 de julio de 1997"
30,20,75,1642,634,623,1257,"6 de julio de 1997"
30,20,75,1643,259,234,493,"6 de julio de 1997"
30,20,75,1644,216,165,381,"6 de julio de 1997"
30,20,75,1645,329,322,651,"6 de julio de 1997"
30,20,75,1646,238,190,428,"6 de julio de 1997"
30,20,75,1647,461,435,896,"6 de julio de 1997"
30,20,75,1648,577,599,1176,"6 de julio de 1997"
30,20,75,1649,355,319,674,"6 de julio de 1997"
30,20,75,1650,398,398,796,"6 de julio de 1997"
30,20,75,1651,577,443,1020,"6 de julio de 1997"
30,20,75,1652,541,534,1075,"6 de julio de 1997"
30,20,75,1653,472,425,897,"6 de julio de 1997"
30,20,75,1654,293,280,573,"6 de julio de 1997"
30,20,75,1655,404,396,800,"6 de julio de 1997"
30,20,75,1656,258,213,471,"6 de julio de 1997"
30,20,75,1657,481,454,935,"6 de julio de 1997"
30,20,75,1658,383,393,776,"6 de julio de 1997"
30,20,75,1659,402,444,846,"6 de julio de 1997"
30,20,75,1660,268,314,582,"6 de julio de 1997"
30,20,75,1661,323,332,655,"6 de julio de 1997"
30,20,75,1662,529,576,1105,"6 de julio de 1997"
30,20,75,1663,212,212,424,"6 de julio de 1997"
30,20,75,1664,464,431,895,"6 de julio de 1997"
30,20,75,1665,829,718,1547,"6 de julio de 1997"
30,20,75,1666,488,494,982,"6 de julio de 1997"
30,20,75,1667,565,442,1007,"6 de julio de 1997"
30,20,95,2179,555,582,1137,"6 de julio de 1997"
30,20,95,2180,419,440,859,"6 de julio de 1997"
30,20,95,2181,504,526,1030,"6 de julio de 1997"
30,20,95,2182,517,560,1077,"6 de julio de 1997"
30,20,95,2183,596,629,1225,"6 de julio de 1997"
30,20,95,2184,617,572,1189,"6 de julio de 1997"
30,20,95,2185,287,293,580,"6 de julio de 1997"
30,20,95,2186,280,243,523,"6 de julio de 1997"
30,20,95,2187,293,276,569,"6 de julio de 1997"
30,20,95,2188,759,723,1482,"6 de julio de 1997"
30,20,95,2189,377,303,680,"6 de julio de 1997"
30,20,95,2190,347,286,633,"6 de julio de 1997"
30,20,95,2191,495,463,958,"6 de julio de 1997"
30,20,95,2192,381,348,729,"6 de julio de 1997"
30,20,95,2193,333,268,601,"6 de julio de 1997"
30,20,95,2194,347,303,650,"6 de julio de 1997"
30,20,95,2195,418,355,773,"6 de julio de 1997"
30,20,95,2196,346,284,630,"6 de julio de 1997"
30,20,95,2197,372,338,710,"6 de julio de 1997"
30,20,95,2198,458,462,920,"6 de julio de 1997"
30,20,95,2199,757,634,1391,"6 de julio de 1997"
30,20,95,2200,480,413,893,"6 de julio de 1997"
30,20,117,2640,415,477,892,"6 de julio de 1997"
30,20,117,2641,460,477,937,"6 de julio de 1997"
30,20,117,2642,562,570,1132,"6 de julio de 1997"
30,20,117,2643,342,390,732,"6 de julio de 1997"
30,20,117,2644,428,431,859,"6 de julio de 1997"
30,20,117,2645,460,513,973,"6 de julio de 1997"
30,20,117,2646,446,476,922,"6 de julio de 1997"
30,20,117,2647,126,111,237,"6 de julio de 1997"
30,20,117,2648,370,308,678,"6 de julio de 1997"
30,20,117,2649,78,63,141,"6 de julio de 1997"
30,20,131,3081,818,861,1679,"6 de julio de 1997"
30,20,131,3082,726,828,1554,"6 de julio de 1997"
30,20,131,3083,375,441,816,"6 de julio de 1997"
30,20,131,3084,405,449,854,"6 de julio de 1997"
30,20,131,3085,495,454,949,"6 de julio de 1997"
30,20,131,3086,495,451,946,"6 de julio de 1997"
30,20,131,3087,373,335,708,"6 de julio de 1997"
30,20,131,3088,395,334,729,"6 de julio de 1997"
30,20,131,3089,524,471,995,"6 de julio de 1997"
30,20,131,3090,301,276,577,"6 de julio de 1997"
30,20,131,3091,265,229,494,"6 de julio de 1997"
30,20,131,3092,411,383,794,"6 de julio de 1997"
30,20,131,3093,465,478,943,"6 de julio de 1997"
30,20,131,3094,517,479,996,"6 de julio de 1997"
30,20,131,3095,422,414,836,"6 de julio de 1997"
30,20,131,3096,287,277,564,"6 de julio de 1997"
30,20,131,3097,313,364,677,"6 de julio de 1997"
30,20,131,3098,489,415,904,"6 de julio de 1997"
30,20,131,3099,589,548,1137,"6 de julio de 1997"
30,20,131,3100,675,651,1326,"6 de julio de 1997"
30,20,131,3101,509,459,968,"6 de julio de 1997"
30,20,131,3102,496,411,907,"6 de julio de 1997"
30,20,131,3103,731,724,1455,"6 de julio de 1997"
30,20,131,3104,658,680,1338,"6 de julio de 1997"
30,20,131,3105,563,541,1104,"6 de julio de 1997"
30,20,131,3106,396,348,744,"6 de julio de 1997"
30,20,131,3107,451,485,936,"6 de julio de 1997"
30,20,131,3108,643,592,1235,"6 de julio de 1997"
30,20,143,3409,185,193,378,"6 de julio de 1997"
30,20,143,3410,395,456,851,"6 de julio de 1997"
30,20,143,3411,392,396,788,"6 de julio de 1997"
30,20,143,3412,405,387,792,"6 de julio de 1997"
30,20,143,3413,413,365,778,"6 de julio de 1997"
30,20,143,3414,438,338,776,"6 de julio de 1997"
30,20,143,3415,386,281,667,"6 de julio de 1997"
30,20,143,3416,560,529,1089,"6 de julio de 1997"
30,20,143,3417,352,337,689,"6 de julio de 1997"
30,20,143,3418,271,222,493,"6 de julio de 1997"
30,20,143,3419,262,203,465,"6 de julio de 1997"
30,20,143,3420,308,255,563,"6 de julio de 1997"
30,20,143,3421,768,825,1593,"6 de julio de 1997"
30,20,143,3422,491,537,1028,"6 de julio de 1997"
30,20,143,3423,249,207,456,"6 de julio de 1997"
30,20,143,3424,355,318,673,"6 de julio de 1997"
30,20,143,3425,146,138,284,"6 de julio de 1997"
30,20,143,3426,297,316,613,"6 de julio de 1997"
30,20,143,3427,296,274,570,"6 de julio de 1997"
30,20,143,3428,750,699,1449,"6 de julio de 1997"
30,20,143,3429,34,32,66,"6 de julio de 1997"
30,20,143,3430,230,213,443,"6 de julio de 1997"
30,20,143,3431,409,307,716,"6 de julio de 1997"
30,20,143,3432,120,86,206,"6 de julio de 1997"
30,20,143,3433,389,338,727,"6 de julio de 1997"
30,20,143,3434,208,158,366,"6 de julio de 1997"
30,20,143,3435,479,381,860,"6 de julio de 1997"
30,20,143,3436,203,177,380,"6 de julio de 1997"
30,20,145,3475,576,529,1105,"6 de julio de 1997"
30,20,145,3476,493,473,966,"6 de julio de 1997"
30,20,145,3477,558,481,1039,"6 de julio de 1997"
30,20,145,3478,439,438,877,"6 de julio de 1997"
30,20,145,3479,555,487,1042,"6 de julio de 1997"
30,20,145,3480,460,426,886,"6 de julio de 1997"
30,20,145,3481,567,512,1079,"6 de julio de 1997"
30,20,145,3482,85,73,158,"6 de julio de 1997"
30,20,145,3483,197,134,331,"6 de julio de 1997"
30,20,145,3484,163,141,304,"6 de julio de 1997"
30,20,145,3485,454,418,872,"6 de julio de 1997"
30,20,145,3486,440,422,862,"6 de julio de 1997"
30,20,145,3487,630,608,1238,"6 de julio de 1997"
30,20,145,3488,440,402,842,"6 de julio de 1997"
30,20,145,3489,453,370,823,"6 de julio de 1997"
30,20,145,3490,542,432,974,"6 de julio de 1997"
30,20,145,3491,619,630,1249,"6 de julio de 1997"
30,20,145,3492,358,302,660,"6 de julio de 1997"
30,20,145,3493,245,184,429,"6 de julio de 1997"
30,20,146,3494,384,407,791,"6 de julio de 1997"
30,20,146,3495,491,479,970,"6 de julio de 1997"
30,20,146,3496,488,525,1013,"6 de julio de 1997"
30,20,146,3497,222,207,429,"6 de julio de 1997"
30,20,146,3498,260,208,468,"6 de julio de 1997"
30,20,146,3499,289,272,561,"6 de julio de 1997"
30,20,146,3500,268,238,506,"6 de julio de 1997"
30,20,146,3501,358,410,768,"6 de julio de 1997"
30,20,168,3780,393,398,791,"6 de julio de 1997"
30,20,168,3781,137,153,290,"6 de julio de 1997"
30,20,168,3782,503,473,976,"6 de julio de 1997"
30,20,168,3783,347,436,783,"6 de julio de 1997"
30,20,168,3784,446,467,913,"6 de julio de 1997"
30,20,168,3785,203,245,448,"6 de julio de 1997"
30,20,168,3786,331,353,684,"6 de julio de 1997"
30,20,168,3787,458,427,885,"6 de julio de 1997"
30,20,168,3788,398,351,749,"6 de julio de 1997"
30,20,168,3789,528,484,1012,"6 de julio de 1997"
30,20,168,3790,548,490,1038,"6 de julio de 1997"
30,20,168,3791,501,395,896,"6 de julio de 1997"
30,20,168,3792,360,370,730,"6 de julio de 1997"
30,20,168,3793,485,490,975,"6 de julio de 1997"
30,20,168,3794,278,234,512,"6 de julio de 1997"
30,20,168,3795,268,252,520,"6 de julio de 1997"
30,20,168,3796,629,494,1123,"6 de julio de 1997"
30,20,168,3797,405,340,745,"6 de julio de 1997"
30,20,168,3798,247,188,435,"6 de julio de 1997"
30,21,50,1184,298,291,589,"6 de julio de 1997"
30,21,50,1185,303,284,587,"6 de julio de 1997"
30,21,50,1186,364,380,744,"6 de julio de 1997"
30,21,50,1187,172,136,308,"6 de julio de 1997"
30,21,50,1188,331,318,649,"6 de julio de 1997"
30,21,50,1189,340,322,662,"6 de julio de 1997"
30,21,50,1190,308,321,629,"6 de julio de 1997"
30,21,50,1191,350,358,708,"6 de julio de 1997"
30,21,50,1192,528,519,1047,"6 de julio de 1997"
30,21,50,1193,489,476,965,"6 de julio de 1997"
30,21,50,1194,366,338,704,"6 de julio de 1997"
30,21,50,1195,340,371,711,"6 de julio de 1997"
30,21,50,1196,332,360,692,"6 de julio de 1997"
30,21,50,1197,327,325,652,"6 de julio de 1997"
30,21,50,1198,284,270,554,"6 de julio de 1997"
30,21,50,1199,236,244,480,"6 de julio de 1997"
30,21,50,1200,251,238,489,"6 de julio de 1997"
30,21,50,1201,304,300,604,"6 de julio de 1997"
30,21,50,1202,271,289,560,"6 de julio de 1997"
30,21,50,1203,357,342,699,"6 de julio de 1997"
30,21,50,1204,304,305,609,"6 de julio de 1997"
30,21,50,1205,263,314,577,"6 de julio de 1997"
30,21,50,1206,448,468,916,"6 de julio de 1997"
30,21,50,1207,437,402,839,"6 de julio de 1997"
30,21,50,1208,337,352,689,"6 de julio de 1997"
30,21,50,1209,282,315,597,"6 de julio de 1997"
30,21,50,1210,197,222,419,"6 de julio de 1997"
30,21,50,1211,51,59,110,"6 de julio de 1997"
30,21,50,1212,348,422,770,"6 de julio de 1997"
30,21,50,1213,319,396,715,"6 de julio de 1997"
30,21,50,1214,257,308,565,"6 de julio de 1997"
30,21,50,1215,276,300,576,"6 de julio de 1997"
30,21,50,1216,251,236,487,"6 de julio de 1997"
30,21,50,1217,429,463,892,"6 de julio de 1997"
30,21,50,1218,349,403,752,"6 de julio de 1997"
30,21,50,1219,435,447,882,"6 de julio de 1997"
30,21,50,1220,239,264,503,"6 de julio de 1997"
30,21,50,1221,369,419,788,"6 de julio de 1997"
30,21,50,1222,533,600,1133,"6 de julio de 1997"
30,21,50,1223,195,209,404,"6 de julio de 1997"
30,21,50,1224,683,737,1420,"6 de julio de 1997"
30,21,50,1225,463,498,961,"6 de julio de 1997"
30,21,50,1226,459,505,964,"6 de julio de 1997"
30,21,50,1227,282,265,547,"6 de julio de 1997"
30,21,50,1228,843,846,1689,"6 de julio de 1997"
30,21,50,1229,175,170,345,"6 de julio de 1997"
30,21,50,1230,344,380,724,"6 de julio de 1997"
30,21,50,1231,435,465,900,"6 de julio de 1997"
30,21,50,1232,635,651,1286,"6 de julio de 1997"
30,21,50,1233,286,311,597,"6 de julio de 1997"
30,21,50,1234,625,733,1358,"6 de julio de 1997"
30,21,50,1235,525,608,1133,"6 de julio de 1997"
30,21,50,1236,475,552,1027,"6 de julio de 1997"
30,21,50,1237,273,280,553,"6 de julio de 1997"
30,21,50,1238,624,671,1295,"6 de julio de 1997"
30,21,50,1239,812,819,1631,"6 de julio de 1997"
30,21,50,1240,439,514,953,"6 de julio de 1997"
30,21,50,1241,157,146,303,"6 de julio de 1997"
30,21,50,1242,458,452,910,"6 de julio de 1997"
30,21,50,1243,459,492,951,"6 de julio de 1997"
30,21,50,1244,150,139,289,"6 de julio de 1997"
30,21,50,1245,313,307,620,"6 de julio de 1997"
30,21,50,1246,278,281,559,"6 de julio de 1997"
30,21,50,1247,330,311,641,"6 de julio de 1997"
30,21,50,1248,353,337,690,"6 de julio de 1997"
30,21,50,1249,264,262,526,"6 de julio de 1997"
30,21,50,1250,248,256,504,"6 de julio de 1997"
30,21,50,1251,339,318,657,"6 de julio de 1997"
30,21,61,1390,487,495,982,"6 de julio de 1997"
30,21,61,1391,436,434,870,"6 de julio de 1997"
30,21,61,1392,272,289,561,"6 de julio de 1997"
30,21,61,1393,891,871,1762,"6 de julio de 1997"
30,21,61,1394,536,514,1050,"6 de julio de 1997"
30,21,61,1395,111,94,205,"6 de julio de 1997"
30,21,61,1396,500,429,929,"6 de julio de 1997"
30,21,61,1397,274,232,506,"6 de julio de 1997"
30,21,61,1398,381,377,758,"6 de julio de 1997"
30,21,61,1399,298,281,579,"6 de julio de 1997"
30,21,61,1400,282,230,512,"6 de julio de 1997"
30,21,61,1401,189,146,335,"6 de julio de 1997"
30,21,61,1402,81,76,157,"6 de julio de 1997"
30,21,72,1579,447,400,847,"6 de julio de 1997"
30,21,72,1580,386,355,741,"6 de julio de 1997"
30,21,72,1581,361,337,698,"6 de julio de 1997"
30,21,72,1582,292,223,515,"6 de julio de 1997"
30,21,72,1583,377,295,672,"6 de julio de 1997"
30,21,72,1584,350,272,622,"6 de julio de 1997"
30,21,72,1585,640,476,1116,"6 de julio de 1997"
30,21,72,1586,332,264,596,"6 de julio de 1997"
30,21,72,1587,251,189,440,"6 de julio de 1997"
30,21,72,1588,474,334,808,"6 de julio de 1997"
30,21,72,1589,495,405,900,"6 de julio de 1997"
30,21,72,1590,313,253,566,"6 de julio de 1997"
30,21,72,1591,324,214,538,"6 de julio de 1997"
30,21,72,1592,349,242,591,"6 de julio de 1997"
30,21,72,1593,261,164,425,"6 de julio de 1997"
30,21,72,1594,203,126,329,"6 de julio de 1997"
30,21,72,1595,912,755,1667,"6 de julio de 1997"
30,21,72,1596,183,102,285,"6 de julio de 1997"
30,21,91,2105,243,268,511,"6 de julio de 1997"
30,21,91,2106,273,318,591,"6 de julio de 1997"
30,21,91,2107,572,589,1161,"6 de julio de 1997"
30,21,91,2108,488,537,1025,"6 de julio de 1997"
30,21,91,2109,288,313,601,"6 de julio de 1997"
30,21,91,2110,434,453,887,"6 de julio de 1997"
30,21,91,2111,246,289,535,"6 de julio de 1997"
30,21,91,2112,474,509,983,"6 de julio de 1997"
30,21,91,2113,504,587,1091,"6 de julio de 1997"
30,21,91,2114,646,685,1331,"6 de julio de 1997"
30,21,91,2115,464,481,945,"6 de julio de 1997"
30,21,91,2116,500,535,1035,"6 de julio de 1997"
30,21,91,2117,442,485,927,"6 de julio de 1997"
30,21,91,2118,416,452,868,"6 de julio de 1997"
30,21,91,2119,162,180,342,"6 de julio de 1997"
30,21,91,2120,682,729,1411,"6 de julio de 1997"
30,21,91,2121,437,488,925,"6 de julio de 1997"
30,21,91,2122,440,484,924,"6 de julio de 1997"
30,21,91,2123,447,490,937,"6 de julio de 1997"
30,21,91,2124,494,565,1059,"6 de julio de 1997"
30,21,91,2125,408,418,826,"6 de julio de 1997"
30,21,91,2126,324,336,660,"6 de julio de 1997"
30,21,91,2127,370,403,773,"6 de julio de 1997"
30,21,91,2128,442,439,881,"6 de julio de 1997"
30,21,91,2129,163,141,304,"6 de julio de 1997"
30,21,91,2130,176,155,331,"6 de julio de 1997"
30,21,91,2131,154,153,307,"6 de julio de 1997"
30,21,91,2132,443,396,839,"6 de julio de 1997"
30,21,91,2133,158,137,295,"6 de julio de 1997"
30,21,91,2134,126,100,226,"6 de julio de 1997"
30,21,91,2135,160,139,299,"6 de julio de 1997"
30,21,91,2136,351,301,652,"6 de julio de 1997"
30,21,91,2137,352,284,636,"6 de julio de 1997"
30,21,93,2146,427,403,830,"6 de julio de 1997"
30,21,93,2147,257,302,559,"6 de julio de 1997"
30,21,93,2148,153,165,318,"6 de julio de 1997"
30,21,93,2149,307,348,655,"6 de julio de 1997"
30,21,93,2150,138,123,261,"6 de julio de 1997"
30,21,93,2151,98,67,165,"6 de julio de 1997"
30,21,93,2152,317,260,577,"6 de julio de 1997"
30,21,93,2153,739,565,1304,"6 de julio de 1997"
30,21,93,2154,236,206,442,"6 de julio de 1997"
30,21,93,2155,724,682,1406,"6 de julio de 1997"
30,21,93,2156,365,328,693,"6 de julio de 1997"
30,21,93,2157,373,305,678,"6 de julio de 1997"
30,21,93,2158,262,194,456,"6 de julio de 1997"
30,21,93,2159,431,350,781,"6 de julio de 1997"
30,21,93,2160,287,221,508,"6 de julio de 1997"
30,21,93,2161,275,349,624,"6 de julio de 1997"
30,21,93,2162,332,363,695,"6 de julio de 1997"
30,21,93,2163,356,362,718,"6 de julio de 1997"
30,21,93,2164,369,260,629,"6 de julio de 1997"
30,21,93,2165,206,159,365,"6 de julio de 1997"
30,21,93,2166,337,279,616,"6 de julio de 1997"
30,21,93,2167,512,415,927,"6 de julio de 1997"
30,21,93,2168,433,339,772,"6 de julio de 1997"
30,21,93,2169,421,306,727,"6 de julio de 1997"
30,21,105,2379,629,610,1239,"6 de julio de 1997"
30,21,105,2380,391,400,791,"6 de julio de 1997"
30,21,105,2381,470,340,810,"6 de julio de 1997"
30,21,105,2382,327,286,613,"6 de julio de 1997"
30,21,105,2383,300,251,551,"6 de julio de 1997"
30,21,105,2384,537,446,983,"6 de julio de 1997"
30,21,105,2385,464,461,925,"6 de julio de 1997"
30,21,105,2386,540,469,1009,"6 de julio de 1997"
30,21,105,2387,512,440,952,"6 de julio de 1997"
30,21,105,2388,744,690,1434,"6 de julio de 1997"
30,21,105,2389,585,507,1092,"6 de julio de 1997"
30,21,121,2770,60,47,107,"6 de julio de 1997"
30,21,121,2771,527,539,1066,"6 de julio de 1997"
30,21,121,2772,502,495,997,"6 de julio de 1997"
30,21,121,2773,523,543,1066,"6 de julio de 1997"
30,21,121,2774,528,528,1056,"6 de julio de 1997"
30,21,121,2775,493,472,965,"6 de julio de 1997"
30,21,123,2805,338,317,655,"6 de julio de 1997"
30,21,123,2806,400,319,719,"6 de julio de 1997"
30,21,123,2807,364,342,706,"6 de julio de 1997"
30,21,123,2808,447,410,857,"6 de julio de 1997"
30,21,123,2809,169,153,322,"6 de julio de 1997"
30,21,123,2810,329,349,678,"6 de julio de 1997"
30,21,123,2811,343,263,606,"6 de julio de 1997"
30,21,123,2812,484,468,952,"6 de julio de 1997"
30,21,123,2813,306,228,534,"6 de julio de 1997"
30,21,150,3530,453,452,905,"6 de julio de 1997"
30,21,150,3531,524,546,1070,"6 de julio de 1997"
30,21,150,3532,457,449,906,"6 de julio de 1997"
30,21,150,3533,624,611,1235,"6 de julio de 1997"
30,21,150,3534,295,255,550,"6 de julio de 1997"
30,21,150,3535,516,462,978,"6 de julio de 1997"
30,21,150,3536,625,531,1156,"6 de julio de 1997"
30,21,150,3537,264,261,525,"6 de julio de 1997"
30,21,150,3538,554,521,1075,"6 de julio de 1997"
30,21,150,3539,615,603,1218,"6 de julio de 1997"
30,21,150,3540,636,669,1305,"6 de julio de 1997"
30,21,150,3541,596,523,1119,"6 de julio de 1997"
30,21,150,3542,534,498,1032,"6 de julio de 1997"
30,21,171,3808,429,410,839,"6 de julio de 1997"
30,21,171,3809,467,436,903,"6 de julio de 1997"
30,21,171,3810,280,257,537,"6 de julio de 1997"
30,21,171,3811,446,478,924,"6 de julio de 1997"
30,21,171,3812,590,556,1146,"6 de julio de 1997"
30,21,171,3813,392,333,725,"6 de julio de 1997"
30,21,171,3814,270,272,542,"6 de julio de 1997"
30,21,171,3815,484,415,899,"6 de julio de 1997"
30,21,171,3816,156,157,313,"6 de julio de 1997"
30,21,171,3817,254,233,487,"6 de julio de 1997"
30,21,171,3818,328,319,647,"6 de julio de 1997"
30,21,171,3819,508,457,965,"6 de julio de 1997"
30,21,171,3820,162,123,285,"6 de julio de 1997"
30,21,171,3821,188,137,325,"6 de julio de 1997"
30,21,171,3822,415,351,766,"6 de julio de 1997"
30,21,171,3823,329,231,560,"6 de julio de 1997"
30,21,199,4557,618,628,1246,"6 de julio de 1997"
30,21,199,4558,740,776,1516,"6 de julio de 1997"
30,21,199,4559,312,321,633,"6 de julio de 1997"
30,21,199,4560,289,265,554,"6 de julio de 1997"
30,22,41,763,277,316,593,"6 de julio de 1997"
30,22,41,764,258,264,522,"6 de julio de 1997"
30,22,41,765,187,230,417,"6 de julio de 1997"
30,22,41,766,350,418,768,"6 de julio de 1997"
30,22,41,767,251,248,499,"6 de julio de 1997"
30,22,41,768,502,529,1031,"6 de julio de 1997"
30,22,41,769,225,235,460,"6 de julio de 1997"
30,22,41,770,245,275,520,"6 de julio de 1997"
30,22,41,771,295,325,620,"6 de julio de 1997"
30,22,41,772,265,317,582,"6 de julio de 1997"
30,22,41,773,517,557,1074,"6 de julio de 1997"
30,22,41,774,556,599,1155,"6 de julio de 1997"
30,22,41,775,612,610,1222,"6 de julio de 1997"
30,22,41,776,398,417,815,"6 de julio de 1997"
30,22,41,777,441,464,905,"6 de julio de 1997"
30,22,41,778,442,496,938,"6 de julio de 1997"
30,22,41,779,393,419,812,"6 de julio de 1997"
30,22,41,780,539,593,1132,"6 de julio de 1997"
30,22,41,781,333,407,740,"6 de julio de 1997"
30,22,41,782,412,458,870,"6 de julio de 1997"
30,22,41,783,296,320,616,"6 de julio de 1997"
30,22,41,784,689,705,1394,"6 de julio de 1997"
30,22,41,785,375,373,748,"6 de julio de 1997"
30,22,41,786,483,558,1041,"6 de julio de 1997"
30,22,41,787,505,556,1061,"6 de julio de 1997"
30,22,41,788,356,422,778,"6 de julio de 1997"
30,22,41,789,263,335,598,"6 de julio de 1997"
30,22,41,790,411,452,863,"6 de julio de 1997"
30,22,41,791,465,493,958,"6 de julio de 1997"
30,22,41,792,974,1062,2036,"6 de julio de 1997"
30,22,41,793,627,703,1330,"6 de julio de 1997"
30,22,41,794,488,521,1009,"6 de julio de 1997"
30,22,41,795,570,635,1205,"6 de julio de 1997"
30,22,41,796,543,592,1135,"6 de julio de 1997"
30,22,41,797,450,531,981,"6 de julio de 1997"
30,22,41,798,503,511,1014,"6 de julio de 1997"
30,22,41,799,468,517,985,"6 de julio de 1997"
30,22,41,800,403,439,842,"6 de julio de 1997"
30,22,41,801,435,470,905,"6 de julio de 1997"
30,22,41,802,237,272,509,"6 de julio de 1997"
30,22,41,803,707,320,1027,"6 de julio de 1997"
30,22,41,804,286,368,654,"6 de julio de 1997"
30,22,41,805,297,334,631,"6 de julio de 1997"
30,22,41,806,442,480,922,"6 de julio de 1997"
30,22,41,807,340,359,699,"6 de julio de 1997"
30,22,41,808,422,453,875,"6 de julio de 1997"
30,22,41,809,424,466,890,"6 de julio de 1997"
30,22,41,810,363,389,752,"6 de julio de 1997"
30,22,41,811,130,158,288,"6 de julio de 1997"
30,22,41,812,514,580,1094,"6 de julio de 1997"
30,22,41,813,457,492,949,"6 de julio de 1997"
30,22,41,814,348,414,762,"6 de julio de 1997"
30,22,41,815,595,624,1219,"6 de julio de 1997"
30,22,41,816,2186,2472,4658,"6 de julio de 1997"
30,22,41,817,978,1040,2018,"6 de julio de 1997"
30,22,41,818,616,685,1301,"6 de julio de 1997"
30,22,41,819,598,688,1286,"6 de julio de 1997"
30,22,41,820,493,533,1026,"6 de julio de 1997"
30,22,41,821,323,321,644,"6 de julio de 1997"
30,22,41,822,268,295,563,"6 de julio de 1997"
30,22,41,823,378,413,791,"6 de julio de 1997"
30,22,41,824,764,780,1544,"6 de julio de 1997"
30,22,41,825,532,602,1134,"6 de julio de 1997"
30,22,41,826,421,403,824,"6 de julio de 1997"
30,22,41,827,254,281,535,"6 de julio de 1997"
30,22,41,828,380,418,798,"6 de julio de 1997"
30,22,41,829,384,405,789,"6 de julio de 1997"
30,22,41,830,509,555,1064,"6 de julio de 1997"
30,22,41,831,455,524,979,"6 de julio de 1997"
30,22,41,832,304,338,642,"6 de julio de 1997"
30,22,41,833,361,417,778,"6 de julio de 1997"
30,22,41,834,307,357,664,"6 de julio de 1997"
30,22,41,835,341,389,730,"6 de julio de 1997"
30,22,41,836,485,577,1062,"6 de julio de 1997"
30,22,41,837,423,478,901,"6 de julio de 1997"
30,22,41,838,459,472,931,"6 de julio de 1997"
30,22,41,839,520,551,1071,"6 de julio de 1997"
30,22,41,840,542,565,1107,"6 de julio de 1997"
30,22,41,841,472,550,1022,"6 de julio de 1997"
30,22,41,842,460,468,928,"6 de julio de 1997"
30,22,41,843,442,470,912,"6 de julio de 1997"
30,22,41,844,311,304,615,"6 de julio de 1997"
30,22,41,845,329,387,716,"6 de julio de 1997"
30,22,41,846,412,474,886,"6 de julio de 1997"
30,22,41,847,463,463,926,"6 de julio de 1997"
30,22,41,848,399,423,822,"6 de julio de 1997"
30,22,41,849,204,204,408,"6 de julio de 1997"
30,22,41,850,839,840,1679,"6 de julio de 1997"
30,22,41,851,330,351,681,"6 de julio de 1997"
30,22,41,852,327,339,666,"6 de julio de 1997"
30,22,41,853,624,644,1268,"6 de julio de 1997"
30,22,41,854,706,690,1396,"6 de julio de 1997"
30,22,41,855,785,798,1583,"6 de julio de 1997"
30,22,41,856,217,206,423,"6 de julio de 1997"
30,22,41,857,431,403,834,"6 de julio de 1997"
30,22,41,858,366,391,757,"6 de julio de 1997"
30,22,41,859,331,348,679,"6 de julio de 1997"
30,22,41,860,322,380,702,"6 de julio de 1997"
30,22,41,861,338,398,736,"6 de julio de 1997"
30,22,41,862,634,602,1236,"6 de julio de 1997"
30,22,41,863,281,288,569,"6 de julio de 1997"
30,22,41,864,632,656,1288,"6 de julio de 1997"
30,22,41,865,422,426,848,"6 de julio de 1997"
30,22,41,866,253,80,333,"6 de julio de 1997"
30,22,41,867,330,343,673,"6 de julio de 1997"
30,22,41,868,446,531,977,"6 de julio de 1997"
30,22,41,869,318,314,632,"6 de julio de 1997"
30,22,41,870,348,333,681,"6 de julio de 1997"
30,22,41,871,309,336,645,"6 de julio de 1997"
30,22,41,872,562,563,1125,"6 de julio de 1997"
30,22,41,873,642,635,1277,"6 de julio de 1997"
30,22,41,874,542,561,1103,"6 de julio de 1997"
30,22,41,875,430,467,897,"6 de julio de 1997"
30,22,41,876,151,142,293,"6 de julio de 1997"
30,22,41,877,248,219,467,"6 de julio de 1997"
30,22,41,878,381,382,763,"6 de julio de 1997"
30,22,41,879,468,457,925,"6 de julio de 1997"
30,22,41,880,579,579,1158,"6 de julio de 1997"
30,22,41,881,358,341,699,"6 de julio de 1997"
30,22,41,882,530,525,1055,"6 de julio de 1997"
30,22,41,883,389,402,791,"6 de julio de 1997"
30,22,41,884,595,606,1201,"6 de julio de 1997"
30,22,41,885,510,526,1036,"6 de julio de 1997"
30,22,41,886,550,576,1126,"6 de julio de 1997"
30,22,41,887,761,789,1550,"6 de julio de 1997"
30,22,41,888,530,547,1077,"6 de julio de 1997"
30,22,41,889,464,518,982,"6 de julio de 1997"
30,22,41,890,483,484,967,"6 de julio de 1997"
30,22,41,891,640,672,1312,"6 de julio de 1997"
30,22,41,892,928,1086,2014,"6 de julio de 1997"
30,22,41,893,485,506,991,"6 de julio de 1997"
30,22,41,894,756,774,1530,"6 de julio de 1997"
30,22,41,895,556,602,1158,"6 de julio de 1997"
30,22,41,896,477,503,980,"6 de julio de 1997"
30,22,41,897,497,472,969,"6 de julio de 1997"
30,22,41,898,541,533,1074,"6 de julio de 1997"
30,22,41,899,444,496,940,"6 de julio de 1997"
30,22,41,900,518,570,1088,"6 de julio de 1997"
30,22,41,901,398,428,826,"6 de julio de 1997"
30,22,41,902,421,457,878,"6 de julio de 1997"
30,22,41,903,414,403,817,"6 de julio de 1997"
30,22,41,904,301,330,631,"6 de julio de 1997"
30,22,41,905,597,643,1240,"6 de julio de 1997"
30,22,41,906,695,714,1409,"6 de julio de 1997"
30,22,41,907,761,862,1623,"6 de julio de 1997"
30,22,41,908,258,215,473,"6 de julio de 1997"
30,22,41,909,479,448,927,"6 de julio de 1997"
30,22,41,910,589,588,1177,"6 de julio de 1997"
30,22,41,911,464,408,872,"6 de julio de 1997"
30,22,41,912,474,427,901,"6 de julio de 1997"
30,22,41,913,225,257,482,"6 de julio de 1997"
30,22,41,914,762,798,1560,"6 de julio de 1997"
30,22,41,915,666,620,1286,"6 de julio de 1997"
30,22,41,916,472,469,941,"6 de julio de 1997"
30,22,41,917,392,432,824,"6 de julio de 1997"
30,22,41,918,641,631,1272,"6 de julio de 1997"
30,22,41,919,767,755,1522,"6 de julio de 1997"
30,22,41,920,301,181,482,"6 de julio de 1997"
30,22,41,921,524,375,899,"6 de julio de 1997"
30,22,41,922,192,135,327,"6 de julio de 1997"
30,22,41,923,266,240,506,"6 de julio de 1997"
30,22,41,924,419,371,790,"6 de julio de 1997"
30,22,41,925,330,272,602,"6 de julio de 1997"
30,22,41,926,435,366,801,"6 de julio de 1997"
30,22,41,927,370,332,702,"6 de julio de 1997"
30,22,41,928,479,461,940,"6 de julio de 1997"
30,22,41,929,314,269,583,"6 de julio de 1997"
30,22,41,930,386,337,723,"6 de julio de 1997"
30,22,41,931,273,270,543,"6 de julio de 1997"
30,22,205,4647,565,669,1234,"6 de julio de 1997"
30,22,205,4648,463,457,920,"6 de julio de 1997"
30,22,205,4649,605,574,1179,"6 de julio de 1997"
30,22,205,4650,464,474,938,"6 de julio de 1997"
30,22,205,4651,419,424,843,"6 de julio de 1997"
30,22,205,4652,422,460,882,"6 de julio de 1997"
30,22,205,4653,489,547,1036,"6 de julio de 1997"
30,22,205,4654,295,262,557,"6 de julio de 1997"
30,22,205,4655,489,501,990,"6 de julio de 1997"
30,22,205,4656,322,292,614,"6 de julio de 1997"
30,22,205,4657,522,465,987,"6 de julio de 1997"
30,22,205,4658,369,310,679,"6 de julio de 1997"
30,22,205,4659,504,505,1009,"6 de julio de 1997"
30,22,205,4660,358,379,737,"6 de julio de 1997"
30,22,205,4661,360,365,725,"6 de julio de 1997"
30,22,205,4662,506,473,979,"6 de julio de 1997"
30,22,205,4663,408,347,755,"6 de julio de 1997"
30,22,205,4664,671,671,1342,"6 de julio de 1997"
30,22,205,4665,334,329,663,"6 de julio de 1997"
30,22,205,4666,268,220,488,"6 de julio de 1997"
30,22,206,4667,332,368,700,"6 de julio de 1997"
30,22,206,4668,418,442,860,"6 de julio de 1997"
30,22,206,4669,294,263,557,"6 de julio de 1997"
30,22,206,4670,599,580,1179,"6 de julio de 1997"
30,22,206,4671,562,591,1153,"6 de julio de 1997"
30,22,206,4672,647,679,1326,"6 de julio de 1997"
30,22,206,4673,430,497,927,"6 de julio de 1997"
30,22,206,4674,463,457,920,"6 de julio de 1997"
30,22,206,4675,499,567,1066,"6 de julio de 1997"
30,22,206,4676,673,721,1394,"6 de julio de 1997"
30,22,206,4677,453,474,927,"6 de julio de 1997"
30,22,206,4678,477,452,929,"6 de julio de 1997"
30,22,206,4679,688,704,1392,"6 de julio de 1997"
30,22,206,4680,328,348,676,"6 de julio de 1997"
30,22,206,4681,772,773,1545,"6 de julio de 1997"
30,22,206,4682,332,332,664,"6 de julio de 1997"
30,22,206,4683,466,491,957,"6 de julio de 1997"
30,22,206,4684,456,535,991,"6 de julio de 1997"
30,22,206,4685,675,656,1331,"6 de julio de 1997"
30,22,206,4686,533,561,1094,"6 de julio de 1997"
30,22,206,4687,723,820,1543,"6 de julio de 1997"
30,22,206,4688,789,784,1573,"6 de julio de 1997"
30,22,206,4689,403,399,802,"6 de julio de 1997"
30,22,206,4690,632,631,1263,"6 de julio de 1997"
30,22,206,4691,235,189,424,"6 de julio de 1997"
30,22,206,4692,541,543,1084,"6 de julio de 1997"
30,22,206,4693,239,201,440,"6 de julio de 1997"
30,22,206,4694,306,248,554,"6 de julio de 1997"
30,22,206,4695,293,271,564,"6 de julio de 1997"
30,23,63,1413,566,585,1151,"6 de julio de 1997"
30,23,63,1414,850,859,1709,"6 de julio de 1997"
30,23,63,1415,476,496,972,"6 de julio de 1997"
30,23,63,1416,571,618,1189,"6 de julio de 1997"
30,23,63,1417,683,754,1437,"6 de julio de 1997"
30,23,63,1418,450,468,918,"6 de julio de 1997"
30,23,63,1419,590,632,1222,"6 de julio de 1997"
30,23,63,1420,377,379,756,"6 de julio de 1997"
30,23,63,1421,431,496,927,"6 de julio de 1997"
30,23,63,1422,632,649,1281,"6 de julio de 1997"
30,23,63,1423,365,363,728,"6 de julio de 1997"
30,23,63,1424,454,435,889,"6 de julio de 1997"
30,23,63,1425,499,507,1006,"6 de julio de 1997"
30,23,63,1426,447,502,949,"6 de julio de 1997"
30,23,63,1427,469,488,957,"6 de julio de 1997"
30,23,63,1428,406,480,886,"6 de julio de 1997"
30,23,63,1429,493,585,1078,"6 de julio de 1997"
30,23,63,1430,363,388,751,"6 de julio de 1997"
30,23,63,1431,513,529,1042,"6 de julio de 1997"
30,23,63,1432,489,520,1009,"6 de julio de 1997"
30,23,63,1433,464,496,960,"6 de julio de 1997"
30,23,63,1434,563,570,1133,"6 de julio de 1997"
30,23,63,1435,488,544,1032,"6 de julio de 1997"
30,23,63,1436,486,506,992,"6 de julio de 1997"
30,23,63,1437,646,570,1216,"6 de julio de 1997"
30,23,63,1438,388,404,792,"6 de julio de 1997"
30,23,63,1439,217,217,434,"6 de julio de 1997"
30,23,63,1440,304,210,514,"6 de julio de 1997"
30,23,63,1441,396,304,700,"6 de julio de 1997"
30,23,63,1442,379,285,664,"6 de julio de 1997"
30,23,63,1443,534,424,958,"6 de julio de 1997"
30,23,63,1444,554,406,960,"6 de julio de 1997"
30,23,63,1445,642,496,1138,"6 de julio de 1997"
30,23,63,1446,967,797,1764,"6 de julio de 1997"
30,23,63,1447,440,340,780,"6 de julio de 1997"
30,23,63,1448,557,447,1004,"6 de julio de 1997"
30,23,63,1449,250,267,517,"6 de julio de 1997"
30,23,63,1450,201,135,336,"6 de julio de 1997"
30,23,63,1451,426,298,724,"6 de julio de 1997"
30,23,63,1452,444,362,806,"6 de julio de 1997"
30,23,63,1453,566,437,1003,"6 de julio de 1997"
30,23,63,1454,601,492,1093,"6 de julio de 1997"
30,23,63,1455,752,588,1340,"6 de julio de 1997"
30,23,84,1775,757,741,1498,"6 de julio de 1997"
30,23,84,1776,683,597,1280,"6 de julio de 1997"
30,23,84,1777,624,554,1178,"6 de julio de 1997"
30,23,84,1778,626,594,1220,"6 de julio de 1997"
30,23,84,1779,58,50,108,"6 de julio de 1997"
30,23,84,1780,580,481,1061,"6 de julio de 1997"
30,23,84,1781,140,83,223,"6 de julio de 1997"
30,23,84,1782,500,159,659,"6 de julio de 1997"
30,23,84,1783,328,252,580,"6 de julio de 1997"
30,23,109,2420,596,602,1198,"6 de julio de 1997"
30,23,109,2421,533,553,1086,"6 de julio de 1997"
30,23,109,2422,471,511,982,"6 de julio de 1997"
30,23,109,2423,466,501,967,"6 de julio de 1997"
30,23,109,2424,433,443,876,"6 de julio de 1997"
30,23,109,2425,528,523,1051,"6 de julio de 1997"
30,23,109,2426,491,511,1002,"6 de julio de 1997"
30,23,109,2427,731,789,1520,"6 de julio de 1997"
30,23,109,2428,554,583,1137,"6 de julio de 1997"
30,23,109,2429,592,678,1270,"6 de julio de 1997"
30,23,109,2430,466,484,950,"6 de julio de 1997"
30,23,109,2431,1122,1011,2133,"6 de julio de 1997"
30,23,109,2432,765,891,1656,"6 de julio de 1997"
30,23,109,2433,522,580,1102,"6 de julio de 1997"
30,23,109,2434,1012,518,1530,"6 de julio de 1997"
30,23,109,2435,730,826,1556,"6 de julio de 1997"
30,23,109,2436,484,529,1013,"6 de julio de 1997"
30,23,109,2437,449,475,924,"6 de julio de 1997"
30,23,109,2438,435,428,863,"6 de julio de 1997"
30,23,109,2439,410,425,835,"6 de julio de 1997"
30,23,109,2440,656,695,1351,"6 de julio de 1997"
30,23,109,2441,556,588,1144,"6 de julio de 1997"
30,23,109,2442,388,428,816,"6 de julio de 1997"
30,23,109,2443,376,378,754,"6 de julio de 1997"
30,23,109,2444,456,509,965,"6 de julio de 1997"
30,23,109,2445,519,623,1142,"6 de julio de 1997"
30,23,109,2446,547,584,1131,"6 de julio de 1997"
30,23,109,2447,485,599,1084,"6 de julio de 1997"
30,23,109,2448,506,555,1061,"6 de julio de 1997"
30,23,109,2449,600,720,1320,"6 de julio de 1997"
30,23,109,2450,470,476,946,"6 de julio de 1997"
30,23,109,2451,353,356,709,"6 de julio de 1997"
30,23,109,2452,698,764,1462,"6 de julio de 1997"
30,23,109,2453,279,306,585,"6 de julio de 1997"
30,23,109,2454,239,288,527,"6 de julio de 1997"
30,23,109,2455,226,261,487,"6 de julio de 1997"
30,23,109,2456,345,421,766,"6 de julio de 1997"
30,23,109,2457,359,439,798,"6 de julio de 1997"
30,23,109,2458,593,647,1240,"6 de julio de 1997"
30,23,109,2459,544,566,1110,"6 de julio de 1997"
30,23,109,2460,581,619,1200,"6 de julio de 1997"
30,23,109,2461,391,468,859,"6 de julio de 1997"
30,23,109,2462,698,767,1465,"6 de julio de 1997"
30,23,109,2463,309,342,651,"6 de julio de 1997"
30,23,109,2464,637,681,1318,"6 de julio de 1997"
30,23,109,2465,893,1035,1928,"6 de julio de 1997"
30,23,109,2466,299,334,633,"6 de julio de 1997"
30,23,109,2467,353,390,743,"6 de julio de 1997"
30,23,109,2468,664,669,1333,"6 de julio de 1997"
30,23,109,2469,534,559,1093,"6 de julio de 1997"
30,23,109,2470,712,813,1525,"6 de julio de 1997"
30,23,109,2471,460,492,952,"6 de julio de 1997"
30,23,109,2472,450,550,1000,"6 de julio de 1997"
30,23,109,2473,570,627,1197,"6 de julio de 1997"
30,23,109,2474,355,397,752,"6 de julio de 1997"
30,23,109,2475,494,549,1043,"6 de julio de 1997"
30,23,109,2476,715,831,1546,"6 de julio de 1997"
30,23,109,2477,584,639,1223,"6 de julio de 1997"
30,23,109,2478,561,617,1178,"6 de julio de 1997"
30,23,109,2479,627,609,1236,"6 de julio de 1997"
30,23,109,2480,381,410,791,"6 de julio de 1997"
30,23,109,2481,574,610,1184,"6 de julio de 1997"
30,23,109,2482,534,558,1092,"6 de julio de 1997"
30,23,109,2483,527,605,1132,"6 de julio de 1997"
30,23,109,2484,409,464,873,"6 de julio de 1997"
30,23,109,2485,389,457,846,"6 de julio de 1997"
30,23,109,2486,575,625,1200,"6 de julio de 1997"
30,23,109,2487,340,397,737,"6 de julio de 1997"
30,23,109,2488,513,565,1078,"6 de julio de 1997"
30,23,109,2489,759,809,1568,"6 de julio de 1997"
30,23,109,2490,266,264,530,"6 de julio de 1997"
30,23,109,2491,281,280,561,"6 de julio de 1997"
30,23,109,2492,670,669,1339,"6 de julio de 1997"
30,23,109,2493,231,232,463,"6 de julio de 1997"
30,23,109,2494,385,312,697,"6 de julio de 1997"
30,23,109,2495,316,325,641,"6 de julio de 1997"
30,23,109,2496,243,188,431,"6 de julio de 1997"
30,23,109,2497,252,230,482,"6 de julio de 1997"
30,23,109,2498,471,416,887,"6 de julio de 1997"
30,23,109,2499,551,409,960,"6 de julio de 1997"
30,23,109,2500,445,383,828,"6 de julio de 1997"
30,23,109,2501,444,386,830,"6 de julio de 1997"
30,23,109,2502,499,435,934,"6 de julio de 1997"
30,23,109,2503,372,314,686,"6 de julio de 1997"
30,23,109,2504,553,455,1008,"6 de julio de 1997"
30,23,109,2505,322,300,622,"6 de julio de 1997"
30,23,109,2506,349,361,710,"6 de julio de 1997"
30,23,109,2507,348,273,621,"6 de julio de 1997"
30,23,109,2508,546,390,936,"6 de julio de 1997"
30,23,109,2509,382,294,676,"6 de julio de 1997"
30,23,109,2510,457,348,805,"6 de julio de 1997"
30,23,109,2511,287,224,511,"6 de julio de 1997"
30,23,109,2512,558,423,981,"6 de julio de 1997"
30,23,109,2513,559,433,992,"6 de julio de 1997"
30,23,109,2514,533,380,913,"6 de julio de 1997"
30,23,109,2515,615,460,1075,"6 de julio de 1997"
30,23,109,2516,610,476,1086,"6 de julio de 1997"
30,23,109,2517,555,416,971,"6 de julio de 1997"
30,23,109,2518,509,416,925,"6 de julio de 1997"
30,23,109,2519,621,422,1043,"6 de julio de 1997"
30,23,109,2520,421,322,743,"6 de julio de 1997"
30,23,109,2521,389,284,673,"6 de julio de 1997"
30,23,109,2522,396,350,746,"6 de julio de 1997"
30,23,109,2523,123,98,221,"6 de julio de 1997"
30,23,109,2524,514,428,942,"6 de julio de 1997"
30,23,109,2525,652,535,1187,"6 de julio de 1997"
30,23,112,2583,609,537,1146,"6 de julio de 1997"
30,23,112,2584,404,343,747,"6 de julio de 1997"
30,23,112,2585,450,364,814,"6 de julio de 1997"
30,23,112,2586,593,596,1189,"6 de julio de 1997"
30,23,112,2587,308,234,542,"6 de julio de 1997"
30,23,112,2588,674,729,1403,"6 de julio de 1997"
30,23,112,2589,353,358,711,"6 de julio de 1997"
30,23,112,2590,590,608,1198,"6 de julio de 1997"
30,23,112,2591,336,355,691,"6 de julio de 1997"
30,23,112,2592,634,556,1190,"6 de julio de 1997"
30,23,112,2593,193,157,350,"6 de julio de 1997"
31,1,6,27,628,602,1230,"6 de julio de 1997"
31,1,6,28,623,597,1220,"6 de julio de 1997"
31,1,6,29,425,435,860,"6 de julio de 1997"
31,1,6,30,356,316,672,"6 de julio de 1997"
31,1,6,31,155,145,300,"6 de julio de 1997"
31,1,6,32,124,101,225,"6 de julio de 1997"
31,1,8,37,432,410,842,"6 de julio de 1997"
31,1,8,38,392,324,716,"6 de julio de 1997"
31,1,8,39,122,105,227,"6 de julio de 1997"
31,1,8,40,212,188,400,"6 de julio de 1997"
31,1,12,54,139,171,310,"6 de julio de 1997"
31,1,12,55,289,351,640,"6 de julio de 1997"
31,1,12,56,264,337,601,"6 de julio de 1997"
31,1,12,57,229,249,478,"6 de julio de 1997"
31,1,12,58,98,97,195,"6 de julio de 1997"
31,1,14,65,295,273,568,"6 de julio de 1997"
31,1,14,66,80,68,148,"6 de julio de 1997"
31,1,17,71,464,434,898,"6 de julio de 1997"
31,1,17,72,221,194,415,"6 de julio de 1997"
31,1,17,73,210,210,420,"6 de julio de 1997"
31,1,17,74,210,191,401,"6 de julio de 1997"
31,1,19,78,830,805,1635,"6 de julio de 1997"
31,1,19,79,440,401,841,"6 de julio de 1997"
31,1,19,80,468,429,897,"6 de julio de 1997"
31,1,19,81,662,638,1300,"6 de julio de 1997"
31,1,19,82,412,358,770,"6 de julio de 1997"
31,1,19,83,573,524,1097,"6 de julio de 1997"
31,1,19,84,380,382,762,"6 de julio de 1997"
31,1,19,85,164,135,299,"6 de julio de 1997"
31,1,19,86,610,553,1163,"6 de julio de 1997"
31,1,19,87,113,92,205,"6 de julio de 1997"
31,1,19,88,380,346,726,"6 de julio de 1997"
31,1,19,89,462,410,872,"6 de julio de 1997"
31,1,19,90,216,172,388,"6 de julio de 1997"
31,1,21,93,380,403,783,"6 de julio de 1997"
31,1,21,94,362,373,735,"6 de julio de 1997"
31,1,21,95,303,332,635,"6 de julio de 1997"
31,1,21,96,190,166,356,"6 de julio de 1997"
31,1,21,97,96,91,187,"6 de julio de 1997"
31,1,21,98,135,137,272,"6 de julio de 1997"
31,1,22,99,525,530,1055,"6 de julio de 1997"
31,1,22,100,32,34,66,"6 de julio de 1997"
31,1,22,101,121,101,222,"6 de julio de 1997"
31,1,22,102,215,198,413,"6 de julio de 1997"
31,1,27,114,520,479,999,"6 de julio de 1997"
31,1,27,115,660,659,1319,"6 de julio de 1997"
31,1,27,116,311,297,608,"6 de julio de 1997"
31,1,27,117,666,587,1253,"6 de julio de 1997"
31,1,27,118,402,368,770,"6 de julio de 1997"
31,1,27,119,20,13,33,"6 de julio de 1997"
31,1,28,120,357,313,670,"6 de julio de 1997"
31,1,28,121,382,323,705,"6 de julio de 1997"
31,1,29,122,318,285,603,"6 de julio de 1997"
31,1,29,123,381,371,752,"6 de julio de 1997"
31,1,29,124,318,281,599,"6 de julio de 1997"
31,1,29,125,357,332,689,"6 de julio de 1997"
31,1,29,126,334,306,640,"6 de julio de 1997"
31,1,30,127,227,229,456,"6 de julio de 1997"
31,1,30,128,203,197,400,"6 de julio de 1997"
31,1,30,129,351,353,704,"6 de julio de 1997"
31,1,30,130,205,169,374,"6 de julio de 1997"
31,1,31,131,283,289,572,"6 de julio de 1997"
31,1,31,132,476,485,961,"6 de julio de 1997"
31,1,31,133,161,130,291,"6 de julio de 1997"
31,1,32,134,560,535,1095,"6 de julio de 1997"
31,1,32,135,407,335,742,"6 de julio de 1997"
31,1,32,136,404,353,757,"6 de julio de 1997"
31,1,32,137,515,484,999,"6 de julio de 1997"
31,1,32,138,608,538,1146,"6 de julio de 1997"
31,1,32,139,180,165,345,"6 de julio de 1997"
31,1,32,140,125,112,237,"6 de julio de 1997"
31,1,32,141,406,374,780,"6 de julio de 1997"
31,1,40,189,550,544,1094,"6 de julio de 1997"
31,1,40,190,357,398,755,"6 de julio de 1997"
31,1,40,191,296,305,601,"6 de julio de 1997"
31,1,40,192,593,633,1226,"6 de julio de 1997"
31,1,40,193,549,527,1076,"6 de julio de 1997"
31,1,40,194,443,436,879,"6 de julio de 1997"
31,1,40,195,506,499,1005,"6 de julio de 1997"
31,1,40,196,414,456,870,"6 de julio de 1997"
31,1,40,197,521,498,1019,"6 de julio de 1997"
31,1,40,198,550,583,1133,"6 de julio de 1997"
31,1,40,199,581,570,1151,"6 de julio de 1997"
31,1,40,200,442,436,878,"6 de julio de 1997"
31,1,40,201,487,519,1006,"6 de julio de 1997"
31,1,40,202,113,114,227,"6 de julio de 1997"
31,1,40,203,357,314,671,"6 de julio de 1997"
31,1,42,224,439,426,865,"6 de julio de 1997"
31,1,42,225,427,409,836,"6 de julio de 1997"
31,1,42,226,502,485,987,"6 de julio de 1997"
31,1,43,227,529,494,1023,"6 de julio de 1997"
31,1,57,709,445,441,886,"6 de julio de 1997"
31,1,57,710,406,371,777,"6 de julio de 1997"
31,1,57,711,365,434,799,"6 de julio de 1997"
31,1,57,712,434,444,878,"6 de julio de 1997"
31,1,57,713,141,97,238,"6 de julio de 1997"
31,1,57,714,302,311,613,"6 de julio de 1997"
31,1,60,765,326,301,627,"6 de julio de 1997"
31,1,61,766,433,383,816,"6 de julio de 1997"
31,1,61,767,175,162,337,"6 de julio de 1997"
31,1,61,768,227,170,397,"6 de julio de 1997"
31,1,65,776,329,272,601,"6 de julio de 1997"
31,1,65,777,170,123,293,"6 de julio de 1997"
31,1,70,796,468,472,940,"6 de julio de 1997"
31,1,70,797,604,549,1153,"6 de julio de 1997"
31,1,71,798,360,337,697,"6 de julio de 1997"
31,1,71,799,108,77,185,"6 de julio de 1997"
31,1,77,817,478,442,920,"6 de julio de 1997"
31,1,77,818,226,215,441,"6 de julio de 1997"
31,1,81,851,285,312,597,"6 de julio de 1997"
31,1,81,852,254,303,557,"6 de julio de 1997"
31,1,81,853,63,73,136,"6 de julio de 1997"
31,1,81,854,49,44,93,"6 de julio de 1997"
31,1,84,861,632,604,1236,"6 de julio de 1997"
31,1,84,862,406,383,789,"6 de julio de 1997"
31,1,84,863,406,402,808,"6 de julio de 1997"
31,1,84,864,459,471,930,"6 de julio de 1997"
31,1,84,865,57,47,104,"6 de julio de 1997"
31,1,84,866,118,103,221,"6 de julio de 1997"
31,1,85,867,526,496,1022,"6 de julio de 1997"
31,1,85,868,373,399,772,"6 de julio de 1997"
31,1,85,869,531,496,1027,"6 de julio de 1997"
31,1,85,870,529,448,977,"6 de julio de 1997"
31,1,85,871,102,73,175,"6 de julio de 1997"
31,1,85,872,105,73,178,"6 de julio de 1997"
31,1,85,873,230,167,397,"6 de julio de 1997"
31,1,85,874,598,548,1146,"6 de julio de 1997"
31,1,86,875,208,190,398,"6 de julio de 1997"
31,1,86,876,424,411,835,"6 de julio de 1997"
31,1,86,877,44,41,85,"6 de julio de 1997"
31,1,91,901,312,322,634,"6 de julio de 1997"
31,1,91,902,270,289,559,"6 de julio de 1997"
31,1,91,903,535,467,1002,"6 de julio de 1997"
31,1,91,904,510,436,946,"6 de julio de 1997"
31,1,91,905,326,255,581,"6 de julio de 1997"
31,1,91,906,115,105,220,"6 de julio de 1997"
31,1,91,907,318,281,599,"6 de julio de 1997"
31,1,92,908,370,371,741,"6 de julio de 1997"
31,1,92,909,287,286,573,"6 de julio de 1997"
31,1,92,910,190,162,352,"6 de julio de 1997"
31,1,92,911,416,408,824,"6 de julio de 1997"
31,1,96,932,216,189,405,"6 de julio de 1997"
31,1,96,933,260,262,522,"6 de julio de 1997"
31,1,96,934,348,357,705,"6 de julio de 1997"
31,1,96,935,317,334,651,"6 de julio de 1997"
31,1,96,936,238,223,461,"6 de julio de 1997"
31,1,96,937,369,390,759,"6 de julio de 1997"
31,1,96,938,532,576,1108,"6 de julio de 1997"
31,1,96,939,419,451,870,"6 de julio de 1997"
31,1,96,940,198,212,410,"6 de julio de 1997"
31,1,96,941,265,308,573,"6 de julio de 1997"
31,1,96,942,449,479,928,"6 de julio de 1997"
31,1,96,943,363,333,696,"6 de julio de 1997"
31,1,96,944,424,439,863,"6 de julio de 1997"
31,1,96,945,525,563,1088,"6 de julio de 1997"
31,1,96,946,304,286,590,"6 de julio de 1997"
31,1,96,947,246,256,502,"6 de julio de 1997"
31,1,96,948,391,386,777,"6 de julio de 1997"
31,1,96,949,525,501,1026,"6 de julio de 1997"
31,1,96,950,476,544,1020,"6 de julio de 1997"
31,1,96,951,402,418,820,"6 de julio de 1997"
31,1,96,952,403,398,801,"6 de julio de 1997"
31,1,96,953,304,294,598,"6 de julio de 1997"
31,1,96,954,485,507,992,"6 de julio de 1997"
31,1,96,955,380,394,774,"6 de julio de 1997"
31,1,96,956,294,260,554,"6 de julio de 1997"
31,1,96,957,189,200,389,"6 de julio de 1997"
31,1,96,958,272,190,462,"6 de julio de 1997"
31,1,96,959,600,470,1070,"6 de julio de 1997"
31,1,96,960,280,235,515,"6 de julio de 1997"
31,1,96,961,244,168,412,"6 de julio de 1997"
31,1,96,962,104,73,177,"6 de julio de 1997"
31,1,96,963,98,78,176,"6 de julio de 1997"
31,1,96,964,339,261,600,"6 de julio de 1997"
31,1,96,965,184,149,333,"6 de julio de 1997"
31,1,96,966,525,394,919,"6 de julio de 1997"
31,1,96,967,176,156,332,"6 de julio de 1997"
31,1,96,968,458,313,771,"6 de julio de 1997"
31,1,96,969,352,252,604,"6 de julio de 1997"
31,1,96,970,654,584,1238,"6 de julio de 1997"
31,1,96,971,467,385,852,"6 de julio de 1997"
31,1,96,972,851,741,1592,"6 de julio de 1997"
31,1,97,973,303,280,583,"6 de julio de 1997"
31,1,97,974,387,356,743,"6 de julio de 1997"
31,1,97,975,324,323,647,"6 de julio de 1997"
31,1,97,976,59,56,115,"6 de julio de 1997"
31,1,99,985,339,326,665,"6 de julio de 1997"
31,1,99,986,321,294,615,"6 de julio de 1997"
31,1,99,987,109,96,205,"6 de julio de 1997"
31,1,102,1010,346,325,671,"6 de julio de 1997"
31,1,102,1011,295,323,618,"6 de julio de 1997"
31,1,102,1012,342,369,711,"6 de julio de 1997"
31,1,102,1013,391,400,791,"6 de julio de 1997"
31,1,102,1014,307,327,634,"6 de julio de 1997"
31,1,102,1015,266,287,553,"6 de julio de 1997"
31,1,102,1016,337,405,742,"6 de julio de 1997"
31,1,102,1017,412,426,838,"6 de julio de 1997"
31,1,102,1018,542,566,1108,"6 de julio de 1997"
31,1,102,1019,462,483,945,"6 de julio de 1997"
31,1,102,1020,272,285,557,"6 de julio de 1997"
31,1,102,1021,468,498,966,"6 de julio de 1997"
31,1,102,1022,380,402,782,"6 de julio de 1997"
31,1,102,1023,468,510,978,"6 de julio de 1997"
31,1,102,1024,404,455,859,"6 de julio de 1997"
31,1,102,1025,396,420,816,"6 de julio de 1997"
31,1,102,1026,926,286,1212,"6 de julio de 1997"
31,1,102,1027,324,412,736,"6 de julio de 1997"
31,1,102,1028,388,387,775,"6 de julio de 1997"
31,1,102,1029,374,397,771,"6 de julio de 1997"
31,1,102,1030,334,340,674,"6 de julio de 1997"
31,1,102,1031,352,326,678,"6 de julio de 1997"
31,1,102,1032,582,519,1101,"6 de julio de 1997"
31,1,102,1033,725,590,1315,"6 de julio de 1997"
31,1,102,1034,449,374,823,"6 de julio de 1997"
31,1,102,1035,208,222,430,"6 de julio de 1997"
31,1,102,1036,390,314,704,"6 de julio de 1997"
31,1,102,1037,161,158,319,"6 de julio de 1997"
31,1,102,1038,245,262,507,"6 de julio de 1997"
31,1,102,1039,289,274,563,"6 de julio de 1997"
31,1,102,1040,584,592,1176,"6 de julio de 1997"
31,1,102,1041,463,483,946,"6 de julio de 1997"
31,1,102,1042,206,199,405,"6 de julio de 1997"
31,1,104,1045,309,277,586,"6 de julio de 1997"
31,1,104,1046,384,356,740,"6 de julio de 1997"
31,1,104,1047,442,392,834,"6 de julio de 1997"
31,1,104,1048,245,195,440,"6 de julio de 1997"
31,1,104,1049,174,160,334,"6 de julio de 1997"
31,1,104,1050,80,72,152,"6 de julio de 1997"
31,1,104,1051,226,211,437,"6 de julio de 1997"
31,1,104,1052,341,275,616,"6 de julio de 1997"
31,1,104,1053,423,343,766,"6 de julio de 1997"
31,1,104,1054,85,74,159,"6 de julio de 1997"
31,1,104,1055,466,366,832,"6 de julio de 1997"
31,2,2,7,561,495,1056,"6 de julio de 1997"
31,2,2,8,660,581,1241,"6 de julio de 1997"
31,2,2,9,761,742,1503,"6 de julio de 1997"
31,2,2,10,736,726,1462,"6 de julio de 1997"
31,2,2,11,209,192,401,"6 de julio de 1997"
31,2,2,12,367,393,760,"6 de julio de 1997"
31,2,2,13,189,192,381,"6 de julio de 1997"
31,2,4,20,523,510,1033,"6 de julio de 1997"
31,2,4,21,337,346,683,"6 de julio de 1997"
31,2,4,22,345,362,707,"6 de julio de 1997"
31,2,4,23,252,262,514,"6 de julio de 1997"
31,2,4,24,229,207,436,"6 de julio de 1997"
31,2,5,25,338,356,694,"6 de julio de 1997"
31,2,5,26,302,273,575,"6 de julio de 1997"
31,2,7,33,372,347,719,"6 de julio de 1997"
31,2,7,34,556,505,1061,"6 de julio de 1997"
31,2,7,35,534,497,1031,"6 de julio de 1997"
31,2,7,36,442,460,902,"6 de julio de 1997"
31,2,9,41,255,258,513,"6 de julio de 1997"
31,2,9,42,351,373,724,"6 de julio de 1997"
31,2,9,43,341,371,712,"6 de julio de 1997"
31,2,9,44,358,339,697,"6 de julio de 1997"
31,2,9,45,92,76,168,"6 de julio de 1997"
31,2,9,46,49,35,84,"6 de julio de 1997"
31,2,11,50,339,299,638,"6 de julio de 1997"
31,2,11,51,316,284,600,"6 de julio de 1997"
31,2,11,52,355,308,663,"6 de julio de 1997"
31,2,11,53,302,249,551,"6 de julio de 1997"
31,2,13,59,500,495,995,"6 de julio de 1997"
31,2,13,60,261,254,515,"6 de julio de 1997"
31,2,13,61,486,465,951,"6 de julio de 1997"
31,2,13,62,482,497,979,"6 de julio de 1997"
31,2,13,63,51,49,100,"6 de julio de 1997"
31,2,13,64,375,337,712,"6 de julio de 1997"
31,2,20,91,569,593,1162,"6 de julio de 1997"
31,2,20,92,414,390,804,"6 de julio de 1997"
31,2,26,110,302,289,591,"6 de julio de 1997"
31,2,26,111,418,418,836,"6 de julio de 1997"
31,2,26,112,420,395,815,"6 de julio de 1997"
31,2,26,113,42,25,67,"6 de julio de 1997"
31,2,35,157,302,336,638,"6 de julio de 1997"
31,2,35,158,221,223,444,"6 de julio de 1997"
31,2,35,159,487,506,993,"6 de julio de 1997"
31,2,35,160,425,473,898,"6 de julio de 1997"
31,2,35,161,174,168,342,"6 de julio de 1997"
31,2,38,172,290,215,505,"6 de julio de 1997"
31,2,38,173,352,332,684,"6 de julio de 1997"
31,2,38,174,443,427,870,"6 de julio de 1997"
31,2,38,175,475,478,953,"6 de julio de 1997"
31,2,38,176,482,463,945,"6 de julio de 1997"
31,2,38,177,532,494,1026,"6 de julio de 1997"
31,2,38,178,786,732,1518,"6 de julio de 1997"
31,2,38,179,546,486,1032,"6 de julio de 1997"
31,2,38,180,411,363,774,"6 de julio de 1997"
31,2,38,181,464,456,920,"6 de julio de 1997"
31,2,38,182,298,237,535,"6 de julio de 1997"
31,2,38,183,271,242,513,"6 de julio de 1997"
31,2,38,184,192,173,365,"6 de julio de 1997"
31,2,38,185,66,51,117,"6 de julio de 1997"
31,2,38,186,657,583,1240,"6 de julio de 1997"
31,2,39,187,374,385,759,"6 de julio de 1997"
31,2,39,188,460,417,877,"6 de julio de 1997"
31,2,41,204,229,270,499,"6 de julio de 1997"
31,2,41,205,566,569,1135,"6 de julio de 1997"
31,2,41,206,766,774,1540,"6 de julio de 1997"
31,2,41,207,643,654,1297,"6 de julio de 1997"
31,2,41,208,654,652,1306,"6 de julio de 1997"
31,2,41,209,375,388,763,"6 de julio de 1997"
31,2,41,210,300,363,663,"6 de julio de 1997"
31,2,41,211,385,446,831,"6 de julio de 1997"
31,2,41,212,417,429,846,"6 de julio de 1997"
31,2,41,213,477,590,1067,"6 de julio de 1997"
31,2,41,214,488,568,1056,"6 de julio de 1997"
31,2,41,215,239,321,560,"6 de julio de 1997"
31,2,41,216,167,217,384,"6 de julio de 1997"
31,2,41,217,686,761,1447,"6 de julio de 1997"
31,2,41,218,440,495,935,"6 de julio de 1997"
31,2,41,219,396,423,819,"6 de julio de 1997"
31,2,41,220,227,201,428,"6 de julio de 1997"
31,2,41,221,118,110,228,"6 de julio de 1997"
31,2,41,222,169,192,361,"6 de julio de 1997"
31,2,41,223,215,251,466,"6 de julio de 1997"
31,2,44,228,222,199,421,"6 de julio de 1997"
31,2,44,229,594,566,1160,"6 de julio de 1997"
31,2,44,230,660,633,1293,"6 de julio de 1997"
31,2,44,231,61,50,111,"6 de julio de 1997"
31,2,51,657,224,222,446,"6 de julio de 1997"
31,2,51,658,324,331,655,"6 de julio de 1997"
31,2,51,659,155,128,283,"6 de julio de 1997"
31,2,51,660,182,157,339,"6 de julio de 1997"
31,2,52,661,714,734,1448,"6 de julio de 1997"
31,2,52,662,605,647,1252,"6 de julio de 1997"
31,2,52,663,562,633,1195,"6 de julio de 1997"
31,2,52,664,358,402,760,"6 de julio de 1997"
31,2,52,665,521,554,1075,"6 de julio de 1997"
31,2,52,666,489,513,1002,"6 de julio de 1997"
31,2,52,667,635,689,1324,"6 de julio de 1997"
31,2,52,668,790,793,1583,"6 de julio de 1997"
31,2,52,669,434,462,896,"6 de julio de 1997"
31,2,52,670,283,275,558,"6 de julio de 1997"
31,2,52,671,241,220,461,"6 de julio de 1997"
31,2,52,672,273,246,519,"6 de julio de 1997"
31,2,52,673,52,60,112,"6 de julio de 1997"
31,2,52,674,454,506,960,"6 de julio de 1997"
31,2,52,675,87,72,159,"6 de julio de 1997"
31,2,52,676,578,601,1179,"6 de julio de 1997"
31,2,52,677,568,533,1101,"6 de julio de 1997"
31,2,52,678,186,175,361,"6 de julio de 1997"
31,2,52,679,272,295,567,"6 de julio de 1997"
31,2,54,687,244,231,475,"6 de julio de 1997"
31,2,54,688,454,466,920,"6 de julio de 1997"
31,2,54,689,87,91,178,"6 de julio de 1997"
31,2,59,734,387,316,703,"6 de julio de 1997"
31,2,59,735,50,44,94,"6 de julio de 1997"
31,2,59,736,46,40,86,"6 de julio de 1997"
31,2,59,737,599,619,1218,"6 de julio de 1997"
31,2,59,738,376,41,417,"6 de julio de 1997"
31,2,59,739,260,300,560,"6 de julio de 1997"
31,2,59,740,487,548,1035,"6 de julio de 1997"
31,2,59,741,684,770,1454,"6 de julio de 1997"
31,2,59,742,623,645,1268,"6 de julio de 1997"
31,2,59,743,381,374,755,"6 de julio de 1997"
31,2,59,744,359,383,742,"6 de julio de 1997"
31,2,59,745,372,459,831,"6 de julio de 1997"
31,2,59,746,574,601,1175,"6 de julio de 1997"
31,2,59,747,213,224,437,"6 de julio de 1997"
31,2,59,748,366,437,803,"6 de julio de 1997"
31,2,59,749,332,339,671,"6 de julio de 1997"
31,2,59,750,371,392,763,"6 de julio de 1997"
31,2,59,751,23,20,43,"6 de julio de 1997"
31,2,59,752,26,21,47,"6 de julio de 1997"
31,2,59,753,725,801,1526,"6 de julio de 1997"
31,2,59,754,697,773,1470,"6 de julio de 1997"
31,2,59,755,537,590,1127,"6 de julio de 1997"
31,2,59,756,388,419,807,"6 de julio de 1997"
31,2,59,757,710,797,1507,"6 de julio de 1997"
31,2,59,758,720,753,1473,"6 de julio de 1997"
31,2,59,759,101,150,251,"6 de julio de 1997"
31,2,59,760,177,152,329,"6 de julio de 1997"
31,2,59,761,219,249,468,"6 de julio de 1997"
31,2,59,762,228,202,430,"6 de julio de 1997"
31,2,59,763,613,644,1257,"6 de julio de 1997"
31,2,59,764,489,502,991,"6 de julio de 1997"
31,2,63,772,681,637,1318,"6 de julio de 1997"
31,2,63,773,206,194,400,"6 de julio de 1997"
31,2,63,774,346,328,674,"6 de julio de 1997"
31,2,68,786,436,417,853,"6 de julio de 1997"
31,2,68,787,432,396,828,"6 de julio de 1997"
31,2,68,788,142,127,269,"6 de julio de 1997"
31,2,72,800,325,313,638,"6 de julio de 1997"
31,2,72,801,332,297,629,"6 de julio de 1997"
31,2,78,819,355,361,716,"6 de julio de 1997"
31,2,78,820,156,164,320,"6 de julio de 1997"
31,2,78,821,150,176,326,"6 de julio de 1997"
31,2,78,822,383,404,787,"6 de julio de 1997"
31,2,78,823,30,27,57,"6 de julio de 1997"
31,2,78,824,136,112,248,"6 de julio de 1997"
31,2,78,825,45,36,81,"6 de julio de 1997"
31,2,82,855,370,370,740,"6 de julio de 1997"
31,2,82,856,250,234,484,"6 de julio de 1997"
31,2,82,857,272,247,519,"6 de julio de 1997"
31,2,82,858,309,284,593,"6 de julio de 1997"
31,2,83,859,314,266,580,"6 de julio de 1997"
31,2,83,860,162,130,292,"6 de julio de 1997"
31,2,87,878,601,549,1150,"6 de julio de 1997"
31,2,87,879,537,513,1050,"6 de julio de 1997"
31,2,88,880,239,251,490,"6 de julio de 1997"
31,2,88,881,339,334,673,"6 de julio de 1997"
31,2,90,898,526,476,1002,"6 de julio de 1997"
31,2,90,899,483,452,935,"6 de julio de 1997"
31,2,90,900,458,451,909,"6 de julio de 1997"
31,2,93,912,403,381,784,"6 de julio de 1997"
31,2,93,913,654,715,1369,"6 de julio de 1997"
31,2,93,914,497,506,1003,"6 de julio de 1997"
31,2,93,915,396,394,790,"6 de julio de 1997"
31,2,93,916,488,510,998,"6 de julio de 1997"
31,2,93,917,479,483,962,"6 de julio de 1997"
31,2,93,918,450,468,918,"6 de julio de 1997"
31,2,93,919,355,327,682,"6 de julio de 1997"
31,2,93,920,610,613,1223,"6 de julio de 1997"
31,2,93,921,136,117,253,"6 de julio de 1997"
31,2,95,926,331,352,683,"6 de julio de 1997"
31,2,95,927,141,147,288,"6 de julio de 1997"
31,2,95,928,611,603,1214,"6 de julio de 1997"
31,2,95,929,175,148,323,"6 de julio de 1997"
31,2,95,930,126,100,226,"6 de julio de 1997"
31,2,95,931,112,119,231,"6 de julio de 1997"
31,2,100,988,609,524,1133,"6 de julio de 1997"
31,2,100,989,241,215,456,"6 de julio de 1997"
31,2,101,990,801,754,1555,"6 de julio de 1997"
31,2,101,991,780,807,1587,"6 de julio de 1997"
31,2,101,992,299,339,638,"6 de julio de 1997"
31,2,101,993,341,379,720,"6 de julio de 1997"
31,2,101,994,420,449,869,"6 de julio de 1997"
31,2,101,995,682,630,1312,"6 de julio de 1997"
31,2,101,996,809,827,1636,"6 de julio de 1997"
31,2,101,997,540,520,1060,"6 de julio de 1997"
31,2,101,998,908,920,1828,"6 de julio de 1997"
31,2,101,999,449,499,948,"6 de julio de 1997"
31,2,101,1000,964,946,1910,"6 de julio de 1997"
31,2,101,1001,274,235,509,"6 de julio de 1997"
31,2,101,1002,251,319,570,"6 de julio de 1997"
31,2,101,1003,334,401,735,"6 de julio de 1997"
31,2,101,1004,484,544,1028,"6 de julio de 1997"
31,2,101,1005,422,400,822,"6 de julio de 1997"
31,2,101,1006,687,603,1290,"6 de julio de 1997"
31,2,101,1007,141,122,263,"6 de julio de 1997"
31,2,101,1008,272,265,537,"6 de julio de 1997"
31,2,101,1009,342,308,650,"6 de julio de 1997"
31,2,105,1056,758,736,1494,"6 de julio de 1997"
31,2,106,1057,232,182,414,"6 de julio de 1997"
31,2,106,1058,376,356,732,"6 de julio de 1997"
31,2,106,1059,102,77,179,"6 de julio de 1997"
31,3,50,254,356,365,721,"6 de julio de 1997"
31,3,50,268,269,313,582,"6 de julio de 1997"
31,3,50,269,1860,2107,3967,"6 de julio de 1997"
31,3,50,270,372,449,821,"6 de julio de 1997"
31,3,50,271,445,550,995,"6 de julio de 1997"
31,3,50,285,418,460,878,"6 de julio de 1997"
31,3,50,286,393,428,821,"6 de julio de 1997"
31,3,50,287,444,510,954,"6 de julio de 1997"
31,3,50,288,404,452,856,"6 de julio de 1997"
31,3,50,289,290,323,613,"6 de julio de 1997"
31,3,50,290,225,253,478,"6 de julio de 1997"
31,3,50,291,357,432,789,"6 de julio de 1997"
31,3,50,292,374,440,814,"6 de julio de 1997"
31,3,50,293,368,472,840,"6 de julio de 1997"
31,3,50,294,383,445,828,"6 de julio de 1997"
31,3,50,295,613,639,1252,"6 de julio de 1997"
31,3,50,308,615,743,1358,"6 de julio de 1997"
31,3,50,309,370,365,735,"6 de julio de 1997"
31,3,50,310,409,482,891,"6 de julio de 1997"
31,3,50,311,604,698,1302,"6 de julio de 1997"
31,3,50,312,228,272,500,"6 de julio de 1997"
31,3,50,313,291,322,613,"6 de julio de 1997"
31,3,50,314,409,455,864,"6 de julio de 1997"
31,3,50,315,353,397,750,"6 de julio de 1997"
31,3,50,316,327,362,689,"6 de julio de 1997"
31,3,50,336,394,451,845,"6 de julio de 1997"
31,3,50,337,383,443,826,"6 de julio de 1997"
31,3,50,338,366,442,808,"6 de julio de 1997"
31,3,50,339,383,433,816,"6 de julio de 1997"
31,3,50,340,334,378,712,"6 de julio de 1997"
31,3,50,341,353,418,771,"6 de julio de 1997"
31,3,50,342,485,557,1042,"6 de julio de 1997"
31,3,50,343,319,359,678,"6 de julio de 1997"
31,3,50,344,315,369,684,"6 de julio de 1997"
31,3,50,345,242,309,551,"6 de julio de 1997"
31,3,50,346,324,379,703,"6 de julio de 1997"
31,3,50,347,394,488,882,"6 de julio de 1997"
31,3,50,348,343,421,764,"6 de julio de 1997"
31,3,50,349,421,511,932,"6 de julio de 1997"
31,3,50,350,366,449,815,"6 de julio de 1997"
31,3,50,351,501,617,1118,"6 de julio de 1997"
31,3,50,352,389,480,869,"6 de julio de 1997"
31,3,50,366,370,433,803,"6 de julio de 1997"
31,3,50,367,462,608,1070,"6 de julio de 1997"
31,3,50,368,404,433,837,"6 de julio de 1997"
31,3,50,369,405,450,855,"6 de julio de 1997"
31,3,50,370,346,383,729,"6 de julio de 1997"
31,3,50,371,347,436,783,"6 de julio de 1997"
31,3,50,372,285,370,655,"6 de julio de 1997"
31,3,50,373,467,551,1018,"6 de julio de 1997"
31,3,50,374,224,252,476,"6 de julio de 1997"
31,3,50,375,315,343,658,"6 de julio de 1997"
31,3,50,376,359,454,813,"6 de julio de 1997"
31,3,50,377,277,351,628,"6 de julio de 1997"
31,3,50,378,442,489,931,"6 de julio de 1997"
31,3,50,379,371,420,791,"6 de julio de 1997"
31,3,50,380,269,298,567,"6 de julio de 1997"
31,3,50,381,291,346,637,"6 de julio de 1997"
31,3,50,382,900,1012,1912,"6 de julio de 1997"
31,3,50,383,412,472,884,"6 de julio de 1997"
31,3,50,384,242,300,542,"6 de julio de 1997"
31,3,50,385,242,274,516,"6 de julio de 1997"
31,3,50,386,332,415,747,"6 de julio de 1997"
31,3,50,387,308,315,623,"6 de julio de 1997"
31,3,50,388,339,399,738,"6 de julio de 1997"
31,3,50,389,365,417,782,"6 de julio de 1997"
31,3,50,390,326,378,704,"6 de julio de 1997"
31,3,50,391,584,662,1246,"6 de julio de 1997"
31,3,50,392,369,478,847,"6 de julio de 1997"
31,3,50,410,371,415,786,"6 de julio de 1997"
31,3,50,411,360,416,776,"6 de julio de 1997"
31,3,50,412,389,415,804,"6 de julio de 1997"
31,3,50,413,482,557,1039,"6 de julio de 1997"
31,3,50,414,372,475,847,"6 de julio de 1997"
31,3,50,415,338,428,766,"6 de julio de 1997"
31,3,50,416,416,483,899,"6 de julio de 1997"
31,3,50,417,290,332,622,"6 de julio de 1997"
31,3,50,418,404,431,835,"6 de julio de 1997"
31,3,50,419,407,444,851,"6 de julio de 1997"
31,3,50,420,492,541,1033,"6 de julio de 1997"
31,3,50,421,403,477,880,"6 de julio de 1997"
31,3,50,422,494,577,1071,"6 de julio de 1997"
31,3,50,423,377,485,862,"6 de julio de 1997"
31,3,50,462,291,333,624,"6 de julio de 1997"
31,3,50,463,272,341,613,"6 de julio de 1997"
31,3,50,464,178,210,388,"6 de julio de 1997"
31,3,50,465,571,620,1191,"6 de julio de 1997"
31,3,50,466,411,506,917,"6 de julio de 1997"
31,3,50,467,409,460,869,"6 de julio de 1997"
31,3,50,468,561,645,1206,"6 de julio de 1997"
31,3,50,469,339,444,783,"6 de julio de 1997"
31,3,50,470,417,445,862,"6 de julio de 1997"
31,3,50,471,542,648,1190,"6 de julio de 1997"
31,3,50,472,355,425,780,"6 de julio de 1997"
31,3,50,473,791,920,1711,"6 de julio de 1997"
31,3,50,474,1179,1291,2470,"6 de julio de 1997"
31,3,50,475,464,567,1031,"6 de julio de 1997"
31,3,50,476,737,821,1558,"6 de julio de 1997"
31,3,50,477,554,638,1192,"6 de julio de 1997"
31,3,50,478,474,529,1003,"6 de julio de 1997"
31,3,50,479,443,483,926,"6 de julio de 1997"
31,3,50,480,402,482,884,"6 de julio de 1997"
31,3,50,498,430,458,888,"6 de julio de 1997"
31,3,50,499,348,333,681,"6 de julio de 1997"
31,3,50,500,524,593,1117,"6 de julio de 1997"
31,3,50,523,622,682,1304,"6 de julio de 1997"
31,3,50,524,336,390,726,"6 de julio de 1997"
31,3,50,525,431,493,924,"6 de julio de 1997"
31,3,50,537,599,673,1272,"6 de julio de 1997"
31,3,50,538,562,666,1228,"6 de julio de 1997"
31,3,50,539,422,473,895,"6 de julio de 1997"
31,3,50,540,425,506,931,"6 de julio de 1997"
31,3,50,541,429,479,908,"6 de julio de 1997"
31,3,50,542,446,479,925,"6 de julio de 1997"
31,3,50,543,391,429,820,"6 de julio de 1997"
31,3,50,544,412,484,896,"6 de julio de 1997"
31,3,50,545,418,458,876,"6 de julio de 1997"
31,3,50,546,537,616,1153,"6 de julio de 1997"
31,3,50,556,399,474,873,"6 de julio de 1997"
31,3,50,557,560,610,1170,"6 de julio de 1997"
31,3,50,558,430,443,873,"6 de julio de 1997"
31,3,50,559,459,517,976,"6 de julio de 1997"
31,3,50,560,391,416,807,"6 de julio de 1997"
31,3,50,561,459,520,979,"6 de julio de 1997"
31,3,50,562,437,488,925,"6 de julio de 1997"
31,3,50,563,421,516,937,"6 de julio de 1997"
31,3,50,564,419,455,874,"6 de julio de 1997"
31,3,50,565,321,368,689,"6 de julio de 1997"
31,3,50,566,484,502,986,"6 de julio de 1997"
31,3,50,567,421,533,954,"6 de julio de 1997"
31,3,50,568,305,333,638,"6 de julio de 1997"
31,3,50,571,318,388,706,"6 de julio de 1997"
31,3,50,572,293,335,628,"6 de julio de 1997"
31,3,50,573,298,372,670,"6 de julio de 1997"
31,3,50,574,345,365,710,"6 de julio de 1997"
31,3,50,575,399,398,797,"6 de julio de 1997"
31,3,50,576,415,453,868,"6 de julio de 1997"
31,3,50,577,336,380,716,"6 de julio de 1997"
31,3,50,578,553,678,1231,"6 de julio de 1997"
31,3,50,579,238,255,493,"6 de julio de 1997"
31,3,50,580,360,387,747,"6 de julio de 1997"
31,3,50,581,457,525,982,"6 de julio de 1997"
31,3,50,582,419,451,870,"6 de julio de 1997"
31,3,50,583,351,395,746,"6 de julio de 1997"
31,3,50,587,372,441,813,"6 de julio de 1997"
31,3,50,588,522,584,1106,"6 de julio de 1997"
31,3,50,589,503,590,1093,"6 de julio de 1997"
31,3,50,590,542,612,1154,"6 de julio de 1997"
31,3,50,591,324,380,704,"6 de julio de 1997"
31,3,50,592,334,373,707,"6 de julio de 1997"
31,3,50,594,717,845,1562,"6 de julio de 1997"
31,3,50,595,294,341,635,"6 de julio de 1997"
31,3,50,596,517,542,1059,"6 de julio de 1997"
31,3,50,597,428,469,897,"6 de julio de 1997"
31,3,50,598,483,555,1038,"6 de julio de 1997"
31,3,50,599,397,405,802,"6 de julio de 1997"
31,3,50,600,559,635,1194,"6 de julio de 1997"
31,3,50,601,424,469,893,"6 de julio de 1997"
31,3,50,602,366,420,786,"6 de julio de 1997"
31,3,50,603,676,782,1458,"6 de julio de 1997"
31,3,50,604,732,824,1556,"6 de julio de 1997"
31,3,50,605,657,722,1379,"6 de julio de 1997"
31,3,50,606,587,679,1266,"6 de julio de 1997"
31,3,50,607,508,594,1102,"6 de julio de 1997"
31,3,50,608,582,642,1224,"6 de julio de 1997"
31,3,50,609,564,625,1189,"6 de julio de 1997"
31,3,50,610,551,571,1122,"6 de julio de 1997"
31,3,50,611,644,526,1170,"6 de julio de 1997"
31,3,50,612,427,456,883,"6 de julio de 1997"
31,3,50,613,436,500,936,"6 de julio de 1997"
31,3,50,614,555,633,1188,"6 de julio de 1997"
31,3,50,615,483,560,1043,"6 de julio de 1997"
31,3,50,616,505,575,1080,"6 de julio de 1997"
31,3,50,617,302,315,617,"6 de julio de 1997"
31,3,50,618,477,533,1010,"6 de julio de 1997"
31,3,50,619,530,614,1144,"6 de julio de 1997"
31,3,50,620,642,653,1295,"6 de julio de 1997"
31,3,50,621,515,566,1081,"6 de julio de 1997"
31,3,50,622,302,326,628,"6 de julio de 1997"
31,3,50,623,372,357,729,"6 de julio de 1997"
31,3,50,624,482,508,990,"6 de julio de 1997"
31,3,50,625,925,941,1866,"6 de julio de 1997"
31,3,50,626,566,599,1165,"6 de julio de 1997"
31,3,50,627,934,1014,1948,"6 de julio de 1997"
31,3,50,628,614,702,1316,"6 de julio de 1997"
31,3,50,629,147,103,250,"6 de julio de 1997"
31,3,50,630,142,141,283,"6 de julio de 1997"
31,3,50,632,303,296,599,"6 de julio de 1997"
31,3,50,633,329,283,612,"6 de julio de 1997"
31,3,50,634,440,426,866,"6 de julio de 1997"
31,3,50,635,516,472,988,"6 de julio de 1997"
31,3,50,638,326,317,643,"6 de julio de 1997"
31,3,50,639,329,313,642,"6 de julio de 1997"
31,3,50,644,740,752,1492,"6 de julio de 1997"
31,3,50,645,685,694,1379,"6 de julio de 1997"
31,3,50,648,175,160,335,"6 de julio de 1997"
31,3,50,649,441,517,958,"6 de julio de 1997"
31,3,50,650,509,502,1011,"6 de julio de 1997"
31,3,50,651,129,124,253,"6 de julio de 1997"
31,3,50,652,477,473,950,"6 de julio de 1997"
31,3,50,653,765,734,1499,"6 de julio de 1997"
31,3,50,654,514,492,1006,"6 de julio de 1997"
31,3,50,655,264,266,530,"6 de julio de 1997"
31,3,50,656,226,204,430,"6 de julio de 1997"
31,4,50,255,197,204,401,"6 de julio de 1997"
31,4,50,256,214,203,417,"6 de julio de 1997"
31,4,50,257,497,600,1097,"6 de julio de 1997"
31,4,50,258,572,570,1142,"6 de julio de 1997"
31,4,50,259,525,529,1054,"6 de julio de 1997"
31,4,50,260,408,423,831,"6 de julio de 1997"
31,4,50,261,360,387,747,"6 de julio de 1997"
31,4,50,262,119,117,236,"6 de julio de 1997"
31,4,50,263,303,359,662,"6 de julio de 1997"
31,4,50,264,352,415,767,"6 de julio de 1997"
31,4,50,265,633,757,1390,"6 de julio de 1997"
31,4,50,266,277,293,570,"6 de julio de 1997"
31,4,50,267,416,460,876,"6 de julio de 1997"
31,4,50,272,456,511,967,"6 de julio de 1997"
31,4,50,273,327,370,697,"6 de julio de 1997"
31,4,50,274,394,428,822,"6 de julio de 1997"
31,4,50,275,252,294,546,"6 de julio de 1997"
31,4,50,276,445,500,945,"6 de julio de 1997"
31,4,50,277,529,576,1105,"6 de julio de 1997"
31,4,50,278,457,500,957,"6 de julio de 1997"
31,4,50,279,535,612,1147,"6 de julio de 1997"
31,4,50,280,490,564,1054,"6 de julio de 1997"
31,4,50,281,316,377,693,"6 de julio de 1997"
31,4,50,282,437,484,921,"6 de julio de 1997"
31,4,50,283,366,347,713,"6 de julio de 1997"
31,4,50,284,351,405,756,"6 de julio de 1997"
31,4,50,296,433,528,961,"6 de julio de 1997"
31,4,50,297,350,382,732,"6 de julio de 1997"
31,4,50,298,645,727,1372,"6 de julio de 1997"
31,4,50,299,587,655,1242,"6 de julio de 1997"
31,4,50,300,365,431,796,"6 de julio de 1997"
31,4,50,301,541,593,1134,"6 de julio de 1997"
31,4,50,302,309,373,682,"6 de julio de 1997"
31,4,50,303,1303,1499,2802,"6 de julio de 1997"
31,4,50,304,283,348,631,"6 de julio de 1997"
31,4,50,305,569,664,1233,"6 de julio de 1997"
31,4,50,306,349,372,721,"6 de julio de 1997"
31,4,50,307,402,469,871,"6 de julio de 1997"
31,4,50,317,347,417,764,"6 de julio de 1997"
31,4,50,318,357,351,708,"6 de julio de 1997"
31,4,50,319,507,588,1095,"6 de julio de 1997"
31,4,50,320,437,471,908,"6 de julio de 1997"
31,4,50,321,642,730,1372,"6 de julio de 1997"
31,4,50,322,520,552,1072,"6 de julio de 1997"
31,4,50,323,337,352,689,"6 de julio de 1997"
31,4,50,324,296,315,611,"6 de julio de 1997"
31,4,50,325,486,491,977,"6 de julio de 1997"
31,4,50,326,374,458,832,"6 de julio de 1997"
31,4,50,327,582,696,1278,"6 de julio de 1997"
31,4,50,328,487,550,1037,"6 de julio de 1997"
31,4,50,329,548,610,1158,"6 de julio de 1997"
31,4,50,330,372,437,809,"6 de julio de 1997"
31,4,50,331,421,452,873,"6 de julio de 1997"
31,4,50,332,432,475,907,"6 de julio de 1997"
31,4,50,333,470,524,994,"6 de julio de 1997"
31,4,50,334,293,351,644,"6 de julio de 1997"
31,4,50,335,478,560,1038,"6 de julio de 1997"
31,4,50,353,369,466,835,"6 de julio de 1997"
31,4,50,354,511,613,1124,"6 de julio de 1997"
31,4,50,355,575,631,1206,"6 de julio de 1997"
31,4,50,356,576,662,1238,"6 de julio de 1997"
31,4,50,357,388,435,823,"6 de julio de 1997"
31,4,50,358,503,559,1062,"6 de julio de 1997"
31,4,50,359,494,557,1051,"6 de julio de 1997"
31,4,50,360,339,401,740,"6 de julio de 1997"
31,4,50,361,308,345,653,"6 de julio de 1997"
31,4,50,362,608,672,1280,"6 de julio de 1997"
31,4,50,363,650,694,1344,"6 de julio de 1997"
31,4,50,364,286,319,605,"6 de julio de 1997"
31,4,50,365,345,401,746,"6 de julio de 1997"
31,4,50,393,377,456,833,"6 de julio de 1997"
31,4,50,394,289,346,635,"6 de julio de 1997"
31,4,50,395,265,409,674,"6 de julio de 1997"
31,4,50,396,351,449,800,"6 de julio de 1997"
31,4,50,397,375,437,812,"6 de julio de 1997"
31,4,50,398,375,440,815,"6 de julio de 1997"
31,4,50,399,420,471,891,"6 de julio de 1997"
31,4,50,400,398,437,835,"6 de julio de 1997"
31,4,50,401,371,387,758,"6 de julio de 1997"
31,4,50,402,434,482,916,"6 de julio de 1997"
31,4,50,403,592,616,1208,"6 de julio de 1997"
31,4,50,404,522,542,1064,"6 de julio de 1997"
31,4,50,405,365,413,778,"6 de julio de 1997"
31,4,50,406,461,534,995,"6 de julio de 1997"
31,4,50,407,445,530,975,"6 de julio de 1997"
31,4,50,408,411,433,844,"6 de julio de 1997"
31,4,50,409,412,472,884,"6 de julio de 1997"
31,4,50,424,264,307,571,"6 de julio de 1997"
31,4,50,425,281,326,607,"6 de julio de 1997"
31,4,50,426,364,428,792,"6 de julio de 1997"
31,4,50,427,206,290,496,"6 de julio de 1997"
31,4,50,428,355,427,782,"6 de julio de 1997"
31,4,50,429,362,427,789,"6 de julio de 1997"
31,4,50,430,284,346,630,"6 de julio de 1997"
31,4,50,431,343,381,724,"6 de julio de 1997"
31,4,50,432,410,434,844,"6 de julio de 1997"
31,4,50,433,379,423,802,"6 de julio de 1997"
31,4,50,434,537,616,1153,"6 de julio de 1997"
31,4,50,435,400,435,835,"6 de julio de 1997"
31,4,50,436,485,579,1064,"6 de julio de 1997"
31,4,50,437,426,510,936,"6 de julio de 1997"
31,4,50,438,544,568,1112,"6 de julio de 1997"
31,4,50,439,496,592,1088,"6 de julio de 1997"
31,4,50,440,485,506,991,"6 de julio de 1997"
31,4,50,441,425,440,865,"6 de julio de 1997"
31,4,50,442,290,332,622,"6 de julio de 1997"
31,4,50,443,334,391,725,"6 de julio de 1997"
31,4,50,444,306,331,637,"6 de julio de 1997"
31,4,50,445,387,446,833,"6 de julio de 1997"
31,4,50,446,556,581,1137,"6 de julio de 1997"
31,4,50,447,557,595,1152,"6 de julio de 1997"
31,4,50,448,649,698,1347,"6 de julio de 1997"
31,4,50,449,564,619,1183,"6 de julio de 1997"
31,4,50,450,547,588,1135,"6 de julio de 1997"
31,4,50,451,396,461,857,"6 de julio de 1997"
31,4,50,452,585,649,1234,"6 de julio de 1997"
31,4,50,453,389,459,848,"6 de julio de 1997"
31,4,50,454,545,601,1146,"6 de julio de 1997"
31,4,50,455,590,671,1261,"6 de julio de 1997"
31,4,50,456,337,438,775,"6 de julio de 1997"
31,4,50,457,262,303,565,"6 de julio de 1997"
31,4,50,458,365,372,737,"6 de julio de 1997"
31,4,50,459,227,225,452,"6 de julio de 1997"
31,4,50,460,209,257,466,"6 de julio de 1997"
31,4,50,461,314,373,687,"6 de julio de 1997"
31,4,50,481,329,418,747,"6 de julio de 1997"
31,4,50,482,432,498,930,"6 de julio de 1997"
31,4,50,483,525,657,1182,"6 de julio de 1997"
31,4,50,484,348,403,751,"6 de julio de 1997"
31,4,50,485,394,471,865,"6 de julio de 1997"
31,4,50,486,531,666,1197,"6 de julio de 1997"
31,4,50,487,590,687,1277,"6 de julio de 1997"
31,4,50,488,619,697,1316,"6 de julio de 1997"
31,4,50,489,355,369,724,"6 de julio de 1997"
31,4,50,490,356,429,785,"6 de julio de 1997"
31,4,50,491,562,606,1168,"6 de julio de 1997"
31,4,50,492,488,577,1065,"6 de julio de 1997"
31,4,50,493,419,459,878,"6 de julio de 1997"
31,4,50,494,495,561,1056,"6 de julio de 1997"
31,4,50,495,321,394,715,"6 de julio de 1997"
31,4,50,496,720,841,1561,"6 de julio de 1997"
31,4,50,497,304,371,675,"6 de julio de 1997"
31,4,50,501,331,389,720,"6 de julio de 1997"
31,4,50,502,400,444,844,"6 de julio de 1997"
31,4,50,503,336,401,737,"6 de julio de 1997"
31,4,50,504,573,643,1216,"6 de julio de 1997"
31,4,50,505,434,471,905,"6 de julio de 1997"
31,4,50,506,434,469,903,"6 de julio de 1997"
31,4,50,507,371,410,781,"6 de julio de 1997"
31,4,50,508,775,852,1627,"6 de julio de 1997"
31,4,50,509,264,301,565,"6 de julio de 1997"
31,4,50,510,1332,1559,2891,"6 de julio de 1997"
31,4,50,511,339,326,665,"6 de julio de 1997"
31,4,50,512,562,624,1186,"6 de julio de 1997"
31,4,50,513,471,532,1003,"6 de julio de 1997"
31,4,50,514,333,391,724,"6 de julio de 1997"
31,4,50,515,609,662,1271,"6 de julio de 1997"
31,4,50,516,461,532,993,"6 de julio de 1997"
31,4,50,517,719,798,1517,"6 de julio de 1997"
31,4,50,518,404,467,871,"6 de julio de 1997"
31,4,50,519,655,697,1352,"6 de julio de 1997"
31,4,50,520,519,565,1084,"6 de julio de 1997"
31,4,50,521,347,379,726,"6 de julio de 1997"
31,4,50,522,426,523,949,"6 de julio de 1997"
31,4,50,526,542,625,1167,"6 de julio de 1997"
31,4,50,527,702,778,1480,"6 de julio de 1997"
31,4,50,528,498,528,1026,"6 de julio de 1997"
31,4,50,529,475,523,998,"6 de julio de 1997"
31,4,50,530,445,471,916,"6 de julio de 1997"
31,4,50,531,221,260,481,"6 de julio de 1997"
31,4,50,532,505,581,1086,"6 de julio de 1997"
31,4,50,533,368,379,747,"6 de julio de 1997"
31,4,50,534,520,581,1101,"6 de julio de 1997"
31,4,50,535,449,491,940,"6 de julio de 1997"
31,4,50,536,394,463,857,"6 de julio de 1997"
31,4,50,547,416,490,906,"6 de julio de 1997"
31,4,50,548,371,396,767,"6 de julio de 1997"
31,4,50,549,464,546,1010,"6 de julio de 1997"
31,4,50,550,266,316,582,"6 de julio de 1997"
31,4,50,551,435,471,906,"6 de julio de 1997"
31,4,50,552,273,309,582,"6 de julio de 1997"
31,4,50,553,265,287,552,"6 de julio de 1997"
31,4,50,554,399,437,836,"6 de julio de 1997"
31,4,50,555,434,451,885,"6 de julio de 1997"
31,4,50,569,457,532,989,"6 de julio de 1997"
31,4,50,570,1021,603,1624,"6 de julio de 1997"
31,4,50,584,248,277,525,"6 de julio de 1997"
31,4,50,585,271,268,539,"6 de julio de 1997"
31,4,50,586,267,323,590,"6 de julio de 1997"
31,4,50,593,408,468,876,"6 de julio de 1997"
31,4,50,631,292,299,591,"6 de julio de 1997"
31,4,50,636,204,190,394,"6 de julio de 1997"
31,4,50,637,703,675,1378,"6 de julio de 1997"
31,4,50,640,245,235,480,"6 de julio de 1997"
31,4,50,641,529,507,1036,"6 de julio de 1997"
31,4,50,642,796,713,1509,"6 de julio de 1997"
31,4,50,643,474,425,899,"6 de julio de 1997"
31,4,50,646,381,387,768,"6 de julio de 1997"
31,4,50,647,174,133,307,"6 de julio de 1997"
31,5,1,1,599,536,1135,"6 de julio de 1997"
31,5,1,2,74,56,130,"6 de julio de 1997"
31,5,1,3,93,81,174,"6 de julio de 1997"
31,5,1,4,289,227,516,"6 de julio de 1997"
31,5,1,5,427,399,826,"6 de julio de 1997"
31,5,1,6,141,129,270,"6 de julio de 1997"
31,5,3,14,474,548,1022,"6 de julio de 1997"
31,5,3,15,565,556,1121,"6 de julio de 1997"
31,5,3,16,392,395,787,"6 de julio de 1997"
31,5,3,17,392,409,801,"6 de julio de 1997"
31,5,3,18,239,240,479,"6 de julio de 1997"
31,5,3,19,27,21,48,"6 de julio de 1997"
31,5,10,47,395,349,744,"6 de julio de 1997"
31,5,10,48,97,75,172,"6 de julio de 1997"
31,5,10,49,50,40,90,"6 de julio de 1997"
31,5,15,67,396,378,774,"6 de julio de 1997"
31,5,15,68,540,523,1063,"6 de julio de 1997"
31,5,15,69,212,192,404,"6 de julio de 1997"
31,5,16,70,564,532,1096,"6 de julio de 1997"
31,5,18,75,291,268,559,"6 de julio de 1997"
31,5,18,76,376,291,667,"6 de julio de 1997"
31,5,18,77,276,237,513,"6 de julio de 1997"
31,5,23,103,391,389,780,"6 de julio de 1997"
31,5,23,104,373,403,776,"6 de julio de 1997"
31,5,23,105,389,367,756,"6 de julio de 1997"
31,5,24,106,432,383,815,"6 de julio de 1997"
31,5,24,107,415,385,800,"6 de julio de 1997"
31,5,25,108,512,516,1028,"6 de julio de 1997"
31,5,25,109,608,571,1179,"6 de julio de 1997"
31,5,33,142,635,608,1243,"6 de julio de 1997"
31,5,33,143,420,459,879,"6 de julio de 1997"
31,5,33,144,431,455,886,"6 de julio de 1997"
31,5,33,145,601,613,1214,"6 de julio de 1997"
31,5,33,146,464,437,901,"6 de julio de 1997"
31,5,33,147,76,67,143,"6 de julio de 1997"
31,5,33,148,539,498,1037,"6 de julio de 1997"
31,5,33,149,731,686,1417,"6 de julio de 1997"
31,5,33,150,411,393,804,"6 de julio de 1997"
31,5,33,151,462,415,877,"6 de julio de 1997"
31,5,34,152,197,217,414,"6 de julio de 1997"
31,5,34,153,278,270,548,"6 de julio de 1997"
31,5,34,154,309,324,633,"6 de julio de 1997"
31,5,34,155,416,367,783,"6 de julio de 1997"
31,5,34,156,407,403,810,"6 de julio de 1997"
31,5,36,162,355,347,702,"6 de julio de 1997"
31,5,36,163,339,303,642,"6 de julio de 1997"
31,5,36,164,423,370,793,"6 de julio de 1997"
31,5,36,165,374,372,746,"6 de julio de 1997"
31,5,36,166,69,54,123,"6 de julio de 1997"
31,5,36,167,227,204,431,"6 de julio de 1997"
31,5,37,168,489,479,968,"6 de julio de 1997"
31,5,37,169,322,286,608,"6 de julio de 1997"
31,5,37,170,462,446,908,"6 de julio de 1997"
31,5,37,171,68,38,106,"6 de julio de 1997"
31,5,45,232,591,552,1143,"6 de julio de 1997"
31,5,45,233,156,121,277,"6 de julio de 1997"
31,5,46,234,351,326,677,"6 de julio de 1997"
31,5,46,235,453,445,898,"6 de julio de 1997"
31,5,47,236,488,517,1005,"6 de julio de 1997"
31,5,47,237,573,572,1145,"6 de julio de 1997"
31,5,47,238,219,228,447,"6 de julio de 1997"
31,5,48,239,655,623,1278,"6 de julio de 1997"
31,5,48,240,488,473,961,"6 de julio de 1997"
31,5,48,241,394,374,768,"6 de julio de 1997"
31,5,48,242,455,432,887,"6 de julio de 1997"
31,5,48,243,601,561,1162,"6 de julio de 1997"
31,5,48,244,790,758,1548,"6 de julio de 1997"
31,5,48,245,416,359,775,"6 de julio de 1997"
31,5,48,246,448,424,872,"6 de julio de 1997"
31,5,48,247,347,328,675,"6 de julio de 1997"
31,5,48,248,171,130,301,"6 de julio de 1997"
31,5,48,249,268,229,497,"6 de julio de 1997"
31,5,48,250,391,340,731,"6 de julio de 1997"
31,5,48,251,36,29,65,"6 de julio de 1997"
31,5,49,252,210,182,392,"6 de julio de 1997"
31,5,49,253,349,330,679,"6 de julio de 1997"
31,5,53,680,324,341,665,"6 de julio de 1997"
31,5,53,681,730,816,1546,"6 de julio de 1997"
31,5,53,682,692,769,1461,"6 de julio de 1997"
31,5,53,683,520,507,1027,"6 de julio de 1997"
31,5,53,684,787,811,1598,"6 de julio de 1997"
31,5,53,685,98,105,203,"6 de julio de 1997"
31,5,53,686,117,117,234,"6 de julio de 1997"
31,5,55,690,569,510,1079,"6 de julio de 1997"
31,5,55,691,548,477,1025,"6 de julio de 1997"
31,5,55,692,327,280,607,"6 de julio de 1997"
31,5,56,693,312,322,634,"6 de julio de 1997"
31,5,56,694,530,604,1134,"6 de julio de 1997"
31,5,56,695,498,544,1042,"6 de julio de 1997"
31,5,56,696,453,515,968,"6 de julio de 1997"
31,5,56,697,68,83,151,"6 de julio de 1997"
31,5,56,698,513,570,1083,"6 de julio de 1997"
31,5,56,699,535,608,1143,"6 de julio de 1997"
31,5,56,700,653,711,1364,"6 de julio de 1997"
31,5,56,701,447,494,941,"6 de julio de 1997"
31,5,56,702,454,452,906,"6 de julio de 1997"
31,5,56,703,346,363,709,"6 de julio de 1997"
31,5,56,704,425,378,803,"6 de julio de 1997"
31,5,56,705,278,282,560,"6 de julio de 1997"
31,5,56,706,249,207,456,"6 de julio de 1997"
31,5,56,707,276,248,524,"6 de julio de 1997"
31,5,56,708,91,72,163,"6 de julio de 1997"
31,5,58,715,451,451,902,"6 de julio de 1997"
31,5,58,716,492,415,907,"6 de julio de 1997"
31,5,58,717,235,240,475,"6 de julio de 1997"
31,5,58,718,455,499,954,"6 de julio de 1997"
31,5,58,719,495,541,1036,"6 de julio de 1997"
31,5,58,720,459,510,969,"6 de julio de 1997"
31,5,58,721,353,405,758,"6 de julio de 1997"
31,5,58,722,190,208,398,"6 de julio de 1997"
31,5,58,723,471,478,949,"6 de julio de 1997"
31,5,58,724,280,277,557,"6 de julio de 1997"
31,5,58,725,183,146,329,"6 de julio de 1997"
31,5,58,726,86,51,137,"6 de julio de 1997"
31,5,58,727,80,59,139,"6 de julio de 1997"
31,5,58,728,187,175,362,"6 de julio de 1997"
31,5,58,729,145,123,268,"6 de julio de 1997"
31,5,58,730,266,184,450,"6 de julio de 1997"
31,5,58,731,36,21,57,"6 de julio de 1997"
31,5,58,732,174,136,310,"6 de julio de 1997"
31,5,58,733,61,41,102,"6 de julio de 1997"
31,5,62,769,416,408,824,"6 de julio de 1997"
31,5,62,770,561,512,1073,"6 de julio de 1997"
31,5,62,771,167,166,333,"6 de julio de 1997"
31,5,64,775,478,452,930,"6 de julio de 1997"
31,5,66,778,482,478,960,"6 de julio de 1997"
31,5,66,779,294,277,571,"6 de julio de 1997"
31,5,66,780,77,63,140,"6 de julio de 1997"
31,5,67,781,591,507,1098,"6 de julio de 1997"
31,5,67,782,329,292,621,"6 de julio de 1997"
31,5,67,783,760,734,1494,"6 de julio de 1997"
31,5,67,784,558,514,1072,"6 de julio de 1997"
31,5,67,785,276,243,519,"6 de julio de 1997"
31,5,69,789,380,402,782,"6 de julio de 1997"
31,5,69,790,220,210,430,"6 de julio de 1997"
31,5,69,791,248,241,489,"6 de julio de 1997"
31,5,69,792,412,361,773,"6 de julio de 1997"
31,5,69,793,335,309,644,"6 de julio de 1997"
31,5,69,794,140,133,273,"6 de julio de 1997"
31,5,69,795,196,173,369,"6 de julio de 1997"
31,5,73,802,648,614,1262,"6 de julio de 1997"
31,5,74,803,537,511,1048,"6 de julio de 1997"
31,5,74,804,664,638,1302,"6 de julio de 1997"
31,5,75,805,565,580,1145,"6 de julio de 1997"
31,5,75,806,696,604,1300,"6 de julio de 1997"
31,5,76,807,821,799,1620,"6 de julio de 1997"
31,5,76,808,399,381,780,"6 de julio de 1997"
31,5,76,809,434,428,862,"6 de julio de 1997"
31,5,76,810,577,518,1095,"6 de julio de 1997"
31,5,76,811,164,139,303,"6 de julio de 1997"
31,5,76,812,302,270,572,"6 de julio de 1997"
31,5,76,813,152,116,268,"6 de julio de 1997"
31,5,76,814,522,521,1043,"6 de julio de 1997"
31,5,76,815,425,364,789,"6 de julio de 1997"
31,5,76,816,86,74,160,"6 de julio de 1997"
31,5,79,826,478,507,985,"6 de julio de 1997"
31,5,79,827,700,712,1412,"6 de julio de 1997"
31,5,79,828,406,390,796,"6 de julio de 1997"
31,5,79,829,418,393,811,"6 de julio de 1997"
31,5,79,830,534,531,1065,"6 de julio de 1997"
31,5,79,831,280,294,574,"6 de julio de 1997"
31,5,79,832,410,410,820,"6 de julio de 1997"
31,5,79,833,524,562,1086,"6 de julio de 1997"
31,5,79,834,412,444,856,"6 de julio de 1997"
31,5,79,835,681,650,1331,"6 de julio de 1997"
31,5,79,836,424,382,806,"6 de julio de 1997"
31,5,79,837,258,243,501,"6 de julio de 1997"
31,5,79,838,314,313,627,"6 de julio de 1997"
31,5,79,839,315,326,641,"6 de julio de 1997"
31,5,79,840,776,730,1506,"6 de julio de 1997"
31,5,79,841,107,108,215,"6 de julio de 1997"
31,5,79,842,487,473,960,"6 de julio de 1997"
31,5,79,843,218,147,365,"6 de julio de 1997"
31,5,79,844,408,357,765,"6 de julio de 1997"
31,5,79,845,42,20,62,"6 de julio de 1997"
31,5,80,846,670,615,1285,"6 de julio de 1997"
31,5,80,847,510,465,975,"6 de julio de 1997"
31,5,80,848,708,641,1349,"6 de julio de 1997"
31,5,80,849,338,327,665,"6 de julio de 1997"
31,5,80,850,18,14,32,"6 de julio de 1997"
31,5,89,882,392,412,804,"6 de julio de 1997"
31,5,89,883,381,371,752,"6 de julio de 1997"
31,5,89,884,610,659,1269,"6 de julio de 1997"
31,5,89,885,621,662,1283,"6 de julio de 1997"
31,5,89,886,382,388,770,"6 de julio de 1997"
31,5,89,887,312,310,622,"6 de julio de 1997"
31,5,89,888,429,451,880,"6 de julio de 1997"
31,5,89,889,392,377,769,"6 de julio de 1997"
31,5,89,890,337,363,700,"6 de julio de 1997"
31,5,89,891,570,585,1155,"6 de julio de 1997"
31,5,89,892,532,517,1049,"6 de julio de 1997"
31,5,89,893,671,616,1287,"6 de julio de 1997"
31,5,89,894,517,570,1087,"6 de julio de 1997"
31,5,89,895,389,410,799,"6 de julio de 1997"
31,5,89,896,564,547,1111,"6 de julio de 1997"
31,5,89,897,500,453,953,"6 de julio de 1997"
31,5,94,922,247,264,511,"6 de julio de 1997"
31,5,94,923,306,292,598,"6 de julio de 1997"
31,5,94,924,140,132,272,"6 de julio de 1997"
31,5,94,925,292,291,583,"6 de julio de 1997"
31,5,98,977,529,552,1081,"6 de julio de 1997"
31,5,98,978,650,616,1266,"6 de julio de 1997"
31,5,98,979,531,497,1028,"6 de julio de 1997"
31,5,98,980,505,430,935,"6 de julio de 1997"
31,5,98,981,131,109,240,"6 de julio de 1997"
31,5,98,982,329,296,625,"6 de julio de 1997"
31,5,98,983,165,113,278,"6 de julio de 1997"
31,5,98,984,178,106,284,"6 de julio de 1997"
31,5,103,1043,368,322,690,"6 de julio de 1997"
31,5,103,1044,494,463,957,"6 de julio de 1997"
32,1,7,73,238,249,487,"6 de julio de 1997"
32,1,7,74,215,216,431,"6 de julio de 1997"
32,1,7,75,236,247,483,"6 de julio de 1997"
32,1,7,76,353,387,740,"6 de julio de 1997"
32,1,7,77,319,304,623,"6 de julio de 1997"
32,1,7,78,251,271,522,"6 de julio de 1997"
32,1,7,79,344,375,719,"6 de julio de 1997"
32,1,7,80,394,431,825,"6 de julio de 1997"
32,1,7,81,38,30,68,"6 de julio de 1997"
32,1,7,82,102,98,200,"6 de julio de 1997"
32,1,7,83,194,160,354,"6 de julio de 1997"
32,1,7,84,152,126,278,"6 de julio de 1997"
32,1,7,85,101,100,201,"6 de julio de 1997"
32,1,7,86,84,74,158,"6 de julio de 1997"
32,1,7,87,115,92,207,"6 de julio de 1997"
32,1,7,88,39,35,74,"6 de julio de 1997"
32,1,7,89,61,48,109,"6 de julio de 1997"
32,1,7,90,32,34,66,"6 de julio de 1997"
32,1,7,91,151,133,284,"6 de julio de 1997"
32,1,7,92,119,97,216,"6 de julio de 1997"
32,1,7,93,75,47,122,"6 de julio de 1997"
32,1,7,94,77,52,129,"6 de julio de 1997"
32,1,7,95,36,27,63,"6 de julio de 1997"
32,1,7,96,158,113,271,"6 de julio de 1997"
32,1,7,97,47,36,83,"6 de julio de 1997"
32,1,7,98,59,49,108,"6 de julio de 1997"
32,1,7,99,51,33,84,"6 de julio de 1997"
32,1,7,100,28,25,53,"6 de julio de 1997"
32,1,7,101,29,26,55,"6 de julio de 1997"
32,1,7,102,42,27,69,"6 de julio de 1997"
32,1,10,135,223,249,472,"6 de julio de 1997"
32,1,10,136,348,399,747,"6 de julio de 1997"
32,1,10,137,284,320,604,"6 de julio de 1997"
32,1,10,138,182,220,402,"6 de julio de 1997"
32,1,10,139,422,476,898,"6 de julio de 1997"
32,1,10,140,255,277,532,"6 de julio de 1997"
32,1,10,141,207,216,423,"6 de julio de 1997"
32,1,10,142,241,305,546,"6 de julio de 1997"
32,1,10,143,299,338,637,"6 de julio de 1997"
32,1,10,144,418,445,863,"6 de julio de 1997"
32,1,10,145,214,255,469,"6 de julio de 1997"
32,1,10,146,213,253,466,"6 de julio de 1997"
32,1,10,147,252,289,541,"6 de julio de 1997"
32,1,10,148,151,133,284,"6 de julio de 1997"
32,1,10,149,304,329,633,"6 de julio de 1997"
32,1,10,150,427,482,909,"6 de julio de 1997"
32,1,10,151,502,530,1032,"6 de julio de 1997"
32,1,10,152,370,418,788,"6 de julio de 1997"
32,1,10,153,181,232,413,"6 de julio de 1997"
32,1,10,154,335,370,705,"6 de julio de 1997"
32,1,10,155,377,383,760,"6 de julio de 1997"
32,1,10,156,315,333,648,"6 de julio de 1997"
32,1,10,157,534,607,1141,"6 de julio de 1997"
32,1,10,158,198,251,449,"6 de julio de 1997"
32,1,10,159,289,305,594,"6 de julio de 1997"
32,1,10,160,238,256,494,"6 de julio de 1997"
32,1,10,161,208,237,445,"6 de julio de 1997"
32,1,10,162,341,397,738,"6 de julio de 1997"
32,1,10,163,293,347,640,"6 de julio de 1997"
32,1,10,164,322,337,659,"6 de julio de 1997"
32,1,10,165,302,392,694,"6 de julio de 1997"
32,1,10,166,310,389,699,"6 de julio de 1997"
32,1,10,167,285,319,604,"6 de julio de 1997"
32,1,10,168,249,317,566,"6 de julio de 1997"
32,1,10,169,342,397,739,"6 de julio de 1997"
32,1,10,170,320,350,670,"6 de julio de 1997"
32,1,10,171,364,424,788,"6 de julio de 1997"
32,1,10,172,193,225,418,"6 de julio de 1997"
32,1,10,173,306,359,665,"6 de julio de 1997"
32,1,10,174,263,331,594,"6 de julio de 1997"
32,1,10,175,285,353,638,"6 de julio de 1997"
32,1,10,176,269,339,608,"6 de julio de 1997"
32,1,10,177,381,439,820,"6 de julio de 1997"
32,1,10,178,248,306,554,"6 de julio de 1997"
32,1,10,179,269,305,574,"6 de julio de 1997"
32,1,10,180,404,439,843,"6 de julio de 1997"
32,1,10,181,318,410,728,"6 de julio de 1997"
32,1,10,182,363,463,826,"6 de julio de 1997"
32,1,10,183,211,261,472,"6 de julio de 1997"
32,1,10,184,211,229,440,"6 de julio de 1997"
32,1,10,185,188,217,405,"6 de julio de 1997"
32,1,10,186,273,311,584,"6 de julio de 1997"
32,1,10,187,208,263,471,"6 de julio de 1997"
32,1,10,188,213,227,440,"6 de julio de 1997"
32,1,10,189,359,397,756,"6 de julio de 1997"
32,1,10,190,334,371,705,"6 de julio de 1997"
32,1,10,191,360,412,772,"6 de julio de 1997"
32,1,10,192,324,367,691,"6 de julio de 1997"
32,1,10,193,291,329,620,"6 de julio de 1997"
32,1,10,194,235,295,530,"6 de julio de 1997"
32,1,10,195,377,442,819,"6 de julio de 1997"
32,1,10,196,329,345,674,"6 de julio de 1997"
32,1,10,197,257,306,563,"6 de julio de 1997"
32,1,10,198,273,320,593,"6 de julio de 1997"
32,1,10,199,164,178,342,"6 de julio de 1997"
32,1,10,200,320,406,726,"6 de julio de 1997"
32,1,10,201,218,272,490,"6 de julio de 1997"
32,1,10,202,209,219,428,"6 de julio de 1997"
32,1,10,203,322,410,732,"6 de julio de 1997"
32,1,10,204,341,357,698,"6 de julio de 1997"
32,1,10,205,223,310,533,"6 de julio de 1997"
32,1,10,206,358,439,797,"6 de julio de 1997"
32,1,10,207,335,404,739,"6 de julio de 1997"
32,1,10,208,290,392,682,"6 de julio de 1997"
32,1,10,209,319,381,700,"6 de julio de 1997"
32,1,10,210,564,625,1189,"6 de julio de 1997"
32,1,10,211,333,375,708,"6 de julio de 1997"
32,1,10,212,327,360,687,"6 de julio de 1997"
32,1,10,213,176,215,391,"6 de julio de 1997"
32,1,10,214,216,254,470,"6 de julio de 1997"
32,1,10,215,243,280,523,"6 de julio de 1997"
32,1,10,216,392,454,846,"6 de julio de 1997"
32,1,10,217,152,159,311,"6 de julio de 1997"
32,1,10,218,247,241,488,"6 de julio de 1997"
32,1,10,219,122,124,246,"6 de julio de 1997"
32,1,10,220,192,192,384,"6 de julio de 1997"
32,1,10,221,129,121,250,"6 de julio de 1997"
32,1,10,222,132,124,256,"6 de julio de 1997"
32,1,10,223,132,123,255,"6 de julio de 1997"
32,1,10,224,135,144,279,"6 de julio de 1997"
32,1,10,225,312,290,602,"6 de julio de 1997"
32,1,10,226,102,98,200,"6 de julio de 1997"
32,1,10,227,210,200,410,"6 de julio de 1997"
32,1,10,228,502,543,1045,"6 de julio de 1997"
32,1,10,229,484,496,980,"6 de julio de 1997"
32,1,10,230,270,277,547,"6 de julio de 1997"
32,1,10,231,301,314,615,"6 de julio de 1997"
32,1,10,232,282,253,535,"6 de julio de 1997"
32,1,10,233,248,264,512,"6 de julio de 1997"
32,1,10,234,142,143,285,"6 de julio de 1997"
32,1,10,235,207,220,427,"6 de julio de 1997"
32,1,10,236,68,63,131,"6 de julio de 1997"
32,1,10,237,216,258,474,"6 de julio de 1997"
32,1,10,238,113,133,246,"6 de julio de 1997"
32,1,10,239,276,273,549,"6 de julio de 1997"
32,1,10,240,354,365,719,"6 de julio de 1997"
32,1,10,241,102,91,193,"6 de julio de 1997"
32,1,10,242,126,116,242,"6 de julio de 1997"
32,1,10,243,223,254,477,"6 de julio de 1997"
32,1,10,244,136,139,275,"6 de julio de 1997"
32,1,10,245,268,254,522,"6 de julio de 1997"
32,1,10,246,331,313,644,"6 de julio de 1997"
32,1,10,247,136,97,233,"6 de julio de 1997"
32,1,10,248,176,145,321,"6 de julio de 1997"
32,1,10,249,339,340,679,"6 de julio de 1997"
32,1,10,250,311,294,605,"6 de julio de 1997"
32,1,10,251,286,303,589,"6 de julio de 1997"
32,1,10,252,341,326,667,"6 de julio de 1997"
32,1,10,253,269,280,549,"6 de julio de 1997"
32,1,10,254,100,98,198,"6 de julio de 1997"
32,1,10,255,55,49,104,"6 de julio de 1997"
32,1,10,256,224,215,439,"6 de julio de 1997"
32,1,10,257,179,204,383,"6 de julio de 1997"
32,1,10,258,60,59,119,"6 de julio de 1997"
32,1,10,259,90,83,173,"6 de julio de 1997"
32,1,10,260,178,171,349,"6 de julio de 1997"
32,1,10,261,146,137,283,"6 de julio de 1997"
32,1,10,262,50,44,94,"6 de julio de 1997"
32,1,10,263,179,188,367,"6 de julio de 1997"
32,1,10,264,194,208,402,"6 de julio de 1997"
32,1,10,265,348,350,698,"6 de julio de 1997"
32,1,10,266,417,416,833,"6 de julio de 1997"
32,1,10,267,438,439,877,"6 de julio de 1997"
32,1,10,268,293,281,574,"6 de julio de 1997"
32,1,10,269,150,140,290,"6 de julio de 1997"
32,1,10,270,331,369,700,"6 de julio de 1997"
32,1,10,271,328,345,673,"6 de julio de 1997"
32,1,10,272,296,324,620,"6 de julio de 1997"
32,1,10,273,123,111,234,"6 de julio de 1997"
32,1,10,274,410,361,771,"6 de julio de 1997"
32,1,10,275,182,175,357,"6 de julio de 1997"
32,1,10,276,409,473,882,"6 de julio de 1997"
32,1,10,277,336,357,693,"6 de julio de 1997"
32,1,10,278,42,49,91,"6 de julio de 1997"
32,1,10,279,292,293,585,"6 de julio de 1997"
32,1,10,280,142,144,286,"6 de julio de 1997"
32,1,10,281,95,101,196,"6 de julio de 1997"
32,1,10,282,321,345,666,"6 de julio de 1997"
32,1,10,283,110,116,226,"6 de julio de 1997"
32,1,10,284,204,197,401,"6 de julio de 1997"
32,1,10,285,62,66,128,"6 de julio de 1997"
32,1,10,286,67,86,153,"6 de julio de 1997"
32,1,10,287,39,39,78,"6 de julio de 1997"
32,1,10,288,115,99,214,"6 de julio de 1997"
32,1,10,289,135,133,268,"6 de julio de 1997"
32,1,10,290,304,273,577,"6 de julio de 1997"
32,1,10,291,257,257,514,"6 de julio de 1997"
32,1,10,292,470,469,939,"6 de julio de 1997"
32,1,10,293,208,203,411,"6 de julio de 1997"
32,1,10,294,158,178,336,"6 de julio de 1997"
32,1,10,295,151,153,304,"6 de julio de 1997"
32,1,10,296,94,118,212,"6 de julio de 1997"
32,1,10,297,106,104,210,"6 de julio de 1997"
32,1,10,298,122,124,246,"6 de julio de 1997"
32,1,10,299,94,86,180,"6 de julio de 1997"
32,1,10,300,370,357,727,"6 de julio de 1997"
32,1,10,301,24,19,43,"6 de julio de 1997"
32,1,10,302,109,117,226,"6 de julio de 1997"
32,1,10,303,311,281,592,"6 de julio de 1997"
32,1,10,304,336,308,644,"6 de julio de 1997"
32,1,10,305,141,131,272,"6 de julio de 1997"
32,1,10,306,70,58,128,"6 de julio de 1997"
32,1,10,307,184,158,342,"6 de julio de 1997"
32,1,10,308,89,101,190,"6 de julio de 1997"
32,1,10,309,91,95,186,"6 de julio de 1997"
32,1,10,310,206,214,420,"6 de julio de 1997"
32,1,10,311,204,183,387,"6 de julio de 1997"
32,1,10,312,189,194,383,"6 de julio de 1997"
32,1,10,313,144,144,288,"6 de julio de 1997"
32,1,10,314,186,197,383,"6 de julio de 1997"
32,1,10,315,59,66,125,"6 de julio de 1997"
32,1,10,316,49,61,110,"6 de julio de 1997"
32,1,10,317,144,134,278,"6 de julio de 1997"
32,1,10,318,766,776,1542,"6 de julio de 1997"
32,1,10,319,64,67,131,"6 de julio de 1997"
32,1,10,320,79,84,163,"6 de julio de 1997"
32,1,10,321,219,233,452,"6 de julio de 1997"
32,1,10,322,60,73,133,"6 de julio de 1997"
32,1,10,323,40,30,70,"6 de julio de 1997"
32,1,10,324,100,114,214,"6 de julio de 1997"
32,1,10,325,191,217,408,"6 de julio de 1997"
32,1,10,326,75,66,141,"6 de julio de 1997"
32,1,10,327,83,81,164,"6 de julio de 1997"
32,1,10,328,60,75,135,"6 de julio de 1997"
32,1,10,329,57,59,116,"6 de julio de 1997"
32,1,10,330,75,75,150,"6 de julio de 1997"
32,1,10,331,43,46,89,"6 de julio de 1997"
32,1,10,332,111,109,220,"6 de julio de 1997"
32,1,10,333,90,92,182,"6 de julio de 1997"
32,1,10,334,56,51,107,"6 de julio de 1997"
32,1,10,335,64,69,133,"6 de julio de 1997"
32,1,10,336,57,44,101,"6 de julio de 1997"
32,1,10,337,40,36,76,"6 de julio de 1997"
32,1,10,338,126,116,242,"6 de julio de 1997"
32,1,10,339,128,113,241,"6 de julio de 1997"
32,1,10,340,198,171,369,"6 de julio de 1997"
32,1,10,341,166,159,325,"6 de julio de 1997"
32,1,10,342,28,26,54,"6 de julio de 1997"
32,1,10,343,53,45,98,"6 de julio de 1997"
32,1,10,344,200,195,395,"6 de julio de 1997"
32,1,10,345,95,89,184,"6 de julio de 1997"
32,1,10,346,139,136,275,"6 de julio de 1997"
32,1,10,347,62,64,126,"6 de julio de 1997"
32,1,10,348,35,32,67,"6 de julio de 1997"
32,1,13,378,278,336,614,"6 de julio de 1997"
32,1,13,379,409,443,852,"6 de julio de 1997"
32,1,13,380,291,320,611,"6 de julio de 1997"
32,1,13,381,187,192,379,"6 de julio de 1997"
32,1,13,382,208,215,423,"6 de julio de 1997"
32,1,13,383,72,77,149,"6 de julio de 1997"
32,1,13,384,47,57,104,"6 de julio de 1997"
32,1,13,385,29,30,59,"6 de julio de 1997"
32,1,26,808,179,151,330,"6 de julio de 1997"
32,1,26,809,236,235,471,"6 de julio de 1997"
32,1,26,810,210,201,411,"6 de julio de 1997"
32,1,26,811,223,245,468,"6 de julio de 1997"
32,1,26,812,45,40,85,"6 de julio de 1997"
32,1,26,813,88,82,170,"6 de julio de 1997"
32,1,26,814,93,81,174,"6 de julio de 1997"
32,1,26,815,38,32,70,"6 de julio de 1997"
32,1,26,816,161,164,325,"6 de julio de 1997"
32,1,26,817,188,156,344,"6 de julio de 1997"
32,1,26,818,62,44,106,"6 de julio de 1997"
32,1,26,819,81,85,166,"6 de julio de 1997"
32,1,26,820,217,180,397,"6 de julio de 1997"
32,1,26,821,91,87,178,"6 de julio de 1997"
32,1,26,822,170,156,326,"6 de julio de 1997"
32,1,26,823,121,100,221,"6 de julio de 1997"
32,1,26,824,100,93,193,"6 de julio de 1997"
32,1,26,825,32,26,58,"6 de julio de 1997"
32,1,26,826,89,69,158,"6 de julio de 1997"
32,1,26,827,174,153,327,"6 de julio de 1997"
32,1,26,828,94,77,171,"6 de julio de 1997"
32,1,26,829,56,35,91,"6 de julio de 1997"
32,1,26,830,37,32,69,"6 de julio de 1997"
32,1,26,831,121,103,224,"6 de julio de 1997"
32,1,26,832,83,65,148,"6 de julio de 1997"
32,1,26,833,64,56,120,"6 de julio de 1997"
32,1,26,834,89,89,178,"6 de julio de 1997"
32,1,26,835,78,71,149,"6 de julio de 1997"
32,1,26,836,125,90,215,"6 de julio de 1997"
32,1,26,837,118,104,222,"6 de julio de 1997"
32,1,26,838,97,69,166,"6 de julio de 1997"
32,1,26,839,40,31,71,"6 de julio de 1997"
32,1,26,840,31,29,60,"6 de julio de 1997"
32,1,26,841,247,186,433,"6 de julio de 1997"
32,1,26,842,89,71,160,"6 de julio de 1997"
32,1,26,843,60,45,105,"6 de julio de 1997"
32,1,26,844,157,123,280,"6 de julio de 1997"
32,1,26,845,137,115,252,"6 de julio de 1997"
32,1,26,846,63,56,119,"6 de julio de 1997"
32,1,26,847,58,44,102,"6 de julio de 1997"
32,1,26,848,37,28,65,"6 de julio de 1997"
32,1,26,849,58,60,118,"6 de julio de 1997"
32,1,26,850,63,51,114,"6 de julio de 1997"
32,1,26,851,89,55,144,"6 de julio de 1997"
32,1,26,852,23,22,45,"6 de julio de 1997"
32,1,26,853,87,84,171,"6 de julio de 1997"
32,1,26,854,43,41,84,"6 de julio de 1997"
32,1,26,855,25,30,55,"6 de julio de 1997"
32,1,26,856,31,35,66,"6 de julio de 1997"
32,1,26,857,27,24,51,"6 de julio de 1997"
32,1,26,858,38,33,71,"6 de julio de 1997"
32,1,26,859,115,93,208,"6 de julio de 1997"
32,1,26,860,77,59,136,"6 de julio de 1997"
32,1,26,861,76,58,134,"6 de julio de 1997"
32,1,26,862,53,45,98,"6 de julio de 1997"
32,1,26,863,66,53,119,"6 de julio de 1997"
32,1,26,864,42,35,77,"6 de julio de 1997"
32,1,26,865,43,45,88,"6 de julio de 1997"
32,1,26,866,82,49,131,"6 de julio de 1997"
32,1,26,867,82,65,147,"6 de julio de 1997"
32,1,27,868,225,212,437,"6 de julio de 1997"
32,1,27,869,189,153,342,"6 de julio de 1997"
32,1,27,870,57,42,99,"6 de julio de 1997"
32,1,27,871,91,76,167,"6 de julio de 1997"
32,1,27,872,36,31,67,"6 de julio de 1997"
32,1,27,873,131,106,237,"6 de julio de 1997"
32,1,27,874,91,78,169,"6 de julio de 1997"
32,1,27,875,47,37,84,"6 de julio de 1997"
32,1,41,1283,196,164,360,"6 de julio de 1997"
32,1,41,1284,229,191,420,"6 de julio de 1997"
32,1,41,1285,56,41,97,"6 de julio de 1997"
32,1,41,1286,324,313,637,"6 de julio de 1997"
32,1,41,1287,146,122,268,"6 de julio de 1997"
32,1,41,1288,47,38,85,"6 de julio de 1997"
32,1,49,1525,135,165,300,"6 de julio de 1997"
32,1,49,1526,239,267,506,"6 de julio de 1997"
32,1,49,1527,308,340,648,"6 de julio de 1997"
32,1,49,1528,210,227,437,"6 de julio de 1997"
32,1,49,1529,168,212,380,"6 de julio de 1997"
32,1,49,1530,182,208,390,"6 de julio de 1997"
32,1,49,1531,270,324,594,"6 de julio de 1997"
32,1,49,1532,169,183,352,"6 de julio de 1997"
32,1,49,1533,277,306,583,"6 de julio de 1997"
32,1,49,1534,359,417,776,"6 de julio de 1997"
32,1,49,1535,267,327,594,"6 de julio de 1997"
32,1,49,1536,235,284,519,"6 de julio de 1997"
32,1,49,1537,94,131,225,"6 de julio de 1997"
32,1,49,1538,261,294,555,"6 de julio de 1997"
32,1,49,1539,221,260,481,"6 de julio de 1997"
32,1,49,1540,109,142,251,"6 de julio de 1997"
32,1,49,1541,166,231,397,"6 de julio de 1997"
32,1,49,1542,85,74,159,"6 de julio de 1997"
32,1,49,1543,204,228,432,"6 de julio de 1997"
32,1,49,1544,98,97,195,"6 de julio de 1997"
32,1,49,1545,158,167,325,"6 de julio de 1997"
32,1,49,1546,96,111,207,"6 de julio de 1997"
32,1,49,1547,79,107,186,"6 de julio de 1997"
32,1,49,1548,75,73,148,"6 de julio de 1997"
32,1,49,1549,123,116,239,"6 de julio de 1997"
32,1,49,1550,102,102,204,"6 de julio de 1997"
32,1,49,1551,185,187,372,"6 de julio de 1997"
32,1,49,1552,111,124,235,"6 de julio de 1997"
32,1,49,1553,71,79,150,"6 de julio de 1997"
32,1,49,1554,63,74,137,"6 de julio de 1997"
32,1,49,1555,113,142,255,"6 de julio de 1997"
32,1,49,1556,54,69,123,"6 de julio de 1997"
32,1,49,1557,139,180,319,"6 de julio de 1997"
32,1,49,1558,122,136,258,"6 de julio de 1997"
32,1,49,1559,248,280,528,"6 de julio de 1997"
32,1,49,1560,186,215,401,"6 de julio de 1997"
32,1,49,1561,203,260,463,"6 de julio de 1997"
32,1,49,1562,221,286,507,"6 de julio de 1997"
32,1,49,1563,230,270,500,"6 de julio de 1997"
32,1,49,1564,172,182,354,"6 de julio de 1997"
32,1,49,1565,34,42,76,"6 de julio de 1997"
32,1,49,1566,59,92,151,"6 de julio de 1997"
32,1,49,1567,107,146,253,"6 de julio de 1997"
32,1,49,1568,94,93,187,"6 de julio de 1997"
32,1,49,1569,171,205,376,"6 de julio de 1997"
32,1,49,1570,83,92,175,"6 de julio de 1997"
32,1,49,1571,109,119,228,"6 de julio de 1997"
32,1,49,1572,64,92,156,"6 de julio de 1997"
32,1,49,1573,141,173,314,"6 de julio de 1997"
32,1,49,1574,33,49,82,"6 de julio de 1997"
32,1,49,1575,92,112,204,"6 de julio de 1997"
32,1,49,1576,81,101,182,"6 de julio de 1997"
32,1,49,1577,196,216,412,"6 de julio de 1997"
32,1,49,1578,216,273,489,"6 de julio de 1997"
32,1,49,1579,75,100,175,"6 de julio de 1997"
32,1,49,1580,161,194,355,"6 de julio de 1997"
32,1,49,1581,31,49,80,"6 de julio de 1997"
32,1,49,1582,61,62,123,"6 de julio de 1997"
32,1,49,1583,47,63,110,"6 de julio de 1997"
32,1,49,1584,197,227,424,"6 de julio de 1997"
32,1,49,1585,118,134,252,"6 de julio de 1997"
32,1,49,1586,231,241,472,"6 de julio de 1997"
32,1,49,1587,56,53,109,"6 de julio de 1997"
32,1,49,1588,167,203,370,"6 de julio de 1997"
32,1,49,1589,109,138,247,"6 de julio de 1997"
32,1,49,1590,133,136,269,"6 de julio de 1997"
32,1,49,1591,114,115,229,"6 de julio de 1997"
32,1,49,1592,56,55,111,"6 de julio de 1997"
32,1,49,1593,79,87,166,"6 de julio de 1997"
32,1,49,1594,60,89,149,"6 de julio de 1997"
32,1,49,1595,31,35,66,"6 de julio de 1997"
32,1,49,1596,91,93,184,"6 de julio de 1997"
32,1,49,1597,122,132,254,"6 de julio de 1997"
32,1,49,1598,86,86,172,"6 de julio de 1997"
32,1,49,1599,35,43,78,"6 de julio de 1997"
32,1,49,1600,119,144,263,"6 de julio de 1997"
32,1,51,1609,274,265,539,"6 de julio de 1997"
32,1,51,1610,301,315,616,"6 de julio de 1997"
32,1,51,1611,263,282,545,"6 de julio de 1997"
32,1,51,1612,268,277,545,"6 de julio de 1997"
32,1,51,1613,364,369,733,"6 de julio de 1997"
32,1,51,1614,328,299,627,"6 de julio de 1997"
32,1,51,1615,319,306,625,"6 de julio de 1997"
32,1,51,1616,110,86,196,"6 de julio de 1997"
32,1,51,1617,63,44,107,"6 de julio de 1997"
32,1,51,1618,328,329,657,"6 de julio de 1997"
32,1,51,1619,119,97,216,"6 de julio de 1997"
32,1,51,1620,85,63,148,"6 de julio de 1997"
32,1,51,1621,148,123,271,"6 de julio de 1997"
32,1,51,1622,179,174,353,"6 de julio de 1997"
32,1,51,1623,82,71,153,"6 de julio de 1997"
32,1,51,1624,264,223,487,"6 de julio de 1997"
32,1,51,1625,53,59,112,"6 de julio de 1997"
32,1,51,1626,97,102,199,"6 de julio de 1997"
32,1,51,1627,295,234,529,"6 de julio de 1997"
32,1,51,1628,211,201,412,"6 de julio de 1997"
32,1,51,1629,159,131,290,"6 de julio de 1997"
32,1,51,1630,80,72,152,"6 de julio de 1997"
32,1,51,1631,170,170,340,"6 de julio de 1997"
32,1,51,1632,259,241,500,"6 de julio de 1997"
32,1,51,1633,224,227,451,"6 de julio de 1997"
32,1,51,1634,237,236,473,"6 de julio de 1997"
32,1,51,1635,236,245,481,"6 de julio de 1997"
32,1,51,1636,256,215,471,"6 de julio de 1997"
32,1,51,1637,254,217,471,"6 de julio de 1997"
32,1,51,1638,233,225,458,"6 de julio de 1997"
32,1,51,1639,210,171,381,"6 de julio de 1997"
32,1,51,1640,268,246,514,"6 de julio de 1997"
32,1,51,1641,254,232,486,"6 de julio de 1997"
32,1,51,1642,134,110,244,"6 de julio de 1997"
32,1,51,1643,122,118,240,"6 de julio de 1997"
32,1,51,1644,54,44,98,"6 de julio de 1997"
32,1,51,1645,70,61,131,"6 de julio de 1997"
32,1,51,1646,60,60,120,"6 de julio de 1997"
32,1,51,1647,74,64,138,"6 de julio de 1997"
32,1,51,1648,65,57,122,"6 de julio de 1997"
32,1,51,1649,45,35,80,"6 de julio de 1997"
32,1,51,1650,123,107,230,"6 de julio de 1997"
32,1,51,1651,33,21,54,"6 de julio de 1997"
32,1,51,1652,118,94,212,"6 de julio de 1997"
32,1,51,1653,146,134,280,"6 de julio de 1997"
32,1,51,1654,190,171,361,"6 de julio de 1997"
32,1,51,1655,92,84,176,"6 de julio de 1997"
32,1,51,1656,74,68,142,"6 de julio de 1997"
32,1,51,1657,41,35,76,"6 de julio de 1997"
32,1,51,1658,50,43,93,"6 de julio de 1997"
32,2,6,61,261,273,534,"6 de julio de 1997"
32,2,6,62,291,307,598,"6 de julio de 1997"
32,2,6,63,293,310,603,"6 de julio de 1997"
32,2,6,64,286,286,572,"6 de julio de 1997"
32,2,6,65,237,283,520,"6 de julio de 1997"
32,2,6,66,288,320,608,"6 de julio de 1997"
32,2,6,67,140,127,267,"6 de julio de 1997"
32,2,6,68,94,84,178,"6 de julio de 1997"
32,2,6,69,350,358,708,"6 de julio de 1997"
32,2,6,70,168,180,348,"6 de julio de 1997"
32,2,6,71,53,51,104,"6 de julio de 1997"
32,2,6,72,27,23,50,"6 de julio de 1997"
32,2,9,114,200,240,440,"6 de julio de 1997"
32,2,9,115,135,154,289,"6 de julio de 1997"
32,2,9,116,227,282,509,"6 de julio de 1997"
32,2,9,117,163,210,373,"6 de julio de 1997"
32,2,9,118,165,203,368,"6 de julio de 1997"
32,2,9,119,258,289,547,"6 de julio de 1997"
32,2,9,120,142,149,291,"6 de julio de 1997"
32,2,9,121,126,156,282,"6 de julio de 1997"
32,2,9,122,142,175,317,"6 de julio de 1997"
32,2,9,123,206,255,461,"6 de julio de 1997"
32,2,9,124,194,171,365,"6 de julio de 1997"
32,2,9,125,223,213,436,"6 de julio de 1997"
32,2,9,126,61,74,135,"6 de julio de 1997"
32,2,9,127,185,229,414,"6 de julio de 1997"
32,2,9,128,218,230,448,"6 de julio de 1997"
32,2,9,129,171,181,352,"6 de julio de 1997"
32,2,9,130,157,182,339,"6 de julio de 1997"
32,2,9,131,140,140,280,"6 de julio de 1997"
32,2,9,132,161,210,371,"6 de julio de 1997"
32,2,9,133,119,133,252,"6 de julio de 1997"
32,2,9,134,129,135,264,"6 de julio de 1997"
32,2,14,386,273,311,584,"6 de julio de 1997"
32,2,14,387,283,341,624,"6 de julio de 1997"
32,2,14,388,226,251,477,"6 de julio de 1997"
32,2,14,389,232,293,525,"6 de julio de 1997"
32,2,14,390,205,267,472,"6 de julio de 1997"
32,2,14,391,207,282,489,"6 de julio de 1997"
32,2,14,392,108,120,228,"6 de julio de 1997"
32,2,14,393,205,224,429,"6 de julio de 1997"
32,2,14,394,160,171,331,"6 de julio de 1997"
32,2,14,395,139,140,279,"6 de julio de 1997"
32,2,14,396,141,208,349,"6 de julio de 1997"
32,2,14,397,207,224,431,"6 de julio de 1997"
32,2,14,398,145,182,327,"6 de julio de 1997"
32,2,14,399,163,228,391,"6 de julio de 1997"
32,2,14,400,124,151,275,"6 de julio de 1997"
32,2,14,401,84,110,194,"6 de julio de 1997"
32,2,14,402,256,264,520,"6 de julio de 1997"
32,2,14,403,90,132,222,"6 de julio de 1997"
32,2,14,404,92,120,212,"6 de julio de 1997"
32,2,14,405,146,149,295,"6 de julio de 1997"
32,2,14,406,103,174,277,"6 de julio de 1997"
32,2,14,407,152,220,372,"6 de julio de 1997"
32,2,14,408,220,208,428,"6 de julio de 1997"
32,2,14,409,204,201,405,"6 de julio de 1997"
32,2,14,410,181,140,321,"6 de julio de 1997"
32,2,14,411,96,100,196,"6 de julio de 1997"
32,2,14,412,208,266,474,"6 de julio de 1997"
32,2,14,413,254,319,573,"6 de julio de 1997"
32,2,14,414,200,235,435,"6 de julio de 1997"
32,2,14,415,100,114,214,"6 de julio de 1997"
32,2,14,416,50,51,101,"6 de julio de 1997"
32,2,14,417,59,62,121,"6 de julio de 1997"
32,2,14,418,89,137,226,"6 de julio de 1997"
32,2,14,419,74,102,176,"6 de julio de 1997"
32,2,14,420,53,75,128,"6 de julio de 1997"
32,2,14,421,106,147,253,"6 de julio de 1997"
32,2,14,422,54,56,110,"6 de julio de 1997"
32,2,14,423,42,51,93,"6 de julio de 1997"
32,2,14,424,59,53,112,"6 de julio de 1997"
32,2,14,425,145,188,333,"6 de julio de 1997"
32,2,14,426,73,78,151,"6 de julio de 1997"
32,2,14,427,60,73,133,"6 de julio de 1997"
32,2,21,708,146,178,324,"6 de julio de 1997"
32,2,21,709,145,168,313,"6 de julio de 1997"
32,2,21,710,128,132,260,"6 de julio de 1997"
32,2,21,711,171,236,407,"6 de julio de 1997"
32,2,21,712,123,117,240,"6 de julio de 1997"
32,2,21,713,148,165,313,"6 de julio de 1997"
32,2,21,714,85,82,167,"6 de julio de 1997"
32,2,21,715,59,65,124,"6 de julio de 1997"
32,2,21,716,97,104,201,"6 de julio de 1997"
32,2,21,717,67,85,152,"6 de julio de 1997"
32,2,22,718,339,349,688,"6 de julio de 1997"
32,2,22,719,330,412,742,"6 de julio de 1997"
32,2,22,720,241,277,518,"6 de julio de 1997"
32,2,22,721,211,257,468,"6 de julio de 1997"
32,2,22,722,315,326,641,"6 de julio de 1997"
32,2,22,723,281,343,624,"6 de julio de 1997"
32,2,22,724,165,184,349,"6 de julio de 1997"
32,2,22,725,306,374,680,"6 de julio de 1997"
32,2,22,726,303,356,659,"6 de julio de 1997"
32,2,22,727,189,223,412,"6 de julio de 1997"
32,2,22,728,245,287,532,"6 de julio de 1997"
32,2,22,729,221,247,468,"6 de julio de 1997"
32,2,22,730,274,306,580,"6 de julio de 1997"
32,2,22,731,85,98,183,"6 de julio de 1997"
32,2,22,732,109,112,221,"6 de julio de 1997"
32,2,22,733,192,228,420,"6 de julio de 1997"
32,2,22,734,122,125,247,"6 de julio de 1997"
32,2,22,735,121,150,271,"6 de julio de 1997"
32,2,22,736,183,229,412,"6 de julio de 1997"
32,2,22,737,188,208,396,"6 de julio de 1997"
32,2,22,738,59,45,104,"6 de julio de 1997"
32,2,22,739,193,179,372,"6 de julio de 1997"
32,2,22,740,95,114,209,"6 de julio de 1997"
32,2,22,741,26,23,49,"6 de julio de 1997"
32,2,29,884,319,326,645,"6 de julio de 1997"
32,2,29,885,345,370,715,"6 de julio de 1997"
32,2,29,886,190,206,396,"6 de julio de 1997"
32,2,29,887,201,249,450,"6 de julio de 1997"
32,2,29,888,244,272,516,"6 de julio de 1997"
32,2,29,889,183,189,372,"6 de julio de 1997"
32,2,29,890,327,388,715,"6 de julio de 1997"
32,2,29,891,326,373,699,"6 de julio de 1997"
32,2,29,892,291,323,614,"6 de julio de 1997"
32,2,29,893,228,256,484,"6 de julio de 1997"
32,2,29,894,358,407,765,"6 de julio de 1997"
32,2,29,895,194,171,365,"6 de julio de 1997"
32,2,29,896,169,180,349,"6 de julio de 1997"
32,2,29,897,125,152,277,"6 de julio de 1997"
32,2,29,898,139,146,285,"6 de julio de 1997"
32,2,29,899,151,167,318,"6 de julio de 1997"
32,2,29,900,219,249,468,"6 de julio de 1997"
32,2,29,901,218,236,454,"6 de julio de 1997"
32,2,29,902,42,42,84,"6 de julio de 1997"
32,2,29,903,121,124,245,"6 de julio de 1997"
32,2,29,904,156,145,301,"6 de julio de 1997"
32,2,29,905,27,26,53,"6 de julio de 1997"
32,2,39,1192,292,305,597,"6 de julio de 1997"
32,2,39,1193,249,331,580,"6 de julio de 1997"
32,2,39,1194,219,264,483,"6 de julio de 1997"
32,2,39,1195,275,303,578,"6 de julio de 1997"
32,2,39,1196,191,223,414,"6 de julio de 1997"
32,2,39,1197,206,262,468,"6 de julio de 1997"
32,2,39,1198,232,265,497,"6 de julio de 1997"
32,2,39,1199,244,256,500,"6 de julio de 1997"
32,2,39,1200,442,490,932,"6 de julio de 1997"
32,2,39,1201,281,357,638,"6 de julio de 1997"
32,2,39,1202,383,478,861,"6 de julio de 1997"
32,2,39,1203,226,264,490,"6 de julio de 1997"
32,2,39,1204,256,266,522,"6 de julio de 1997"
32,2,39,1205,265,286,551,"6 de julio de 1997"
32,2,39,1206,283,319,602,"6 de julio de 1997"
32,2,39,1207,290,336,626,"6 de julio de 1997"
32,2,39,1208,194,235,429,"6 de julio de 1997"
32,2,39,1209,247,277,524,"6 de julio de 1997"
32,2,39,1210,328,420,748,"6 de julio de 1997"
32,2,39,1211,387,459,846,"6 de julio de 1997"
32,2,39,1212,362,377,739,"6 de julio de 1997"
32,2,39,1213,298,323,621,"6 de julio de 1997"
32,2,39,1214,106,127,233,"6 de julio de 1997"
32,2,39,1215,361,394,755,"6 de julio de 1997"
32,2,39,1216,203,236,439,"6 de julio de 1997"
32,2,39,1217,265,306,571,"6 de julio de 1997"
32,2,39,1218,225,275,500,"6 de julio de 1997"
32,2,39,1219,231,298,529,"6 de julio de 1997"
32,2,39,1220,273,333,606,"6 de julio de 1997"
32,2,39,1221,237,299,536,"6 de julio de 1997"
32,2,39,1222,133,155,288,"6 de julio de 1997"
32,2,39,1223,240,289,529,"6 de julio de 1997"
32,2,39,1224,175,192,367,"6 de julio de 1997"
32,2,39,1225,208,232,440,"6 de julio de 1997"
32,2,39,1226,482,559,1041,"6 de julio de 1997"
32,2,39,1227,230,308,538,"6 de julio de 1997"
32,2,39,1228,212,253,465,"6 de julio de 1997"
32,2,39,1229,247,289,536,"6 de julio de 1997"
32,2,39,1230,196,235,431,"6 de julio de 1997"
32,2,39,1231,323,385,708,"6 de julio de 1997"
32,2,39,1232,307,351,658,"6 de julio de 1997"
32,2,39,1233,233,294,527,"6 de julio de 1997"
32,2,39,1234,212,307,519,"6 de julio de 1997"
32,2,39,1235,304,307,611,"6 de julio de 1997"
32,2,39,1236,291,317,608,"6 de julio de 1997"
32,2,39,1237,323,357,680,"6 de julio de 1997"
32,2,39,1238,190,222,412,"6 de julio de 1997"
32,2,39,1239,170,192,362,"6 de julio de 1997"
32,2,39,1240,231,339,570,"6 de julio de 1997"
32,2,39,1241,205,291,496,"6 de julio de 1997"
32,2,39,1242,278,334,612,"6 de julio de 1997"
32,2,39,1243,109,159,268,"6 de julio de 1997"
32,2,39,1244,108,141,249,"6 de julio de 1997"
32,2,39,1245,181,226,407,"6 de julio de 1997"
32,2,39,1246,167,217,384,"6 de julio de 1997"
32,2,39,1247,163,211,374,"6 de julio de 1997"
32,2,39,1248,151,169,320,"6 de julio de 1997"
32,2,39,1249,225,297,522,"6 de julio de 1997"
32,2,39,1250,255,285,540,"6 de julio de 1997"
32,2,39,1251,112,120,232,"6 de julio de 1997"
32,2,39,1252,199,200,399,"6 de julio de 1997"
32,2,39,1253,139,148,287,"6 de julio de 1997"
32,2,39,1254,25,23,48,"6 de julio de 1997"
32,2,39,1255,91,92,183,"6 de julio de 1997"
32,2,40,1256,324,372,696,"6 de julio de 1997"
32,2,40,1257,211,305,516,"6 de julio de 1997"
32,2,40,1258,252,304,556,"6 de julio de 1997"
32,2,40,1259,225,295,520,"6 de julio de 1997"
32,2,40,1260,221,260,481,"6 de julio de 1997"
32,2,40,1261,191,202,393,"6 de julio de 1997"
32,2,40,1262,168,195,363,"6 de julio de 1997"
32,2,40,1263,147,167,314,"6 de julio de 1997"
32,2,40,1264,188,217,405,"6 de julio de 1997"
32,2,40,1265,148,156,304,"6 de julio de 1997"
32,2,40,1266,312,341,653,"6 de julio de 1997"
32,2,40,1267,87,103,190,"6 de julio de 1997"
32,2,40,1268,219,221,440,"6 de julio de 1997"
32,2,40,1269,249,265,514,"6 de julio de 1997"
32,2,40,1270,270,275,545,"6 de julio de 1997"
32,2,40,1271,181,219,400,"6 de julio de 1997"
32,2,40,1272,105,156,261,"6 de julio de 1997"
32,2,40,1273,272,320,592,"6 de julio de 1997"
32,2,40,1274,215,258,473,"6 de julio de 1997"
32,2,40,1275,106,109,215,"6 de julio de 1997"
32,2,40,1276,174,175,349,"6 de julio de 1997"
32,2,40,1277,253,276,529,"6 de julio de 1997"
32,2,40,1278,289,304,593,"6 de julio de 1997"
32,2,40,1279,143,151,294,"6 de julio de 1997"
32,2,40,1280,111,122,233,"6 de julio de 1997"
32,2,40,1281,133,133,266,"6 de julio de 1997"
32,2,40,1282,73,79,152,"6 de julio de 1997"
32,2,42,1289,359,365,724,"6 de julio de 1997"
32,2,42,1290,233,266,499,"6 de julio de 1997"
32,2,42,1291,153,169,322,"6 de julio de 1997"
32,2,42,1292,285,287,572,"6 de julio de 1997"
32,2,42,1293,337,410,747,"6 de julio de 1997"
32,2,42,1294,235,275,510,"6 de julio de 1997"
32,2,42,1295,113,133,246,"6 de julio de 1997"
32,2,42,1296,284,302,586,"6 de julio de 1997"
32,2,42,1297,306,331,637,"6 de julio de 1997"
32,2,42,1298,317,382,699,"6 de julio de 1997"
32,2,42,1299,325,363,688,"6 de julio de 1997"
32,2,42,1300,268,312,580,"6 de julio de 1997"
32,2,42,1301,300,374,674,"6 de julio de 1997"
32,2,42,1302,296,333,629,"6 de julio de 1997"
32,2,42,1303,282,354,636,"6 de julio de 1997"
32,2,42,1304,391,446,837,"6 de julio de 1997"
32,2,42,1305,263,266,529,"6 de julio de 1997"
32,2,42,1306,200,226,426,"6 de julio de 1997"
32,2,42,1307,103,105,208,"6 de julio de 1997"
32,2,42,1308,142,134,276,"6 de julio de 1997"
32,2,42,1309,305,319,624,"6 de julio de 1997"
32,2,42,1310,203,188,391,"6 de julio de 1997"
32,2,42,1311,205,200,405,"6 de julio de 1997"
32,2,42,1312,224,235,459,"6 de julio de 1997"
32,2,42,1313,276,301,577,"6 de julio de 1997"
32,2,42,1314,240,280,520,"6 de julio de 1997"
32,2,42,1315,255,271,526,"6 de julio de 1997"
32,2,42,1316,281,307,588,"6 de julio de 1997"
32,2,42,1317,171,144,315,"6 de julio de 1997"
32,2,42,1318,164,154,318,"6 de julio de 1997"
32,2,42,1319,222,220,442,"6 de julio de 1997"
32,2,42,1320,102,95,197,"6 de julio de 1997"
32,2,42,1321,248,306,554,"6 de julio de 1997"
32,2,42,1322,278,244,522,"6 de julio de 1997"
32,2,42,1323,339,369,708,"6 de julio de 1997"
32,2,42,1324,107,95,202,"6 de julio de 1997"
32,2,42,1325,210,213,423,"6 de julio de 1997"
32,2,42,1326,278,315,593,"6 de julio de 1997"
32,2,42,1327,157,212,369,"6 de julio de 1997"
32,2,42,1328,133,174,307,"6 de julio de 1997"
32,2,42,1329,231,214,445,"6 de julio de 1997"
32,2,42,1330,66,76,142,"6 de julio de 1997"
32,2,42,1331,247,228,475,"6 de julio de 1997"
32,2,42,1332,39,38,77,"6 de julio de 1997"
32,2,42,1333,96,153,249,"6 de julio de 1997"
32,2,42,1334,185,197,382,"6 de julio de 1997"
32,2,42,1335,189,233,422,"6 de julio de 1997"
32,2,42,1336,220,299,519,"6 de julio de 1997"
32,2,42,1337,89,98,187,"6 de julio de 1997"
32,2,42,1338,120,141,261,"6 de julio de 1997"
32,2,42,1339,374,378,752,"6 de julio de 1997"
32,2,42,1340,224,216,440,"6 de julio de 1997"
32,2,42,1341,138,148,286,"6 de julio de 1997"
32,2,42,1342,135,123,258,"6 de julio de 1997"
32,2,42,1343,135,134,269,"6 de julio de 1997"
32,2,42,1344,141,165,306,"6 de julio de 1997"
32,2,42,1345,218,225,443,"6 de julio de 1997"
32,2,42,1346,298,283,581,"6 de julio de 1997"
32,2,42,1347,197,256,453,"6 de julio de 1997"
32,2,42,1348,78,111,189,"6 de julio de 1997"
32,2,42,1349,152,151,303,"6 de julio de 1997"
32,2,42,1350,149,148,297,"6 de julio de 1997"
32,2,42,1351,138,125,263,"6 de julio de 1997"
32,2,42,1352,124,133,257,"6 de julio de 1997"
32,2,42,1353,205,219,424,"6 de julio de 1997"
32,2,42,1354,68,98,166,"6 de julio de 1997"
32,2,42,1355,131,149,280,"6 de julio de 1997"
32,2,42,1356,209,243,452,"6 de julio de 1997"
32,2,42,1357,112,119,231,"6 de julio de 1997"
32,2,42,1358,261,256,517,"6 de julio de 1997"
32,2,42,1359,64,76,140,"6 de julio de 1997"
32,2,42,1360,114,128,242,"6 de julio de 1997"
32,2,42,1361,141,173,314,"6 de julio de 1997"
32,2,42,1362,181,198,379,"6 de julio de 1997"
32,2,42,1363,133,128,261,"6 de julio de 1997"
32,2,42,1364,113,161,274,"6 de julio de 1997"
32,2,42,1365,157,169,326,"6 de julio de 1997"
32,2,42,1366,158,153,311,"6 de julio de 1997"
32,2,42,1367,104,101,205,"6 de julio de 1997"
32,2,42,1368,144,145,289,"6 de julio de 1997"
32,2,42,1369,65,66,131,"6 de julio de 1997"
32,2,42,1370,72,76,148,"6 de julio de 1997"
32,2,42,1371,78,70,148,"6 de julio de 1997"
32,2,42,1372,70,70,140,"6 de julio de 1997"
32,2,42,1373,99,90,189,"6 de julio de 1997"
32,2,42,1374,35,46,81,"6 de julio de 1997"
32,2,42,1375,149,143,292,"6 de julio de 1997"
32,2,42,1376,41,46,87,"6 de julio de 1997"
32,2,42,1377,81,91,172,"6 de julio de 1997"
32,2,42,1378,42,42,84,"6 de julio de 1997"
32,2,42,1379,36,24,60,"6 de julio de 1997"
32,2,42,1380,47,49,96,"6 de julio de 1997"
32,2,42,1381,86,104,190,"6 de julio de 1997"
32,2,42,1382,49,64,113,"6 de julio de 1997"
32,2,42,1383,77,77,154,"6 de julio de 1997"
32,3,5,40,401,430,831,"6 de julio de 1997"
32,3,5,41,424,428,852,"6 de julio de 1997"
32,3,5,42,218,208,426,"6 de julio de 1997"
32,3,5,43,333,327,660,"6 de julio de 1997"
32,3,5,44,234,237,471,"6 de julio de 1997"
32,3,5,45,172,158,330,"6 de julio de 1997"
32,3,5,46,368,390,758,"6 de julio de 1997"
32,3,5,47,395,400,795,"6 de julio de 1997"
32,3,5,48,412,424,836,"6 de julio de 1997"
32,3,5,49,302,314,616,"6 de julio de 1997"
32,3,5,50,455,479,934,"6 de julio de 1997"
32,3,5,51,424,451,875,"6 de julio de 1997"
32,3,5,52,280,289,569,"6 de julio de 1997"
32,3,5,53,490,479,969,"6 de julio de 1997"
32,3,5,54,351,377,728,"6 de julio de 1997"
32,3,5,55,322,344,666,"6 de julio de 1997"
32,3,5,56,397,416,813,"6 de julio de 1997"
32,3,5,57,430,403,833,"6 de julio de 1997"
32,3,5,58,194,202,396,"6 de julio de 1997"
32,3,5,59,231,224,455,"6 de julio de 1997"
32,3,5,60,67,70,137,"6 de julio de 1997"
32,3,8,103,345,403,748,"6 de julio de 1997"
32,3,8,104,288,292,580,"6 de julio de 1997"
32,3,8,105,392,416,808,"6 de julio de 1997"
32,3,8,106,317,347,664,"6 de julio de 1997"
32,3,8,107,295,319,614,"6 de julio de 1997"
32,3,8,108,278,270,548,"6 de julio de 1997"
32,3,8,109,139,180,319,"6 de julio de 1997"
32,3,8,110,159,204,363,"6 de julio de 1997"
32,3,8,111,156,172,328,"6 de julio de 1997"
32,3,8,112,305,287,592,"6 de julio de 1997"
32,3,8,113,102,85,187,"6 de julio de 1997"
32,3,12,359,178,207,385,"6 de julio de 1997"
32,3,12,360,87,86,173,"6 de julio de 1997"
32,3,12,361,162,171,333,"6 de julio de 1997"
32,3,12,362,113,103,216,"6 de julio de 1997"
32,3,12,363,31,36,67,"6 de julio de 1997"
32,3,12,364,309,313,622,"6 de julio de 1997"
32,3,12,365,144,150,294,"6 de julio de 1997"
32,3,12,366,86,78,164,"6 de julio de 1997"
32,3,12,367,35,34,69,"6 de julio de 1997"
32,3,12,368,57,47,104,"6 de julio de 1997"
32,3,12,369,209,217,426,"6 de julio de 1997"
32,3,12,370,126,139,265,"6 de julio de 1997"
32,3,12,371,67,75,142,"6 de julio de 1997"
32,3,12,372,58,55,113,"6 de julio de 1997"
32,3,12,373,56,55,111,"6 de julio de 1997"
32,3,12,374,84,93,177,"6 de julio de 1997"
32,3,12,375,63,81,144,"6 de julio de 1997"
32,3,12,376,46,49,95,"6 de julio de 1997"
32,3,12,377,56,59,115,"6 de julio de 1997"
32,3,20,606,206,194,400,"6 de julio de 1997"
32,3,20,607,228,286,514,"6 de julio de 1997"
32,3,20,608,232,262,494,"6 de julio de 1997"
32,3,20,609,248,300,548,"6 de julio de 1997"
32,3,20,610,252,303,555,"6 de julio de 1997"
32,3,20,611,211,272,483,"6 de julio de 1997"
32,3,20,612,231,288,519,"6 de julio de 1997"
32,3,20,613,310,361,671,"6 de julio de 1997"
32,3,20,614,245,271,516,"6 de julio de 1997"
32,3,20,615,256,314,570,"6 de julio de 1997"
32,3,20,616,278,313,591,"6 de julio de 1997"
32,3,20,617,296,324,620,"6 de julio de 1997"
32,3,20,618,244,302,546,"6 de julio de 1997"
32,3,20,619,284,341,625,"6 de julio de 1997"
32,3,20,620,159,180,339,"6 de julio de 1997"
32,3,20,621,193,213,406,"6 de julio de 1997"
32,3,20,622,202,290,492,"6 de julio de 1997"
32,3,20,623,187,231,418,"6 de julio de 1997"
32,3,20,624,263,310,573,"6 de julio de 1997"
32,3,20,625,205,235,440,"6 de julio de 1997"
32,3,20,626,236,263,499,"6 de julio de 1997"
32,3,20,627,315,353,668,"6 de julio de 1997"
32,3,20,628,170,208,378,"6 de julio de 1997"
32,3,20,629,239,277,516,"6 de julio de 1997"
32,3,20,630,264,338,602,"6 de julio de 1997"
32,3,20,631,277,321,598,"6 de julio de 1997"
32,3,20,632,286,356,642,"6 de julio de 1997"
32,3,20,633,302,336,638,"6 de julio de 1997"
32,3,20,634,191,214,405,"6 de julio de 1997"
32,3,20,635,229,247,476,"6 de julio de 1997"
32,3,20,636,168,213,381,"6 de julio de 1997"
32,3,20,637,229,350,579,"6 de julio de 1997"
32,3,20,638,343,426,769,"6 de julio de 1997"
32,3,20,639,190,260,450,"6 de julio de 1997"
32,3,20,640,245,302,547,"6 de julio de 1997"
32,3,20,641,275,334,609,"6 de julio de 1997"
32,3,20,642,231,284,515,"6 de julio de 1997"
32,3,20,643,201,220,421,"6 de julio de 1997"
32,3,20,644,237,289,526,"6 de julio de 1997"
32,3,20,645,249,298,547,"6 de julio de 1997"
32,3,20,646,224,302,526,"6 de julio de 1997"
32,3,20,647,101,139,240,"6 de julio de 1997"
32,3,20,648,239,291,530,"6 de julio de 1997"
32,3,20,649,258,333,591,"6 de julio de 1997"
32,3,20,650,95,105,200,"6 de julio de 1997"
32,3,20,651,130,178,308,"6 de julio de 1997"
32,3,20,652,200,245,445,"6 de julio de 1997"
32,3,20,653,181,254,435,"6 de julio de 1997"
32,3,20,654,170,240,410,"6 de julio de 1997"
32,3,20,655,101,140,241,"6 de julio de 1997"
32,3,20,656,167,218,385,"6 de julio de 1997"
32,3,20,657,205,251,456,"6 de julio de 1997"
32,3,20,658,46,68,114,"6 de julio de 1997"
32,3,20,659,130,108,238,"6 de julio de 1997"
32,3,20,660,64,63,127,"6 de julio de 1997"
32,3,20,661,76,72,148,"6 de julio de 1997"
32,3,20,662,68,81,149,"6 de julio de 1997"
32,3,20,663,152,192,344,"6 de julio de 1997"
32,3,20,664,95,108,203,"6 de julio de 1997"
32,3,20,665,97,111,208,"6 de julio de 1997"
32,3,20,666,86,107,193,"6 de julio de 1997"
32,3,20,667,95,106,201,"6 de julio de 1997"
32,3,20,668,56,59,115,"6 de julio de 1997"
32,3,20,669,96,111,207,"6 de julio de 1997"
32,3,20,670,152,169,321,"6 de julio de 1997"
32,3,20,671,160,177,337,"6 de julio de 1997"
32,3,20,672,181,224,405,"6 de julio de 1997"
32,3,20,673,59,65,124,"6 de julio de 1997"
32,3,20,674,67,67,134,"6 de julio de 1997"
32,3,20,675,157,203,360,"6 de julio de 1997"
32,3,20,676,85,123,208,"6 de julio de 1997"
32,3,20,677,122,136,258,"6 de julio de 1997"
32,3,20,678,63,71,134,"6 de julio de 1997"
32,3,20,679,136,171,307,"6 de julio de 1997"
32,3,20,680,130,155,285,"6 de julio de 1997"
32,3,20,681,58,67,125,"6 de julio de 1997"
32,3,20,682,230,297,527,"6 de julio de 1997"
32,3,20,683,73,84,157,"6 de julio de 1997"
32,3,20,684,100,110,210,"6 de julio de 1997"
32,3,20,685,90,114,204,"6 de julio de 1997"
32,3,20,686,114,144,258,"6 de julio de 1997"
32,3,20,687,104,122,226,"6 de julio de 1997"
32,3,20,688,95,133,228,"6 de julio de 1997"
32,3,20,689,61,66,127,"6 de julio de 1997"
32,3,20,690,90,83,173,"6 de julio de 1997"
32,3,20,691,136,198,334,"6 de julio de 1997"
32,3,20,692,103,124,227,"6 de julio de 1997"
32,3,20,693,49,67,116,"6 de julio de 1997"
32,3,20,694,160,243,403,"6 de julio de 1997"
32,3,20,695,60,96,156,"6 de julio de 1997"
32,3,20,696,47,89,136,"6 de julio de 1997"
32,3,20,697,67,109,176,"6 de julio de 1997"
32,3,20,698,125,127,252,"6 de julio de 1997"
32,3,20,699,87,117,204,"6 de julio de 1997"
32,3,20,700,21,35,56,"6 de julio de 1997"
32,3,20,701,66,71,137,"6 de julio de 1997"
32,3,20,702,25,34,59,"6 de julio de 1997"
32,3,20,703,48,58,106,"6 de julio de 1997"
32,3,20,704,98,142,240,"6 de julio de 1997"
32,3,20,705,43,56,99,"6 de julio de 1997"
32,3,20,706,34,40,74,"6 de julio de 1997"
32,3,20,707,40,46,86,"6 de julio de 1997"
32,3,25,794,322,369,691,"6 de julio de 1997"
32,3,25,795,299,346,645,"6 de julio de 1997"
32,3,25,796,229,265,494,"6 de julio de 1997"
32,3,25,797,276,310,586,"6 de julio de 1997"
32,3,25,798,410,454,864,"6 de julio de 1997"
32,3,25,799,203,219,422,"6 de julio de 1997"
32,3,25,800,277,281,558,"6 de julio de 1997"
32,3,25,801,42,40,82,"6 de julio de 1997"
32,3,25,802,260,286,546,"6 de julio de 1997"
32,3,25,803,236,243,479,"6 de julio de 1997"
32,3,25,804,141,129,270,"6 de julio de 1997"
32,3,25,805,278,296,574,"6 de julio de 1997"
32,3,25,806,148,177,325,"6 de julio de 1997"
32,3,25,807,23,25,48,"6 de julio de 1997"
32,3,32,945,365,389,754,"6 de julio de 1997"
32,3,32,946,404,419,823,"6 de julio de 1997"
32,3,32,947,404,404,808,"6 de julio de 1997"
32,3,32,948,273,273,546,"6 de julio de 1997"
32,3,32,949,254,217,471,"6 de julio de 1997"
32,3,32,950,32,30,62,"6 de julio de 1997"
32,3,32,951,272,279,551,"6 de julio de 1997"
32,3,32,952,508,533,1041,"6 de julio de 1997"
32,3,32,953,275,274,549,"6 de julio de 1997"
32,3,37,1080,279,322,601,"6 de julio de 1997"
32,3,37,1081,257,269,526,"6 de julio de 1997"
32,3,37,1082,357,360,717,"6 de julio de 1997"
32,3,37,1083,53,39,92,"6 de julio de 1997"
32,3,37,1084,216,220,436,"6 de julio de 1997"
32,3,37,1085,95,87,182,"6 de julio de 1997"
32,3,37,1086,393,363,756,"6 de julio de 1997"
32,3,37,1087,438,374,812,"6 de julio de 1997"
32,3,37,1088,362,339,701,"6 de julio de 1997"
32,3,37,1089,397,383,780,"6 de julio de 1997"
32,3,37,1090,437,443,880,"6 de julio de 1997"
32,3,37,1091,308,352,660,"6 de julio de 1997"
32,3,37,1092,114,117,231,"6 de julio de 1997"
32,3,37,1093,147,143,290,"6 de julio de 1997"
32,3,50,1601,262,262,524,"6 de julio de 1997"
32,3,50,1602,245,254,499,"6 de julio de 1997"
32,3,50,1603,376,385,761,"6 de julio de 1997"
32,3,50,1604,245,235,480,"6 de julio de 1997"
32,3,50,1605,78,57,135,"6 de julio de 1997"
32,3,50,1606,353,408,761,"6 de julio de 1997"
32,3,50,1607,288,310,598,"6 de julio de 1997"
32,3,50,1608,412,398,810,"6 de julio de 1997"
32,3,56,1772,335,384,719,"6 de julio de 1997"
32,3,56,1773,435,495,930,"6 de julio de 1997"
32,3,56,1774,372,413,785,"6 de julio de 1997"
32,3,56,1775,413,467,880,"6 de julio de 1997"
32,3,56,1776,261,272,533,"6 de julio de 1997"
32,3,56,1777,316,358,674,"6 de julio de 1997"
32,3,56,1778,391,471,862,"6 de julio de 1997"
32,3,56,1779,377,471,848,"6 de julio de 1997"
32,3,56,1780,325,357,682,"6 de julio de 1997"
32,3,56,1781,268,343,611,"6 de julio de 1997"
32,3,56,1782,273,347,620,"6 de julio de 1997"
32,3,56,1783,360,420,780,"6 de julio de 1997"
32,3,56,1784,266,313,579,"6 de julio de 1997"
32,3,56,1785,353,379,732,"6 de julio de 1997"
32,3,56,1786,223,277,500,"6 de julio de 1997"
32,3,56,1787,202,318,520,"6 de julio de 1997"
32,3,56,1788,270,327,597,"6 de julio de 1997"
32,3,56,1789,408,452,860,"6 de julio de 1997"
32,3,56,1790,342,344,686,"6 de julio de 1997"
32,3,56,1791,401,459,860,"6 de julio de 1997"
32,3,56,1792,429,473,902,"6 de julio de 1997"
32,3,56,1793,384,427,811,"6 de julio de 1997"
32,3,56,1794,227,278,505,"6 de julio de 1997"
32,3,56,1795,272,298,570,"6 de julio de 1997"
32,3,56,1796,190,269,459,"6 de julio de 1997"
32,3,56,1797,243,288,531,"6 de julio de 1997"
32,3,56,1798,311,346,657,"6 de julio de 1997"
32,3,56,1799,304,357,661,"6 de julio de 1997"
32,3,56,1800,285,323,608,"6 de julio de 1997"
32,3,56,1801,430,472,902,"6 de julio de 1997"
32,3,56,1802,198,217,415,"6 de julio de 1997"
32,3,56,1803,310,366,676,"6 de julio de 1997"
32,3,56,1804,361,400,761,"6 de julio de 1997"
32,3,56,1805,297,363,660,"6 de julio de 1997"
32,3,56,1806,356,455,811,"6 de julio de 1997"
32,3,56,1807,279,319,598,"6 de julio de 1997"
32,3,56,1808,166,195,361,"6 de julio de 1997"
32,3,56,1809,346,381,727,"6 de julio de 1997"
32,3,56,1810,371,401,772,"6 de julio de 1997"
32,3,56,1811,322,345,667,"6 de julio de 1997"
32,3,56,1812,310,335,645,"6 de julio de 1997"
32,3,56,1813,331,386,717,"6 de julio de 1997"
32,3,56,1814,130,161,291,"6 de julio de 1997"
32,3,56,1815,193,266,459,"6 de julio de 1997"
32,3,56,1816,187,250,437,"6 de julio de 1997"
32,3,56,1817,299,379,678,"6 de julio de 1997"
32,3,56,1818,491,545,1036,"6 de julio de 1997"
32,3,56,1819,394,427,821,"6 de julio de 1997"
32,3,56,1820,340,403,743,"6 de julio de 1997"
32,3,56,1821,317,375,692,"6 de julio de 1997"
32,3,56,1822,339,369,708,"6 de julio de 1997"
32,3,56,1823,396,431,827,"6 de julio de 1997"
32,3,56,1824,408,477,885,"6 de julio de 1997"
32,3,56,1825,388,448,836,"6 de julio de 1997"
32,3,56,1826,392,456,848,"6 de julio de 1997"
32,3,56,1827,341,369,710,"6 de julio de 1997"
32,3,56,1828,334,405,739,"6 de julio de 1997"
32,3,56,1829,267,343,610,"6 de julio de 1997"
32,3,56,1830,360,401,761,"6 de julio de 1997"
32,3,56,1831,390,484,874,"6 de julio de 1997"
32,3,56,1832,433,466,899,"6 de julio de 1997"
32,3,56,1833,391,419,810,"6 de julio de 1997"
32,3,56,1834,382,439,821,"6 de julio de 1997"
32,3,56,1835,369,419,788,"6 de julio de 1997"
32,3,56,1836,365,455,820,"6 de julio de 1997"
32,3,56,1837,297,370,667,"6 de julio de 1997"
32,3,56,1838,286,337,623,"6 de julio de 1997"
32,3,56,1839,283,379,662,"6 de julio de 1997"
32,3,56,1840,310,365,675,"6 de julio de 1997"
32,3,56,1841,358,397,755,"6 de julio de 1997"
32,3,56,1842,283,317,600,"6 de julio de 1997"
32,3,56,1843,324,381,705,"6 de julio de 1997"
32,3,56,1844,373,381,754,"6 de julio de 1997"
32,3,56,1845,220,267,487,"6 de julio de 1997"
32,3,56,1846,246,271,517,"6 de julio de 1997"
32,3,56,1847,232,313,545,"6 de julio de 1997"
32,3,56,1848,311,320,631,"6 de julio de 1997"
32,3,56,1849,295,323,618,"6 de julio de 1997"
32,3,56,1850,198,262,460,"6 de julio de 1997"
32,3,56,1851,264,314,578,"6 de julio de 1997"
32,3,56,1852,316,356,672,"6 de julio de 1997"
32,3,56,1853,360,409,769,"6 de julio de 1997"
32,3,56,1854,340,379,719,"6 de julio de 1997"
32,3,56,1855,323,373,696,"6 de julio de 1997"
32,3,56,1856,402,453,855,"6 de julio de 1997"
32,3,56,1857,252,281,533,"6 de julio de 1997"
32,3,56,1858,288,321,609,"6 de julio de 1997"
32,3,56,1859,237,262,499,"6 de julio de 1997"
32,3,56,1860,385,399,784,"6 de julio de 1997"
32,3,56,1861,305,366,671,"6 de julio de 1997"
32,3,56,1862,267,319,586,"6 de julio de 1997"
32,3,56,1863,396,434,830,"6 de julio de 1997"
32,3,56,1864,295,373,668,"6 de julio de 1997"
32,3,56,1865,189,210,399,"6 de julio de 1997"
32,3,56,1866,202,236,438,"6 de julio de 1997"
32,3,56,1867,108,130,238,"6 de julio de 1997"
32,3,56,1868,310,346,656,"6 de julio de 1997"
32,3,56,1869,618,663,1281,"6 de julio de 1997"
32,3,56,1870,460,511,971,"6 de julio de 1997"
32,3,56,1871,149,141,290,"6 de julio de 1997"
32,3,56,1872,168,176,344,"6 de julio de 1997"
32,3,56,1873,188,201,389,"6 de julio de 1997"
32,3,56,1874,395,409,804,"6 de julio de 1997"
32,3,56,1875,352,346,698,"6 de julio de 1997"
32,3,56,1876,100,109,209,"6 de julio de 1997"
32,3,56,1877,326,374,700,"6 de julio de 1997"
32,3,56,1878,181,184,365,"6 de julio de 1997"
32,3,56,1879,122,139,261,"6 de julio de 1997"
32,3,56,1880,193,214,407,"6 de julio de 1997"
32,3,56,1881,107,110,217,"6 de julio de 1997"
32,3,56,1882,82,82,164,"6 de julio de 1997"
32,4,16,436,261,296,557,"6 de julio de 1997"
32,4,16,437,301,358,659,"6 de julio de 1997"
32,4,16,438,280,307,587,"6 de julio de 1997"
32,4,16,439,291,338,629,"6 de julio de 1997"
32,4,16,440,175,194,369,"6 de julio de 1997"
32,4,16,441,470,506,976,"6 de julio de 1997"
32,4,16,442,312,368,680,"6 de julio de 1997"
32,4,16,443,126,141,267,"6 de julio de 1997"
32,4,16,444,151,173,324,"6 de julio de 1997"
32,4,16,445,347,342,689,"6 de julio de 1997"
32,4,16,446,227,218,445,"6 de julio de 1997"
32,4,16,447,313,302,615,"6 de julio de 1997"
32,4,16,448,280,274,554,"6 de julio de 1997"
32,4,16,449,201,205,406,"6 de julio de 1997"
32,4,16,450,233,273,506,"6 de julio de 1997"
32,4,16,451,194,203,397,"6 de julio de 1997"
32,4,16,452,283,298,581,"6 de julio de 1997"
32,4,16,453,211,249,460,"6 de julio de 1997"
32,4,16,454,144,164,308,"6 de julio de 1997"
32,4,16,455,223,274,497,"6 de julio de 1997"
32,4,16,456,244,309,553,"6 de julio de 1997"
32,4,16,457,91,101,192,"6 de julio de 1997"
32,4,16,458,132,125,257,"6 de julio de 1997"
32,4,16,459,217,244,461,"6 de julio de 1997"
32,4,17,460,240,284,524,"6 de julio de 1997"
32,4,17,461,254,301,555,"6 de julio de 1997"
32,4,17,462,209,229,438,"6 de julio de 1997"
32,4,17,463,296,361,657,"6 de julio de 1997"
32,4,17,464,342,391,733,"6 de julio de 1997"
32,4,17,465,318,335,653,"6 de julio de 1997"
32,4,17,466,363,440,803,"6 de julio de 1997"
32,4,17,467,409,481,890,"6 de julio de 1997"
32,4,17,468,271,314,585,"6 de julio de 1997"
32,4,17,469,411,452,863,"6 de julio de 1997"
32,4,17,470,583,682,1265,"6 de julio de 1997"
32,4,17,471,491,529,1020,"6 de julio de 1997"
32,4,17,472,425,449,874,"6 de julio de 1997"
32,4,17,473,333,408,741,"6 de julio de 1997"
32,4,17,474,240,233,473,"6 de julio de 1997"
32,4,17,475,345,360,705,"6 de julio de 1997"
32,4,17,476,248,286,534,"6 de julio de 1997"
32,4,17,477,219,262,481,"6 de julio de 1997"
32,4,17,478,225,284,509,"6 de julio de 1997"
32,4,17,479,277,340,617,"6 de julio de 1997"
32,4,17,480,202,262,464,"6 de julio de 1997"
32,4,17,481,199,231,430,"6 de julio de 1997"
32,4,17,482,319,357,676,"6 de julio de 1997"
32,4,17,483,302,342,644,"6 de julio de 1997"
32,4,17,484,305,338,643,"6 de julio de 1997"
32,4,17,485,351,358,709,"6 de julio de 1997"
32,4,17,486,330,370,700,"6 de julio de 1997"
32,4,17,487,381,428,809,"6 de julio de 1997"
32,4,17,488,326,355,681,"6 de julio de 1997"
32,4,17,489,254,272,526,"6 de julio de 1997"
32,4,17,490,312,352,664,"6 de julio de 1997"
32,4,17,491,140,162,302,"6 de julio de 1997"
32,4,17,492,456,522,978,"6 de julio de 1997"
32,4,17,493,418,438,856,"6 de julio de 1997"
32,4,17,494,636,717,1353,"6 de julio de 1997"
32,4,17,495,292,343,635,"6 de julio de 1997"
32,4,17,496,196,241,437,"6 de julio de 1997"
32,4,17,497,121,150,271,"6 de julio de 1997"
32,4,17,498,170,214,384,"6 de julio de 1997"
32,4,17,499,317,374,691,"6 de julio de 1997"
32,4,17,500,261,324,585,"6 de julio de 1997"
32,4,17,501,201,220,421,"6 de julio de 1997"
32,4,17,502,372,400,772,"6 de julio de 1997"
32,4,17,503,308,384,692,"6 de julio de 1997"
32,4,17,504,385,390,775,"6 de julio de 1997"
32,4,17,505,272,281,553,"6 de julio de 1997"
32,4,17,506,334,367,701,"6 de julio de 1997"
32,4,17,507,567,599,1166,"6 de julio de 1997"
32,4,17,508,439,488,927,"6 de julio de 1997"
32,4,17,509,407,432,839,"6 de julio de 1997"
32,4,17,510,346,373,719,"6 de julio de 1997"
32,4,17,511,195,183,378,"6 de julio de 1997"
32,4,17,512,381,438,819,"6 de julio de 1997"
32,4,17,513,219,223,442,"6 de julio de 1997"
32,4,17,514,318,273,591,"6 de julio de 1997"
32,4,17,515,235,252,487,"6 de julio de 1997"
32,4,17,516,192,215,407,"6 de julio de 1997"
32,4,17,517,297,310,607,"6 de julio de 1997"
32,4,17,518,355,353,708,"6 de julio de 1997"
32,4,17,519,364,382,746,"6 de julio de 1997"
32,4,17,520,340,371,711,"6 de julio de 1997"
32,4,17,521,319,308,627,"6 de julio de 1997"
32,4,17,522,388,404,792,"6 de julio de 1997"
32,4,17,523,399,432,831,"6 de julio de 1997"
32,4,17,524,423,467,890,"6 de julio de 1997"
32,4,17,525,110,93,203,"6 de julio de 1997"
32,4,17,526,164,145,309,"6 de julio de 1997"
32,4,17,527,442,456,898,"6 de julio de 1997"
32,4,17,528,413,431,844,"6 de julio de 1997"
32,4,17,529,388,397,785,"6 de julio de 1997"
32,4,17,530,389,398,787,"6 de julio de 1997"
32,4,17,531,423,457,880,"6 de julio de 1997"
32,4,17,532,419,434,853,"6 de julio de 1997"
32,4,17,533,317,318,635,"6 de julio de 1997"
32,4,17,534,218,221,439,"6 de julio de 1997"
32,4,17,535,328,296,624,"6 de julio de 1997"
32,4,17,536,280,277,557,"6 de julio de 1997"
32,4,17,537,296,282,578,"6 de julio de 1997"
32,4,17,538,73,80,153,"6 de julio de 1997"
32,4,17,539,294,291,585,"6 de julio de 1997"
32,4,17,540,211,224,435,"6 de julio de 1997"
32,4,17,541,206,228,434,"6 de julio de 1997"
32,4,17,542,380,455,835,"6 de julio de 1997"
32,4,17,543,362,386,748,"6 de julio de 1997"
32,4,17,544,43,40,83,"6 de julio de 1997"
32,4,17,545,88,97,185,"6 de julio de 1997"
32,4,17,546,78,80,158,"6 de julio de 1997"
32,4,17,547,123,120,243,"6 de julio de 1997"
32,4,17,548,38,36,74,"6 de julio de 1997"
32,4,17,549,40,41,81,"6 de julio de 1997"
32,4,17,550,697,325,1022,"6 de julio de 1997"
32,4,17,551,207,202,409,"6 de julio de 1997"
32,4,24,763,456,457,913,"6 de julio de 1997"
32,4,24,764,406,472,878,"6 de julio de 1997"
32,4,24,765,412,459,871,"6 de julio de 1997"
32,4,24,766,434,446,880,"6 de julio de 1997"
32,4,24,767,318,365,683,"6 de julio de 1997"
32,4,24,768,352,354,706,"6 de julio de 1997"
32,4,24,769,408,420,828,"6 de julio de 1997"
32,4,24,770,164,183,347,"6 de julio de 1997"
32,4,24,771,169,153,322,"6 de julio de 1997"
32,4,24,772,359,391,750,"6 de julio de 1997"
32,4,24,773,337,391,728,"6 de julio de 1997"
32,4,24,774,390,356,746,"6 de julio de 1997"
32,4,24,775,330,353,683,"6 de julio de 1997"
32,4,24,776,199,191,390,"6 de julio de 1997"
32,4,24,777,322,369,691,"6 de julio de 1997"
32,4,24,778,280,300,580,"6 de julio de 1997"
32,4,24,779,291,282,573,"6 de julio de 1997"
32,4,24,780,359,384,743,"6 de julio de 1997"
32,4,24,781,290,264,554,"6 de julio de 1997"
32,4,24,782,300,282,582,"6 de julio de 1997"
32,4,24,783,181,206,387,"6 de julio de 1997"
32,4,24,784,180,201,381,"6 de julio de 1997"
32,4,24,785,203,206,409,"6 de julio de 1997"
32,4,24,786,339,340,679,"6 de julio de 1997"
32,4,24,787,302,267,569,"6 de julio de 1997"
32,4,24,788,305,286,591,"6 de julio de 1997"
32,4,24,789,293,280,573,"6 de julio de 1997"
32,4,24,790,321,325,646,"6 de julio de 1997"
32,4,24,791,245,257,502,"6 de julio de 1997"
32,4,24,792,491,462,953,"6 de julio de 1997"
32,4,24,793,117,106,223,"6 de julio de 1997"
32,4,35,1020,237,246,483,"6 de julio de 1997"
32,4,35,1021,298,289,587,"6 de julio de 1997"
32,4,35,1022,225,239,464,"6 de julio de 1997"
32,4,35,1023,163,174,337,"6 de julio de 1997"
32,4,35,1024,294,310,604,"6 de julio de 1997"
32,4,35,1025,242,280,522,"6 de julio de 1997"
32,4,35,1026,274,330,604,"6 de julio de 1997"
32,4,35,1027,82,115,197,"6 de julio de 1997"
32,4,35,1028,237,259,496,"6 de julio de 1997"
32,4,35,1029,201,207,408,"6 de julio de 1997"
32,4,35,1030,415,427,842,"6 de julio de 1997"
32,4,35,1031,287,320,607,"6 de julio de 1997"
32,4,35,1032,152,154,306,"6 de julio de 1997"
32,4,35,1033,239,230,469,"6 de julio de 1997"
32,4,35,1034,128,106,234,"6 de julio de 1997"
32,4,35,1035,55,56,111,"6 de julio de 1997"
32,4,36,1036,266,307,573,"6 de julio de 1997"
32,4,36,1037,388,394,782,"6 de julio de 1997"
32,4,36,1038,287,343,630,"6 de julio de 1997"
32,4,36,1039,248,279,527,"6 de julio de 1997"
32,4,36,1040,242,309,551,"6 de julio de 1997"
32,4,36,1041,309,344,653,"6 de julio de 1997"
32,4,36,1042,345,362,707,"6 de julio de 1997"
32,4,36,1043,360,413,773,"6 de julio de 1997"
32,4,36,1044,350,417,767,"6 de julio de 1997"
32,4,36,1045,366,390,756,"6 de julio de 1997"
32,4,36,1046,301,335,636,"6 de julio de 1997"
32,4,36,1047,413,442,855,"6 de julio de 1997"
32,4,36,1048,256,263,519,"6 de julio de 1997"
32,4,36,1049,216,237,453,"6 de julio de 1997"
32,4,36,1050,147,144,291,"6 de julio de 1997"
32,4,36,1051,286,282,568,"6 de julio de 1997"
32,4,36,1052,165,185,350,"6 de julio de 1997"
32,4,36,1053,203,208,411,"6 de julio de 1997"
32,4,36,1054,161,164,325,"6 de julio de 1997"
32,4,36,1055,135,143,278,"6 de julio de 1997"
32,4,36,1056,241,263,504,"6 de julio de 1997"
32,4,36,1057,249,275,524,"6 de julio de 1997"
32,4,36,1058,297,298,595,"6 de julio de 1997"
32,4,36,1059,164,170,334,"6 de julio de 1997"
32,4,36,1060,280,279,559,"6 de julio de 1997"
32,4,36,1061,55,53,108,"6 de julio de 1997"
32,4,36,1062,113,102,215,"6 de julio de 1997"
32,4,36,1063,135,148,283,"6 de julio de 1997"
32,4,36,1064,189,209,398,"6 de julio de 1997"
32,4,36,1065,118,119,237,"6 de julio de 1997"
32,4,36,1066,299,319,618,"6 de julio de 1997"
32,4,36,1067,423,415,838,"6 de julio de 1997"
32,4,36,1068,138,182,320,"6 de julio de 1997"
32,4,36,1069,190,222,412,"6 de julio de 1997"
32,4,36,1070,142,156,298,"6 de julio de 1997"
32,4,36,1071,106,112,218,"6 de julio de 1997"
32,4,36,1072,76,85,161,"6 de julio de 1997"
32,4,36,1073,242,256,498,"6 de julio de 1997"
32,4,36,1074,67,57,124,"6 de julio de 1997"
32,4,36,1075,72,67,139,"6 de julio de 1997"
32,4,36,1076,97,89,186,"6 de julio de 1997"
32,4,36,1077,36,35,71,"6 de julio de 1997"
32,4,36,1078,54,51,105,"6 de julio de 1997"
32,4,36,1079,40,40,80,"6 de julio de 1997"
32,4,38,1094,266,278,544,"6 de julio de 1997"
32,4,38,1095,218,230,448,"6 de julio de 1997"
32,4,38,1096,242,267,509,"6 de julio de 1997"
32,4,38,1097,412,424,836,"6 de julio de 1997"
32,4,38,1098,84,91,175,"6 de julio de 1997"
32,4,38,1099,222,214,436,"6 de julio de 1997"
32,4,38,1100,270,310,580,"6 de julio de 1997"
32,4,38,1101,84,86,170,"6 de julio de 1997"
32,4,38,1102,92,97,189,"6 de julio de 1997"
32,4,38,1103,62,58,120,"6 de julio de 1997"
32,4,38,1104,51,49,100,"6 de julio de 1997"
32,4,38,1105,78,51,129,"6 de julio de 1997"
32,4,38,1106,309,276,585,"6 de julio de 1997"
32,4,38,1107,213,200,413,"6 de julio de 1997"
32,4,38,1108,199,195,394,"6 de julio de 1997"
32,4,38,1109,364,381,745,"6 de julio de 1997"
32,4,38,1110,192,191,383,"6 de julio de 1997"
32,4,38,1111,295,268,563,"6 de julio de 1997"
32,4,38,1112,159,137,296,"6 de julio de 1997"
32,4,38,1113,135,128,263,"6 de julio de 1997"
32,4,38,1114,138,140,278,"6 de julio de 1997"
32,4,38,1115,374,401,775,"6 de julio de 1997"
32,4,38,1116,188,183,371,"6 de julio de 1997"
32,4,38,1117,121,107,228,"6 de julio de 1997"
32,4,38,1118,214,296,510,"6 de julio de 1997"
32,4,38,1119,343,247,590,"6 de julio de 1997"
32,4,38,1120,333,345,678,"6 de julio de 1997"
32,4,38,1121,321,370,691,"6 de julio de 1997"
32,4,38,1122,92,75,167,"6 de julio de 1997"
32,4,38,1123,287,325,612,"6 de julio de 1997"
32,4,38,1124,176,164,340,"6 de julio de 1997"
32,4,38,1125,217,220,437,"6 de julio de 1997"
32,4,38,1126,110,120,230,"6 de julio de 1997"
32,4,38,1127,368,376,744,"6 de julio de 1997"
32,4,38,1128,152,149,301,"6 de julio de 1997"
32,4,38,1129,169,155,324,"6 de julio de 1997"
32,4,38,1130,213,215,428,"6 de julio de 1997"
32,4,38,1131,342,329,671,"6 de julio de 1997"
32,4,38,1132,144,158,302,"6 de julio de 1997"
32,4,38,1133,80,92,172,"6 de julio de 1997"
32,4,38,1134,273,283,556,"6 de julio de 1997"
32,4,38,1135,246,237,483,"6 de julio de 1997"
32,4,38,1136,163,176,339,"6 de julio de 1997"
32,4,38,1137,157,178,335,"6 de julio de 1997"
32,4,38,1138,313,301,614,"6 de julio de 1997"
32,4,38,1139,251,270,521,"6 de julio de 1997"
32,4,38,1140,99,90,189,"6 de julio de 1997"
32,4,38,1141,81,70,151,"6 de julio de 1997"
32,4,38,1142,168,166,334,"6 de julio de 1997"
32,4,38,1143,207,249,456,"6 de julio de 1997"
32,4,38,1144,244,304,548,"6 de julio de 1997"
32,4,38,1145,105,120,225,"6 de julio de 1997"
32,4,38,1146,89,98,187,"6 de julio de 1997"
32,4,38,1147,208,255,463,"6 de julio de 1997"
32,4,38,1148,136,138,274,"6 de julio de 1997"
32,4,38,1149,132,106,238,"6 de julio de 1997"
32,4,38,1150,143,181,324,"6 de julio de 1997"
32,4,38,1151,221,252,473,"6 de julio de 1997"
32,4,38,1152,237,302,539,"6 de julio de 1997"
32,4,38,1153,99,122,221,"6 de julio de 1997"
32,4,38,1154,152,178,330,"6 de julio de 1997"
32,4,38,1155,218,210,428,"6 de julio de 1997"
32,4,38,1156,57,43,100,"6 de julio de 1997"
32,4,38,1157,114,110,224,"6 de julio de 1997"
32,4,38,1158,79,73,152,"6 de julio de 1997"
32,4,38,1159,239,252,491,"6 de julio de 1997"
32,4,38,1160,114,129,243,"6 de julio de 1997"
32,4,38,1161,86,89,175,"6 de julio de 1997"
32,4,38,1162,77,91,168,"6 de julio de 1997"
32,4,38,1163,61,63,124,"6 de julio de 1997"
32,4,38,1164,147,121,268,"6 de julio de 1997"
32,4,38,1165,94,88,182,"6 de julio de 1997"
32,4,38,1166,72,65,137,"6 de julio de 1997"
32,4,38,1167,55,63,118,"6 de julio de 1997"
32,4,38,1168,25,25,50,"6 de julio de 1997"
32,4,38,1169,212,195,407,"6 de julio de 1997"
32,4,38,1170,70,72,142,"6 de julio de 1997"
32,4,38,1171,150,168,318,"6 de julio de 1997"
32,4,38,1172,78,71,149,"6 de julio de 1997"
32,4,38,1173,42,40,82,"6 de julio de 1997"
32,4,38,1174,90,96,186,"6 de julio de 1997"
32,4,38,1175,77,68,145,"6 de julio de 1997"
32,4,38,1176,119,105,224,"6 de julio de 1997"
32,4,38,1177,68,74,142,"6 de julio de 1997"
32,4,38,1178,60,78,138,"6 de julio de 1997"
32,4,38,1179,90,91,181,"6 de julio de 1997"
32,4,38,1180,117,101,218,"6 de julio de 1997"
32,4,38,1181,66,70,136,"6 de julio de 1997"
32,4,38,1182,97,85,182,"6 de julio de 1997"
32,4,38,1183,70,64,134,"6 de julio de 1997"
32,4,38,1184,38,43,81,"6 de julio de 1997"
32,4,38,1185,65,54,119,"6 de julio de 1997"
32,4,38,1186,94,82,176,"6 de julio de 1997"
32,4,38,1187,65,55,120,"6 de julio de 1997"
32,4,38,1188,68,59,127,"6 de julio de 1997"
32,4,38,1189,43,46,89,"6 de julio de 1997"
32,4,38,1190,122,126,248,"6 de julio de 1997"
32,4,38,1191,69,73,142,"6 de julio de 1997"
32,4,52,1659,457,460,917,"6 de julio de 1997"
32,4,52,1660,343,387,730,"6 de julio de 1997"
32,4,52,1661,393,414,807,"6 de julio de 1997"
32,4,52,1662,418,419,837,"6 de julio de 1997"
32,4,52,1663,154,123,277,"6 de julio de 1997"
32,4,52,1664,232,208,440,"6 de julio de 1997"
32,4,52,1665,237,207,444,"6 de julio de 1997"
32,4,52,1666,146,165,311,"6 de julio de 1997"
32,4,52,1667,232,225,457,"6 de julio de 1997"
32,4,52,1668,306,297,603,"6 de julio de 1997"
32,4,52,1669,128,115,243,"6 de julio de 1997"
32,4,52,1670,168,159,327,"6 de julio de 1997"
32,4,52,1671,307,289,596,"6 de julio de 1997"
32,4,52,1672,85,72,157,"6 de julio de 1997"
32,4,52,1673,253,272,525,"6 de julio de 1997"
32,4,52,1674,54,53,107,"6 de julio de 1997"
32,4,53,1675,286,361,647,"6 de julio de 1997"
32,4,53,1676,298,307,605,"6 de julio de 1997"
32,4,53,1677,327,357,684,"6 de julio de 1997"
32,4,53,1678,329,338,667,"6 de julio de 1997"
32,4,53,1679,195,221,416,"6 de julio de 1997"
32,4,53,1680,355,359,714,"6 de julio de 1997"
32,4,53,1681,249,263,512,"6 de julio de 1997"
32,4,53,1682,125,128,253,"6 de julio de 1997"
32,4,53,1683,181,266,447,"6 de julio de 1997"
32,4,53,1684,141,202,343,"6 de julio de 1997"
32,4,53,1685,160,228,388,"6 de julio de 1997"
32,4,53,1686,197,280,477,"6 de julio de 1997"
32,4,54,1687,376,427,803,"6 de julio de 1997"
32,4,54,1688,375,376,751,"6 de julio de 1997"
32,4,54,1689,317,286,603,"6 de julio de 1997"
32,4,54,1690,146,143,289,"6 de julio de 1997"
32,4,54,1691,258,262,520,"6 de julio de 1997"
32,4,54,1692,131,153,284,"6 de julio de 1997"
32,4,54,1693,208,238,446,"6 de julio de 1997"
32,4,54,1694,144,132,276,"6 de julio de 1997"
32,4,54,1695,187,175,362,"6 de julio de 1997"
32,4,54,1696,172,159,331,"6 de julio de 1997"
32,4,54,1697,176,149,325,"6 de julio de 1997"
32,4,54,1698,86,85,171,"6 de julio de 1997"
32,4,54,1699,306,271,577,"6 de julio de 1997"
32,4,54,1700,361,397,758,"6 de julio de 1997"
32,4,54,1701,100,102,202,"6 de julio de 1997"
32,4,54,1702,105,94,199,"6 de julio de 1997"
32,4,54,1703,75,72,147,"6 de julio de 1997"
32,4,54,1704,37,43,80,"6 de julio de 1997"
32,4,54,1705,56,56,112,"6 de julio de 1997"
32,4,54,1706,27,22,49,"6 de julio de 1997"
32,4,54,1707,74,61,135,"6 de julio de 1997"
32,4,54,1708,110,101,211,"6 de julio de 1997"
32,4,54,1709,106,87,193,"6 de julio de 1997"
32,4,54,1710,168,150,318,"6 de julio de 1997"
32,5,1,1,175,181,356,"6 de julio de 1997"
32,5,1,2,250,318,568,"6 de julio de 1997"
32,5,1,3,262,307,569,"6 de julio de 1997"
32,5,1,4,176,176,352,"6 de julio de 1997"
32,5,1,5,150,176,326,"6 de julio de 1997"
32,5,1,6,275,328,603,"6 de julio de 1997"
32,5,1,7,142,134,276,"6 de julio de 1997"
32,5,1,8,214,271,485,"6 de julio de 1997"
32,5,1,9,74,90,164,"6 de julio de 1997"
32,5,1,10,109,136,245,"6 de julio de 1997"
32,5,1,11,49,65,114,"6 de julio de 1997"
32,5,1,12,55,83,138,"6 de julio de 1997"
32,5,1,13,189,229,418,"6 de julio de 1997"
32,5,2,14,197,247,444,"6 de julio de 1997"
32,5,2,15,224,281,505,"6 de julio de 1997"
32,5,2,16,78,108,186,"6 de julio de 1997"
32,5,2,17,266,278,544,"6 de julio de 1997"
32,5,2,18,206,236,442,"6 de julio de 1997"
32,5,2,19,119,154,273,"6 de julio de 1997"
32,5,2,20,147,184,331,"6 de julio de 1997"
32,5,2,21,64,82,146,"6 de julio de 1997"
32,5,3,22,176,224,400,"6 de julio de 1997"
32,5,3,23,164,180,344,"6 de julio de 1997"
32,5,3,24,160,212,372,"6 de julio de 1997"
32,5,3,25,78,96,174,"6 de julio de 1997"
32,5,3,26,130,185,315,"6 de julio de 1997"
32,5,3,27,109,152,261,"6 de julio de 1997"
32,5,3,28,61,74,135,"6 de julio de 1997"
32,5,3,29,61,85,146,"6 de julio de 1997"
32,5,3,30,52,73,125,"6 de julio de 1997"
32,5,4,31,173,200,373,"6 de julio de 1997"
32,5,4,32,158,204,362,"6 de julio de 1997"
32,5,4,33,95,114,209,"6 de julio de 1997"
32,5,4,34,160,166,326,"6 de julio de 1997"
32,5,4,35,199,215,414,"6 de julio de 1997"
32,5,4,36,110,135,245,"6 de julio de 1997"
32,5,4,37,103,115,218,"6 de julio de 1997"
32,5,4,38,138,177,315,"6 de julio de 1997"
32,5,4,39,62,56,118,"6 de julio de 1997"
32,5,11,349,137,181,318,"6 de julio de 1997"
32,5,11,350,180,200,380,"6 de julio de 1997"
32,5,11,351,132,154,286,"6 de julio de 1997"
32,5,11,352,141,190,331,"6 de julio de 1997"
32,5,11,353,104,151,255,"6 de julio de 1997"
32,5,11,354,83,84,167,"6 de julio de 1997"
32,5,11,355,47,62,109,"6 de julio de 1997"
32,5,11,356,141,146,287,"6 de julio de 1997"
32,5,11,357,15,15,30,"6 de julio de 1997"
32,5,11,358,31,40,71,"6 de julio de 1997"
32,5,15,428,239,255,494,"6 de julio de 1997"
32,5,15,429,122,154,276,"6 de julio de 1997"
32,5,15,430,133,161,294,"6 de julio de 1997"
32,5,15,431,40,51,91,"6 de julio de 1997"
32,5,15,432,43,59,102,"6 de julio de 1997"
32,5,15,433,58,69,127,"6 de julio de 1997"
32,5,15,434,39,49,88,"6 de julio de 1997"
32,5,15,435,63,72,135,"6 de julio de 1997"
32,5,18,552,297,356,653,"6 de julio de 1997"
32,5,18,553,79,86,165,"6 de julio de 1997"
32,5,18,554,221,235,456,"6 de julio de 1997"
32,5,18,555,111,107,218,"6 de julio de 1997"
32,5,18,556,91,99,190,"6 de julio de 1997"
32,5,18,557,107,115,222,"6 de julio de 1997"
32,5,18,558,102,155,257,"6 de julio de 1997"
32,5,18,559,127,213,340,"6 de julio de 1997"
32,5,18,560,134,186,320,"6 de julio de 1997"
32,5,18,561,33,48,81,"6 de julio de 1997"
32,5,18,562,29,42,71,"6 de julio de 1997"
32,5,18,563,57,80,137,"6 de julio de 1997"
32,5,18,564,65,91,156,"6 de julio de 1997"
32,5,18,565,66,78,144,"6 de julio de 1997"
32,5,19,566,127,161,288,"6 de julio de 1997"
32,5,19,567,289,335,624,"6 de julio de 1997"
32,5,19,568,305,364,669,"6 de julio de 1997"
32,5,19,569,300,372,672,"6 de julio de 1997"
32,5,19,570,275,330,605,"6 de julio de 1997"
32,5,19,571,225,278,503,"6 de julio de 1997"
32,5,19,572,361,458,819,"6 de julio de 1997"
32,5,19,573,273,336,609,"6 de julio de 1997"
32,5,19,574,256,289,545,"6 de julio de 1997"
32,5,19,575,239,302,541,"6 de julio de 1997"
32,5,19,576,229,232,461,"6 de julio de 1997"
32,5,19,577,177,204,381,"6 de julio de 1997"
32,5,19,578,303,330,633,"6 de julio de 1997"
32,5,19,579,273,372,645,"6 de julio de 1997"
32,5,19,580,154,150,304,"6 de julio de 1997"
32,5,19,581,163,205,368,"6 de julio de 1997"
32,5,19,582,178,186,364,"6 de julio de 1997"
32,5,19,583,289,331,620,"6 de julio de 1997"
32,5,19,584,95,94,189,"6 de julio de 1997"
32,5,19,585,46,50,96,"6 de julio de 1997"
32,5,19,586,234,323,557,"6 de julio de 1997"
32,5,19,587,213,262,475,"6 de julio de 1997"
32,5,19,588,77,67,144,"6 de julio de 1997"
32,5,19,589,210,222,432,"6 de julio de 1997"
32,5,19,590,90,122,212,"6 de julio de 1997"
32,5,19,591,111,119,230,"6 de julio de 1997"
32,5,19,592,72,68,140,"6 de julio de 1997"
32,5,19,593,176,213,389,"6 de julio de 1997"
32,5,19,594,110,137,247,"6 de julio de 1997"
32,5,19,595,34,43,77,"6 de julio de 1997"
32,5,19,596,140,182,322,"6 de julio de 1997"
32,5,19,597,73,103,176,"6 de julio de 1997"
32,5,19,598,46,54,100,"6 de julio de 1997"
32,5,19,599,124,130,254,"6 de julio de 1997"
32,5,19,600,49,67,116,"6 de julio de 1997"
32,5,19,601,100,122,222,"6 de julio de 1997"
32,5,19,602,45,47,92,"6 de julio de 1997"
32,5,19,603,74,119,193,"6 de julio de 1997"
32,5,19,604,147,147,294,"6 de julio de 1997"
32,5,19,605,94,119,213,"6 de julio de 1997"
32,5,23,742,446,531,977,"6 de julio de 1997"
32,5,23,743,317,356,673,"6 de julio de 1997"
32,5,23,744,388,450,838,"6 de julio de 1997"
32,5,23,745,277,336,613,"6 de julio de 1997"
32,5,23,746,190,241,431,"6 de julio de 1997"
32,5,23,747,223,245,468,"6 de julio de 1997"
32,5,23,748,311,330,641,"6 de julio de 1997"
32,5,23,749,271,323,594,"6 de julio de 1997"
32,5,23,750,160,202,362,"6 de julio de 1997"
32,5,23,751,93,104,197,"6 de julio de 1997"
32,5,23,752,235,291,526,"6 de julio de 1997"
32,5,23,753,200,218,418,"6 de julio de 1997"
32,5,23,754,81,119,200,"6 de julio de 1997"
32,5,23,755,111,114,225,"6 de julio de 1997"
32,5,23,756,313,367,680,"6 de julio de 1997"
32,5,23,757,105,118,223,"6 de julio de 1997"
32,5,23,758,137,154,291,"6 de julio de 1997"
32,5,23,759,55,77,132,"6 de julio de 1997"
32,5,23,760,44,73,117,"6 de julio de 1997"
32,5,23,761,49,59,108,"6 de julio de 1997"
32,5,23,762,77,84,161,"6 de julio de 1997"
32,5,28,876,235,235,470,"6 de julio de 1997"
32,5,28,877,316,331,647,"6 de julio de 1997"
32,5,28,878,112,134,246,"6 de julio de 1997"
32,5,28,879,58,46,104,"6 de julio de 1997"
32,5,28,880,68,76,144,"6 de julio de 1997"
32,5,28,881,46,62,108,"6 de julio de 1997"
32,5,28,882,51,53,104,"6 de julio de 1997"
32,5,28,883,90,86,176,"6 de julio de 1997"
32,5,30,906,100,145,245,"6 de julio de 1997"
32,5,30,907,152,188,340,"6 de julio de 1997"
32,5,30,908,275,340,615,"6 de julio de 1997"
32,5,30,909,79,110,189,"6 de julio de 1997"
32,5,30,910,45,59,104,"6 de julio de 1997"
32,5,30,911,108,136,244,"6 de julio de 1997"
32,5,30,912,30,31,61,"6 de julio de 1997"
32,5,30,913,83,103,186,"6 de julio de 1997"
32,5,31,914,195,244,439,"6 de julio de 1997"
32,5,31,915,197,245,442,"6 de julio de 1997"
32,5,31,916,163,195,358,"6 de julio de 1997"
32,5,31,917,158,200,358,"6 de julio de 1997"
32,5,31,918,248,353,601,"6 de julio de 1997"
32,5,31,919,139,155,294,"6 de julio de 1997"
32,5,31,920,17,14,31,"6 de julio de 1997"
32,5,31,921,72,106,178,"6 de julio de 1997"
32,5,31,922,50,45,95,"6 de julio de 1997"
32,5,31,923,159,197,356,"6 de julio de 1997"
32,5,31,924,56,76,132,"6 de julio de 1997"
32,5,31,925,74,84,158,"6 de julio de 1997"
32,5,31,926,85,111,196,"6 de julio de 1997"
32,5,31,927,218,238,456,"6 de julio de 1997"
32,5,31,928,135,164,299,"6 de julio de 1997"
32,5,31,929,82,98,180,"6 de julio de 1997"
32,5,31,930,33,29,62,"6 de julio de 1997"
32,5,31,931,85,98,183,"6 de julio de 1997"
32,5,31,932,48,61,109,"6 de julio de 1997"
32,5,31,933,159,218,377,"6 de julio de 1997"
32,5,31,934,50,40,90,"6 de julio de 1997"
32,5,31,935,47,35,82,"6 de julio de 1997"
32,5,31,936,52,55,107,"6 de julio de 1997"
32,5,31,937,17,24,41,"6 de julio de 1997"
32,5,31,938,34,48,82,"6 de julio de 1997"
32,5,31,939,34,56,90,"6 de julio de 1997"
32,5,31,940,77,100,177,"6 de julio de 1997"
32,5,31,941,44,50,94,"6 de julio de 1997"
32,5,31,942,17,20,37,"6 de julio de 1997"
32,5,31,943,51,58,109,"6 de julio de 1997"
32,5,31,944,29,39,68,"6 de julio de 1997"
32,5,33,954,224,253,477,"6 de julio de 1997"
32,5,33,955,134,154,288,"6 de julio de 1997"
32,5,33,956,253,291,544,"6 de julio de 1997"
32,5,33,957,209,255,464,"6 de julio de 1997"
32,5,33,958,254,286,540,"6 de julio de 1997"
32,5,33,959,58,102,160,"6 de julio de 1997"
32,5,33,960,98,112,210,"6 de julio de 1997"
32,5,33,961,200,240,440,"6 de julio de 1997"
32,5,33,962,113,126,239,"6 de julio de 1997"
32,5,33,963,147,178,325,"6 de julio de 1997"
32,5,33,964,174,212,386,"6 de julio de 1997"
32,5,34,965,286,374,660,"6 de julio de 1997"
32,5,34,966,356,456,812,"6 de julio de 1997"
32,5,34,967,307,368,675,"6 de julio de 1997"
32,5,34,968,375,500,875,"6 de julio de 1997"
32,5,34,969,272,371,643,"6 de julio de 1997"
32,5,34,970,280,386,666,"6 de julio de 1997"
32,5,34,971,317,385,702,"6 de julio de 1997"
32,5,34,972,298,359,657,"6 de julio de 1997"
32,5,34,973,323,429,752,"6 de julio de 1997"
32,5,34,974,226,310,536,"6 de julio de 1997"
32,5,34,975,133,167,300,"6 de julio de 1997"
32,5,34,976,339,391,730,"6 de julio de 1997"
32,5,34,977,293,360,653,"6 de julio de 1997"
32,5,34,978,265,302,567,"6 de julio de 1997"
32,5,34,979,276,337,613,"6 de julio de 1997"
32,5,34,980,151,182,333,"6 de julio de 1997"
32,5,34,981,48,81,129,"6 de julio de 1997"
32,5,34,982,299,467,766,"6 de julio de 1997"
32,5,34,983,245,313,558,"6 de julio de 1997"
32,5,34,984,61,78,139,"6 de julio de 1997"
32,5,34,985,32,50,82,"6 de julio de 1997"
32,5,34,986,71,120,191,"6 de julio de 1997"
32,5,34,987,93,148,241,"6 de julio de 1997"
32,5,34,988,47,78,125,"6 de julio de 1997"
32,5,34,989,50,78,128,"6 de julio de 1997"
32,5,34,990,75,113,188,"6 de julio de 1997"
32,5,34,991,46,64,110,"6 de julio de 1997"
32,5,34,992,56,71,127,"6 de julio de 1997"
32,5,34,993,127,171,298,"6 de julio de 1997"
32,5,34,994,65,106,171,"6 de julio de 1997"
32,5,34,995,172,235,407,"6 de julio de 1997"
32,5,34,996,105,139,244,"6 de julio de 1997"
32,5,34,997,161,229,390,"6 de julio de 1997"
32,5,34,998,62,71,133,"6 de julio de 1997"
32,5,34,999,215,274,489,"6 de julio de 1997"
32,5,34,1000,126,160,286,"6 de julio de 1997"
32,5,34,1001,91,116,207,"6 de julio de 1997"
32,5,34,1002,208,221,429,"6 de julio de 1997"
32,5,34,1003,144,175,319,"6 de julio de 1997"
32,5,34,1004,71,96,167,"6 de julio de 1997"
32,5,34,1005,80,122,202,"6 de julio de 1997"
32,5,34,1006,47,73,120,"6 de julio de 1997"
32,5,34,1007,103,154,257,"6 de julio de 1997"
32,5,34,1008,118,124,242,"6 de julio de 1997"
32,5,34,1009,24,43,67,"6 de julio de 1997"
32,5,34,1010,45,63,108,"6 de julio de 1997"
32,5,34,1011,68,115,183,"6 de julio de 1997"
32,5,34,1012,119,148,267,"6 de julio de 1997"
32,5,34,1013,46,56,102,"6 de julio de 1997"
32,5,34,1014,69,97,166,"6 de julio de 1997"
32,5,34,1015,33,55,88,"6 de julio de 1997"
32,5,34,1016,75,106,181,"6 de julio de 1997"
32,5,34,1017,19,32,51,"6 de julio de 1997"
32,5,34,1018,79,100,179,"6 de julio de 1997"
32,5,34,1019,81,116,197,"6 de julio de 1997"
32,5,43,1384,129,159,288,"6 de julio de 1997"
32,5,43,1385,146,205,351,"6 de julio de 1997"
32,5,43,1386,24,42,66,"6 de julio de 1997"
32,5,43,1387,76,100,176,"6 de julio de 1997"
32,5,44,1388,112,132,244,"6 de julio de 1997"
32,5,44,1389,416,475,891,"6 de julio de 1997"
32,5,44,1390,258,329,587,"6 de julio de 1997"
32,5,44,1391,270,330,600,"6 de julio de 1997"
32,5,44,1392,321,372,693,"6 de julio de 1997"
32,5,44,1393,149,194,343,"6 de julio de 1997"
32,5,44,1394,125,149,274,"6 de julio de 1997"
32,5,44,1395,166,199,365,"6 de julio de 1997"
32,5,44,1396,502,583,1085,"6 de julio de 1997"
32,5,44,1397,233,274,507,"6 de julio de 1997"
32,5,44,1398,141,145,286,"6 de julio de 1997"
32,5,44,1399,109,141,250,"6 de julio de 1997"
32,5,44,1400,161,198,359,"6 de julio de 1997"
32,5,44,1401,195,187,382,"6 de julio de 1997"
32,5,44,1402,183,229,412,"6 de julio de 1997"
32,5,44,1403,150,185,335,"6 de julio de 1997"
32,5,44,1404,71,69,140,"6 de julio de 1997"
32,5,44,1405,90,91,181,"6 de julio de 1997"
32,5,44,1406,48,54,102,"6 de julio de 1997"
32,5,44,1407,62,80,142,"6 de julio de 1997"
32,5,44,1408,68,75,143,"6 de julio de 1997"
32,5,44,1409,118,147,265,"6 de julio de 1997"
32,5,44,1410,32,40,72,"6 de julio de 1997"
32,5,44,1411,120,129,249,"6 de julio de 1997"
32,5,45,1412,104,144,248,"6 de julio de 1997"
32,5,45,1413,139,176,315,"6 de julio de 1997"
32,5,45,1414,190,204,394,"6 de julio de 1997"
32,5,45,1415,156,179,335,"6 de julio de 1997"
32,5,45,1416,184,201,385,"6 de julio de 1997"
32,5,45,1417,208,309,517,"6 de julio de 1997"
32,5,45,1418,147,185,332,"6 de julio de 1997"
32,5,45,1419,124,145,269,"6 de julio de 1997"
32,5,45,1420,136,160,296,"6 de julio de 1997"
32,5,45,1421,78,93,171,"6 de julio de 1997"
32,5,45,1422,124,131,255,"6 de julio de 1997"
32,5,45,1423,175,235,410,"6 de julio de 1997"
32,5,45,1424,64,68,132,"6 de julio de 1997"
32,5,45,1425,69,91,160,"6 de julio de 1997"
32,5,45,1426,35,43,78,"6 de julio de 1997"
32,5,45,1427,114,144,258,"6 de julio de 1997"
32,5,45,1428,61,67,128,"6 de julio de 1997"
32,5,45,1429,65,61,126,"6 de julio de 1997"
32,5,45,1430,264,336,600,"6 de julio de 1997"
32,5,45,1431,65,72,137,"6 de julio de 1997"
32,5,45,1432,86,94,180,"6 de julio de 1997"
32,5,46,1433,132,160,292,"6 de julio de 1997"
32,5,46,1434,208,248,456,"6 de julio de 1997"
32,5,46,1435,165,198,363,"6 de julio de 1997"
32,5,46,1436,93,109,202,"6 de julio de 1997"
32,5,46,1437,64,85,149,"6 de julio de 1997"
32,5,46,1438,52,68,120,"6 de julio de 1997"
32,5,46,1439,125,136,261,"6 de julio de 1997"
32,5,46,1440,59,62,121,"6 de julio de 1997"
32,5,46,1441,29,41,70,"6 de julio de 1997"
32,5,46,1442,208,277,485,"6 de julio de 1997"
32,5,46,1443,108,138,246,"6 de julio de 1997"
32,5,46,1444,127,124,251,"6 de julio de 1997"
32,5,46,1445,48,70,118,"6 de julio de 1997"
32,5,46,1446,46,72,118,"6 de julio de 1997"
32,5,46,1447,111,184,295,"6 de julio de 1997"
32,5,46,1448,66,71,137,"6 de julio de 1997"
32,5,46,1449,34,43,77,"6 de julio de 1997"
32,5,46,1450,109,129,238,"6 de julio de 1997"
32,5,46,1451,32,49,81,"6 de julio de 1997"
32,5,46,1452,216,255,471,"6 de julio de 1997"
32,5,46,1453,38,44,82,"6 de julio de 1997"
32,5,46,1454,87,107,194,"6 de julio de 1997"
32,5,46,1455,208,280,488,"6 de julio de 1997"
32,5,46,1456,42,49,91,"6 de julio de 1997"
32,5,46,1457,42,50,92,"6 de julio de 1997"
32,5,46,1458,45,60,105,"6 de julio de 1997"
32,5,46,1459,32,45,77,"6 de julio de 1997"
32,5,46,1460,71,81,152,"6 de julio de 1997"
32,5,46,1461,44,47,91,"6 de julio de 1997"
32,5,46,1462,48,65,113,"6 de julio de 1997"
32,5,46,1463,52,75,127,"6 de julio de 1997"
32,5,46,1464,31,46,77,"6 de julio de 1997"
32,5,47,1465,296,339,635,"6 de julio de 1997"
32,5,47,1466,155,220,375,"6 de julio de 1997"
32,5,47,1467,274,303,577,"6 de julio de 1997"
32,5,47,1468,276,290,566,"6 de julio de 1997"
32,5,47,1469,35,36,71,"6 de julio de 1997"
32,5,47,1470,163,192,355,"6 de julio de 1997"
32,5,47,1471,198,236,434,"6 de julio de 1997"
32,5,47,1472,120,132,252,"6 de julio de 1997"
32,5,47,1473,105,123,228,"6 de julio de 1997"
32,5,47,1474,80,96,176,"6 de julio de 1997"
32,5,47,1475,123,142,265,"6 de julio de 1997"
32,5,47,1476,150,149,299,"6 de julio de 1997"
32,5,47,1477,37,32,69,"6 de julio de 1997"
32,5,47,1478,164,175,339,"6 de julio de 1997"
32,5,47,1479,82,64,146,"6 de julio de 1997"
32,5,47,1480,101,127,228,"6 de julio de 1997"
32,5,47,1481,124,126,250,"6 de julio de 1997"
32,5,47,1482,93,98,191,"6 de julio de 1997"
32,5,47,1483,84,92,176,"6 de julio de 1997"
32,5,47,1484,67,65,132,"6 de julio de 1997"
32,5,48,1485,171,202,373,"6 de julio de 1997"
32,5,48,1486,277,329,606,"6 de julio de 1997"
32,5,48,1487,252,333,585,"6 de julio de 1997"
32,5,48,1488,108,138,246,"6 de julio de 1997"
32,5,48,1489,209,256,465,"6 de julio de 1997"
32,5,48,1490,214,273,487,"6 de julio de 1997"
32,5,48,1491,249,276,525,"6 de julio de 1997"
32,5,48,1492,281,343,624,"6 de julio de 1997"
32,5,48,1493,276,335,611,"6 de julio de 1997"
32,5,48,1494,167,243,410,"6 de julio de 1997"
32,5,48,1495,280,351,631,"6 de julio de 1997"
32,5,48,1496,233,281,514,"6 de julio de 1997"
32,5,48,1497,317,324,641,"6 de julio de 1997"
32,5,48,1498,742,276,1018,"6 de julio de 1997"
32,5,48,1499,93,125,218,"6 de julio de 1997"
32,5,48,1500,60,77,137,"6 de julio de 1997"
32,5,48,1501,124,155,279,"6 de julio de 1997"
32,5,48,1502,161,161,322,"6 de julio de 1997"
32,5,48,1503,80,79,159,"6 de julio de 1997"
32,5,48,1504,98,93,191,"6 de julio de 1997"
32,5,48,1505,92,104,196,"6 de julio de 1997"
32,5,48,1506,123,186,309,"6 de julio de 1997"
32,5,48,1507,128,132,260,"6 de julio de 1997"
32,5,48,1508,100,120,220,"6 de julio de 1997"
32,5,48,1509,63,64,127,"6 de julio de 1997"
32,5,48,1510,179,213,392,"6 de julio de 1997"
32,5,48,1511,250,299,549,"6 de julio de 1997"
32,5,48,1512,51,44,95,"6 de julio de 1997"
32,5,48,1513,112,131,243,"6 de julio de 1997"
32,5,48,1514,115,138,253,"6 de julio de 1997"
32,5,48,1515,61,64,125,"6 de julio de 1997"
32,5,48,1516,47,72,119,"6 de julio de 1997"
32,5,48,1517,39,56,95,"6 de julio de 1997"
32,5,48,1518,66,82,148,"6 de julio de 1997"
32,5,48,1519,103,83,186,"6 de julio de 1997"
32,5,48,1520,63,54,117,"6 de julio de 1997"
32,5,48,1521,79,61,140,"6 de julio de 1997"
32,5,48,1522,97,100,197,"6 de julio de 1997"
32,5,48,1523,51,62,113,"6 de julio de 1997"
32,5,48,1524,80,69,149,"6 de julio de 1997"
32,5,55,1711,323,364,687,"6 de julio de 1997"
32,5,55,1712,218,261,479,"6 de julio de 1997"
32,5,55,1713,209,280,489,"6 de julio de 1997"
32,5,55,1714,165,203,368,"6 de julio de 1997"
32,5,55,1715,235,297,532,"6 de julio de 1997"
32,5,55,1716,302,390,692,"6 de julio de 1997"
32,5,55,1717,236,304,540,"6 de julio de 1997"
32,5,55,1718,262,320,582,"6 de julio de 1997"
32,5,55,1719,268,326,594,"6 de julio de 1997"
32,5,55,1720,191,241,432,"6 de julio de 1997"
32,5,55,1721,92,107,199,"6 de julio de 1997"
32,5,55,1722,151,196,347,"6 de julio de 1997"
32,5,55,1723,208,236,444,"6 de julio de 1997"
32,5,55,1724,274,330,604,"6 de julio de 1997"
32,5,55,1725,263,314,577,"6 de julio de 1997"
32,5,55,1726,245,325,570,"6 de julio de 1997"
32,5,55,1727,235,320,555,"6 de julio de 1997"
32,5,55,1728,230,270,500,"6 de julio de 1997"
32,5,55,1729,38,53,91,"6 de julio de 1997"
32,5,55,1730,187,218,405,"6 de julio de 1997"
32,5,55,1731,143,156,299,"6 de julio de 1997"
32,5,55,1732,79,91,170,"6 de julio de 1997"
32,5,55,1733,84,105,189,"6 de julio de 1997"
32,5,55,1734,375,388,763,"6 de julio de 1997"
32,5,55,1735,86,108,194,"6 de julio de 1997"
32,5,55,1736,163,255,418,"6 de julio de 1997"
32,5,55,1737,160,250,410,"6 de julio de 1997"
32,5,55,1738,210,240,450,"6 de julio de 1997"
32,5,55,1739,260,326,586,"6 de julio de 1997"
32,5,55,1740,290,397,687,"6 de julio de 1997"
32,5,55,1741,43,58,101,"6 de julio de 1997"
32,5,55,1742,97,97,194,"6 de julio de 1997"
32,5,55,1743,87,123,210,"6 de julio de 1997"
32,5,55,1744,179,185,364,"6 de julio de 1997"
32,5,55,1745,229,222,451,"6 de julio de 1997"
32,5,55,1746,87,102,189,"6 de julio de 1997"
32,5,55,1747,54,82,136,"6 de julio de 1997"
32,5,55,1748,191,221,412,"6 de julio de 1997"
32,5,55,1749,242,326,568,"6 de julio de 1997"
32,5,55,1750,135,132,267,"6 de julio de 1997"
32,5,55,1751,109,117,226,"6 de julio de 1997"
32,5,55,1752,63,63,126,"6 de julio de 1997"
32,5,55,1753,116,145,261,"6 de julio de 1997"
32,5,55,1754,27,24,51,"6 de julio de 1997"
32,5,55,1755,128,162,290,"6 de julio de 1997"
32,5,55,1756,48,62,110,"6 de julio de 1997"
32,5,55,1757,76,100,176,"6 de julio de 1997"
32,5,55,1758,112,124,236,"6 de julio de 1997"
32,5,55,1759,145,228,373,"6 de julio de 1997"
32,5,55,1760,67,79,146,"6 de julio de 1997"
32,5,55,1761,49,71,120,"6 de julio de 1997"
32,5,55,1762,57,71,128,"6 de julio de 1997"
32,5,55,1763,45,48,93,"6 de julio de 1997"
32,5,55,1764,63,79,142,"6 de julio de 1997"
32,5,55,1765,46,69,115,"6 de julio de 1997"
32,5,55,1766,37,44,81,"6 de julio de 1997"
32,5,55,1767,26,26,52,"6 de julio de 1997"
32,5,55,1768,31,29,60,"6 de julio de 1997"
32,5,55,1769,124,137,261,"6 de julio de 1997"
32,5,55,1770,55,48,103,"6 de julio de 1997"
32,5,55,1771,23,33,56,"6 de julio de 1997"
