edon,ife,fch,rmp,amlo,pna,asdc,efec,lisnom
1,1001,141814,67846,65882,3504,13030,292076,488004
1,1002,6318,3069,3137,220,294,13038,25446
1,1003,10083,2972,3361,246,584,17246,37518
1,1004,2180,1526,886,69,67,4728,8976
1,1005,12597,7043,3926,307,766,24639,45892
1,1006,4019,4236,3867,357,426,12905,23926
1,1007,6239,3606,3220,410,550,14025,28684
1,1008,1076,689,997,51,68,2881,5186
1,1009,2818,1659,1092,128,98,5795,11647
1,1010,4271,2599,2106,192,247,9415,17336
1,1011,1952,2252,1377,113,132,5826,10673
2,2001,66744,25367,38207,1543,5479,137340,282573
2,2002,137543,70304,67043,4548,12234,291672,595388
2,2003,13768,7202,7430,443,1044,29887,64745
2,2004,220216,95785,103693,6544,16408,442646,1023875
2,2005,11108,4506,7492,435,727,24268,55895
3,3001,8899,4578,9864,194,432,23967,45832
3,3002,5416,3551,7982,165,380,17494,32015
3,3003,26860,15590,38636,746,3151,84983,147996
3,3004,18603,5424,19594,320,1428,45369,95962
3,3005,2315,730,1787,50,75,4957,8084
4,4001,38096,25899,35696,1336,2587,103614,161689
4,4002,8000,7953,6223,1113,238,23527,31995
4,4003,24637,19859,27431,353,1072,73352,127163
4,4004,10648,10161,9310,721,363,31203,50613
4,4005,2688,4218,2922,2948,103,12879,17138
4,4006,5078,7245,5943,771,117,19154,29588
4,4007,384,1479,1845,76,41,3825,5520
4,4008,1623,1825,850,123,49,4470,6128
4,4009,3821,4854,8123,931,140,17869,31557
4,4010,4531,3919,2833,98,46,11427,21813
5,5001,229,220,75,4,2,530,1080
5,5002,14752,8668,8774,360,820,33374,83853
5,5003,4178,1982,960,71,166,7357,15582
5,5004,1931,3662,974,129,92,6788,13604
5,5005,276,443,53,4,4,780,1513
5,5006,2327,2617,2639,56,128,7767,17223
5,5007,1178,1628,819,27,45,3697,7623
5,5008,262,467,105,4,13,851,2182
5,5009,4566,5994,8321,369,472,19722,35348
5,5010,8600,6324,6874,154,604,22556,47256
5,5011,970,1716,491,53,30,3260,7802
5,5012,331,357,44,4,4,740,1691
5,5013,105,262,73,4,0,444,940
5,5014,668,1292,646,30,41,2677,7186
5,5015,211,229,55,13,5,513,1181
5,5016,327,235,181,0,10,753,1458
5,5017,10138,10151,14080,230,832,35431,66764
5,5018,36070,17226,19102,573,1895,74866,142009
5,5019,1504,962,380,23,57,2926,5708
5,5020,7426,8225,5153,245,528,21577,46962
5,5021,623,731,503,12,20,1889,4285
5,5022,3058,1994,1232,48,162,6494,14358
5,5023,564,1048,1068,10,40,2730,6187
5,5024,4587,4653,3094,142,467,12943,28861
5,5025,23919,12305,10252,459,1400,48335,103778
5,5026,319,617,182,12,10,1140,2592
5,5027,8772,4102,2870,144,490,16378,33196
5,5028,9325,5259,3672,306,445,19007,40050
5,5029,156,352,405,5,9,927,1564
5,5030,107734,72247,41078,2467,9041,232567,421503
5,5031,2688,1979,1756,68,150,6641,14643
5,5032,6581,4820,3857,196,458,15912,32076
5,5033,5726,9370,21463,410,669,37638,65467
5,5034,633,535,291,5,48,1512,3142
5,5035,125200,47823,60951,1679,7126,242779,401790
5,5036,1476,3489,1971,23,64,7023,13140
5,5037,941,744,146,23,28,1882,4550
5,5038,2226,1211,415,48,62,3962,9173
6,6001,30617,18176,17746,425,1757,68721,103497
6,6002,4022,3660,1296,39,136,9153,13922
6,6003,3487,3423,1169,66,91,8236,13517
6,6004,4453,4128,3447,69,213,12310,19681
6,6005,17476,9469,10426,272,1168,38811,60424
6,6006,2823,3824,3563,94,82,10386,20312
6,6007,785,1025,976,20,27,2833,4561
6,6008,27809,17102,13311,368,1382,59972,98445
6,6009,1321,1311,846,17,31,3526,5829
6,6010,14920,14445,8572,197,392,38526,69752
7,7001,975,1306,1678,42,35,4036,8932
7,7002,1849,2400,2878,45,52,7224,17750
7,7003,1281,1590,4015,76,75,7037,16247
7,7004,282,3022,2351,25,43,5723,13839
7,7005,940,2217,1434,27,20,4638,10215
7,7006,553,2750,3878,24,35,7240,15254
7,7007,48,825,603,7,2,1485,4363
7,7008,2333,3210,2704,28,51,8326,16712
7,7009,4514,2913,5285,188,190,13090,27037
7,7010,57,805,475,2,1,1340,3778
7,7011,248,2518,1848,44,8,4666,11052
7,7012,1812,2564,3554,61,108,8099,20192
7,7013,581,4266,2735,25,69,7676,13828
7,7014,285,1652,782,34,24,2777,10291
7,7015,1588,3716,6430,38,125,11897,24921
7,7016,509,2623,3285,21,38,6476,11423
7,7017,3503,5418,11315,207,266,20709,46186
7,7018,160,1249,1129,0,6,2544,4418
7,7019,6094,11727,14344,282,916,33363,74337
7,7020,1925,4097,3912,52,84,10070,25244
7,7021,1490,2133,1921,14,54,5612,12599
7,7022,536,1181,1037,21,18,2793,6901
7,7023,903,10690,3503,138,82,15316,37419
7,7024,278,1549,791,9,9,2636,4873
7,7025,533,834,863,2,16,2248,3739
7,7026,730,5818,854,24,38,7464,21146
7,7027,4113,6977,10403,214,249,21956,45721
7,7028,365,530,544,11,4,1454,3694
7,7029,672,663,414,7,5,1761,3549
7,7030,550,3158,3715,29,46,7498,17513
7,7031,1030,11830,13121,26,52,26059,49056
7,7032,1884,2194,3844,84,58,8064,17335
7,7033,756,318,879,2,5,1960,3199
7,7034,1088,4339,5897,62,99,11485,32592
7,7035,703,1013,1317,20,41,3094,7296
7,7036,83,738,678,11,10,1520,3393
7,7037,1317,3187,5412,50,90,10056,21860
7,7038,227,2587,1861,12,11,4698,11077
7,7039,548,2404,2045,28,18,5043,10770
7,7040,5842,4207,5251,55,127,15482,34049
7,7041,708,3022,2156,220,52,6158,21383
7,7042,197,1042,1142,9,8,2398,5135
7,7043,668,1347,1190,13,17,3235,5927
7,7044,318,2758,4127,167,31,7401,12205
7,7045,612,679,372,9,3,1675,3007
7,7046,1168,3364,7753,68,74,12427,25605
7,7047,255,2042,3071,13,23,5404,7922
7,7048,925,2710,3004,30,67,6736,13889
7,7049,335,3955,618,16,37,4961,11387
7,7050,1300,816,538,8,10,2672,3872
7,7051,2708,2724,5130,55,111,10728,25846
7,7052,1167,10523,17433,108,167,29398,58753
7,7053,111,1104,956,2,2,2175,4803
7,7054,1111,2595,4265,29,85,8085,16358
7,7055,642,535,772,3,7,1959,3604
7,7056,156,1183,415,13,25,1792,4073
7,7057,1224,6568,6073,71,139,14075,36496
7,7058,3,60,788,0,1,852,2128
7,7059,3820,20887,17270,230,281,42488,105750
7,7060,205,1420,1157,10,5,2797,5323
7,7061,5130,6638,6846,147,246,19007,43239
7,7062,931,2253,1540,19,33,4776,10034
7,7063,484,540,240,3,4,1271,2125
7,7064,526,7329,3968,89,51,11963,23436
7,7065,2845,9537,16160,150,257,28949,58862
7,7066,102,2720,1544,21,16,4403,9446
7,7067,532,1319,1558,6,8,3423,5537
7,7068,2307,3801,4753,78,119,11058,20413
7,7069,2808,4301,6599,84,131,13923,31230
7,7070,164,1860,1078,6,20,3128,6951
7,7071,910,3007,4533,16,24,8490,13534
7,7072,726,742,868,12,19,2367,4169
7,7073,1042,4350,8014,49,155,13610,22955
7,7074,1198,1473,1905,95,48,4719,13039
7,7075,270,4165,2875,10,26,7346,12605
7,7076,654,7202,5453,61,63,13433,29944
7,7077,8596,14275,23491,364,1506,48232,94772
7,7078,1845,2170,2466,45,86,6612,18472
7,7079,341,3178,2286,13,28,5846,14035
7,7080,396,855,633,8,25,1917,3433
7,7081,416,3618,3939,27,31,8031,19520
7,7082,854,4322,2754,42,33,8005,20474
7,7083,82,1299,1723,1,8,3113,5797
7,7084,310,1293,2099,19,27,3748,9895
7,7085,184,1144,1076,10,6,2420,4770
7,7086,140,1305,1588,5,5,3043,5198
7,7087,909,1173,2993,35,44,5154,11139
7,7088,2198,1861,3291,64,127,7541,16743
7,7089,113,520,177,2,3,815,1425
7,7090,21616,20882,42934,515,1527,87474,176602
7,7091,57,876,683,1,4,1621,2466
7,7092,742,1268,1424,8,20,3462,6670
7,7093,1338,4999,3362,60,82,9841,24140
7,7094,598,4636,2302,123,32,7691,18546
7,7095,1056,2730,1766,43,48,5643,16101
7,7096,980,8557,5752,46,103,15438,35946
7,7097,9060,6136,12040,344,299,27879,55163
7,7098,164,739,680,74,14,1671,3547
7,7099,1469,5627,9480,86,147,16809,40200
7,7100,646,4622,2703,70,43,8084,16162
7,7101,3557,3936,3684,78,97,11352,22925
7,7102,49250,34724,86106,830,4340,175250,324890
7,7103,2466,1890,2894,16,42,7308,15086
7,7104,440,1490,1166,11,10,3117,8378
7,7105,747,1542,2307,12,40,4648,8774
7,7106,1441,3507,6193,61,123,11325,33730
7,7107,1152,2125,3739,84,73,7173,17691
7,7108,2712,5618,8961,98,170,17559,42763
7,7109,6234,8571,11111,112,269,26297,57226
7,7110,1133,3656,2411,12,78,7290,18716
7,7111,622,4407,6328,92,27,11476,17695
8,8001,1675,1840,790,72,70,4447,8098
8,8002,3569,2664,1329,166,173,7901,16182
8,8003,1288,1391,492,120,53,3344,6442
8,8004,585,521,261,43,33,1443,3184
8,8005,2612,2498,1632,58,114,6914,16372
8,8006,515,784,961,65,29,2354,5548
8,8007,1529,2076,377,67,34,4083,11217
8,8008,667,1283,159,30,20,2159,6833
8,8009,2227,3307,1870,399,137,7940,18148
8,8010,2457,2775,2018,129,151,7530,14991
8,8011,9889,5202,2858,288,365,18602,34902
8,8012,383,1370,409,40,29,2231,5885
8,8013,1664,1596,892,66,74,4292,8382
8,8014,517,440,76,4,6,1043,1789
8,8015,299,278,66,1,4,648,1713
8,8016,929,526,150,13,16,1634,2973
8,8017,15401,12368,15984,664,1280,45697,99726
8,8018,385,708,554,23,21,1691,4609
8,8019,173532,79599,42648,4867,8670,309316,546076
8,8020,595,590,153,80,13,1431,4159
8,8021,25229,12450,9338,849,1454,49320,94127
8,8022,643,564,207,17,17,1448,3728
8,8023,409,558,337,25,21,1350,2823
8,8024,760,574,267,21,23,1645,3907
8,8025,1021,1108,885,41,63,3118,7584
8,8026,473,733,246,20,21,1493,3835
8,8027,2702,4611,1751,339,169,9572,24543
8,8028,1055,1317,776,55,54,3257,8423
8,8029,2523,5031,1055,369,74,9052,24647
8,8030,831,954,283,45,14,2127,5263
8,8031,3724,5448,4002,448,232,13854,28856
8,8032,23000,11609,5846,757,1127,42339,76022
8,8033,217,256,10,2,1,486,1216
8,8034,575,1030,1000,39,26,2670,6451
8,8035,774,1156,606,54,42,2632,6523
8,8036,6368,4395,3500,230,247,14740,26309
8,8037,177523,127766,85624,7134,14204,412251,969619
8,8038,1089,675,225,70,25,2084,4488
8,8039,650,518,460,15,18,1661,3147
8,8040,4919,3872,1735,223,156,10905,23659
8,8041,207,359,44,14,2,626,1314
8,8042,281,236,48,4,4,573,1875
8,8043,530,410,305,20,21,1286,2783
8,8044,803,613,283,28,23,1750,3631
8,8045,7471,3419,2703,364,342,14299,31259
8,8046,440,717,100,13,8,1278,4246
8,8047,679,799,77,21,11,1587,3505
8,8048,2623,2209,2169,182,114,7297,18422
8,8049,458,613,58,19,6,1154,2254
8,8050,8492,6173,5938,564,702,21869,46020
8,8051,767,1054,316,26,10,2173,4457
8,8052,4920,3097,1217,107,145,9486,20405
8,8053,1359,1170,684,40,36,3289,8014
8,8054,439,470,231,17,11,1168,5397
8,8055,2884,1853,896,136,114,5883,11983
8,8056,230,278,132,10,6,656,2168
8,8057,610,448,133,9,6,1206,2491
8,8058,624,299,351,16,14,1304,2435
8,8059,887,827,363,111,56,2244,4353
8,8060,1984,1416,689,129,116,4334,8178
8,8061,934,780,108,41,9,1872,4201
8,8062,6884,3164,1781,225,254,12308,22644
8,8063,691,1029,409,52,30,2211,5317
8,8064,303,386,36,4,5,734,2013
8,8065,1222,1849,368,162,40,3641,10262
8,8066,566,756,396,40,11,1769,4667
8,8067,702,1008,198,66,11,1985,4532
9,9002,80566,23491,152138,1648,10133,267976,390435
9,9003,129794,31426,212513,1608,14410,389751,547532
9,9004,27617,7207,41202,737,3015,79778,119654
9,9005,178269,58546,415773,4059,24559,681206,1038865
9,9006,60310,21197,143792,1396,9104,235799,348394
9,9007,175743,72733,577588,5380,32450,863894,1342098
9,9008,30457,9652,78763,707,3861,123440,178933
9,9009,6223,6594,33924,374,1460,48575,75842
9,9010,111933,27002,222249,2077,13824,377085,559083
9,9011,23940,14876,102658,871,5358,147703,224235
9,9012,93679,25847,195872,1515,11455,328368,472620
9,9013,38872,16072,128824,1284,6884,191936,285955
9,9014,116819,20741,89657,865,8640,236722,335683
9,9015,89086,31275,169652,1636,12439,304088,472447
9,9016,87431,19568,92841,1190,7054,208084,308946
9,9017,71988,27296,153361,1791,10688,265124,404115
10,10001,4963,3550,2964,151,196,11824,23481
10,10002,394,393,293,11,10,1101,2586
10,10003,431,711,346,20,12,1520,3350
10,10004,4992,3598,1991,193,125,10899,22585
10,10005,102676,44377,43208,2291,5218,197770,364270
10,10006,978,1578,944,20,30,3550,7770
10,10007,47969,27783,31152,878,2805,110587,196205
10,10008,4723,3524,4281,138,207,12873,24686
10,10009,1892,1825,337,21,24,4099,8007
10,10010,973,739,159,15,19,1905,3464
10,10011,1095,823,229,28,20,2195,4916
10,10012,24757,12140,12955,371,856,51079,87027
10,10013,3136,2504,2320,58,105,8123,15981
10,10014,4003,4871,558,49,59,9540,18678
10,10015,1503,1356,1948,28,37,4872,9077
10,10016,2654,1764,1673,78,123,6292,13897
10,10017,3240,2930,1341,57,117,7685,18159
10,10018,1657,1849,504,70,29,4109,8096
10,10019,2176,1721,742,100,45,4784,10031
10,10020,620,438,513,9,4,1584,3190
10,10021,1533,1791,1101,72,73,4570,10103
10,10022,1639,1210,1002,71,41,3963,7647
10,10023,3561,2719,2880,100,131,9391,19014
10,10024,5853,5200,1564,100,72,12789,25154
10,10025,1841,1517,1056,71,29,4514,8779
10,10026,475,793,232,27,20,1547,3311
10,10027,2445,1982,901,80,31,5439,11938
10,10028,907,764,268,4,16,1959,4323
10,10029,1763,1734,701,98,57,4353,9668
10,10030,424,425,44,11,1,905,1796
10,10031,292,305,106,8,2,713,1446
10,10032,1172,829,610,31,26,2668,5330
10,10033,7585,5976,2290,237,247,16335,34367
10,10034,832,760,654,18,32,2296,5180
10,10035,1447,2707,921,11,15,5101,13005
10,10036,2217,1742,471,39,50,4519,10208
10,10037,2151,2129,3633,96,124,8133,14748
10,10038,805,899,333,19,16,2072,4712
10,10039,3119,2001,1564,88,155,6927,15251
11,11001,15186,7881,5398,239,437,29141,56051
11,11002,18722,5083,16944,456,1138,42343,92178
11,11003,29506,5510,12076,554,1922,49568,92936
11,11004,9500,4988,4983,213,547,20231,41379
11,11005,14409,5099,5450,276,676,25910,51263
11,11006,954,1016,207,14,48,2239,3435
11,11007,108207,23710,22603,1511,4628,160659,286426
11,11008,5495,5709,1924,81,208,13417,28569
11,11009,12275,6225,3086,314,478,22378,45357
11,11010,2568,769,1375,51,80,4843,8267
11,11011,21543,4463,5467,538,1017,33028,62365
11,11012,4139,3197,2160,69,123,9688,19756
11,11013,3841,1079,1157,163,1339,7579,13128
11,11014,26331,8622,6532,434,1773,43692,87385
11,11015,29661,15572,10644,597,2696,59170,103656
11,11016,3187,2522,1781,65,118,7673,14677
11,11017,107481,35420,24219,1467,3876,172463,315041
11,11018,8107,2991,2645,186,228,14157,24785
11,11019,6256,5409,3201,282,315,15463,38862
11,11020,360236,94645,48994,3552,12762,520189,823723
11,11021,12463,3499,3781,194,657,20594,38974
11,11022,4643,2153,505,43,76,7420,14035
11,11023,30568,10934,10438,418,809,53167,109763
11,11024,2507,1212,1205,20,391,5335,8997
11,11025,14304,4969,1222,86,269,20850,34342
11,11026,8207,3700,5228,987,230,18352,36679
11,11027,64879,17296,16645,871,2496,102187,174806
11,11028,18086,5986,10242,408,1195,35917,79354
11,11029,5672,2153,2312,84,471,10692,22680
11,11030,18305,7440,4363,307,441,30856,62133
11,11031,30367,9696,3366,251,659,44339,73226
11,11032,15176,2924,4063,443,618,23224,39822
11,11033,17052,5331,9047,307,905,32642,64244
11,11034,1018,741,209,9,36,2013,3367
11,11035,15273,5146,3880,863,626,25788,46271
11,11036,1302,928,901,18,33,3182,6311
11,11037,28911,11936,9422,583,1246,52098,99807
11,11038,2755,1188,716,16,93,4768,9890
11,11039,7472,3155,2911,88,205,13831,28526
11,11040,2471,1357,1681,23,214,5746,9622
11,11041,10872,5373,3510,213,579,20547,40051
11,11042,23177,6016,16274,641,1279,47387,101299
11,11043,3278,2627,828,55,77,6865,12093
11,11044,13531,3545,2460,264,718,20518,33271
11,11045,2134,1751,249,6,21,4161,6981
11,11046,11830,7752,4787,350,932,25651,56505
12,12001,51978,43966,133125,2443,6939,238451,533337
12,12002,299,3743,2299,13,40,6394,13824
12,12003,1241,3841,6692,86,58,11918,26891
12,12004,128,1807,2110,12,25,4082,10778
12,12005,124,706,741,8,24,1603,4194
12,12006,498,1557,2234,34,22,4345,9259
12,12007,1125,2995,6684,151,93,11048,23200
12,12008,256,1161,1324,13,28,2782,6062
12,12009,181,308,468,8,8,973,2942
12,12010,292,1462,2714,33,39,4540,11707
12,12011,2001,4706,11352,300,239,18598,40388
12,12012,785,2539,6963,205,99,10591,30878
12,12013,565,3081,6164,59,59,9928,21575
12,12014,777,1794,3524,78,49,6222,12241
12,12015,1992,1140,1795,40,91,5058,9514
12,12016,170,1638,2290,40,9,4147,9306
12,12017,556,1940,2477,60,36,5069,11586
12,12018,330,927,1845,31,29,3162,8478
12,12019,229,1379,1167,7,15,2797,8367
12,12020,189,1303,1596,55,18,3161,9777
12,12021,2770,6107,10986,339,220,20422,47013
12,12022,1788,5753,6028,97,84,13750,33027
12,12023,720,2196,4005,50,64,7035,18169
12,12024,76,983,1028,21,4,2112,4261
12,12025,175,1724,2317,30,12,4258,9124
12,12026,184,1506,1782,11,5,3488,6883
12,12027,821,2743,3855,13,40,7472,19974
12,12028,3211,8600,13069,240,348,25468,63688
12,12029,13255,21232,33757,906,1776,70926,140838
12,12030,1980,3686,6704,288,171,12829,26298
12,12031,432,1746,2678,182,22,5060,12828
12,12032,125,1137,1055,16,8,2341,5079
12,12033,1400,2594,2633,165,37,6829,17756
12,12034,423,1331,1768,19,36,3577,9881
12,12035,2113,3957,5268,144,216,11698,27946
12,12036,10613,10463,23976,576,1507,47135,95166
12,12037,375,918,1413,72,22,2800,6167
12,12038,179,1043,1478,17,16,2733,5465
12,12039,8925,5483,18574,336,947,34265,74702
12,12040,987,2311,3922,55,61,7336,16012
12,12041,960,1930,2076,62,26,5054,13664
12,12042,271,2273,5886,24,50,8504,17154
12,12043,376,1608,1711,39,43,3777,9857
12,12044,316,1463,6607,24,27,8437,18461
12,12045,576,1339,1461,60,35,3471,7411
12,12046,567,2924,3269,30,52,6842,13726
12,12047,1070,6573,9067,54,116,16880,33322
12,12048,194,1059,1053,23,4,2333,4975
12,12049,1901,3174,8143,138,129,13485,30801
12,12050,1535,715,1385,32,83,3750,7528
12,12051,1997,3153,7639,112,170,13071,26727
12,12052,1318,2049,4339,64,72,7842,19225
12,12053,773,1792,4259,45,79,6948,20066
12,12054,1212,4239,6183,81,76,11791,30563
12,12055,428,2516,5013,58,34,8049,16118
12,12056,14453,9944,12240,432,850,37919,71293
12,12057,1116,2184,5395,150,112,8957,24083
12,12058,2250,4566,14121,185,143,21265,43166
12,12059,1616,3303,11309,206,168,16602,38255
12,12060,1350,3445,4495,87,106,9483,23816
12,12061,1045,1501,1337,51,63,3997,8358
12,12062,1330,2674,5478,476,230,10188,23285
12,12063,1198,1259,1981,18,24,4480,11634
12,12064,129,1057,1219,16,13,2434,4849
12,12065,1156,1188,2521,41,15,4921,10474
12,12066,165,1117,643,20,11,1956,4580
12,12067,1497,4901,7887,212,233,14730,40524
12,12068,847,2710,3962,224,28,7771,16432
12,12069,515,4510,5185,63,51,10324,18858
12,12070,355,851,1810,17,14,3047,7444
12,12071,274,900,1229,6,24,2433,5754
12,12072,859,4344,3400,16,35,8654,14777
12,12073,120,1012,690,30,8,1860,5024
12,12074,560,1526,4603,42,27,6758,15548
12,12075,878,2604,2658,61,55,6256,12077
12,12076,315,1831,3976,29,40,6191,12294
12,12077,183,1280,1613,10,32,3118,6848
13,13001,2060,1816,1614,85,123,5698,13532
13,13002,3159,3182,3631,168,140,10280,24166
13,13003,4963,5199,9319,302,631,20414,36660
13,13004,1288,1096,854,69,29,3336,5708
13,13005,1325,1530,3125,84,171,6235,10892
13,13006,1403,2262,3014,113,132,6924,13199
13,13007,1449,1166,1122,60,96,3893,7151
13,13008,5013,2936,7110,194,494,15747,28088
13,13009,2534,2484,4538,76,280,9912,15220
13,13010,711,2571,3677,119,37,7115,11878
13,13011,3588,2290,2786,578,222,9464,20582
13,13012,2799,2370,6000,130,316,11615,17676
13,13013,1902,2799,1706,73,54,6534,10708
13,13014,1054,2107,2643,220,120,6144,12592
13,13015,7103,3536,5056,264,490,16449,32306
13,13016,929,1339,2052,72,69,4461,8077
13,13017,946,3581,2998,140,58,7723,14074
13,13018,766,2275,2723,80,89,5933,10972
13,13019,1361,2229,2072,71,102,5835,10401
13,13020,100,459,684,13,6,1262,2314
13,13021,1091,1231,2921,48,134,5425,9153
13,13022,1972,912,1670,115,120,4789,8368
13,13023,1823,3074,7036,573,239,12745,21747
13,13024,1611,1485,2101,169,95,5461,11173
13,13025,844,3093,4471,136,73,8617,14757
13,13026,432,1290,2425,23,30,4200,6996
13,13027,792,3758,3082,146,39,7817,14315
13,13028,6455,11613,17525,577,470,36640,68573
13,13029,4761,5828,4093,246,382,15310,27344
13,13030,6539,7333,14010,459,699,29040,57966
13,13031,863,1413,2025,111,53,4465,9304
13,13032,759,1425,1946,45,28,4203,6946
13,13033,68,720,533,15,20,1356,2297
13,13034,439,1328,1927,26,20,3740,7453
13,13035,842,1179,1208,36,35,3300,5942
13,13036,1241,908,1439,69,69,3726,7201
13,13037,851,2767,2569,190,70,6447,14565
13,13038,527,862,1330,92,62,2873,5297
13,13039,1365,1431,2205,158,199,5358,10204
13,13040,10046,4560,10537,409,1483,27035,44587
13,13041,4143,2901,6022,323,485,13874,25944
13,13042,442,1139,1891,179,49,3700,7094
13,13043,347,1300,883,45,29,2604,4595
13,13044,1937,1850,1891,53,85,5816,9808
13,13045,1009,745,1121,68,40,2983,5926
13,13046,1091,845,183,24,13,2156,4135
13,13047,44665,22282,45660,1692,6181,120480,188929
13,13048,1440,2795,816,140,30,5221,10148
13,13049,2666,1732,3619,200,249,8466,14610
13,13050,999,1002,1500,195,54,3750,6898
13,13051,2955,2287,4197,105,392,9936,17269
13,13052,922,2282,2383,181,32,5800,11259
13,13053,5077,5361,3347,131,67,13983,23357
13,13054,1875,3106,6409,241,235,11866,20700
13,13055,863,1664,2370,84,129,5110,10398
13,13056,3765,2360,2913,147,325,9510,18285
13,13057,1345,1248,1961,89,130,4773,9544
13,13058,1086,1580,2784,84,115,5649,12973
13,13059,3447,2905,4392,206,196,11146,21471
13,13060,714,2132,2743,87,26,5702,10603
13,13061,6713,3448,12602,330,746,23839,38163
13,13062,1229,4141,3126,57,60,8613,14495
13,13063,6652,5633,13815,366,740,27206,45906
13,13064,1297,847,1639,30,62,3875,6496
13,13065,383,752,2921,46,79,4181,6715
13,13066,2633,4139,8185,136,911,16004,27612
13,13067,827,1188,1336,222,52,3625,9533
13,13068,6988,4406,10640,212,991,23237,38249
13,13069,1232,1311,3195,69,124,5931,10035
13,13070,386,1523,1458,150,29,3546,6782
13,13071,914,802,2770,115,120,4721,7384
13,13072,2044,4170,4171,132,100,10617,19483
13,13073,2104,2064,4811,175,280,9434,15915
13,13074,1657,980,1840,78,172,4727,7845
13,13075,10726,9812,19724,321,1320,41903,66749
13,13076,20363,8561,20519,772,1883,52098,93590
13,13077,1380,745,1355,137,127,3744,6653
13,13078,2012,2113,2066,94,35,6320,9925
13,13079,771,907,1004,182,38,2902,5038
13,13080,1787,2671,3317,80,73,7928,12899
13,13081,2542,2292,3364,298,169,8665,19058
13,13082,2492,1443,2285,65,245,6530,11132
13,13083,3166,2691,4742,209,290,11098,18838
13,13084,2696,4311,5743,254,205,13209,28002
14,14001,4643,2186,1006,94,207,8136,13950
14,14002,2209,2375,3247,107,614,8552,14073
14,14003,3049,2854,3208,105,266,9482,14668
14,14004,946,986,358,13,43,2346,3899
14,14005,1511,2145,1832,325,77,5890,8974
14,14006,10234,6310,6228,370,707,23849,44249
14,14007,1590,1064,963,46,140,3803,6435
14,14008,20034,9278,2183,221,1332,33048,52845
14,14009,3313,2047,1199,106,176,6841,11085
14,14010,1111,893,404,60,15,2483,3848
14,14011,1422,1217,109,9,19,2776,4028
14,14012,1141,724,120,11,39,2035,3292
14,14013,14467,5956,2253,167,428,23271,38510
14,14014,2113,1270,395,12,44,3834,6343
14,14015,11088,5937,4406,465,738,22634,40416
14,14016,6770,5280,2335,57,146,14588,24689
14,14017,4016,1116,379,27,47,5585,9640
14,14018,10637,5543,7376,500,416,24472,46682
14,14019,1407,1317,230,6,23,2983,4270
14,14020,1785,2123,806,12,45,4771,7272
14,14021,2725,2024,2859,97,132,7837,14667
14,14022,4088,3057,4382,257,231,12015,22065
14,14023,19883,9504,11595,436,1585,43003,69338
14,14024,1923,1979,1835,529,72,6338,10541
14,14025,4067,2364,4775,253,212,11671,20332
14,14026,3933,2202,1417,55,148,7755,13195
14,14027,1543,601,389,7,25,2565,4121
14,14028,3317,2677,746,40,44,6824,10315
14,14029,594,480,64,1,12,1151,2071
14,14030,2538,1707,1896,762,156,7059,12942
14,14031,7537,5647,4678,364,547,18773,30201
14,14032,489,696,98,6,12,1301,2153
14,14033,871,799,508,49,19,2246,3674
14,14034,4525,3480,665,29,87,8786,16287
14,14035,593,405,82,3,9,1092,1776
14,14036,11209,5722,1381,183,288,18783,32264
14,14037,3628,2154,1837,135,154,7908,12483
14,14038,2611,1929,952,87,122,5701,9331
14,14039,4000,2837,1533,128,268,8766,16671
14,14040,830,860,182,17,18,1907,3399
14,14041,426881,178244,166651,9621,32901,814298,1283836
14,14042,1450,1487,588,22,41,3588,5910
14,14043,1401,852,639,8,38,2938,5395
14,14044,1725,1054,660,5,26,3470,6551
14,14045,2958,2905,2677,109,210,8859,15858
14,14046,4423,2990,2142,213,194,9962,15851
14,14047,3008,2572,1402,110,297,7389,14487
14,14048,7262,2715,741,92,180,10990,20742
14,14049,4356,2202,1961,584,136,9239,15368
14,14050,5127,2128,497,69,120,7941,14999
14,14051,1655,1186,753,1,14,3609,6426
14,14052,7235,3885,2555,612,711,14998,26734
14,14053,2164,1594,1577,45,96,5476,8729
14,14054,1381,609,730,40,36,2796,4771
14,14055,32615,12898,6207,490,1315,53525,95158
14,14056,1021,715,856,103,70,2765,5201
14,14057,3359,3022,1248,24,100,7753,13136
14,14058,633,268,277,1,5,1184,2051
14,14059,846,383,685,9,10,1933,2919
14,14060,3518,1547,786,89,162,6102,10139
14,14061,2350,1601,1823,43,156,5973,8591
14,14062,1620,790,276,9,29,2724,4822
14,14063,2554,1716,1181,25,39,5515,9465
14,14064,830,678,210,7,11,1736,2886
14,14065,21702,6086,8485,333,813,37419,61638
14,14066,3885,2263,2888,172,340,9548,15930
14,14067,2224,1641,1546,39,115,5565,10191
14,14068,5963,4073,5361,143,349,15889,27823
14,14069,36829,17135,18231,667,2588,75450,144496
14,14070,2079,1613,703,26,29,4450,8194
14,14071,1025,1445,1402,13,49,3934,9369
14,14072,13728,12457,9296,661,964,37106,65758
14,14073,670,673,131,41,14,1529,3126
14,14074,1671,898,230,10,39,2848,4568
14,14075,16699,4896,1591,321,441,23948,39961
14,14076,5087,1583,198,32,78,6978,11170
14,14077,560,507,566,25,26,1684,2603
14,14078,711,650,97,4,4,1466,2528
14,14079,3842,2573,4913,168,205,11701,21566
14,14080,7958,2913,762,93,209,11935,20657
14,14081,517,851,1214,7,30,2619,4419
14,14082,977,402,389,19,32,1819,3392
14,14083,4312,2692,4400,273,1345,13022,21324
14,14084,7420,5760,7102,727,1003,22012,38403
14,14085,2750,2624,772,45,62,6253,9369
14,14086,7132,5739,3736,93,249,16949,32928
14,14087,2899,2351,1959,19,112,7340,9885
14,14088,3007,2223,1718,22,112,7082,12921
14,14089,3228,2284,1159,185,106,6962,12120
14,14090,687,500,441,10,32,1670,2654
14,14091,1861,975,489,77,39,3441,5597
14,14092,7260,3840,2560,273,291,14224,27981
14,14093,2301,2181,631,23,63,5199,9480
14,14094,35578,11019,4182,903,1102,52784,89833
14,14095,6265,3596,4263,97,234,14455,23524
14,14096,1395,1453,1445,17,66,4376,6824
14,14097,2581,1887,2435,41,147,7091,14502
14,14098,30745,14963,12709,1121,1720,61258,95278
14,14099,97067,55029,36431,2947,7639,199113,341056
14,14100,1548,1543,528,33,40,3692,6528
14,14101,3571,3057,3653,498,338,11117,21861
14,14102,55965,36105,24082,2090,4763,123005,214517
14,14103,1722,984,264,13,31,3014,5061
14,14104,1584,944,833,148,48,3557,5471
14,14105,1299,551,516,7,29,2402,4212
14,14106,4655,2828,1008,148,112,8751,15756
14,14107,997,811,294,8,40,2150,3307
14,14108,1271,619,775,62,81,2808,4791
14,14109,4768,3441,5455,620,555,14839,24633
14,14110,3438,2548,514,44,102,6646,11618
14,14111,2243,1613,1356,259,182,5653,10763
14,14112,1946,779,124,70,49,2968,4941
14,14113,1312,825,561,5,18,2721,4667
14,14114,2590,1972,1896,205,765,7428,12871
14,14115,1175,960,523,5,23,2686,4461
14,14116,4229,1952,499,58,147,6885,11366
14,14117,1068,663,93,10,9,1843,3682
14,14118,5882,2902,1180,60,215,10239,19001
14,14119,4424,2682,3805,127,481,11519,19811
14,14120,257200,103353,79985,4609,17550,462697,741788
14,14121,5139,3286,2967,276,326,11994,21401
14,14122,799,1144,610,6,20,2579,4327
14,14123,3215,2229,992,28,85,6549,11451
14,14124,13004,6404,3346,207,501,23462,39980
15,15001,5635,6708,5736,408,329,18816,35245
15,15002,5975,6285,15307,317,1179,29063,45593
15,15003,5209,4056,4332,153,269,14019,23700
15,15004,1685,1422,1724,63,55,4949,9530
15,15005,15591,11699,13463,451,887,42091,71499
15,15006,1196,1190,1385,37,90,3898,6406
15,15007,1198,2119,3250,66,86,6719,12012
15,15008,1513,4791,4173,55,66,10598,19865
15,15009,4631,3578,9957,272,1033,19471,32085
15,15010,4080,1173,3868,73,287,9481,15951
15,15011,2614,2251,9340,158,469,14832,24143
15,15012,1203,827,1001,36,91,3158,5563
15,15013,93254,30264,79553,2091,8311,213473,337663
15,15014,10405,9227,9401,587,907,30527,51439
15,15015,1991,1869,4775,65,233,8933,16314
15,15016,2309,2122,3879,116,202,8628,13087
15,15017,620,663,1242,19,86,2630,4068
15,15018,5433,2996,4560,190,448,13627,23154
15,15019,2583,1833,4265,113,392,9186,19136
15,15020,43288,17289,55160,1220,6450,123407,183549
15,15021,3528,2259,2585,58,178,8608,20589
15,15022,1243,911,2849,64,200,5267,8046
15,15023,3317,2887,7980,182,585,14951,26514
15,15024,11727,6104,13135,428,1411,32805,49493
15,15025,89745,29936,89144,2333,11020,222178,330535
15,15026,16205,14742,46408,992,3382,81729,144734
15,15027,3659,2600,2471,59,120,8909,14562
15,15028,912,765,830,25,63,2595,3929
15,15029,2201,1793,4768,111,340,9213,14706
15,15030,8854,8449,27996,622,2219,48140,83176
15,15031,2055,1045,5377,52,240,8769,13738
15,15032,29704,35524,84379,1916,6332,157855,297673
15,15033,1483,3082,5424,109,71,10169,16310
15,15034,179217,101466,363260,7627,30413,681983,1113659
15,15035,830,780,1053,26,28,2717,4901
15,15036,6484,5979,7263,182,668,20576,38368
15,15037,2588,4240,6848,174,384,14234,23471
15,15038,37563,15677,34402,740,3008,91390,136722
15,15039,637,956,1408,17,88,3106,5451
15,15040,26902,20864,73033,1343,5703,127845,209995
15,15041,4238,3285,2601,152,448,10724,19282
15,15042,536,815,1158,20,7,2536,3830
15,15043,11319,16379,15833,780,1184,45495,78378
15,15044,1397,1395,2493,101,173,5559,12153
15,15045,2591,1674,5351,135,516,10267,15841
15,15046,9647,7975,12260,408,667,30957,45228
15,15047,1889,1536,2728,50,186,6389,10200
15,15048,3642,6680,9991,294,445,21052,37981
15,15049,6806,8244,6466,271,514,22301,35271
15,15050,1240,1247,1404,35,80,4006,7496
15,15051,1831,1711,4113,72,203,7930,13120
15,15052,14649,9492,17010,426,1385,42962,66588
15,15053,2201,2569,2590,161,174,7695,14347
15,15054,4819,3075,8920,210,599,17623,27617
15,15055,47229,16661,23930,967,3656,92443,136171
15,15056,1287,609,1233,32,91,3252,6386
15,15057,2135,3175,2874,286,136,8606,16305
15,15058,162372,62997,151167,3145,14014,393695,647929
15,15059,2143,1329,3715,87,301,7575,13120
15,15060,127171,75502,312782,5237,23824,544516,921220
15,15061,38655,25727,48957,1686,5244,120269,203784
15,15062,1173,954,1337,13,65,3542,5352
15,15063,6978,4083,9160,232,917,21370,33986
15,15064,1292,2398,5115,70,110,8985,15150
15,15065,4012,2736,4799,182,218,11947,18984
15,15066,2890,2837,5088,98,342,11255,18892
15,15067,355,547,971,11,14,1898,3528
15,15068,7334,4138,9132,214,544,21362,36763
15,15069,1593,1733,4484,69,309,8188,15926
15,15070,672,339,805,19,58,1893,2720
15,15071,14020,14555,43240,731,3126,75672,130116
15,15072,2011,2230,1382,54,134,5811,8722
15,15073,1485,899,1178,50,158,3770,6234
15,15074,2056,1026,1047,29,102,4260,7257
15,15075,7700,12353,11609,425,466,32553,58987
15,15076,3385,1511,3039,76,274,8285,13291
15,15077,10621,6002,9150,416,1144,27333,43695
15,15078,369,843,814,19,23,2068,3442
15,15079,651,687,1546,35,20,2939,5687
15,15080,2381,1394,854,31,83,4743,6964
15,15081,2887,3854,1933,60,58,8792,15619
15,15082,31113,18449,37673,1012,4047,92294,139037
15,15083,5885,8132,8717,245,347,23326,43371
15,15084,999,997,1606,48,153,3803,6790
15,15085,4196,2501,4613,129,376,11815,18859
15,15086,4236,5487,10453,329,310,20815,38943
15,15087,3849,3605,2031,92,122,9699,18120
15,15088,6716,6228,9899,261,464,23568,42738
15,15089,9184,5148,10696,699,1065,26792,52260
15,15090,886,1127,1767,40,167,3987,6133
15,15091,7005,4143,8627,308,692,20775,41438
15,15092,7366,5027,13707,361,1063,27524,45571
15,15093,4180,4947,10325,232,774,20458,32477
15,15094,2116,2195,4605,78,349,9343,15060
15,15095,1102,1340,3006,53,137,5638,11163
15,15096,9210,5857,11223,361,1086,27737,43036
15,15097,3968,2030,4882,99,384,11363,19038
15,15098,1087,1729,2241,72,76,5205,10017
15,15099,391,517,816,37,38,1799,2857
15,15100,19918,14181,45080,1448,3889,84516,137813
15,15101,2297,1640,5034,102,481,9554,15573
15,15102,8461,5956,7652,342,931,23342,38289
15,15103,2370,1715,1807,75,93,6060,9622
15,15104,3514,2948,10162,257,697,17578,29915
15,15105,143351,47874,138745,3324,13932,347226,543118
15,15106,1103,3765,7207,77,63,12215,23922
15,15107,160135,65943,70545,3665,11754,312042,482121
15,15108,1438,1655,1510,36,82,4721,8471
15,15109,10986,6111,21717,509,1961,41284,67207
15,15110,50287,27462,87767,2243,8794,176553,287366
15,15111,8431,5146,7856,381,839,22653,37145
15,15112,4861,3465,3737,93,135,12291,22358
15,15113,4976,5673,2872,108,200,13829,22779
15,15114,7263,3485,3584,213,387,14932,29641
15,15115,4820,8196,8162,227,265,21670,40316
15,15116,5579,3593,7469,107,570,17318,29193
15,15117,647,432,382,3,14,1478,2387
15,15118,1138,1643,1703,35,58,4577,9366
15,15119,22338,10464,12660,621,1656,47739,81733
15,15120,1409,1561,1344,44,43,4401,9005
15,15121,10722,10152,19938,617,1744,43173,73393
15,15122,18440,19176,72347,1215,4860,116038,207201
15,15123,2103,3792,3319,40,54,9308,19301
15,15124,8279,7318,5374,277,179,21427,41218
15,15125,478,590,1621,21,87,2797,4547
16,16001,1176,689,1352,12,60,3289,7254
16,16002,1058,1026,3265,15,27,5391,14902
16,16003,2486,1661,2688,33,97,6965,14937
16,16004,819,1810,2453,14,71,5167,12183
16,16005,1123,994,1665,22,76,3880,7216
16,16006,9013,7458,18724,176,801,36172,83473
16,16007,299,438,551,0,6,1294,2204
16,16008,1282,2462,2696,10,57,6507,14328
16,16009,3697,2624,3650,63,202,10236,20755
16,16010,1007,2298,3571,10,57,6943,15269
16,16011,1059,881,1493,17,53,3503,6958
16,16012,2420,2724,6294,43,135,11616,28245
16,16013,512,1342,1243,3,21,3121,6887
16,16014,1003,1098,1886,25,65,4077,9552
16,16015,2232,1637,2324,25,68,6286,14847
16,16016,1477,1704,4385,38,119,7723,20261
16,16017,2030,1621,5890,44,92,9677,18591
16,16018,526,863,1046,13,27,2475,6997
16,16019,4139,1346,2168,14,50,7717,16838
16,16020,3033,1266,2812,170,208,7489,19225
16,16021,635,1496,1695,14,29,3869,8141
16,16022,3187,1170,2019,40,101,6517,13278
16,16023,1308,1200,1189,20,45,3762,9297
16,16024,791,1234,3045,18,61,5149,11543
16,16025,2173,3239,4764,44,120,10340,21503
16,16026,226,725,870,3,8,1832,4159
16,16027,407,528,941,19,26,1921,5812
16,16028,570,435,1543,12,53,2613,6738
16,16029,215,1194,2719,4,2,4134,9402
16,16030,1193,2097,1832,17,65,5204,12841
16,16031,1337,1688,2599,40,95,5759,10906
16,16032,1100,1175,2536,70,95,4976,10091
16,16033,790,1659,4401,27,64,6941,14403
16,16034,18009,6654,12150,203,673,37689,77321
16,16035,1636,3512,5605,23,92,10868,23006
16,16036,1814,1062,1630,21,79,4606,9562
16,16037,427,398,2075,15,44,2959,8391
16,16038,1607,3441,7438,36,115,12637,31654
16,16039,340,583,1345,16,52,2336,4801
16,16040,1545,1323,2132,31,72,5103,11891
16,16041,1474,868,1950,23,102,4417,9414
16,16042,1199,1383,2418,24,61,5085,11603
16,16043,8338,3148,5727,94,334,17641,39610
16,16044,1269,1185,2232,29,74,4789,12383
16,16045,4716,2428,6929,77,278,14428,30417
16,16046,2702,2539,4752,39,76,10108,21266
16,16047,700,1401,2416,13,49,4579,9061
16,16048,785,2000,3608,21,48,6462,13278
16,16049,550,512,932,16,13,2023,4241
16,16050,10882,8191,37716,309,1285,58383,119099
16,16051,1146,1093,2530,20,66,4855,11577
16,16052,7427,2961,12993,175,424,23980,49664
16,16053,2133,871,1652,25,92,4773,9020
16,16054,135167,34550,100160,1284,8639,279800,480820
16,16055,1263,696,886,19,47,2911,8394
16,16056,1870,3400,7742,120,169,13301,28991
16,16057,1187,3299,4453,13,74,9026,16873
16,16058,234,1245,1427,2,13,2921,5845
16,16059,1019,2879,2218,26,67,6209,11002
16,16060,363,522,1827,6,21,2739,5738
16,16061,984,993,1548,10,25,3560,8168
16,16062,1226,1306,3566,48,59,6205,11626
16,16063,2974,1159,2275,25,58,6491,15098
16,16064,1089,1553,2318,14,54,5028,13757
16,16065,905,1139,4774,17,71,6906,16363
16,16066,1961,2540,6191,69,174,10935,22323
16,16067,7903,5485,13045,244,838,27515,54817
16,16068,1387,2250,2288,21,66,6012,16298
16,16069,4215,1675,2105,49,173,8217,14669
16,16070,20574,5929,7988,175,508,35174,71759
16,16071,2803,1074,2011,28,102,6018,12520
16,16072,8818,3501,11260,116,353,24048,55830
16,16073,1475,832,1994,28,93,4422,10380
16,16074,4576,1503,2791,56,121,9047,18225
16,16075,1003,641,1931,36,40,3651,7883
16,16076,8025,5473,8588,111,467,22664,41186
16,16077,16172,4515,4987,119,384,26177,46331
16,16078,952,1500,3496,13,27,5988,14749
16,16079,1796,1017,1449,41,65,4368,10975
16,16080,3407,2448,6247,124,279,12505,25942
16,16081,1519,930,2862,32,78,5421,12110
16,16082,231,1253,1607,3,9,3103,6143
16,16083,7387,5098,7422,230,510,20647,43179
16,16084,2361,1647,4060,52,104,8224,16607
16,16085,2341,2133,3504,20,105,8103,17669
16,16086,4345,2198,2781,57,205,9586,24437
16,16087,1361,555,3465,13,39,5433,10991
16,16088,1121,1629,2308,35,58,5151,9801
16,16089,5206,3301,5806,85,244,14642,30824
16,16090,1805,1977,3353,36,114,7285,18220
16,16091,946,1143,2442,47,84,4662,8265
16,16092,2656,1304,1480,20,63,5523,10255
16,16093,385,1837,2202,3,18,4445,10132
16,16094,3121,1100,4053,278,144,8696,17079
16,16095,607,766,1760,10,34,3177,8130
16,16096,1783,973,1818,14,62,4650,9459
16,16097,176,889,1887,4,12,2968,6889
16,16098,1106,2951,5383,42,128,9610,21685
16,16099,2460,2127,3292,42,154,8075,16967
16,16100,664,1837,3467,16,20,6004,12903
16,16101,1259,728,2062,59,66,4174,8970
16,16102,778,1204,1063,7,15,3067,7502
16,16103,40291,13866,41454,775,3417,99803,192655
16,16104,2191,1803,4113,109,76,8292,18067
16,16105,2410,1496,2341,20,69,6336,16403
16,16106,1551,1590,3395,9,52,6597,13799
16,16107,2856,1792,4498,51,87,9284,19723
16,16108,9662,4608,12426,183,629,27508,54002
16,16109,31987,10610,20006,323,1582,64508,125766
16,16110,382,530,601,4,17,1534,3845
16,16111,5625,3286,7234,85,246,16476,37617
16,16112,1137,1261,2504,35,101,5038,9081
16,16113,16178,12155,19650,418,1287,49688,96714
17,17001,1452,1050,3774,279,158,6713,12161
17,17002,2116,765,3172,237,541,6831,11191
17,17003,3102,2488,5070,107,561,11328,21962
17,17004,7561,5192,11357,1004,781,25895,49715
17,17005,985,845,2033,370,80,4313,7747
17,17006,20330,9531,31935,1082,2915,65793,118401
17,17007,74091,21700,69672,1407,6707,173577,274654
17,17008,7727,5391,8935,207,529,22789,38978
17,17009,1589,1046,4267,28,175,7105,10190
17,17010,1782,1016,2747,123,156,5824,10092
17,17011,27747,9726,35422,629,2672,76196,128715
17,17012,6561,4038,11564,538,818,23519,42302
17,17013,2047,997,2483,156,394,6077,10120
17,17014,891,700,2347,209,107,4254,6753
17,17015,2035,2879,4684,56,175,9829,17047
17,17016,2088,827,2808,68,431,6222,10346
17,17017,5817,4910,10285,862,572,22446,40633
17,17018,11978,6674,15119,518,1157,35446,66517
17,17019,2944,1901,4279,523,249,9896,17374
17,17020,3698,2102,7943,129,468,14340,22925
17,17021,806,675,1615,232,87,3415,5418
17,17022,2029,1037,2480,619,307,6472,10699
17,17023,225,717,1959,13,27,2941,3975
17,17024,4135,3445,9643,370,698,18291,33075
17,17025,2837,2858,5663,134,441,11933,22673
17,17026,1528,1044,3858,434,213,7077,10487
17,17027,1322,749,1795,93,105,4064,6117
17,17028,6552,2903,9195,198,540,19388,34838
17,17029,9852,6296,16900,597,1219,34864,62616
17,17030,4260,2805,6343,282,542,14232,26172
17,17031,3383,2935,9039,115,662,16134,27469
17,17032,1224,707,1488,236,127,3782,5899
17,17033,1233,1137,2573,269,96,5308,8284
18,18001,2773,4777,5609,352,170,13681,24617
18,18002,1510,2297,2056,65,103,6031,11887
18,18003,2118,1480,1057,23,50,4728,9135
18,18004,6619,7089,7230,110,386,21434,42018
18,18005,5600,7832,10246,191,352,24221,50160
18,18006,209,1685,1535,63,18,3510,6139
18,18007,3223,2897,3686,80,207,10093,18980
18,18008,1969,2716,1525,61,69,6340,11453
18,18009,1128,3641,1931,41,56,6797,16627
18,18010,1476,5621,6075,85,125,13382,24784
18,18011,1743,2827,3726,49,87,8432,15766
18,18012,3820,4736,5305,76,191,14128,27817
18,18013,1071,1238,657,35,46,3047,6524
18,18014,1051,4134,2580,83,124,7972,15422
18,18015,3813,13573,18020,322,362,36090,70002
18,18016,1914,5583,8656,105,118,16376,29823
18,18017,24315,40085,60487,1775,4660,131322,235253
18,18018,1971,3883,5956,138,146,12094,23114
18,18019,1718,5748,6251,166,435,14318,27396
18,18020,880,1417,273,20,18,2608,6638
19,19001,616,583,210,23,15,1447,1915
19,19002,1253,1220,159,6,11,2649,3944
19,19003,858,576,65,5,1,1505,2554
19,19004,5232,3650,2419,66,200,11567,21067
19,19005,3089,3112,919,38,58,7216,13459
19,19006,52231,41095,19286,2066,4023,118701,218259
19,19007,1149,4130,525,1075,66,6945,9821
19,19008,1009,494,418,21,17,1959,2607
19,19009,11143,10252,8506,296,465,30662,52638
19,19010,1338,1096,383,380,61,3258,4887
19,19011,1683,1930,296,38,35,3982,6648
19,19012,1995,1634,1040,50,70,4789,8336
19,19013,2042,2342,1194,73,37,5688,9267
19,19014,3278,6598,3195,161,96,13328,23360
19,19015,1055,796,180,3,3,2037,2876
19,19016,674,415,314,94,12,1509,2258
19,19017,2815,6499,2119,69,3452,14954,26332
19,19018,4127,4780,4741,642,243,14533,24863
19,19019,46756,11654,5716,600,1092,65818,97347
19,19020,1359,1185,576,343,31,3494,5250
19,19021,34561,29680,15168,1485,2674,83568,165348
19,19022,3469,2414,620,38,70,6611,12055
19,19023,667,412,110,4,3,1196,1825
19,19024,495,1416,370,5,11,2297,3397
19,19025,2010,1190,303,24,41,3568,4780
19,19026,147267,78180,50319,4848,9926,290540,506521
19,19027,839,907,181,42,8,1977,2844
19,19028,2079,2443,2295,102,136,7055,10764
19,19029,275,334,264,7,7,887,1091
19,19030,1752,1304,321,40,20,3437,5403
19,19031,401,824,676,25,12,1938,2503
19,19032,11995,10483,6154,500,876,30008,57841
19,19033,847,895,276,493,18,2529,3870
19,19034,15670,9946,4099,733,295,30743,53432
19,19035,1037,761,394,37,28,2257,3579
19,19036,332,341,54,170,4,901,1223
19,19037,486,1791,173,65,14,2529,5047
19,19038,592,1028,697,66,28,2411,3414
19,19039,8782,6351,5313,288,1539,22273,41525
19,19040,267737,148619,82550,6991,15006,520903,881283
19,19041,372,300,506,3,4,1185,1432
19,19042,2417,1884,1119,75,149,5644,8743
19,19043,1480,978,117,22,11,2608,4857
19,19044,407,845,169,6,12,1439,2135
19,19045,7289,3997,4179,169,207,15841,25479
19,19046,2890,3826,1231,196,133,8276,15356
19,19047,145932,42173,33449,3447,7139,232140,377382
19,19048,48077,24020,14315,4924,2947,94283,170241
19,19049,9240,5501,3105,232,381,18459,29144
19,19050,260,733,490,5,5,1493,2059
19,19051,624,730,894,10,24,2282,3472
20,20001,43,182,117,0,0,342,881
20,20002,3712,6013,7617,93,244,17679,29167
20,20003,312,406,663,5,43,1429,2265
20,20004,71,247,252,5,2,577,1427
20,20005,209,175,54,0,4,442,771
20,20006,463,3014,3722,11,50,7260,10932
20,20007,844,1819,3553,29,119,6364,9647
20,20008,471,320,236,3,14,1044,2843
20,20009,24,186,200,0,0,410,656
20,20010,466,257,633,23,34,1413,4080
20,20011,111,1048,880,2,7,2048,3291
20,20012,1524,1699,2195,14,84,5516,8967
20,20013,28,96,224,0,3,351,988
20,20014,261,841,1395,10,20,2527,5499
20,20015,941,1331,1466,3,13,3754,7081
20,20016,173,1115,1502,7,18,2815,5190
20,20017,211,362,609,4,32,1218,2500
20,20018,276,693,180,8,25,1182,3751
20,20019,78,250,776,17,8,1129,4294
20,20020,163,886,228,6,6,1289,2742
20,20021,65,68,129,4,3,269,539
20,20022,83,406,416,3,9,917,1942
20,20023,44,145,149,5,4,347,1592
20,20024,1144,1762,2716,15,105,5742,9257
20,20025,42,174,195,3,5,419,648
20,20026,862,1547,2615,30,138,5192,9519
20,20027,143,362,341,13,10,869,2395
20,20028,3340,2541,1694,52,119,7746,14580
20,20029,145,259,350,7,4,765,2116
20,20030,249,1774,2200,4,43,4270,5997
20,20031,11,195,150,0,0,356,746
20,20032,56,247,279,0,3,585,1122
20,20033,179,144,554,4,22,903,1574
20,20034,17,49,148,2,3,219,354
20,20035,139,940,680,3,2,1764,2882
20,20036,112,303,478,4,9,906,3007
20,20037,7430,4989,10341,71,586,23417,42634
20,20038,44,1283,569,2,8,1906,3199
20,20039,2043,5246,4674,14,70,12047,18609
20,20040,32,207,239,2,5,485,1388
20,20041,1692,4540,5716,26,145,12119,17290
20,20042,517,663,1510,11,70,2771,4535
20,20043,1751,13861,21862,48,219,37741,56834
20,20044,3419,3881,6984,52,230,14566,26565
20,20045,491,327,1022,9,68,1917,3270
20,20046,259,344,509,38,19,1169,2474
20,20047,10,165,108,0,1,284,617
20,20048,28,219,208,0,6,461,728
20,20049,95,115,555,15,11,791,1914
20,20050,87,127,150,2,2,368,2230
20,20051,158,929,1602,28,17,2734,4804
20,20052,6,327,261,0,7,601,1007
20,20053,90,137,190,1,8,426,832
20,20054,27,50,59,1,3,140,316
20,20055,77,636,585,5,6,1309,2439
20,20056,21,247,308,5,2,583,978
20,20057,3865,5943,5666,41,162,15677,25434
20,20058,249,1579,1609,14,35,3486,7022
20,20059,2997,3470,5657,68,249,12441,24848
20,20060,46,448,138,2,1,635,1276
20,20061,164,338,128,8,10,648,1805
20,20062,54,62,97,3,4,220,445
20,20063,173,380,1129,5,24,1711,2648
20,20064,520,962,962,9,25,2478,4946
20,20065,107,125,102,2,7,343,986
20,20066,34743,24269,69456,598,4259,133325,204657
20,20067,1993,1545,3916,41,191,7686,13356
20,20068,145,334,86,4,2,571,1229
20,20069,65,1440,1079,4,7,2595,3837
20,20070,134,535,587,5,4,1265,2022
20,20071,790,3079,5779,35,108,9791,19999
20,20072,135,530,531,1,6,1203,1971
20,20073,133,461,490,5,8,1097,2156
20,20074,233,223,731,4,19,1210,2181
20,20075,87,64,212,2,9,374,843
20,20076,4321,8636,18720,92,366,32135,53007
20,20077,136,306,377,3,4,826,1513
20,20078,27,302,349,1,6,685,1683
20,20079,50,537,710,0,7,1304,2604
20,20080,581,523,989,24,68,2185,3892
20,20081,330,263,946,8,47,1594,2478
20,20082,359,3175,2698,38,56,6326,12462
20,20083,18,44,221,2,2,287,570
20,20084,333,212,230,10,30,815,2429
20,20085,92,547,198,1,5,843,1760
20,20086,54,319,305,6,8,692,1488
20,20087,162,670,1222,33,17,2104,3761
20,20088,465,265,686,6,66,1488,2511
20,20089,116,111,245,6,14,492,1153
20,20090,17,106,105,0,3,231,374
20,20091,91,441,161,2,7,702,1214
20,20092,208,471,207,6,12,904,2262
20,20093,57,49,163,0,6,275,506
20,20094,61,82,313,5,4,465,1342
20,20095,251,515,429,1,5,1201,2339
20,20096,17,116,12,0,1,146,352
20,20097,30,17,151,1,3,202,464
20,20098,15,154,35,2,7,213,686
20,20099,213,508,854,1,41,1617,2347
20,20100,321,465,1012,8,27,1833,3394
20,20101,130,324,227,7,6,694,1376
20,20102,65,1632,246,12,11,1966,3611
20,20103,25,60,73,0,4,162,229
20,20104,1530,983,2823,42,196,5574,10637
20,20105,225,168,1139,12,14,1558,2678
20,20106,58,211,301,3,4,577,903
20,20107,22,241,94,3,2,362,796
20,20108,27,127,719,3,2,878,2130
20,20109,225,457,539,6,6,1233,2119
20,20110,114,239,437,4,7,801,1704
20,20111,34,31,233,1,4,303,632
20,20112,616,387,1431,18,74,2526,4248
20,20113,45,66,199,6,7,323,590
20,20114,68,148,114,7,7,344,524
20,20115,345,497,671,2,2,1517,2254
20,20116,71,146,376,1,1,595,1342
20,20117,101,250,66,4,2,423,1870
20,20118,12,59,58,0,0,129,275
20,20119,14,34,109,3,1,161,353
20,20120,73,407,258,9,8,755,1835
20,20121,179,4723,3331,9,23,8265,11311
20,20122,607,1035,1332,17,22,3013,6340
20,20123,210,282,679,11,20,1202,2705
20,20124,22,45,208,1,1,277,678
20,20125,96,115,224,4,13,452,1076
20,20126,20,31,78,2,3,134,217
20,20127,26,1285,867,1,4,2183,3299
20,20128,588,1154,776,20,29,2567,5931
20,20129,129,142,161,2,6,440,807
20,20130,58,157,890,5,9,1119,2099
20,20131,873,4704,4842,8,29,10456,14120
20,20132,352,439,662,17,49,1519,3955
20,20133,952,1946,1583,2,9,4492,6541
20,20134,175,193,391,3,10,772,1731
20,20135,29,9,154,1,5,198,410
20,20136,14,259,130,3,3,409,1043
20,20137,9,140,105,1,4,259,459
20,20138,61,1221,999,2,1,2284,4051
20,20139,59,62,285,3,2,411,809
20,20140,219,1707,1852,3,8,3789,5981
20,20141,43,123,211,2,5,384,795
20,20142,146,157,272,2,23,600,1247
20,20143,194,199,158,10,12,573,1264
20,20144,12,80,48,0,2,142,252
20,20145,46,80,306,4,6,442,1132
20,20146,93,145,140,0,5,383,853
20,20147,474,1630,2227,12,62,4405,6828
20,20148,19,65,75,0,1,160,267
20,20149,48,131,211,4,4,398,1450
20,20150,95,832,548,4,5,1484,2465
20,20151,127,521,62,1,1,712,1398
20,20152,31,142,24,2,6,205,424
20,20153,109,319,774,10,21,1233,2356
20,20154,849,837,2340,18,117,4161,6419
20,20155,47,120,419,5,8,599,1268
20,20156,284,494,401,14,16,1209,2636
20,20157,254,214,138,0,5,611,1398
20,20158,209,462,328,7,16,1022,1840
20,20159,61,244,98,2,0,405,906
20,20160,44,255,251,9,10,569,995
20,20161,335,646,841,14,51,1887,3716
20,20162,51,155,344,4,8,562,2072
20,20163,24,192,227,1,3,447,913
20,20164,1365,1149,2043,13,40,4610,6966
20,20165,35,496,36,2,0,569,1113
20,20166,77,122,152,0,1,352,576
20,20167,63,825,944,4,7,1843,2628
20,20168,161,646,319,10,26,1162,2339
20,20169,532,740,434,19,31,1756,3748
20,20170,494,2475,3311,8,21,6309,10444
20,20171,13,48,162,2,2,227,370
20,20172,37,205,284,0,9,535,1118
20,20173,139,175,233,5,9,561,1022
20,20174,138,245,534,8,11,936,1990
20,20175,641,1348,2026,10,26,4051,6357
20,20176,369,303,779,13,48,1512,2878
20,20177,66,200,140,6,5,417,920
20,20178,167,354,435,3,8,967,1732
20,20179,95,124,20,1,7,247,358
20,20180,120,131,99,1,0,351,917
20,20181,7,421,309,0,4,741,1301
20,20182,19356,13855,22851,232,1022,57316,95498
20,20183,1029,2673,4593,15,56,8366,14540
20,20184,205,1155,1554,17,24,2955,5193
20,20185,19,53,82,1,3,158,275
20,20186,158,177,315,2,18,670,1090
20,20187,54,476,251,2,4,787,1624
20,20188,34,115,55,0,2,206,441
20,20189,19,483,300,0,1,803,1342
20,20190,67,1456,1575,9,13,3120,4687
20,20191,91,428,155,4,0,678,1283
20,20192,976,2482,2490,25,45,6018,11886
20,20193,214,232,468,3,10,927,1563
20,20194,358,168,281,10,13,830,1662
20,20195,165,161,114,3,8,451,1026
20,20196,100,106,193,6,2,407,927
20,20197,13,70,138,1,3,225,381
20,20198,160,319,232,2,16,729,2221
20,20199,409,5965,6684,19,47,13124,18525
20,20200,123,131,10,0,1,265,576
20,20201,236,296,422,11,10,975,2104
20,20202,17,179,390,4,5,595,1189
20,20203,156,631,359,6,18,1170,2358
20,20204,183,348,281,2,11,825,1916
20,20205,20,97,199,0,2,318,564
20,20206,522,3024,2425,7,27,6005,9196
20,20207,568,2298,1371,27,46,4310,8661
20,20208,99,875,1533,15,15,2537,7299
20,20209,63,124,72,2,4,265,526
20,20210,71,1298,550,13,6,1938,3972
20,20211,69,111,374,4,5,563,1530
20,20212,40,96,285,1,9,431,1376
20,20213,212,169,471,8,6,866,2065
20,20214,93,146,419,8,9,675,1693
20,20215,44,63,147,0,12,266,475
20,20216,14,71,216,2,1,304,795
20,20217,65,379,425,7,11,887,1725
20,20218,4,152,39,1,1,197,394
20,20219,233,309,134,12,18,706,2087
20,20220,105,243,449,4,11,812,1751
20,20221,53,76,275,3,4,411,993
20,20222,43,123,227,2,8,403,1047
20,20223,13,103,96,0,0,212,329
20,20224,63,59,220,3,4,349,563
20,20225,597,538,822,4,15,1976,3382
20,20226,158,284,180,6,18,646,1701
20,20227,847,619,2344,15,106,3931,7214
20,20228,21,163,119,0,0,303,445
20,20229,261,214,387,2,7,871,2884
20,20230,31,152,147,0,0,330,817
20,20231,110,115,45,2,0,272,1326
20,20232,1965,2926,2807,15,45,7758,11690
20,20233,88,178,28,4,4,302,1458
20,20234,119,1123,922,28,15,2207,3847
20,20235,187,746,307,9,17,1266,2339
20,20236,180,40,187,3,4,414,979
20,20237,100,227,422,3,18,770,1706
20,20238,12,194,154,2,4,366,571
20,20239,32,57,292,1,7,389,744
20,20240,17,118,422,3,3,563,1648
20,20241,114,203,78,3,7,405,912
20,20242,280,378,1089,30,31,1808,6162
20,20243,170,229,197,2,14,612,1258
20,20244,131,396,530,5,11,1073,1973
20,20245,16,293,248,1,1,559,1210
20,20246,28,89,93,1,2,213,437
20,20247,397,2183,1365,11,41,3997,6860
20,20248,68,92,176,0,1,337,694
20,20249,103,82,52,4,6,247,702
20,20250,50,126,272,6,7,461,1143
20,20251,68,303,412,3,5,791,1642
20,20252,483,360,273,1,7,1124,2170
20,20253,47,106,139,6,4,302,1257
20,20254,28,25,54,0,0,107,172
20,20255,164,509,360,8,10,1051,1809
20,20256,18,111,201,3,4,337,816
20,20257,32,166,86,4,2,290,615
20,20258,336,334,38,0,1,709,1664
20,20259,86,453,251,2,4,796,1531
20,20260,451,1265,416,0,16,2148,3932
20,20261,47,160,106,1,11,325,666
20,20262,62,127,494,8,9,700,1311
20,20263,103,1307,1131,2,13,2556,3785
20,20264,255,205,241,5,8,714,1694
20,20265,233,1121,1222,3,16,2595,4627
20,20266,11,42,42,1,1,97,249
20,20267,84,190,59,0,4,337,611
20,20268,55,196,1015,4,7,1277,2370
20,20269,19,184,217,3,3,426,934
20,20270,93,144,427,19,16,699,1582
20,20271,79,460,865,13,5,1422,2895
20,20272,229,601,232,12,15,1089,1910
20,20273,87,148,138,2,3,378,835
20,20274,81,619,449,8,3,1160,3741
20,20275,26,84,76,1,0,187,574
20,20276,3730,7697,5249,48,107,16831,22131
20,20277,208,116,552,15,19,910,1693
20,20278,114,176,427,4,5,726,1755
20,20279,16,50,52,0,0,118,208
20,20280,36,243,60,0,4,343,517
20,20281,61,138,129,9,8,345,683
20,20282,81,317,285,10,3,696,2009
20,20283,135,552,442,3,10,1142,1925
20,20284,141,253,416,6,14,830,2317
20,20285,51,38,74,1,5,169,330
20,20286,31,88,62,1,1,183,349
20,20287,204,220,36,1,4,465,850
20,20288,8,142,227,0,0,377,760
20,20289,222,296,678,10,6,1212,2354
20,20290,40,359,38,5,8,450,772
20,20291,977,521,1869,21,154,3542,6337
20,20292,591,909,1306,7,37,2850,4329
20,20293,960,1134,1429,16,43,3582,6398
20,20294,47,90,267,4,6,414,780
20,20295,45,148,146,6,5,350,1250
20,20296,1325,1122,1953,23,120,4543,7459
20,20297,21,85,128,1,4,239,719
20,20298,45,1126,1224,0,4,2399,3724
20,20299,112,125,231,5,12,485,1287
20,20300,46,691,551,1,3,1292,2236
20,20301,62,42,239,6,8,357,834
20,20302,45,109,155,3,4,316,648
20,20303,39,761,1310,1,21,2132,3137
20,20304,49,466,384,1,9,909,1818
20,20305,193,1819,1582,1,17,3612,5660
20,20307,1586,1967,957,3,16,4529,6341
20,20308,263,312,683,10,32,1300,3131
20,20309,13,128,59,2,1,203,371
20,20310,201,1336,1444,6,17,3004,5698
20,20311,2,225,237,0,0,464,682
20,20312,56,467,122,5,8,658,1070
20,20313,147,145,178,5,8,483,1305
20,20314,62,72,115,3,7,259,525
20,20315,63,75,222,3,5,368,961
20,20316,3138,4313,6636,42,188,14317,23049
20,20317,26,147,183,2,3,361,748
20,20318,18,50,174,1,7,250,477
20,20319,93,73,62,1,0,229,538
20,20320,7,197,66,11,3,284,528
20,20321,58,238,88,3,6,393,1050
20,20322,1810,4677,8255,43,123,14908,23733
20,20323,387,1510,953,33,33,2916,5267
20,20324,200,570,443,7,13,1233,2399
20,20325,874,2113,1396,7,28,4418,8524
20,20326,143,158,41,3,4,349,603
20,20327,79,144,195,1,3,422,834
20,20328,152,507,501,5,5,1170,2390
20,20329,53,40,162,3,9,267,535
20,20330,21,63,105,2,4,195,309
20,20331,297,219,332,7,61,916,2019
20,20332,1177,5032,7799,34,113,14155,26753
20,20333,223,525,450,8,19,1225,2849
20,20334,152,390,820,6,37,1405,2646
20,20335,137,344,414,3,12,910,1544
20,20336,8,92,130,0,2,232,590
20,20337,144,105,357,14,17,637,1616
20,20338,12,52,35,0,0,99,161
20,20339,167,134,298,4,19,622,1250
20,20340,186,176,192,1,10,565,1478
20,20341,258,578,75,10,1,922,1518
20,20342,38,671,803,5,11,1528,2688
20,20343,63,158,193,2,4,420,1277
20,20344,151,672,275,13,5,1116,2012
20,20345,306,429,1252,9,32,2028,5582
20,20346,133,272,195,8,10,618,1502
20,20347,1785,1183,3544,23,254,6789,9875
20,20348,272,287,165,11,21,756,2100
20,20349,24,521,69,4,0,618,1423
20,20350,102,204,182,5,5,498,2397
20,20351,71,152,251,7,10,491,1400
20,20352,65,129,26,0,3,223,383
20,20353,173,354,50,4,6,587,1245
20,20354,26,94,58,1,2,181,300
20,20355,18,116,130,0,4,268,526
20,20356,112,161,162,7,12,454,1679
20,20357,105,231,48,0,3,387,700
20,20358,135,294,292,11,19,751,1755
20,20359,32,89,176,5,6,308,782
20,20360,206,469,432,16,18,1141,2437
20,20361,55,75,108,0,4,242,715
20,20362,178,162,215,3,6,564,1064
20,20363,193,329,394,5,10,931,1736
20,20364,861,2671,2179,15,57,5783,8653
20,20365,98,213,305,5,16,637,1050
20,20366,91,296,511,7,10,915,2196
20,20367,78,478,440,3,8,1007,2278
20,20368,175,171,218,4,6,574,1147
20,20369,111,156,300,8,12,587,1321
20,20370,22,73,68,0,1,164,268
20,20371,22,101,132,1,3,259,433
20,20372,37,89,225,7,6,364,576
20,20373,29,73,402,9,3,516,1141
20,20374,34,89,90,0,1,214,409
20,20375,22,177,247,1,1,448,701
20,20376,927,823,2018,10,107,3885,5705
20,20377,10,92,36,1,1,140,362
20,20378,157,1295,1823,11,18,3304,5963
20,20379,143,361,500,19,10,1033,2295
20,20380,53,163,439,6,5,666,1641
20,20381,81,155,273,4,7,520,1241
20,20382,86,482,454,0,8,1030,1901
20,20383,13,138,237,1,3,392,727
20,20384,19,117,96,1,2,235,332
20,20385,128,624,171,7,5,935,2736
20,20386,4991,4775,13972,157,748,24643,41226
20,20387,481,923,1776,20,14,3214,8086
20,20388,87,494,696,7,23,1307,2346
20,20389,90,274,151,7,8,530,1288
20,20390,34,84,63,4,3,188,734
20,20391,75,350,210,1,8,644,1176
20,20392,4661,3579,12346,100,682,21368,34181
20,20393,58,402,79,3,6,548,1561
20,20394,110,259,1035,13,9,1426,3638
20,20395,123,443,156,12,6,740,2356
20,20396,6,39,3,0,0,48,71
20,20397,59,188,448,2,6,703,1684
20,20398,47,207,261,6,9,530,1359
20,20399,92,641,157,6,1,897,1728
20,20400,1243,929,3329,41,161,5703,11602
20,20401,57,276,379,2,6,720,1283
20,20402,54,41,208,0,3,306,584
20,20403,163,218,307,7,13,708,1465
20,20404,775,3587,1909,19,32,6322,11391
20,20405,399,1320,811,13,21,2564,3807
20,20406,1249,1809,3087,18,92,6255,11503
20,20407,74,187,163,3,3,430,774
20,20408,199,189,347,5,30,770,1409
20,20409,13,91,72,1,2,179,328
20,20410,806,628,1833,15,125,3407,5453
20,20411,196,376,554,7,5,1138,2083
20,20412,25,105,103,3,11,247,555
20,20413,57,491,255,2,3,808,1733
20,20414,2982,3615,6043,25,146,12811,20151
20,20415,258,1477,1973,16,26,3750,6808
20,20416,167,653,610,2,19,1451,2967
20,20417,18,262,28,3,2,313,416
20,20418,713,917,1948,9,25,3612,6115
20,20419,212,2043,2552,26,19,4852,7896
20,20420,30,23,137,0,2,192,506
20,20421,51,114,162,3,4,334,755
20,20422,56,779,1061,2,6,1904,2926
20,20423,23,51,199,7,1,281,476
20,20424,38,125,89,0,2,254,456
20,20425,315,304,426,15,18,1078,2342
20,20426,56,234,348,2,7,647,1303
20,20427,662,2568,2335,12,36,5613,8849
20,20428,149,1116,801,4,10,2080,3760
20,20429,61,194,239,5,9,508,893
20,20430,164,241,94,1,4,504,1064
20,20431,5,70,44,0,0,119,198
20,20432,30,408,388,1,2,829,1275
20,20433,29,72,145,0,5,251,630
20,20434,19,350,223,0,3,595,1332
20,20435,81,668,309,5,9,1072,2207
20,20436,98,252,155,19,8,532,1459
20,20437,24,140,259,0,4,427,736
20,20438,281,211,843,41,50,1426,4182
20,20439,27,211,124,1,6,369,855
20,20440,1112,2708,2787,12,45,6664,12291
20,20441,18,211,206,0,1,436,668
20,20442,129,1050,1201,0,2,2382,4464
20,20443,29,33,110,2,2,176,281
20,20444,23,65,101,4,3,196,344
20,20445,14,27,89,1,0,131,274
20,20446,10,32,330,1,2,375,812
20,20447,233,482,924,22,35,1696,4192
20,20448,179,1167,2841,23,22,4232,9513
20,20449,42,117,158,1,1,319,856
20,20450,255,280,602,7,17,1161,2641
20,20451,117,727,514,17,18,1393,4868
20,20452,55,195,217,4,7,478,881
20,20453,418,298,249,12,27,1004,3055
20,20454,65,525,802,2,4,1398,2349
20,20455,61,163,194,4,3,425,1601
20,20456,305,392,97,2,0,796,1477
20,20457,248,414,40,0,2,704,1402
20,20458,78,179,612,5,5,879,1791
20,20459,242,710,1049,15,31,2047,3147
20,20460,155,791,361,8,3,1318,2693
20,20461,84,107,328,1,13,533,1149
20,20462,11,57,185,0,2,255,628
20,20463,232,764,510,0,27,1533,2934
20,20464,23,85,189,1,3,301,542
20,20465,37,25,111,0,4,177,337
20,20466,71,274,66,2,1,414,775
20,20467,60,800,2204,9,6,3079,5830
20,20468,437,2175,3769,51,68,6500,11644
20,20469,790,1277,1710,10,21,3808,6605
20,20470,905,2723,3270,45,92,7035,15539
20,20471,132,870,364,2,3,1371,3153
20,20472,16,46,179,0,3,244,341
20,20473,29,876,655,3,10,1573,2252
20,20474,23,73,158,4,2,260,916
20,20475,27,694,725,2,3,1451,2566
20,20476,535,654,897,19,38,2143,5881
20,20477,20,58,57,0,1,136,279
20,20478,98,226,52,4,1,381,900
20,20479,110,351,285,5,6,757,1497
20,20480,19,78,15,1,3,116,173
20,20481,164,1128,1112,2,15,2421,3621
20,20482,15,174,125,1,2,317,640
20,20483,53,89,435,3,9,589,1393
20,20484,1731,4882,10019,57,151,16840,29321
20,20485,513,979,1463,8,53,3016,5509
20,20486,220,672,435,2,11,1340,2836
20,20487,150,443,206,3,11,813,1756
20,20488,131,236,294,2,7,670,1179
20,20489,3,86,10,1,0,100,101
20,20490,186,752,523,1,5,1467,2760
20,20491,32,738,117,0,14,901,1385
20,20492,66,372,507,4,3,952,1771
20,20493,156,274,549,7,10,996,2088
20,20494,39,55,128,3,2,227,381
20,20495,196,486,631,22,20,1355,2606
20,20496,69,290,312,10,15,696,1712
20,20497,115,209,313,1,6,644,1316
20,20498,111,665,412,2,8,1198,2062
20,20499,361,881,450,6,19,1717,3714
20,20500,91,50,560,2,16,719,1288
20,20501,224,802,1255,26,19,2326,4701
20,20502,23,68,203,0,3,297,915
20,20503,257,356,419,15,6,1053,2850
20,20504,23,23,151,1,4,202,330
20,20505,33,57,192,1,2,285,504
20,20506,199,488,299,0,7,993,2075
20,20507,28,405,427,0,4,864,1191
20,20508,95,475,1054,9,7,1640,4741
20,20509,303,1950,1541,2,28,3824,5769
20,20510,9,394,78,0,5,486,528
20,20511,123,603,320,2,6,1054,1764
20,20512,55,127,65,3,5,255,586
20,20513,67,1707,1849,2,7,3632,5308
20,20514,12,119,30,0,1,162,562
20,20515,3246,7664,12270,77,257,23514,38377
20,20516,165,345,654,1,7,1172,2246
20,20517,150,497,196,15,6,864,2394
20,20518,6,61,14,1,1,83,121
20,20519,316,139,366,1,20,842,1963
20,20520,127,483,1512,3,22,2147,5030
20,20521,16,78,47,2,1,144,219
20,20522,24,150,101,1,1,277,657
20,20523,115,108,356,8,8,595,1138
20,20524,4,218,23,0,1,246,359
20,20525,189,2324,1953,5,16,4487,7078
20,20526,156,615,245,8,10,1034,1856
20,20527,65,176,236,1,13,491,1350
20,20528,54,100,545,10,6,715,2222
20,20529,148,66,256,3,6,479,1164
20,20530,259,2677,1576,19,32,4563,8571
20,20531,46,291,183,1,0,521,1349
20,20532,15,19,412,0,2,448,1013
20,20533,21,123,66,2,0,212,572
20,20534,219,1053,1184,10,19,2485,5902
20,20535,39,94,78,1,2,214,418
20,20536,739,1442,1259,22,30,3492,7590
20,20537,284,507,1095,10,30,1926,2986
20,20538,58,127,67,2,8,262,675
20,20539,515,713,1872,10,93,3203,4379
20,20540,225,224,939,13,18,1419,3488
20,20541,31,290,310,1,0,632,1188
20,20542,119,350,622,2,14,1107,2879
20,20543,112,358,409,7,13,899,1535
20,20544,102,181,179,3,12,477,1128
20,20545,524,1449,2150,15,59,4197,5628
20,20546,622,250,1109,18,52,2051,4084
20,20547,25,47,299,2,12,385,747
20,20548,94,125,293,2,6,520,962
20,20549,695,1029,1567,22,54,3367,8383
20,20550,1343,1886,3147,46,155,6577,12041
20,20551,25,31,144,2,2,204,351
20,20552,743,392,1012,24,66,2237,5058
20,20553,992,2917,8197,49,199,12354,22305
20,20554,280,442,407,7,12,1148,3086
20,20555,139,231,480,6,15,871,2038
20,20556,7,28,73,1,6,115,192
20,20557,452,1595,3730,2,28,5807,9302
20,20558,21,278,355,1,6,661,1086
20,20559,87,92,330,1,8,518,991
20,20560,830,939,2329,20,122,4240,5694
20,20561,510,672,525,22,25,1754,4250
20,20562,29,197,293,2,4,525,1370
20,20563,87,352,175,4,7,625,1377
20,20564,51,536,39,0,0,626,1223
20,20565,63,246,55,0,1,365,748
20,20566,1248,1602,5827,47,199,8923,16431
20,20567,59,352,286,12,10,719,1671
20,20568,307,369,168,2,4,850,2296
20,20569,41,315,93,2,5,456,1181
20,20570,1174,1750,4338,63,136,7461,12561
21,21001,5411,3692,5646,123,185,15057,33064
21,21002,1014,854,1334,16,39,3257,5694
21,21003,3147,3380,5512,245,206,12490,25287
21,21004,3878,3080,4974,84,224,12240,24362
21,21005,154,612,122,5,8,901,2126
21,21006,1555,1151,1805,46,29,4586,8027
21,21007,384,541,229,6,7,1167,2421
21,21008,990,640,1275,15,51,2971,5702
21,21009,73,299,431,7,6,816,1796
21,21010,3893,5442,3767,107,115,13324,27075
21,21011,175,338,64,1,2,580,1265
21,21012,1073,734,441,11,34,2293,4707
21,21013,1786,1490,2394,35,27,5732,10413
21,21014,285,730,459,144,17,1635,2939
21,21015,10131,4362,6549,190,555,21787,38824
21,21016,1015,846,682,19,36,2598,4609
21,21017,2225,1561,2334,73,111,6304,11529
21,21018,348,669,306,4,16,1343,2202
21,21019,19794,9508,14162,436,1355,45255,88076
21,21020,304,563,1035,14,24,1940,3736
21,21021,82,290,99,4,2,477,973
21,21022,594,1490,1276,30,21,3411,7650
21,21023,324,951,1420,6,15,2716,5060
21,21024,167,85,127,1,3,383,1040
21,21025,958,886,488,28,16,2376,4525
21,21026,1211,1423,1293,25,86,4038,8823
21,21027,675,864,338,12,15,1904,2939
21,21028,344,356,167,90,2,959,1367
21,21029,2000,2161,1426,32,70,5689,10600
21,21030,130,706,531,161,16,1544,2346
21,21031,184,192,9,1,0,386,650
21,21032,189,438,301,8,13,949,2297
21,21033,119,307,89,11,8,534,1298
21,21034,597,528,258,10,14,1407,2859
21,21035,3814,2120,3405,39,172,9550,18746
21,21036,1402,2196,3013,66,77,6754,11693
21,21037,813,1358,1111,41,20,3343,6608
21,21038,251,484,346,7,20,1108,1894
21,21039,644,583,865,20,25,2137,3890
21,21040,917,1029,760,83,18,2807,5135
21,21041,862,581,642,23,29,2137,4184
21,21042,8726,2555,7006,185,641,19113,33142
21,21043,145,771,405,4,3,1328,2754
21,21044,3807,3553,3958,445,223,11986,25842
21,21045,1805,1488,1634,53,82,5062,9255
21,21046,6478,3841,4435,129,344,15227,26582
21,21047,966,763,357,7,15,2108,3360
21,21048,1728,2381,2202,119,105,6535,14639
21,21049,2292,1669,1694,37,100,5792,11675
21,21050,1221,1660,572,22,33,3508,6773
21,21051,1464,2346,1517,24,34,5385,10539
21,21052,2575,3819,5211,101,190,11896,26402
21,21053,169,282,125,1,10,587,976
21,21054,6481,5027,5770,133,478,17889,31745
21,21055,2892,2420,2124,148,177,7761,13601
21,21056,261,713,866,10,12,1862,3585
21,21057,111,365,64,5,7,552,1357
21,21058,675,906,493,10,13,2097,4248
21,21059,2054,1588,874,19,31,4566,9498
21,21060,253,392,225,11,8,889,1987
21,21061,231,666,714,15,25,1651,3795
21,21062,694,1767,1507,14,14,3996,5918
21,21063,532,724,328,7,25,1616,3493
21,21064,1635,1319,1815,38,64,4871,8430
21,21065,1643,1807,1978,49,33,5510,10161
21,21066,1394,754,2055,30,86,4319,9852
21,21067,362,1212,631,9,16,2230,5374
21,21068,1926,1580,1090,12,68,4676,8641
21,21069,765,1013,303,60,10,2151,4534
21,21070,2197,2937,1739,76,96,7045,18484
21,21071,921,806,749,9,18,2503,4988
21,21072,8063,7341,15161,277,654,31496,56159
21,21073,1161,2548,1927,120,33,5789,9334
21,21074,1024,1238,760,21,39,3082,6869
21,21075,607,782,448,14,16,1867,4396
21,21076,8595,4127,5804,175,463,19164,36044
21,21077,606,1167,1152,34,33,2992,5762
21,21078,3587,3013,2148,50,129,8927,15925
21,21079,354,915,240,380,14,1903,3054
21,21080,941,2048,480,73,17,3559,6299
21,21081,410,539,813,8,37,1807,3201
21,21082,164,396,440,75,3,1078,1653
21,21083,320,589,395,12,12,1328,2870
21,21084,590,856,1104,31,45,2626,4657
21,21085,2953,2480,2526,43,111,8113,15376
21,21086,277,780,762,233,21,2073,3755
21,21087,4665,6665,12158,322,605,24415,51526
21,21088,1049,1431,1465,35,33,4013,7322
21,21089,650,1366,1979,26,18,4039,8321
21,21090,499,630,404,66,18,1617,2894
21,21091,989,1398,1197,13,18,3615,7385
21,21092,2015,921,2364,49,128,5477,10975
21,21093,472,394,2289,23,74,3252,5192
21,21094,182,504,637,11,26,1360,3053
21,21095,765,1086,844,14,22,2731,5938
21,21096,3763,2181,3052,92,228,9316,16762
21,21097,124,114,12,0,1,251,494
21,21098,371,290,190,1,12,864,1645
21,21099,196,337,290,6,10,839,1426
21,21100,191,741,1278,7,21,2238,4447
21,21101,920,1134,729,29,20,2832,5355
21,21102,277,518,299,55,14,1163,2240
21,21103,1343,937,955,15,53,3303,6350
21,21104,293,717,690,3,14,1717,3258
21,21105,2487,1772,1287,50,89,5685,11519
21,21106,548,520,565,22,28,1683,3200
21,21107,1738,1953,2288,43,77,6099,14603
21,21108,1614,2082,414,136,21,4267,7008
21,21109,1961,1118,1376,31,65,4551,8477
21,21110,632,2086,2840,28,25,5611,10886
21,21111,4206,2032,3730,53,156,10177,20330
21,21112,1127,2301,2686,54,38,6206,11627
21,21113,643,1200,1175,29,45,3092,6238
21,21114,209,820,943,14,16,2002,4197
21,21115,295209,106608,202683,5990,24889,635379,1022157
21,21116,3862,2560,4943,58,192,11615,22929
21,21117,2384,2486,566,14,18,5468,9975
21,21118,2245,1654,1090,43,138,5170,9370
21,21119,1619,1033,2642,48,98,5440,12045
21,21120,15453,3854,8401,204,892,28804,47963
21,21121,108,587,692,13,3,1403,2579
21,21122,105,184,163,7,4,463,807
21,21123,802,923,1036,69,67,2897,5760
21,21124,267,259,626,121,8,1281,2537
21,21125,1379,1765,2297,21,37,5499,8930
21,21126,1886,335,462,27,65,2775,5269
21,21127,392,457,538,14,19,1420,3239
21,21128,168,807,692,27,29,1723,3013
21,21129,559,687,767,19,30,2062,4184
21,21130,1102,1218,1979,10,16,4325,7553
21,21131,578,414,412,12,17,1433,2696
21,21132,117,145,54,6,3,325,712
21,21133,20524,10043,17431,526,1711,50235,85803
21,21134,12,126,132,4,2,276,544
21,21135,2366,1529,1844,58,253,6050,11578
21,21136,69,177,46,0,1,293,490
21,21137,1741,971,1116,34,142,4004,6858
21,21138,998,1073,748,18,24,2861,5347
21,21139,555,1078,1577,30,46,3286,6665
21,21140,77,579,818,7,7,1488,2720
21,21141,19986,6196,13782,506,1358,41828,71577
21,21142,414,666,352,9,12,1453,2728
21,21143,2611,1605,3514,63,220,8013,15323
21,21144,3091,1620,2869,87,208,7875,15277
21,21145,1133,855,1540,18,32,3578,6395
21,21146,67,186,121,2,8,384,687
21,21147,625,958,482,29,28,2122,4049
21,21148,757,699,845,19,40,2360,5873
21,21149,1813,1762,1822,33,68,5498,9486
21,21150,807,427,1293,8,52,2587,4790
21,21151,1024,1049,793,16,31,2913,7171
21,21152,2619,1673,2478,63,119,6952,11480
21,21153,5959,2986,11120,102,485,20652,37359
21,21154,288,993,525,10,19,1835,4402
21,21155,34643,21531,29428,768,2429,88799,158995
21,21156,848,1809,1450,55,25,4187,9577
21,21157,625,771,909,19,27,2351,4729
21,21158,509,901,206,11,7,1634,3674
21,21159,303,451,274,18,19,1065,2378
21,21160,1594,1994,1999,55,96,5738,10593
21,21161,476,488,394,150,5,1513,2492
21,21162,1196,1005,1622,20,62,3905,9665
21,21163,8770,4822,7306,223,468,21589,40964
21,21164,25,166,49,2,2,244,683
21,21165,548,933,837,33,45,2396,6247
21,21166,930,1023,510,133,24,2620,5348
21,21167,158,769,868,15,8,1818,4032
21,21168,1399,2929,2141,57,138,6664,12087
21,21169,2066,1767,1369,29,53,5284,9328
21,21170,290,274,635,8,19,1226,1980
21,21171,2540,2765,2420,43,146,7914,15286
21,21172,675,591,818,38,41,2163,3326
21,21173,16086,6744,9234,228,1096,33388,57256
21,21174,1004,1174,656,16,27,2877,6433
21,21175,734,980,1122,29,39,2904,5949
21,21176,3864,3337,4453,72,187,11913,23702
21,21177,1627,1736,598,20,19,4000,6575
21,21178,1650,1780,1573,40,24,5067,9308
21,21179,3858,1845,2191,89,131,8114,15835
21,21180,3317,2656,3847,64,217,10101,20681
21,21181,528,495,543,16,36,1618,3556
21,21182,393,318,662,13,18,1404,2636
21,21183,2890,2587,741,19,33,6270,10275
21,21184,1165,730,196,70,12,2173,3485
21,21185,737,699,819,13,33,2301,5592
21,21186,5666,4181,4998,193,458,15496,29723
21,21187,776,929,286,4,14,2009,3478
21,21188,1376,2272,936,25,33,4642,10399
21,21189,1689,726,2720,27,111,5273,10818
21,21190,71,224,181,11,5,492,791
21,21191,420,1398,1137,17,44,3016,7009
21,21192,798,728,415,79,15,2035,3615
21,21193,1026,1028,221,5,3,2283,4167
21,21194,2576,2265,3281,108,133,8363,16835
21,21195,1767,2681,1438,33,39,5958,11592
21,21196,118,266,321,13,6,724,1273
21,21197,9480,5581,7505,246,440,23252,41748
21,21198,142,303,26,2,1,474,942
21,21199,4585,3043,2225,59,183,10095,18704
21,21200,170,360,555,120,20,1225,2605
21,21201,357,352,241,5,5,960,2425
21,21202,1085,960,607,383,35,3070,6802
21,21203,366,675,525,14,19,1599,3238
21,21204,285,708,1077,42,42,2154,4059
21,21205,2531,1316,2485,20,83,6435,11441
21,21206,425,587,360,7,14,1393,3015
21,21207,4143,3786,5551,547,328,14355,28048
21,21208,8881,5824,8074,293,696,23768,43675
21,21209,858,936,1017,35,53,2899,5446
21,21210,506,521,815,77,11,1930,3275
21,21211,1773,1274,2363,89,185,5684,8934
21,21212,1293,1672,2080,242,60,5347,11141
21,21213,1192,1050,1900,35,37,4214,7352
21,21214,1894,1898,1434,43,52,5321,9055
21,21215,745,715,336,23,5,1824,2838
21,21216,240,350,140,37,9,776,1591
21,21217,850,1500,2494,38,34,4916,9784
22,22001,6036,5366,6545,361,328,18636,35457
22,22002,1304,1667,2110,29,36,5146,9198
22,22003,8955,6377,4560,308,353,20553,37815
22,22004,9929,4767,3113,227,498,18534,30112
22,22005,22259,8126,9586,231,1049,41251,62605
22,22006,5608,3024,3193,294,331,12450,21065
22,22007,5876,2840,913,56,106,9791,18331
22,22008,4296,2714,1849,71,151,9081,15368
22,22009,3408,2124,1501,23,53,7109,12322
22,22010,12882,9363,7283,187,522,30237,48900
22,22011,11163,5359,6214,168,406,23310,34332
22,22012,1715,2529,2244,10,56,6554,10948
22,22013,4279,2679,2023,22,50,9053,16118
22,22014,168315,53030,75660,1923,9427,308355,485333
22,22015,1106,1325,414,23,39,2907,5083
22,22016,40264,14709,23363,1642,2306,82284,138688
22,22017,11413,4490,7270,359,670,24202,36288
22,22018,3836,2680,2432,91,144,9183,14580
23,23001,56941,32109,75361,894,5025,170330,328009
23,23002,14030,11244,6106,162,620,32162,50432
23,23003,2216,10020,13110,288,186,25820,36969
23,23004,1156,2127,2512,28,75,5898,10381
23,23005,2423,6510,4697,112,68,13810,19072
23,23006,1485,4166,3458,52,37,9198,13504
23,23007,25536,28170,28241,1116,2172,85235,146707
23,23008,7627,10726,14306,114,615,33388,70659
24,24001,3009,1933,943,61,125,6071,11410
24,24002,1159,1257,573,106,43,3138,5686
24,24003,8427,4013,2063,28,94,14625,23881
24,24004,1080,704,192,17,41,2034,3460
24,24005,2543,1972,2580,102,160,7357,13512
24,24006,1756,1356,779,11,17,3919,6200
24,24007,2801,1668,1593,93,290,6445,11743
24,24008,3849,3345,1562,45,96,8897,15851
24,24009,920,279,555,10,51,1815,2465
24,24010,5091,5376,1272,25,78,11842,20961
24,24011,6543,4204,2698,895,300,14640,27862
24,24012,2687,1803,3601,31,75,8197,12280
24,24013,30785,10339,19481,794,1366,62765,108406
24,24014,2198,2122,2184,10,41,6555,10409
24,24015,3103,3018,1587,57,133,7898,14086
24,24016,5559,3773,5668,78,186,15264,27151
24,24017,4252,4225,601,21,52,9151,17022
24,24018,3012,1629,1273,19,36,5969,8838
24,24019,1039,705,681,6,18,2449,4811
24,24020,17712,7726,6324,258,857,32877,59859
24,24021,7868,5542,2741,140,314,16605,30989
24,24022,3085,1651,1349,143,179,6407,12209
24,24023,2451,2108,1346,20,72,5997,11855
24,24024,17486,9257,6240,193,655,33831,65526
24,24025,4833,3067,1371,72,135,9478,17254
24,24026,2012,1378,584,6,15,3995,5349
24,24027,1979,1788,564,16,53,4400,8133
24,24028,172103,37812,57854,1903,11451,281123,487975
24,24029,3553,2216,3151,16,39,8975,13674
24,24030,1154,970,706,14,26,2870,5080
24,24031,2816,1675,1301,93,103,5988,9126
24,24032,976,1004,1101,6,24,3111,6358
24,24033,6324,4262,1797,70,226,12679,24461
24,24034,2433,1563,1329,89,61,5475,9297
24,24035,39611,10623,16499,840,3452,71025,132835
24,24036,4960,3333,2152,45,152,10642,18689
24,24037,7277,9040,13988,192,362,30859,56116
24,24038,2162,1906,2237,18,435,6758,9823
24,24039,2612,1366,1478,27,165,5648,8471
24,24040,7463,2636,4009,122,178,14408,23751
24,24041,2501,1747,2447,629,38,7362,10225
24,24042,3555,2050,731,15,26,6377,8938
24,24043,1836,1298,274,22,40,3470,6453
24,24044,1165,1536,232,18,11,2962,4913
24,24045,1956,2425,1150,82,102,5715,9709
24,24046,2686,1840,920,12,23,5481,8910
24,24047,2062,1676,1856,54,97,5745,9327
24,24048,1820,943,543,220,33,3559,7175
24,24049,916,905,424,7,42,2294,3714
24,24050,4300,4137,3412,126,114,12089,22391
24,24051,9107,4751,1370,67,153,15448,25702
24,24052,3111,2409,511,22,50,6103,10790
24,24053,2105,1955,244,8,21,4333,8622
24,24054,5149,2307,3904,86,248,11694,19826
24,24055,6421,6346,2761,38,124,15690,28582
24,24056,3913,2363,1164,103,197,7740,13561
24,24057,3654,2879,1182,50,65,7830,12607
24,24058,4962,1344,3678,106,92,10182,16872
25,25001,53786,40539,42453,868,3286,140932,250670
25,25002,4177,7320,8537,59,193,20286,32357
25,25003,2450,6329,1327,22,44,10172,20686
25,25004,4544,4343,1783,27,84,10781,18650
25,25005,2375,2678,614,11,34,5712,11365
25,25006,115546,69117,91109,2374,7348,285494,516819
25,25007,5319,4269,1234,48,37,10907,21458
25,25008,4547,5844,2505,41,130,13067,23479
25,25009,7379,5136,4792,293,241,17841,32356
25,25010,11205,12344,10542,366,378,34835,64272
25,25011,29184,29135,42866,1029,1531,103745,182650
25,25012,59310,26811,54352,986,5427,146886,277726
25,25013,6290,7455,4432,66,177,18420,34867
25,25014,5932,5515,5426,95,244,17212,32173
25,25015,11592,9670,8976,162,544,30944,53166
25,25016,3113,3579,1458,30,51,8231,16351
25,25017,15385,9813,6670,55,202,32125,56811
25,25018,21041,13636,12495,185,660,48017,85414
26,26001,822,479,162,17,16,1496,1922
26,26002,11865,8242,6330,147,492,27076,50683
26,26003,1635,549,1153,11,40,3388,5158
26,26004,403,273,151,5,3,835,1071
26,26005,951,580,244,24,2,1801,2561
26,26006,295,202,68,0,4,569,679
26,26007,443,213,80,7,3,746,954
26,26008,574,300,110,3,13,1000,1271
26,26009,420,284,51,4,5,764,1038
26,26010,422,125,295,10,14,866,1233
26,26011,540,293,85,6,8,932,1192
26,26012,1318,772,220,6,19,2335,2852
26,26013,435,91,219,5,7,757,1063
26,26014,1459,388,482,22,50,2401,4043
26,26015,5154,2030,5283,81,348,12896,23831
26,26016,380,246,44,2,1,673,887
26,26017,1737,972,252,28,33,3022,5024
26,26018,379,246,42,6,6,679,800
26,26019,1646,998,684,16,36,3380,5417
26,26020,526,373,93,14,10,1016,1212
26,26021,403,205,33,4,3,648,918
26,26022,256,315,28,14,12,625,811
26,26023,507,238,73,20,14,852,1024
26,26024,2246,1028,820,61,59,4214,7742
26,26025,5439,2362,3025,106,240,11172,20816
26,26026,1494,729,221,26,26,2496,3484
26,26027,1478,754,490,13,30,2765,4015
26,26028,513,406,52,4,5,980,1395
26,26029,2078,943,1958,34,246,5259,9303
26,26030,38550,12361,11831,382,1458,64582,144502
26,26031,102,130,82,0,4,318,426
26,26032,1457,1122,359,17,32,2987,4604
26,26033,238,88,28,3,7,364,428
26,26034,211,99,55,2,4,371,448
26,26035,843,561,80,5,32,1521,1835
26,26036,3806,2146,1262,53,118,7385,11103
26,26037,297,264,125,2,16,704,1168
26,26038,676,534,158,4,11,1383,2017
26,26039,823,442,226,12,8,1511,1906
26,26040,577,273,140,0,12,1002,1291
26,26041,268,263,337,1,9,878,1337
26,26042,439,310,92,1,1,843,1277
26,26043,493,364,139,3,3,1002,1405
26,26044,433,472,158,4,5,1072,1503
26,26045,638,283,193,5,19,1138,1369
26,26046,14390,4356,5506,177,915,25344,48584
26,26047,1120,514,254,19,31,1938,3193
26,26048,1072,389,177,4,7,1649,2001
26,26049,160818,40104,43439,2172,7210,253743,445899
26,26050,374,315,326,3,1,1019,1269
26,26051,736,257,389,1,7,1390,2094
26,26052,1760,856,925,28,76,3645,5537
26,26053,8393,4349,3528,158,476,16904,29933
26,26054,770,437,112,2,5,1326,1589
26,26055,27141,11486,14531,539,1527,55224,123158
26,26056,1083,418,421,7,13,1942,3871
26,26057,2678,1305,650,90,77,4800,7537
26,26058,2235,1726,4515,60,273,8809,15239
26,26059,67751,19591,47065,932,4850,140189,261464
26,26060,5508,3581,9774,184,628,19675,35675
26,26061,19058,7968,19328,296,1420,48070,93546
26,26062,4099,2844,2051,90,56,9140,16793
26,26063,8565,5718,8660,141,196,23280,37905
26,26064,11112,6569,13480,150,413,31724,51541
26,26065,23733,10707,18878,498,1133,54949,100816
26,26066,132,136,204,0,8,480,557
26,26067,953,658,294,14,10,1929,2589
26,26068,1043,856,498,19,18,2434,4246
26,26069,1430,1089,222,4,19,2764,3836
26,26070,1985,1594,1493,36,94,5202,8710
26,26071,3271,1818,2918,29,130,8166,13677
26,26072,1041,1344,2331,69,96,4881,8447
27,27001,1340,11404,9139,69,67,22019,36442
27,27002,3261,27667,59924,202,405,91459,143427
27,27003,917,18577,20227,163,124,40008,58048
27,27004,12105,96151,152072,457,2014,262799,400611
27,27005,2050,30354,48457,122,253,81236,114301
27,27006,1945,17509,27583,251,153,47441,70459
27,27007,704,6117,6602,21,54,13498,18985
27,27008,2019,27879,32284,141,256,62579,102797
27,27009,451,8268,7593,29,49,16390,23805
27,27010,942,13474,21614,52,68,36150,47554
27,27011,221,6363,7777,11,17,14389,18689
27,27012,1534,22447,40692,142,257,65072,95872
27,27013,811,15477,26542,68,128,43026,58338
27,27014,888,16165,20995,50,137,38235,50558
27,27015,582,7657,9170,27,54,17490,25967
27,27016,1006,8466,10924,46,124,20566,32544
27,27017,1175,10526,11078,55,100,22934,36897
28,28001,2207,1667,1249,34,21,5178,8814
28,28002,6045,3351,2536,175,72,12179,19588
28,28003,24231,14641,12990,498,1134,53494,98192
28,28004,1482,1359,731,26,31,3629,6525
28,28005,821,1197,351,6,6,2381,4234
28,28006,718,2090,229,24,6,3067,5193
28,28007,1814,1963,2112,56,75,6020,13780
28,28008,709,1081,263,6,9,2068,3369
28,28009,36595,20327,29159,874,2546,89501,148944
28,28010,293,843,187,0,2,1325,2130
28,28011,1935,1522,1035,48,28,4568,6322
28,28012,7419,6058,2840,144,148,16609,29736
28,28013,2051,3388,1355,62,40,6896,10658
28,28014,624,416,565,8,9,1622,3409
28,28015,1799,2051,2146,73,60,6129,14248
28,28016,3543,4263,2457,115,66,10444,17553
28,28017,2097,2770,979,135,27,6008,9635
28,28018,1317,1252,863,46,31,3509,6447
28,28019,2869,3232,1777,94,35,8007,13167
28,28020,387,897,95,13,8,1400,2330
28,28021,18725,11922,16400,580,737,48364,85988
28,28022,70742,42132,44786,1410,3798,162868,347197
28,28023,732,1016,734,9,10,2501,4088
28,28024,996,763,820,15,31,2625,5616
28,28025,3493,2943,3850,98,138,10522,19993
28,28026,322,871,211,12,1,1417,2292
28,28027,55160,33998,28890,1209,3598,122855,263283
28,28028,395,602,385,6,8,1396,2239
28,28029,2140,2327,1103,89,34,5693,9908
28,28030,2092,2208,1402,145,123,5970,10133
28,28031,237,398,131,31,1,798,1394
28,28032,88053,38622,52224,1161,3861,183921,379235
28,28033,13939,10594,18370,386,1397,44686,85573
28,28034,1241,1878,749,57,15,3940,6857
28,28035,7187,7641,8919,257,188,24192,41950
28,28036,125,413,11,0,0,549,879
28,28037,3406,3761,2218,114,46,9545,16584
28,28038,70969,30481,32126,1211,3665,138452,233921
28,28039,2638,5527,1157,224,67,9613,18804
28,28040,12595,6348,5325,246,410,24924,46894
28,28041,46016,33459,37796,2640,2448,122359,195608
28,28042,708,1716,481,26,5,2936,5049
28,28043,4858,3820,2292,57,79,11106,16379
29,29001,1122,662,1789,22,105,3700,5821
29,29002,2103,732,2444,66,172,5517,8872
29,29003,12413,4076,13418,224,1375,31506,53052
29,29004,792,458,913,18,52,2233,3772
29,29005,2869,1005,1968,57,134,6033,9463
29,29006,5340,1768,8552,90,504,16254,26687
29,29007,1536,615,1605,37,90,3883,8505
29,29008,1652,705,1976,27,80,4440,7435
29,29009,865,374,736,18,23,2016,3269
29,29010,9566,3587,11022,202,809,25186,43147
29,29011,581,235,754,6,28,1604,2789
29,29012,919,394,1377,35,48,2773,4994
29,29013,10356,4112,9972,202,843,25485,46391
29,29014,1872,486,2046,52,79,4535,9185
29,29015,3864,1872,5193,144,278,11351,22920
29,29016,780,316,1345,33,90,2564,4513
29,29017,822,435,1473,5,50,2785,5499
29,29018,3659,1620,5681,81,320,11361,20047
29,29019,2025,722,2813,94,140,5794,10770
29,29020,1340,316,1087,14,50,2807,5132
29,29021,2276,676,2603,46,160,5761,10753
29,29022,732,333,1043,5,27,2140,3274
29,29023,2979,1012,3126,115,193,7425,14974
29,29024,2417,1455,4913,117,244,9146,16685
29,29025,8071,3944,8056,117,546,20734,37219
29,29026,2290,875,2485,31,132,5813,9500
29,29027,705,831,1781,27,40,3384,7759
29,29028,2144,1405,3213,47,230,7039,12720
29,29029,1268,560,1909,37,94,3868,7022
29,29030,1436,740,1883,28,71,4158,7729
29,29031,3466,1133,3322,54,259,8234,14981
29,29032,1365,537,1732,72,86,3792,7799
29,29033,12492,5230,15794,330,1238,35084,55477
29,29034,4420,2434,5905,107,283,13149,24131
29,29035,607,280,811,15,36,1749,3323
29,29036,2362,1223,4082,109,227,8003,13081
29,29037,852,686,1362,44,43,2987,6164
29,29038,1284,570,1849,31,92,3826,6940
29,29039,1886,1168,3413,59,160,6686,12631
29,29040,1277,426,1612,14,78,3407,6248
29,29041,2146,1721,4608,68,215,8758,15912
29,29042,1656,613,2263,40,135,4707,8401
29,29043,3211,1012,3459,57,280,8019,14886
29,29044,4117,1549,7779,106,398,13949,25049
29,29045,338,170,704,21,13,1246,2866
29,29046,360,255,816,6,33,1470,3420
29,29047,426,152,946,14,29,1567,3959
29,29048,607,455,1588,29,55,2734,5455
29,29049,340,191,490,5,21,1047,2404
29,29050,477,480,1015,9,35,2016,3419
29,29051,1271,599,1676,27,64,3637,6564
29,29052,2014,708,2430,35,113,5300,9345
29,29053,530,259,838,54,39,1720,3273
29,29054,608,196,651,4,18,1477,2321
29,29055,394,123,337,11,18,883,1628
29,29056,333,287,566,47,33,1266,2603
29,29057,363,130,502,15,32,1042,2005
29,29058,913,291,1053,16,20,2293,4261
29,29059,440,204,849,23,35,1551,2850
29,29060,713,262,801,7,33,1816,3185
30,30001,1041,765,864,21,41,2732,4679
30,30002,616,267,245,3,6,1137,1930
30,30003,11179,8078,11972,100,418,31747,55934
30,30004,6269,4096,5698,103,342,16508,30632
30,30005,731,1137,420,2,17,2307,3829
30,30006,1685,1744,2554,58,89,6130,10840
30,30007,958,1337,502,41,13,2851,4380
30,30008,10178,8394,16524,385,542,36023,65405
30,30009,1165,1286,400,15,26,2892,5065
30,30010,3563,2891,4765,41,159,11419,20498
30,30011,4512,5359,5963,128,388,16350,30900
30,30012,8323,7643,3354,101,406,19827,34911
30,30013,1394,1100,832,13,29,3368,5721
30,30014,5786,4062,5785,81,243,15957,26603
30,30015,3561,3428,4103,55,171,11318,17360
30,30016,4502,3882,4651,52,130,13217,23560
30,30017,4627,3234,3596,155,314,11926,20019
30,30018,438,676,594,3,35,1746,2961
30,30019,324,232,173,0,1,730,1255
30,30020,792,707,233,6,9,1747,3127
30,30021,917,909,1540,10,20,3396,4823
30,30022,3064,2445,3620,55,92,9276,15851
30,30023,2368,2651,2074,25,84,7202,11118
30,30024,7755,5212,3427,50,89,16533,29278
30,30025,1947,1447,1126,74,63,4657,8368
30,30026,2328,2531,1405,70,47,6381,12438
30,30027,2457,1681,3482,49,348,8017,12731
30,30028,1280,2253,2088,20,38,5679,9711
30,30029,37102,14549,16018,290,1815,69774,111665
30,30030,1282,1308,725,17,47,3379,6090
30,30031,3899,2743,7085,142,356,14225,21616
30,30032,2153,1701,2059,53,90,6056,9973
30,30033,2037,2503,2820,68,53,7481,12355
30,30034,4598,3506,8002,55,267,16428,30415
30,30035,3634,3936,1939,49,56,9614,15398
30,30036,2774,2403,4963,60,246,10446,17407
30,30037,2063,2053,507,7,28,4658,6947
30,30038,1133,847,1125,43,35,3183,4968
30,30039,771,918,862,5,20,2576,4201
30,30040,11471,7675,13549,299,1311,34305,55264
30,30041,26793,22510,66157,375,2551,118386,201990
30,30042,6047,3640,7062,180,326,17255,29668
30,30043,228,339,311,1,1,880,1252
30,30044,690,723,838,7,19,2277,4305
30,30045,3151,2334,545,137,31,6198,10878
30,30046,35178,17811,28627,439,2349,84404,133612
30,30047,7708,7465,8165,136,473,23947,41909
30,30048,2694,1146,1440,44,114,5438,9720
30,30049,4487,5690,2331,82,256,12846,24885
30,30050,9196,8340,22781,107,557,40981,66653
30,30051,3085,2128,2826,22,76,8137,13821
30,30052,2165,1241,1667,18,27,5118,9290
30,30053,1124,3006,3483,11,28,7652,13092
30,30054,1281,1315,1805,16,53,4470,7821
30,30055,3478,2320,3707,68,188,9761,18170
30,30056,1026,2327,2086,7,36,5482,8784
30,30057,1630,945,2482,18,32,5107,8908
30,30058,823,666,1081,5,17,2592,4250
30,30059,1817,1010,1100,19,40,3986,7808
30,30060,4642,5570,8977,102,266,19557,36589
30,30061,1538,1820,2781,12,57,6208,11136
30,30062,1913,1861,1242,12,26,5054,8463
30,30063,7236,6611,8074,95,257,22273,47572
30,30064,1940,2290,2004,41,87,6362,10426
30,30065,2812,2864,490,4,24,6194,8785
30,30066,323,386,566,9,4,1288,2305
30,30067,7370,4500,7135,157,523,19685,32933
30,30068,1759,2735,4152,25,59,8730,15950
30,30069,1617,1571,1184,4,7,4383,6383
30,30070,9607,4807,8523,152,709,23798,36919
30,30071,2431,1842,4963,56,152,9444,17326
30,30072,2645,1979,1688,13,40,6365,11027
30,30073,8197,5310,4194,994,497,19192,31287
30,30074,1353,2375,2898,85,75,6786,11545
30,30075,4316,4136,5904,51,126,14533,26195
30,30076,1037,615,1001,13,46,2712,4174
30,30077,2743,3107,987,28,45,6910,12301
30,30078,1915,1062,988,15,20,4000,8001
30,30079,6156,3719,3018,43,135,13071,25398
30,30080,2088,2693,603,15,25,5424,8039
30,30081,1603,1083,465,13,20,3184,6003
30,30082,3077,4718,7627,116,131,15669,29222
30,30083,2145,1995,2327,135,111,6713,12328
30,30084,912,1507,3678,15,37,6149,9519
30,30085,1478,1508,1549,27,138,4700,9145
30,30086,1036,1050,592,16,36,2730,4715
30,30087,8978,5215,8712,149,412,23466,36858
30,30088,3770,2494,3209,80,197,9750,19065
30,30089,62341,35195,81062,1263,9006,188867,299547
30,30090,301,546,1079,1,14,1941,3547
30,30091,4136,4666,7994,38,199,17033,27052
30,30092,1988,1357,581,28,38,3992,7195
30,30093,2635,2871,3326,29,76,8937,17663
30,30094,1493,1838,1570,36,85,5022,9287
30,30095,5875,5429,1874,32,98,13308,22971
30,30096,1673,2070,2165,25,47,5980,11903
30,30097,424,396,64,1,5,890,1611
30,30098,3053,2151,2464,73,105,7846,14887
30,30099,271,502,322,0,1,1096,1392
30,30100,1598,1194,1516,28,182,4518,9583
30,30101,3308,2742,2372,81,89,8592,15118
30,30102,2914,2566,4334,58,242,10114,17610
30,30103,13463,7841,11741,402,776,34223,65221
30,30104,1025,915,1096,3,7,3046,5677
30,30105,1156,2251,2340,41,35,5823,9236
30,30106,6639,3851,3462,89,273,14314,26477
30,30107,454,299,605,3,4,1365,2600
30,30108,251,324,298,2,7,882,1657
30,30109,15708,16521,35941,222,1042,69434,113687
30,30110,8329,5608,8082,747,289,23055,43163
30,30111,796,1422,233,20,26,2497,5134
30,30112,893,2096,3310,22,62,6383,11204
30,30113,3508,1613,2613,52,172,7958,12628
30,30114,516,714,498,7,11,1746,2648
30,30115,832,1204,1662,42,55,3795,7255
30,30116,5178,3589,8414,115,421,17717,29426
30,30117,1808,1206,2217,10,43,5284,9252
30,30118,2785,2945,2761,49,159,8699,15136
30,30119,26364,8519,25590,424,1811,62708,93749
30,30120,603,712,928,10,28,2281,4177
30,30121,821,1431,2213,5,18,4488,7181
30,30122,3936,2779,936,54,52,7757,15460
30,30123,1849,1941,1839,40,48,5717,8658
30,30124,13185,9901,10763,227,506,34582,64153
30,30125,16502,13250,27660,315,847,58574,103994
30,30126,2032,3888,5742,88,155,11905,18991
30,30127,5308,2859,4167,121,168,12623,22019
30,30128,1354,2892,812,22,42,5122,9586
30,30129,7361,6710,5970,148,522,20711,35896
30,30130,2524,1815,2283,25,38,6685,11426
30,30131,5771,4961,4042,28,148,14950,26704
30,30132,32209,16043,30324,463,1746,80785,132254
30,30133,7830,4164,6307,174,345,18820,35515
30,30134,2724,2166,2795,64,149,7898,13786
30,30135,2955,1737,1905,29,64,6690,9455
30,30136,821,804,789,14,39,2467,3965
30,30137,2200,1201,1980,36,195,5612,9737
30,30138,704,841,189,17,9,1760,2630
30,30139,6461,3487,8754,136,555,19393,31339
30,30140,762,666,968,11,13,2420,4476
30,30141,353,396,176,2,1,928,1341
30,30142,14144,14744,20798,211,714,50611,98455
30,30143,4196,3278,3710,27,67,11278,21927
30,30144,4811,7554,8515,61,167,21108,37703
30,30145,2715,3354,4918,24,71,11082,19288
30,30146,1072,1784,1662,7,38,4563,7299
30,30147,690,483,187,19,12,1391,1990
30,30148,689,2495,3652,26,37,6899,9951
30,30149,4808,2926,2930,96,96,10856,19473
30,30150,2992,3794,3258,102,76,10222,15676
30,30151,1807,2396,429,4,21,4657,7044
30,30152,3221,3693,2362,67,96,9439,16103
30,30153,2236,1264,1257,19,49,4825,8885
30,30154,685,791,1166,7,14,2663,4056
30,30155,2610,1986,616,7,24,5243,8379
30,30156,18251,10086,7182,92,256,35867,56449
30,30157,790,477,334,4,21,1626,2862
30,30158,2435,2974,5282,43,127,10861,16938
30,30159,1438,1904,1999,27,40,5408,10105
30,30160,4519,3680,4556,32,409,13196,23193
30,30161,948,990,270,40,11,2259,3886
30,30162,723,779,482,3,8,1995,3514
30,30163,1854,1370,2610,32,175,6041,10449
30,30164,1574,864,741,34,16,3229,4992
30,30165,1185,1014,872,17,65,3153,5999
30,30166,1566,1839,2164,46,57,5672,8638
30,30167,1224,1602,1204,13,41,4084,7062
30,30168,4027,2078,2471,20,72,8668,16609
30,30169,285,1391,1860,44,9,3589,5385
30,30170,959,556,296,13,13,1837,3020
30,30171,3224,1786,2638,25,33,7706,12994
30,30172,5496,5321,6679,56,184,17736,31560
30,30173,14362,8761,12408,276,610,36417,64639
30,30174,11530,7295,9565,223,409,29022,54257
30,30175,481,686,768,3,7,1945,3394
30,30176,1147,922,1342,14,36,3461,5524
30,30177,2899,1446,1795,33,91,6264,10463
30,30178,726,616,271,18,9,1640,2392
30,30179,786,1142,1978,17,21,3944,6987
30,30180,5755,4308,3991,54,156,14264,26068
30,30181,1373,1160,1415,34,136,4118,7942
30,30182,6616,3590,5787,165,443,16601,34274
30,30183,644,757,681,14,9,2105,3583
30,30184,732,462,683,1,22,1900,2564
30,30185,1198,721,645,19,61,2644,4328
30,30186,594,338,515,2,10,1459,2995
30,30187,3041,2346,891,108,41,6427,10001
30,30188,19085,11780,17006,446,1431,49748,92077
30,30189,252,400,391,3,10,1056,1755
30,30190,4242,3343,4513,116,293,12507,22018
30,30191,2244,2365,2118,30,66,6823,13762
30,30192,111926,40520,56146,1103,6288,215983,364122
30,30193,1235,685,945,17,49,2931,5291
30,30194,2538,3398,5535,112,263,11846,19841
30,30195,382,886,535,2,10,1815,2564
30,30196,2061,1781,3232,37,114,7225,13312
30,30197,1362,1037,1884,45,22,4350,8830
30,30198,769,479,1453,7,13,2721,4469
30,30199,360,1591,2111,6,3,4071,5635
30,30200,2678,2045,842,87,43,5695,8545
30,30201,3772,4230,3173,228,142,11545,24703
30,30202,914,861,1899,11,39,3724,7471
30,30203,2171,1636,840,6,16,4669,7540
30,30204,5996,4451,6153,103,211,16914,30992
30,30205,1276,4306,7982,29,174,13767,19415
30,30206,2361,4131,13400,42,219,20153,31048
30,30207,1808,2849,2583,60,81,7381,12874
30,30208,3240,2812,2501,34,141,8728,16304
30,30209,3284,2738,1944,12,65,8043,14119
30,30210,699,2346,2142,18,27,5232,7886
30,30211,5323,2875,2805,70,131,11204,20353
30,30212,1265,1190,1356,3,21,3835,7355
31,31001,1773,837,243,8,5,2866,3887
31,31002,2360,2954,693,41,60,6108,9309
31,31003,1446,1661,489,14,13,3623,5960
31,31004,1017,1255,314,25,17,2628,3896
31,31005,516,574,40,1,5,1136,1560
31,31006,2048,1804,312,27,7,4198,5762
31,31007,1251,847,464,9,9,2580,4600
31,31008,572,681,619,5,4,1881,2688
31,31009,1118,622,479,40,15,2274,3482
31,31010,456,456,30,3,0,945,1273
31,31011,730,958,570,26,19,2303,3835
31,31012,848,820,50,8,8,1734,2922
31,31013,1804,1618,396,24,39,3881,5665
31,31014,398,373,31,0,2,804,964
31,31015,835,949,194,14,7,1999,2952
31,31016,521,542,24,0,0,1087,1431
31,31017,1147,1100,46,2,0,2295,2751
31,31018,634,619,136,4,5,1398,2171
31,31019,6057,3490,1459,5,17,11028,14834
31,31020,779,837,118,11,16,1761,2596
31,31021,1468,1317,293,5,7,3090,4232
31,31022,1023,881,7,1,0,1912,2309
31,31023,796,1106,211,4,11,2128,2897
31,31024,622,460,141,0,7,1230,2070
31,31025,1118,872,168,1,5,2164,3073
31,31026,706,972,229,6,11,1924,2565
31,31027,1479,1531,807,56,30,3903,5766
31,31028,501,523,186,6,5,1221,1623
31,31029,1229,999,747,10,13,2998,4068
31,31030,769,822,77,6,3,1677,2339
31,31031,760,789,41,3,2,1595,2128
31,31032,3100,1881,800,9,29,5819,8090
31,31033,2793,3524,1821,74,48,8260,11704
31,31034,1230,940,280,13,13,2476,3924
31,31035,1464,883,183,8,8,2546,4049
31,31036,1369,1104,576,16,15,3080,4556
31,31037,993,738,138,5,9,1883,3152
31,31038,6003,3899,971,61,128,11062,17688
31,31039,708,745,159,9,13,1634,2323
31,31040,4286,4881,1638,101,126,11032,16748
31,31041,7804,7958,2881,158,310,19111,32810
31,31042,950,874,158,5,9,1996,3345
31,31043,541,680,77,0,2,1300,1569
31,31044,889,1162,292,13,16,2372,3766
31,31045,352,596,107,0,3,1058,1709
31,31046,603,612,101,1,2,1319,1923
31,31047,1011,930,198,4,15,2158,3447
31,31048,2447,3468,2741,30,63,8749,13518
31,31049,638,449,18,0,0,1105,1551
31,31050,175599,88176,60360,2278,9631,336044,520014
31,31051,734,751,97,13,7,1602,2088
31,31052,7297,4497,1955,115,207,14071,21467
31,31053,1514,1712,722,21,34,4003,8536
31,31054,566,645,119,46,11,1387,1960
31,31055,833,953,295,13,7,2101,3600
31,31056,3880,4144,1247,57,72,9400,17522
31,31057,1871,1293,371,24,7,3566,4813
31,31058,2896,2934,1531,19,37,7417,13629
31,31059,8152,8953,4949,154,429,22637,34972
31,31060,118,241,196,1,2,558,909
31,31061,758,594,243,4,6,1605,2131
31,31062,729,1215,144,3,14,2105,2845
31,31063,908,729,580,14,8,2239,3047
31,31064,396,427,63,2,4,892,1162
31,31065,652,318,84,4,5,1063,1248
31,31066,678,738,86,1,3,1506,2340
31,31067,1499,1489,286,22,26,3322,5927
31,31068,743,663,199,13,10,1628,2223
31,31069,1300,1236,140,2,8,2686,4801
31,31070,875,879,179,5,1,1939,2515
31,31071,352,320,117,3,1,793,1141
31,31072,192,412,431,5,4,1044,1491
31,31073,431,557,274,1,0,1263,1679
31,31074,873,744,175,4,8,1804,2765
31,31075,938,877,145,1,7,1968,3324
31,31076,2735,3033,500,22,46,6336,9888
31,31077,593,483,64,5,2,1147,1742
31,31078,1004,824,199,10,3,2040,2807
31,31079,6084,6155,1897,56,64,14256,22434
31,31080,2100,1862,248,8,19,4237,5791
31,31081,728,638,64,0,3,1433,1934
31,31082,770,839,206,38,11,1864,2655
31,31083,315,345,140,3,5,808,1192
31,31084,1622,1793,148,7,10,3580,4721
31,31085,2130,2644,1015,14,25,5828,8017
31,31086,330,462,233,9,2,1036,1555
31,31087,1057,542,239,11,8,1857,2942
31,31088,438,491,40,7,1,977,1363
31,31089,6073,5034,2643,65,130,13945,22655
31,31090,1347,1261,74,5,11,2698,3971
31,31091,1998,1643,967,14,37,4659,6173
31,31092,1066,1383,108,7,3,2567,3348
31,31093,3193,2789,1403,48,90,7523,11347
31,31094,462,594,831,1,5,1893,2648
31,31095,1345,765,392,10,28,2540,3704
31,31096,13700,8689,3692,247,163,26491,40898
31,31097,796,712,81,2,7,1598,2743
31,31098,1300,1789,1363,18,21,4491,7463
31,31099,895,698,66,1,6,1666,2030
31,31100,639,500,94,6,7,1246,2094
31,31101,8641,6665,2540,75,279,18200,29147
31,31102,10529,8798,7202,99,236,26864,40323
31,31103,535,530,104,10,1,1180,2028
31,31104,2303,2961,249,2,19,5534,7864
31,31105,364,585,285,3,11,1248,1868
31,31106,405,511,283,4,4,1207,1545
32,32001,955,584,942,24,38,2543,5902
32,32002,590,825,380,16,28,1839,3933
32,32003,529,197,522,5,14,1267,2919
32,32004,728,507,298,11,12,1556,3241
32,32005,3799,2221,3513,122,332,9987,21652
32,32006,889,571,1466,49,76,3051,5630
32,32007,1172,1915,1760,80,77,5004,8748
32,32008,895,1114,1199,31,31,3270,7507
32,32009,1642,1157,790,57,90,3736,9009
32,32010,20397,12836,32336,779,2002,68350,133084
32,32011,535,349,493,13,25,1415,2763
32,32012,1181,458,847,19,23,2528,5039
32,32013,726,536,792,20,51,2125,4210
32,32014,2374,2238,3035,68,115,7830,17049
32,32015,287,184,335,11,9,826,1921
32,32016,2052,1864,2881,114,151,7062,15876
32,32017,16392,8797,17438,757,1871,45255,79880
32,32018,812,539,628,18,31,2028,4213
32,32019,4280,1806,2750,98,239,9173,18858
32,32020,9094,4360,6701,467,987,21609,45527
32,32021,354,534,711,11,17,1627,3354
32,32022,3101,1345,2121,61,158,6786,13901
32,32023,2041,1271,1994,74,147,5527,11662
32,32024,4181,2779,5266,286,461,12973,26399
32,32025,1110,1130,1745,41,90,4116,8615
32,32026,735,2293,2658,24,47,5757,11494
32,32027,55,542,433,2,1,1033,1902
32,32028,332,408,386,6,4,1136,2458
32,32029,2584,1015,2123,61,109,5892,13548
32,32030,710,305,190,2,9,1216,2517
32,32031,1630,1172,1007,46,102,3957,7681
32,32032,1651,857,1336,39,119,4002,7195
32,32033,951,546,546,13,47,2103,5130
32,32034,5326,2659,2650,179,301,11115,23364
32,32035,1062,1674,2099,60,86,4981,9523
32,32036,4481,3150,3843,195,287,11956,26323
32,32037,1645,954,1681,40,77,4397,9691
32,32038,4057,11972,6603,85,223,22940,41287
32,32039,6693,7265,6395,256,596,21205,43425
32,32040,1954,2448,2624,80,102,7208,14615
32,32041,86,426,655,7,4,1178,2137
32,32042,7330,6808,6011,152,434,20735,44917
32,32043,177,139,209,10,7,542,1125
32,32044,2432,1571,1641,47,101,5792,11557
32,32045,805,1201,1601,27,39,3673,7150
32,32046,992,1156,1096,42,46,3332,7208
32,32047,965,590,730,9,41,2335,4495
32,32048,3047,2036,3179,97,199,8558,17893
32,32049,4361,3620,4637,103,199,12920,27708
32,32050,1024,661,1457,23,55,3220,5996
32,32051,3474,2389,5051,167,171,11252,21419
32,32052,954,2193,3041,121,129,6438,10600
32,32053,1032,1318,2008,62,52,4472,8678
32,32054,954,1913,2893,40,71,5871,10932
32,32055,4297,2953,3110,136,226,10722,25803
32,32056,20207,10005,21425,771,2456,54864,92936
32,32057,1014,1591,2003,73,87,4768,9566
32,32058,279,400,622,10,12,1323,2464
