edon,ife,rac,jam,amlo,bronco,efec,lisnom
1,1001,123958,65957,150635,30989,371539,636960
1,1002,5021,3902,11312,673,20908,33710
1,1003,9505,4451,8122,1241,23319,45680
1,1004,1756,1532,2868,210,6366,11439
1,1005,16784,9344,14116,3442,43686,78946
1,1010,4133,4972,7495,1110,17710,32309
1,1006,5397,3674,8512,968,18551,30679
1,1007,5031,3792,9724,984,19531,37004
1,1008,1663,910,2044,157,4774,6770
1,1009,3042,3069,3277,229,9617,15125
1,1011,2409,1991,3960,270,8630,14826
2,2001,38451,19296,136049,15013,208809,391569
2,2002,91641,39398,241742,28013,400794,776148
2,2003,8602,5833,24208,3234,41877,84638
2,2004,127600,56646,486867,41140,712253,1386657
2,2005,8795,2972,29127,2386,43280,92555
3,3001,5993,4100,20828,1407,32328,53666
3,3002,5106,3141,15964,976,25187,41048
3,3003,22706,13634,78120,8337,122797,203030
3,3004,20661,6371,74337,5657,107026,206467
3,3005,2290,948,4497,388,8123,11935
4,4001,17745,31447,88880,5334,143406,205172
4,4002,2779,9042,19808,498,32127,40662
4,4003,10657,16908,79927,3401,110893,178048
4,4010,4340,4736,10188,212,19476,30987
4,4004,5859,10682,26902,729,44172,64270
4,4009,2974,5388,16505,523,25390,39866
4,4011,1721,4285,6552,106,12664,18972
4,4005,2571,3083,11879,172,17705,22098
4,4006,4164,7282,8015,138,19599,26997
4,4007,659,1542,2943,16,5160,6978
4,4008,917,2175,3500,64,6656,8006
5,5001,282,351,245,13,891,1085
5,5002,15237,14685,30167,3169,63258,110572
5,5003,2727,2374,5082,494,10677,17866
5,5004,2524,5686,3178,440,11828,18035
5,5005,468,613,246,20,1347,1633
5,5006,1896,3584,6584,443,12507,20815
5,5007,2041,1967,1977,181,6166,9465
5,5008,551,740,473,28,1792,2355
5,5009,4077,8142,15953,686,28858,42019
5,5010,5561,7573,19997,1693,34824,59573
5,5011,3297,1849,1449,106,6701,9144
5,5012,594,491,161,25,1271,1780
5,5013,282,414,144,14,854,1109
5,5014,1280,2007,1449,84,4820,8129
5,5015,327,367,307,17,1018,1334
5,5016,396,419,502,28,1345,1568
5,5017,5189,17065,30568,936,53758,80559
5,5018,24554,22240,54838,6932,108564,169719
5,5019,1020,1273,1788,163,4244,6652
5,5020,6053,9799,13660,955,30467,53018
5,5021,650,1080,1842,94,3666,5008
5,5022,2766,2960,7203,510,13439,21637
5,5023,514,1833,2418,100,4865,7337
5,5024,3659,6230,9676,839,20404,33585
5,5025,14629,15585,34892,4338,69444,126105
5,5026,177,1230,586,10,2003,2845
5,5027,10024,10551,13940,2302,36817,63919
5,5028,8100,8169,11502,1698,29469,49336
5,5029,418,588,589,24,1619,1888
5,5030,81518,100223,140101,25134,346976,570465
5,5031,1718,3006,6167,505,11396,17812
5,5032,5923,4810,9175,806,20714,33059
5,5033,8575,12678,26478,876,48607,72759
5,5034,749,786,1234,58,2827,3840
5,5035,84320,80164,146761,16905,328150,497356
5,5036,1695,4120,3865,106,9786,15114
5,5037,1111,695,1254,58,3118,5131
5,5038,2164,1864,2163,227,6418,10472
6,6001,16845,14182,45045,4301,80373,123072
6,6002,3059,3261,4727,422,11469,16597
6,6003,2206,3016,4706,273,10201,15996
6,6004,2956,3358,7752,625,14691,22909
6,6005,10406,10085,38219,4075,62785,98772
6,6006,1820,3040,7674,310,12844,21499
6,6007,272,1285,2331,49,3937,5084
6,6008,10950,13019,55852,3867,83688,136912
6,6009,566,1268,3748,156,5738,7341
6,6010,7253,9460,26820,1663,45196,82538
7,7001,779,1599,4796,147,7321,11832
7,7002,847,1736,11730,191,14504,20728
7,7003,976,2332,9357,211,12876,20009
7,7004,589,9934,4541,74,15138,20182
7,7005,350,2004,4535,49,6938,14462
7,7006,1641,4213,7891,119,13864,21173
7,7007,320,2554,1943,28,4845,6293
7,7008,1490,3943,8800,209,14442,24147
7,7009,1989,2837,13545,470,18841,30789
7,7010,889,577,837,38,2341,5358
7,7011,1835,3117,3939,45,8936,13832
7,7012,2604,4655,15035,655,22949,32843
7,7013,1385,2333,12125,225,16068,22429
7,7014,830,3804,5119,193,9946,15416
7,7015,1265,5849,15098,411,22623,32160
7,7016,273,2060,6811,44,9188,13299
7,7017,2449,10308,24134,651,37542,60535
7,7018,673,1052,2899,42,4666,5913
7,7019,4895,12334,45741,1574,64544,105790
7,7020,1753,8269,12238,211,22471,32883
7,7021,489,2641,7774,113,11017,15452
7,7022,3662,2233,2648,36,8579,10620
7,7023,2468,12716,24656,503,40343,62270
7,7024,451,868,799,4,2122,7024
7,7025,452,532,2448,47,3479,4784
7,7026,690,13380,7643,114,21827,32206
7,7027,2277,10560,33716,759,47312,69512
7,7028,611,304,2324,82,3321,4644
7,7029,88,33,405,5,531,4266
7,7030,806,4921,9479,98,15304,23436
7,7031,1587,17195,26352,246,45380,71900
7,7032,1170,2392,9993,262,13817,21365
7,7033,244,1153,2433,12,3842,4544
7,7034,2719,5178,20187,387,28471,49095
7,7035,675,918,5219,142,6954,9666
7,7036,307,1309,1550,54,3220,4902
7,7037,1662,2521,14059,315,18557,26460
7,7038,1177,5823,4948,105,12053,16187
7,7039,1419,2980,5199,29,9627,14929
7,7040,2341,3980,17900,589,24810,38273
7,7041,859,12865,7263,91,21078,30550
7,7042,358,1281,3622,56,5317,6755
7,7043,849,675,3702,59,5285,7242
7,7044,569,5467,8978,74,15088,18508
7,7045,258,1350,1916,21,3545,4377
7,7046,1242,6022,13579,250,21093,30615
7,7047,1167,2520,5797,55,9539,12397
7,7048,768,1374,8266,207,10615,15158
7,7049,277,7508,4174,25,11984,17396
7,7050,443,239,2430,95,3207,4401
7,7051,1495,2760,13814,419,18488,31718
7,7052,18338,18276,19941,413,56968,89902
7,7053,271,1200,2257,22,3750,5822
7,7054,1841,1357,9059,225,12482,18883
7,7055,336,618,2221,48,3223,4601
7,7056,335,2888,1553,19,4795,7062
7,7057,1953,8482,18309,462,29206,48110
7,7058,55,64,1542,8,1669,2805
7,7059,7490,35287,53531,1221,97529,154799
7,7060,139,2209,2972,17,5337,7849
7,7061,8187,5748,27096,710,41741,62684
7,7062,699,3332,5551,86,9668,12924
7,7063,663,580,1118,54,2415,2960
7,7064,876,7030,12758,97,20761,35272
7,7065,3404,7425,42359,910,54098,83924
7,7066,4047,3091,2210,33,9381,13323
7,7067,1655,1306,2822,34,5817,7459
7,7068,1349,2336,11532,259,15476,22679
7,7069,1271,6315,15787,285,23658,36121
7,7070,308,1450,2481,32,4271,9009
7,7071,2166,1880,7754,98,11898,19032
7,7072,261,1327,3198,40,4826,6161
7,7073,656,2069,18315,210,21250,29686
7,7074,912,2813,7938,249,11912,17991
7,7075,1369,3812,6119,306,11606,17906
7,7076,3137,5358,18350,366,27211,40640
7,7077,6888,7613,68113,2751,85365,133291
7,7078,1321,3801,13539,405,19066,25478
7,7079,377,9683,6053,27,16140,21322
7,7080,950,538,1778,19,3285,4910
7,7081,619,6141,8812,214,15786,25575
7,7082,1433,10042,7958,121,19554,32606
7,7083,151,2700,1734,97,4682,8586
7,7084,853,2158,5837,131,8979,13016
7,7085,75,342,871,14,1302,5681
7,7086,222,1539,3346,93,5200,7087
7,7087,449,1482,10262,105,12298,16543
7,7088,1544,3140,10982,421,16087,23238
7,7089,571,166,742,16,1495,1860
7,7090,11299,17844,100718,3646,133507,230238
7,7091,403,864,1290,14,2571,3254
7,7092,234,518,3192,42,3986,8603
7,7093,1145,6569,11129,252,19095,27710
7,7094,2884,4079,11932,265,19160,26688
7,7095,1619,4721,10698,497,17535,26293
7,7096,1092,16702,6975,76,24845,38987
7,7097,2459,7165,31710,488,41822,66005
7,7098,1799,330,2155,55,4339,5449
7,7099,1818,22469,15662,252,40201,57292
7,7100,1180,3476,11094,690,16440,22625
7,7101,2598,3153,13761,339,19851,30471
7,7102,19958,20926,213675,8198,262757,440458
7,7103,1331,4514,8049,166,14060,20470
7,7104,387,2521,5404,252,8564,11282
7,7105,816,1266,5720,200,8002,11248
7,7106,1309,5918,19600,846,27673,44631
7,7107,1114,2702,9290,161,13267,21059
7,7108,1388,8901,24969,505,35763,52519
7,7109,2839,9323,33309,875,46346,76461
7,7110,745,5016,13070,165,18996,25265
7,7111,668,17407,7206,101,25382,28383
7,NA,48,42,302,4,396,474
8,8001,2160,1813,2020,300,6293,9268
8,8002,2995,2557,3538,872,9962,18647
8,8003,1345,1561,1700,260,4866,7259
8,8004,1526,1723,2324,400,5973,11922
8,8005,2124,1902,4327,472,8825,17920
8,8006,1033,506,1774,86,3399,5601
8,8007,1313,4391,2164,108,7976,13068
8,8008,1096,1431,491,9,3027,8191
8,8009,4165,3029,5694,284,13172,20625
8,8010,2889,2400,4665,403,10357,18426
8,8011,8583,3634,8006,1729,21952,37986
8,8012,1883,1693,838,50,4464,7242
8,8013,1580,555,2546,862,5543,10251
8,8014,465,520,512,55,1552,1906
8,8015,791,638,214,35,1678,2275
8,8016,652,868,630,161,2311,3458
8,8017,14924,7053,35373,3926,61276,127190
8,8018,794,739,1152,100,2785,5302
8,8019,161133,49488,136468,43826,390915,680376
8,8020,358,1260,1519,10,3147,5049
8,8021,17294,8093,30967,6315,62669,112975
8,8022,538,698,366,43,1645,3021
8,8023,770,449,1037,283,2539,4365
8,8024,1357,591,604,138,2690,4243
8,8025,664,738,2076,151,3629,7268
8,8026,542,770,504,41,1857,3186
8,8027,6017,7680,5003,622,19322,35538
8,8028,684,920,789,89,2482,4797
8,8029,2584,6516,5764,164,15028,30294
8,8030,1617,1444,1016,56,4133,6764
8,8031,3628,3304,8837,607,16376,30445
8,8032,12648,9023,17950,8897,48518,85682
8,8033,457,410,277,72,1216,1507
8,8034,1058,463,1377,87,2985,5994
8,8035,1105,595,1745,434,3879,7582
8,8036,3670,4578,7666,1506,17420,29905
8,8037,106836,71493,277090,49056,504475,1069315
8,8038,946,675,1163,163,2947,4773
8,8039,448,685,1143,143,2419,3473
8,8040,4363,1706,4078,304,10451,22130
8,8041,118,468,169,7,762,1268
8,8042,364,572,458,14,1408,1931
8,8043,362,417,790,57,1626,2624
8,8044,876,700,826,219,2621,3972
8,8045,4650,2637,8978,1233,17498,34632
8,8046,1611,1334,593,15,3553,5402
8,8047,965,842,550,13,2370,3953
8,8048,2475,1773,4379,320,8947,19627
8,8049,1043,722,363,39,2167,2605
8,8050,5221,2780,13765,3669,25435,48323
8,8051,1198,1278,1483,46,4005,6102
8,8052,5319,2734,3034,560,11647,22115
8,8053,810,970,1039,96,2915,5733
8,8054,928,873,527,48,2376,7296
8,8055,1853,1707,4217,543,8320,13468
8,8056,781,599,294,34,1708,2056
8,8057,665,538,284,35,1522,2282
8,8058,542,501,724,65,1832,2570
8,8059,784,785,1124,304,2997,4232
8,8060,1762,1216,2009,619,5606,8619
8,8061,1220,351,865,82,2518,4064
8,8062,4009,2729,6158,713,13609,24621
8,8063,1182,676,931,83,2872,5273
8,8064,707,389,360,58,1514,2342
8,8065,4160,2434,1375,69,8038,13326
8,8066,1131,1064,849,16,3060,5227
8,8067,1178,891,544,88,2701,4378
9,9002,63898,33335,158209,13232,268674,378726
9,9003,120476,51671,222041,15571,409759,563976
9,9004,36385,18673,53846,4277,113181,160351
9,9005,156399,85397,443602,32350,717748,1045113
9,9006,60715,28422,151231,10132,250500,357004
9,9007,216212,97451,649632,40617,1003912,1470405
9,9008,28251,20958,82928,4930,137067,196534
9,9009,9704,7498,48764,3063,69029,104842
9,9010,119277,51113,234648,15773,420811,606598
9,9011,28290,20756,133678,9671,192395,294302
9,9012,85669,47294,225199,15161,373323,539660
9,9013,37862,25869,147278,10771,221780,340509
9,9014,104841,43785,110341,9565,268532,367723
9,9015,70235,48879,182566,15308,316988,478442
9,9016,76120,32330,104464,9473,222387,319499
9,9017,69128,37082,158062,13100,277372,404572
10,10001,3943,2772,7156,638,14509,24292
10,10002,367,333,752,12,1464,3149
10,10003,667,635,473,18,1793,3411
10,10004,3694,3024,7246,486,14450,25473
10,10005,80379,40961,118864,26352,266556,473938
10,10006,2047,1834,790,33,4704,7751
10,10007,30146,22167,83249,8342,143904,254410
10,10008,3756,3582,8471,865,16674,28874
10,10009,1565,1767,1168,83,4583,7334
10,10010,551,538,805,41,1935,3319
10,10011,863,887,492,51,2293,4391
10,10012,14123,12202,32306,3429,62060,107982
10,10013,2302,2904,4979,261,10446,17958
10,10014,1379,10401,4144,134,16058,28358
10,10015,1350,1209,2738,82,5379,9329
10,10016,1866,1727,3865,340,7798,14367
10,10017,2695,1575,4082,400,8752,20705
10,10018,1250,934,1626,109,3919,6784
10,10019,1333,855,2386,248,4822,9563
10,10020,941,449,673,34,2097,3765
10,10021,1744,1570,2305,228,5847,10836
10,10022,1396,1234,2157,146,4933,8515
10,10023,2835,2852,5204,345,11236,19213
10,10024,4218,4540,6972,612,16342,32371
10,10025,1222,1372,2730,93,5417,9836
10,10026,243,520,653,31,1447,2730
10,10027,1678,1561,3551,80,6870,13497
10,10028,1123,1031,449,15,2618,4421
10,10029,1729,1421,1848,109,5107,9836
10,10030,475,322,182,7,986,1856
10,10031,309,292,226,4,831,1461
10,10032,1060,884,1126,104,3174,5278
10,10033,5702,5063,7261,1346,19372,36302
10,10034,541,1006,1290,69,2906,5221
10,10035,1275,1526,4805,40,7646,16031
10,10036,1423,1136,1914,122,4595,9664
10,10037,2680,1619,4238,175,8712,14857
10,10038,691,581,1587,36,2895,5707
10,10039,1943,1901,4699,419,8962,16894
11,11001,10803,7652,12564,3004,34023,67145
11,11002,14535,4725,20335,3991,43586,95102
11,11003,26134,8870,20139,6234,61377,126028
11,11004,8805,3933,10349,2137,25224,50108
11,11005,10363,8155,11685,3399,33602,66615
11,11006,1375,632,1088,116,3211,4242
11,11007,74543,22804,65904,25924,189175,373130
11,11008,6650,6497,3305,1184,17636,31241
11,11009,9015,5744,9811,3188,27758,59583
11,11010,2403,1627,1270,488,5788,9461
11,11011,21017,4932,12317,5253,43519,74090
11,11012,5304,2474,3199,796,11773,23226
11,11013,5553,1236,3893,686,11368,18050
11,11014,18159,14256,14318,7783,54516,112026
11,11015,23583,12765,24460,7821,68629,137513
11,11016,4006,1607,3237,607,9457,16900
11,11017,79194,33024,69017,23601,204836,415087
11,11018,6435,4927,5346,1356,18064,28989
11,11019,7474,6734,5038,1172,20418,41440
11,11020,326233,83620,135035,53068,597956,1114438
11,11021,9668,2677,8140,3173,23658,43487
11,11022,4945,3007,1693,387,10032,17804
11,11023,20452,11082,20736,3899,56169,124292
11,11024,2284,2505,1798,418,7005,10744
11,11025,13933,5582,4854,2607,26976,53515
11,11026,6971,7746,8539,1625,24881,45218
11,11027,34972,13177,54126,12610,114885,212516
11,11028,15128,7132,17927,3150,43337,84454
11,11029,7192,4415,2390,839,14836,27250
11,11030,12936,12134,9482,3105,37657,80941
11,11031,21723,11289,10061,4866,47939,91009
11,11032,10227,2935,15165,3596,31923,58276
11,11033,13593,8978,15875,4054,42500,88157
11,11034,1329,747,739,73,2888,4309
11,11035,14753,3654,10371,3885,32663,60770
11,11036,1492,1410,1271,159,4332,6671
11,11037,22166,10919,22199,5953,61237,134585
11,11038,2141,1654,1547,418,5760,10229
11,11039,6218,3108,4571,1572,15469,31224
11,11040,3565,1860,3839,213,9477,13033
11,11041,7143,5943,9534,3632,26252,49270
11,11042,18225,6487,23080,5313,53105,114493
11,11043,4434,1971,2974,241,9620,15422
11,11044,8844,5358,9634,3494,27330,45588
11,11045,2832,1824,1129,120,5905,8459
11,11046,10144,7675,10092,1848,29759,63401
12,12001,34746,52052,243781,7573,338152,582951
12,12002,5592,3336,3823,52,12803,18263
12,12003,932,4373,10700,89,16094,26305
12,12004,1490,1749,4555,108,7902,13773
12,12005,218,660,2654,54,3586,5365
12,12006,617,750,3304,66,4737,7915
12,12007,1043,2920,10943,81,14987,23345
12,12008,303,1274,2650,77,4304,6387
12,12009,279,494,2078,7,2858,4143
12,12010,5413,1476,5193,52,12134,17267
12,12011,2436,4500,18141,402,25479,43820
12,12012,2478,4028,17739,163,24408,41920
12,12013,884,1377,5677,33,7971,11070
12,12080,384,970,4982,35,6371,9529
12,12081,507,1244,2003,20,3774,5705
12,12014,1022,2146,5246,95,8509,12547
12,12015,1382,1315,3829,371,6897,9994
12,12016,307,2372,4337,7,7023,9323
12,12017,973,2043,3646,107,6769,11598
12,12018,1149,1068,4621,20,6858,10586
12,12019,1420,1630,4234,62,7346,10644
12,12020,2238,2712,3658,16,8624,12951
12,12021,3869,7560,20695,304,32428,52420
12,12022,3352,2445,11472,176,17445,31923
12,12023,1151,1726,8939,81,11897,18508
12,12024,308,1052,2450,16,3826,5310
12,12025,1505,2677,3782,19,7983,11312
12,12026,682,1361,1990,46,4079,6204
12,12027,1440,2953,5163,93,9649,17916
12,12028,11179,12772,23777,548,48276,86923
12,12077,810,2215,3168,51,6244,10244
12,12029,8634,17998,90477,2721,119830,192372
12,12030,2233,3613,16393,366,22605,35472
12,12031,1814,1776,7010,74,10674,15612
12,12032,1109,586,1435,19,3149,4677
12,12033,1372,6013,4662,55,12102,22696
12,12034,1489,1249,5424,232,8394,11681
12,12035,2910,5057,8358,433,16758,29541
12,12036,5988,9020,47828,2391,65227,109264
12,12037,1023,900,4029,23,5975,8003
12,12038,878,1257,1865,30,4030,5354
12,12039,5513,7400,42973,1278,57164,95280
12,12040,2500,1416,7865,106,11887,18104
12,12041,1353,2330,6202,147,10032,17866
12,12042,1605,699,9241,36,11581,18231
12,12078,1059,621,2783,74,4537,6738
12,12043,2698,1671,4047,60,8476,13344
12,12044,1336,954,5741,48,8079,12561
12,12079,2054,2100,3615,13,7782,14727
12,12045,600,1543,3432,78,5653,8959
12,12046,722,5849,6449,120,13140,18413
12,12047,1929,6250,21863,208,30250,44087
12,12048,1053,893,1091,21,3058,4997
12,12049,2469,3220,12720,194,18603,33070
12,12050,1517,1359,3925,154,6955,8941
12,12051,1647,3626,12491,393,18157,29152
12,12052,5548,1532,6083,100,13263,23864
12,12053,2274,3003,12309,85,17671,27802
12,12054,4322,4828,14343,107,23600,36339
12,12055,1957,685,6115,31,8788,14432
12,12056,9240,10416,28431,1991,50078,81143
12,12057,4456,4035,11808,79,20378,31017
12,12058,3060,4389,21063,282,28794,47490
12,12059,5491,1789,14905,299,22484,38009
12,12060,3962,3291,7918,230,15401,25208
12,12061,1838,2497,2400,151,6886,9818
12,12062,2339,3107,13908,176,19530,30372
12,12063,2508,1397,5244,37,9186,14779
12,12064,880,1185,2508,5,4578,6187
12,12065,1271,543,4499,45,6358,9677
12,12066,304,941,2065,35,3345,5324
12,12067,1734,5638,28714,374,36460,59777
12,12068,1556,1792,7574,55,10977,16824
12,12069,2841,3299,8609,103,14852,21738
12,12070,473,2389,3713,16,6591,9715
12,12071,502,740,2613,26,3881,5805
12,12072,404,4304,10565,28,15301,19365
12,12073,245,1545,3440,6,5236,6959
12,12076,9735,1298,4810,16,15859,19891
12,12074,720,1939,6180,59,8898,13976
12,12075,4292,2466,3299,59,10116,16098
13,13001,1567,1724,5104,422,8817,16424
13,13002,1823,4489,9470,567,16349,29945
13,13003,2758,4972,19828,1444,29002,44265
13,13004,982,964,2217,246,4409,7073
13,13005,1102,1486,5551,436,8575,13429
13,13006,953,1707,6610,290,9560,14916
13,13007,784,1660,2949,225,5618,8892
13,13008,2881,3744,13503,1220,21348,33190
13,13009,1447,2288,9036,676,13447,20610
13,13010,439,2920,6881,56,10296,14261
13,13011,2139,2765,7622,482,13008,22734
13,13012,2560,2899,13340,1049,19848,31774
13,13013,537,2509,5363,97,8506,12039
13,13014,770,1555,6885,184,9394,14339
13,13015,3349,3912,15336,1184,23781,41971
13,13016,1216,2109,3026,255,6606,9700
13,13017,1885,3063,4637,177,9762,16234
13,13018,854,1475,6078,323,8730,13204
13,13019,880,2051,5501,296,8728,13512
13,13020,90,830,691,17,1628,2427
13,13021,730,1247,4661,317,6955,10867
13,13022,1497,1466,4274,383,7620,11591
13,13023,1365,2734,14107,599,18805,26754
13,13024,1427,1396,4870,282,7975,13672
13,13025,504,3360,7224,69,11157,15826
13,13026,2043,1275,3033,53,6404,8746
13,13027,938,3395,6274,96,10703,16429
13,13028,3803,10185,41823,796,56607,88351
13,13029,4725,5682,9748,1394,21549,34140
13,13030,3476,6425,34698,1816,46415,70363
13,13031,1002,1889,3049,103,6043,9610
13,13032,336,1815,3114,46,5311,7715
13,13033,425,606,555,14,1600,2445
13,13034,2776,861,1354,56,5047,7901
13,13035,427,1284,2641,50,4402,6869
13,13036,1148,704,4139,358,6349,9055
13,13037,1743,2641,5211,206,9801,16682
13,13038,870,931,2146,219,4166,6699
13,13039,847,1286,4526,315,6974,11106
13,13040,11835,11002,47191,5372,75400,115964
13,13047,25477,27630,89124,9478,151709,226432
13,13041,2182,3331,15074,1265,21852,32237
13,13042,320,1114,3922,90,5446,8028
13,13043,1613,540,1352,21,3526,5076
13,13044,1699,2219,2912,322,7152,11383
13,13045,566,1296,2991,80,4933,7082
13,13046,1285,538,587,18,2428,4135
13,13048,1646,3462,2418,61,7587,12589
13,13049,1332,2100,8436,651,12519,17993
13,13050,439,1428,3171,85,5123,7521
13,13051,1710,3222,9984,695,15611,23797
13,13052,1295,3124,3414,103,7936,12797
13,13053,3498,5891,7914,157,17460,27615
13,13054,1123,2518,13433,614,17688,25494
13,13055,664,1628,6013,235,8540,12750
13,13056,1908,2857,8893,814,14472,25028
13,13057,921,1582,4833,331,7667,12270
13,13058,812,1271,6032,187,8302,14389
13,13059,3526,2837,8100,562,15025,26710
13,13060,1119,1632,4618,94,7463,12041
13,13061,3723,4380,19385,1752,29240,43377
13,13062,1776,5790,4800,115,12481,18812
13,13063,5012,5284,26739,1951,38986,60914
13,13064,1085,1040,2957,262,5344,7879
13,13065,353,772,4737,169,6031,8698
13,13066,3220,3243,16103,994,23560,36395
13,13067,516,1847,4068,74,6505,10452
13,13068,8430,7459,35720,3429,55038,93805
13,13069,771,1163,5998,356,8288,12965
13,13070,506,2036,1838,42,4422,7327
13,13071,589,996,4350,249,6184,8518
13,13072,3486,3273,9521,193,16473,24436
13,13073,1785,2010,9334,657,13786,21104
13,13074,1517,1436,4087,409,7449,11613
13,13075,6875,7326,38672,2533,55406,84482
13,13076,9289,9425,46384,4889,69987,123569
13,13077,820,1012,3327,347,5506,8907
13,13078,3022,1618,3898,54,8592,12349
13,13079,345,1207,2399,64,4015,5552
13,13080,1624,3037,7154,81,11896,16528
13,13081,1672,2909,10575,673,15829,26001
13,13082,1498,2003,5444,568,9513,14779
13,13083,2781,5907,12685,1180,22553,32447
13,13084,3055,2791,11320,510,17676,30481
14,14001,3521,1837,2376,855,8589,16097
14,14002,3128,1344,5459,879,10810,17461
14,14003,3294,2248,6266,474,12282,17434
14,14004,942,633,1138,115,2828,4482
14,14005,1660,1607,3892,373,7532,11199
14,14006,7030,4878,13246,1686,26840,47954
14,14007,1563,815,2176,185,4739,7367
14,14008,15066,6204,7581,3456,32307,55804
14,14125,4092,1844,845,684,7465,14383
14,14009,3357,1377,3743,620,9097,14212
14,14010,988,1402,1259,101,3750,4783
14,14011,1578,901,710,103,3292,4436
14,14012,1181,528,482,140,2331,3511
14,14013,9436,5034,8406,2709,25585,47034
14,14014,1371,1423,1370,192,4356,6899
14,14015,5452,3580,16253,1329,26614,48176
14,14016,3597,4323,8054,1173,17147,28865
14,14017,3697,743,1821,232,6493,10353
14,14018,6421,4603,15605,1581,28210,54172
14,14019,644,382,588,38,1652,2175
14,14020,1556,1429,3019,113,6117,8988
14,14021,2152,1125,4989,277,8543,15927
14,14022,3159,2480,9492,636,15767,26508
14,14023,12558,4350,28701,4758,50367,83914
14,14024,2476,1733,3233,225,7667,11889
14,14025,3992,1905,6561,841,13299,22660
14,14026,2606,1363,4422,869,9260,14675
14,14027,1103,1069,1038,194,3404,4930
14,14028,5069,1593,3138,132,9932,13040
14,14029,749,300,351,57,1457,2165
14,14030,2372,973,5380,463,9188,14046
14,14031,8985,3724,10046,1510,24265,37256
14,14032,1035,802,363,38,2238,2769
14,14033,903,787,1151,54,2895,4332
14,14034,2596,3429,2542,657,9224,18278
14,14035,560,293,357,34,1244,1913
14,14036,10878,3647,5083,1663,21271,37535
14,14037,3301,1286,4415,593,9595,14672
14,14038,1721,1687,3392,368,7168,11864
14,14039,2296,1460,5441,526,9723,19466
14,14040,711,880,746,80,2417,3596
14,14041,260998,104858,339920,60672,766448,1258768
14,14042,1588,1047,1458,73,4166,6635
14,14043,1587,638,1039,121,3385,5225
14,14044,2109,1114,1160,103,4486,7127
14,14045,3169,2361,5929,288,11747,18103
14,14046,4108,4000,8621,862,17591,33303
14,14047,3504,1997,2750,794,9045,15140
14,14048,7301,2373,2140,1471,13285,24100
14,14049,2832,2446,5201,676,11155,18650
14,14050,6085,936,1400,548,8969,16286
14,14051,2026,789,1410,45,4270,6446
14,14052,6637,3329,7385,1337,18688,33077
14,14053,2566,1219,4033,382,8200,12825
14,14054,1378,783,1020,96,3277,5016
14,14055,30548,10947,20149,5312,66956,117951
14,14056,569,514,1827,144,3054,5426
14,14057,2488,2180,3741,445,8854,15180
14,14058,604,435,287,32,1358,1996
14,14059,760,669,774,169,2372,3254
14,14060,2379,1258,3018,465,7120,10999
14,14061,1769,2306,3503,411,7989,10490
14,14062,1117,561,892,86,2656,4855
14,14063,3689,1957,1061,69,6776,9926
14,14064,855,875,474,37,2241,3128
14,14065,12398,4192,22756,3340,42686,76008
14,14066,6060,2287,3771,752,12870,20406
14,14067,890,1246,3565,116,5817,8975
14,14068,5928,3613,9504,880,19925,36422
14,14069,23467,8609,68985,5474,106535,211250
14,14070,2453,887,2598,81,6019,9952
14,14071,1714,1617,1202,63,4596,8421
14,14072,17740,10128,29593,3418,60879,115960
14,14073,879,424,487,129,1919,2899
14,14074,1754,1122,427,152,3455,5201
14,14075,12347,5496,7467,3678,28988,51313
14,14076,4914,1416,987,745,8062,12689
14,14077,651,448,965,74,2138,2967
14,14078,896,435,365,75,1771,2582
14,14079,3654,2531,6914,774,13873,23890
14,14080,7301,2462,2449,1713,13925,24153
14,14081,874,858,1573,85,3390,4615
14,14082,1077,631,368,111,2187,3262
14,14083,3039,1806,9549,1246,15640,26342
14,14084,7302,5255,14849,1814,29220,52767
14,14085,2571,2584,2653,281,8089,11195
14,14086,4393,4296,8587,948,18224,33919
14,14087,3988,2862,3661,407,10918,13883
14,14088,2469,1603,3419,489,7980,12853
14,14089,3177,2010,3745,437,9369,13402
14,14090,797,466,835,93,2191,3100
14,14091,1451,955,1476,141,4023,6222
14,14092,5550,3592,5315,925,15382,30358
14,14093,2673,1497,1581,151,5902,9381
14,14094,34207,7526,10131,8736,60600,115374
14,14095,4244,2454,9498,1089,17285,30739
14,14096,1443,961,2839,188,5431,7829
14,14097,1613,2601,4151,308,8673,16643
14,14098,62319,14262,84283,12630,173494,331697
14,14099,73974,38708,119468,20656,252806,467588
14,14100,1592,2023,1553,106,5274,7645
14,14101,3590,1860,8501,293,14244,25433
14,14102,46754,25714,83888,14941,171297,333319
14,14103,1329,1044,1049,102,3524,5184
14,14104,1277,1125,1836,93,4331,5746
14,14105,1509,617,391,134,2651,3903
14,14106,4816,2321,3014,533,10684,17931
14,14107,865,838,967,35,2705,3844
14,14108,1232,810,1467,95,3604,5303
14,14109,2765,2139,10244,847,15995,27136
14,14110,5932,1641,1196,527,9296,13743
14,14111,2307,1305,2980,307,6899,11520
14,14112,2094,480,481,470,3525,5935
14,14113,1525,919,1027,187,3658,5409
14,14114,2547,1596,3886,635,8664,14768
14,14115,1655,916,488,148,3207,4496
14,14116,3379,1410,2362,1107,8258,14578
14,14117,1021,661,404,108,2194,3742
14,14118,4052,2730,4119,666,11567,19427
14,14119,3317,2718,6899,806,13740,22956
14,14120,246756,73511,221679,43325,585271,1014204
14,14121,3363,2070,8705,750,14888,24180
14,14122,1226,981,1023,55,3285,4967
14,14123,2087,2118,3891,284,8380,14242
14,14124,10116,3739,10133,2322,26310,51965
15,15001,5761,8300,14814,1005,29880,45311
15,15002,6886,11545,33874,2796,55101,81436
15,15003,6512,7389,8312,859,23072,33305
15,15004,1317,3031,4018,151,8517,11863
15,15005,16865,16906,36376,3329,73476,112204
15,15006,889,1298,3886,272,6345,8464
15,15007,1523,3178,7842,275,12818,17591
15,15008,3454,4515,6563,123,14655,20578
15,15009,3951,4819,18922,1606,29298,40264
15,15010,3413,2159,8212,1067,14851,21514
15,15011,3187,6195,18574,1336,29292,43672
15,15012,818,1101,3698,334,5951,8343
15,15013,76204,40429,130908,12654,260195,396803
15,15014,6981,12308,28240,3170,50699,74401
15,15015,1832,2729,9646,439,14646,20936
15,15016,2059,3616,7814,502,13991,17874
15,15017,1201,769,2149,117,4236,5683
15,15018,6877,5300,13628,1395,27200,37607
15,15019,2051,3167,8838,1129,15185,25014
15,15020,30326,22160,89853,9391,151730,223214
15,15021,4018,4099,9533,505,18155,26702
15,15022,1489,1274,5574,410,8747,11388
15,15023,3176,3318,15469,1256,23219,36152
15,15024,9995,9815,33525,3696,57031,81448
15,15025,65516,41306,160522,17596,284940,408508
15,15122,28436,20527,106986,6524,162473,262331
15,15026,21612,23364,95398,6937,147311,239188
15,15027,5040,4210,6733,491,16474,20760
15,15028,807,1326,3239,280,5652,7927
15,15029,1822,3726,10092,644,16284,21271
15,15030,9865,18440,48033,4238,80576,129663
15,15031,1484,2105,9978,720,14287,19651
15,15032,30630,67789,157121,10232,265772,451573
15,15060,106222,88060,341309,25868,561459,865265
15,15033,4907,5090,6039,204,16240,23599
15,15034,123697,147358,487956,41389,800400,1248615
15,15035,1284,1138,2618,108,5148,6830
15,15036,11754,9230,27855,3392,52231,92773
15,15037,3457,5201,11857,778,21293,30394
15,15038,55302,25436,50210,4558,135506,187671
15,15039,1009,1606,2794,312,5721,8054
15,15040,26953,47555,134234,10535,219277,344842
15,15041,4447,3951,9040,912,18350,26407
15,15042,1605,1069,1613,44,4331,5116
15,15043,13924,15515,40119,3558,73116,107519
15,15044,1076,2888,7366,725,12055,18208
15,15045,2311,2533,8159,779,13782,19670
15,15125,795,983,3757,341,5876,8032
15,15046,8811,11326,25075,2131,47343,64903
15,15047,2680,2812,4461,709,10662,14896
15,15048,4151,10125,18489,1366,34131,51235
15,15049,6441,9657,17144,1672,34914,47187
15,15050,800,2169,4243,202,7414,10087
15,15051,1549,2480,8124,427,12580,17550
15,15052,14562,15023,38383,3377,71345,96954
15,15053,3320,3678,6458,349,13805,19224
15,15054,6335,4318,20588,1591,32832,49097
15,15055,37392,26690,60645,7734,132461,180279
15,15056,1048,1344,3543,423,6358,9479
15,15057,4612,4768,5807,473,15660,21739
15,15058,128725,74694,211641,20428,435488,686477
15,15059,2539,3083,12051,1078,18751,26750
15,15061,34911,32599,106141,8870,182521,284282
15,15062,1442,1515,2815,253,6025,7529
15,15063,6494,6556,19399,2040,34489,47899
15,15064,3008,3874,8707,374,15963,20827
15,15065,3673,5000,8941,730,18344,25978
15,15066,3230,3545,9672,851,17298,26374
15,15067,308,1187,2005,36,3536,4201
15,15068,5895,7414,23001,1524,37834,55239
15,15069,1369,2963,9051,582,13965,19836
15,15070,460,752,1740,164,3116,3877
15,15071,14773,27502,74330,5204,121809,193763
15,15072,1642,3188,3053,365,8248,11640
15,15073,862,1748,3909,311,6830,8778
15,15074,2211,2376,6972,748,12307,16927
15,15075,8315,19285,30136,1489,59225,89327
15,15124,10603,16794,10594,773,38764,64471
15,15076,2970,2814,7941,632,14357,19819
15,15077,11519,10598,26442,2734,51293,71400
15,15078,1040,1068,1831,33,3972,4938
15,15079,1050,1672,2617,63,5402,7024
15,15080,3246,1753,3112,370,8481,10207
15,15081,2886,5377,4792,174,13229,19349
15,15082,30837,50680,123715,11516,216748,322728
15,15083,6538,8988,21449,568,37543,55886
15,15123,2989,6673,5266,175,15103,21979
15,15084,1359,1146,3604,491,6600,9877
15,15085,5044,3764,10874,759,20441,28256
15,15086,3899,9439,19609,1128,34075,48037
15,15087,4639,5212,7467,308,17626,23868
15,15088,8047,9202,24765,1617,43631,66560
15,15089,7408,8362,26659,2709,45138,69404
15,15090,882,1607,3371,293,6153,8305
15,15091,6501,6041,24256,1569,38367,59014
15,15092,7028,7048,24750,2152,40978,62655
15,15093,4617,6002,18460,1687,30766,44310
15,15094,1931,3380,9177,775,15263,21489
15,15095,989,2115,6292,301,9697,14030
15,15096,7976,6390,22797,2341,39504,57778
15,15097,3187,3974,10711,1063,18935,26598
15,15098,2592,2742,4784,230,10348,12979
15,15099,406,734,1749,186,3075,4139
15,15100,15967,24868,78907,7019,126761,195151
15,15101,3265,3099,10883,909,18156,29280
15,15102,5114,7934,22293,2277,37618,53495
15,15103,2139,3276,4532,292,10239,12912
15,15104,3607,4113,15542,1472,24734,36705
15,15105,90461,67759,198641,19063,375924,562003
15,15106,8198,5348,5897,96,19539,25981
15,15107,108822,90061,222427,29021,450331,640081
15,15108,1786,1775,3652,340,7553,10474
15,15109,15444,10111,47179,4095,76829,116211
15,15110,39748,37788,143076,13235,233847,361888
15,15111,7479,8038,19062,1471,36050,50958
15,15112,8450,4943,9749,506,23648,33252
15,15113,6024,8860,8225,792,23901,32179
15,15114,7703,6581,11828,1471,27583,42422
15,15115,8018,23328,14451,660,46457,64832
15,15116,5023,5070,18197,1784,30074,41550
15,15117,812,785,1262,43,2902,3545
15,15118,937,2700,3585,116,7338,10586
15,15119,19166,19315,44071,5066,87618,129935
15,15120,2158,2017,4264,247,8686,11999
15,15121,11237,15435,54827,4471,85970,142742
16,16001,873,950,2718,555,5096,8549
16,16002,916,1192,2855,112,5075,12272
16,16003,1678,3147,5019,732,10576,16440
16,16004,2955,1540,2890,176,7561,12431
16,16005,974,1353,2650,235,5212,7764
16,16006,5689,6480,31582,1479,45230,90067
16,16007,399,482,1139,87,2107,2698
16,16008,2117,4880,6817,147,13961,18813
16,16009,4545,3277,6391,735,14948,26009
16,16010,1634,2212,5858,74,9778,16210
16,16011,636,1582,1662,171,4051,6266
16,16012,3240,1641,11927,337,17145,31230
16,16013,2206,1151,1555,54,4966,7441
16,16014,1156,1473,3434,115,6178,10578
16,16015,2496,2469,3562,454,8981,14274
16,16016,2511,2078,4812,293,9694,18795
16,16017,1636,4718,7233,395,13982,22656
16,16018,1213,1174,1784,168,4339,7283
16,16019,3138,1362,3651,511,8662,16692
16,16020,2687,2868,5705,964,12224,22454
16,16021,686,961,1783,94,3524,5929
16,16022,2769,3095,3500,579,9943,16105
16,16023,1487,1239,1681,187,4594,8988
16,16024,326,182,517,12,1037,1899
16,16025,2497,3259,8516,223,14495,23573
16,16026,665,620,1299,31,2615,3955
16,16027,890,1042,686,62,2680,4942
16,16028,1042,456,1300,104,2902,6014
16,16029,1206,2931,3049,56,7242,11076
16,16030,2233,1245,2485,195,6158,11343
16,16031,1599,1916,3580,418,7513,11548
16,16032,790,1678,4576,227,7271,11327
16,16033,1972,2062,6243,187,10464,15944
16,16034,12065,8925,21580,4750,47320,87283
16,16035,1595,6015,6250,135,13995,24280
16,16036,1836,1027,2728,425,6016,9892
16,16037,1398,302,2239,101,4040,7569
16,16038,6197,2082,9423,185,17887,33021
16,16039,979,933,2332,105,4349,6406
16,16040,2282,2650,2788,372,8092,12979
16,16041,1894,1645,3302,470,7311,11974
16,16042,2242,1711,2725,156,6834,11174
16,16043,5941,5709,11718,2031,25399,50757
16,16044,2170,1530,2175,316,6191,12099
16,16045,3556,2535,9773,1144,17008,31681
16,16046,2710,3668,6174,380,12932,20949
16,16047,1214,1978,4039,271,7502,10379
16,16048,2513,1766,3986,305,8570,14335
16,16049,340,137,431,41,949,4954
16,16050,7174,5238,66393,2324,81129,135477
16,16051,1752,3525,2754,409,8440,13492
16,16052,7194,4638,17001,1739,30572,61435
16,16053,1593,1717,2456,340,6106,9578
16,16054,75584,50137,172634,36464,334819,598555
16,16055,1809,1110,1223,192,4334,7748
16,16056,1610,4726,10921,317,17574,32731
16,16057,1324,1214,2329,39,4906,10357
16,16058,1427,1867,1778,61,5133,7156
16,16059,2402,2932,3169,564,9067,14078
16,16060,1060,500,2587,66,4213,6025
16,16061,2006,835,2483,254,5578,9526
16,16062,2702,1260,6242,295,10499,15434
16,16063,2479,2531,3856,239,9105,15020
16,16064,2776,1420,3344,353,7893,13795
16,16065,2213,1432,7466,189,11300,18399
16,16066,2675,2160,10332,390,15557,23970
16,16067,6030,5190,22134,2054,35408,66653
16,16068,2197,2766,3688,267,8918,15754
16,16069,2717,1746,4646,1287,10396,19546
16,16070,14008,5690,16656,3934,40288,78169
16,16071,1615,1605,2839,858,6917,12742
16,16072,7463,5186,14197,1607,28453,58090
16,16073,1711,1058,3177,553,6499,10838
16,16074,2784,2348,4616,921,10669,16608
16,16075,2209,1280,1373,145,5007,8237
16,16076,8500,3726,13090,2419,27735,52620
16,16077,12544,4589,11139,2204,30476,53202
16,16078,643,2429,5271,126,8469,14222
16,16079,1690,935,3052,285,5962,10891
16,16080,4410,3058,10849,1167,19484,34040
16,16081,2257,2105,4311,400,9073,14866
16,16082,1362,1487,2309,75,5233,6896
16,16083,7483,5202,14790,1763,29238,53752
16,16084,2569,1512,4740,668,9489,20556
16,16085,3218,2510,5894,322,11944,22328
16,16086,4119,2852,4734,817,12522,26744
16,16087,1165,374,4810,309,6658,11408
16,16088,2876,1018,2911,259,7064,11282
16,16089,7150,6766,18226,2881,35023,66100
16,16090,1771,1294,5066,213,8344,16605
16,16091,1063,807,2991,181,5042,7186
16,16092,2317,1556,2306,400,6579,11042
16,16093,1024,2120,3295,89,6528,10019
16,16094,3170,2846,5563,860,12439,19522
16,16095,1353,871,1177,143,3544,7866
16,16096,1545,1300,2669,508,6022,9663
16,16097,1026,1006,1560,34,3626,5472
16,16098,5106,2714,6455,245,14520,24434
16,16099,3891,2733,5629,763,13016,19132
16,16100,2803,1340,4593,131,8867,12468
16,16101,795,1658,4746,213,7412,10990
16,16102,1826,1496,1407,93,4822,7622
16,16103,31388,12313,69989,11211,124901,239846
16,16104,3809,917,6014,326,11066,18448
16,16105,2674,682,3040,232,6628,15736
16,16106,1071,2427,4577,251,8326,14798
16,16107,2426,2723,6509,1013,12671,21968
16,16108,6085,5547,18811,2750,33193,58064
16,16109,16495,11770,38676,5372,72313,144445
16,16110,737,472,698,73,1980,3597
16,16111,5956,3874,9373,1454,20657,38035
16,16112,1666,1741,3857,285,7549,12333
16,16113,14745,9439,37382,4601,66167,114030
17,17001,651,883,6013,336,7883,13369
17,17002,1806,795,8517,532,11650,16998
17,17003,1881,1247,13783,608,17519,25912
17,17004,4062,4687,27718,1753,38220,61774
17,17005,766,887,4132,260,6045,8246
17,17006,10346,7272,65478,6152,89248,142231
17,17007,45513,22236,119020,16508,203277,312635
17,17008,6329,6643,24984,2689,40645,62469
17,17009,1082,1398,7481,941,10902,14751
17,17010,826,1003,7139,491,9459,12685
17,17011,17512,9027,69454,8347,104340,164437
17,17012,2823,2770,23178,1631,30402,46785
17,17013,955,691,6633,413,8692,11879
17,17014,440,904,4360,257,5961,8015
17,17015,2286,1570,8602,389,12847,20101
17,17016,1207,1145,7139,696,10187,13010
17,17017,4311,3201,23684,1144,32340,48691
17,17018,8746,6115,31805,3685,50351,86373
17,17019,1329,1629,10801,527,14286,20210
17,17020,2431,1399,14661,1217,19708,29119
17,17021,636,771,3392,171,4970,6324
17,17022,1485,1081,7562,644,10772,14454
17,17023,304,443,2891,156,3794,5027
17,17024,2909,2528,17743,1129,24309,37694
17,17025,1586,2005,12209,757,16557,24975
17,17026,1155,857,7972,417,10401,14099
17,17027,563,874,4320,238,5995,8003
17,17028,3665,5570,19711,1950,30896,49145
17,17029,8249,5035,32163,3313,48760,77060
17,17030,3708,1703,17304,1231,23946,35463
17,17031,1414,1651,16467,997,20529,29253
17,17032,712,437,4488,250,5887,7182
17,17033,543,994,6454,222,8213,10996
18,18001,2039,2451,10914,200,15604,26525
18,18002,1346,1018,4177,71,6612,12272
18,18003,1218,1041,2990,83,5332,9443
18,18004,10569,3646,33492,1283,48990,103289
18,18005,5003,3544,21529,507,30583,56565
18,18006,842,1483,2187,10,4522,7935
18,18007,2632,1252,7356,342,11582,21103
18,18008,2115,1968,3882,89,8054,13213
18,18009,3074,5704,4125,47,12950,25596
18,18010,2507,3122,9177,140,14946,25797
18,18011,2084,1910,6414,99,10507,17343
18,18012,2188,2162,11356,275,15981,29906
18,18013,988,723,1897,52,3660,6419
18,18014,1567,2237,5876,193,9873,18091
18,18015,6815,6835,25269,456,39375,71405
18,18016,2144,2913,11063,143,16263,29466
18,18017,25632,19475,126090,5654,176851,302091
18,18018,2069,1758,9649,147,13623,22797
18,18019,3241,2524,15903,530,22198,39539
18,18020,1609,635,1695,48,3987,8016
19,19001,444,305,611,306,1666,2288
19,19002,1272,774,427,370,2843,3965
19,19003,452,478,304,90,1324,2160
19,19004,5040,2863,3720,2359,13982,27284
19,19005,2364,2412,3016,919,8711,14525
19,19006,56270,27686,88777,45568,218301,403229
19,19007,2548,3694,1529,1512,9283,12010
19,19008,780,675,829,302,2586,3293
19,19009,5779,6445,19187,4701,36112,70505
19,19010,1663,1666,5277,1509,10115,22227
19,19011,2028,303,979,584,3894,6507
19,19012,2740,2044,6498,3234,14516,31320
19,19013,1387,1545,1785,1179,5896,9483
19,19014,5715,8817,4209,1601,20342,28105
19,19015,507,680,401,100,1688,2717
19,19016,683,367,655,346,2051,3153
19,19017,1727,6559,3852,5810,17948,30138
19,19018,12883,5567,28679,19538,66667,157626
19,19019,47368,5964,11236,4775,69343,103718
19,19020,1209,342,1029,920,3500,5665
19,19021,36858,19909,55315,26272,138354,292781
19,19022,1543,2516,2294,1243,7596,13007
19,19023,589,346,201,140,1276,1892
19,19024,237,1556,1924,187,3904,4977
19,19025,3315,2561,7147,2201,15224,35251
19,19026,96425,44604,108525,52491,302045,539693
19,19027,634,555,635,67,1891,2686
19,19028,1958,1249,4064,1286,8557,12798
19,19029,499,218,323,154,1194,1438
19,19030,831,1588,803,598,3820,6147
19,19031,257,945,636,699,2537,3013
19,19032,17635,16905,41436,18798,94774,209794
19,19033,1995,577,701,288,3561,4754
19,19034,8307,6518,12878,5434,33137,63409
19,19035,1167,767,820,410,3164,4575
19,19036,299,359,470,167,1295,1698
19,19037,285,1808,726,1713,4532,6215
19,19038,651,929,1028,607,3215,4709
19,19039,4316,6171,11701,3891,26079,51570
19,19040,208640,78360,166995,72494,526489,938523
19,19041,620,356,361,125,1462,1851
19,19042,2589,3682,7665,2729,16665,40915
19,19043,1020,722,519,470,2731,5290
19,19044,1430,686,457,228,2801,3277
19,19045,5106,2103,6672,1904,15785,27700
19,19046,6089,3605,7781,2753,20228,39283
19,19047,91359,20330,69220,38079,218988,365145
19,19048,40966,10731,39598,24207,115502,212885
19,19049,9609,3881,6273,2691,22454,37516
19,19050,415,258,746,248,1667,2287
19,19051,1244,209,1181,229,2863,3672
20,20001,41,28,348,4,421,771
20,20002,8242,4569,10840,215,23866,31395
20,20003,200,258,1490,86,2034,3101
20,20386,6235,4371,33551,1900,46057,65372
20,20004,104,116,754,2,976,1720
20,20005,285,239,179,5,708,852
20,20006,263,3112,5459,112,8946,11914
20,20007,1103,1373,6884,383,9743,13139
20,20008,173,784,530,20,1507,2517
20,20009,18,82,292,4,396,638
20,20010,272,122,1632,34,2060,3889
20,20011,260,502,2097,23,2882,4970
20,20012,661,1220,5092,154,7127,10208
20,20013,49,48,290,1,388,884
20,20014,463,632,2646,31,3772,6682
20,20015,1139,725,3320,111,5295,8021
20,20016,496,549,3621,81,4747,6373
20,20017,432,558,749,69,1808,2405
20,20018,429,355,1440,23,2247,4076
20,20019,419,242,1354,9,2024,5283
20,20020,211,444,914,14,1583,2670
20,20021,45,68,171,2,286,538
20,20022,158,328,826,22,1334,2114
20,20023,37,34,1774,5,1850,2923
20,20024,530,1918,4443,86,6977,9877
20,20025,36,106,296,10,448,686
20,20026,1305,984,7911,329,10529,15686
20,20027,139,341,816,17,1313,2512
20,20028,3454,2260,6351,251,12316,16499
20,20029,60,639,800,7,1506,2638
20,20030,315,696,4175,76,5262,6789
20,20031,145,211,226,1,583,814
20,20032,73,227,417,3,720,1086
20,20033,81,149,929,55,1214,2011
20,20034,9,31,242,7,289,435
20,20035,120,663,1013,10,1806,3760
20,20036,250,136,1027,18,1431,3278
20,20037,4821,5025,22507,1171,33524,55074
20,20038,179,1496,919,19,2613,3993
20,20039,3671,4207,8932,175,16985,21624
20,20040,59,40,312,9,420,1069
20,20041,956,2570,11351,456,15333,21064
20,20042,260,442,3148,55,3905,5350
20,20043,1863,6697,39055,625,48240,70445
20,20044,4534,3035,11286,626,19481,28951
20,20045,277,375,2517,74,3243,5312
20,20046,151,154,671,43,1019,2402
20,20047,42,61,404,2,509,764
20,20048,130,167,340,9,646,821
20,20049,250,101,1208,9,1568,2612
20,20050,52,38,651,2,743,2869
20,20051,241,640,3474,52,4407,5457
20,20052,56,105,445,6,612,1083
20,20053,55,150,319,28,552,1072
20,20054,23,40,109,1,173,303
20,20055,112,739,1041,20,1912,2741
20,20056,104,195,599,1,899,1057
20,20057,1795,3664,12501,509,18469,29309
20,20058,539,1208,2695,32,4474,8171
20,20059,2215,4554,15344,411,22524,33038
20,20060,79,98,801,0,978,1708
20,20061,169,262,637,13,1081,2193
20,20062,34,55,169,6,264,392
20,20063,117,257,1715,53,2142,3262
20,20064,274,334,2456,42,3106,5510
20,20065,26,77,503,2,608,1176
20,20066,20617,20620,100737,7363,149337,222254
20,20067,1599,1303,8674,568,12144,16219
20,20068,139,200,506,9,854,1780
20,20069,502,1132,1835,18,3487,4580
20,20070,214,297,1014,17,1542,2344
20,20071,1202,1438,13237,239,16116,23211
20,20072,88,515,1112,21,1736,2140
20,20073,68,198,930,7,1203,2333
20,20074,129,214,1189,62,1594,2814
20,20075,52,86,414,46,598,906
20,20076,2224,3275,34823,949,41271,63468
20,20077,110,260,475,26,871,1254
20,20078,169,231,474,11,885,1530
20,20079,276,315,1282,7,1880,2996
20,20080,378,435,2997,186,3996,6667
20,20081,155,274,1560,75,2064,3154
20,20082,1123,2775,4886,68,8852,16007
20,20083,54,16,312,4,386,666
20,20084,138,146,1003,55,1342,3119
20,20085,62,474,938,24,1498,1996
20,20086,236,304,611,16,1167,1699
20,20087,147,690,1914,19,2770,4405
20,20088,327,335,1580,127,2369,3791
20,20089,72,89,507,23,691,1265
20,20090,26,71,108,1,206,383
20,20091,80,251,319,10,660,1325
20,20092,195,309,834,16,1354,2984
20,20093,28,25,304,9,366,559
20,20094,28,117,498,0,643,1235
20,20095,113,377,1316,14,1820,2769
20,20096,54,33,56,2,145,334
20,20097,14,40,151,1,206,331
20,20098,55,108,222,2,387,639
20,20099,110,493,1619,62,2284,2988
20,20100,265,379,2039,102,2785,4246
20,20101,188,114,704,11,1017,1730
20,20102,374,1185,1319,9,2887,5068
20,20103,10,11,107,0,128,212
20,20104,939,901,7533,344,9717,16159
20,20105,199,63,1162,7,1431,2197
20,20106,17,95,622,7,741,1006
20,20107,61,91,431,4,587,1027
20,20108,109,106,962,4,1181,2803
20,20109,74,395,1310,24,1803,2233
20,20110,103,227,1001,11,1342,2102
20,20111,20,36,220,1,277,489
20,20112,405,479,3646,223,4753,6694
20,20113,29,47,203,4,283,502
20,20114,43,33,228,9,313,508
20,20115,166,860,990,25,2041,2766
20,20116,58,65,646,4,773,1554
20,20117,70,137,376,5,588,2127
20,20118,10,63,90,0,163,278
20,20119,19,12,103,0,134,274
20,20120,144,163,865,10,1182,2159
20,20121,690,2304,7661,72,10727,14211
20,20122,388,371,3355,13,4127,7325
20,20123,197,138,1588,8,1931,3417
20,20124,35,23,364,4,426,843
20,20125,44,67,531,7,649,999
20,20126,13,22,134,2,171,246
20,20127,137,1105,1106,4,2352,3893
20,20128,556,1008,2626,90,4280,8054
20,20129,85,71,374,22,552,983
20,20130,186,100,1642,11,1939,2749
20,20131,2516,4412,8776,53,15757,19015
20,20132,234,354,1850,46,2484,5336
20,20133,748,1787,4719,40,7294,8548
20,20134,144,176,946,4,1270,2229
20,20135,6,9,169,0,184,352
20,20136,49,201,522,1,773,1313
20,20137,43,55,216,11,325,557
20,20138,145,1601,2481,18,4245,5858
20,20139,42,59,230,0,331,657
20,20140,418,1046,3755,19,5238,6994
20,20141,50,104,298,10,462,790
20,20142,134,194,1019,62,1409,2566
20,20143,146,149,595,7,897,1732
20,20144,17,74,55,2,148,273
20,20145,78,96,510,5,689,1343
20,20146,72,84,479,8,643,1204
20,20147,508,1144,5156,158,6966,9181
20,20148,24,35,111,0,170,253
20,20149,83,138,360,1,582,1526
20,20150,128,538,1397,23,2086,3247
20,20151,128,280,478,14,900,1681
20,20152,42,96,177,1,316,557
20,20153,45,176,1326,8,1555,2600
20,20154,916,937,5159,415,7427,10650
20,20155,64,70,361,5,500,1622
20,20156,291,308,1016,11,1626,3205
20,20157,279,342,250,14,885,1540
20,20158,123,307,660,19,1109,1901
20,20159,107,188,296,8,599,1215
20,20160,47,120,428,8,603,1081
20,20161,222,469,1562,57,2310,4087
20,20162,239,74,359,7,679,2329
20,20163,45,176,261,4,486,1056
20,20164,811,931,4823,103,6668,8448
20,20165,62,373,396,10,841,1491
20,20166,61,189,307,9,566,749
20,20167,991,1085,543,4,2623,3242
20,20168,209,153,858,25,1245,2846
20,20169,470,653,1678,67,2868,4924
20,20170,1710,2886,4166,34,8796,11608
20,20171,16,34,169,6,225,351
20,20172,98,136,399,14,647,1115
20,20173,152,58,201,0,411,1237
20,20174,107,286,835,19,1247,2099
20,20175,744,1461,3566,58,5829,7280
20,20176,174,332,1946,98,2550,4266
20,20177,70,165,203,7,445,1014
20,20178,217,304,929,16,1466,2013
20,20179,89,108,99,4,300,406
20,20180,52,48,352,0,452,1000
20,20181,22,511,859,4,1396,1661
20,20182,5585,12439,57409,2404,77837,113778
20,20183,729,1972,9036,92,11829,17192
20,20184,520,887,3100,39,4546,6420
20,20185,9,50,104,4,167,248
20,20186,121,83,667,28,899,1213
20,20187,85,321,462,2,870,1596
20,20188,35,65,90,1,191,405
20,20189,155,356,614,7,1132,1463
20,20190,1284,1621,2168,6,5079,6467
20,20191,102,128,662,4,896,1842
20,20192,1081,1492,6517,120,9210,16714
20,20193,96,290,559,25,970,1809
20,20194,165,190,643,35,1033,1924
20,20195,78,106,350,10,544,1031
20,20196,62,97,297,3,459,856
20,20197,32,20,159,14,225,330
20,20198,124,236,587,30,977,2378
20,20199,7473,2630,6204,120,16427,22330
20,20200,49,34,19,0,102,577
20,20201,95,73,729,3,900,2543
20,20202,40,132,552,2,726,1305
20,20203,146,381,1268,7,1802,3067
20,20204,324,152,780,23,1279,2245
20,20205,22,58,177,7,264,508
20,20206,560,2152,4739,52,7503,11105
20,20207,599,1288,5895,47,7829,12302
20,20208,316,243,2683,26,3268,6296
20,20209,41,19,204,1,265,499
20,20210,306,452,1806,10,2574,4870
20,20211,105,108,834,1,1048,1915
20,20212,29,69,1058,0,1156,1785
20,20213,130,136,959,8,1233,2812
20,20214,57,339,731,3,1130,1607
20,20215,25,48,288,13,374,608
20,20216,12,23,302,1,338,797
20,20217,113,250,633,14,1010,2238
20,20218,7,50,154,0,211,422
20,20219,115,224,469,16,824,1988
20,20220,94,271,690,1,1056,1801
20,20221,49,139,425,11,624,992
20,20222,35,54,393,2,484,1005
20,20223,16,49,166,0,231,321
20,20224,34,28,286,8,356,570
20,20225,1385,689,1045,9,3128,3927
20,20226,140,250,479,18,887,2038
20,20227,616,668,4796,244,6324,10804
20,20228,12,134,165,1,312,463
20,20229,341,412,1735,21,2509,4528
20,20230,80,113,183,4,380,760
20,20231,67,156,256,1,480,1683
20,20232,2381,2433,7486,65,12365,15259
20,20233,38,96,278,7,419,1465
20,20234,601,782,1186,9,2578,4410
20,20235,363,298,872,20,1553,2735
20,20236,133,59,319,2,513,958
20,20237,233,221,592,23,1069,1805
20,20238,29,158,268,12,467,667
20,20239,17,55,372,9,453,776
20,20240,71,143,824,4,1042,1808
20,20241,79,115,349,19,562,879
20,20242,500,420,2774,23,3717,7886
20,20243,94,73,514,27,708,1405
20,20244,83,284,1094,15,1476,2587
20,20245,15,413,529,5,962,1255
20,20246,11,30,187,7,235,436
20,20247,709,1451,3683,59,5902,9332
20,20248,35,69,371,6,481,877
20,20249,39,34,165,0,238,749
20,20250,198,92,481,5,776,1514
20,20251,92,146,641,4,883,1533
20,20252,338,261,1137,19,1755,2419
20,20253,95,63,436,8,602,1540
20,20254,9,22,71,3,105,152
20,20255,80,377,743,11,1211,2393
20,20256,27,87,269,4,387,801
20,20257,23,75,154,2,254,537
20,20258,489,500,289,7,1285,1856
20,20259,192,220,512,9,933,1745
20,20260,1139,1166,1455,19,3779,5135
20,20261,30,140,240,5,415,745
20,20262,94,173,625,7,899,1588
20,20263,206,1379,1450,20,3055,4884
20,20264,190,299,466,9,964,2149
20,20265,316,762,2213,28,3319,5969
20,20266,9,18,96,2,125,210
20,20267,37,98,303,15,453,749
20,20268,175,107,1601,10,1893,2744
20,20269,55,184,216,6,461,907
20,20270,269,103,867,7,1246,2051
20,20271,118,405,1607,11,2141,4047
20,20272,257,353,742,13,1365,2297
20,20273,48,142,365,9,564,902
20,20274,234,615,1040,8,1897,5016
20,20275,33,108,143,4,288,565
20,20276,2252,10376,8933,117,21678,26770
20,20277,138,84,821,6,1049,2056
20,20278,47,129,681,11,868,1658
20,20279,32,51,49,12,144,243
20,20280,22,122,165,10,319,585
20,20281,51,69,251,7,378,717
20,20282,110,183,639,12,944,2310
20,20283,263,526,1126,17,1932,2514
20,20284,149,126,819,22,1116,2406
20,20285,17,22,110,4,153,284
20,20286,13,60,209,2,284,436
20,20287,141,131,242,5,519,872
20,20288,127,139,264,2,532,784
20,20289,121,528,1114,18,1781,2872
20,20290,74,137,396,5,612,984
20,20291,668,669,4708,388,6433,10328
20,20292,352,673,2764,95,3884,5225
20,20293,631,1040,3513,114,5298,7256
20,20294,14,20,440,2,476,756
20,20295,150,78,574,1,803,1525
20,20296,749,2305,4207,258,7519,9065
20,20297,20,67,352,1,440,790
20,20298,1006,1033,1288,11,3338,4660
20,20299,92,62,480,23,657,1269
20,20300,739,763,811,2,2315,2945
20,20301,31,55,365,1,452,811
20,20302,32,53,228,0,313,591
20,20303,200,299,2128,37,2664,3505
20,20304,206,314,849,3,1372,2509
20,20305,143,634,4243,25,5045,7183
20,20306,124,414,1073,16,1627,2357
20,20307,329,1923,3961,46,6259,7556
20,20308,283,385,2884,79,3631,6767
20,20309,27,54,103,1,185,372
20,20310,973,1351,3027,16,5367,7455
20,20311,24,121,176,1,322,641
20,20312,74,252,409,26,761,1189
20,20313,157,113,426,12,708,1384
20,20314,19,24,263,7,313,536
20,20315,35,51,398,12,496,1002
20,20316,1196,4529,17243,330,23298,34651
20,20317,23,27,326,6,382,753
20,20318,47,59,210,4,320,532
20,20319,57,68,173,3,301,529
20,20320,11,188,144,0,343,567
20,20321,56,99,288,3,446,1266
20,20322,2603,3836,15004,272,21715,32612
20,20323,380,916,2820,28,4144,7217
20,20324,152,497,903,12,1564,3044
20,20325,654,1696,4899,117,7366,10080
20,20326,84,117,124,1,326,842
20,20327,44,87,401,2,534,937
20,20328,121,419,1431,14,1985,2997
20,20329,29,32,227,0,288,585
20,20330,15,41,123,1,180,280
20,20331,159,110,837,11,1117,2305
20,20332,1026,3655,15689,204,20574,33442
20,20333,196,282,1668,28,2174,3661
20,20334,144,533,1563,38,2278,3205
20,20335,153,161,560,14,888,1431
20,20336,38,51,316,4,409,668
20,20337,131,175,729,1,1036,1675
20,20338,14,46,49,2,111,173
20,20339,112,112,892,48,1164,1820
20,20340,85,164,522,10,781,1492
20,20341,221,524,487,11,1243,1924
20,20342,291,666,1262,9,2228,2978
20,20343,71,85,265,5,426,1204
20,20344,156,467,1060,17,1700,2669
20,20345,293,378,2375,43,3089,6104
20,20346,77,122,614,15,828,1655
20,20347,950,1113,5916,491,8470,12501
20,20348,169,231,668,13,1081,2231
20,20349,178,607,234,6,1025,2407
20,20350,200,116,329,2,647,2799
20,20351,251,165,709,8,1133,2027
20,20352,52,96,57,2,207,375
20,20353,149,187,418,13,767,1607
20,20354,15,43,129,0,187,323
20,20355,14,63,249,0,326,497
20,20356,58,85,553,13,709,1676
20,20357,46,113,160,3,322,626
20,20358,321,81,538,14,954,1657
20,20359,50,42,204,2,298,657
20,20360,694,405,937,42,2078,2933
20,20361,21,27,345,1,394,662
20,20362,79,88,418,14,599,1107
20,20363,85,250,754,20,1109,2040
20,20364,879,1328,6470,71,8748,11364
20,20365,38,172,431,1,642,996
20,20366,52,219,860,6,1137,2361
20,20367,229,586,949,7,1771,2918
20,20368,122,99,576,28,825,1379
20,20369,109,148,718,34,1009,1589
20,20370,18,9,198,1,226,334
20,20371,46,69,201,7,323,504
20,20372,85,43,358,8,494,730
20,20373,80,25,576,2,683,1106
20,20374,23,78,108,2,211,349
20,20375,224,140,258,5,627,992
20,20376,741,686,4427,288,6142,8670
20,20377,16,57,89,1,163,293
20,20378,684,1564,3056,122,5426,7571
20,20379,222,221,1046,28,1517,2662
20,20380,73,86,1057,9,1225,2091
20,20381,60,137,603,17,817,1528
20,20382,378,486,602,9,1475,2053
20,20383,30,51,387,0,468,850
20,20384,21,61,165,5,252,430
20,20385,176,320,1034,15,1545,3431
20,20387,720,577,3932,20,5249,11270
20,20388,178,506,963,96,1743,2438
20,20389,155,147,580,9,891,1712
20,20390,63,91,135,2,291,827
20,20391,65,283,233,6,587,1177
20,20392,2816,3261,19257,1329,26663,38778
20,20393,110,221,651,6,988,2071
20,20394,331,236,1613,4,2184,4269
20,20395,215,228,646,23,1112,2764
20,20396,7,16,33,2,58,72
20,20397,74,177,753,9,1013,1956
20,20398,73,97,369,2,541,1223
20,20399,425,425,390,5,1245,2106
20,20400,1054,1503,10838,556,13951,23696
20,20401,62,267,468,9,806,1340
20,20402,40,32,270,5,347,608
20,20403,112,119,537,19,787,1453
20,20404,1434,3417,4183,43,9077,14150
20,20405,368,599,1927,16,2910,5065
20,20406,798,981,8914,161,10854,18082
20,20407,175,259,321,7,762,941
20,20408,119,241,862,83,1305,2189
20,20409,15,55,135,10,215,350
20,20410,545,663,3057,281,4546,6633
20,20411,78,131,999,10,1218,2280
20,20412,29,64,257,11,361,587
20,20413,63,336,595,16,1010,2160
20,20414,2624,3033,16052,453,22162,32733
20,20415,987,1620,3044,44,5695,8064
20,20416,766,468,1125,15,2374,3505
20,20417,15,109,116,5,245,383
20,20418,796,721,3963,49,5529,7086
20,20419,246,1246,5207,80,6779,9143
20,20420,10,16,249,1,276,443
20,20421,231,72,509,9,821,1136
20,20422,385,431,1866,43,2725,3453
20,20423,22,48,202,6,278,459
20,20424,24,89,146,4,263,402
20,20425,177,122,1012,6,1317,2437
20,20426,96,187,644,7,934,1475
20,20427,420,1939,5405,103,7867,11413
20,20428,230,1113,1578,11,2932,4802
20,20429,46,198,553,4,801,1270
20,20430,209,97,427,14,747,1136
20,20431,12,29,87,1,129,185
20,20432,27,262,737,25,1051,1427
20,20433,36,38,313,1,388,711
20,20434,57,336,386,3,782,1682
20,20435,73,802,1042,10,1927,2986
20,20436,114,143,675,2,934,2182
20,20437,139,222,179,1,541,756
20,20438,223,172,1812,12,2219,5999
20,20439,64,204,439,5,712,1146
20,20440,1453,2043,8620,163,12279,17931
20,20441,20,51,446,1,518,689
20,20442,219,2247,2594,5,5065,6149
20,20443,8,22,78,0,108,219
20,20444,6,39,160,1,206,338
20,20445,25,19,167,0,211,319
20,20446,31,23,656,1,711,1150
20,20447,269,222,2229,18,2738,4580
20,20448,1064,1875,4620,47,7606,11712
20,20449,150,130,397,0,677,1277
20,20450,229,152,788,17,1186,2546
20,20451,218,153,2574,18,2963,6937
20,20452,99,102,255,2,458,804
20,20453,289,171,950,55,1465,3321
20,20454,95,270,1237,11,1613,2916
20,20455,75,132,723,1,931,2124
20,20456,422,510,236,8,1176,1878
20,20457,493,413,263,17,1186,1511
20,20458,61,166,1197,2,1426,2122
20,20459,125,754,1631,46,2556,3386
20,20460,119,487,1107,9,1722,3405
20,20461,36,78,457,1,572,987
20,20462,23,75,142,1,241,511
20,20463,351,656,1278,64,2349,3377
20,20464,40,51,162,2,255,443
20,20465,19,25,119,0,163,310
20,20466,29,217,211,1,458,1010
20,20467,1166,939,2523,15,4643,8079
20,20468,397,3724,6356,56,10533,13533
20,20469,656,1098,4104,30,5888,8849
20,20470,1269,2591,10128,266,14254,22342
20,20471,95,562,992,10,1659,3521
20,20515,3115,3425,27933,490,34963,48095
20,20472,8,32,185,0,225,330
20,20473,49,647,1618,10,2324,2801
20,20474,59,83,255,7,404,948
20,20475,41,868,976,7,1892,2660
20,20476,429,464,2765,54,3712,7344
20,20477,12,75,89,4,180,307
20,20478,68,127,399,4,598,1082
20,20479,52,197,495,5,749,1379
20,20480,9,40,31,0,80,151
20,20481,354,904,2028,32,3318,4211
20,20482,57,56,370,7,490,747
20,20483,78,94,683,2,857,1448
20,20484,3374,4949,15958,241,24522,37751
20,20485,639,1083,3426,176,5324,7321
20,20486,195,786,1012,26,2019,3138
20,20487,114,1010,452,4,1580,2218
20,20488,66,186,532,16,800,1425
20,20489,8,13,34,3,58,88
20,20490,97,845,1649,16,2607,3369
20,20491,48,831,262,8,1149,1772
20,20492,144,187,1357,9,1697,2530
20,20493,167,211,788,20,1186,2203
20,20494,20,40,181,7,248,415
20,20495,279,369,1035,9,1692,3207
20,20496,223,143,578,5,949,1953
20,20497,73,222,532,20,847,1254
20,20498,421,515,877,1,1814,2749
20,20499,327,451,2129,28,2935,4693
20,20500,72,100,720,28,920,1543
20,20501,658,323,2388,46,3415,5566
20,20502,36,51,227,2,316,823
20,20503,150,220,1216,7,1593,3450
20,20504,8,12,168,2,190,319
20,20505,29,44,263,1,337,585
20,20506,365,548,546,11,1470,2297
20,20507,33,321,666,16,1036,1302
20,20508,379,331,2827,16,3553,7166
20,20509,195,1121,3162,38,4516,6567
20,20510,18,160,177,3,358,505
20,20511,162,429,526,11,1128,2149
20,20512,47,53,293,2,395,676
20,20513,155,2430,2498,30,5113,6273
20,20514,12,149,147,0,308,610
20,20516,145,181,1409,15,1750,3122
20,20517,147,217,1238,9,1611,3600
20,20518,6,27,35,2,70,103
20,20519,164,116,1019,27,1326,2298
20,20520,450,562,2098,38,3148,5802
20,20521,14,50,53,2,119,192
20,20522,20,63,254,0,337,718
20,20523,67,83,484,14,648,1164
20,20524,27,19,138,0,184,314
20,20525,484,1947,3651,57,6139,8595
20,20526,302,197,974,35,1508,2480
20,20527,53,111,615,7,786,1694
20,20528,92,125,1273,6,1496,2675
20,20529,66,67,702,7,842,1648
20,20530,339,2805,4877,47,8068,11947
20,20531,53,276,239,6,574,1719
20,20532,17,16,195,5,233,757
20,20533,52,97,154,1,304,807
20,20534,428,913,1692,33,3066,5426
20,20535,81,30,194,13,318,515
20,20536,1359,763,4111,66,6299,9047
20,20537,277,539,2135,126,3077,4267
20,20538,47,102,218,4,371,640
20,20539,291,549,3003,143,3986,5587
20,20540,208,215,1668,12,2103,5180
20,20541,30,71,480,0,581,1132
20,20542,118,367,1729,14,2228,3766
20,20543,258,281,854,26,1419,1829
20,20544,32,90,288,2,412,903
20,20545,441,767,4336,151,5695,7074
20,20546,260,237,2258,65,2820,4685
20,20547,34,39,409,6,488,767
20,20548,51,101,483,15,650,1185
20,20549,1327,1118,2311,63,4819,9177
20,20550,1259,1733,8253,479,11724,18666
20,20551,20,36,111,3,170,303
20,20552,491,550,2242,173,3456,7107
20,20553,1257,2503,14964,580,19304,29287
20,20554,245,181,1260,18,1704,3707
20,20555,337,221,1028,29,1615,2362
20,20556,2,23,126,4,155,216
20,20557,297,1327,6842,68,8534,10920
20,20558,91,193,699,9,992,1250
20,20559,32,61,571,8,672,1123
20,20560,569,727,4593,250,6139,7926
20,20561,284,434,1772,42,2532,4709
20,20562,37,170,420,3,630,1368
20,20563,111,190,611,5,917,1905
20,20564,106,107,340,5,558,1056
20,20565,57,150,299,6,512,844
20,20566,2313,2013,12748,709,17783,27798
20,20567,217,252,674,6,1149,2104
20,20568,431,218,593,19,1261,2201
20,20569,52,105,275,3,435,1254
20,20570,2191,1211,7777,306,11485,15244
21,21001,4777,2506,19574,650,27507,44025
21,21002,1325,1157,2441,110,5033,6839
21,21003,1919,2987,12085,285,17276,28104
21,21004,3442,3337,16137,696,23612,36284
21,21005,580,769,535,20,1904,2289
21,21006,1735,2904,3016,107,7762,10223
21,21007,322,695,660,10,1687,2545
21,21008,690,592,1830,147,3259,7541
21,21009,152,170,895,8,1225,1823
21,21010,7727,5744,17980,379,31830,41977
21,21011,366,311,332,14,1023,1445
21,21012,986,552,2135,178,3851,4858
21,21013,1950,1214,8072,123,11359,13488
21,21014,885,889,822,7,2603,3459
21,21015,9334,4240,28941,2183,44698,68752
21,21016,1262,1747,1264,240,4513,6004
21,21017,1759,4043,6503,259,12564,18161
21,21018,567,696,906,33,2202,2775
21,21019,14420,9267,39169,2596,65452,103235
21,21020,289,470,2927,93,3779,4905
21,21021,175,342,401,35,953,1074
21,21022,1749,1899,2595,101,6344,9014
21,21023,1645,1075,1863,104,4687,6190
21,21024,268,159,245,4,676,1059
21,21025,1077,1461,1651,68,4257,5880
21,21026,1230,1101,4058,236,6625,10576
21,21027,983,800,969,54,2806,3572
21,21028,678,478,480,13,1649,1855
21,21029,1391,1694,5472,162,8719,13797
21,21030,293,678,1128,14,2113,2796
21,21031,136,178,124,6,444,749
21,21032,361,800,439,24,1624,2278
21,21033,114,486,237,11,848,1179
21,21034,872,763,1004,70,2709,3566
21,21035,3254,2521,17067,811,23653,36473
21,21036,1309,1510,7204,213,10236,14760
21,21037,3070,1655,2490,10,7225,8935
21,21038,191,389,922,12,1514,1976
21,21039,707,546,2981,154,4388,6038
21,21040,1805,1318,1813,58,4994,6671
21,21041,1179,682,3232,145,5238,6841
21,21042,9788,4011,31079,2496,47374,70757
21,21043,547,835,757,8,2147,2778
21,21044,6083,6016,8908,265,21272,31820
21,21045,2384,1736,4285,249,8654,11442
21,21046,5245,2481,13281,893,21900,33128
21,21047,885,648,2083,76,3692,4888
21,21048,1319,2491,6103,172,10085,16307
21,21049,1268,1607,5342,491,8708,14334
21,21050,2411,4295,1207,60,7973,10348
21,21051,2517,3863,3765,81,10226,14444
21,21052,2891,3302,10720,447,17360,27640
21,21053,226,276,419,10,931,1111
21,21054,10969,5701,14592,1089,32351,44566
21,21055,2647,3892,7741,541,14821,21286
21,21056,824,911,987,32,2754,3935
21,21057,134,446,316,6,902,1212
21,21058,1196,1387,1224,89,3896,5186
21,21059,3286,1445,3674,90,8495,12104
21,21060,319,429,693,11,1452,2323
21,21061,551,688,2025,185,3449,5018
21,21062,3328,2338,1588,13,7267,8683
21,21063,866,522,1207,72,2667,3707
21,21064,1413,1285,4150,182,7030,10175
21,21065,2662,1890,4677,134,9363,12623
21,21066,1291,1054,6384,218,8947,13860
21,21067,1182,1492,1130,25,3829,5408
21,21068,1213,3595,3097,376,8281,11502
21,21069,1338,1771,1013,16,4138,5337
21,21070,2388,3593,6950,245,13176,20393
21,21071,1371,265,1906,30,3572,5094
21,21072,8548,7745,30271,1799,48363,71439
21,21073,3888,3210,1974,34,9106,11343
21,21074,1215,1091,2675,86,5067,7283
21,21075,984,1002,1446,33,3465,4970
21,21076,4969,4271,22865,2125,34230,53731
21,21077,1156,1480,3078,77,5791,8275
21,21078,2697,4607,5575,305,13184,19500
21,21079,1053,1473,731,12,3269,4075
21,21080,1494,3412,1737,21,6664,9430
21,21081,423,468,2087,99,3077,4025
21,21082,233,673,675,7,1588,1889
21,21083,731,909,629,21,2290,3066
21,21084,400,1170,2767,36,4373,5800
21,21085,3046,4541,5167,180,12934,17912
21,21086,1540,762,1329,11,3642,4822
21,21087,4249,5688,24094,1173,35204,57741
21,21088,1498,1986,3122,86,6692,9278
21,21089,1445,1823,3643,54,6965,9401
21,21090,322,1289,812,22,2445,3415
21,21091,2412,1658,2743,47,6860,9104
21,21092,1566,1083,8116,393,11158,16551
21,21093,426,722,3185,92,4425,5886
21,21094,560,771,1695,56,3082,3914
21,21095,978,1533,1721,67,4299,5751
21,21096,2795,3465,9295,842,16397,23082
21,21097,115,142,159,4,420,484
21,21098,154,136,690,62,1042,2092
21,21099,158,255,917,40,1370,1751
21,21100,512,492,2485,67,3556,4886
21,21101,1258,1547,2558,54,5417,6762
21,21102,434,768,784,23,2009,2676
21,21103,1240,1147,3561,275,6223,8559
21,21104,240,887,2216,111,3454,4584
21,21105,2344,3240,5868,371,11823,17323
21,21106,501,590,1253,194,2538,3594
21,21107,2804,3680,8596,357,15437,23653
21,21108,2320,3345,962,9,6636,8175
21,21109,2129,1622,3944,291,7986,11637
21,21110,2236,1266,5674,99,9275,13693
21,21111,4119,2062,13067,503,19751,29236
21,21112,5450,958,4186,188,10782,13961
21,21113,1087,1887,1901,22,4897,7065
21,21114,353,565,1560,25,2503,4105
21,21115,159949,85658,491251,42051,778909,1280071
21,21116,2155,1485,18273,474,22387,33324
21,21117,4174,2846,3076,80,10176,13166
21,21118,1913,1440,4454,497,8304,13184
21,21119,2005,1646,7465,268,11384,16873
21,21120,18387,5736,33874,3237,61234,92095
21,21121,594,717,1688,14,3013,3769
21,21122,293,269,184,5,751,911
21,21123,765,725,2573,177,4240,7353
21,21124,432,927,869,9,2237,2859
21,21125,1077,1984,5181,263,8505,10933
21,21126,1610,459,2164,289,4522,6953
21,21127,542,656,1778,43,3019,4114
21,21128,351,705,1309,25,2390,3216
21,21129,1336,656,2536,211,4739,6321
21,21130,802,1811,4650,39,7302,9606
21,21131,575,152,1317,110,2154,2911
21,21132,60,188,354,6,608,805
21,21133,9731,7336,45061,4056,66184,109573
21,21134,53,140,262,0,455,604
21,21135,1743,1927,5715,422,9807,15019
21,21136,101,129,156,5,391,487
21,21137,1027,795,4056,321,6199,8889
21,21138,1714,1134,1950,128,4926,7280
21,21139,944,912,3592,87,5535,7948
21,21140,526,803,949,26,2304,2941
21,21141,15450,6553,40334,4060,66397,102485
21,21142,385,720,1097,12,2214,2836
21,21143,2945,2141,9106,575,14767,20289
21,21144,1907,2069,9186,646,13808,22092
21,21145,706,618,5210,126,6660,9289
21,21146,109,175,265,3,552,748
21,21147,672,1117,1540,38,3367,4529
21,21148,769,723,3136,125,4753,7645
21,21149,1405,1765,7179,351,10700,17231
21,21150,498,363,3459,166,4486,6130
21,21151,904,1420,3352,220,5896,8814
21,21152,1892,1393,7064,336,10685,15067
21,21153,3654,2505,29515,1092,36766,53689
21,21154,143,1600,827,18,2588,4794
21,21155,19238,14211,97276,6828,137553,216180
21,21156,967,1873,3354,64,6258,9608
21,21157,933,1600,1423,65,4021,5261
21,21158,1012,683,692,10,2397,3489
21,21159,374,559,928,22,1883,2559
21,21160,1277,1674,7531,294,10776,15051
21,21161,635,469,980,13,2097,2899
21,21162,1430,1476,5469,242,8617,11798
21,21163,7444,5967,21928,1098,36437,54888
21,21164,141,336,147,5,629,880
21,21165,887,1310,2412,89,4698,6715
21,21166,1050,2148,1652,40,4890,7018
21,21167,311,1145,2130,50,3636,4881
21,21168,1003,2508,6271,226,10008,14383
21,21169,2397,2553,3804,265,9019,12192
21,21170,296,139,1683,44,2162,2712
21,21171,3804,4441,5590,297,14132,18777
21,21172,503,383,2271,143,3300,4397
21,21173,11207,7422,26829,3306,48764,71760
21,21174,989,794,2263,78,4124,8107
21,21175,786,832,2785,119,4522,6800
21,21176,2775,2965,17807,563,24110,34998
21,21177,2374,2076,1766,23,6239,8172
21,21178,2149,3612,2735,56,8552,11719
21,21179,2547,2529,8676,480,14232,20335
21,21180,2715,4022,10605,643,17985,27932
21,21181,763,349,1886,89,3087,4696
21,21182,450,281,1768,88,2587,3403
21,21183,4250,3299,3328,90,10967,14179
21,21184,1122,1318,1431,35,3906,4755
21,21185,1317,665,2915,85,4982,6723
21,21186,5433,4603,14246,932,25214,37763
21,21187,1063,915,1175,21,3174,3814
21,21188,2726,3016,3088,198,9028,12735
21,21189,1459,1140,7554,264,10417,14163
21,21190,188,169,410,19,786,958
21,21191,870,1687,1842,58,4457,7529
21,21192,808,752,1901,25,3486,4415
21,21193,648,1191,1601,47,3487,5075
21,21194,6371,642,8537,196,15746,20881
21,21195,4760,4525,3456,87,12828,16757
21,21196,101,288,660,6,1055,1428
21,21197,8766,7942,18555,1658,36921,55468
21,21198,317,139,289,9,754,1081
21,21199,5455,6299,6682,327,18763,26446
21,21200,516,684,776,37,2013,2770
21,21201,398,347,816,33,1594,2520
21,21202,1414,2407,1905,59,5785,8493
21,21203,406,729,2164,73,3372,4602
21,21204,532,741,2927,64,4264,5545
21,21205,1504,777,9051,488,11820,16590
21,21206,495,480,1149,32,2156,3308
21,21207,4703,4172,15052,743,24670,38086
21,21208,8541,8282,21434,1601,39858,59565
21,21209,783,1095,2987,87,4952,6679
21,21210,620,835,1815,23,3293,4022
21,21211,915,1871,5384,341,8511,11553
21,21212,3272,1614,5778,125,10789,14084
21,21213,3000,894,3276,82,7252,9532
21,21214,1084,1280,6148,167,8679,11491
21,21215,648,1052,1097,14,2811,3485
21,21216,271,516,538,10,1335,1816
21,21217,2596,950,5203,82,8831,12477
22,22001,13450,6841,8386,1471,30148,45894
22,22002,1814,1953,3313,290,7370,10955
22,22003,9922,5103,12246,1911,29182,49997
22,22004,10249,5092,10418,1905,27664,43739
22,22005,37429,10774,33482,7514,89199,134877
22,22006,7382,2378,8618,2100,20478,30261
22,22007,7043,3405,3695,991,15134,27969
22,22008,3456,3141,6261,697,13555,20479
22,22009,3721,3195,2848,248,10012,15876
22,22010,24794,14802,28933,3908,72437,112388
22,22011,10505,5806,16410,2308,35029,51376
22,22012,2214,4035,3582,206,10037,14199
22,22013,4846,3573,2937,331,11687,19432
22,22014,159338,54075,193356,35074,441843,725247
22,22015,1411,1070,1361,185,4027,6625
22,22016,35205,18615,62088,10040,125948,201655
22,22017,10620,5010,17832,3305,36767,52131
22,22018,3630,2007,7686,388,13711,19853
23,23001,55134,27727,236377,15897,335135,596602
23,23002,6702,8122,23816,1831,40471,67040
23,23008,18722,9427,89935,4765,122849,230011
23,23003,6852,8105,21275,558,36790,51668
23,23004,2031,3040,7242,470,12783,19285
23,23005,4072,5063,11281,177,20593,25556
23,23006,2446,1646,10863,238,15193,20253
23,23007,19359,13364,85910,5426,124059,195643
24,24001,3722,2703,2269,413,9107,14228
24,24002,1166,2152,834,91,4243,6358
24,24003,9602,7970,5149,330,23051,31756
24,24004,736,1570,397,88,2791,3925
24,24005,1595,2096,4397,578,8666,14091
24,24006,1565,1750,1727,121,5163,6892
24,24007,937,2354,5323,492,9106,13706
24,24008,2568,2548,4303,587,10006,16883
24,24009,943,857,1079,215,3094,3937
24,24010,4802,5564,3399,268,14033,22149
24,24057,1914,2548,4665,471,9598,14660
24,24011,5391,4484,10138,1365,21378,35118
24,24012,2722,2094,5177,205,10198,14091
24,24013,12757,11909,47662,5712,78040,126191
24,24014,2413,2228,2989,142,7772,11724
24,24015,2327,4005,2777,471,9580,15416
24,24016,4027,2810,10704,546,18087,29766
24,24017,3077,7150,2235,241,12703,18548
24,24018,1405,2387,3719,207,7718,10654
24,24019,529,841,1657,69,3096,4802
24,24020,7409,7586,20356,3957,39308,70638
24,24021,6181,8144,11762,1705,27792,41669
24,24022,3880,3027,1872,431,9210,14246
24,24023,1612,1462,3120,366,6560,12312
24,24024,9805,9429,18858,2743,40835,75639
24,24025,2674,5463,4087,665,12889,21523
24,24026,1285,1256,2492,116,5149,6750
24,24027,1382,1040,2439,228,5089,8668
24,24028,121341,46340,160377,38215,366273,634076
24,24029,4121,1731,4603,160,10615,15263
24,24030,537,878,1493,163,3071,4883
24,24031,2744,2719,3219,242,8924,11267
24,24032,799,2457,2184,69,5509,8437
24,24033,6041,7961,5477,1053,20532,30535
24,24034,1865,2611,1708,106,6290,9620
24,24035,28193,11075,53320,11572,104160,194489
24,24036,2896,3551,6368,755,13570,21169
24,24037,6032,9683,22759,861,39335,68202
24,24058,4416,4132,5679,188,14415,21103
24,24038,1347,2019,4810,101,8277,11303
24,24039,1487,1724,3597,156,6964,9916
24,24040,2843,3406,8900,603,15752,25868
24,24041,1330,2131,5953,228,9642,12999
24,24042,2112,1547,3548,201,7408,10054
24,24043,2163,1467,664,170,4464,7459
24,24044,926,1790,769,37,3522,5301
24,24045,2484,1565,2661,641,7351,10624
24,24046,2658,2204,2182,264,7308,11283
24,24047,2270,4013,2758,349,9390,12488
24,24048,2187,1422,1113,116,4838,7560
24,24049,644,741,1139,174,2698,3908
24,24050,6320,7316,4517,419,18572,26890
24,24051,9414,6684,8528,1102,25728,35720
24,24052,2390,4605,1571,316,8882,11862
24,24053,1798,2223,1061,123,5205,8948
24,24054,3481,4167,8069,418,16135,23238
24,24055,7260,6414,7524,630,21828,35131
24,24056,3717,4107,3896,650,12370,18390
25,25001,25556,29728,135145,5001,195430,321131
25,25002,3339,5187,16590,331,25447,35903
25,25003,3162,5670,5053,78,13963,22814
25,25004,2135,3999,6524,132,12790,20583
25,25005,2312,2861,2542,59,7774,12149
25,25006,48581,59271,268822,10894,387568,681372
25,25007,2836,3968,8818,105,15727,23300
25,25008,2781,5473,10886,179,19319,29975
25,25009,2762,5091,15786,373,24012,40712
25,25010,4904,10163,29416,387,44870,71928
25,25011,10004,28952,89546,1726,130228,208773
25,25012,28007,29683,129451,7442,194583,350510
25,25013,3523,6759,11887,194,22363,35352
25,25014,6756,3946,11928,276,22906,37933
25,25015,5277,7328,24122,988,37715,60843
25,25016,1136,3684,3988,76,8884,15867
25,25017,4175,11187,20219,210,35791,62809
25,25018,6451,11403,42446,702,61002,103304
26,26001,549,493,619,55,1716,2431
26,26002,5277,6047,16641,2594,30559,64815
26,26003,516,1486,1959,139,4100,6573
26,26004,99,319,371,21,810,1215
26,26005,516,933,677,67,2193,3019
26,26006,223,216,240,33,712,841
26,26007,110,244,553,30,937,1147
26,26008,237,224,375,28,864,1293
26,26009,243,341,319,40,943,1152
26,26010,217,307,440,29,993,1443
26,26011,372,437,328,48,1185,1541
26,26012,958,582,872,84,2496,3430
26,26013,23,508,462,19,1012,1324
26,26014,557,460,1076,80,2173,3792
26,26015,2718,2079,9659,955,15411,28255
26,26016,224,226,214,20,684,1017
26,26017,599,1367,1542,268,3776,5359
26,26018,24,400,461,7,892,1118
26,26019,731,730,2403,202,4066,6308
26,26020,178,431,283,30,922,1168
26,26021,274,331,261,27,893,1042
26,26022,110,445,343,37,935,1428
26,26023,327,311,401,66,1105,1396
26,26024,1062,864,2749,291,4966,9668
26,26025,2896,2897,5526,1136,12455,24032
26,26026,474,1058,1284,194,3010,4251
26,26027,1093,866,1331,194,3484,4602
26,26028,285,290,579,24,1178,1581
26,26029,1475,1196,2840,843,6354,10017
26,26030,14058,10937,50570,6266,81831,189282
26,26031,25,163,157,9,354,475
26,26032,561,1016,1193,94,2864,4619
26,26033,135,123,166,28,452,531
26,26034,127,120,301,23,571,700
26,26035,469,645,412,38,1564,2052
26,26036,1612,1975,2868,602,7057,12646
26,26037,291,296,374,18,979,1440
26,26038,128,610,762,20,1520,2022
26,26039,414,208,1019,34,1675,1994
26,26040,430,252,440,40,1162,1402
26,26041,293,261,302,20,876,1392
26,26042,169,398,393,40,1000,1565
26,26043,268,313,409,35,1025,1454
26,26044,200,344,671,53,1268,1730
26,26045,174,431,884,109,1598,1800
26,26046,4389,4687,19357,1983,30416,62598
26,26047,529,671,1080,51,2331,3696
26,26048,484,582,909,62,2037,2581
26,26049,53661,50345,173037,24192,301235,600038
26,26050,353,321,476,24,1174,1460
26,26051,526,434,526,30,1516,2170
26,26052,587,748,2170,164,3669,6220
26,26053,4696,3324,12834,1392,22246,45479
26,26054,262,501,582,60,1405,2077
26,26055,11444,8817,36641,4323,61225,150586
26,26056,525,751,1634,73,2983,5540
26,26057,1043,1183,2989,227,5442,9740
26,26058,985,1072,6282,148,8487,17970
26,26059,16519,20070,116171,8876,161636,320447
26,26060,1871,2297,12922,597,17687,41003
26,26061,6818,7327,41002,2958,58105,115520
26,26072,592,938,4049,126,5705,10526
26,26062,2592,3826,4911,272,11601,19332
26,26063,2056,5379,17847,252,25534,44395
26,26071,604,2591,5971,104,9270,15809
26,26064,5709,6473,21270,568,34020,59555
26,26065,7155,10414,44218,1915,63702,120836
26,26066,51,219,372,20,662,877
26,26067,216,710,1602,15,2543,3457
26,26068,146,974,2017,33,3170,4740
26,26069,287,1039,1585,81,2992,4417
26,26070,1118,1105,2795,224,5242,10257
27,27001,1533,3495,23159,208,28395,40024
27,27002,11243,7842,94388,732,114205,172275
27,27003,3969,4724,42755,288,51736,72426
27,27004,15362,22666,302161,4376,344565,505368
27,27005,15057,12718,80646,750,109171,148837
27,27006,4582,5967,48230,440,59219,91994
27,27007,1345,1723,13505,94,16667,22973
27,27008,13551,9127,65169,412,88259,128545
27,27009,1815,3437,15311,122,20685,27884
27,27010,3249,4685,39745,289,47968,62418
27,27011,3779,2236,12670,46,18731,22847
27,27012,4080,5531,65092,424,75127,116099
27,27013,2964,4696,59110,481,67251,92145
27,27014,3030,4660,40443,455,48588,68267
27,27015,2562,3930,16543,170,23205,33033
27,27016,1553,4427,19566,264,25810,39754
27,27017,1604,5654,22640,198,30096,42729
28,28001,2119,1893,2035,174,6221,8255
28,28002,6852,3534,6140,329,16855,23128
28,28003,28729,12819,52922,6773,101243,165719
28,28004,2917,1058,1384,124,5483,7221
28,28005,1848,942,661,70,3521,4540
28,28006,1676,2378,469,31,4554,5635
28,28007,2506,1340,2794,252,6892,12770
28,28008,1568,991,808,104,3471,4304
28,28009,26126,11271,64863,9270,111530,168153
28,28010,461,479,672,43,1655,2017
28,28011,2674,877,1635,89,5275,7170
28,28012,8408,2161,8436,537,19542,31247
28,28013,3089,2282,3645,238,9254,12684
28,28014,580,694,423,106,1803,2617
28,28015,2077,1345,4101,297,7820,13374
28,28016,3608,841,4533,196,9178,15169
28,28017,2992,2497,3219,289,8997,11608
28,28018,1699,1239,1437,202,4577,6022
28,28019,3781,913,4319,388,9401,12882
28,28020,1061,76,196,34,1367,2148
28,28021,16802,8364,26835,3403,55404,86555
28,28022,54606,34329,122121,11540,222596,394634
28,28023,1241,866,1056,63,3226,4040
28,28024,1290,552,611,97,2550,4359
28,28025,3986,3252,4540,660,12438,20446
28,28026,1482,561,356,47,2446,2960
28,28027,53113,24584,66762,17788,162247,310391
28,28028,949,696,763,73,2481,3102
28,28029,3532,2567,2088,110,8297,10570
28,28030,3719,1646,2856,329,8550,11486
28,28031,716,314,252,27,1309,1704
28,28032,73716,24432,169303,18762,286213,509333
28,28033,15212,8509,30282,4198,58201,102249
28,28034,1409,2612,876,72,4969,7368
28,28035,9538,5704,10147,735,26124,38481
28,28036,288,556,80,8,932,1095
28,28037,5696,2691,4541,459,13387,18742
28,28038,48973,17548,82449,14383,163353,248205
28,28039,6505,4174,3747,424,14850,21451
28,28040,9536,4807,12662,1541,28546,46712
28,28041,48100,28580,71986,15432,164098,245077
28,28042,2395,174,710,80,3359,4806
28,28043,7030,1123,5274,390,13817,18316
29,29001,449,761,4187,249,5646,8024
29,29002,973,1089,5636,441,8139,11474
29,29003,6324,5386,28444,2936,43090,64021
29,29004,439,658,1954,126,3177,4886
29,29034,3315,3001,11746,976,19038,30994
29,29005,1252,1445,5103,314,8114,12181
29,29006,2701,2417,14778,1230,21126,34177
29,29007,1020,1422,3486,284,6212,11380
29,29008,712,996,4410,304,6422,10194
29,29009,450,393,1920,169,2932,4390
29,29010,3586,4027,25537,1718,34868,51679
29,29052,958,830,7139,325,9252,14119
29,29051,481,491,4500,112,5584,8279
29,29011,223,284,1740,65,2312,3631
29,29012,795,836,2651,106,4388,6566
29,29013,5268,6676,23997,2128,38069,63563
29,29014,1085,1018,4573,267,6943,11283
29,29015,1441,2126,12799,599,16965,27916
29,29058,283,307,2502,47,3139,5456
29,29016,289,354,2579,157,3379,5277
29,29017,579,370,4094,100,5143,7693
29,29018,1214,1744,15155,667,18780,26505
29,29019,794,575,7451,379,9199,14581
29,29020,535,530,2794,168,4027,6544
29,29060,342,352,1755,91,2540,4280
29,29021,1001,1536,4681,420,7638,12923
29,29022,303,218,2803,62,3386,4477
29,29046,190,206,2668,40,3104,4786
29,29045,118,143,2278,35,2574,3673
29,29023,1068,952,8872,386,11278,18316
29,29024,1103,1369,10192,484,13148,19992
29,29025,3857,3902,26154,1057,34970,54385
29,29026,1017,1207,6438,411,9073,13910
29,29027,459,597,3969,74,5099,8777
29,29028,822,1298,9476,280,11876,16964
29,29029,412,792,4871,153,6228,8740
29,29049,159,236,1367,40,1802,3214
29,29047,146,183,2324,52,2705,5318
29,29030,849,1067,4374,187,6477,10079
29,29054,434,707,944,50,2135,3131
29,29055,211,379,858,52,1500,2225
29,29031,1897,1294,9122,816,13129,21726
29,29032,410,559,4819,159,5947,9432
29,29053,281,231,2438,101,3051,4350
29,29056,132,302,1624,54,2112,2971
29,29033,5606,7010,37106,2737,52459,73408
29,29035,297,426,1869,129,2721,4439
29,29036,853,1115,9096,465,11529,16898
29,29037,438,665,2721,89,3913,6640
29,29038,839,867,4828,391,6925,11078
29,29050,262,588,2031,99,2980,4210
29,29039,959,1427,7880,409,10675,16568
29,29040,539,552,3686,221,4998,7910
29,29057,287,176,976,43,1482,2415
29,29041,1443,1577,11125,364,14509,21542
29,29042,619,718,5766,231,7334,10601
29,29043,2013,1396,10564,943,14916,23907
29,29059,156,352,2055,59,2622,3762
29,29044,1629,2171,17330,782,21912,32739
29,29048,315,391,4056,91,4853,6907
30,30001,1936,450,1846,184,4416,6536
30,30002,972,130,764,47,1913,2439
30,30003,10411,3335,25765,984,40495,62342
30,30004,6518,3024,9966,569,20077,31574
30,30005,821,1177,830,15,2843,4134
30,30006,2095,558,6078,192,8923,13916
30,30007,1728,533,1276,61,3598,4958
30,30008,16927,8602,25329,1185,52043,77934
30,30009,1842,719,1242,96,3899,6352
30,30010,3774,1984,7795,345,13898,21702
30,30011,7264,4526,14607,905,27302,40921
30,30012,8705,2763,12181,996,24645,41448
30,30013,1635,357,1812,29,3833,5977
30,30014,4817,2521,12880,559,20777,30774
30,30015,3186,1864,8227,518,13795,19355
30,30016,5302,2091,8009,261,15663,25717
30,30017,4156,1211,8006,735,14108,23101
30,30018,1021,325,1086,36,2468,3314
30,30019,373,458,212,13,1056,1502
30,30020,695,554,1628,30,2907,4509
30,30021,1731,727,2707,89,5254,6969
30,30022,1994,1450,6608,322,10374,16841
30,30023,2663,1063,5761,251,9738,13957
30,30024,6124,6418,9898,282,22722,35002
30,30025,2604,2346,2433,116,7499,11025
30,30026,3957,2634,2688,81,9360,15733
30,30027,3300,963,7364,785,12412,17735
30,30028,3674,1815,2455,41,7985,11116
30,30029,38426,7673,31514,4815,82428,123977
30,30030,1961,1554,1539,91,5145,8312
30,30031,3219,1351,11678,718,16966,23300
30,30032,2321,1074,5056,126,8577,12660
30,30033,3207,1299,5293,106,9905,14407
30,30034,5211,1886,14095,444,21636,35113
30,30035,4990,2203,5233,130,12556,18558
30,30036,2402,1872,7067,463,11804,18254
30,30037,2145,1324,1832,80,5381,7277
30,30038,1693,285,2370,132,4480,7111
30,30039,1382,519,1440,22,3363,5295
30,30040,11842,4580,24851,2323,43596,67104
30,30041,22180,12889,117840,5318,158227,247776
30,30042,5610,2411,15195,1119,24335,38693
30,30043,276,277,670,3,1226,1687
30,30044,1561,166,1347,22,3096,4446
30,30045,3309,3095,3046,149,9599,14197
30,30046,21631,12164,64564,5430,103789,153995
30,30047,6541,2845,15874,603,25863,42021
30,30208,2350,1470,5798,151,9769,16793
30,30048,3109,979,3008,193,7289,11082
30,30049,6549,5285,8874,600,21308,35511
30,30050,5198,6093,42867,1295,55453,87773
30,30051,3547,1052,6245,241,11085,15942
30,30052,3290,1385,2394,43,7112,10578
30,30053,4227,1049,5892,110,11278,15731
30,30054,1589,1011,3352,96,6048,8753
30,30055,2348,1528,8583,495,12954,20135
30,30056,1976,1096,2866,81,6019,9128
30,30057,2013,1025,3202,35,6275,9268
30,30058,1321,544,1294,21,3180,4635
30,30059,2551,1231,2215,54,6051,9201
30,30060,5056,5759,15705,332,26852,38584
30,30061,1465,1088,5840,130,8523,13393
30,30062,2523,625,3706,120,6974,10397
30,30063,6853,3399,20492,578,31322,55115
30,30064,2809,1169,4450,328,8756,13453
30,30065,2992,1969,1583,85,6629,9436
30,30066,1071,144,830,12,2057,2911
30,30067,8173,3186,18291,1483,31133,49145
30,30068,4421,2468,4989,174,12052,18923
30,30069,2789,1730,2141,23,6683,9791
30,30070,7427,2696,20062,1845,32030,47450
30,30071,3484,1562,6218,394,11658,18098
30,30072,3212,1265,3375,138,7990,12300
30,30209,3833,1434,6247,147,11661,18973
30,30073,7987,4901,13433,1086,27407,40664
30,30074,3232,1306,5085,217,9840,13697
30,30075,4723,2325,10137,255,17440,29441
30,30076,670,251,2200,116,3237,4976
30,30077,3381,1963,2753,105,8202,13054
30,30078,3135,908,1771,28,5842,8615
30,30079,5765,1343,8757,435,16300,28743
30,30080,2845,1078,2342,71,6336,8795
30,30081,2380,2000,1106,69,5555,7698
30,30082,8463,3983,9612,233,22291,33434
30,30083,3008,1567,4752,228,9555,15619
30,30084,1342,542,5898,79,7861,11904
30,30085,2436,738,5254,399,8827,14893
30,30086,1380,304,1311,34,3029,4809
30,30087,6546,2798,20527,1154,31025,46008
30,30088,5680,2878,7545,465,16568,26393
30,30089,58926,26623,144755,17415,247719,371931
30,30090,1010,263,1189,35,2497,4020
30,30091,3885,2286,13142,488,19801,29572
30,30092,2145,890,2178,134,5347,8490
30,30093,2846,1137,6740,277,11000,18747
30,30094,1956,1211,3940,278,7385,11364
30,30095,5611,2601,6046,246,14504,25823
30,30096,2190,1164,3928,118,7400,11735
30,30097,440,91,423,5,959,1456
30,30098,2814,637,5855,255,9561,15334
30,30099,618,224,616,8,1466,1979
30,30100,1920,823,3550,324,6617,11359
30,30101,3477,1136,5586,230,10429,17041
30,30102,3985,1333,7543,565,13426,22744
30,30103,10498,4099,30851,1536,46984,77921
30,30211,4524,2463,7060,393,14440,22793
30,30104,1450,966,2051,29,4496,7326
30,30105,3238,1229,3939,68,8474,13211
30,30210,1569,1577,4005,108,7259,11032
30,30106,10127,2455,13954,1487,28023,50655
30,30107,908,223,1158,19,2308,3221
30,30108,666,206,422,12,1306,2082
30,30109,12404,7957,60088,2155,82604,124228
30,30110,7958,2411,19478,714,30561,47009
30,30111,2660,1095,839,22,4616,7261
30,30112,1033,1502,5375,134,8044,12310
30,30113,3752,1085,5602,344,10783,15369
30,30114,604,540,1129,39,2312,3366
30,30115,1571,989,2631,120,5311,7951
30,30116,3523,2153,14359,955,20990,33158
30,30117,2180,618,4308,149,7255,11809
30,30118,1719,2068,6754,286,10827,16487
30,30119,13649,6006,43156,4626,67437,97209
30,30120,651,446,1568,42,2707,4246
30,30121,872,707,4252,110,5941,9821
30,30122,3716,1896,3041,265,8918,15243
30,30123,2291,781,4521,89,7682,12288
30,30124,12285,4568,24284,1502,42639,68376
30,30125,19613,9775,43680,1844,74912,119982
30,30126,4821,1931,8045,425,15222,22358
30,30127,5658,1515,7323,418,14914,24755
30,30128,5894,1430,1538,107,8969,14046
30,30129,8945,6193,15059,1285,31482,47828
30,30130,3002,1308,3778,142,8230,12349
30,30131,7941,1497,8870,224,18532,28813
30,30212,1166,995,2954,38,5153,8928
30,30132,17557,9658,65593,5051,97859,147043
30,30133,5355,1870,12725,934,20884,33807
30,30134,3522,1956,5052,386,10916,16876
30,30135,2507,1402,5053,272,9234,13861
30,30136,1242,384,2143,142,3911,5695
30,30137,3479,891,4034,260,8664,12691
30,30138,949,858,775,21,2603,3710
30,30139,3497,1614,15435,1375,21921,33526
30,30140,1018,288,1452,54,2812,4879
30,30141,570,261,487,17,1335,1823
30,30142,21287,8320,35814,1475,66896,117374
30,30143,4835,1619,7488,183,14125,23874
30,30144,9845,3458,12678,444,26425,43254
30,30145,3344,1713,8509,207,13773,22820
30,30146,1927,383,4209,112,6631,10113
30,30147,632,457,720,44,1853,2744
30,30148,2241,1734,5973,145,10093,14026
30,30149,4686,2383,6714,355,14138,21396
30,30150,4604,4050,6623,132,15409,23144
30,30151,2269,2061,1939,79,6348,8470
30,30152,3731,3125,3863,207,10926,16864
30,30153,2019,727,2523,165,5434,8693
30,30154,1259,475,1309,46,3089,4371
30,30155,3455,1253,1610,92,6410,9056
30,30156,22657,9157,16532,582,48928,68338
30,30157,1564,309,745,45,2663,3752
30,30158,3955,2548,6556,335,13394,18452
30,30159,3874,2219,4137,65,10295,15559
30,30160,5660,2181,7892,194,15927,24826
30,30161,1432,895,981,28,3336,4797
30,30162,968,244,1332,29,2573,4004
30,30163,2117,1014,4412,364,7907,12226
30,30164,1780,1566,1303,72,4721,6233
30,30165,2440,224,2018,78,4760,6973
30,30166,2632,1205,3553,108,7498,10224
30,30167,2301,1869,2533,79,6782,9615
30,30168,2932,1238,4997,176,9343,17540
30,30169,1349,1989,1661,17,5016,6803
30,30170,638,500,1275,54,2467,3839
30,30171,2949,1162,5038,93,9242,14258
30,30172,7365,3867,13085,367,24684,37897
30,30173,10726,4339,26864,1290,43219,73338
30,30174,12479,4317,21629,1234,39659,64785
30,30175,868,262,1031,44,2205,3522
30,30176,2405,410,2281,95,5191,7443
30,30177,2480,766,3165,207,6618,10429
30,30178,912,304,953,35,2204,3133
30,30179,2177,1581,1629,23,5410,7856
30,30180,7410,1711,7533,339,16993,27695
30,30181,2241,1266,3993,362,7862,12456
30,30182,5139,4091,14240,663,24133,42040
30,30183,704,436,2094,12,3246,5173
30,30184,795,232,1494,72,2593,3691
30,30185,901,426,2001,150,3478,5206
30,30186,794,589,1265,17,2665,4010
30,30187,3617,2037,2671,173,8498,12140
30,30188,15756,7750,40176,3577,67259,109523
30,30189,864,129,482,8,1483,1944
30,30190,3866,1469,9541,625,15501,23545
30,30191,1930,1739,5131,230,9030,14998
30,30192,97997,22693,135344,19514,275548,456963
30,30193,2047,663,2425,84,5219,7655
30,30194,3908,4108,9330,498,17844,26049
30,30195,1109,390,1239,25,2763,3763
30,30196,1686,1329,5711,245,8971,13423
30,30197,2307,615,2644,74,5640,8380
30,30198,1880,314,1081,26,3301,4561
30,30199,775,806,3379,58,5018,8165
30,30200,2917,1169,2185,252,6523,9617
30,30201,9278,2888,8437,322,20925,30966
30,30202,3118,1001,1890,29,6038,8822
30,30203,2999,1019,1736,55,5809,8852
30,30204,4636,3096,11819,536,20087,32364
30,30205,1148,1751,12400,265,15564,23009
30,30206,1802,2122,17286,358,21568,33218
30,30207,1958,1969,5689,242,9858,14404
31,31001,1760,1561,901,21,4243,4892
31,31002,1691,3372,3735,203,9001,11578
31,31003,1114,1686,3222,64,6086,7792
31,31004,1110,1278,1294,72,3754,4519
31,31005,583,855,308,39,1785,1956
31,31006,1744,2233,1594,33,5604,6752
31,31007,773,1866,1978,67,4684,5478
31,31008,802,1355,791,15,2963,3352
31,31009,960,828,1285,52,3125,3664
31,31010,652,699,265,13,1629,1785
31,31011,868,1441,1867,45,4221,5500
31,31012,987,1116,352,20,2475,3078
31,31013,2167,2156,2106,181,6610,8331
31,31014,294,612,360,8,1274,1360
31,31015,1154,1104,926,23,3207,3794
31,31016,370,1288,356,2,2016,2126
31,31017,878,2001,490,18,3387,3602
31,31018,797,902,906,11,2616,2928
31,31019,8717,5968,4314,68,19067,22062
31,31020,830,1189,717,52,2788,3356
31,31021,1544,2475,1211,21,5251,5959
31,31022,345,1612,657,2,2616,2952
31,31023,783,959,1261,57,3060,3570
31,31024,972,750,573,19,2314,2593
31,31025,1273,806,1395,29,3503,3973
31,31026,650,1196,841,45,2732,3092
31,31027,1196,1465,2571,96,5328,6459
31,31028,457,574,886,22,1939,2213
31,31029,1251,1574,1325,33,4183,4842
31,31030,525,1033,1033,14,2605,2967
31,31031,1015,1105,455,21,2596,2846
31,31032,2271,4011,2117,43,8442,10520
31,31033,1908,5759,4949,83,12699,14705
31,31034,1088,974,1874,28,3964,4666
31,31035,1476,1483,990,24,3973,4738
31,31036,1860,1812,1447,60,5179,5930
31,31037,1080,1397,907,13,3397,3973
31,31038,5222,4905,6515,272,16914,23400
31,31039,775,911,844,78,2608,2994
31,31040,2741,6207,6137,242,15327,19663
31,31041,8939,10765,18111,1449,39264,66320
31,31042,942,1379,863,31,3215,3958
31,31043,354,813,801,9,1977,2196
31,31044,1915,1200,1247,51,4413,5021
31,31045,326,622,656,28,1632,1995
31,31046,620,851,736,20,2227,2506
31,31047,1315,1180,1220,34,3749,4220
31,31048,1727,5435,5033,110,12305,16477
31,31049,1129,1068,186,8,2391,2504
31,31050,136767,100002,208393,26810,471972,679846
31,31051,776,935,614,32,2357,2685
31,31052,4625,7596,7010,535,19766,25509
31,31053,1694,2637,2935,193,7459,9694
31,31054,487,1031,523,10,2051,2359
31,31055,1593,871,1031,19,3514,4852
31,31056,5541,4220,5744,242,15747,22275
31,31057,2300,1898,788,52,5038,5596
31,31058,2304,4231,5671,172,12378,16396
31,31059,7263,7205,13247,1824,29539,44094
31,31060,217,363,236,5,821,954
31,31061,910,823,881,32,2646,2909
31,31062,942,949,1178,28,3097,3670
31,31063,1163,1053,1175,67,3458,3977
31,31064,201,282,151,10,644,1377
31,31065,334,637,624,29,1624,1756
31,31066,638,1248,618,9,2513,2959
31,31067,2645,1399,1940,77,6061,7309
31,31068,763,775,506,15,2059,2533
31,31069,1641,1759,1017,15,4432,6002
31,31070,888,1110,603,32,2633,3008
31,31071,395,418,546,14,1373,1555
31,31072,171,579,646,11,1407,1705
31,31073,1035,1227,470,5,2737,2960
31,31074,983,702,1096,31,2812,3092
31,31075,1049,2117,964,19,4149,4660
31,31076,3987,3656,2125,121,9889,12414
31,31077,962,603,359,4,1928,2282
31,31078,704,1249,713,23,2689,3056
31,31079,6657,6517,9031,266,22471,29361
31,31080,2576,3073,1306,32,6987,7763
31,31081,746,1132,607,13,2498,2680
31,31082,583,1058,719,43,2403,2872
31,31083,458,489,533,54,1534,1806
31,31084,2409,1153,970,31,4563,5345
31,31085,2136,2654,4562,62,9414,10746
31,31086,660,584,583,13,1840,2081
31,31087,1357,1015,825,28,3225,3761
31,31088,492,554,292,12,1350,1616
31,31089,4550,5211,11562,268,21591,27919
31,31090,1940,1550,532,16,4038,5190
31,31091,1415,2817,3132,90,7454,8316
31,31092,302,1793,1788,3,3886,4576
31,31093,2876,2904,4461,249,10490,13450
31,31094,989,1590,780,13,3372,3795
31,31095,1160,1189,1287,68,3704,4378
31,31096,7951,12592,14314,767,35624,52608
31,31097,954,653,439,26,2072,2804
31,31098,2358,1934,2498,33,6823,9866
31,31099,1149,811,631,15,2606,2771
31,31100,371,998,723,75,2167,2769
31,31101,7892,7947,11606,874,28319,40503
31,31102,7026,9129,21770,1558,39483,53150
31,31103,202,106,156,2,466,2590
31,31104,3020,3948,1470,17,8455,10233
31,31105,252,765,1040,74,2131,2442
31,31106,537,438,762,15,1752,2030
32,32001,678,1178,1302,70,3228,5346
32,32002,504,903,1141,61,2609,4343
32,32003,520,528,408,59,1515,2413
32,32004,1081,497,716,114,2408,3478
32,32005,5724,2984,7008,1737,17453,28360
32,32006,481,1188,2349,128,4146,6002
32,32007,895,2596,3366,301,7158,9441
32,32008,1154,2595,2614,116,6479,8968
32,32009,1140,2275,1641,158,5214,8424
32,32010,16569,18111,59244,5978,99902,162936
32,32011,418,500,672,64,1654,2821
32,32012,1308,1039,1618,197,4162,6075
32,32013,928,723,1336,215,3202,4823
32,32014,1445,4626,5560,263,11894,17409
32,32015,416,362,335,7,1120,1635
32,32016,3332,3444,4912,276,11964,17285
32,32017,13258,13662,47732,5285,79937,126679
32,32057,1674,2843,4040,282,8839,12919
32,32018,744,684,839,89,2356,3934
32,32019,3680,2452,5083,546,11761,19875
32,32020,8075,6617,12546,2199,29437,51256
32,32021,600,771,979,29,2379,3282
32,32022,2659,2272,4895,497,10323,15891
32,32023,1850,968,3159,325,6302,10883
32,32024,2628,2930,14335,1072,20965,33654
32,32025,1517,1619,2921,227,6284,9211
32,32026,1044,5915,3762,173,10894,14626
32,32027,125,877,1082,22,2106,2499
32,32028,664,187,715,34,1600,2360
32,32029,1183,2089,5409,501,9182,16723
32,32030,542,455,439,41,1477,2343
32,32031,1259,1900,1208,271,4638,7745
32,32032,992,1497,3584,498,6571,9159
32,32033,893,654,951,110,2608,4440
32,32034,4168,1692,6952,629,13441,24642
32,32035,1062,2725,3917,155,7859,11322
32,32036,3396,5093,8541,825,17855,29423
32,32037,1532,2909,4022,222,8685,12354
32,32038,6419,14150,11583,487,32639,49548
32,32039,6871,6221,12736,1364,27192,49779
32,32040,3383,3057,4325,121,10886,16473
32,32041,123,1194,377,16,1710,2105
32,32042,6837,5865,12254,1669,26625,46783
32,32043,164,213,508,12,897,1289
32,32044,3083,1689,2796,294,7862,12535
32,32045,1173,1413,1796,141,4523,7011
32,32046,661,2227,850,118,3856,6311
32,32047,698,851,1173,136,2858,4349
32,32058,517,338,610,29,1494,2338
32,32048,3648,2423,6085,705,12861,19994
32,32049,5117,4753,6111,698,16679,26866
32,32050,596,1427,3584,176,5783,7667
32,32051,2795,5221,8222,434,16672,24913
32,32052,1710,2532,4964,177,9383,12626
32,32053,1223,1705,3430,120,6478,9855
32,32054,2596,3191,3658,141,9586,13389
32,32055,6007,3566,6070,565,16208,25131
32,32056,12740,11161,42445,4988,71334,108518
